,data,area,Vaccinazioni giornaliere,sesso_maschile,sesso_femminile,prima_dose,seconda_dose,codice_NUTS1,codice_NUTS2,codice_regione_ISTAT,nome_area,Regione,popolazione,Totale vaccinazioni,Totale vaccinazioni ogni cento ab,Vaccinazioni giornaliere ogni cento ab
0,2021-04-10,PAB,5391,2664,2727,4803,588,ITH,ITH1,4,Provincia Autonoma Bolzano / Bozen,P.A. Bolzano,533050,5391,1.01,1.01
1,2021-04-19,PAB,1871,858,1013,1689,182,ITH,ITH1,4,Provincia Autonoma Bolzano / Bozen,P.A. Bolzano,533050,7262,1.36,0.35
2,2021-01-07,PAB,917,327,590,917,0,ITH,ITH1,4,Provincia Autonoma Bolzano / Bozen,P.A. Bolzano,533050,8179,1.53,0.17
3,2021-03-07,PAB,114,13,101,9,105,ITH,ITH1,4,Provincia Autonoma Bolzano / Bozen,P.A. Bolzano,533050,8293,1.56,0.02
4,2021-01-02,PAB,91,48,43,91,0,ITH,ITH1,4,Provincia Autonoma Bolzano / Bozen,P.A. Bolzano,533050,8384,1.57,0.02
5,2021-05-18,PAB,3303,1727,1576,2139,1164,ITH,ITH1,4,Provincia Autonoma Bolzano / Bozen,P.A. Bolzano,533050,11687,2.19,0.62
6,2021-03-29,PAB,1171,499,672,412,759,ITH,ITH1,4,Provincia Autonoma Bolzano / Bozen,P.A. Bolzano,533050,12858,2.41,0.22
7,2021-05-01,PAB,2104,1067,1037,1944,160,ITH,ITH1,4,Provincia Autonoma Bolzano / Bozen,P.A. Bolzano,533050,14962,2.81,0.39
8,2021-03-12,PAB,1664,734,930,1251,413,ITH,ITH1,4,Provincia Autonoma Bolzano / Bozen,P.A. Bolzano,533050,16626,3.12,0.31
9,2021-03-10,PAB,1262,524,738,1119,143,ITH,ITH1,4,Provincia Autonoma Bolzano / Bozen,P.A. Bolzano,533050,17888,3.36,0.24
10,2021-05-06,PAB,5181,2747,2434,2612,2569,ITH,ITH1,4,Provincia Autonoma Bolzano / Bozen,P.A. Bolzano,533050,23069,4.33,0.97
11,2021-04-29,PAB,2630,1351,1279,1936,694,ITH,ITH1,4,Provincia Autonoma Bolzano / Bozen,P.A. Bolzano,533050,25699,4.82,0.49
12,2021-01-26,PAB,810,291,519,1,809,ITH,ITH1,4,Provincia Autonoma Bolzano / Bozen,P.A. Bolzano,533050,26509,4.97,0.15
13,2021-03-24,PAB,2041,978,1063,2028,13,ITH,ITH1,4,Provincia Autonoma Bolzano / Bozen,P.A. Bolzano,533050,28550,5.36,0.38
14,2021-03-17,PAB,581,213,368,580,1,ITH,ITH1,4,Provincia Autonoma Bolzano / Bozen,P.A. Bolzano,533050,29131,5.46,0.11
15,2021-05-13,PAB,2989,1352,1637,1059,1930,ITH,ITH1,4,Provincia Autonoma Bolzano / Bozen,P.A. Bolzano,533050,32120,6.03,0.56
16,2021-01-19,PAB,853,371,482,723,130,ITH,ITH1,4,Provincia Autonoma Bolzano / Bozen,P.A. Bolzano,533050,32973,6.19,0.16
17,2021-02-09,PAB,317,126,191,1,316,ITH,ITH1,4,Provincia Autonoma Bolzano / Bozen,P.A. Bolzano,533050,33290,6.25,0.06
18,2021-02-02,PAB,1745,506,1239,8,1737,ITH,ITH1,4,Provincia Autonoma Bolzano / Bozen,P.A. Bolzano,533050,35035,6.57,0.33
19,2021-01-12,PAB,1709,459,1250,1709,0,ITH,ITH1,4,Provincia Autonoma Bolzano / Bozen,P.A. Bolzano,533050,36744,6.89,0.32
20,2021-04-07,PAB,1777,802,975,1238,539,ITH,ITH1,4,Provincia Autonoma Bolzano / Bozen,P.A. Bolzano,533050,38521,7.23,0.33
21,2021-03-02,PAB,695,200,495,693,2,ITH,ITH1,4,Provincia Autonoma Bolzano / Bozen,P.A. Bolzano,533050,39216,7.36,0.13
22,2021-03-04,PAB,1714,1004,710,1485,229,ITH,ITH1,4,Provincia Autonoma Bolzano / Bozen,P.A. Bolzano,533050,40930,7.68,0.32
23,2021-03-03,PAB,1179,393,786,1166,13,ITH,ITH1,4,Provincia Autonoma Bolzano / Bozen,P.A. Bolzano,533050,42109,7.9,0.22
24,2021-05-27,PAB,6049,3178,2871,4045,2004,ITH,ITH1,4,Provincia Autonoma Bolzano / Bozen,P.A. Bolzano,533050,48158,9.03,1.13
25,2021-02-14,PAB,297,130,167,297,0,ITH,ITH1,4,Provincia Autonoma Bolzano / Bozen,P.A. Bolzano,533050,48455,9.09,0.06
26,2021-01-28,PAB,871,308,563,10,861,ITH,ITH1,4,Provincia Autonoma Bolzano / Bozen,P.A. Bolzano,533050,49326,9.25,0.16
27,2021-05-10,PAB,3018,1300,1718,1413,1605,ITH,ITH1,4,Provincia Autonoma Bolzano / Bozen,P.A. Bolzano,533050,52344,9.82,0.57
28,2021-04-28,PAB,2464,1302,1162,2459,5,ITH,ITH1,4,Provincia Autonoma Bolzano / Bozen,P.A. Bolzano,533050,54808,10.28,0.46
29,2021-01-24,PAB,12,10,2,0,12,ITH,ITH1,4,Provincia Autonoma Bolzano / Bozen,P.A. Bolzano,533050,54820,10.28,0.0
30,2021-05-15,PAB,6996,3684,3312,6701,295,ITH,ITH1,4,Provincia Autonoma Bolzano / Bozen,P.A. Bolzano,533050,61816,11.6,1.31
31,2021-05-22,PAB,6821,3552,3269,4654,2167,ITH,ITH1,4,Provincia Autonoma Bolzano / Bozen,P.A. Bolzano,533050,68637,12.88,1.28
32,2021-04-02,PAB,2077,837,1240,720,1357,ITH,ITH1,4,Provincia Autonoma Bolzano / Bozen,P.A. Bolzano,533050,70714,13.27,0.39
33,2021-01-05,PAB,830,286,544,830,0,ITH,ITH1,4,Provincia Autonoma Bolzano / Bozen,P.A. Bolzano,533050,71544,13.42,0.16
34,2021-05-20,PAB,4696,2314,2382,3240,1456,ITH,ITH1,4,Provincia Autonoma Bolzano / Bozen,P.A. Bolzano,533050,76240,14.3,0.88
35,2021-03-31,PAB,1832,694,1138,821,1011,ITH,ITH1,4,Provincia Autonoma Bolzano / Bozen,P.A. Bolzano,533050,78072,14.65,0.34
36,2021-06-03,PAB,4656,2523,2133,3748,908,ITH,ITH1,4,Provincia Autonoma Bolzano / Bozen,P.A. Bolzano,533050,82728,15.52,0.87
37,2021-04-14,PAB,3593,1645,1948,3502,91,ITH,ITH1,4,Provincia Autonoma Bolzano / Bozen,P.A. Bolzano,533050,86321,16.19,0.67
38,2021-02-23,PAB,769,324,445,763,6,ITH,ITH1,4,Provincia Autonoma Bolzano / Bozen,P.A. Bolzano,533050,87090,16.34,0.14
39,2021-01-04,PAB,508,201,307,508,0,ITH,ITH1,4,Provincia Autonoma Bolzano / Bozen,P.A. Bolzano,533050,87598,16.43,0.1
40,2021-03-26,PAB,1645,722,923,512,1133,ITH,ITH1,4,Provincia Autonoma Bolzano / Bozen,P.A. Bolzano,533050,89243,16.74,0.31
41,2021-02-04,PAB,1958,593,1365,8,1950,ITH,ITH1,4,Provincia Autonoma Bolzano / Bozen,P.A. Bolzano,533050,91201,17.11,0.37
42,2021-05-29,PAB,7129,3766,3363,3994,3135,ITH,ITH1,4,Provincia Autonoma Bolzano / Bozen,P.A. Bolzano,533050,98330,18.45,1.34
43,2021-04-09,PAB,2926,1292,1634,2196,730,ITH,ITH1,4,Provincia Autonoma Bolzano / Bozen,P.A. Bolzano,533050,101256,19.0,0.55
44,2021-02-11,PAB,1093,431,662,239,854,ITH,ITH1,4,Provincia Autonoma Bolzano / Bozen,P.A. Bolzano,533050,102349,19.2,0.21
45,2021-02-12,PAB,730,217,513,482,248,ITH,ITH1,4,Provincia Autonoma Bolzano / Bozen,P.A. Bolzano,533050,103079,19.34,0.14
46,2021-04-17,PAB,5232,2598,2634,5188,44,ITH,ITH1,4,Provincia Autonoma Bolzano / Bozen,P.A. Bolzano,533050,108311,20.32,0.98
47,2020-12-31,PAB,912,518,394,912,0,ITH,ITH1,4,Provincia Autonoma Bolzano / Bozen,P.A. Bolzano,533050,109223,20.49,0.17
48,2021-04-12,PAB,2105,946,1159,2098,7,ITH,ITH1,4,Provincia Autonoma Bolzano / Bozen,P.A. Bolzano,533050,111328,20.89,0.39
49,2021-01-09,PAB,612,326,286,612,0,ITH,ITH1,4,Provincia Autonoma Bolzano / Bozen,P.A. Bolzano,533050,111940,21.0,0.11
50,2021-04-21,PAB,3012,1468,1544,2164,848,ITH,ITH1,4,Provincia Autonoma Bolzano / Bozen,P.A. Bolzano,533050,114952,21.56,0.57
51,2021-02-07,PAB,2361,1057,1304,14,2347,ITH,ITH1,4,Provincia Autonoma Bolzano / Bozen,P.A. Bolzano,533050,117313,22.01,0.44
52,2021-01-21,PAB,953,442,511,139,814,ITH,ITH1,4,Provincia Autonoma Bolzano / Bozen,P.A. Bolzano,533050,118266,22.19,0.18
53,2021-05-03,PAB,1830,847,983,417,1413,ITH,ITH1,4,Provincia Autonoma Bolzano / Bozen,P.A. Bolzano,533050,120096,22.53,0.34
54,2021-01-23,PAB,197,117,80,0,197,ITH,ITH1,4,Provincia Autonoma Bolzano / Bozen,P.A. Bolzano,533050,120293,22.57,0.04
55,2021-05-17,PAB,3124,1506,1618,2440,684,ITH,ITH1,4,Provincia Autonoma Bolzano / Bozen,P.A. Bolzano,533050,123417,23.15,0.59
56,2021-03-14,PAB,758,336,422,25,733,ITH,ITH1,4,Provincia Autonoma Bolzano / Bozen,P.A. Bolzano,533050,124175,23.3,0.14
57,2021-02-19,PAB,2252,512,1740,2241,11,ITH,ITH1,4,Provincia Autonoma Bolzano / Bozen,P.A. Bolzano,533050,126427,23.72,0.42
58,2021-02-26,PAB,1526,551,975,1496,30,ITH,ITH1,4,Provincia Autonoma Bolzano / Bozen,P.A. Bolzano,533050,127953,24.0,0.29
59,2021-06-01,PAB,3461,2244,1217,2038,1423,ITH,ITH1,4,Provincia Autonoma Bolzano / Bozen,P.A. Bolzano,533050,131414,24.65,0.65
60,2021-04-26,PAB,1543,771,772,1538,5,ITH,ITH1,4,Provincia Autonoma Bolzano / Bozen,P.A. Bolzano,533050,132957,24.94,0.29
61,2021-01-16,PAB,2840,1265,1575,2840,0,ITH,ITH1,4,Provincia Autonoma Bolzano / Bozen,P.A. Bolzano,533050,135797,25.48,0.53
62,2021-03-16,PAB,1290,532,758,124,1166,ITH,ITH1,4,Provincia Autonoma Bolzano / Bozen,P.A. Bolzano,533050,137087,25.72,0.24
63,2021-05-14,PAB,5102,2297,2805,3086,2016,ITH,ITH1,4,Provincia Autonoma Bolzano / Bozen,P.A. Bolzano,533050,142189,26.67,0.96
64,2021-02-01,PAB,1452,440,1012,12,1440,ITH,ITH1,4,Provincia Autonoma Bolzano / Bozen,P.A. Bolzano,533050,143641,26.95,0.27
65,2021-05-23,PAB,4332,2302,2030,4324,8,ITH,ITH1,4,Provincia Autonoma Bolzano / Bozen,P.A. Bolzano,533050,147973,27.76,0.81
66,2021-02-10,PAB,1635,604,1031,26,1609,ITH,ITH1,4,Provincia Autonoma Bolzano / Bozen,P.A. Bolzano,533050,149608,28.07,0.31
67,2021-03-22,PAB,1133,514,619,1129,4,ITH,ITH1,4,Provincia Autonoma Bolzano / Bozen,P.A. Bolzano,533050,150741,28.28,0.21
68,2021-05-25,PAB,3809,1968,1841,2935,874,ITH,ITH1,4,Provincia Autonoma Bolzano / Bozen,P.A. Bolzano,533050,154550,28.99,0.71
69,2021-03-05,PAB,1839,625,1214,1397,442,ITH,ITH1,4,Provincia Autonoma Bolzano / Bozen,P.A. Bolzano,533050,156389,29.34,0.34
70,2021-05-08,PAB,4426,2381,2045,3762,664,ITH,ITH1,4,Provincia Autonoma Bolzano / Bozen,P.A. Bolzano,533050,160815,30.17,0.83
71,2021-02-16,PAB,530,205,325,530,0,ITH,ITH1,4,Provincia Autonoma Bolzano / Bozen,P.A. Bolzano,533050,161345,30.27,0.1
72,2021-01-06,PAB,59,18,41,59,0,ITH,ITH1,4,Provincia Autonoma Bolzano / Bozen,P.A. Bolzano,533050,161404,30.28,0.01
73,2021-05-19,PAB,3575,1820,1755,1812,1763,ITH,ITH1,4,Provincia Autonoma Bolzano / Bozen,P.A. Bolzano,533050,164979,30.95,0.67
74,2021-01-20,PAB,617,252,365,409,208,ITH,ITH1,4,Provincia Autonoma Bolzano / Bozen,P.A. Bolzano,533050,165596,31.07,0.12
75,2021-03-11,PAB,1681,823,858,1143,538,ITH,ITH1,4,Provincia Autonoma Bolzano / Bozen,P.A. Bolzano,533050,167277,31.38,0.32
76,2021-02-22,PAB,526,143,383,514,12,ITH,ITH1,4,Provincia Autonoma Bolzano / Bozen,P.A. Bolzano,533050,167803,31.48,0.1
77,2021-01-03,PAB,41,16,25,41,0,ITH,ITH1,4,Provincia Autonoma Bolzano / Bozen,P.A. Bolzano,533050,167844,31.49,0.01
78,2021-05-26,PAB,4797,2421,2376,2845,1952,ITH,ITH1,4,Provincia Autonoma Bolzano / Bozen,P.A. Bolzano,533050,172641,32.39,0.9
79,2021-02-15,PAB,72,42,30,26,46,ITH,ITH1,4,Provincia Autonoma Bolzano / Bozen,P.A. Bolzano,533050,172713,32.4,0.01
80,2021-05-28,PAB,5623,2853,2770,3775,1848,ITH,ITH1,4,Provincia Autonoma Bolzano / Bozen,P.A. Bolzano,533050,178336,33.46,1.05
81,2021-04-22,PAB,2923,1500,1423,1981,942,ITH,ITH1,4,Provincia Autonoma Bolzano / Bozen,P.A. Bolzano,533050,181259,34.0,0.55
82,2021-04-23,PAB,4542,2151,2391,3251,1291,ITH,ITH1,4,Provincia Autonoma Bolzano / Bozen,P.A. Bolzano,533050,185801,34.86,0.85
83,2021-01-11,PAB,1570,513,1057,1570,0,ITH,ITH1,4,Provincia Autonoma Bolzano / Bozen,P.A. Bolzano,533050,187371,35.15,0.29
84,2021-04-06,PAB,2249,1117,1132,2146,103,ITH,ITH1,4,Provincia Autonoma Bolzano / Bozen,P.A. Bolzano,533050,189620,35.57,0.42
85,2021-01-18,PAB,1772,687,1085,1767,5,ITH,ITH1,4,Provincia Autonoma Bolzano / Bozen,P.A. Bolzano,533050,191392,35.91,0.33
86,2021-05-05,PAB,4154,1945,2209,2038,2116,ITH,ITH1,4,Provincia Autonoma Bolzano / Bozen,P.A. Bolzano,533050,195546,36.68,0.78
87,2021-01-25,PAB,487,183,304,3,484,ITH,ITH1,4,Provincia Autonoma Bolzano / Bozen,P.A. Bolzano,533050,196033,36.78,0.09
88,2021-03-23,PAB,1552,759,793,1551,1,ITH,ITH1,4,Provincia Autonoma Bolzano / Bozen,P.A. Bolzano,533050,197585,37.07,0.29
89,2021-05-07,PAB,4181,2055,2126,3663,518,ITH,ITH1,4,Provincia Autonoma Bolzano / Bozen,P.A. Bolzano,533050,201766,37.85,0.78
90,2021-04-01,PAB,2786,1407,1379,2642,144,ITH,ITH1,4,Provincia Autonoma Bolzano / Bozen,P.A. Bolzano,533050,204552,38.37,0.52
91,2021-03-25,PAB,2141,1059,1082,1698,443,ITH,ITH1,4,Provincia Autonoma Bolzano / Bozen,P.A. Bolzano,533050,206693,38.78,0.4
92,2021-01-27,PAB,84,28,56,1,83,ITH,ITH1,4,Provincia Autonoma Bolzano / Bozen,P.A. Bolzano,533050,206777,38.79,0.02
93,2021-02-18,PAB,1839,457,1382,1832,7,ITH,ITH1,4,Provincia Autonoma Bolzano / Bozen,P.A. Bolzano,533050,208616,39.14,0.34
94,2020-12-30,PAB,388,182,206,388,0,ITH,ITH1,4,Provincia Autonoma Bolzano / Bozen,P.A. Bolzano,533050,209004,39.21,0.07
95,2021-04-27,PAB,2226,1013,1213,1150,1076,ITH,ITH1,4,Provincia Autonoma Bolzano / Bozen,P.A. Bolzano,533050,211230,39.63,0.42
96,2021-03-15,PAB,1192,451,741,710,482,ITH,ITH1,4,Provincia Autonoma Bolzano / Bozen,P.A. Bolzano,533050,212422,39.85,0.22
97,2021-01-10,PAB,2,2,0,2,0,ITH,ITH1,4,Provincia Autonoma Bolzano / Bozen,P.A. Bolzano,533050,212424,39.85,0.0
98,2021-02-24,PAB,1367,406,961,1355,12,ITH,ITH1,4,Provincia Autonoma Bolzano / Bozen,P.A. Bolzano,533050,213791,40.11,0.26
99,2021-04-15,PAB,4399,2307,2092,4136,263,ITH,ITH1,4,Provincia Autonoma Bolzano / Bozen,P.A. Bolzano,533050,218190,40.93,0.83
100,2021-04-20,PAB,1560,783,777,1559,1,ITH,ITH1,4,Provincia Autonoma Bolzano / Bozen,P.A. Bolzano,533050,219750,41.23,0.29
101,2021-03-01,PAB,922,221,701,921,1,ITH,ITH1,4,Provincia Autonoma Bolzano / Bozen,P.A. Bolzano,533050,220672,41.4,0.17
102,2021-01-17,PAB,2328,1044,1284,2317,11,ITH,ITH1,4,Provincia Autonoma Bolzano / Bozen,P.A. Bolzano,533050,223000,41.83,0.44
103,2021-05-30,PAB,4758,2514,2244,752,4006,ITH,ITH1,4,Provincia Autonoma Bolzano / Bozen,P.A. Bolzano,533050,227758,42.73,0.89
104,2021-04-03,PAB,831,364,467,22,809,ITH,ITH1,4,Provincia Autonoma Bolzano / Bozen,P.A. Bolzano,533050,228589,42.88,0.16
105,2021-05-12,PAB,3790,2058,1732,3637,153,ITH,ITH1,4,Provincia Autonoma Bolzano / Bozen,P.A. Bolzano,533050,232379,43.59,0.71
106,2021-03-09,PAB,1194,543,651,1192,2,ITH,ITH1,4,Provincia Autonoma Bolzano / Bozen,P.A. Bolzano,533050,233573,43.82,0.22
107,2021-03-18,PAB,1302,531,771,226,1076,ITH,ITH1,4,Provincia Autonoma Bolzano / Bozen,P.A. Bolzano,533050,234875,44.06,0.24
108,2021-02-03,PAB,1503,478,1025,5,1498,ITH,ITH1,4,Provincia Autonoma Bolzano / Bozen,P.A. Bolzano,533050,236378,44.34,0.28
109,2021-05-21,PAB,6844,3738,3106,5066,1778,ITH,ITH1,4,Provincia Autonoma Bolzano / Bozen,P.A. Bolzano,533050,243222,45.63,1.28
110,2021-05-16,PAB,2024,931,1093,1330,694,ITH,ITH1,4,Provincia Autonoma Bolzano / Bozen,P.A. Bolzano,533050,245246,46.01,0.38
111,2021-04-30,PAB,3337,1592,1745,1562,1775,ITH,ITH1,4,Provincia Autonoma Bolzano / Bozen,P.A. Bolzano,533050,248583,46.63,0.63
112,2021-04-16,PAB,2949,1418,1531,2438,511,ITH,ITH1,4,Provincia Autonoma Bolzano / Bozen,P.A. Bolzano,533050,251532,47.19,0.55
113,2021-02-25,PAB,1498,549,949,1497,1,ITH,ITH1,4,Provincia Autonoma Bolzano / Bozen,P.A. Bolzano,533050,253030,47.47,0.28
114,2021-03-30,PAB,1298,532,766,218,1080,ITH,ITH1,4,Provincia Autonoma Bolzano / Bozen,P.A. Bolzano,533050,254328,47.71,0.24
115,2021-06-02,PAB,1442,809,633,987,455,ITH,ITH1,4,Provincia Autonoma Bolzano / Bozen,P.A. Bolzano,533050,255770,47.98,0.27
116,2021-02-08,PAB,2,1,1,1,1,ITH,ITH1,4,Provincia Autonoma Bolzano / Bozen,P.A. Bolzano,533050,255772,47.98,0.0
117,2021-04-13,PAB,2391,1130,1261,2384,7,ITH,ITH1,4,Provincia Autonoma Bolzano / Bozen,P.A. Bolzano,533050,258163,48.43,0.45
118,2021-05-31,PAB,2987,1464,1523,2120,867,ITH,ITH1,4,Provincia Autonoma Bolzano / Bozen,P.A. Bolzano,533050,261150,48.99,0.56
119,2021-02-13,PAB,318,79,239,312,6,ITH,ITH1,4,Provincia Autonoma Bolzano / Bozen,P.A. Bolzano,533050,261468,49.05,0.06
120,2021-04-11,PAB,2720,1291,1429,2543,177,ITH,ITH1,4,Provincia Autonoma Bolzano / Bozen,P.A. Bolzano,533050,264188,49.56,0.51
121,2021-05-24,PAB,1442,761,681,1109,333,ITH,ITH1,4,Provincia Autonoma Bolzano / Bozen,P.A. Bolzano,533050,265630,49.83,0.27
122,2021-01-01,PAB,6,5,1,6,0,ITH,ITH1,4,Provincia Autonoma Bolzano / Bozen,P.A. Bolzano,533050,265636,49.83,0.0
123,2021-02-27,PAB,2458,759,1699,2448,10,ITH,ITH1,4,Provincia Autonoma Bolzano / Bozen,P.A. Bolzano,533050,268094,50.29,0.46
124,2021-02-20,PAB,1802,540,1262,1784,18,ITH,ITH1,4,Provincia Autonoma Bolzano / Bozen,P.A. Bolzano,533050,269896,50.63,0.34
125,2021-04-18,PAB,3110,1607,1503,2100,1010,ITH,ITH1,4,Provincia Autonoma Bolzano / Bozen,P.A. Bolzano,533050,273006,51.22,0.58
126,2021-01-15,PAB,3282,1228,2054,3282,0,ITH,ITH1,4,Provincia Autonoma Bolzano / Bozen,P.A. Bolzano,533050,276288,51.83,0.62
127,2021-01-08,PAB,1521,479,1042,1521,0,ITH,ITH1,4,Provincia Autonoma Bolzano / Bozen,P.A. Bolzano,533050,277809,52.12,0.29
128,2021-02-06,PAB,2626,1171,1455,19,2607,ITH,ITH1,4,Provincia Autonoma Bolzano / Bozen,P.A. Bolzano,533050,280435,52.61,0.49
129,2021-03-28,PAB,569,212,357,11,558,ITH,ITH1,4,Provincia Autonoma Bolzano / Bozen,P.A. Bolzano,533050,281004,52.72,0.11
130,2021-03-13,PAB,2885,1459,1426,2784,101,ITH,ITH1,4,Provincia Autonoma Bolzano / Bozen,P.A. Bolzano,533050,283889,53.26,0.54
131,2021-05-02,PAB,2457,1288,1169,1536,921,ITH,ITH1,4,Provincia Autonoma Bolzano / Bozen,P.A. Bolzano,533050,286346,53.72,0.46
132,2021-04-24,PAB,5104,2449,2655,4619,485,ITH,ITH1,4,Provincia Autonoma Bolzano / Bozen,P.A. Bolzano,533050,291450,54.68,0.96
133,2021-04-05,PAB,301,144,157,23,278,ITH,ITH1,4,Provincia Autonoma Bolzano / Bozen,P.A. Bolzano,533050,291751,54.73,0.06
134,2021-01-14,PAB,1946,575,1371,1946,0,ITH,ITH1,4,Provincia Autonoma Bolzano / Bozen,P.A. Bolzano,533050,293697,55.1,0.37
135,2021-03-19,PAB,1906,773,1133,799,1107,ITH,ITH1,4,Provincia Autonoma Bolzano / Bozen,P.A. Bolzano,533050,295603,55.46,0.36
136,2021-03-21,PAB,768,285,483,14,754,ITH,ITH1,4,Provincia Autonoma Bolzano / Bozen,P.A. Bolzano,533050,296371,55.6,0.14
137,2021-01-30,PAB,498,245,253,4,494,ITH,ITH1,4,Provincia Autonoma Bolzano / Bozen,P.A. Bolzano,533050,296869,55.69,0.09
138,2021-04-25,PAB,3072,1497,1575,2401,671,ITH,ITH1,4,Provincia Autonoma Bolzano / Bozen,P.A. Bolzano,533050,299941,56.27,0.58
139,2021-01-13,PAB,1691,557,1134,1691,0,ITH,ITH1,4,Provincia Autonoma Bolzano / Bozen,P.A. Bolzano,533050,301632,56.59,0.32
140,2021-04-08,PAB,2754,1336,1418,2551,203,ITH,ITH1,4,Provincia Autonoma Bolzano / Bozen,P.A. Bolzano,533050,304386,57.1,0.52
141,2020-12-27,PAB,144,65,79,144,0,ITH,ITH1,4,Provincia Autonoma Bolzano / Bozen,P.A. Bolzano,533050,304530,57.13,0.03
142,2021-02-17,PAB,156,51,105,139,17,ITH,ITH1,4,Provincia Autonoma Bolzano / Bozen,P.A. Bolzano,533050,304686,57.16,0.03
143,2021-03-20,PAB,1757,848,909,1132,625,ITH,ITH1,4,Provincia Autonoma Bolzano / Bozen,P.A. Bolzano,533050,306443,57.49,0.33
144,2021-03-08,PAB,1200,526,674,1173,27,ITH,ITH1,4,Provincia Autonoma Bolzano / Bozen,P.A. Bolzano,533050,307643,57.71,0.23
145,2021-05-04,PAB,3447,1843,1604,2410,1037,ITH,ITH1,4,Provincia Autonoma Bolzano / Bozen,P.A. Bolzano,533050,311090,58.36,0.65
146,2021-05-09,PAB,4234,2405,1829,3081,1153,ITH,ITH1,4,Provincia Autonoma Bolzano / Bozen,P.A. Bolzano,533050,315324,59.15,0.79
147,2021-03-06,PAB,3972,2081,1891,3761,211,ITH,ITH1,4,Provincia Autonoma Bolzano / Bozen,P.A. Bolzano,533050,319296,59.9,0.75
148,2021-05-11,PAB,2842,1334,1508,1320,1522,ITH,ITH1,4,Provincia Autonoma Bolzano / Bozen,P.A. Bolzano,533050,322138,60.43,0.53
149,2021-01-29,PAB,1497,510,987,24,1473,ITH,ITH1,4,Provincia Autonoma Bolzano / Bozen,P.A. Bolzano,533050,323635,60.71,0.28
150,2021-03-27,PAB,3049,1553,1496,1543,1506,ITH,ITH1,4,Provincia Autonoma Bolzano / Bozen,P.A. Bolzano,533050,326684,61.29,0.57
151,2021-02-05,PAB,3195,1181,2014,8,3187,ITH,ITH1,4,Provincia Autonoma Bolzano / Bozen,P.A. Bolzano,533050,329879,61.89,0.6
152,2021-01-22,PAB,248,143,105,124,124,ITH,ITH1,4,Provincia Autonoma Bolzano / Bozen,P.A. Bolzano,533050,330127,61.93,0.05
153,2021-03-28,UMB,1096,442,654,1072,24,ITI,ITI2,10,Umbria,Umbria,882015,1096,0.12,0.12
154,2021-04-06,UMB,5290,2169,3121,2901,2389,ITI,ITI2,10,Umbria,Umbria,882015,6386,0.72,0.6
155,2021-02-22,UMB,1859,778,1081,1773,86,ITI,ITI2,10,Umbria,Umbria,882015,8245,0.93,0.21
156,2021-01-27,UMB,840,330,510,13,827,ITI,ITI2,10,Umbria,Umbria,882015,9085,1.03,0.1
157,2021-04-01,UMB,4374,1836,2538,2366,2008,ITI,ITI2,10,Umbria,Umbria,882015,13459,1.53,0.5
158,2021-01-10,UMB,1070,277,793,1070,0,ITI,ITI2,10,Umbria,Umbria,882015,14529,1.65,0.12
159,2021-01-18,UMB,614,219,395,529,85,ITI,ITI2,10,Umbria,Umbria,882015,15143,1.72,0.07
160,2021-03-25,UMB,3904,1699,2205,2840,1064,ITI,ITI2,10,Umbria,Umbria,882015,19047,2.16,0.44
161,2021-03-08,UMB,3672,1801,1871,2309,1363,ITI,ITI2,10,Umbria,Umbria,882015,22719,2.58,0.42
162,2021-05-31,UMB,5764,2814,2950,4914,850,ITI,ITI2,10,Umbria,Umbria,882015,28483,3.23,0.65
163,2021-02-18,UMB,1496,582,914,1030,466,ITI,ITI2,10,Umbria,Umbria,882015,29979,3.4,0.17
164,2021-05-14,UMB,5240,2435,2805,3435,1805,ITI,ITI2,10,Umbria,Umbria,882015,35219,3.99,0.59
165,2021-02-01,UMB,1285,342,943,48,1237,ITI,ITI2,10,Umbria,Umbria,882015,36504,4.14,0.15
166,2021-04-27,UMB,5665,2403,3262,3088,2577,ITI,ITI2,10,Umbria,Umbria,882015,42169,4.78,0.64
167,2021-05-19,UMB,9391,4197,5194,5651,3740,ITI,ITI2,10,Umbria,Umbria,882015,51560,5.85,1.06
168,2021-03-23,UMB,3797,1685,2112,2168,1629,ITI,ITI2,10,Umbria,Umbria,882015,55357,6.28,0.43
169,2021-02-08,UMB,637,203,434,88,549,ITI,ITI2,10,Umbria,Umbria,882015,55994,6.35,0.07
170,2021-05-26,UMB,9609,4545,5064,8379,1230,ITI,ITI2,10,Umbria,Umbria,882015,65603,7.44,1.09
171,2021-05-28,UMB,9480,4357,5123,7254,2226,ITI,ITI2,10,Umbria,Umbria,882015,75083,8.51,1.07
172,2021-04-13,UMB,7678,3399,4279,6009,1669,ITI,ITI2,10,Umbria,Umbria,882015,82761,9.38,0.87
173,2021-02-15,UMB,1368,692,676,1367,1,ITI,ITI2,10,Umbria,Umbria,882015,84129,9.54,0.16
174,2021-04-15,UMB,7628,3483,4145,5742,1886,ITI,ITI2,10,Umbria,Umbria,882015,91757,10.4,0.86
175,2021-02-17,UMB,1618,748,870,1267,351,ITI,ITI2,10,Umbria,Umbria,882015,93375,10.59,0.18
176,2021-04-23,UMB,6607,2786,3821,3488,3119,ITI,ITI2,10,Umbria,Umbria,882015,99982,11.34,0.75
177,2021-03-11,UMB,3565,1697,1868,2559,1006,ITI,ITI2,10,Umbria,Umbria,882015,103547,11.74,0.4
178,2021-01-06,UMB,846,325,521,846,0,ITI,ITI2,10,Umbria,Umbria,882015,104393,11.84,0.1
179,2021-01-20,UMB,613,222,391,613,0,ITI,ITI2,10,Umbria,Umbria,882015,105006,11.91,0.07
180,2021-01-11,UMB,1315,346,969,1315,0,ITI,ITI2,10,Umbria,Umbria,882015,106321,12.05,0.15
181,2021-05-05,UMB,7173,3284,3889,3877,3296,ITI,ITI2,10,Umbria,Umbria,882015,113494,12.87,0.81
182,2021-03-16,UMB,3538,1454,2084,1911,1627,ITI,ITI2,10,Umbria,Umbria,882015,117032,13.27,0.4
183,2021-01-25,UMB,648,323,325,5,643,ITI,ITI2,10,Umbria,Umbria,882015,117680,13.34,0.07
184,2021-02-25,UMB,1336,497,839,1284,52,ITI,ITI2,10,Umbria,Umbria,882015,119016,13.49,0.15
185,2021-04-16,UMB,8109,3746,4363,6272,1837,ITI,ITI2,10,Umbria,Umbria,882015,127125,14.41,0.92
186,2021-04-30,UMB,6232,2962,3270,2843,3389,ITI,ITI2,10,Umbria,Umbria,882015,133357,15.12,0.71
187,2021-01-13,UMB,450,139,311,450,0,ITI,ITI2,10,Umbria,Umbria,882015,133807,15.17,0.05
188,2021-03-04,UMB,4485,1853,2632,3657,828,ITI,ITI2,10,Umbria,Umbria,882015,138292,15.68,0.51
189,2021-05-11,UMB,6226,2827,3399,4025,2201,ITI,ITI2,10,Umbria,Umbria,882015,144518,16.38,0.71
190,2021-04-25,UMB,4364,1685,2679,4282,82,ITI,ITI2,10,Umbria,Umbria,882015,148882,16.88,0.49
191,2021-03-06,UMB,4267,1110,3157,4124,143,ITI,ITI2,10,Umbria,Umbria,882015,153149,17.36,0.48
192,2021-05-02,UMB,3787,1868,1919,1333,2454,ITI,ITI2,10,Umbria,Umbria,882015,156936,17.79,0.43
193,2021-03-13,UMB,1731,524,1207,1486,245,ITI,ITI2,10,Umbria,Umbria,882015,158667,17.99,0.2
194,2021-01-15,UMB,701,215,486,701,0,ITI,ITI2,10,Umbria,Umbria,882015,159368,18.07,0.08
195,2021-05-09,UMB,5765,2757,3008,5374,391,ITI,ITI2,10,Umbria,Umbria,882015,165133,18.72,0.65
196,2021-01-22,UMB,276,105,171,32,244,ITI,ITI2,10,Umbria,Umbria,882015,165409,18.75,0.03
197,2021-03-20,UMB,2298,833,1465,2273,25,ITI,ITI2,10,Umbria,Umbria,882015,167707,19.01,0.26
198,2021-01-30,UMB,1590,490,1100,44,1546,ITI,ITI2,10,Umbria,Umbria,882015,169297,19.19,0.18
199,2021-05-12,UMB,6467,3011,3456,4324,2143,ITI,ITI2,10,Umbria,Umbria,882015,175764,19.93,0.73
200,2021-03-30,UMB,3948,1705,2243,2416,1532,ITI,ITI2,10,Umbria,Umbria,882015,179712,20.38,0.45
201,2020-12-27,UMB,86,45,41,86,0,ITI,ITI2,10,Umbria,Umbria,882015,179798,20.38,0.01
202,2021-04-08,UMB,5832,2465,3367,4037,1795,ITI,ITI2,10,Umbria,Umbria,882015,185630,21.05,0.66
203,2021-05-07,UMB,10102,4694,5408,6903,3199,ITI,ITI2,10,Umbria,Umbria,882015,195732,22.19,1.15
204,2021-03-18,UMB,2942,1164,1778,1704,1238,ITI,ITI2,10,Umbria,Umbria,882015,198674,22.53,0.33
205,2021-04-20,UMB,5439,2356,3083,3492,1947,ITI,ITI2,10,Umbria,Umbria,882015,204113,23.14,0.62
206,2021-05-21,UMB,8919,3635,5284,4116,4803,ITI,ITI2,10,Umbria,Umbria,882015,213032,24.15,1.01
207,2021-05-04,UMB,5531,2543,2988,2410,3121,ITI,ITI2,10,Umbria,Umbria,882015,218563,24.78,0.63
208,2021-03-01,UMB,1503,774,729,1389,114,ITI,ITI2,10,Umbria,Umbria,882015,220066,24.95,0.17
209,2021-05-24,UMB,9015,4480,4535,8169,846,ITI,ITI2,10,Umbria,Umbria,882015,229081,25.97,1.02
210,2021-04-04,UMB,59,20,39,23,36,ITI,ITI2,10,Umbria,Umbria,882015,229140,25.98,0.01
211,2021-02-13,UMB,115,28,87,112,3,ITI,ITI2,10,Umbria,Umbria,882015,229255,25.99,0.01
212,2021-04-18,UMB,1530,680,850,600,930,ITI,ITI2,10,Umbria,Umbria,882015,230785,26.17,0.17
213,2021-02-27,UMB,1658,354,1304,1642,16,ITI,ITI2,10,Umbria,Umbria,882015,232443,26.35,0.19
214,2021-01-08,UMB,1190,345,845,1190,0,ITI,ITI2,10,Umbria,Umbria,882015,233633,26.49,0.13
215,2021-04-03,UMB,2111,716,1395,1058,1053,ITI,ITI2,10,Umbria,Umbria,882015,235744,26.73,0.24
216,2021-05-23,UMB,5068,1855,3213,652,4416,ITI,ITI2,10,Umbria,Umbria,882015,240812,27.3,0.57
217,2021-02-06,UMB,396,138,258,34,362,ITI,ITI2,10,Umbria,Umbria,882015,241208,27.35,0.04
218,2021-03-03,UMB,4438,1773,2665,3727,711,ITI,ITI2,10,Umbria,Umbria,882015,245646,27.85,0.5
219,2021-05-01,UMB,5374,2640,2734,2146,3228,ITI,ITI2,10,Umbria,Umbria,882015,251020,28.46,0.61
220,2021-01-28,UMB,1247,394,853,19,1228,ITI,ITI2,10,Umbria,Umbria,882015,252267,28.6,0.14
221,2021-05-10,UMB,5982,2799,3183,3830,2152,ITI,ITI2,10,Umbria,Umbria,882015,258249,29.28,0.68
222,2021-03-09,UMB,4051,1971,2080,2760,1291,ITI,ITI2,10,Umbria,Umbria,882015,262300,29.74,0.46
223,2021-06-02,UMB,3938,1893,2045,3898,40,ITI,ITI2,10,Umbria,Umbria,882015,266238,30.19,0.45
224,2021-02-20,UMB,282,100,182,258,24,ITI,ITI2,10,Umbria,Umbria,882015,266520,30.22,0.03
225,2021-02-03,UMB,725,174,551,67,658,ITI,ITI2,10,Umbria,Umbria,882015,267245,30.3,0.08
226,2021-05-16,UMB,5318,2535,2783,5266,52,ITI,ITI2,10,Umbria,Umbria,882015,272563,30.9,0.6
227,2021-03-15,UMB,4596,1930,2666,2828,1768,ITI,ITI2,10,Umbria,Umbria,882015,277159,31.42,0.52
228,2021-02-10,UMB,715,349,366,700,15,ITI,ITI2,10,Umbria,Umbria,882015,277874,31.5,0.08
229,2021-01-24,UMB,258,106,152,1,257,ITI,ITI2,10,Umbria,Umbria,882015,278132,31.53,0.03
230,2021-05-22,UMB,6909,2712,4197,2640,4269,ITI,ITI2,10,Umbria,Umbria,882015,285041,32.32,0.78
231,2021-04-19,UMB,5015,2216,2799,2966,2049,ITI,ITI2,10,Umbria,Umbria,882015,290056,32.89,0.57
232,2021-03-10,UMB,4013,1927,2086,2757,1256,ITI,ITI2,10,Umbria,Umbria,882015,294069,33.34,0.45
233,2021-05-13,UMB,5897,2656,3241,3824,2073,ITI,ITI2,10,Umbria,Umbria,882015,299966,34.01,0.67
234,2021-02-02,UMB,944,274,670,32,912,ITI,ITI2,10,Umbria,Umbria,882015,300910,34.12,0.11
235,2021-04-28,UMB,5346,2317,3029,2964,2382,ITI,ITI2,10,Umbria,Umbria,882015,306256,34.72,0.61
236,2021-05-20,UMB,9829,4585,5244,6192,3637,ITI,ITI2,10,Umbria,Umbria,882015,316085,35.84,1.11
237,2021-03-31,UMB,3903,1733,2170,2216,1687,ITI,ITI2,10,Umbria,Umbria,882015,319988,36.28,0.44
238,2021-02-16,UMB,1308,655,653,1299,9,ITI,ITI2,10,Umbria,Umbria,882015,321296,36.43,0.15
239,2021-05-27,UMB,9930,4828,5102,8647,1283,ITI,ITI2,10,Umbria,Umbria,882015,331226,37.55,1.13
240,2021-04-14,UMB,8150,3673,4477,6171,1979,ITI,ITI2,10,Umbria,Umbria,882015,339376,38.48,0.92
241,2021-06-03,UMB,8919,4421,4498,8684,235,ITI,ITI2,10,Umbria,Umbria,882015,348295,39.49,1.01
242,2021-04-07,UMB,5568,2289,3279,3562,2006,ITI,ITI2,10,Umbria,Umbria,882015,353863,40.12,0.63
243,2021-01-04,UMB,810,398,412,810,0,ITI,ITI2,10,Umbria,Umbria,882015,354673,40.21,0.09
244,2021-02-05,UMB,780,234,546,18,762,ITI,ITI2,10,Umbria,Umbria,882015,355453,40.3,0.09
245,2021-04-10,UMB,7467,3512,3955,7332,135,ITI,ITI2,10,Umbria,Umbria,882015,362920,41.15,0.85
246,2021-01-19,UMB,103,23,80,103,0,ITI,ITI2,10,Umbria,Umbria,882015,363023,41.16,0.01
247,2021-03-24,UMB,4073,1760,2313,2750,1323,ITI,ITI2,10,Umbria,Umbria,882015,367096,41.62,0.46
248,2021-01-02,UMB,304,111,193,304,0,ITI,ITI2,10,Umbria,Umbria,882015,367400,41.65,0.03
249,2021-03-07,UMB,845,180,665,838,7,ITI,ITI2,10,Umbria,Umbria,882015,368245,41.75,0.1
250,2021-01-03,UMB,270,112,158,270,0,ITI,ITI2,10,Umbria,Umbria,882015,368515,41.78,0.03
251,2021-04-22,UMB,5427,2230,3197,2766,2661,ITI,ITI2,10,Umbria,Umbria,882015,373942,42.4,0.62
252,2021-01-05,UMB,854,429,425,854,0,ITI,ITI2,10,Umbria,Umbria,882015,374796,42.49,0.1
253,2021-01-12,UMB,838,248,590,838,0,ITI,ITI2,10,Umbria,Umbria,882015,375634,42.59,0.1
254,2021-03-29,UMB,3844,1692,2152,2365,1479,ITI,ITI2,10,Umbria,Umbria,882015,379478,43.02,0.44
255,2021-01-31,UMB,1058,276,782,25,1033,ITI,ITI2,10,Umbria,Umbria,882015,380536,43.14,0.12
256,2021-05-18,UMB,7722,3342,4380,3884,3838,ITI,ITI2,10,Umbria,Umbria,882015,388258,44.02,0.88
257,2021-04-05,UMB,4250,1728,2522,2195,2055,ITI,ITI2,10,Umbria,Umbria,882015,392508,44.5,0.48
258,2021-05-06,UMB,9459,4312,5147,6149,3310,ITI,ITI2,10,Umbria,Umbria,882015,401967,45.57,1.07
259,2021-03-17,UMB,3331,1313,2018,1859,1472,ITI,ITI2,10,Umbria,Umbria,882015,405298,45.95,0.38
260,2021-01-26,UMB,816,390,426,18,798,ITI,ITI2,10,Umbria,Umbria,882015,406114,46.04,0.09
261,2021-04-21,UMB,5311,2309,3002,3085,2226,ITI,ITI2,10,Umbria,Umbria,882015,411425,46.65,0.6
262,2021-05-25,UMB,8753,4258,4495,7735,1018,ITI,ITI2,10,Umbria,Umbria,882015,420178,47.64,0.99
263,2021-03-22,UMB,3559,1654,1905,2313,1246,ITI,ITI2,10,Umbria,Umbria,882015,423737,48.04,0.4
264,2021-02-07,UMB,54,17,37,1,53,ITI,ITI2,10,Umbria,Umbria,882015,423791,48.05,0.01
265,2021-04-17,UMB,6665,3059,3606,5325,1340,ITI,ITI2,10,Umbria,Umbria,882015,430456,48.8,0.76
266,2021-04-24,UMB,4562,1963,2599,3384,1178,ITI,ITI2,10,Umbria,Umbria,882015,435018,49.32,0.52
267,2021-03-12,UMB,2653,1040,1613,2157,496,ITI,ITI2,10,Umbria,Umbria,882015,437671,49.62,0.3
268,2021-01-14,UMB,752,201,551,752,0,ITI,ITI2,10,Umbria,Umbria,882015,438423,49.71,0.09
269,2021-03-19,UMB,1743,565,1178,1087,656,ITI,ITI2,10,Umbria,Umbria,882015,440166,49.9,0.2
270,2021-03-14,UMB,66,48,18,66,0,ITI,ITI2,10,Umbria,Umbria,882015,440232,49.91,0.01
271,2021-03-21,UMB,665,330,335,665,0,ITI,ITI2,10,Umbria,Umbria,882015,440897,49.99,0.08
272,2021-05-17,UMB,6360,3058,3302,4187,2173,ITI,ITI2,10,Umbria,Umbria,882015,447257,50.71,0.72
273,2021-02-24,UMB,1520,565,955,1505,15,ITI,ITI2,10,Umbria,Umbria,882015,448777,50.88,0.17
274,2021-03-05,UMB,4592,1379,3213,3936,656,ITI,ITI2,10,Umbria,Umbria,882015,453369,51.4,0.52
275,2021-05-08,UMB,8102,3730,4372,4906,3196,ITI,ITI2,10,Umbria,Umbria,882015,461471,52.32,0.92
276,2021-05-03,UMB,5091,2271,2820,2204,2887,ITI,ITI2,10,Umbria,Umbria,882015,466562,52.9,0.58
277,2021-01-21,UMB,610,202,408,341,269,ITI,ITI2,10,Umbria,Umbria,882015,467172,52.97,0.07
278,2021-02-11,UMB,842,349,493,837,5,ITI,ITI2,10,Umbria,Umbria,882015,468014,53.06,0.1
279,2021-01-29,UMB,1232,348,884,79,1153,ITI,ITI2,10,Umbria,Umbria,882015,469246,53.2,0.14
280,2021-02-12,UMB,671,224,447,665,6,ITI,ITI2,10,Umbria,Umbria,882015,469917,53.28,0.08
281,2021-01-07,UMB,1300,387,913,1300,0,ITI,ITI2,10,Umbria,Umbria,882015,471217,53.43,0.15
282,2021-02-26,UMB,660,253,407,652,8,ITI,ITI2,10,Umbria,Umbria,882015,471877,53.5,0.07
283,2021-01-23,UMB,280,100,180,2,278,ITI,ITI2,10,Umbria,Umbria,882015,472157,53.53,0.03
284,2021-04-02,UMB,4308,1746,2562,3551,757,ITI,ITI2,10,Umbria,Umbria,882015,476465,54.02,0.49
285,2021-01-01,UMB,274,105,169,274,0,ITI,ITI2,10,Umbria,Umbria,882015,476739,54.05,0.03
286,2021-04-11,UMB,3102,1503,1599,3053,49,ITI,ITI2,10,Umbria,Umbria,882015,479841,54.4,0.35
287,2021-05-30,UMB,5971,2992,2979,5780,191,ITI,ITI2,10,Umbria,Umbria,882015,485812,55.08,0.68
288,2021-03-27,UMB,4253,1512,2741,3913,340,ITI,ITI2,10,Umbria,Umbria,882015,490065,55.56,0.48
289,2021-04-29,UMB,5209,2245,2964,2883,2326,ITI,ITI2,10,Umbria,Umbria,882015,495274,56.15,0.59
290,2021-01-17,UMB,54,17,37,54,0,ITI,ITI2,10,Umbria,Umbria,882015,495328,56.16,0.01
291,2021-04-12,UMB,7086,3076,4010,5369,1717,ITI,ITI2,10,Umbria,Umbria,882015,502414,56.96,0.8
292,2020-12-31,UMB,322,127,195,322,0,ITI,ITI2,10,Umbria,Umbria,882015,502736,57.0,0.04
293,2021-03-26,UMB,4571,1683,2888,4399,172,ITI,ITI2,10,Umbria,Umbria,882015,507307,57.52,0.52
294,2021-02-23,UMB,1693,658,1035,1651,42,ITI,ITI2,10,Umbria,Umbria,882015,509000,57.71,0.19
295,2021-03-02,UMB,3642,1346,2296,3638,4,ITI,ITI2,10,Umbria,Umbria,882015,512642,58.12,0.41
296,2021-01-09,UMB,1745,499,1246,1745,0,ITI,ITI2,10,Umbria,Umbria,882015,514387,58.32,0.2
297,2021-02-19,UMB,743,293,450,526,217,ITI,ITI2,10,Umbria,Umbria,882015,515130,58.4,0.08
298,2021-06-01,UMB,4364,2083,2281,4217,147,ITI,ITI2,10,Umbria,Umbria,882015,519494,58.9,0.49
299,2021-04-26,UMB,5375,2328,3047,3123,2252,ITI,ITI2,10,Umbria,Umbria,882015,524869,59.51,0.61
300,2021-05-15,UMB,4984,1875,3109,1819,3165,ITI,ITI2,10,Umbria,Umbria,882015,529853,60.07,0.57
301,2021-01-16,UMB,221,73,148,221,0,ITI,ITI2,10,Umbria,Umbria,882015,530074,60.1,0.03
302,2021-05-29,UMB,7825,3594,4231,6270,1555,ITI,ITI2,10,Umbria,Umbria,882015,537899,60.99,0.89
303,2021-04-09,UMB,6791,3162,3629,6572,219,ITI,ITI2,10,Umbria,Umbria,882015,544690,61.76,0.77
304,2021-02-04,UMB,733,226,507,25,708,ITI,ITI2,10,Umbria,Umbria,882015,545423,61.84,0.08
305,2021-04-29,ABR,12669,5850,6819,9574,3095,ITF,ITF1,13,Abruzzo,Abruzzo,1304970,12669,0.97,0.97
306,2021-01-17,ABR,188,59,129,181,7,ITF,ITF1,13,Abruzzo,Abruzzo,1304970,12857,0.99,0.01
307,2021-03-17,ABR,4539,1873,2666,2799,1740,ITF,ITF1,13,Abruzzo,Abruzzo,1304970,17396,1.33,0.35
308,2021-03-22,ABR,4281,1852,2429,2311,1970,ITF,ITF1,13,Abruzzo,Abruzzo,1304970,21677,1.66,0.33
309,2021-05-11,ABR,10737,5098,5639,5909,4828,ITF,ITF1,13,Abruzzo,Abruzzo,1304970,32414,2.48,0.82
310,2021-04-08,ABR,7390,3335,4055,5065,2325,ITF,ITF1,13,Abruzzo,Abruzzo,1304970,39804,3.05,0.57
311,2021-01-12,ABR,1804,666,1138,1804,0,ITF,ITF1,13,Abruzzo,Abruzzo,1304970,41608,3.19,0.14
312,2021-05-30,ABR,8564,4067,4497,5350,3214,ITF,ITF1,13,Abruzzo,Abruzzo,1304970,50172,3.84,0.66
313,2021-04-03,ABR,5086,2222,2864,3490,1596,ITF,ITF1,13,Abruzzo,Abruzzo,1304970,55258,4.23,0.39
314,2021-02-12,ABR,1228,567,661,1039,189,ITF,ITF1,13,Abruzzo,Abruzzo,1304970,56486,4.33,0.09
315,2021-04-10,ABR,8774,4057,4717,6266,2508,ITF,ITF1,13,Abruzzo,Abruzzo,1304970,65260,5.0,0.67
316,2021-05-23,ABR,9886,4701,5185,7190,2696,ITF,ITF1,13,Abruzzo,Abruzzo,1304970,75146,5.76,0.76
317,2021-01-07,ABR,1603,552,1051,1603,0,ITF,ITF1,13,Abruzzo,Abruzzo,1304970,76749,5.88,0.12
318,2021-04-17,ABR,7346,3398,3948,4293,3053,ITF,ITF1,13,Abruzzo,Abruzzo,1304970,84095,6.44,0.56
319,2021-02-19,ABR,3300,1551,1749,3200,100,ITF,ITF1,13,Abruzzo,Abruzzo,1304970,87395,6.7,0.25
320,2021-01-22,ABR,118,57,61,118,0,ITF,ITF1,13,Abruzzo,Abruzzo,1304970,87513,6.71,0.01
321,2021-03-27,ABR,6122,2621,3501,3637,2485,ITF,ITF1,13,Abruzzo,Abruzzo,1304970,93635,7.18,0.47
322,2021-03-12,ABR,6015,1986,4029,4433,1582,ITF,ITF1,13,Abruzzo,Abruzzo,1304970,99650,7.64,0.46
323,2021-02-24,ABR,3306,1441,1865,3130,176,ITF,ITF1,13,Abruzzo,Abruzzo,1304970,102956,7.89,0.25
324,2021-05-16,ABR,9580,4139,5441,5764,3816,ITF,ITF1,13,Abruzzo,Abruzzo,1304970,112536,8.62,0.73
325,2021-01-21,ABR,157,47,110,157,0,ITF,ITF1,13,Abruzzo,Abruzzo,1304970,112693,8.64,0.01
326,2021-02-07,ABR,778,307,471,201,577,ITF,ITF1,13,Abruzzo,Abruzzo,1304970,113471,8.7,0.06
327,2021-05-20,ABR,12546,5784,6762,7328,5218,ITF,ITF1,13,Abruzzo,Abruzzo,1304970,126017,9.66,0.96
328,2021-05-15,ABR,11422,5174,6248,6126,5296,ITF,ITF1,13,Abruzzo,Abruzzo,1304970,137439,10.53,0.88
329,2021-02-03,ABR,2062,718,1344,419,1643,ITF,ITF1,13,Abruzzo,Abruzzo,1304970,139501,10.69,0.16
330,2021-02-28,ABR,1708,511,1197,1706,2,ITF,ITF1,13,Abruzzo,Abruzzo,1304970,141209,10.82,0.13
331,2021-06-01,ABR,10924,4822,6102,6560,4364,ITF,ITF1,13,Abruzzo,Abruzzo,1304970,152133,11.66,0.84
332,2021-04-12,ABR,6225,2949,3276,5051,1174,ITF,ITF1,13,Abruzzo,Abruzzo,1304970,158358,12.13,0.48
333,2021-03-20,ABR,4788,2197,2591,2619,2169,ITF,ITF1,13,Abruzzo,Abruzzo,1304970,163146,12.5,0.37
334,2021-01-29,ABR,1387,449,938,74,1313,ITF,ITF1,13,Abruzzo,Abruzzo,1304970,164533,12.61,0.11
335,2021-03-19,ABR,5794,2584,3210,2774,3020,ITF,ITF1,13,Abruzzo,Abruzzo,1304970,170327,13.05,0.44
336,2021-05-08,ABR,10304,4877,5427,6469,3835,ITF,ITF1,13,Abruzzo,Abruzzo,1304970,180631,13.84,0.79
337,2021-01-14,ABR,530,189,341,530,0,ITF,ITF1,13,Abruzzo,Abruzzo,1304970,181161,13.88,0.04
338,2021-03-05,ABR,5344,1956,3388,4647,697,ITF,ITF1,13,Abruzzo,Abruzzo,1304970,186505,14.29,0.41
339,2021-04-24,ABR,8709,3970,4739,7179,1530,ITF,ITF1,13,Abruzzo,Abruzzo,1304970,195214,14.96,0.67
340,2021-02-10,ABR,947,312,635,503,444,ITF,ITF1,13,Abruzzo,Abruzzo,1304970,196161,15.03,0.07
341,2021-01-02,ABR,548,218,330,548,0,ITF,ITF1,13,Abruzzo,Abruzzo,1304970,196709,15.07,0.04
342,2021-04-26,ABR,8563,4066,4497,7349,1214,ITF,ITF1,13,Abruzzo,Abruzzo,1304970,205272,15.73,0.66
343,2021-04-19,ABR,6225,2856,3369,3854,2371,ITF,ITF1,13,Abruzzo,Abruzzo,1304970,211497,16.21,0.48
344,2021-02-21,ABR,1218,550,668,1217,1,ITF,ITF1,13,Abruzzo,Abruzzo,1304970,212715,16.3,0.09
345,2021-03-15,ABR,3624,1389,2235,1816,1808,ITF,ITF1,13,Abruzzo,Abruzzo,1304970,216339,16.58,0.28
346,2021-01-10,ABR,1139,409,730,1139,0,ITF,ITF1,13,Abruzzo,Abruzzo,1304970,217478,16.67,0.09
347,2021-01-15,ABR,379,149,230,379,0,ITF,ITF1,13,Abruzzo,Abruzzo,1304970,217857,16.69,0.03
348,2021-04-27,ABR,9085,4371,4714,6617,2468,ITF,ITF1,13,Abruzzo,Abruzzo,1304970,226942,17.39,0.7
349,2021-02-09,ABR,908,311,597,499,409,ITF,ITF1,13,Abruzzo,Abruzzo,1304970,227850,17.46,0.07
350,2021-03-24,ABR,6386,2785,3601,4134,2252,ITF,ITF1,13,Abruzzo,Abruzzo,1304970,234236,17.95,0.49
351,2021-03-03,ABR,4622,1879,2743,3716,906,ITF,ITF1,13,Abruzzo,Abruzzo,1304970,238858,18.3,0.35
352,2021-04-22,ABR,6662,3193,3469,4981,1681,ITF,ITF1,13,Abruzzo,Abruzzo,1304970,245520,18.81,0.51
353,2021-02-17,ABR,2071,948,1123,1789,282,ITF,ITF1,13,Abruzzo,Abruzzo,1304970,247591,18.97,0.16
354,2021-04-05,ABR,2693,1147,1546,1813,880,ITF,ITF1,13,Abruzzo,Abruzzo,1304970,250284,19.18,0.21
355,2021-01-31,ABR,1501,487,1014,286,1215,ITF,ITF1,13,Abruzzo,Abruzzo,1304970,251785,19.29,0.12
356,2020-12-27,ABR,37,19,18,37,0,ITF,ITF1,13,Abruzzo,Abruzzo,1304970,251822,19.3,0.0
357,2021-05-27,ABR,12922,5874,7048,8241,4681,ITF,ITF1,13,Abruzzo,Abruzzo,1304970,264744,20.29,0.99
358,2021-04-07,ABR,7137,3286,3851,4404,2733,ITF,ITF1,13,Abruzzo,Abruzzo,1304970,271881,20.83,0.55
359,2021-01-24,ABR,50,22,28,6,44,ITF,ITF1,13,Abruzzo,Abruzzo,1304970,271931,20.84,0.0
360,2021-05-04,ABR,10665,5004,5661,7048,3617,ITF,ITF1,13,Abruzzo,Abruzzo,1304970,282596,21.66,0.82
361,2021-03-08,ABR,5122,1666,3456,4150,972,ITF,ITF1,13,Abruzzo,Abruzzo,1304970,287718,22.05,0.39
362,2021-03-01,ABR,3479,1386,2093,2727,752,ITF,ITF1,13,Abruzzo,Abruzzo,1304970,291197,22.31,0.27
363,2021-02-02,ABR,1780,672,1108,222,1558,ITF,ITF1,13,Abruzzo,Abruzzo,1304970,292977,22.45,0.14
364,2021-03-31,ABR,6649,2880,3769,4581,2068,ITF,ITF1,13,Abruzzo,Abruzzo,1304970,299626,22.96,0.51
365,2021-05-13,ABR,11148,5041,6107,7187,3961,ITF,ITF1,13,Abruzzo,Abruzzo,1304970,310774,23.81,0.85
366,2021-03-10,ABR,4978,1646,3332,4023,955,ITF,ITF1,13,Abruzzo,Abruzzo,1304970,315752,24.2,0.38
367,2021-01-26,ABR,1543,567,976,30,1513,ITF,ITF1,13,Abruzzo,Abruzzo,1304970,317295,24.31,0.12
368,2021-05-06,ABR,13068,6125,6943,8009,5059,ITF,ITF1,13,Abruzzo,Abruzzo,1304970,330363,25.32,1.0
369,2021-02-11,ABR,816,262,554,773,43,ITF,ITF1,13,Abruzzo,Abruzzo,1304970,331179,25.38,0.06
370,2021-05-24,ABR,12171,5783,6388,8875,3296,ITF,ITF1,13,Abruzzo,Abruzzo,1304970,343350,26.31,0.93
371,2021-05-29,ABR,10179,4411,5768,4544,5635,ITF,ITF1,13,Abruzzo,Abruzzo,1304970,353529,27.09,0.78
372,2021-03-26,ABR,5306,2264,3042,3232,2074,ITF,ITF1,13,Abruzzo,Abruzzo,1304970,358835,27.5,0.41
373,2021-04-20,ABR,5589,2689,2900,4179,1410,ITF,ITF1,13,Abruzzo,Abruzzo,1304970,364424,27.93,0.43
374,2021-04-25,ABR,9066,4621,4445,8256,810,ITF,ITF1,13,Abruzzo,Abruzzo,1304970,373490,28.62,0.69
375,2021-01-08,ABR,1525,507,1018,1525,0,ITF,ITF1,13,Abruzzo,Abruzzo,1304970,375015,28.74,0.12
376,2021-02-05,ABR,1534,521,1013,788,746,ITF,ITF1,13,Abruzzo,Abruzzo,1304970,376549,28.85,0.12
377,2021-05-18,ABR,12116,5662,6454,7733,4383,ITF,ITF1,13,Abruzzo,Abruzzo,1304970,388665,29.78,0.93
378,2021-02-22,ABR,2642,1173,1469,2612,30,ITF,ITF1,13,Abruzzo,Abruzzo,1304970,391307,29.99,0.2
379,2021-01-19,ABR,111,55,56,91,20,ITF,ITF1,13,Abruzzo,Abruzzo,1304970,391418,29.99,0.01
380,2021-05-01,ABR,10745,5052,5693,5771,4974,ITF,ITF1,13,Abruzzo,Abruzzo,1304970,402163,30.82,0.82
381,2021-05-25,ABR,11213,5195,6018,8091,3122,ITF,ITF1,13,Abruzzo,Abruzzo,1304970,413376,31.68,0.86
382,2021-01-30,ABR,1510,567,943,69,1441,ITF,ITF1,13,Abruzzo,Abruzzo,1304970,414886,31.79,0.12
383,2021-03-21,ABR,2135,914,1221,844,1291,ITF,ITF1,13,Abruzzo,Abruzzo,1304970,417021,31.96,0.16
384,2021-05-28,ABR,13960,6276,7684,7612,6348,ITF,ITF1,13,Abruzzo,Abruzzo,1304970,430981,33.03,1.07
385,2021-01-13,ABR,1253,440,813,1253,0,ITF,ITF1,13,Abruzzo,Abruzzo,1304970,432234,33.12,0.1
386,2021-02-25,ABR,3042,1330,1712,2514,528,ITF,ITF1,13,Abruzzo,Abruzzo,1304970,435276,33.36,0.23
387,2021-02-06,ABR,1611,743,868,602,1009,ITF,ITF1,13,Abruzzo,Abruzzo,1304970,436887,33.48,0.12
388,2021-03-14,ABR,1883,731,1152,1216,667,ITF,ITF1,13,Abruzzo,Abruzzo,1304970,438770,33.62,0.14
389,2021-05-17,ABR,11026,5038,5988,6167,4859,ITF,ITF1,13,Abruzzo,Abruzzo,1304970,449796,34.47,0.84
390,2021-01-20,ABR,447,156,291,445,2,ITF,ITF1,13,Abruzzo,Abruzzo,1304970,450243,34.5,0.03
391,2021-05-02,ABR,10424,5088,5336,5214,5210,ITF,ITF1,13,Abruzzo,Abruzzo,1304970,460667,35.3,0.8
392,2021-04-30,ABR,12393,5805,6588,6703,5690,ITF,ITF1,13,Abruzzo,Abruzzo,1304970,473060,36.25,0.95
393,2021-02-26,ABR,3914,1670,2244,2946,968,ITF,ITF1,13,Abruzzo,Abruzzo,1304970,476974,36.55,0.3
394,2021-01-04,ABR,1401,575,826,1401,0,ITF,ITF1,13,Abruzzo,Abruzzo,1304970,478375,36.66,0.11
395,2021-04-16,ABR,7535,3488,4047,5618,1917,ITF,ITF1,13,Abruzzo,Abruzzo,1304970,485910,37.24,0.58
396,2021-05-03,ABR,11108,5240,5868,7259,3849,ITF,ITF1,13,Abruzzo,Abruzzo,1304970,497018,38.09,0.85
397,2021-06-02,ABR,9686,4693,4993,6876,2810,ITF,ITF1,13,Abruzzo,Abruzzo,1304970,506704,38.83,0.74
398,2021-03-13,ABR,4125,1421,2704,3082,1043,ITF,ITF1,13,Abruzzo,Abruzzo,1304970,510829,39.14,0.32
399,2021-04-09,ABR,8793,4140,4653,6254,2539,ITF,ITF1,13,Abruzzo,Abruzzo,1304970,519622,39.82,0.67
400,2021-04-04,ABR,1631,768,863,1502,129,ITF,ITF1,13,Abruzzo,Abruzzo,1304970,521253,39.94,0.12
401,2021-04-02,ABR,6686,3094,3592,5199,1487,ITF,ITF1,13,Abruzzo,Abruzzo,1304970,527939,40.46,0.51
402,2021-02-04,ABR,1679,615,1064,609,1070,ITF,ITF1,13,Abruzzo,Abruzzo,1304970,529618,40.58,0.13
403,2021-02-27,ABR,2811,1337,1474,2546,265,ITF,ITF1,13,Abruzzo,Abruzzo,1304970,532429,40.8,0.22
404,2021-03-06,ABR,4177,1358,2819,3607,570,ITF,ITF1,13,Abruzzo,Abruzzo,1304970,536606,41.12,0.32
405,2021-01-16,ABR,929,429,500,929,0,ITF,ITF1,13,Abruzzo,Abruzzo,1304970,537535,41.19,0.07
406,2021-01-09,ABR,1483,565,918,1483,0,ITF,ITF1,13,Abruzzo,Abruzzo,1304970,539018,41.31,0.11
407,2021-03-25,ABR,5686,2561,3125,3070,2616,ITF,ITF1,13,Abruzzo,Abruzzo,1304970,544704,41.74,0.44
408,2021-05-21,ABR,13004,6328,6676,8028,4976,ITF,ITF1,13,Abruzzo,Abruzzo,1304970,557708,42.74,1.0
409,2021-03-18,ABR,3896,1651,2245,2065,1831,ITF,ITF1,13,Abruzzo,Abruzzo,1304970,561604,43.04,0.3
410,2021-05-07,ABR,12193,5702,6491,7764,4429,ITF,ITF1,13,Abruzzo,Abruzzo,1304970,573797,43.97,0.93
411,2021-01-28,ABR,1433,495,938,12,1421,ITF,ITF1,13,Abruzzo,Abruzzo,1304970,575230,44.08,0.11
412,2021-05-09,ABR,9152,4089,5063,4282,4870,ITF,ITF1,13,Abruzzo,Abruzzo,1304970,584382,44.78,0.7
413,2021-03-07,ABR,2523,630,1893,2523,0,ITF,ITF1,13,Abruzzo,Abruzzo,1304970,586905,44.97,0.19
414,2021-01-27,ABR,1364,515,849,39,1325,ITF,ITF1,13,Abruzzo,Abruzzo,1304970,588269,45.08,0.1
415,2021-05-14,ABR,10603,5076,5527,5444,5159,ITF,ITF1,13,Abruzzo,Abruzzo,1304970,598872,45.89,0.81
416,2021-04-01,ABR,5522,2442,3080,3435,2087,ITF,ITF1,13,Abruzzo,Abruzzo,1304970,604394,46.31,0.42
417,2021-02-18,ABR,2288,933,1355,2158,130,ITF,ITF1,13,Abruzzo,Abruzzo,1304970,606682,46.49,0.18
418,2021-05-31,ABR,11219,5044,6175,6908,4311,ITF,ITF1,13,Abruzzo,Abruzzo,1304970,617901,47.35,0.86
419,2021-05-22,ABR,13066,6349,6717,8165,4901,ITF,ITF1,13,Abruzzo,Abruzzo,1304970,630967,48.35,1.0
420,2021-04-23,ABR,7369,3382,3987,5067,2302,ITF,ITF1,13,Abruzzo,Abruzzo,1304970,638336,48.92,0.56
421,2021-05-10,ABR,10112,4785,5327,5460,4652,ITF,ITF1,13,Abruzzo,Abruzzo,1304970,648448,49.69,0.77
422,2021-02-13,ABR,850,383,467,438,412,ITF,ITF1,13,Abruzzo,Abruzzo,1304970,649298,49.76,0.07
423,2021-01-18,ABR,122,48,74,46,76,ITF,ITF1,13,Abruzzo,Abruzzo,1304970,649420,49.77,0.01
424,2021-05-12,ABR,9616,4586,5030,6046,3570,ITF,ITF1,13,Abruzzo,Abruzzo,1304970,659036,50.5,0.74
425,2021-03-16,ABR,3484,1452,2032,1830,1654,ITF,ITF1,13,Abruzzo,Abruzzo,1304970,662520,50.77,0.27
426,2021-05-05,ABR,11582,5546,6036,6451,5131,ITF,ITF1,13,Abruzzo,Abruzzo,1304970,674102,51.66,0.89
427,2021-03-09,ABR,5168,1795,3373,4229,939,ITF,ITF1,13,Abruzzo,Abruzzo,1304970,679270,52.05,0.4
428,2021-04-28,ABR,9510,4585,4925,7486,2024,ITF,ITF1,13,Abruzzo,Abruzzo,1304970,688780,52.78,0.73
429,2021-03-02,ABR,3963,1676,2287,3279,684,ITF,ITF1,13,Abruzzo,Abruzzo,1304970,692743,53.08,0.3
430,2021-01-11,ABR,1551,557,994,1551,0,ITF,ITF1,13,Abruzzo,Abruzzo,1304970,694294,53.2,0.12
431,2021-02-16,ABR,1918,842,1076,1906,12,ITF,ITF1,13,Abruzzo,Abruzzo,1304970,696212,53.35,0.15
432,2021-04-21,ABR,6384,3100,3284,4710,1674,ITF,ITF1,13,Abruzzo,Abruzzo,1304970,702596,53.84,0.49
433,2021-04-06,ABR,7681,3581,4100,5362,2319,ITF,ITF1,13,Abruzzo,Abruzzo,1304970,710277,54.43,0.59
434,2021-02-15,ABR,1794,831,963,1752,42,ITF,ITF1,13,Abruzzo,Abruzzo,1304970,712071,54.57,0.14
435,2021-02-20,ABR,4777,1842,2935,4701,76,ITF,ITF1,13,Abruzzo,Abruzzo,1304970,716848,54.93,0.37
436,2021-03-04,ABR,5935,2359,3576,5013,922,ITF,ITF1,13,Abruzzo,Abruzzo,1304970,722783,55.39,0.45
437,2021-01-05,ABR,1615,604,1011,1615,0,ITF,ITF1,13,Abruzzo,Abruzzo,1304970,724398,55.51,0.12
438,2021-01-03,ABR,471,185,286,471,0,ITF,ITF1,13,Abruzzo,Abruzzo,1304970,724869,55.55,0.04
439,2021-04-15,ABR,7818,3678,4140,5978,1840,ITF,ITF1,13,Abruzzo,Abruzzo,1304970,732687,56.15,0.6
440,2021-06-03,ABR,12791,6067,6724,9105,3686,ITF,ITF1,13,Abruzzo,Abruzzo,1304970,745478,57.13,0.98
441,2021-03-28,ABR,2415,1017,1398,2044,371,ITF,ITF1,13,Abruzzo,Abruzzo,1304970,747893,57.31,0.19
442,2021-01-23,ABR,263,114,149,57,206,ITF,ITF1,13,Abruzzo,Abruzzo,1304970,748156,57.33,0.02
443,2021-04-14,ABR,6504,2898,3606,4424,2080,ITF,ITF1,13,Abruzzo,Abruzzo,1304970,754660,57.83,0.5
444,2021-03-11,ABR,5475,2200,3275,4336,1139,ITF,ITF1,13,Abruzzo,Abruzzo,1304970,760135,58.25,0.42
445,2021-03-30,ABR,5056,2197,2859,3232,1824,ITF,ITF1,13,Abruzzo,Abruzzo,1304970,765191,58.64,0.39
446,2021-04-11,ABR,5331,2606,2725,4847,484,ITF,ITF1,13,Abruzzo,Abruzzo,1304970,770522,59.05,0.41
447,2021-04-18,ABR,5811,2726,3085,4869,942,ITF,ITF1,13,Abruzzo,Abruzzo,1304970,776333,59.49,0.45
448,2021-03-29,ABR,5624,2524,3100,2985,2639,ITF,ITF1,13,Abruzzo,Abruzzo,1304970,781957,59.92,0.43
449,2021-02-23,ABR,2782,1275,1507,2771,11,ITF,ITF1,13,Abruzzo,Abruzzo,1304970,784739,60.13,0.21
450,2021-02-08,ABR,1197,396,801,487,710,ITF,ITF1,13,Abruzzo,Abruzzo,1304970,785936,60.23,0.09
451,2021-04-13,ABR,5879,2752,3127,4679,1200,ITF,ITF1,13,Abruzzo,Abruzzo,1304970,791815,60.68,0.45
452,2021-05-19,ABR,10693,5109,5584,7654,3039,ITF,ITF1,13,Abruzzo,Abruzzo,1304970,802508,61.5,0.82
453,2021-02-01,ABR,1632,573,1059,271,1361,ITF,ITF1,13,Abruzzo,Abruzzo,1304970,804140,61.62,0.13
454,2021-03-23,ABR,4783,2144,2639,2217,2566,ITF,ITF1,13,Abruzzo,Abruzzo,1304970,808923,61.99,0.37
455,2021-01-25,ABR,1603,632,971,19,1584,ITF,ITF1,13,Abruzzo,Abruzzo,1304970,810526,62.11,0.12
456,2021-01-06,ABR,1830,664,1166,1830,0,ITF,ITF1,13,Abruzzo,Abruzzo,1304970,812356,62.25,0.14
457,2021-05-26,ABR,13306,5904,7402,8380,4926,ITF,ITF1,13,Abruzzo,Abruzzo,1304970,825662,63.27,1.02
458,2021-01-30,SIC,7836,3569,4267,171,7665,ITG,ITG1,19,Sicilia,Sicilia,4999891,7836,0.16,0.16
459,2021-04-04,SIC,6825,3325,3500,5533,1292,ITG,ITG1,19,Sicilia,Sicilia,4999891,14661,0.29,0.14
460,2021-06-02,SIC,34872,16087,18785,27072,7800,ITG,ITG1,19,Sicilia,Sicilia,4999891,49533,0.99,0.7
461,2020-12-27,SIC,92,55,37,92,0,ITG,ITG1,19,Sicilia,Sicilia,4999891,49625,0.99,0.0
462,2021-03-01,SIC,12959,6119,6840,11304,1655,ITG,ITG1,19,Sicilia,Sicilia,4999891,62584,1.25,0.26
463,2021-03-14,SIC,8779,3930,4849,4943,3836,ITG,ITG1,19,Sicilia,Sicilia,4999891,71363,1.43,0.18
464,2021-02-11,SIC,5321,2097,3224,4859,462,ITG,ITG1,19,Sicilia,Sicilia,4999891,76684,1.53,0.11
465,2021-04-16,SIC,28740,14421,14319,20364,8376,ITG,ITG1,19,Sicilia,Sicilia,4999891,105424,2.11,0.57
466,2021-02-25,SIC,10118,5245,4873,8952,1166,ITG,ITG1,19,Sicilia,Sicilia,4999891,115542,2.31,0.2
467,2021-05-21,SIC,45865,21590,24275,24394,21471,ITG,ITG1,19,Sicilia,Sicilia,4999891,161407,3.23,0.92
468,2021-03-02,SIC,14867,6359,8508,12058,2809,ITG,ITG1,19,Sicilia,Sicilia,4999891,176274,3.53,0.3
469,2021-01-04,SIC,8408,4195,4213,8408,0,ITG,ITG1,19,Sicilia,Sicilia,4999891,184682,3.69,0.17
470,2021-04-28,SIC,29353,13767,15586,20270,9083,ITG,ITG1,19,Sicilia,Sicilia,4999891,214035,4.28,0.59
471,2021-02-23,SIC,8909,4670,4239,8446,463,ITG,ITG1,19,Sicilia,Sicilia,4999891,222944,4.46,0.18
472,2021-03-09,SIC,13145,5586,7559,10772,2373,ITG,ITG1,19,Sicilia,Sicilia,4999891,236089,4.72,0.26
473,2021-01-11,SIC,5917,2597,3320,5917,0,ITG,ITG1,19,Sicilia,Sicilia,4999891,242006,4.84,0.12
474,2021-01-18,SIC,1650,670,980,1495,155,ITG,ITG1,19,Sicilia,Sicilia,4999891,243656,4.87,0.03
475,2020-12-28,SIC,211,126,85,211,0,ITG,ITG1,19,Sicilia,Sicilia,4999891,243867,4.88,0.0
476,2021-03-23,SIC,21066,10077,10989,15412,5654,ITG,ITG1,19,Sicilia,Sicilia,4999891,264933,5.3,0.42
477,2021-03-25,SIC,20635,9556,11079,15096,5539,ITG,ITG1,19,Sicilia,Sicilia,4999891,285568,5.71,0.41
478,2021-05-28,SIC,51151,22815,28336,24775,26376,ITG,ITG1,19,Sicilia,Sicilia,4999891,336719,6.73,1.02
479,2021-05-12,SIC,36859,17351,19508,21914,14945,ITG,ITG1,19,Sicilia,Sicilia,4999891,373578,7.47,0.74
480,2021-02-20,SIC,7242,3726,3516,7000,242,ITG,ITG1,19,Sicilia,Sicilia,4999891,380820,7.62,0.14
481,2021-04-25,SIC,21354,10185,11169,16376,4978,ITG,ITG1,19,Sicilia,Sicilia,4999891,402174,8.04,0.43
482,2021-04-08,SIC,16795,8287,8508,8312,8483,ITG,ITG1,19,Sicilia,Sicilia,4999891,418969,8.38,0.34
483,2021-02-03,SIC,6094,2853,3241,752,5342,ITG,ITG1,19,Sicilia,Sicilia,4999891,425063,8.5,0.12
484,2021-05-26,SIC,44244,20626,23618,23790,20454,ITG,ITG1,19,Sicilia,Sicilia,4999891,469307,9.39,0.88
485,2021-04-13,SIC,19903,9684,10219,11068,8835,ITG,ITG1,19,Sicilia,Sicilia,4999891,489210,9.78,0.4
486,2021-04-20,SIC,19281,9087,10194,13942,5339,ITG,ITG1,19,Sicilia,Sicilia,4999891,508491,10.17,0.39
487,2021-04-30,SIC,35229,16462,18767,24024,11205,ITG,ITG1,19,Sicilia,Sicilia,4999891,543720,10.87,0.7
488,2021-03-04,SIC,15181,6544,8637,10983,4198,ITG,ITG1,19,Sicilia,Sicilia,4999891,558901,11.18,0.3
489,2021-05-07,SIC,36664,17313,19351,25029,11635,ITG,ITG1,19,Sicilia,Sicilia,4999891,595565,11.91,0.73
490,2021-01-13,SIC,5269,2494,2775,5269,0,ITG,ITG1,19,Sicilia,Sicilia,4999891,600834,12.02,0.11
491,2021-03-18,SIC,15602,7783,7819,9864,5738,ITG,ITG1,19,Sicilia,Sicilia,4999891,616436,12.33,0.31
492,2021-05-05,SIC,26314,12182,14132,16710,9604,ITG,ITG1,19,Sicilia,Sicilia,4999891,642750,12.86,0.53
493,2021-01-25,SIC,7512,3695,3817,305,7207,ITG,ITG1,19,Sicilia,Sicilia,4999891,650262,13.01,0.15
494,2021-05-19,SIC,42692,20585,22107,28388,14304,ITG,ITG1,19,Sicilia,Sicilia,4999891,692954,13.86,0.85
495,2021-03-16,SIC,9780,4363,5417,3662,6118,ITG,ITG1,19,Sicilia,Sicilia,4999891,702734,14.05,0.2
496,2021-02-08,SIC,4086,1760,2326,2129,1957,ITG,ITG1,19,Sicilia,Sicilia,4999891,706820,14.14,0.08
497,2021-03-30,SIC,14596,6759,7837,9771,4825,ITG,ITG1,19,Sicilia,Sicilia,4999891,721416,14.43,0.29
498,2021-04-23,SIC,28890,13846,15044,22943,5947,ITG,ITG1,19,Sicilia,Sicilia,4999891,750306,15.01,0.58
499,2021-03-11,SIC,15447,6518,8929,12882,2565,ITG,ITG1,19,Sicilia,Sicilia,4999891,765753,15.32,0.31
500,2021-01-20,SIC,837,427,410,574,263,ITG,ITG1,19,Sicilia,Sicilia,4999891,766590,15.33,0.02
501,2021-01-27,SIC,7527,3836,3691,182,7345,ITG,ITG1,19,Sicilia,Sicilia,4999891,774117,15.48,0.15
502,2021-05-02,SIC,24654,11444,13210,18053,6601,ITG,ITG1,19,Sicilia,Sicilia,4999891,798771,15.98,0.49
503,2021-05-16,SIC,33110,16124,16986,21784,11326,ITG,ITG1,19,Sicilia,Sicilia,4999891,831881,16.64,0.66
504,2021-03-20,SIC,18811,9029,9782,13486,5325,ITG,ITG1,19,Sicilia,Sicilia,4999891,850692,17.01,0.38
505,2021-05-09,SIC,28138,13162,14976,19867,8271,ITG,ITG1,19,Sicilia,Sicilia,4999891,878830,17.58,0.56
506,2021-03-28,SIC,10910,5132,5778,6899,4011,ITG,ITG1,19,Sicilia,Sicilia,4999891,889740,17.8,0.22
507,2021-04-06,SIC,17821,8542,9279,13495,4326,ITG,ITG1,19,Sicilia,Sicilia,4999891,907561,18.15,0.36
508,2021-02-22,SIC,8012,4146,3866,7521,491,ITG,ITG1,19,Sicilia,Sicilia,4999891,915573,18.31,0.16
509,2021-01-23,SIC,4335,2236,2099,216,4119,ITG,ITG1,19,Sicilia,Sicilia,4999891,919908,18.4,0.09
510,2021-04-02,SIC,14009,6595,7414,9222,4787,ITG,ITG1,19,Sicilia,Sicilia,4999891,933917,18.68,0.28
511,2021-01-06,SIC,6486,3412,3074,6486,0,ITG,ITG1,19,Sicilia,Sicilia,4999891,940403,18.81,0.13
512,2021-02-10,SIC,4420,1813,2607,3999,421,ITG,ITG1,19,Sicilia,Sicilia,4999891,944823,18.9,0.09
513,2021-04-01,SIC,14403,6676,7727,9689,4714,ITG,ITG1,19,Sicilia,Sicilia,4999891,959226,19.18,0.29
514,2021-02-27,SIC,12426,5557,6869,11222,1204,ITG,ITG1,19,Sicilia,Sicilia,4999891,971652,19.43,0.25
515,2021-04-18,SIC,19743,9872,9871,15377,4366,ITG,ITG1,19,Sicilia,Sicilia,4999891,991395,19.83,0.39
516,2021-01-22,SIC,1254,634,620,243,1011,ITG,ITG1,19,Sicilia,Sicilia,4999891,992649,19.85,0.03
517,2021-01-08,SIC,8335,3868,4467,8335,0,ITG,ITG1,19,Sicilia,Sicilia,4999891,1000984,20.02,0.17
518,2021-05-24,SIC,35601,17139,18462,15709,19892,ITG,ITG1,19,Sicilia,Sicilia,4999891,1036585,20.73,0.71
519,2021-05-17,SIC,32097,15459,16638,19346,12751,ITG,ITG1,19,Sicilia,Sicilia,4999891,1068682,21.37,0.64
520,2021-03-21,SIC,15206,7330,7876,11236,3970,ITG,ITG1,19,Sicilia,Sicilia,4999891,1083888,21.68,0.3
521,2021-02-04,SIC,6932,3187,3745,1455,5477,ITG,ITG1,19,Sicilia,Sicilia,4999891,1090820,21.82,0.14
522,2021-02-13,SIC,3097,1164,1933,2841,256,ITG,ITG1,19,Sicilia,Sicilia,4999891,1093917,21.88,0.06
523,2021-02-06,SIC,5015,2189,2826,1463,3552,ITG,ITG1,19,Sicilia,Sicilia,4999891,1098932,21.98,0.1
524,2021-01-01,SIC,816,437,379,816,0,ITG,ITG1,19,Sicilia,Sicilia,4999891,1099748,22.0,0.02
525,2021-02-24,SIC,9561,4850,4711,8971,590,ITG,ITG1,19,Sicilia,Sicilia,4999891,1109309,22.19,0.19
526,2021-04-29,SIC,31689,14766,16923,22329,9360,ITG,ITG1,19,Sicilia,Sicilia,4999891,1140998,22.82,0.63
527,2021-05-08,SIC,35762,17078,18684,25435,10327,ITG,ITG1,19,Sicilia,Sicilia,4999891,1176760,23.54,0.72
528,2021-01-26,SIC,9483,4669,4814,259,9224,ITG,ITG1,19,Sicilia,Sicilia,4999891,1186243,23.73,0.19
529,2021-01-21,SIC,1394,682,712,500,894,ITG,ITG1,19,Sicilia,Sicilia,4999891,1187637,23.75,0.03
530,2021-03-26,SIC,18036,8377,9659,12505,5531,ITG,ITG1,19,Sicilia,Sicilia,4999891,1205673,24.11,0.36
531,2021-02-18,SIC,5471,3152,2319,5044,427,ITG,ITG1,19,Sicilia,Sicilia,4999891,1211144,24.22,0.11
532,2021-05-31,SIC,37507,16708,20799,21383,16124,ITG,ITG1,19,Sicilia,Sicilia,4999891,1248651,24.97,0.75
533,2021-05-14,SIC,52242,24467,27775,36396,15846,ITG,ITG1,19,Sicilia,Sicilia,4999891,1300893,26.02,1.04
534,2021-02-01,SIC,6069,2682,3387,296,5773,ITG,ITG1,19,Sicilia,Sicilia,4999891,1306962,26.14,0.12
535,2021-04-27,SIC,26395,12717,13678,15589,10806,ITG,ITG1,19,Sicilia,Sicilia,4999891,1333357,26.67,0.53
536,2021-05-04,SIC,26854,12474,14380,17634,9220,ITG,ITG1,19,Sicilia,Sicilia,4999891,1360211,27.2,0.54
537,2021-03-08,SIC,13534,5824,7710,10728,2806,ITG,ITG1,19,Sicilia,Sicilia,4999891,1373745,27.48,0.27
538,2021-05-11,SIC,32429,15425,17004,19887,12542,ITG,ITG1,19,Sicilia,Sicilia,4999891,1406174,28.12,0.65
539,2021-02-17,SIC,5415,3278,2137,4747,668,ITG,ITG1,19,Sicilia,Sicilia,4999891,1411589,28.23,0.11
540,2021-05-13,SIC,47386,22235,25151,30785,16601,ITG,ITG1,19,Sicilia,Sicilia,4999891,1458975,29.18,0.95
541,2021-01-31,SIC,4109,1959,2150,113,3996,ITG,ITG1,19,Sicilia,Sicilia,4999891,1463084,29.26,0.08
542,2021-02-02,SIC,5534,2620,2914,629,4905,ITG,ITG1,19,Sicilia,Sicilia,4999891,1468618,29.37,0.11
543,2021-05-27,SIC,47158,21529,25629,24888,22270,ITG,ITG1,19,Sicilia,Sicilia,4999891,1515776,30.32,0.94
544,2021-04-14,SIC,20289,9798,10491,11505,8784,ITG,ITG1,19,Sicilia,Sicilia,4999891,1536065,30.72,0.41
545,2021-01-17,SIC,1302,589,713,1245,57,ITG,ITG1,19,Sicilia,Sicilia,4999891,1537367,30.75,0.03
546,2021-03-22,SIC,16818,7916,8902,11275,5543,ITG,ITG1,19,Sicilia,Sicilia,4999891,1554185,31.08,0.34
547,2021-03-05,SIC,15873,6835,9038,11556,4317,ITG,ITG1,19,Sicilia,Sicilia,4999891,1570058,31.4,0.32
548,2020-12-31,SIC,880,470,410,880,0,ITG,ITG1,19,Sicilia,Sicilia,4999891,1570938,31.42,0.02
549,2021-02-16,SIC,4370,2282,2088,3905,465,ITG,ITG1,19,Sicilia,Sicilia,4999891,1575308,31.51,0.09
550,2021-02-15,SIC,3926,1817,2109,3361,565,ITG,ITG1,19,Sicilia,Sicilia,4999891,1579234,31.59,0.08
551,2021-01-03,SIC,4705,2461,2244,4705,0,ITG,ITG1,19,Sicilia,Sicilia,4999891,1583939,31.68,0.09
552,2021-01-10,SIC,3622,1616,2006,3622,0,ITG,ITG1,19,Sicilia,Sicilia,4999891,1587561,31.75,0.07
553,2021-04-15,SIC,21367,10387,10980,11810,9557,ITG,ITG1,19,Sicilia,Sicilia,4999891,1608928,32.18,0.43
554,2021-04-22,SIC,27157,12817,14340,20567,6590,ITG,ITG1,19,Sicilia,Sicilia,4999891,1636085,32.72,0.54
555,2021-01-05,SIC,10540,5163,5377,10540,0,ITG,ITG1,19,Sicilia,Sicilia,4999891,1646625,32.93,0.21
556,2021-03-10,SIC,13932,5954,7978,11547,2385,ITG,ITG1,19,Sicilia,Sicilia,4999891,1660557,33.21,0.28
557,2021-01-12,SIC,4548,2237,2311,4548,0,ITG,ITG1,19,Sicilia,Sicilia,4999891,1665105,33.3,0.09
558,2021-02-07,SIC,2338,991,1347,674,1664,ITG,ITG1,19,Sicilia,Sicilia,4999891,1667443,33.35,0.05
559,2021-05-25,SIC,33171,15009,18162,14002,19169,ITG,ITG1,19,Sicilia,Sicilia,4999891,1700614,34.01,0.66
560,2021-04-12,SIC,18954,9203,9751,11614,7340,ITG,ITG1,19,Sicilia,Sicilia,4999891,1719568,34.39,0.38
561,2021-02-21,SIC,5168,2501,2667,5062,106,ITG,ITG1,19,Sicilia,Sicilia,4999891,1724736,34.5,0.1
562,2021-03-17,SIC,15170,7462,7708,9258,5912,ITG,ITG1,19,Sicilia,Sicilia,4999891,1739906,34.8,0.3
563,2021-05-06,SIC,29237,13886,15351,18498,10739,ITG,ITG1,19,Sicilia,Sicilia,4999891,1769143,35.38,0.58
564,2021-03-31,SIC,14605,6750,7855,9577,5028,ITG,ITG1,19,Sicilia,Sicilia,4999891,1783748,35.68,0.29
565,2021-05-20,SIC,43541,20784,22757,27662,15879,ITG,ITG1,19,Sicilia,Sicilia,4999891,1827289,36.55,0.87
566,2021-02-09,SIC,4411,1823,2588,3356,1055,ITG,ITG1,19,Sicilia,Sicilia,4999891,1831700,36.63,0.09
567,2021-05-18,SIC,36148,17310,18838,23567,12581,ITG,ITG1,19,Sicilia,Sicilia,4999891,1867848,37.36,0.72
568,2021-03-29,SIC,15017,7037,7980,10501,4516,ITG,ITG1,19,Sicilia,Sicilia,4999891,1882865,37.66,0.3
569,2021-06-01,SIC,38184,17238,20946,24526,13658,ITG,ITG1,19,Sicilia,Sicilia,4999891,1921049,38.42,0.76
570,2021-04-05,SIC,8025,3959,4066,6585,1440,ITG,ITG1,19,Sicilia,Sicilia,4999891,1929074,38.58,0.16
571,2021-02-14,SIC,1058,403,655,918,140,ITG,ITG1,19,Sicilia,Sicilia,4999891,1930132,38.6,0.02
572,2021-01-02,SIC,4885,2541,2344,4885,0,ITG,ITG1,19,Sicilia,Sicilia,4999891,1935017,38.7,0.1
573,2021-03-12,SIC,13103,5605,7498,10886,2217,ITG,ITG1,19,Sicilia,Sicilia,4999891,1948120,38.96,0.26
574,2021-05-15,SIC,57074,26664,30410,41704,15370,ITG,ITG1,19,Sicilia,Sicilia,4999891,2005194,40.1,1.14
575,2021-03-19,SIC,16516,8113,8403,10785,5731,ITG,ITG1,19,Sicilia,Sicilia,4999891,2021710,40.44,0.33
576,2021-01-19,SIC,1304,541,763,1096,208,ITG,ITG1,19,Sicilia,Sicilia,4999891,2023014,40.46,0.03
577,2021-03-03,SIC,14663,6522,8141,11575,3088,ITG,ITG1,19,Sicilia,Sicilia,4999891,2037677,40.75,0.29
578,2021-05-01,SIC,24474,11326,13148,19316,5158,ITG,ITG1,19,Sicilia,Sicilia,4999891,2062151,41.24,0.49
579,2021-05-10,SIC,28317,13596,14721,16189,12128,ITG,ITG1,19,Sicilia,Sicilia,4999891,2090468,41.81,0.57
580,2021-01-28,SIC,9313,4394,4919,398,8915,ITG,ITG1,19,Sicilia,Sicilia,4999891,2099781,42.0,0.19
581,2021-03-15,SIC,10819,4718,6101,5754,5065,ITG,ITG1,19,Sicilia,Sicilia,4999891,2110600,42.21,0.22
582,2021-01-24,SIC,4307,2251,2056,140,4167,ITG,ITG1,19,Sicilia,Sicilia,4999891,2114907,42.3,0.09
583,2021-04-19,SIC,18477,8737,9740,12770,5707,ITG,ITG1,19,Sicilia,Sicilia,4999891,2133384,42.67,0.37
584,2021-05-22,SIC,48110,22846,25264,28673,19437,ITG,ITG1,19,Sicilia,Sicilia,4999891,2181494,43.63,0.96
585,2021-02-05,SIC,7103,3158,3945,2128,4975,ITG,ITG1,19,Sicilia,Sicilia,4999891,2188597,43.77,0.14
586,2021-04-03,SIC,16350,7780,8570,13514,2836,ITG,ITG1,19,Sicilia,Sicilia,4999891,2204947,44.1,0.33
587,2021-03-27,SIC,15750,7437,8313,10837,4913,ITG,ITG1,19,Sicilia,Sicilia,4999891,2220697,44.41,0.32
588,2021-01-29,SIC,9355,4318,5037,425,8930,ITG,ITG1,19,Sicilia,Sicilia,4999891,2230052,44.6,0.19
589,2021-05-23,SIC,34146,16616,17530,20120,14026,ITG,ITG1,19,Sicilia,Sicilia,4999891,2264198,45.28,0.68
590,2021-02-12,SIC,4674,1847,2827,4406,268,ITG,ITG1,19,Sicilia,Sicilia,4999891,2268872,45.38,0.09
591,2021-03-13,SIC,12421,5480,6941,7838,4583,ITG,ITG1,19,Sicilia,Sicilia,4999891,2281293,45.63,0.25
592,2021-04-17,SIC,26189,13226,12963,19037,7152,ITG,ITG1,19,Sicilia,Sicilia,4999891,2307482,46.15,0.52
593,2021-02-26,SIC,12207,5966,6241,10523,1684,ITG,ITG1,19,Sicilia,Sicilia,4999891,2319689,46.39,0.24
594,2021-01-07,SIC,9190,4250,4940,9190,0,ITG,ITG1,19,Sicilia,Sicilia,4999891,2328879,46.58,0.18
595,2021-02-28,SIC,7165,3063,4102,6535,630,ITG,ITG1,19,Sicilia,Sicilia,4999891,2336044,46.72,0.14
596,2021-01-09,SIC,7328,3425,3903,7328,0,ITG,ITG1,19,Sicilia,Sicilia,4999891,2343372,46.87,0.15
597,2021-05-03,SIC,23477,10827,12650,13593,9884,ITG,ITG1,19,Sicilia,Sicilia,4999891,2366849,47.34,0.47
598,2021-01-16,SIC,2782,1198,1584,2782,0,ITG,ITG1,19,Sicilia,Sicilia,4999891,2369631,47.39,0.06
599,2021-04-09,SIC,20547,10005,10542,11397,9150,ITG,ITG1,19,Sicilia,Sicilia,4999891,2390178,47.8,0.41
600,2021-04-11,SIC,15336,7575,7761,8307,7029,ITG,ITG1,19,Sicilia,Sicilia,4999891,2405514,48.11,0.31
601,2020-12-30,SIC,176,102,74,176,0,ITG,ITG1,19,Sicilia,Sicilia,4999891,2405690,48.11,0.0
602,2021-03-06,SIC,12914,5165,7749,10011,2903,ITG,ITG1,19,Sicilia,Sicilia,4999891,2418604,48.37,0.26
603,2021-01-15,SIC,5088,2236,2852,5088,0,ITG,ITG1,19,Sicilia,Sicilia,4999891,2423692,48.47,0.1
604,2020-12-29,SIC,240,149,91,240,0,ITG,ITG1,19,Sicilia,Sicilia,4999891,2423932,48.48,0.0
605,2021-04-10,SIC,20662,10083,10579,11620,9042,ITG,ITG1,19,Sicilia,Sicilia,4999891,2444594,48.89,0.41
606,2021-03-24,SIC,21146,9908,11238,15309,5837,ITG,ITG1,19,Sicilia,Sicilia,4999891,2465740,49.32,0.42
607,2021-04-21,SIC,22687,10885,11802,16460,6227,ITG,ITG1,19,Sicilia,Sicilia,4999891,2488427,49.77,0.45
608,2021-04-07,SIC,15538,7637,7901,8373,7165,ITG,ITG1,19,Sicilia,Sicilia,4999891,2503965,50.08,0.31
609,2021-06-03,SIC,44589,20331,24258,33284,11305,ITG,ITG1,19,Sicilia,Sicilia,4999891,2548554,50.97,0.89
610,2021-05-29,SIC,47143,21413,25730,23919,23224,ITG,ITG1,19,Sicilia,Sicilia,4999891,2595697,51.92,0.94
611,2021-05-30,SIC,35483,16050,19433,17428,18055,ITG,ITG1,19,Sicilia,Sicilia,4999891,2631180,52.62,0.71
612,2021-02-19,SIC,5130,2732,2398,4564,566,ITG,ITG1,19,Sicilia,Sicilia,4999891,2636310,52.73,0.1
613,2021-04-24,SIC,31362,14805,16557,23622,7740,ITG,ITG1,19,Sicilia,Sicilia,4999891,2667672,53.35,0.63
614,2021-01-14,SIC,5263,2521,2742,5263,0,ITG,ITG1,19,Sicilia,Sicilia,4999891,2672935,53.46,0.11
615,2021-04-26,SIC,21918,10372,11546,13780,8138,ITG,ITG1,19,Sicilia,Sicilia,4999891,2694853,53.9,0.44
616,2021-03-07,SIC,9264,3454,5810,8181,1083,ITG,ITG1,19,Sicilia,Sicilia,4999891,2704117,54.08,0.19
617,2021-02-04,LOM,27650,8072,19578,1996,25654,ITC,ITC4,3,Lombardia,Lombardia,10060574,27650,0.27,0.27
618,2021-04-09,LOM,52223,22292,29931,36230,15993,ITC,ITC4,3,Lombardia,Lombardia,10060574,79873,0.79,0.52
619,2021-04-04,LOM,7613,3232,4381,3716,3897,ITC,ITC4,3,Lombardia,Lombardia,10060574,87486,0.87,0.08
620,2021-01-01,LOM,24,7,17,24,0,ITC,ITC4,3,Lombardia,Lombardia,10060574,87510,0.87,0.0
621,2021-03-06,LOM,21308,9084,12224,16792,4516,ITC,ITC4,3,Lombardia,Lombardia,10060574,108818,1.08,0.21
622,2021-01-30,LOM,12311,4564,7747,159,12152,ITC,ITC4,3,Lombardia,Lombardia,10060574,121129,1.2,0.12
623,2021-02-13,LOM,6417,2441,3976,4941,1476,ITC,ITC4,3,Lombardia,Lombardia,10060574,127546,1.27,0.06
624,2021-01-13,LOM,26374,8052,18322,26374,0,ITC,ITC4,3,Lombardia,Lombardia,10060574,153920,1.53,0.26
625,2021-05-03,LOM,83640,39731,43909,71524,12116,ITC,ITC4,3,Lombardia,Lombardia,10060574,237560,2.36,0.83
626,2021-03-28,LOM,20467,7803,12664,14304,6163,ITC,ITC4,3,Lombardia,Lombardia,10060574,258027,2.56,0.2
627,2021-04-16,LOM,53617,23903,29714,39279,14338,ITC,ITC4,3,Lombardia,Lombardia,10060574,311644,3.1,0.53
628,2021-01-23,LOM,1114,357,757,916,198,ITC,ITC4,3,Lombardia,Lombardia,10060574,312758,3.11,0.01
629,2021-03-11,LOM,36197,13466,22731,26298,9899,ITC,ITC4,3,Lombardia,Lombardia,10060574,348955,3.47,0.36
630,2021-01-06,LOM,7059,2491,4568,7059,0,ITC,ITC4,3,Lombardia,Lombardia,10060574,356014,3.54,0.07
631,2021-03-14,LOM,14874,5349,9525,11590,3284,ITC,ITC4,3,Lombardia,Lombardia,10060574,370888,3.69,0.15
632,2021-05-17,LOM,94513,45271,49242,30205,64308,ITC,ITC4,3,Lombardia,Lombardia,10060574,465401,4.63,0.94
633,2021-02-25,LOM,15230,6314,8916,13670,1560,ITC,ITC4,3,Lombardia,Lombardia,10060574,480631,4.78,0.15
634,2021-04-30,LOM,116904,54643,62261,89710,27194,ITC,ITC4,3,Lombardia,Lombardia,10060574,597535,5.94,1.16
635,2021-02-08,LOM,10079,2918,7161,2133,7946,ITC,ITC4,3,Lombardia,Lombardia,10060574,607614,6.04,0.1
636,2021-03-26,LOM,41152,15604,25548,28077,13075,ITC,ITC4,3,Lombardia,Lombardia,10060574,648766,6.45,0.41
637,2021-05-22,LOM,70276,33707,36569,32352,37924,ITC,ITC4,3,Lombardia,Lombardia,10060574,719042,7.15,0.7
638,2021-05-29,LOM,87794,42159,45635,42016,45778,ITC,ITC4,3,Lombardia,Lombardia,10060574,806836,8.02,0.87
639,2021-05-24,LOM,89135,43248,45887,49430,39705,ITC,ITC4,3,Lombardia,Lombardia,10060574,895971,8.91,0.89
640,2021-02-11,LOM,17042,5002,12040,9696,7346,ITC,ITC4,3,Lombardia,Lombardia,10060574,913013,9.08,0.17
641,2021-05-31,LOM,95201,47160,48041,79276,15925,ITC,ITC4,3,Lombardia,Lombardia,10060574,1008214,10.02,0.95
642,2021-02-18,LOM,14035,4922,9113,13016,1019,ITC,ITC4,3,Lombardia,Lombardia,10060574,1022249,10.16,0.14
643,2021-02-20,LOM,9339,3867,5472,9042,297,ITC,ITC4,3,Lombardia,Lombardia,10060574,1031588,10.25,0.09
644,2021-04-18,LOM,36342,16203,20139,31114,5228,ITC,ITC4,3,Lombardia,Lombardia,10060574,1067930,10.62,0.36
645,2021-01-09,LOM,12411,4573,7838,12411,0,ITC,ITC4,3,Lombardia,Lombardia,10060574,1080341,10.74,0.12
646,2021-01-27,LOM,8034,2672,5362,809,7225,ITC,ITC4,3,Lombardia,Lombardia,10060574,1088375,10.82,0.08
647,2021-05-21,LOM,93491,45098,48393,29048,64443,ITC,ITC4,3,Lombardia,Lombardia,10060574,1181866,11.75,0.93
648,2021-03-18,LOM,27391,10955,16436,16150,11241,ITC,ITC4,3,Lombardia,Lombardia,10060574,1209257,12.02,0.27
649,2021-01-28,LOM,12191,3692,8499,771,11420,ITC,ITC4,3,Lombardia,Lombardia,10060574,1221448,12.14,0.12
650,2021-04-25,LOM,51470,23606,27864,46736,4734,ITC,ITC4,3,Lombardia,Lombardia,10060574,1272918,12.65,0.51
651,2021-01-16,LOM,15429,5732,9697,15429,0,ITC,ITC4,3,Lombardia,Lombardia,10060574,1288347,12.81,0.15
652,2021-03-07,LOM,12082,5355,6727,9523,2559,ITC,ITC4,3,Lombardia,Lombardia,10060574,1300429,12.93,0.12
653,2021-05-07,LOM,92058,43581,48477,69870,22188,ITC,ITC4,3,Lombardia,Lombardia,10060574,1392487,13.84,0.92
654,2021-03-25,LOM,42628,15905,26723,30038,12590,ITC,ITC4,3,Lombardia,Lombardia,10060574,1435115,14.26,0.42
655,2021-05-14,LOM,85600,41230,44370,55536,30064,ITC,ITC4,3,Lombardia,Lombardia,10060574,1520715,15.12,0.85
656,2021-04-28,LOM,95566,43595,51971,68728,26838,ITC,ITC4,3,Lombardia,Lombardia,10060574,1616281,16.07,0.95
657,2021-03-16,LOM,25472,10114,15358,16420,9052,ITC,ITC4,3,Lombardia,Lombardia,10060574,1641753,16.32,0.25
658,2021-05-12,LOM,87211,41615,45596,59781,27430,ITC,ITC4,3,Lombardia,Lombardia,10060574,1728964,17.19,0.87
659,2021-03-09,LOM,33214,12856,20358,25814,7400,ITC,ITC4,3,Lombardia,Lombardia,10060574,1762178,17.52,0.33
660,2021-05-05,LOM,87786,41868,45918,72546,15240,ITC,ITC4,3,Lombardia,Lombardia,10060574,1849964,18.39,0.87
661,2021-01-18,LOM,9146,2969,6177,8171,975,ITC,ITC4,3,Lombardia,Lombardia,10060574,1859110,18.48,0.09
662,2021-03-23,LOM,42514,15405,27109,29642,12872,ITC,ITC4,3,Lombardia,Lombardia,10060574,1901624,18.9,0.42
663,2021-01-25,LOM,7012,2367,4645,473,6539,ITC,ITC4,3,Lombardia,Lombardia,10060574,1908636,18.97,0.07
664,2021-02-01,LOM,16055,5315,10740,305,15750,ITC,ITC4,3,Lombardia,Lombardia,10060574,1924691,19.13,0.16
665,2021-04-02,LOM,41143,16830,24313,26691,14452,ITC,ITC4,3,Lombardia,Lombardia,10060574,1965834,19.54,0.41
666,2021-04-11,LOM,32200,13937,18263,24809,7391,ITC,ITC4,3,Lombardia,Lombardia,10060574,1998034,19.86,0.32
667,2020-12-30,LOM,114,42,72,114,0,ITC,ITC4,3,Lombardia,Lombardia,10060574,1998148,19.86,0.0
668,2021-02-27,LOM,13946,5870,8076,13305,641,ITC,ITC4,3,Lombardia,Lombardia,10060574,2012094,20.0,0.14
669,2021-05-10,LOM,85183,40855,44328,63679,21504,ITC,ITC4,3,Lombardia,Lombardia,10060574,2097277,20.85,0.85
670,2021-04-23,LOM,73369,33273,40096,56857,16512,ITC,ITC4,3,Lombardia,Lombardia,10060574,2170646,21.58,0.73
671,2021-03-21,LOM,23574,8548,15026,18315,5259,ITC,ITC4,3,Lombardia,Lombardia,10060574,2194220,21.81,0.23
672,2021-03-04,LOM,29370,12134,17236,20242,9128,ITC,ITC4,3,Lombardia,Lombardia,10060574,2223590,22.1,0.29
673,2021-02-16,LOM,9512,3077,6435,9060,452,ITC,ITC4,3,Lombardia,Lombardia,10060574,2233102,22.2,0.09
674,2020-12-28,LOM,107,47,60,107,0,ITC,ITC4,3,Lombardia,Lombardia,10060574,2233209,22.2,0.0
675,2021-04-21,LOM,71656,32503,39153,57068,14588,ITC,ITC4,3,Lombardia,Lombardia,10060574,2304865,22.91,0.71
676,2021-03-02,LOM,22807,9696,13111,19770,3037,ITC,ITC4,3,Lombardia,Lombardia,10060574,2327672,23.14,0.23
677,2021-01-11,LOM,16170,5361,10809,16170,0,ITC,ITC4,3,Lombardia,Lombardia,10060574,2343842,23.3,0.16
678,2021-05-26,LOM,93041,44340,48701,43493,49548,ITC,ITC4,3,Lombardia,Lombardia,10060574,2436883,24.22,0.92
679,2021-04-06,LOM,43039,17559,25480,25091,17948,ITC,ITC4,3,Lombardia,Lombardia,10060574,2479922,24.65,0.43
680,2021-05-04,LOM,86764,41050,45714,72400,14364,ITC,ITC4,3,Lombardia,Lombardia,10060574,2566686,25.51,0.86
681,2021-03-01,LOM,18783,8228,10555,17078,1705,ITC,ITC4,3,Lombardia,Lombardia,10060574,2585469,25.7,0.19
682,2021-05-13,LOM,86958,41689,45269,58232,28726,ITC,ITC4,3,Lombardia,Lombardia,10060574,2672427,26.56,0.86
683,2021-03-10,LOM,33239,12711,20528,25380,7859,ITC,ITC4,3,Lombardia,Lombardia,10060574,2705666,26.89,0.33
684,2021-02-23,LOM,11793,4797,6996,11466,327,ITC,ITC4,3,Lombardia,Lombardia,10060574,2717459,27.01,0.12
685,2021-05-19,LOM,82658,39508,43150,33782,48876,ITC,ITC4,3,Lombardia,Lombardia,10060574,2800117,27.83,0.82
686,2021-02-06,LOM,15239,5532,9707,1017,14222,ITC,ITC4,3,Lombardia,Lombardia,10060574,2815356,27.98,0.15
687,2021-05-02,LOM,83497,38330,45167,61037,22460,ITC,ITC4,3,Lombardia,Lombardia,10060574,2898853,28.81,0.83
688,2021-04-08,LOM,52314,21751,30563,35862,16452,ITC,ITC4,3,Lombardia,Lombardia,10060574,2951167,29.33,0.52
689,2021-02-17,LOM,11974,3747,8227,10584,1390,ITC,ITC4,3,Lombardia,Lombardia,10060574,2963141,29.45,0.12
690,2021-03-22,LOM,40304,14291,26013,29761,10543,ITC,ITC4,3,Lombardia,Lombardia,10060574,3003445,29.85,0.4
691,2021-04-22,LOM,73780,33333,40447,57485,16295,ITC,ITC4,3,Lombardia,Lombardia,10060574,3077225,30.59,0.73
692,2021-04-05,LOM,27383,11697,15686,19273,8110,ITC,ITC4,3,Lombardia,Lombardia,10060574,3104608,30.86,0.27
693,2021-01-31,LOM,9731,3760,5971,29,9702,ITC,ITC4,3,Lombardia,Lombardia,10060574,3114339,30.96,0.1
694,2021-05-25,LOM,90761,43429,47332,44584,46177,ITC,ITC4,3,Lombardia,Lombardia,10060574,3205100,31.86,0.9
695,2021-05-16,LOM,68483,32408,36075,36482,32001,ITC,ITC4,3,Lombardia,Lombardia,10060574,3273583,32.54,0.68
696,2021-03-13,LOM,27174,9766,17408,21079,6095,ITC,ITC4,3,Lombardia,Lombardia,10060574,3300757,32.81,0.27
697,2021-02-05,LOM,25623,7443,18180,2391,23232,ITC,ITC4,3,Lombardia,Lombardia,10060574,3326380,33.06,0.25
698,2021-05-01,LOM,95878,43645,52233,66746,29132,ITC,ITC4,3,Lombardia,Lombardia,10060574,3422258,34.02,0.95
699,2021-01-21,LOM,5319,1564,3755,4631,688,ITC,ITC4,3,Lombardia,Lombardia,10060574,3427577,34.07,0.05
700,2021-05-23,LOM,60727,28916,31811,26788,33939,ITC,ITC4,3,Lombardia,Lombardia,10060574,3488304,34.67,0.6
701,2021-04-03,LOM,36240,14861,21379,26151,10089,ITC,ITC4,3,Lombardia,Lombardia,10060574,3524544,35.03,0.36
702,2021-05-30,LOM,74244,35533,38711,34313,39931,ITC,ITC4,3,Lombardia,Lombardia,10060574,3598788,35.77,0.74
703,2021-02-12,LOM,13943,4356,9587,9023,4920,ITC,ITC4,3,Lombardia,Lombardia,10060574,3612731,35.91,0.14
704,2021-04-10,LOM,52389,21706,30683,40597,11792,ITC,ITC4,3,Lombardia,Lombardia,10060574,3665120,36.43,0.52
705,2021-02-19,LOM,14166,5387,8779,13486,680,ITC,ITC4,3,Lombardia,Lombardia,10060574,3679286,36.57,0.14
706,2021-04-17,LOM,48392,21259,27133,37624,10768,ITC,ITC4,3,Lombardia,Lombardia,10060574,3727678,37.05,0.48
707,2021-02-26,LOM,18360,7548,10812,16513,1847,ITC,ITC4,3,Lombardia,Lombardia,10060574,3746038,37.23,0.18
708,2020-12-31,LOM,714,301,413,714,0,ITC,ITC4,3,Lombardia,Lombardia,10060574,3746752,37.24,0.01
709,2021-01-07,LOM,11759,3635,8124,11759,0,ITC,ITC4,3,Lombardia,Lombardia,10060574,3758511,37.36,0.12
710,2021-04-13,LOM,47566,21235,26331,33496,14070,ITC,ITC4,3,Lombardia,Lombardia,10060574,3806077,37.83,0.47
711,2021-01-22,LOM,3103,865,2238,3034,69,ITC,ITC4,3,Lombardia,Lombardia,10060574,3809180,37.86,0.03
712,2021-03-27,LOM,32439,12373,20066,23720,8719,ITC,ITC4,3,Lombardia,Lombardia,10060574,3841619,38.18,0.32
713,2021-01-05,LOM,7821,2567,5254,7821,0,ITC,ITC4,3,Lombardia,Lombardia,10060574,3849440,38.26,0.08
714,2021-01-08,LOM,12695,3915,8780,12695,0,ITC,ITC4,3,Lombardia,Lombardia,10060574,3862135,38.39,0.13
715,2021-01-15,LOM,25198,7428,17770,25198,0,ITC,ITC4,3,Lombardia,Lombardia,10060574,3887333,38.64,0.25
716,2021-02-03,LOM,25535,7897,17638,1078,24457,ITC,ITC4,3,Lombardia,Lombardia,10060574,3912868,38.89,0.25
717,2021-04-01,LOM,42924,17214,25710,26737,16187,ITC,ITC4,3,Lombardia,Lombardia,10060574,3955792,39.32,0.43
718,2021-04-26,LOM,87926,40919,47007,68770,19156,ITC,ITC4,3,Lombardia,Lombardia,10060574,4043718,40.19,0.87
719,2021-03-20,LOM,32508,12148,20360,22657,9851,ITC,ITC4,3,Lombardia,Lombardia,10060574,4076226,40.52,0.32
720,2021-05-09,LOM,69516,32810,36706,56426,13090,ITC,ITC4,3,Lombardia,Lombardia,10060574,4145742,41.21,0.69
721,2021-01-29,LOM,13442,4114,9328,656,12786,ITC,ITC4,3,Lombardia,Lombardia,10060574,4159184,41.34,0.13
722,2021-04-24,LOM,75672,33539,42133,54609,21063,ITC,ITC4,3,Lombardia,Lombardia,10060574,4234856,42.09,0.75
723,2021-03-05,LOM,28976,11944,17032,20572,8404,ITC,ITC4,3,Lombardia,Lombardia,10060574,4263832,42.38,0.29
724,2021-03-19,LOM,32412,12910,19502,19218,13194,ITC,ITC4,3,Lombardia,Lombardia,10060574,4296244,42.7,0.32
725,2021-01-14,LOM,26798,7781,19017,26798,0,ITC,ITC4,3,Lombardia,Lombardia,10060574,4323042,42.97,0.27
726,2021-05-08,LOM,87367,40595,46772,65654,21713,ITC,ITC4,3,Lombardia,Lombardia,10060574,4410409,43.84,0.87
727,2021-02-10,LOM,14392,4503,9889,7573,6819,ITC,ITC4,3,Lombardia,Lombardia,10060574,4424801,43.98,0.14
728,2021-06-01,LOM,93371,45890,47481,76658,16713,ITC,ITC4,3,Lombardia,Lombardia,10060574,4518172,44.91,0.93
729,2021-01-02,LOM,199,72,127,199,0,ITC,ITC4,3,Lombardia,Lombardia,10060574,4518371,44.91,0.0
730,2021-02-28,LOM,7889,3257,4632,7674,215,ITC,ITC4,3,Lombardia,Lombardia,10060574,4526260,44.99,0.08
731,2021-04-20,LOM,67626,30820,36806,57291,10335,ITC,ITC4,3,Lombardia,Lombardia,10060574,4593886,45.66,0.67
732,2021-01-10,LOM,10520,3957,6563,10520,0,ITC,ITC4,3,Lombardia,Lombardia,10060574,4604406,45.77,0.1
733,2021-04-27,LOM,85918,39952,45966,69379,16539,ITC,ITC4,3,Lombardia,Lombardia,10060574,4690324,46.62,0.85
734,2021-04-29,LOM,115398,53551,61847,85588,29810,ITC,ITC4,3,Lombardia,Lombardia,10060574,4805722,47.77,1.15
735,2021-01-17,LOM,8337,3341,4996,8137,200,ITC,ITC4,3,Lombardia,Lombardia,10060574,4814059,47.85,0.08
736,2021-03-15,LOM,31556,11331,20225,23040,8516,ITC,ITC4,3,Lombardia,Lombardia,10060574,4845615,48.16,0.31
737,2021-03-17,LOM,26258,10489,15769,15254,11004,ITC,ITC4,3,Lombardia,Lombardia,10060574,4871873,48.43,0.26
738,2021-03-24,LOM,43232,15600,27632,31350,11882,ITC,ITC4,3,Lombardia,Lombardia,10060574,4915105,48.86,0.43
739,2021-03-08,LOM,29712,11174,18538,22643,7069,ITC,ITC4,3,Lombardia,Lombardia,10060574,4944817,49.15,0.3
740,2021-01-24,LOM,1199,457,742,536,663,ITC,ITC4,3,Lombardia,Lombardia,10060574,4946016,49.16,0.01
741,2021-05-06,LOM,89715,42156,47559,73292,16423,ITC,ITC4,3,Lombardia,Lombardia,10060574,5035731,50.05,0.89
742,2021-05-15,LOM,80559,38676,41883,47332,33227,ITC,ITC4,3,Lombardia,Lombardia,10060574,5116290,50.85,0.8
743,2021-02-02,LOM,19865,6590,13275,498,19367,ITC,ITC4,3,Lombardia,Lombardia,10060574,5136155,51.05,0.2
744,2021-05-28,LOM,92881,44534,48347,42781,50100,ITC,ITC4,3,Lombardia,Lombardia,10060574,5229036,51.98,0.92
745,2020-12-29,LOM,104,44,60,104,0,ITC,ITC4,3,Lombardia,Lombardia,10060574,5229140,51.98,0.0
746,2021-03-03,LOM,26978,11513,15465,19699,7279,ITC,ITC4,3,Lombardia,Lombardia,10060574,5256118,52.24,0.27
747,2021-05-11,LOM,86731,41374,45357,60609,26122,ITC,ITC4,3,Lombardia,Lombardia,10060574,5342849,53.11,0.86
748,2021-01-12,LOM,20217,6697,13520,20217,0,ITC,ITC4,3,Lombardia,Lombardia,10060574,5363066,53.31,0.2
749,2021-02-14,LOM,3577,1545,2032,2942,635,ITC,ITC4,3,Lombardia,Lombardia,10060574,5366643,53.34,0.04
750,2021-02-15,LOM,8940,3129,5811,8522,418,ITC,ITC4,3,Lombardia,Lombardia,10060574,5375583,53.43,0.09
751,2020-12-27,LOM,717,413,304,717,0,ITC,ITC4,3,Lombardia,Lombardia,10060574,5376300,53.44,0.01
752,2021-03-31,LOM,41927,16966,24961,26720,15207,ITC,ITC4,3,Lombardia,Lombardia,10060574,5418227,53.86,0.42
753,2021-01-26,LOM,8341,2707,5634,350,7991,ITC,ITC4,3,Lombardia,Lombardia,10060574,5426568,53.94,0.08
754,2021-04-14,LOM,47118,21006,26112,34153,12965,ITC,ITC4,3,Lombardia,Lombardia,10060574,5473686,54.41,0.47
755,2021-01-04,LOM,6095,2101,3994,6095,0,ITC,ITC4,3,Lombardia,Lombardia,10060574,5479781,54.47,0.06
756,2021-03-30,LOM,39483,15485,23998,24700,14783,ITC,ITC4,3,Lombardia,Lombardia,10060574,5519264,54.86,0.39
757,2021-06-02,LOM,67995,35048,32947,62634,5361,ITC,ITC4,3,Lombardia,Lombardia,10060574,5587259,55.54,0.68
758,2021-01-20,LOM,5664,1378,4286,5550,114,ITC,ITC4,3,Lombardia,Lombardia,10060574,5592923,55.59,0.06
759,2021-04-15,LOM,49391,21838,27553,35582,13809,ITC,ITC4,3,Lombardia,Lombardia,10060574,5642314,56.08,0.49
760,2021-01-03,LOM,854,316,538,854,0,ITC,ITC4,3,Lombardia,Lombardia,10060574,5643168,56.09,0.01
761,2021-03-29,LOM,40017,15515,24502,25182,14835,ITC,ITC4,3,Lombardia,Lombardia,10060574,5683185,56.49,0.4
762,2021-06-03,LOM,70185,35773,34412,61943,8242,ITC,ITC4,3,Lombardia,Lombardia,10060574,5753370,57.19,0.7
763,2021-04-12,LOM,47222,20571,26651,32890,14332,ITC,ITC4,3,Lombardia,Lombardia,10060574,5800592,57.66,0.47
764,2021-02-21,LOM,5052,1862,3190,5034,18,ITC,ITC4,3,Lombardia,Lombardia,10060574,5805644,57.71,0.05
765,2021-02-09,LOM,12205,3331,8874,4033,8172,ITC,ITC4,3,Lombardia,Lombardia,10060574,5817849,57.83,0.12
766,2021-04-19,LOM,60090,27338,32752,50687,9403,ITC,ITC4,3,Lombardia,Lombardia,10060574,5877939,58.43,0.6
767,2021-02-22,LOM,11897,4809,7088,11590,307,ITC,ITC4,3,Lombardia,Lombardia,10060574,5889836,58.54,0.12
768,2021-05-18,LOM,88011,42052,45959,32582,55429,ITC,ITC4,3,Lombardia,Lombardia,10060574,5977847,59.42,0.87
769,2021-02-24,LOM,14658,5923,8735,13731,927,ITC,ITC4,3,Lombardia,Lombardia,10060574,5992505,59.56,0.15
770,2021-02-07,LOM,7307,2822,4485,338,6969,ITC,ITC4,3,Lombardia,Lombardia,10060574,5999812,59.64,0.07
771,2021-01-19,LOM,8070,2335,5735,7602,468,ITC,ITC4,3,Lombardia,Lombardia,10060574,6007882,59.72,0.08
772,2021-05-20,LOM,94154,45500,48654,31789,62365,ITC,ITC4,3,Lombardia,Lombardia,10060574,6102036,60.65,0.94
773,2021-03-12,LOM,35253,12953,22300,25051,10202,ITC,ITC4,3,Lombardia,Lombardia,10060574,6137289,61.0,0.35
774,2021-05-27,LOM,94315,45213,49102,41229,53086,ITC,ITC4,3,Lombardia,Lombardia,10060574,6231604,61.94,0.94
775,2021-04-07,LOM,50518,20874,29644,34708,15810,ITC,ITC4,3,Lombardia,Lombardia,10060574,6282122,62.44,0.5
776,2021-02-25,CAM,12425,4478,7947,11237,1188,ITF,ITF3,15,Campania,Campania,5801692,12425,0.21,0.21
777,2021-04-09,CAM,29846,13964,15882,23719,6127,ITF,ITF3,15,Campania,Campania,5801692,42271,0.73,0.51
778,2021-01-22,CAM,1524,776,748,673,851,ITF,ITF3,15,Campania,Campania,5801692,43795,0.75,0.03
779,2021-03-06,CAM,16308,6753,9555,10639,5669,ITF,ITF3,15,Campania,Campania,5801692,60103,1.04,0.28
780,2021-02-13,CAM,5508,2550,2958,5291,217,ITF,ITF3,15,Campania,Campania,5801692,65611,1.13,0.09
781,2021-04-04,CAM,7959,4012,3947,6915,1044,ITF,ITF3,15,Campania,Campania,5801692,73570,1.27,0.14
782,2021-01-27,CAM,7738,3820,3918,162,7576,ITF,ITF3,15,Campania,Campania,5801692,81308,1.4,0.13
783,2021-03-18,CAM,12172,5378,6794,5984,6188,ITF,ITF3,15,Campania,Campania,5801692,93480,1.61,0.21
784,2021-05-31,CAM,40092,20086,20006,30085,10007,ITF,ITF3,15,Campania,Campania,5801692,133572,2.3,0.69
785,2021-03-28,CAM,15552,7501,8051,13927,1625,ITF,ITF3,15,Campania,Campania,5801692,149124,2.57,0.27
786,2021-05-16,CAM,51114,23197,27917,33568,17546,ITF,ITF3,15,Campania,Campania,5801692,200238,3.45,0.88
787,2021-02-03,CAM,8903,4003,4900,878,8025,ITF,ITF3,15,Campania,Campania,5801692,209141,3.6,0.15
788,2021-03-11,CAM,17584,8672,8912,10306,7278,ITF,ITF3,15,Campania,Campania,5801692,226725,3.91,0.3
789,2021-02-20,CAM,8573,3080,5493,8270,303,ITF,ITF3,15,Campania,Campania,5801692,235298,4.06,0.15
790,2021-01-18,CAM,957,399,558,713,244,ITF,ITF3,15,Campania,Campania,5801692,236255,4.07,0.02
791,2021-04-30,CAM,42232,20132,22100,25784,16448,ITF,ITF3,15,Campania,Campania,5801692,278487,4.8,0.73
792,2021-05-17,CAM,49217,21604,27613,24078,25139,ITF,ITF3,15,Campania,Campania,5801692,327704,5.65,0.85
793,2021-02-04,CAM,7943,3429,4514,1308,6635,ITF,ITF3,15,Campania,Campania,5801692,335647,5.79,0.14
794,2021-01-01,CAM,919,506,413,919,0,ITF,ITF3,15,Campania,Campania,5801692,336566,5.8,0.02
795,2021-01-06,CAM,7652,3749,3903,7652,0,ITF,ITF3,15,Campania,Campania,5801692,344218,5.93,0.13
796,2021-02-11,CAM,6278,2704,3574,6212,66,ITF,ITF3,15,Campania,Campania,5801692,350496,6.04,0.11
797,2021-04-16,CAM,34300,16550,17750,23642,10658,ITF,ITF3,15,Campania,Campania,5801692,384796,6.63,0.59
798,2021-02-18,CAM,9080,3812,5268,8372,708,ITF,ITF3,15,Campania,Campania,5801692,393876,6.79,0.16
799,2021-01-15,CAM,4980,2381,2599,4980,0,ITF,ITF3,15,Campania,Campania,5801692,398856,6.87,0.09
800,2021-03-13,CAM,14252,6796,7456,8970,5282,ITF,ITF3,15,Campania,Campania,5801692,413108,7.12,0.25
801,2021-04-25,CAM,30732,15172,15560,25340,5392,ITF,ITF3,15,Campania,Campania,5801692,443840,7.65,0.53
802,2021-01-13,CAM,8020,3666,4354,8020,0,ITF,ITF3,15,Campania,Campania,5801692,451860,7.79,0.14
803,2021-04-18,CAM,27216,13281,13935,18318,8898,ITF,ITF3,15,Campania,Campania,5801692,479076,8.26,0.47
804,2021-01-08,CAM,10455,4968,5487,10455,0,ITF,ITF3,15,Campania,Campania,5801692,489531,8.44,0.18
805,2021-01-30,CAM,10721,5079,5642,38,10683,ITF,ITF3,15,Campania,Campania,5801692,500252,8.62,0.18
806,2021-01-23,CAM,3838,2028,1810,273,3565,ITF,ITF3,15,Campania,Campania,5801692,504090,8.69,0.07
807,2021-04-08,CAM,28269,13639,14630,22433,5836,ITF,ITF3,15,Campania,Campania,5801692,532359,9.18,0.49
808,2021-04-01,CAM,24338,11687,12651,20205,4133,ITF,ITF3,15,Campania,Campania,5801692,556697,9.6,0.42
809,2021-05-21,CAM,63382,29337,34045,43178,20204,ITF,ITF3,15,Campania,Campania,5801692,620079,10.69,1.09
810,2021-03-20,CAM,13882,6429,7453,10143,3739,ITF,ITF3,15,Campania,Campania,5801692,633961,10.93,0.24
811,2021-05-09,CAM,43168,20271,22897,32078,11090,ITF,ITF3,15,Campania,Campania,5801692,677129,11.67,0.74
812,2021-01-16,CAM,3369,1675,1694,3369,0,ITF,ITF3,15,Campania,Campania,5801692,680498,11.73,0.06
813,2021-03-21,CAM,9982,4591,5391,7592,2390,ITF,ITF3,15,Campania,Campania,5801692,690480,11.9,0.17
814,2021-02-10,CAM,6903,3413,3490,6727,176,ITF,ITF3,15,Campania,Campania,5801692,697383,12.02,0.12
815,2021-05-28,CAM,72338,34688,37650,26743,45595,ITF,ITF3,15,Campania,Campania,5801692,769721,13.27,1.25
816,2021-05-14,CAM,60798,27467,33331,36308,24490,ITF,ITF3,15,Campania,Campania,5801692,830519,14.32,1.05
817,2021-03-16,CAM,8087,3519,4568,3773,4314,ITF,ITF3,15,Campania,Campania,5801692,838606,14.45,0.14
818,2021-01-25,CAM,5745,2927,2818,164,5581,ITF,ITF3,15,Campania,Campania,5801692,844351,14.55,0.1
819,2021-03-23,CAM,15335,7055,8280,12822,2513,ITF,ITF3,15,Campania,Campania,5801692,859686,14.82,0.26
820,2021-05-19,CAM,51018,22495,28523,34521,16497,ITF,ITF3,15,Campania,Campania,5801692,910704,15.7,0.88
821,2021-05-12,CAM,40796,19913,20883,31656,9140,ITF,ITF3,15,Campania,Campania,5801692,951500,16.4,0.7
822,2021-05-05,CAM,51131,24842,26289,44755,6376,ITF,ITF3,15,Campania,Campania,5801692,1002631,17.28,0.88
823,2021-02-08,CAM,5113,2449,2664,4310,803,ITF,ITF3,15,Campania,Campania,5801692,1007744,17.37,0.09
824,2021-02-01,CAM,3985,1813,2172,110,3875,ITF,ITF3,15,Campania,Campania,5801692,1011729,17.44,0.07
825,2021-03-30,CAM,21729,10272,11457,18771,2958,ITF,ITF3,15,Campania,Campania,5801692,1033458,17.81,0.37
826,2021-02-27,CAM,13950,4473,9477,12308,1642,ITF,ITF3,15,Campania,Campania,5801692,1047408,18.05,0.24
827,2021-05-02,CAM,43483,21537,21946,32132,11351,ITF,ITF3,15,Campania,Campania,5801692,1090891,18.8,0.75
828,2021-04-23,CAM,32299,15508,16791,23162,9137,ITF,ITF3,15,Campania,Campania,5801692,1123190,19.36,0.56
829,2021-03-04,CAM,14658,5352,9306,8765,5893,ITF,ITF3,15,Campania,Campania,5801692,1137848,19.61,0.25
830,2021-05-24,CAM,31061,14890,16171,16173,14888,ITF,ITF3,15,Campania,Campania,5801692,1168909,20.15,0.54
831,2021-05-07,CAM,59717,29182,30535,43773,15944,ITF,ITF3,15,Campania,Campania,5801692,1228626,21.18,1.03
832,2021-05-26,CAM,52019,25397,26622,21148,30871,ITF,ITF3,15,Campania,Campania,5801692,1280645,22.07,0.9
833,2021-03-02,CAM,12757,4554,8203,8412,4345,ITF,ITF3,15,Campania,Campania,5801692,1293402,22.29,0.22
834,2021-01-11,CAM,4072,1871,2201,4072,0,ITF,ITF3,15,Campania,Campania,5801692,1297474,22.36,0.07
835,2020-12-27,CAM,720,422,298,720,0,ITF,ITF3,15,Campania,Campania,5801692,1298194,22.38,0.01
836,2021-04-20,CAM,32013,15491,16522,20707,11306,ITF,ITF3,15,Campania,Campania,5801692,1330207,22.93,0.55
837,2021-03-01,CAM,12130,4247,7883,8017,4113,ITF,ITF3,15,Campania,Campania,5801692,1342337,23.14,0.21
838,2021-04-06,CAM,24372,11420,12952,19848,4524,ITF,ITF3,15,Campania,Campania,5801692,1366709,23.56,0.42
839,2021-04-27,CAM,32131,15598,16533,24211,7920,ITF,ITF3,15,Campania,Campania,5801692,1398840,24.11,0.55
840,2021-03-22,CAM,12740,5921,6819,10700,2040,ITF,ITF3,15,Campania,Campania,5801692,1411580,24.33,0.22
841,2021-05-13,CAM,55381,24808,30573,39389,15992,ITF,ITF3,15,Campania,Campania,5801692,1466961,25.29,0.95
842,2021-01-31,CAM,8067,3711,4356,23,8044,ITF,ITF3,15,Campania,Campania,5801692,1475028,25.42,0.14
843,2021-05-04,CAM,48450,23336,25114,39562,8888,ITF,ITF3,15,Campania,Campania,5801692,1523478,26.26,0.84
844,2021-03-31,CAM,22685,10906,11779,19246,3439,ITF,ITF3,15,Campania,Campania,5801692,1546163,26.65,0.39
845,2021-04-11,CAM,17522,8605,8917,15440,2082,ITF,ITF3,15,Campania,Campania,5801692,1563685,26.95,0.3
846,2021-02-06,CAM,5340,2665,2675,2102,3238,ITF,ITF3,15,Campania,Campania,5801692,1569025,27.04,0.09
847,2021-04-28,CAM,36407,17619,18788,26657,9750,ITF,ITF3,15,Campania,Campania,5801692,1605432,27.67,0.63
848,2021-01-03,CAM,3837,2009,1828,3837,0,ITF,ITF3,15,Campania,Campania,5801692,1609269,27.74,0.07
849,2021-03-25,CAM,19990,9335,10655,16487,3503,ITF,ITF3,15,Campania,Campania,5801692,1629259,28.08,0.34
850,2021-01-20,CAM,1257,650,607,1257,0,ITF,ITF3,15,Campania,Campania,5801692,1630516,28.1,0.02
851,2021-04-05,CAM,11638,5543,6095,9215,2423,ITF,ITF3,15,Campania,Campania,5801692,1642154,28.3,0.2
852,2021-05-25,CAM,45951,21930,24021,22884,23067,ITF,ITF3,15,Campania,Campania,5801692,1688105,29.1,0.79
853,2021-04-22,CAM,33941,16530,17411,21539,12402,ITF,ITF3,15,Campania,Campania,5801692,1722046,29.68,0.59
854,2021-01-09,CAM,10567,5024,5543,10567,0,ITF,ITF3,15,Campania,Campania,5801692,1732613,29.86,0.18
855,2021-02-05,CAM,7260,3463,3797,2133,5127,ITF,ITF3,15,Campania,Campania,5801692,1739873,29.99,0.13
856,2021-01-21,CAM,2092,1115,977,676,1416,ITF,ITF3,15,Campania,Campania,5801692,1741965,30.03,0.04
857,2021-03-26,CAM,19458,8929,10529,15644,3814,ITF,ITF3,15,Campania,Campania,5801692,1761423,30.36,0.34
858,2021-05-01,CAM,46319,22654,23665,30221,16098,ITF,ITF3,15,Campania,Campania,5801692,1807742,31.16,0.8
859,2021-04-17,CAM,36172,17506,18666,24666,11506,ITF,ITF3,15,Campania,Campania,5801692,1843914,31.78,0.62
860,2021-02-19,CAM,9570,3559,6011,8920,650,ITF,ITF3,15,Campania,Campania,5801692,1853484,31.95,0.16
861,2020-12-31,CAM,1490,811,679,1490,0,ITF,ITF3,15,Campania,Campania,5801692,1854974,31.97,0.03
862,2021-02-26,CAM,13339,4230,9109,12004,1335,ITF,ITF3,15,Campania,Campania,5801692,1868313,32.2,0.23
863,2021-04-24,CAM,36328,17519,18809,25082,11246,ITF,ITF3,15,Campania,Campania,5801692,1904641,32.83,0.63
864,2021-05-30,CAM,52048,25368,26680,38808,13240,ITF,ITF3,15,Campania,Campania,5801692,1956689,33.73,0.9
865,2021-04-10,CAM,28341,13486,14855,23428,4913,ITF,ITF3,15,Campania,Campania,5801692,1985030,34.21,0.49
866,2021-01-07,CAM,8910,4166,4744,8910,0,ITF,ITF3,15,Campania,Campania,5801692,1993940,34.37,0.15
867,2021-03-05,CAM,16483,6348,10135,9820,6663,ITF,ITF3,15,Campania,Campania,5801692,2010423,34.65,0.28
868,2021-04-13,CAM,26599,12682,13917,21069,5530,ITF,ITF3,15,Campania,Campania,5801692,2037022,35.11,0.46
869,2021-03-10,CAM,15253,7382,7871,8419,6834,ITF,ITF3,15,Campania,Campania,5801692,2052275,35.37,0.26
870,2021-03-27,CAM,21278,10032,11246,17414,3864,ITF,ITF3,15,Campania,Campania,5801692,2073553,35.74,0.37
871,2021-06-03,CAM,71254,34264,36990,61167,10087,ITF,ITF3,15,Campania,Campania,5801692,2144807,36.97,1.23
872,2021-05-22,CAM,67835,32439,35396,46439,21396,ITF,ITF3,15,Campania,Campania,5801692,2212642,38.14,1.17
873,2021-01-05,CAM,7237,3637,3600,7237,0,ITF,ITF3,15,Campania,Campania,5801692,2219879,38.26,0.12
874,2021-02-17,CAM,7388,3210,4178,6328,1060,ITF,ITF3,15,Campania,Campania,5801692,2227267,38.39,0.13
875,2021-03-14,CAM,8501,3721,4780,4362,4139,ITF,ITF3,15,Campania,Campania,5801692,2235768,38.54,0.15
876,2021-04-26,CAM,34001,16636,17365,28379,5622,ITF,ITF3,15,Campania,Campania,5801692,2269769,39.12,0.59
877,2021-02-12,CAM,6529,2861,3668,6343,186,ITF,ITF3,15,Campania,Campania,5801692,2276298,39.24,0.11
878,2021-04-03,CAM,21115,10315,10800,18735,2380,ITF,ITF3,15,Campania,Campania,5801692,2297413,39.6,0.36
879,2021-05-23,CAM,58716,28617,30099,37840,20876,ITF,ITF3,15,Campania,Campania,5801692,2356129,40.61,1.01
880,2021-01-29,CAM,10052,4812,5240,47,10005,ITF,ITF3,15,Campania,Campania,5801692,2366181,40.78,0.17
881,2021-03-19,CAM,11037,4870,6167,7165,3872,ITF,ITF3,15,Campania,Campania,5801692,2377218,40.97,0.19
882,2021-01-28,CAM,8832,4121,4711,134,8698,ITF,ITF3,15,Campania,Campania,5801692,2386050,41.13,0.15
883,2021-05-08,CAM,56348,27098,29250,40527,15821,ITF,ITF3,15,Campania,Campania,5801692,2442398,42.1,0.97
884,2021-02-24,CAM,11786,4149,7637,11098,688,ITF,ITF3,15,Campania,Campania,5801692,2454184,42.3,0.2
885,2021-04-15,CAM,34338,16659,17679,24440,9898,ITF,ITF3,15,Campania,Campania,5801692,2488522,42.89,0.59
886,2021-05-10,CAM,35402,16369,19033,25485,9917,ITF,ITF3,15,Campania,Campania,5801692,2523924,43.5,0.61
887,2021-03-07,CAM,11911,5344,6567,8068,3843,ITF,ITF3,15,Campania,Campania,5801692,2535835,43.71,0.21
888,2021-05-03,CAM,40748,19886,20862,28902,11846,ITF,ITF3,15,Campania,Campania,5801692,2576583,44.41,0.7
889,2021-02-07,CAM,2929,1382,1547,2158,771,ITF,ITF3,15,Campania,Campania,5801692,2579512,44.46,0.05
890,2021-01-17,CAM,1155,551,604,702,453,ITF,ITF3,15,Campania,Campania,5801692,2580667,44.48,0.02
891,2021-03-15,CAM,12932,6088,6844,8187,4745,ITF,ITF3,15,Campania,Campania,5801692,2593599,44.7,0.22
892,2021-02-16,CAM,5440,2411,3029,4669,771,ITF,ITF3,15,Campania,Campania,5801692,2599039,44.8,0.09
893,2021-02-09,CAM,4643,2202,2441,4391,252,ITF,ITF3,15,Campania,Campania,5801692,2603682,44.88,0.08
894,2021-05-27,CAM,72299,34759,37540,26213,46086,ITF,ITF3,15,Campania,Campania,5801692,2675981,46.12,1.25
895,2021-03-24,CAM,17621,8082,9539,14664,2957,ITF,ITF3,15,Campania,Campania,5801692,2693602,46.43,0.3
896,2021-05-20,CAM,60449,27825,32624,43070,17379,ITF,ITF3,15,Campania,Campania,5801692,2754051,47.47,1.04
897,2021-01-24,CAM,4128,2123,2005,383,3745,ITF,ITF3,15,Campania,Campania,5801692,2758179,47.54,0.07
898,2021-03-08,CAM,14542,6717,7825,9766,4776,ITF,ITF3,15,Campania,Campania,5801692,2772721,47.79,0.25
899,2021-05-11,CAM,39829,19228,20601,30460,9369,ITF,ITF3,15,Campania,Campania,5801692,2812550,48.48,0.69
900,2021-04-07,CAM,24757,11781,12976,20035,4722,ITF,ITF3,15,Campania,Campania,5801692,2837307,48.9,0.43
901,2021-04-02,CAM,21730,10411,11319,19409,2321,ITF,ITF3,15,Campania,Campania,5801692,2859037,49.28,0.37
902,2021-02-02,CAM,5723,2804,2919,444,5279,ITF,ITF3,15,Campania,Campania,5801692,2864760,49.38,0.1
903,2021-03-17,CAM,11588,5099,6489,5008,6580,ITF,ITF3,15,Campania,Campania,5801692,2876348,49.58,0.2
904,2021-03-03,CAM,13921,5494,8427,7291,6630,ITF,ITF3,15,Campania,Campania,5801692,2890269,49.82,0.24
905,2021-01-12,CAM,5214,2563,2651,5214,0,ITF,ITF3,15,Campania,Campania,5801692,2895483,49.91,0.09
906,2021-05-06,CAM,57258,27893,29365,42818,14440,ITF,ITF3,15,Campania,Campania,5801692,2952741,50.89,0.99
907,2021-02-28,CAM,10412,3206,7206,8512,1900,ITF,ITF3,15,Campania,Campania,5801692,2963153,51.07,0.18
908,2021-02-14,CAM,3928,1923,2005,3894,34,ITF,ITF3,15,Campania,Campania,5801692,2967081,51.14,0.07
909,2021-04-19,CAM,30730,14817,15913,19163,11567,ITF,ITF3,15,Campania,Campania,5801692,2997811,51.67,0.53
910,2021-02-15,CAM,5470,2516,2954,5297,173,ITF,ITF3,15,Campania,Campania,5801692,3003281,51.77,0.09
911,2021-01-10,CAM,8165,3736,4429,8165,0,ITF,ITF3,15,Campania,Campania,5801692,3011446,51.91,0.14
912,2021-04-21,CAM,30222,14723,15499,17995,12227,ITF,ITF3,15,Campania,Campania,5801692,3041668,52.43,0.52
913,2021-01-26,CAM,7340,3726,3614,351,6989,ITF,ITF3,15,Campania,Campania,5801692,3049008,52.55,0.13
914,2021-01-04,CAM,5825,2962,2863,5825,0,ITF,ITF3,15,Campania,Campania,5801692,3054833,52.65,0.1
915,2021-03-09,CAM,13881,6637,7244,10096,3785,ITF,ITF3,15,Campania,Campania,5801692,3068714,52.89,0.24
916,2021-02-22,CAM,10680,3294,7386,10417,263,ITF,ITF3,15,Campania,Campania,5801692,3079394,53.08,0.18
917,2021-06-02,CAM,42732,20103,22629,38105,4627,ITF,ITF3,15,Campania,Campania,5801692,3122126,53.81,0.74
918,2021-03-29,CAM,18947,9134,9813,17401,1546,ITF,ITF3,15,Campania,Campania,5801692,3141073,54.14,0.33
919,2021-06-01,CAM,41346,20333,21013,31243,10103,ITF,ITF3,15,Campania,Campania,5801692,3182419,54.85,0.71
920,2021-05-15,CAM,62614,29037,33577,43947,18667,ITF,ITF3,15,Campania,Campania,5801692,3245033,55.93,1.08
921,2021-02-23,CAM,11003,3388,7615,10477,526,ITF,ITF3,15,Campania,Campania,5801692,3256036,56.12,0.19
922,2021-03-12,CAM,14247,7096,7151,8165,6082,ITF,ITF3,15,Campania,Campania,5801692,3270283,56.37,0.25
923,2021-01-14,CAM,7073,2977,4096,7073,0,ITF,ITF3,15,Campania,Campania,5801692,3277356,56.49,0.12
924,2021-02-21,CAM,5834,2239,3595,5609,225,ITF,ITF3,15,Campania,Campania,5801692,3283190,56.59,0.1
925,2021-05-29,CAM,67651,32142,35509,43924,23727,ITF,ITF3,15,Campania,Campania,5801692,3350841,57.76,1.17
926,2021-01-19,CAM,1095,474,621,1092,3,ITF,ITF3,15,Campania,Campania,5801692,3351936,57.78,0.02
927,2021-05-18,CAM,52048,23142,28906,32506,19542,ITF,ITF3,15,Campania,Campania,5801692,3403984,58.67,0.9
928,2021-04-29,CAM,41285,20008,21277,24818,16467,ITF,ITF3,15,Campania,Campania,5801692,3445269,59.38,0.71
929,2021-04-14,CAM,27639,13330,14309,19073,8566,ITF,ITF3,15,Campania,Campania,5801692,3472908,59.86,0.48
930,2021-01-02,CAM,3673,1962,1711,3673,0,ITF,ITF3,15,Campania,Campania,5801692,3476581,59.92,0.06
931,2021-04-12,CAM,23301,10916,12385,20265,3036,ITF,ITF3,15,Campania,Campania,5801692,3499882,60.33,0.4
932,2021-03-31,LIG,11841,5206,6635,9071,2770,ITC,ITC3,7,Liguria,Liguria,1550640,11841,0.76,0.76
933,2021-06-03,LIG,14989,7432,7557,8890,6099,ITC,ITC3,7,Liguria,Liguria,1550640,26830,1.73,0.97
934,2021-04-09,LIG,12422,5554,6868,10683,1739,ITC,ITC3,7,Liguria,Liguria,1550640,39252,2.53,0.8
935,2020-12-28,LIG,80,30,50,80,0,ITC,ITC3,7,Liguria,Liguria,1550640,39332,2.54,0.01
936,2021-02-25,LIG,3455,1349,2106,3325,130,ITC,ITC3,7,Liguria,Liguria,1550640,42787,2.76,0.22
937,2021-04-30,LIG,14346,6389,7957,5778,8568,ITC,ITC3,7,Liguria,Liguria,1550640,57133,3.68,0.93
938,2021-01-09,LIG,1335,481,854,1335,0,ITC,ITC3,7,Liguria,Liguria,1550640,58468,3.77,0.09
939,2021-04-04,LIG,756,366,390,507,249,ITC,ITC3,7,Liguria,Liguria,1550640,59224,3.82,0.05
940,2021-02-13,LIG,1080,508,572,800,280,ITC,ITC3,7,Liguria,Liguria,1550640,60304,3.89,0.07
941,2021-01-21,LIG,1103,385,718,672,431,ITC,ITC3,7,Liguria,Liguria,1550640,61407,3.96,0.07
942,2021-01-14,LIG,2980,1055,1925,2980,0,ITC,ITC3,7,Liguria,Liguria,1550640,64387,4.15,0.19
943,2021-03-12,LIG,6150,2814,3336,3681,2469,ITC,ITC3,7,Liguria,Liguria,1550640,70537,4.55,0.4
944,2021-01-28,LIG,2847,971,1876,39,2808,ITC,ITC3,7,Liguria,Liguria,1550640,73384,4.73,0.18
945,2021-03-26,LIG,9121,3855,5266,5967,3154,ITC,ITC3,7,Liguria,Liguria,1550640,82505,5.32,0.59
946,2021-02-18,LIG,2761,1126,1635,2430,331,ITC,ITC3,7,Liguria,Liguria,1550640,85266,5.5,0.18
947,2021-05-31,LIG,14316,7094,7222,8924,5392,ITC,ITC3,7,Liguria,Liguria,1550640,99582,6.42,0.92
948,2021-05-14,LIG,12875,5647,7228,8578,4297,ITC,ITC3,7,Liguria,Liguria,1550640,112457,7.25,0.83
949,2021-02-20,LIG,1335,637,698,1334,1,ITC,ITC3,7,Liguria,Liguria,1550640,113792,7.34,0.09
950,2021-04-26,LIG,10446,4914,5532,7820,2626,ITC,ITC3,7,Liguria,Liguria,1550640,124238,8.01,0.67
951,2021-02-21,LIG,869,491,378,865,4,ITC,ITC3,7,Liguria,Liguria,1550640,125107,8.07,0.06
952,2021-02-04,LIG,2817,986,1831,179,2638,ITC,ITC3,7,Liguria,Liguria,1550640,127924,8.25,0.18
953,2021-01-18,LIG,2137,745,1392,1980,157,ITC,ITC3,7,Liguria,Liguria,1550640,130061,8.39,0.14
954,2021-05-29,LIG,6799,3224,3575,3960,2839,ITC,ITC3,7,Liguria,Liguria,1550640,136860,8.83,0.44
955,2021-04-23,LIG,14672,6637,8035,8552,6120,ITC,ITC3,7,Liguria,Liguria,1550640,151532,9.77,0.95
956,2021-04-16,LIG,11969,5279,6690,10159,1810,ITC,ITC3,7,Liguria,Liguria,1550640,163501,10.54,0.77
957,2021-03-11,LIG,6351,3053,3298,4345,2006,ITC,ITC3,7,Liguria,Liguria,1550640,169852,10.95,0.41
958,2021-01-13,LIG,2754,1013,1741,2754,0,ITC,ITC3,7,Liguria,Liguria,1550640,172606,11.13,0.18
959,2021-03-14,LIG,1659,752,907,1055,604,ITC,ITC3,7,Liguria,Liguria,1550640,174265,11.24,0.11
960,2021-01-23,LIG,809,295,514,153,656,ITC,ITC3,7,Liguria,Liguria,1550640,175074,11.29,0.05
961,2021-05-17,LIG,11828,5358,6470,8526,3302,ITC,ITC3,7,Liguria,Liguria,1550640,186902,12.05,0.76
962,2021-01-30,LIG,1660,566,1094,24,1636,ITC,ITC3,7,Liguria,Liguria,1550640,188562,12.16,0.11
963,2021-03-28,LIG,1141,511,630,390,751,ITC,ITC3,7,Liguria,Liguria,1550640,189703,12.23,0.07
964,2021-03-19,LIG,5294,2234,3060,2149,3145,ITC,ITC3,7,Liguria,Liguria,1550640,194997,12.58,0.34
965,2021-05-08,LIG,7527,3332,4195,2314,5213,ITC,ITC3,7,Liguria,Liguria,1550640,202524,13.06,0.49
966,2021-02-11,LIG,1979,767,1212,1103,876,ITC,ITC3,7,Liguria,Liguria,1550640,204503,13.19,0.13
967,2021-05-22,LIG,6551,3195,3356,4943,1608,ITC,ITC3,7,Liguria,Liguria,1550640,211054,13.61,0.42
968,2021-04-02,LIG,11670,5116,6554,9184,2486,ITC,ITC3,7,Liguria,Liguria,1550640,222724,14.36,0.75
969,2021-05-10,LIG,12505,5504,7001,6132,6373,ITC,ITC3,7,Liguria,Liguria,1550640,235229,15.17,0.81
970,2021-05-03,LIG,13266,5918,7348,6454,6812,ITC,ITC3,7,Liguria,Liguria,1550640,248495,16.03,0.86
971,2021-03-21,LIG,550,220,330,69,481,ITC,ITC3,7,Liguria,Liguria,1550640,249045,16.06,0.04
972,2021-02-06,LIG,1892,768,1124,145,1747,ITC,ITC3,7,Liguria,Liguria,1550640,250937,16.18,0.12
973,2021-05-12,LIG,11895,5331,6564,6555,5340,ITC,ITC3,7,Liguria,Liguria,1550640,262832,16.95,0.77
974,2021-05-19,LIG,13526,5946,7580,10407,3119,ITC,ITC3,7,Liguria,Liguria,1550640,276358,17.82,0.87
975,2021-03-23,LIG,9036,4082,4954,5827,3209,ITC,ITC3,7,Liguria,Liguria,1550640,285394,18.4,0.58
976,2021-02-01,LIG,2557,922,1635,90,2467,ITC,ITC3,7,Liguria,Liguria,1550640,287951,18.57,0.16
977,2021-05-26,LIG,16153,8009,8144,11999,4154,ITC,ITC3,7,Liguria,Liguria,1550640,304104,19.61,1.04
978,2021-03-30,LIG,12142,5378,6764,8753,3389,ITC,ITC3,7,Liguria,Liguria,1550640,316246,20.39,0.78
979,2021-04-07,LIG,13583,6031,7552,11294,2289,ITC,ITC3,7,Liguria,Liguria,1550640,329829,21.27,0.88
980,2021-02-23,LIG,3806,1559,2247,3697,109,ITC,ITC3,7,Liguria,Liguria,1550640,333635,21.52,0.25
981,2021-03-04,LIG,4738,2118,2620,3891,847,ITC,ITC3,7,Liguria,Liguria,1550640,338373,21.82,0.31
982,2021-02-28,LIG,1058,580,478,1049,9,ITC,ITC3,7,Liguria,Liguria,1550640,339431,21.89,0.07
983,2021-04-19,LIG,12807,5613,7194,8999,3808,ITC,ITC3,7,Liguria,Liguria,1550640,352238,22.72,0.83
984,2021-05-24,LIG,11654,5421,6233,9175,2479,ITC,ITC3,7,Liguria,Liguria,1550640,363892,23.47,0.75
985,2021-05-07,LIG,13566,6020,7546,5782,7784,ITC,ITC3,7,Liguria,Liguria,1550640,377458,24.34,0.87
986,2021-03-02,LIG,4074,1689,2385,3764,310,ITC,ITC3,7,Liguria,Liguria,1550640,381532,24.6,0.26
987,2021-04-21,LIG,14244,6432,7812,8922,5322,ITC,ITC3,7,Liguria,Liguria,1550640,395776,25.52,0.92
988,2021-05-05,LIG,13668,6122,7546,5251,8417,ITC,ITC3,7,Liguria,Liguria,1550640,409444,26.4,0.88
989,2021-03-16,LIG,6073,2722,3351,2349,3724,ITC,ITC3,7,Liguria,Liguria,1550640,415517,26.8,0.39
990,2021-01-11,LIG,2653,989,1664,2653,0,ITC,ITC3,7,Liguria,Liguria,1550640,418170,26.97,0.17
991,2021-01-25,LIG,2723,888,1835,478,2245,ITC,ITC3,7,Liguria,Liguria,1550640,420893,27.14,0.18
992,2021-05-27,LIG,16339,8225,8114,12399,3940,ITC,ITC3,7,Liguria,Liguria,1550640,437232,28.2,1.05
993,2021-02-09,LIG,1936,689,1247,256,1680,ITC,ITC3,7,Liguria,Liguria,1550640,439168,28.32,0.12
994,2021-02-16,LIG,2397,954,1443,2004,393,ITC,ITC3,7,Liguria,Liguria,1550640,441565,28.48,0.15
995,2021-04-14,LIG,13028,5658,7370,10826,2202,ITC,ITC3,7,Liguria,Liguria,1550640,454593,29.32,0.84
996,2021-01-04,LIG,2615,854,1761,2615,0,ITC,ITC3,7,Liguria,Liguria,1550640,457208,29.49,0.17
997,2021-03-06,LIG,3304,1842,1462,2599,705,ITC,ITC3,7,Liguria,Liguria,1550640,460512,29.7,0.21
998,2021-05-09,LIG,2825,1245,1580,1115,1710,ITC,ITC3,7,Liguria,Liguria,1550640,463337,29.88,0.18
999,2021-01-22,LIG,1817,604,1213,1331,486,ITC,ITC3,7,Liguria,Liguria,1550640,465154,30.0,0.12
1000,2021-05-04,LIG,13601,6079,7522,5374,8227,ITC,ITC3,7,Liguria,Liguria,1550640,478755,30.87,0.88
1001,2021-02-02,LIG,2668,1005,1663,134,2534,ITC,ITC3,7,Liguria,Liguria,1550640,481423,31.05,0.17
1002,2021-05-15,LIG,7184,3195,3989,4297,2887,ITC,ITC3,7,Liguria,Liguria,1550640,488607,31.51,0.46
1003,2021-01-16,LIG,1278,557,721,1278,0,ITC,ITC3,7,Liguria,Liguria,1550640,489885,31.59,0.08
1004,2021-04-28,LIG,14442,6519,7923,6458,7984,ITC,ITC3,7,Liguria,Liguria,1550640,504327,32.52,0.93
1005,2020-12-30,LIG,12,5,7,12,0,ITC,ITC3,7,Liguria,Liguria,1550640,504339,32.52,0.0
1006,2021-04-11,LIG,4248,1930,2318,3999,249,ITC,ITC3,7,Liguria,Liguria,1550640,508587,32.8,0.27
1007,2021-04-18,LIG,2613,1164,1449,2145,468,ITC,ITC3,7,Liguria,Liguria,1550640,511200,32.97,0.17
1008,2021-01-27,LIG,1744,603,1141,141,1603,ITC,ITC3,7,Liguria,Liguria,1550640,512944,33.08,0.11
1009,2021-05-21,LIG,12831,5950,6881,9706,3125,ITC,ITC3,7,Liguria,Liguria,1550640,525775,33.91,0.83
1010,2021-03-18,LIG,4981,2124,2857,2008,2973,ITC,ITC3,7,Liguria,Liguria,1550640,530756,34.23,0.32
1011,2021-04-01,LIG,12374,5467,6907,9604,2770,ITC,ITC3,7,Liguria,Liguria,1550640,543130,35.03,0.8
1012,2021-02-03,LIG,2314,790,1524,55,2259,ITC,ITC3,7,Liguria,Liguria,1550640,545444,35.18,0.15
1013,2021-05-16,LIG,3693,1855,1838,2133,1560,ITC,ITC3,7,Liguria,Liguria,1550640,549137,35.41,0.24
1014,2021-02-05,LIG,2673,986,1687,304,2369,ITC,ITC3,7,Liguria,Liguria,1550640,551810,35.59,0.17
1015,2021-04-10,LIG,7883,3556,4327,6969,914,ITC,ITC3,7,Liguria,Liguria,1550640,559693,36.09,0.51
1016,2020-12-31,LIG,989,354,635,989,0,ITC,ITC3,7,Liguria,Liguria,1550640,560682,36.16,0.06
1017,2021-04-17,LIG,7383,3217,4166,6633,750,ITC,ITC3,7,Liguria,Liguria,1550640,568065,36.63,0.48
1018,2021-01-07,LIG,3229,1095,2134,3229,0,ITC,ITC3,7,Liguria,Liguria,1550640,571294,36.84,0.21
1019,2021-05-01,LIG,7131,3253,3878,1332,5799,ITC,ITC3,7,Liguria,Liguria,1550640,578425,37.3,0.46
1020,2021-03-05,LIG,4869,2150,2719,3737,1132,ITC,ITC3,7,Liguria,Liguria,1550640,583294,37.62,0.31
1021,2021-01-01,LIG,144,55,89,144,0,ITC,ITC3,7,Liguria,Liguria,1550640,583438,37.63,0.01
1022,2021-04-13,LIG,13076,5866,7210,11052,2024,ITC,ITC3,7,Liguria,Liguria,1550640,596514,38.47,0.84
1023,2021-03-27,LIG,3920,1537,2383,2524,1396,ITC,ITC3,7,Liguria,Liguria,1550640,600434,38.72,0.25
1024,2021-05-30,LIG,3275,1603,1672,1364,1911,ITC,ITC3,7,Liguria,Liguria,1550640,603709,38.93,0.21
1025,2021-05-13,LIG,13024,5848,7176,8811,4213,ITC,ITC3,7,Liguria,Liguria,1550640,616733,39.77,0.84
1026,2021-01-06,LIG,1660,616,1044,1660,0,ITC,ITC3,7,Liguria,Liguria,1550640,618393,39.88,0.11
1027,2021-01-15,LIG,2255,754,1501,2255,0,ITC,ITC3,7,Liguria,Liguria,1550640,620648,40.03,0.15
1028,2021-04-25,LIG,1936,921,1015,1521,415,ITC,ITC3,7,Liguria,Liguria,1550640,622584,40.15,0.12
1029,2021-03-13,LIG,3827,1616,2211,2972,855,ITC,ITC3,7,Liguria,Liguria,1550640,626411,40.4,0.25
1030,2021-03-20,LIG,2316,995,1321,1142,1174,ITC,ITC3,7,Liguria,Liguria,1550640,628727,40.55,0.15
1031,2021-04-08,LIG,13723,6156,7567,11680,2043,ITC,ITC3,7,Liguria,Liguria,1550640,642450,41.43,0.88
1032,2021-02-17,LIG,2688,1181,1507,2262,426,ITC,ITC3,7,Liguria,Liguria,1550640,645138,41.6,0.17
1033,2021-01-05,LIG,2879,896,1983,2879,0,ITC,ITC3,7,Liguria,Liguria,1550640,648017,41.79,0.19
1034,2021-04-22,LIG,13816,6194,7622,8746,5070,ITC,ITC3,7,Liguria,Liguria,1550640,661833,42.68,0.89
1035,2021-05-23,LIG,2305,1119,1186,1182,1123,ITC,ITC3,7,Liguria,Liguria,1550640,664138,42.83,0.15
1036,2021-04-03,LIG,5404,2497,2907,4461,943,ITC,ITC3,7,Liguria,Liguria,1550640,669542,43.18,0.35
1037,2021-02-12,LIG,1927,689,1238,895,1032,ITC,ITC3,7,Liguria,Liguria,1550640,671469,43.3,0.12
1038,2021-05-28,LIG,15971,7904,8067,11537,4434,ITC,ITC3,7,Liguria,Liguria,1550640,687440,44.33,1.03
1039,2021-04-15,LIG,11817,5218,6599,9965,1852,ITC,ITC3,7,Liguria,Liguria,1550640,699257,45.09,0.76
1040,2021-03-03,LIG,4580,1847,2733,3554,1026,ITC,ITC3,7,Liguria,Liguria,1550640,703837,45.39,0.3
1041,2021-02-24,LIG,3763,1560,2203,3505,258,ITC,ITC3,7,Liguria,Liguria,1550640,707600,45.63,0.24
1042,2020-12-29,LIG,125,33,92,125,0,ITC,ITC3,7,Liguria,Liguria,1550640,707725,45.64,0.01
1043,2021-01-12,LIG,2459,885,1574,2459,0,ITC,ITC3,7,Liguria,Liguria,1550640,710184,45.8,0.16
1044,2021-05-25,LIG,13718,6598,7120,10729,2989,ITC,ITC3,7,Liguria,Liguria,1550640,723902,46.68,0.88
1045,2021-03-22,LIG,7663,3399,4264,4727,2936,ITC,ITC3,7,Liguria,Liguria,1550640,731565,47.18,0.49
1046,2021-05-18,LIG,13320,6010,7310,10035,3285,ITC,ITC3,7,Liguria,Liguria,1550640,744885,48.04,0.86
1047,2021-02-14,LIG,233,122,111,233,0,ITC,ITC3,7,Liguria,Liguria,1550640,745118,48.05,0.02
1048,2021-02-07,LIG,407,153,254,2,405,ITC,ITC3,7,Liguria,Liguria,1550640,745525,48.08,0.03
1049,2021-05-20,LIG,12814,5941,6873,8796,4018,ITC,ITC3,7,Liguria,Liguria,1550640,758339,48.9,0.83
1050,2021-05-02,LIG,3876,1767,2109,505,3371,ITC,ITC3,7,Liguria,Liguria,1550640,762215,49.15,0.25
1051,2021-01-20,LIG,1550,555,995,1538,12,ITC,ITC3,7,Liguria,Liguria,1550640,763765,49.25,0.1
1052,2021-01-29,LIG,3079,1064,2015,67,3012,ITC,ITC3,7,Liguria,Liguria,1550640,766844,49.45,0.2
1053,2021-05-11,LIG,13671,6177,7494,7069,6602,ITC,ITC3,7,Liguria,Liguria,1550640,780515,50.34,0.88
1054,2021-03-29,LIG,10437,4509,5928,7308,3129,ITC,ITC3,7,Liguria,Liguria,1550640,790952,51.01,0.67
1055,2021-01-08,LIG,2926,999,1927,2926,0,ITC,ITC3,7,Liguria,Liguria,1550640,793878,51.2,0.19
1056,2021-02-27,LIG,1888,921,967,1759,129,ITC,ITC3,7,Liguria,Liguria,1550640,795766,51.32,0.12
1057,2021-02-10,LIG,2314,837,1477,1019,1295,ITC,ITC3,7,Liguria,Liguria,1550640,798080,51.47,0.15
1058,2021-05-06,LIG,14465,6404,8061,6165,8300,ITC,ITC3,7,Liguria,Liguria,1550640,812545,52.4,0.93
1059,2021-03-17,LIG,5552,2368,3184,2473,3079,ITC,ITC3,7,Liguria,Liguria,1550640,818097,52.76,0.36
1060,2021-04-06,LIG,13171,5857,7314,10931,2240,ITC,ITC3,7,Liguria,Liguria,1550640,831268,53.61,0.85
1061,2021-02-08,LIG,1976,741,1235,306,1670,ITC,ITC3,7,Liguria,Liguria,1550640,833244,53.74,0.13
1062,2020-12-27,LIG,135,56,79,135,0,ITC,ITC3,7,Liguria,Liguria,1550640,833379,53.74,0.01
1063,2021-02-15,LIG,2262,839,1423,1865,397,ITC,ITC3,7,Liguria,Liguria,1550640,835641,53.89,0.15
1064,2021-01-03,LIG,734,230,504,734,0,ITC,ITC3,7,Liguria,Liguria,1550640,836375,53.94,0.05
1065,2021-04-20,LIG,14207,6503,7704,9861,4346,ITC,ITC3,7,Liguria,Liguria,1550640,850582,54.85,0.92
1066,2021-01-10,LIG,648,262,386,648,0,ITC,ITC3,7,Liguria,Liguria,1550640,851230,54.9,0.04
1067,2021-03-01,LIG,3506,1430,2076,3384,122,ITC,ITC3,7,Liguria,Liguria,1550640,854736,55.12,0.23
1068,2021-01-24,LIG,756,237,519,113,643,ITC,ITC3,7,Liguria,Liguria,1550640,855492,55.17,0.05
1069,2021-03-15,LIG,7193,3056,4137,4492,2701,ITC,ITC3,7,Liguria,Liguria,1550640,862685,55.63,0.46
1070,2021-04-05,LIG,3976,1751,2225,2327,1649,ITC,ITC3,7,Liguria,Liguria,1550640,866661,55.89,0.26
1071,2021-01-31,LIG,624,270,354,9,615,ITC,ITC3,7,Liguria,Liguria,1550640,867285,55.93,0.04
1072,2021-01-26,LIG,2492,808,1684,21,2471,ITC,ITC3,7,Liguria,Liguria,1550640,869777,56.09,0.16
1073,2021-01-02,LIG,691,245,446,691,0,ITC,ITC3,7,Liguria,Liguria,1550640,870468,56.14,0.04
1074,2021-03-07,LIG,1858,1085,773,1557,301,ITC,ITC3,7,Liguria,Liguria,1550640,872326,56.26,0.12
1075,2021-03-09,LIG,5930,2753,3177,4500,1430,ITC,ITC3,7,Liguria,Liguria,1550640,878256,56.64,0.38
1076,2021-06-02,LIG,8531,4343,4188,5364,3167,ITC,ITC3,7,Liguria,Liguria,1550640,886787,57.19,0.55
1077,2021-03-25,LIG,9593,4080,5513,6200,3393,ITC,ITC3,7,Liguria,Liguria,1550640,896380,57.81,0.62
1078,2021-03-08,LIG,5629,2459,3170,3940,1689,ITC,ITC3,7,Liguria,Liguria,1550640,902009,58.17,0.36
1079,2021-02-19,LIG,3213,1305,1908,3037,176,ITC,ITC3,7,Liguria,Liguria,1550640,905222,58.38,0.21
1080,2021-06-01,LIG,15811,7901,7910,10601,5210,ITC,ITC3,7,Liguria,Liguria,1550640,921033,59.4,1.02
1081,2021-04-24,LIG,8169,3785,4384,5018,3151,ITC,ITC3,7,Liguria,Liguria,1550640,929202,59.92,0.53
1082,2021-02-26,LIG,3765,1523,2242,3437,328,ITC,ITC3,7,Liguria,Liguria,1550640,932967,60.17,0.24
1083,2021-03-10,LIG,5877,2839,3038,3971,1906,ITC,ITC3,7,Liguria,Liguria,1550640,938844,60.55,0.38
1084,2021-02-22,LIG,3334,1467,1867,3192,142,ITC,ITC3,7,Liguria,Liguria,1550640,942178,60.76,0.22
1085,2021-04-27,LIG,14735,6675,8060,7156,7579,ITC,ITC3,7,Liguria,Liguria,1550640,956913,61.71,0.95
1086,2021-04-29,LIG,15548,6974,8574,6731,8817,ITC,ITC3,7,Liguria,Liguria,1550640,972461,62.71,1.0
1087,2021-01-17,LIG,862,300,562,862,0,ITC,ITC3,7,Liguria,Liguria,1550640,973323,62.77,0.06
1088,2021-04-12,LIG,12381,5475,6906,10362,2019,ITC,ITC3,7,Liguria,Liguria,1550640,985704,63.57,0.8
1089,2021-01-19,LIG,1371,438,933,1281,90,ITC,ITC3,7,Liguria,Liguria,1550640,987075,63.66,0.09
1090,2021-03-24,LIG,8942,3833,5109,5656,3286,ITC,ITC3,7,Liguria,Liguria,1550640,996017,64.23,0.58
1091,2021-04-24,PUG,29234,13310,15924,25291,3943,ITF,ITF4,16,Puglia,Puglia,4029053,29234,0.73,0.73
1092,2021-02-19,PUG,4730,2009,2721,4338,392,ITF,ITF4,16,Puglia,Puglia,4029053,33964,0.84,0.12
1093,2021-04-19,PUG,27548,12781,14767,24502,3046,ITF,ITF4,16,Puglia,Puglia,4029053,61512,1.53,0.68
1094,2021-01-07,PUG,5716,2457,3259,5716,0,ITF,ITF4,16,Puglia,Puglia,4029053,67228,1.67,0.14
1095,2021-01-16,PUG,2507,1033,1474,2507,0,ITF,ITF4,16,Puglia,Puglia,4029053,69735,1.73,0.06
1096,2021-03-16,PUG,9867,4685,5182,3509,6358,ITF,ITF4,16,Puglia,Puglia,4029053,79602,1.98,0.24
1097,2021-04-28,PUG,19720,8838,10882,14970,4750,ITF,ITF4,16,Puglia,Puglia,4029053,99322,2.47,0.49
1098,2021-02-14,PUG,787,348,439,663,124,ITF,ITF4,16,Puglia,Puglia,4029053,100109,2.48,0.02
1099,2021-01-28,PUG,5472,2277,3195,471,5001,ITF,ITF4,16,Puglia,Puglia,4029053,105581,2.62,0.14
1100,2021-02-07,PUG,1579,669,910,253,1326,ITF,ITF4,16,Puglia,Puglia,4029053,107160,2.66,0.04
1101,2021-05-01,PUG,27473,12581,14892,16825,10648,ITF,ITF4,16,Puglia,Puglia,4029053,134633,3.34,0.68
1102,2021-04-12,PUG,29101,13707,15394,26276,2825,ITF,ITF4,16,Puglia,Puglia,4029053,163734,4.06,0.72
1103,2021-01-21,PUG,2132,904,1228,1271,861,ITF,ITF4,16,Puglia,Puglia,4029053,165866,4.12,0.05
1104,2021-01-02,PUG,2949,1301,1648,2949,0,ITF,ITF4,16,Puglia,Puglia,4029053,168815,4.19,0.07
1105,2021-03-26,PUG,11541,5421,6120,6896,4645,ITF,ITF4,16,Puglia,Puglia,4029053,180356,4.48,0.29
1106,2021-03-28,PUG,3527,1650,1877,1202,2325,ITF,ITF4,16,Puglia,Puglia,4029053,183883,4.56,0.09
1107,2021-06-01,PUG,32799,16139,16660,20902,11897,ITF,ITF4,16,Puglia,Puglia,4029053,216682,5.38,0.81
1108,2021-03-29,PUG,12905,6012,6893,6169,6736,ITF,ITF4,16,Puglia,Puglia,4029053,229587,5.7,0.32
1109,2021-05-15,PUG,42907,18699,24208,23301,19606,ITF,ITF4,16,Puglia,Puglia,4029053,272494,6.76,1.06
1110,2021-03-12,PUG,13934,6110,7824,10008,3926,ITF,ITF4,16,Puglia,Puglia,4029053,286428,7.11,0.35
1111,2021-02-23,PUG,9349,4422,4927,8874,475,ITF,ITF4,16,Puglia,Puglia,4029053,295777,7.34,0.23
1112,2021-02-26,PUG,13714,5027,8687,12680,1034,ITF,ITF4,16,Puglia,Puglia,4029053,309491,7.68,0.34
1113,2020-12-31,PUG,1634,782,852,1634,0,ITF,ITF4,16,Puglia,Puglia,4029053,311125,7.72,0.04
1114,2021-03-05,PUG,17315,6870,10445,15068,2247,ITF,ITF4,16,Puglia,Puglia,4029053,328440,8.15,0.43
1115,2021-02-28,PUG,6046,1806,4240,5860,186,ITF,ITF4,16,Puglia,Puglia,4029053,334486,8.3,0.15
1116,2021-05-03,PUG,33116,14784,18332,22497,10619,ITF,ITF4,16,Puglia,Puglia,4029053,367602,9.12,0.82
1117,2021-03-07,PUG,4922,1943,2979,4351,571,ITF,ITF4,16,Puglia,Puglia,4029053,372524,9.25,0.12
1118,2021-01-23,PUG,3040,1294,1746,886,2154,ITF,ITF4,16,Puglia,Puglia,4029053,375564,9.32,0.08
1119,2021-04-02,PUG,12593,5767,6826,8073,4520,ITF,ITF4,16,Puglia,Puglia,4029053,388157,9.63,0.31
1120,2021-04-16,PUG,35845,16845,19000,32564,3281,ITF,ITF4,16,Puglia,Puglia,4029053,424002,10.52,0.89
1121,2021-02-18,PUG,4378,1846,2532,3774,604,ITF,ITF4,16,Puglia,Puglia,4029053,428380,10.63,0.11
1122,2021-02-11,PUG,3701,1402,2299,2423,1278,ITF,ITF4,16,Puglia,Puglia,4029053,432081,10.72,0.09
1123,2021-05-10,PUG,37362,16477,20885,19509,17853,ITF,ITF4,16,Puglia,Puglia,4029053,469443,11.65,0.93
1124,2021-04-04,PUG,5945,2953,2992,5940,5,ITF,ITF4,16,Puglia,Puglia,4029053,475388,11.8,0.15
1125,2021-03-21,PUG,2692,1226,1466,588,2104,ITF,ITF4,16,Puglia,Puglia,4029053,478080,11.87,0.07
1126,2021-05-24,PUG,34860,16145,18715,24347,10513,ITF,ITF4,16,Puglia,Puglia,4029053,512940,12.73,0.87
1127,2021-01-30,PUG,5527,2514,3013,410,5117,ITF,ITF4,16,Puglia,Puglia,4029053,518467,12.87,0.14
1128,2021-01-31,PUG,1813,828,985,74,1739,ITF,ITF4,16,Puglia,Puglia,4029053,520280,12.91,0.04
1129,2021-05-29,PUG,29413,13873,15540,20339,9074,ITF,ITF4,16,Puglia,Puglia,4029053,549693,13.64,0.73
1130,2021-05-22,PUG,34078,15607,18471,23848,10230,ITF,ITF4,16,Puglia,Puglia,4029053,583771,14.49,0.85
1131,2021-04-09,PUG,21842,9392,12450,17220,4622,ITF,ITF4,16,Puglia,Puglia,4029053,605613,15.03,0.54
1132,2021-02-25,PUG,11959,5055,6904,10793,1166,ITF,ITF4,16,Puglia,Puglia,4029053,617572,15.33,0.3
1133,2021-05-20,PUG,32698,14542,18156,20622,12076,ITF,ITF4,16,Puglia,Puglia,4029053,650270,16.14,0.81
1134,2021-05-06,PUG,39301,17152,22149,19657,19644,ITF,ITF4,16,Puglia,Puglia,4029053,689571,17.11,0.98
1135,2021-05-13,PUG,38328,17049,21279,21293,17035,ITF,ITF4,16,Puglia,Puglia,4029053,727899,18.07,0.95
1136,2021-03-17,PUG,10345,4702,5643,4171,6174,ITF,ITF4,16,Puglia,Puglia,4029053,738244,18.32,0.26
1137,2021-02-09,PUG,3840,1570,2270,2168,1672,ITF,ITF4,16,Puglia,Puglia,4029053,742084,18.42,0.1
1138,2021-03-24,PUG,13015,6006,7009,5732,7283,ITF,ITF4,16,Puglia,Puglia,4029053,755099,18.74,0.32
1139,2021-01-26,PUG,5360,2397,2963,570,4790,ITF,ITF4,16,Puglia,Puglia,4029053,760459,18.87,0.13
1140,2021-03-31,PUG,14050,6357,7693,8494,5556,ITF,ITF4,16,Puglia,Puglia,4029053,774509,19.22,0.35
1141,2021-02-02,PUG,4344,1846,2498,593,3751,ITF,ITF4,16,Puglia,Puglia,4029053,778853,19.33,0.11
1142,2021-04-17,PUG,39842,18878,20964,36276,3566,ITF,ITF4,16,Puglia,Puglia,4029053,818695,20.32,0.99
1143,2021-01-14,PUG,4070,1589,2481,4070,0,ITF,ITF4,16,Puglia,Puglia,4029053,822765,20.42,0.1
1144,2021-04-26,PUG,26095,11949,14146,22864,3231,ITF,ITF4,16,Puglia,Puglia,4029053,848860,21.07,0.65
1145,2021-01-09,PUG,4886,2251,2635,4886,0,ITF,ITF4,16,Puglia,Puglia,4029053,853746,21.19,0.12
1146,2021-03-14,PUG,3320,1429,1891,2509,811,ITF,ITF4,16,Puglia,Puglia,4029053,857066,21.27,0.08
1147,2021-04-05,PUG,12693,6167,6526,12160,533,ITF,ITF4,16,Puglia,Puglia,4029053,869759,21.59,0.32
1148,2021-05-25,PUG,33512,15240,18272,20472,13040,ITF,ITF4,16,Puglia,Puglia,4029053,903271,22.42,0.83
1149,2021-03-19,PUG,7956,3652,4304,3411,4545,ITF,ITF4,16,Puglia,Puglia,4029053,911227,22.62,0.2
1150,2021-05-08,PUG,53950,22816,31134,24315,29635,ITF,ITF4,16,Puglia,Puglia,4029053,965177,23.96,1.34
1151,2021-01-12,PUG,4212,1772,2440,4212,0,ITF,ITF4,16,Puglia,Puglia,4029053,969389,24.06,0.1
1152,2021-04-07,PUG,15328,6790,8538,8656,6672,ITF,ITF4,16,Puglia,Puglia,4029053,984717,24.44,0.38
1153,2021-05-27,PUG,38956,17913,21043,22525,16431,ITF,ITF4,16,Puglia,Puglia,4029053,1023673,25.41,0.97
1154,2021-04-21,PUG,23055,10637,12418,19322,3733,ITF,ITF4,16,Puglia,Puglia,4029053,1046728,25.98,0.57
1155,2021-02-16,PUG,3379,1452,1927,2735,644,ITF,ITF4,16,Puglia,Puglia,4029053,1050107,26.06,0.08
1156,2021-03-02,PUG,16345,6070,10275,15045,1300,ITF,ITF4,16,Puglia,Puglia,4029053,1066452,26.47,0.41
1157,2021-05-12,PUG,36159,16069,20090,23788,12371,ITF,ITF4,16,Puglia,Puglia,4029053,1102611,27.37,0.9
1158,2021-05-05,PUG,38831,16969,21862,24700,14131,ITF,ITF4,16,Puglia,Puglia,4029053,1141442,28.33,0.96
1159,2021-05-19,PUG,25615,12143,13472,19318,6297,ITF,ITF4,16,Puglia,Puglia,4029053,1167057,28.97,0.64
1160,2021-03-25,PUG,10917,5299,5618,4682,6235,ITF,ITF4,16,Puglia,Puglia,4029053,1177974,29.24,0.27
1161,2021-02-10,PUG,3644,1436,2208,2134,1510,ITF,ITF4,16,Puglia,Puglia,4029053,1181618,29.33,0.09
1162,2021-05-23,PUG,17731,8295,9436,13930,3801,ITF,ITF4,16,Puglia,Puglia,4029053,1199349,29.77,0.44
1163,2021-05-28,PUG,41707,19432,22275,26820,14887,ITF,ITF4,16,Puglia,Puglia,4029053,1241056,30.8,1.04
1164,2021-03-10,PUG,14412,6250,8162,11294,3118,ITF,ITF4,16,Puglia,Puglia,4029053,1255468,31.16,0.36
1165,2021-02-21,PUG,2175,472,1703,2114,61,ITF,ITF4,16,Puglia,Puglia,4029053,1257643,31.21,0.05
1166,2021-06-03,PUG,43035,20623,22412,27049,15986,ITF,ITF4,16,Puglia,Puglia,4029053,1300678,32.28,1.07
1167,2021-02-04,PUG,5927,2366,3561,1195,4732,ITF,ITF4,16,Puglia,Puglia,4029053,1306605,32.43,0.15
1168,2021-05-17,PUG,32202,14753,17449,20568,11634,ITF,ITF4,16,Puglia,Puglia,4029053,1338807,33.23,0.8
1169,2021-04-23,PUG,29325,13625,15700,24119,5206,ITF,ITF4,16,Puglia,Puglia,4029053,1368132,33.96,0.73
1170,2021-03-04,PUG,15113,5903,9210,13715,1398,ITF,ITF4,16,Puglia,Puglia,4029053,1383245,34.33,0.38
1171,2021-05-07,PUG,49412,22033,27379,26162,23250,ITF,ITF4,16,Puglia,Puglia,4029053,1432657,35.56,1.23
1172,2021-02-15,PUG,3252,1268,1984,2632,620,ITF,ITF4,16,Puglia,Puglia,4029053,1435909,35.64,0.08
1173,2021-04-06,PUG,13581,6027,7554,6831,6750,ITF,ITF4,16,Puglia,Puglia,4029053,1449490,35.98,0.34
1174,2021-04-20,PUG,21082,9785,11297,17628,3454,ITF,ITF4,16,Puglia,Puglia,4029053,1470572,36.5,0.52
1175,2021-03-13,PUG,10387,4104,6283,8655,1732,ITF,ITF4,16,Puglia,Puglia,4029053,1480959,36.76,0.26
1176,2021-05-16,PUG,24357,10986,13371,12587,11770,ITF,ITF4,16,Puglia,Puglia,4029053,1505316,37.36,0.6
1177,2021-05-18,PUG,28222,12940,15282,15645,12577,ITF,ITF4,16,Puglia,Puglia,4029053,1533538,38.06,0.7
1178,2021-05-31,PUG,35001,16426,18575,22272,12729,ITF,ITF4,16,Puglia,Puglia,4029053,1568539,38.93,0.87
1179,2021-04-11,PUG,16443,7240,9203,14787,1656,ITF,ITF4,16,Puglia,Puglia,4029053,1584982,39.34,0.41
1180,2021-04-18,PUG,22539,10778,11761,21474,1065,ITF,ITF4,16,Puglia,Puglia,4029053,1607521,39.9,0.56
1181,2021-02-20,PUG,2969,1080,1889,2713,256,ITF,ITF4,16,Puglia,Puglia,4029053,1610490,39.97,0.07
1182,2021-04-25,PUG,11204,5196,6008,10047,1157,ITF,ITF4,16,Puglia,Puglia,4029053,1621694,40.25,0.28
1183,2021-02-27,PUG,14212,4812,9400,12987,1225,ITF,ITF4,16,Puglia,Puglia,4029053,1635906,40.6,0.35
1184,2021-01-01,PUG,148,61,87,148,0,ITF,ITF4,16,Puglia,Puglia,4029053,1636054,40.61,0.0
1185,2021-03-06,PUG,15974,5968,10006,13887,2087,ITF,ITF4,16,Puglia,Puglia,4029053,1652028,41.0,0.4
1186,2021-01-08,PUG,5597,2347,3250,5597,0,ITF,ITF4,16,Puglia,Puglia,4029053,1657625,41.14,0.14
1187,2021-01-15,PUG,4552,1866,2686,4552,0,ITF,ITF4,16,Puglia,Puglia,4029053,1662177,41.25,0.11
1188,2021-01-22,PUG,1409,578,831,991,418,ITF,ITF4,16,Puglia,Puglia,4029053,1663586,41.29,0.03
1189,2021-02-06,PUG,4546,1928,2618,1590,2956,ITF,ITF4,16,Puglia,Puglia,4029053,1668132,41.4,0.11
1190,2021-01-20,PUG,1545,540,1005,1537,8,ITF,ITF4,16,Puglia,Puglia,4029053,1669677,41.44,0.04
1191,2021-05-02,PUG,21253,9639,11614,14003,7250,ITF,ITF4,16,Puglia,Puglia,4029053,1690930,41.97,0.53
1192,2021-01-03,PUG,2007,943,1064,2007,0,ITF,ITF4,16,Puglia,Puglia,4029053,1692937,42.02,0.05
1193,2021-04-15,PUG,32385,15107,17278,28886,3499,ITF,ITF4,16,Puglia,Puglia,4029053,1725322,42.82,0.8
1194,2020-12-30,PUG,1,0,1,1,0,ITF,ITF4,16,Puglia,Puglia,4029053,1725323,42.82,0.0
1195,2021-04-27,PUG,26543,12015,14528,20958,5585,ITF,ITF4,16,Puglia,Puglia,4029053,1751866,43.48,0.66
1196,2021-03-08,PUG,14604,6087,8517,12205,2399,ITF,ITF4,16,Puglia,Puglia,4029053,1766470,43.84,0.36
1197,2021-01-24,PUG,1669,749,920,153,1516,ITF,ITF4,16,Puglia,Puglia,4029053,1768139,43.88,0.04
1198,2021-02-13,PUG,3726,1455,2271,3031,695,ITF,ITF4,16,Puglia,Puglia,4029053,1771865,43.98,0.09
1199,2021-05-09,PUG,30495,12488,18007,14938,15557,ITF,ITF4,16,Puglia,Puglia,4029053,1802360,44.73,0.76
1200,2021-01-29,PUG,6196,2661,3535,436,5760,ITF,ITF4,16,Puglia,Puglia,4029053,1808556,44.89,0.15
1201,2021-03-20,PUG,8255,3734,4521,3666,4589,ITF,ITF4,16,Puglia,Puglia,4029053,1816811,45.09,0.2
1202,2021-02-12,PUG,4165,1660,2505,3073,1092,ITF,ITF4,16,Puglia,Puglia,4029053,1820976,45.2,0.1
1203,2021-01-06,PUG,3946,1669,2277,3946,0,ITF,ITF4,16,Puglia,Puglia,4029053,1824922,45.29,0.1
1204,2021-05-04,PUG,34801,14679,20122,18399,16402,ITF,ITF4,16,Puglia,Puglia,4029053,1859723,46.16,0.86
1205,2021-03-22,PUG,9350,4555,4795,3705,5645,ITF,ITF4,16,Puglia,Puglia,4029053,1869073,46.39,0.23
1206,2021-03-15,PUG,11785,5626,6159,5284,6501,ITF,ITF4,16,Puglia,Puglia,4029053,1880858,46.68,0.29
1207,2021-01-17,PUG,1308,590,718,1239,69,ITF,ITF4,16,Puglia,Puglia,4029053,1882166,46.71,0.03
1208,2021-03-30,PUG,11873,5495,6378,5978,5895,ITF,ITF4,16,Puglia,Puglia,4029053,1894039,47.01,0.29
1209,2021-02-01,PUG,3965,1659,2306,375,3590,ITF,ITF4,16,Puglia,Puglia,4029053,1898004,47.11,0.1
1210,2021-01-25,PUG,3824,1681,2143,423,3401,ITF,ITF4,16,Puglia,Puglia,4029053,1901828,47.2,0.09
1211,2021-05-14,PUG,44569,20326,24243,28510,16059,ITF,ITF4,16,Puglia,Puglia,4029053,1946397,48.31,1.11
1212,2021-04-08,PUG,17444,7570,9874,11271,6173,ITF,ITF4,16,Puglia,Puglia,4029053,1963841,48.74,0.43
1213,2021-04-01,PUG,13505,6158,7347,7162,6343,ITF,ITF4,16,Puglia,Puglia,4029053,1977346,49.08,0.34
1214,2021-02-03,PUG,5036,2005,3031,730,4306,ITF,ITF4,16,Puglia,Puglia,4029053,1982382,49.2,0.12
1215,2021-03-23,PUG,10414,5002,5412,3944,6470,ITF,ITF4,16,Puglia,Puglia,4029053,1992796,49.46,0.26
1216,2021-05-21,PUG,37844,17713,20131,28183,9661,ITF,ITF4,16,Puglia,Puglia,4029053,2030640,50.4,0.94
1217,2021-02-08,PUG,3992,1610,2382,1597,2395,ITF,ITF4,16,Puglia,Puglia,4029053,2034632,50.5,0.1
1218,2021-02-17,PUG,4272,1744,2528,3670,602,ITF,ITF4,16,Puglia,Puglia,4029053,2038904,50.61,0.11
1219,2021-05-26,PUG,37229,17475,19754,26111,11118,ITF,ITF4,16,Puglia,Puglia,4029053,2076133,51.53,0.92
1220,2021-01-13,PUG,4540,1730,2810,4540,0,ITF,ITF4,16,Puglia,Puglia,4029053,2080673,51.64,0.11
1221,2021-03-18,PUG,9401,4254,5147,3284,6117,ITF,ITF4,16,Puglia,Puglia,4029053,2090074,51.88,0.23
1222,2021-01-27,PUG,4580,1931,2649,611,3969,ITF,ITF4,16,Puglia,Puglia,4029053,2094654,51.99,0.11
1223,2021-03-01,PUG,15090,5862,9228,13720,1370,ITF,ITF4,16,Puglia,Puglia,4029053,2109744,52.36,0.37
1224,2021-01-10,PUG,2348,1061,1287,2348,0,ITF,ITF4,16,Puglia,Puglia,4029053,2112092,52.42,0.06
1225,2020-12-27,PUG,509,252,257,509,0,ITF,ITF4,16,Puglia,Puglia,4029053,2112601,52.43,0.01
1226,2021-01-11,PUG,3753,1588,2165,3753,0,ITF,ITF4,16,Puglia,Puglia,4029053,2116354,52.53,0.09
1227,2021-04-22,PUG,22902,10466,12436,18034,4868,ITF,ITF4,16,Puglia,Puglia,4029053,2139256,53.1,0.57
1228,2021-01-19,PUG,1221,452,769,1211,10,ITF,ITF4,16,Puglia,Puglia,4029053,2140477,53.13,0.03
1229,2021-04-14,PUG,31796,15014,16782,28490,3306,ITF,ITF4,16,Puglia,Puglia,4029053,2172273,53.92,0.79
1230,2021-01-04,PUG,4507,2016,2491,4507,0,ITF,ITF4,16,Puglia,Puglia,4029053,2176780,54.03,0.11
1231,2021-03-09,PUG,13292,5791,7501,11284,2008,ITF,ITF4,16,Puglia,Puglia,4029053,2190072,54.36,0.33
1232,2021-01-18,PUG,1845,770,1075,1496,349,ITF,ITF4,16,Puglia,Puglia,4029053,2191917,54.4,0.05
1233,2021-04-30,PUG,34672,15504,19168,22724,11948,ITF,ITF4,16,Puglia,Puglia,4029053,2226589,55.26,0.86
1234,2021-04-13,PUG,28625,13566,15059,25228,3397,ITF,ITF4,16,Puglia,Puglia,4029053,2255214,55.97,0.71
1235,2021-03-27,PUG,12139,5703,6436,6978,5161,ITF,ITF4,16,Puglia,Puglia,4029053,2267353,56.28,0.3
1236,2021-02-05,PUG,5635,2273,3362,1333,4302,ITF,ITF4,16,Puglia,Puglia,4029053,2272988,56.41,0.14
1237,2021-04-10,PUG,30726,13029,17697,26502,4224,ITF,ITF4,16,Puglia,Puglia,4029053,2303714,57.18,0.76
1238,2021-05-11,PUG,32253,14189,18064,13915,18338,ITF,ITF4,16,Puglia,Puglia,4029053,2335967,57.98,0.8
1239,2021-04-03,PUG,10542,4634,5908,6988,3554,ITF,ITF4,16,Puglia,Puglia,4029053,2346509,58.24,0.26
1240,2021-05-30,PUG,20527,9826,10701,15586,4941,ITF,ITF4,16,Puglia,Puglia,4029053,2367036,58.75,0.51
1241,2021-03-11,PUG,14388,6198,8190,11279,3109,ITF,ITF4,16,Puglia,Puglia,4029053,2381424,59.11,0.36
1242,2021-06-02,PUG,26155,12827,13328,21488,4667,ITF,ITF4,16,Puglia,Puglia,4029053,2407579,59.76,0.65
1243,2021-02-22,PUG,9630,4537,5093,9298,332,ITF,ITF4,16,Puglia,Puglia,4029053,2417209,59.99,0.24
1244,2021-02-24,PUG,10034,4703,5331,9445,589,ITF,ITF4,16,Puglia,Puglia,4029053,2427243,60.24,0.25
1245,2021-01-05,PUG,5104,2249,2855,5104,0,ITF,ITF4,16,Puglia,Puglia,4029053,2432347,60.37,0.13
1246,2021-04-29,PUG,25949,12013,13936,19294,6655,ITF,ITF4,16,Puglia,Puglia,4029053,2458296,61.01,0.64
1247,2021-03-03,PUG,16669,6705,9964,14757,1912,ITF,ITF4,16,Puglia,Puglia,4029053,2474965,61.43,0.41
1248,2021-04-11,EMR,15262,6926,8336,12217,3045,ITH,ITH5,8,Emilia-Romagna,Emilia-Romagna,4459477,15262,0.34,0.34
1249,2021-02-11,EMR,4251,1416,2835,3411,840,ITH,ITH5,8,Emilia-Romagna,Emilia-Romagna,4459477,19513,0.44,0.1
1250,2021-03-08,EMR,12176,5063,7113,9502,2674,ITH,ITH5,8,Emilia-Romagna,Emilia-Romagna,4459477,31689,0.71,0.27
1251,2021-04-20,EMR,22601,10396,12205,14250,8351,ITH,ITH5,8,Emilia-Romagna,Emilia-Romagna,4459477,54290,1.22,0.51
1252,2021-03-30,EMR,23288,10293,12995,18251,5037,ITH,ITH5,8,Emilia-Romagna,Emilia-Romagna,4459477,77578,1.74,0.52
1253,2021-05-19,EMR,33557,14916,18641,18511,15046,ITH,ITH5,8,Emilia-Romagna,Emilia-Romagna,4459477,111135,2.49,0.75
1254,2021-06-02,EMR,23319,11628,11691,18734,4585,ITH,ITH5,8,Emilia-Romagna,Emilia-Romagna,4459477,134454,3.02,0.52
1255,2021-01-04,EMR,7311,2527,4784,7311,0,ITH,ITH5,8,Emilia-Romagna,Emilia-Romagna,4459477,141765,3.18,0.16
1256,2021-01-03,EMR,2762,943,1819,2762,0,ITH,ITH5,8,Emilia-Romagna,Emilia-Romagna,4459477,144527,3.24,0.06
1257,2021-05-16,EMR,25838,12166,13672,18728,7110,ITH,ITH5,8,Emilia-Romagna,Emilia-Romagna,4459477,170365,3.82,0.58
1258,2021-03-13,EMR,16078,6308,9770,10765,5313,ITH,ITH5,8,Emilia-Romagna,Emilia-Romagna,4459477,186443,4.18,0.36
1259,2021-05-02,EMR,25573,11648,13925,13584,11989,ITH,ITH5,8,Emilia-Romagna,Emilia-Romagna,4459477,212016,4.75,0.57
1260,2021-05-07,EMR,35149,16894,18255,23345,11804,ITH,ITH5,8,Emilia-Romagna,Emilia-Romagna,4459477,247165,5.54,0.79
1261,2021-02-10,EMR,4019,1383,2636,2764,1255,ITH,ITH5,8,Emilia-Romagna,Emilia-Romagna,4459477,251184,5.63,0.09
1262,2021-04-08,EMR,30836,14133,16703,25535,5301,ITH,ITH5,8,Emilia-Romagna,Emilia-Romagna,4459477,282020,6.32,0.69
1263,2021-02-17,EMR,6537,2763,3774,5765,772,ITH,ITH5,8,Emilia-Romagna,Emilia-Romagna,4459477,288557,6.47,0.15
1264,2021-03-25,EMR,21392,9348,12044,14404,6988,ITH,ITH5,8,Emilia-Romagna,Emilia-Romagna,4459477,309949,6.95,0.48
1265,2021-01-13,EMR,9074,2940,6134,9074,0,ITH,ITH5,8,Emilia-Romagna,Emilia-Romagna,4459477,319023,7.15,0.2
1266,2021-04-23,EMR,29554,13809,15745,14675,14879,ITH,ITH5,8,Emilia-Romagna,Emilia-Romagna,4459477,348577,7.82,0.66
1267,2021-01-11,EMR,9348,3273,6075,9348,0,ITH,ITH5,8,Emilia-Romagna,Emilia-Romagna,4459477,357925,8.03,0.21
1268,2021-03-04,EMR,16443,5347,11096,13430,3013,ITH,ITH5,8,Emilia-Romagna,Emilia-Romagna,4459477,374368,8.39,0.37
1269,2021-05-24,EMR,29637,13522,16115,18399,11238,ITH,ITH5,8,Emilia-Romagna,Emilia-Romagna,4459477,404005,9.06,0.66
1270,2021-01-29,EMR,10415,3497,6918,290,10125,ITH,ITH5,8,Emilia-Romagna,Emilia-Romagna,4459477,414420,9.29,0.23
1271,2021-02-15,EMR,2902,850,2052,2777,125,ITH,ITH5,8,Emilia-Romagna,Emilia-Romagna,4459477,417322,9.36,0.07
1272,2021-02-18,EMR,7039,2892,4147,6456,583,ITH,ITH5,8,Emilia-Romagna,Emilia-Romagna,4459477,424361,9.52,0.16
1273,2021-01-25,EMR,6457,2146,4311,207,6250,ITH,ITH5,8,Emilia-Romagna,Emilia-Romagna,4459477,430818,9.66,0.14
1274,2021-05-12,EMR,38802,18256,20546,29194,9608,ITH,ITH5,8,Emilia-Romagna,Emilia-Romagna,4459477,469620,10.53,0.87
1275,2021-03-16,EMR,12242,5027,7215,4934,7308,ITH,ITH5,8,Emilia-Romagna,Emilia-Romagna,4459477,481862,10.81,0.27
1276,2021-03-09,EMR,14705,5984,8721,10749,3956,ITH,ITH5,8,Emilia-Romagna,Emilia-Romagna,4459477,496567,11.14,0.33
1277,2021-05-23,EMR,25447,11853,13594,13885,11562,ITH,ITH5,8,Emilia-Romagna,Emilia-Romagna,4459477,522014,11.71,0.57
1278,2021-01-06,EMR,8285,2954,5331,8285,0,ITH,ITH5,8,Emilia-Romagna,Emilia-Romagna,4459477,530299,11.89,0.19
1279,2021-04-30,EMR,36563,16770,19793,21773,14790,ITH,ITH5,8,Emilia-Romagna,Emilia-Romagna,4459477,566862,12.71,0.82
1280,2021-03-11,EMR,17257,7136,10121,11407,5850,ITH,ITH5,8,Emilia-Romagna,Emilia-Romagna,4459477,584119,13.1,0.39
1281,2021-04-16,EMR,28859,13567,15292,20025,8834,ITH,ITH5,8,Emilia-Romagna,Emilia-Romagna,4459477,612978,13.75,0.65
1282,2021-02-25,EMR,9229,3497,5732,8275,954,ITH,ITH5,8,Emilia-Romagna,Emilia-Romagna,4459477,622207,13.95,0.21
1283,2021-04-15,EMR,29024,13810,15214,19354,9670,ITH,ITH5,8,Emilia-Romagna,Emilia-Romagna,4459477,651231,14.6,0.65
1284,2021-01-20,EMR,1325,270,1055,1324,1,ITH,ITH5,8,Emilia-Romagna,Emilia-Romagna,4459477,652556,14.63,0.03
1285,2021-03-10,EMR,18729,7683,11046,13087,5642,ITH,ITH5,8,Emilia-Romagna,Emilia-Romagna,4459477,671285,15.05,0.42
1286,2021-02-01,EMR,10320,3610,6710,362,9958,ITH,ITH5,8,Emilia-Romagna,Emilia-Romagna,4459477,681605,15.28,0.23
1287,2021-03-23,EMR,18698,8069,10629,12011,6687,ITH,ITH5,8,Emilia-Romagna,Emilia-Romagna,4459477,700303,15.7,0.42
1288,2021-01-18,EMR,3127,879,2248,2449,678,ITH,ITH5,8,Emilia-Romagna,Emilia-Romagna,4459477,703430,15.77,0.07
1289,2021-05-05,EMR,30062,13971,16091,18818,11244,ITH,ITH5,8,Emilia-Romagna,Emilia-Romagna,4459477,733492,16.45,0.67
1290,2021-01-23,EMR,2448,871,1577,443,2005,ITH,ITH5,8,Emilia-Romagna,Emilia-Romagna,4459477,735940,16.5,0.05
1291,2021-04-18,EMR,17496,8393,9103,12569,4927,ITH,ITH5,8,Emilia-Romagna,Emilia-Romagna,4459477,753436,16.9,0.39
1292,2021-01-10,EMR,7169,2683,4486,7169,0,ITH,ITH5,8,Emilia-Romagna,Emilia-Romagna,4459477,760605,17.06,0.16
1293,2021-03-27,EMR,21605,9047,12558,14699,6906,ITH,ITH5,8,Emilia-Romagna,Emilia-Romagna,4459477,782210,17.54,0.48
1294,2021-01-22,EMR,1829,477,1352,1088,741,ITH,ITH5,8,Emilia-Romagna,Emilia-Romagna,4459477,784039,17.58,0.04
1295,2021-04-13,EMR,23649,11091,12558,19347,4302,ITH,ITH5,8,Emilia-Romagna,Emilia-Romagna,4459477,807688,18.11,0.53
1296,2021-02-08,EMR,5227,1532,3695,2315,2912,ITH,ITH5,8,Emilia-Romagna,Emilia-Romagna,4459477,812915,18.23,0.12
1297,2021-02-22,EMR,7482,3091,4391,7210,272,ITH,ITH5,8,Emilia-Romagna,Emilia-Romagna,4459477,820397,18.4,0.17
1298,2021-03-28,EMR,13456,6001,7455,9592,3864,ITH,ITH5,8,Emilia-Romagna,Emilia-Romagna,4459477,833853,18.7,0.3
1299,2021-02-06,EMR,7601,2407,5194,2131,5470,ITH,ITH5,8,Emilia-Romagna,Emilia-Romagna,4459477,841454,18.87,0.17
1300,2021-02-20,EMR,5317,2094,3223,5054,263,ITH,ITH5,8,Emilia-Romagna,Emilia-Romagna,4459477,846771,18.99,0.12
1301,2021-05-31,EMR,29059,13319,15740,17941,11118,ITH,ITH5,8,Emilia-Romagna,Emilia-Romagna,4459477,875830,19.64,0.65
1302,2021-03-01,EMR,10092,3578,6514,7836,2256,ITH,ITH5,8,Emilia-Romagna,Emilia-Romagna,4459477,885922,19.87,0.23
1303,2021-05-04,EMR,29242,13691,15551,15586,13656,ITH,ITH5,8,Emilia-Romagna,Emilia-Romagna,4459477,915164,20.52,0.66
1304,2021-04-27,EMR,32082,14856,17226,19621,12461,ITH,ITH5,8,Emilia-Romagna,Emilia-Romagna,4459477,947246,21.24,0.72
1305,2021-01-15,EMR,7746,2403,5343,7746,0,ITH,ITH5,8,Emilia-Romagna,Emilia-Romagna,4459477,954992,21.41,0.17
1306,2021-02-27,EMR,10967,3999,6968,9229,1738,ITH,ITH5,8,Emilia-Romagna,Emilia-Romagna,4459477,965959,21.66,0.25
1307,2021-04-25,EMR,22343,10239,12104,14835,7508,ITH,ITH5,8,Emilia-Romagna,Emilia-Romagna,4459477,988302,22.16,0.5
1308,2021-01-08,EMR,10865,3580,7285,10865,0,ITH,ITH5,8,Emilia-Romagna,Emilia-Romagna,4459477,999167,22.41,0.24
1309,2021-05-20,EMR,39895,18152,21743,18782,21113,ITH,ITH5,8,Emilia-Romagna,Emilia-Romagna,4459477,1039062,23.3,0.89
1310,2021-03-17,EMR,13720,5693,8027,5875,7845,ITH,ITH5,8,Emilia-Romagna,Emilia-Romagna,4459477,1052782,23.61,0.31
1311,2021-05-26,EMR,32912,14558,18354,10194,22718,ITH,ITH5,8,Emilia-Romagna,Emilia-Romagna,4459477,1085694,24.35,0.74
1312,2021-02-13,EMR,3627,1085,2542,3029,598,ITH,ITH5,8,Emilia-Romagna,Emilia-Romagna,4459477,1089321,24.43,0.08
1313,2021-05-09,EMR,25601,12247,13354,18636,6965,ITH,ITH5,8,Emilia-Romagna,Emilia-Romagna,4459477,1114922,25.0,0.57
1314,2021-01-27,EMR,8362,2947,5415,463,7899,ITH,ITH5,8,Emilia-Romagna,Emilia-Romagna,4459477,1123284,25.19,0.19
1315,2021-02-23,EMR,8215,3219,4996,7829,386,ITH,ITH5,8,Emilia-Romagna,Emilia-Romagna,4459477,1131499,25.37,0.18
1316,2021-03-05,EMR,17708,5757,11951,14258,3450,ITH,ITH5,8,Emilia-Romagna,Emilia-Romagna,4459477,1149207,25.77,0.4
1317,2021-03-03,EMR,15834,5251,10583,13358,2476,ITH,ITH5,8,Emilia-Romagna,Emilia-Romagna,4459477,1165041,26.13,0.36
1318,2021-02-16,EMR,5768,2444,3324,5237,531,ITH,ITH5,8,Emilia-Romagna,Emilia-Romagna,4459477,1170809,26.25,0.13
1319,2021-04-21,EMR,23929,10955,12974,14192,9737,ITH,ITH5,8,Emilia-Romagna,Emilia-Romagna,4459477,1194738,26.79,0.54
1320,2021-01-28,EMR,10250,3339,6911,349,9901,ITH,ITH5,8,Emilia-Romagna,Emilia-Romagna,4459477,1204988,27.02,0.23
1321,2021-05-27,EMR,41780,18503,23277,13969,27811,ITH,ITH5,8,Emilia-Romagna,Emilia-Romagna,4459477,1246768,27.96,0.94
1322,2021-05-21,EMR,37810,16862,20948,20997,16813,ITH,ITH5,8,Emilia-Romagna,Emilia-Romagna,4459477,1284578,28.81,0.85
1323,2021-03-18,EMR,13673,5806,7867,5673,8000,ITH,ITH5,8,Emilia-Romagna,Emilia-Romagna,4459477,1298251,29.11,0.31
1324,2021-05-14,EMR,37126,17112,20014,27558,9568,ITH,ITH5,8,Emilia-Romagna,Emilia-Romagna,4459477,1335377,29.94,0.83
1325,2021-02-03,EMR,9355,2995,6360,984,8371,ITH,ITH5,8,Emilia-Romagna,Emilia-Romagna,4459477,1344732,30.15,0.21
1326,2021-04-01,EMR,23880,10732,13148,19339,4541,ITH,ITH5,8,Emilia-Romagna,Emilia-Romagna,4459477,1368612,30.69,0.54
1327,2021-05-28,EMR,40630,18641,21989,17774,22856,ITH,ITH5,8,Emilia-Romagna,Emilia-Romagna,4459477,1409242,31.6,0.91
1328,2021-01-12,EMR,9475,3124,6351,9475,0,ITH,ITH5,8,Emilia-Romagna,Emilia-Romagna,4459477,1418717,31.81,0.21
1329,2021-04-24,EMR,28586,13220,15366,14373,14213,ITH,ITH5,8,Emilia-Romagna,Emilia-Romagna,4459477,1447303,32.45,0.64
1330,2021-05-11,EMR,35715,16766,18949,28455,7260,ITH,ITH5,8,Emilia-Romagna,Emilia-Romagna,4459477,1483018,33.26,0.8
1331,2021-03-21,EMR,11920,5273,6647,7316,4604,ITH,ITH5,8,Emilia-Romagna,Emilia-Romagna,4459477,1494938,33.52,0.27
1332,2021-01-26,EMR,8334,3000,5334,215,8119,ITH,ITH5,8,Emilia-Romagna,Emilia-Romagna,4459477,1503272,33.71,0.19
1333,2021-03-24,EMR,21083,9304,11779,13701,7382,ITH,ITH5,8,Emilia-Romagna,Emilia-Romagna,4459477,1524355,34.18,0.47
1334,2021-05-06,EMR,35877,16586,19291,22830,13047,ITH,ITH5,8,Emilia-Romagna,Emilia-Romagna,4459477,1560232,34.99,0.8
1335,2021-04-02,EMR,23305,10493,12812,18843,4462,ITH,ITH5,8,Emilia-Romagna,Emilia-Romagna,4459477,1583537,35.51,0.52
1336,2021-05-29,EMR,37117,16195,20922,16732,20385,ITH,ITH5,8,Emilia-Romagna,Emilia-Romagna,4459477,1620654,36.34,0.83
1337,2021-01-07,EMR,10272,3406,6866,10272,0,ITH,ITH5,8,Emilia-Romagna,Emilia-Romagna,4459477,1630926,36.57,0.23
1338,2021-02-19,EMR,7327,3010,4317,6813,514,ITH,ITH5,8,Emilia-Romagna,Emilia-Romagna,4459477,1638253,36.74,0.16
1339,2020-12-31,EMR,2214,780,1434,2214,0,ITH,ITH5,8,Emilia-Romagna,Emilia-Romagna,4459477,1640467,36.79,0.05
1340,2021-04-03,EMR,19937,8766,11171,16197,3740,ITH,ITH5,8,Emilia-Romagna,Emilia-Romagna,4459477,1660404,37.23,0.45
1341,2021-04-28,EMR,33701,15579,18122,20815,12886,ITH,ITH5,8,Emilia-Romagna,Emilia-Romagna,4459477,1694105,37.99,0.76
1342,2021-01-19,EMR,2045,505,1540,2028,17,ITH,ITH5,8,Emilia-Romagna,Emilia-Romagna,4459477,1696150,38.03,0.05
1343,2021-02-24,EMR,9350,3566,5784,8466,884,ITH,ITH5,8,Emilia-Romagna,Emilia-Romagna,4459477,1705500,38.24,0.21
1344,2021-01-05,EMR,9362,3170,6192,9362,0,ITH,ITH5,8,Emilia-Romagna,Emilia-Romagna,4459477,1714862,38.45,0.21
1345,2021-04-29,EMR,44939,21130,23809,27394,17545,ITH,ITH5,8,Emilia-Romagna,Emilia-Romagna,4459477,1759801,39.46,1.01
1346,2021-02-26,EMR,9623,3667,5956,8577,1046,ITH,ITH5,8,Emilia-Romagna,Emilia-Romagna,4459477,1769424,39.68,0.22
1347,2021-02-12,EMR,5321,1679,3642,3918,1403,ITH,ITH5,8,Emilia-Romagna,Emilia-Romagna,4459477,1774745,39.8,0.12
1348,2021-04-10,EMR,20907,9292,11615,16764,4143,ITH,ITH5,8,Emilia-Romagna,Emilia-Romagna,4459477,1795652,40.27,0.47
1349,2021-04-17,EMR,27034,12935,14099,17738,9296,ITH,ITH5,8,Emilia-Romagna,Emilia-Romagna,4459477,1822686,40.87,0.61
1350,2021-05-30,EMR,26808,12653,14155,13244,13564,ITH,ITH5,8,Emilia-Romagna,Emilia-Romagna,4459477,1849494,41.47,0.6
1351,2021-01-24,EMR,2443,885,1558,298,2145,ITH,ITH5,8,Emilia-Romagna,Emilia-Romagna,4459477,1851937,41.53,0.05
1352,2021-01-17,EMR,2890,887,2003,2644,246,ITH,ITH5,8,Emilia-Romagna,Emilia-Romagna,4459477,1854827,41.59,0.06
1353,2021-03-06,EMR,20862,5926,14936,18132,2730,ITH,ITH5,8,Emilia-Romagna,Emilia-Romagna,4459477,1875689,42.06,0.47
1354,2021-05-13,EMR,35658,16424,19234,27891,7767,ITH,ITH5,8,Emilia-Romagna,Emilia-Romagna,4459477,1911347,42.86,0.8
1355,2021-03-15,EMR,13268,6091,7177,6769,6499,ITH,ITH5,8,Emilia-Romagna,Emilia-Romagna,4459477,1924615,43.16,0.3
1356,2021-02-04,EMR,9938,3207,6731,1250,8688,ITH,ITH5,8,Emilia-Romagna,Emilia-Romagna,4459477,1934553,43.38,0.22
1357,2021-05-22,EMR,32884,14098,18786,16889,15995,ITH,ITH5,8,Emilia-Romagna,Emilia-Romagna,4459477,1967437,44.12,0.74
1358,2021-04-09,EMR,25509,11570,13939,19818,5691,ITH,ITH5,8,Emilia-Romagna,Emilia-Romagna,4459477,1992946,44.69,0.57
1359,2021-02-09,EMR,4153,1248,2905,2307,1846,ITH,ITH5,8,Emilia-Romagna,Emilia-Romagna,4459477,1997099,44.78,0.09
1360,2021-05-01,EMR,28399,12772,15627,15627,12772,ITH,ITH5,8,Emilia-Romagna,Emilia-Romagna,4459477,2025498,45.42,0.64
1361,2021-02-05,EMR,9316,2966,6350,1637,7679,ITH,ITH5,8,Emilia-Romagna,Emilia-Romagna,4459477,2034814,45.63,0.21
1362,2021-04-14,EMR,27015,12826,14189,20911,6104,ITH,ITH5,8,Emilia-Romagna,Emilia-Romagna,4459477,2061829,46.23,0.61
1363,2021-06-03,EMR,33901,16518,17383,27109,6792,ITH,ITH5,8,Emilia-Romagna,Emilia-Romagna,4459477,2095730,46.99,0.76
1364,2021-06-01,EMR,26596,12758,13838,17002,9594,ITH,ITH5,8,Emilia-Romagna,Emilia-Romagna,4459477,2122326,47.59,0.6
1365,2021-04-12,EMR,19220,8994,10226,14778,4442,ITH,ITH5,8,Emilia-Romagna,Emilia-Romagna,4459477,2141546,48.02,0.43
1366,2021-01-09,EMR,9984,3450,6534,9984,0,ITH,ITH5,8,Emilia-Romagna,Emilia-Romagna,4459477,2151530,48.25,0.22
1367,2021-03-07,EMR,7799,2927,4872,6282,1517,ITH,ITH5,8,Emilia-Romagna,Emilia-Romagna,4459477,2159329,48.42,0.17
1368,2021-05-03,EMR,28485,13468,15017,17608,10877,ITH,ITH5,8,Emilia-Romagna,Emilia-Romagna,4459477,2187814,49.06,0.64
1369,2021-01-16,EMR,5627,1718,3909,5627,0,ITH,ITH5,8,Emilia-Romagna,Emilia-Romagna,4459477,2193441,49.19,0.13
1370,2021-03-14,EMR,8696,3744,4952,4899,3797,ITH,ITH5,8,Emilia-Romagna,Emilia-Romagna,4459477,2202137,49.38,0.2
1371,2021-04-19,EMR,20887,9792,11095,14615,6272,ITH,ITH5,8,Emilia-Romagna,Emilia-Romagna,4459477,2223024,49.85,0.47
1372,2021-02-07,EMR,4793,1537,3256,1732,3061,ITH,ITH5,8,Emilia-Romagna,Emilia-Romagna,4459477,2227817,49.96,0.11
1373,2021-03-29,EMR,21202,9443,11759,16551,4651,ITH,ITH5,8,Emilia-Romagna,Emilia-Romagna,4459477,2249019,50.43,0.48
1374,2021-05-18,EMR,29016,13222,15794,18553,10463,ITH,ITH5,8,Emilia-Romagna,Emilia-Romagna,4459477,2278035,51.08,0.65
1375,2021-05-17,EMR,32327,15376,16951,22882,9445,ITH,ITH5,8,Emilia-Romagna,Emilia-Romagna,4459477,2310362,51.81,0.72
1376,2021-02-21,EMR,4450,1708,2742,4010,440,ITH,ITH5,8,Emilia-Romagna,Emilia-Romagna,4459477,2314812,51.91,0.1
1377,2021-05-15,EMR,33169,14966,18203,22813,10356,ITH,ITH5,8,Emilia-Romagna,Emilia-Romagna,4459477,2347981,52.65,0.74
1378,2021-02-02,EMR,9484,3053,6431,527,8957,ITH,ITH5,8,Emilia-Romagna,Emilia-Romagna,4459477,2357465,52.86,0.21
1379,2021-01-21,EMR,2164,729,1435,819,1345,ITH,ITH5,8,Emilia-Romagna,Emilia-Romagna,4459477,2359629,52.91,0.05
1380,2021-03-12,EMR,18116,7552,10564,11399,6717,ITH,ITH5,8,Emilia-Romagna,Emilia-Romagna,4459477,2377745,53.32,0.41
1381,2021-01-30,EMR,10077,3519,6558,141,9936,ITH,ITH5,8,Emilia-Romagna,Emilia-Romagna,4459477,2387822,53.54,0.23
1382,2021-04-04,EMR,9885,4718,5167,7616,2269,ITH,ITH5,8,Emilia-Romagna,Emilia-Romagna,4459477,2397707,53.77,0.22
1383,2021-03-20,EMR,16086,6831,9255,9122,6964,ITH,ITH5,8,Emilia-Romagna,Emilia-Romagna,4459477,2413793,54.13,0.36
1384,2020-12-27,EMR,970,372,598,970,0,ITH,ITH5,8,Emilia-Romagna,Emilia-Romagna,4459477,2414763,54.15,0.02
1385,2021-04-06,EMR,24622,11115,13507,19885,4737,ITH,ITH5,8,Emilia-Romagna,Emilia-Romagna,4459477,2439385,54.7,0.55
1386,2021-04-05,EMR,14860,6809,8051,11969,2891,ITH,ITH5,8,Emilia-Romagna,Emilia-Romagna,4459477,2454245,55.03,0.33
1387,2021-01-31,EMR,7697,2762,4935,241,7456,ITH,ITH5,8,Emilia-Romagna,Emilia-Romagna,4459477,2461942,55.21,0.17
1388,2021-04-22,EMR,29036,13441,15595,14962,14074,ITH,ITH5,8,Emilia-Romagna,Emilia-Romagna,4459477,2490978,55.86,0.65
1389,2021-03-02,EMR,11874,3910,7964,9845,2029,ITH,ITH5,8,Emilia-Romagna,Emilia-Romagna,4459477,2502852,56.12,0.27
1390,2021-03-19,EMR,15844,6916,8928,7877,7967,ITH,ITH5,8,Emilia-Romagna,Emilia-Romagna,4459477,2518696,56.48,0.36
1391,2021-05-08,EMR,32303,15077,17226,20888,11415,ITH,ITH5,8,Emilia-Romagna,Emilia-Romagna,4459477,2550999,57.2,0.72
1392,2021-04-07,EMR,25807,11737,14070,19796,6011,ITH,ITH5,8,Emilia-Romagna,Emilia-Romagna,4459477,2576806,57.78,0.58
1393,2021-03-26,EMR,23417,9899,13518,16983,6434,ITH,ITH5,8,Emilia-Romagna,Emilia-Romagna,4459477,2600223,58.31,0.53
1394,2021-03-31,EMR,25135,10952,14183,19679,5456,ITH,ITH5,8,Emilia-Romagna,Emilia-Romagna,4459477,2625358,58.87,0.56
1395,2021-02-14,EMR,1401,378,1023,1281,120,ITH,ITH5,8,Emilia-Romagna,Emilia-Romagna,4459477,2626759,58.9,0.03
1396,2021-03-22,EMR,17465,7653,9812,10600,6865,ITH,ITH5,8,Emilia-Romagna,Emilia-Romagna,4459477,2644224,59.29,0.39
1397,2021-05-25,EMR,24848,11085,13763,11603,13245,ITH,ITH5,8,Emilia-Romagna,Emilia-Romagna,4459477,2669072,59.85,0.56
1398,2021-05-10,EMR,33818,16116,17702,26588,7230,ITH,ITH5,8,Emilia-Romagna,Emilia-Romagna,4459477,2702890,60.61,0.76
1399,2021-02-28,EMR,6823,2527,4296,4977,1846,ITH,ITH5,8,Emilia-Romagna,Emilia-Romagna,4459477,2709713,60.76,0.15
1400,2021-04-26,EMR,27875,12926,14949,18569,9306,ITH,ITH5,8,Emilia-Romagna,Emilia-Romagna,4459477,2737588,61.39,0.63
1401,2021-01-14,EMR,8128,2593,5535,8128,0,ITH,ITH5,8,Emilia-Romagna,Emilia-Romagna,4459477,2745716,61.57,0.18
1402,2021-01-02,EMR,2373,914,1459,2373,0,ITH,ITH5,8,Emilia-Romagna,Emilia-Romagna,4459477,2748089,61.62,0.05
1403,2021-05-28,VDA,975,414,561,563,412,ITC,ITC2,2,Valle d'Aosta / Vallée d'Aoste,Valle d'Aosta,125666,975,0.78,0.78
1404,2021-03-25,VDA,389,154,235,379,10,ITC,ITC2,2,Valle d'Aosta / Vallée d'Aoste,Valle d'Aosta,125666,1364,1.09,0.31
1405,2021-02-10,VDA,248,77,171,141,107,ITC,ITC2,2,Valle d'Aosta / Vallée d'Aoste,Valle d'Aosta,125666,1612,1.28,0.2
1406,2021-02-19,VDA,292,102,190,268,24,ITC,ITC2,2,Valle d'Aosta / Vallée d'Aoste,Valle d'Aosta,125666,1904,1.52,0.23
1407,2021-01-07,VDA,276,111,165,276,0,ITC,ITC2,2,Valle d'Aosta / Vallée d'Aoste,Valle d'Aosta,125666,2180,1.73,0.22
1408,2021-04-24,VDA,722,400,322,555,167,ITC,ITC2,2,Valle d'Aosta / Vallée d'Aoste,Valle d'Aosta,125666,2902,2.31,0.57
1409,2021-04-20,VDA,932,430,502,738,194,ITC,ITC2,2,Valle d'Aosta / Vallée d'Aoste,Valle d'Aosta,125666,3834,3.05,0.74
1410,2021-02-15,VDA,264,136,128,229,35,ITC,ITC2,2,Valle d'Aosta / Vallée d'Aoste,Valle d'Aosta,125666,4098,3.26,0.21
1411,2021-02-14,VDA,48,16,32,1,47,ITC,ITC2,2,Valle d'Aosta / Vallée d'Aoste,Valle d'Aosta,125666,4146,3.3,0.04
1412,2021-05-06,VDA,1063,509,554,679,384,ITC,ITC2,2,Valle d'Aosta / Vallée d'Aoste,Valle d'Aosta,125666,5209,4.15,0.85
1413,2021-03-31,VDA,555,302,253,529,26,ITC,ITC2,2,Valle d'Aosta / Vallée d'Aoste,Valle d'Aosta,125666,5764,4.59,0.44
1414,2021-05-27,VDA,1089,497,592,586,503,ITC,ITC2,2,Valle d'Aosta / Vallée d'Aoste,Valle d'Aosta,125666,6853,5.45,0.87
1415,2021-05-13,VDA,1139,556,583,540,599,ITC,ITC2,2,Valle d'Aosta / Vallée d'Aoste,Valle d'Aosta,125666,7992,6.36,0.91
1416,2021-02-02,VDA,272,70,202,2,270,ITC,ITC2,2,Valle d'Aosta / Vallée d'Aoste,Valle d'Aosta,125666,8264,6.58,0.22
1417,2021-02-22,VDA,316,94,222,213,103,ITC,ITC2,2,Valle d'Aosta / Vallée d'Aoste,Valle d'Aosta,125666,8580,6.83,0.25
1418,2021-04-29,VDA,1291,634,657,757,534,ITC,ITC2,2,Valle d'Aosta / Vallée d'Aoste,Valle d'Aosta,125666,9871,7.85,1.03
1419,2021-01-19,VDA,256,77,179,256,0,ITC,ITC2,2,Valle d'Aosta / Vallée d'Aoste,Valle d'Aosta,125666,10127,8.06,0.2
1420,2021-04-14,VDA,941,430,511,717,224,ITC,ITC2,2,Valle d'Aosta / Vallée d'Aoste,Valle d'Aosta,125666,11068,8.81,0.75
1421,2021-04-15,VDA,810,377,433,671,139,ITC,ITC2,2,Valle d'Aosta / Vallée d'Aoste,Valle d'Aosta,125666,11878,9.45,0.64
1422,2021-03-29,VDA,493,233,260,453,40,ITC,ITC2,2,Valle d'Aosta / Vallée d'Aoste,Valle d'Aosta,125666,12371,9.84,0.39
1423,2021-06-01,VDA,871,469,402,518,353,ITC,ITC2,2,Valle d'Aosta / Vallée d'Aoste,Valle d'Aosta,125666,13242,10.54,0.69
1424,2021-03-12,VDA,531,175,356,305,226,ITC,ITC2,2,Valle d'Aosta / Vallée d'Aoste,Valle d'Aosta,125666,13773,10.96,0.42
1425,2021-02-03,VDA,351,114,237,14,337,ITC,ITC2,2,Valle d'Aosta / Vallée d'Aoste,Valle d'Aosta,125666,14124,11.24,0.28
1426,2021-04-01,VDA,776,394,382,764,12,ITC,ITC2,2,Valle d'Aosta / Vallée d'Aoste,Valle d'Aosta,125666,14900,11.86,0.62
1427,2021-04-08,VDA,584,282,302,441,143,ITC,ITC2,2,Valle d'Aosta / Vallée d'Aoste,Valle d'Aosta,125666,15484,12.32,0.46
1428,2021-02-24,VDA,183,82,101,164,19,ITC,ITC2,2,Valle d'Aosta / Vallée d'Aoste,Valle d'Aosta,125666,15667,12.47,0.15
1429,2021-04-27,VDA,978,423,555,686,292,ITC,ITC2,2,Valle d'Aosta / Vallée d'Aoste,Valle d'Aosta,125666,16645,13.25,0.78
1430,2021-03-08,VDA,482,231,251,237,245,ITC,ITC2,2,Valle d'Aosta / Vallée d'Aoste,Valle d'Aosta,125666,17127,13.63,0.38
1431,2021-05-11,VDA,645,325,320,494,151,ITC,ITC2,2,Valle d'Aosta / Vallée d'Aoste,Valle d'Aosta,125666,17772,14.14,0.51
1432,2021-04-22,VDA,1067,449,618,684,383,ITC,ITC2,2,Valle d'Aosta / Vallée d'Aoste,Valle d'Aosta,125666,18839,14.99,0.85
1433,2021-03-03,VDA,255,118,137,187,68,ITC,ITC2,2,Valle d'Aosta / Vallée d'Aoste,Valle d'Aosta,125666,19094,15.19,0.2
1434,2021-01-12,VDA,302,72,230,302,0,ITC,ITC2,2,Valle d'Aosta / Vallée d'Aoste,Valle d'Aosta,125666,19396,15.43,0.24
1435,2021-03-17,VDA,433,185,248,273,160,ITC,ITC2,2,Valle d'Aosta / Vallée d'Aoste,Valle d'Aosta,125666,19829,15.78,0.34
1436,2021-01-26,VDA,139,48,91,0,139,ITC,ITC2,2,Valle d'Aosta / Vallée d'Aoste,Valle d'Aosta,125666,19968,15.89,0.11
1437,2021-05-04,VDA,1135,510,625,462,673,ITC,ITC2,2,Valle d'Aosta / Vallée d'Aoste,Valle d'Aosta,125666,21103,16.79,0.9
1438,2021-03-15,VDA,362,123,239,159,203,ITC,ITC2,2,Valle d'Aosta / Vallée d'Aoste,Valle d'Aosta,125666,21465,17.08,0.29
1439,2021-01-17,VDA,131,56,75,131,0,ITC,ITC2,2,Valle d'Aosta / Vallée d'Aoste,Valle d'Aosta,125666,21596,17.19,0.1
1440,2021-01-31,VDA,291,91,200,58,233,ITC,ITC2,2,Valle d'Aosta / Vallée d'Aoste,Valle d'Aosta,125666,21887,17.42,0.23
1441,2021-03-22,VDA,560,205,355,333,227,ITC,ITC2,2,Valle d'Aosta / Vallée d'Aoste,Valle d'Aosta,125666,22447,17.86,0.45
1442,2021-05-02,VDA,765,345,420,605,160,ITC,ITC2,2,Valle d'Aosta / Vallée d'Aoste,Valle d'Aosta,125666,23212,18.47,0.61
1443,2021-01-08,VDA,299,130,169,299,0,ITC,ITC2,2,Valle d'Aosta / Vallée d'Aoste,Valle d'Aosta,125666,23511,18.71,0.24
1444,2021-03-06,VDA,22,4,18,22,0,ITC,ITC2,2,Valle d'Aosta / Vallée d'Aoste,Valle d'Aosta,125666,23533,18.73,0.02
1445,2021-03-13,VDA,145,86,59,145,0,ITC,ITC2,2,Valle d'Aosta / Vallée d'Aoste,Valle d'Aosta,125666,23678,18.84,0.12
1446,2021-01-15,VDA,218,82,136,218,0,ITC,ITC2,2,Valle d'Aosta / Vallée d'Aoste,Valle d'Aosta,125666,23896,19.02,0.17
1447,2021-01-22,VDA,56,21,35,20,36,ITC,ITC2,2,Valle d'Aosta / Vallée d'Aoste,Valle d'Aosta,125666,23952,19.06,0.04
1448,2021-05-21,VDA,917,433,484,531,386,ITC,ITC2,2,Valle d'Aosta / Vallée d'Aoste,Valle d'Aosta,125666,24869,19.79,0.73
1449,2021-05-30,VDA,865,429,436,694,171,ITC,ITC2,2,Valle d'Aosta / Vallée d'Aoste,Valle d'Aosta,125666,25734,20.48,0.69
1450,2021-02-17,VDA,327,144,183,227,100,ITC,ITC2,2,Valle d'Aosta / Vallée d'Aoste,Valle d'Aosta,125666,26061,20.74,0.26
1451,2021-04-17,VDA,638,407,231,636,2,ITC,ITC2,2,Valle d'Aosta / Vallée d'Aoste,Valle d'Aosta,125666,26699,21.25,0.51
1452,2021-01-05,VDA,150,54,96,150,0,ITC,ITC2,2,Valle d'Aosta / Vallée d'Aoste,Valle d'Aosta,125666,26849,21.37,0.12
1453,2021-01-14,VDA,237,69,168,237,0,ITC,ITC2,2,Valle d'Aosta / Vallée d'Aoste,Valle d'Aosta,125666,27086,21.55,0.19
1454,2021-01-27,VDA,151,71,80,79,72,ITC,ITC2,2,Valle d'Aosta / Vallée d'Aoste,Valle d'Aosta,125666,27237,21.67,0.12
1455,2020-12-27,VDA,20,9,11,20,0,ITC,ITC2,2,Valle d'Aosta / Vallée d'Aoste,Valle d'Aosta,125666,27257,21.69,0.02
1456,2021-03-01,VDA,181,66,115,147,34,ITC,ITC2,2,Valle d'Aosta / Vallée d'Aoste,Valle d'Aosta,125666,27438,21.83,0.14
1457,2021-01-10,VDA,220,71,149,220,0,ITC,ITC2,2,Valle d'Aosta / Vallée d'Aoste,Valle d'Aosta,125666,27658,22.01,0.18
1458,2021-05-25,VDA,1115,530,585,541,574,ITC,ITC2,2,Valle d'Aosta / Vallée d'Aoste,Valle d'Aosta,125666,28773,22.9,0.89
1459,2021-05-08,VDA,904,540,364,526,378,ITC,ITC2,2,Valle d'Aosta / Vallée d'Aoste,Valle d'Aosta,125666,29677,23.62,0.72
1460,2021-04-05,VDA,461,222,239,457,4,ITC,ITC2,2,Valle d'Aosta / Vallée d'Aoste,Valle d'Aosta,125666,30138,23.98,0.37
1461,2021-03-20,VDA,208,86,122,172,36,ITC,ITC2,2,Valle d'Aosta / Vallée d'Aoste,Valle d'Aosta,125666,30346,24.15,0.17
1462,2021-05-09,VDA,574,287,287,444,130,ITC,ITC2,2,Valle d'Aosta / Vallée d'Aoste,Valle d'Aosta,125666,30920,24.6,0.46
1463,2021-04-03,VDA,676,341,335,661,15,ITC,ITC2,2,Valle d'Aosta / Vallée d'Aoste,Valle d'Aosta,125666,31596,25.14,0.54
1464,2021-05-23,VDA,999,465,534,658,341,ITC,ITC2,2,Valle d'Aosta / Vallée d'Aoste,Valle d'Aosta,125666,32595,25.94,0.79
1465,2021-01-29,VDA,318,138,180,2,316,ITC,ITC2,2,Valle d'Aosta / Vallée d'Aoste,Valle d'Aosta,125666,32913,26.19,0.25
1466,2021-02-12,VDA,263,96,167,217,46,ITC,ITC2,2,Valle d'Aosta / Vallée d'Aoste,Valle d'Aosta,125666,33176,26.4,0.21
1467,2021-04-10,VDA,404,190,214,399,5,ITC,ITC2,2,Valle d'Aosta / Vallée d'Aoste,Valle d'Aosta,125666,33580,26.72,0.32
1468,2021-02-26,VDA,207,58,149,122,85,ITC,ITC2,2,Valle d'Aosta / Vallée d'Aoste,Valle d'Aosta,125666,33787,26.89,0.16
1469,2020-12-31,VDA,18,4,14,18,0,ITC,ITC2,2,Valle d'Aosta / Vallée d'Aoste,Valle d'Aosta,125666,33805,26.9,0.01
1470,2021-03-05,VDA,275,124,151,53,222,ITC,ITC2,2,Valle d'Aosta / Vallée d'Aoste,Valle d'Aosta,125666,34080,27.12,0.22
1471,2021-04-19,VDA,751,325,426,542,209,ITC,ITC2,2,Valle d'Aosta / Vallée d'Aoste,Valle d'Aosta,125666,34831,27.72,0.6
1472,2021-01-16,VDA,236,80,156,236,0,ITC,ITC2,2,Valle d'Aosta / Vallée d'Aoste,Valle d'Aosta,125666,35067,27.9,0.19
1473,2021-05-19,VDA,993,498,495,418,575,ITC,ITC2,2,Valle d'Aosta / Vallée d'Aoste,Valle d'Aosta,125666,36060,28.7,0.79
1474,2021-03-16,VDA,180,37,143,118,62,ITC,ITC2,2,Valle d'Aosta / Vallée d'Aoste,Valle d'Aosta,125666,36240,28.84,0.14
1475,2021-04-13,VDA,373,171,202,329,44,ITC,ITC2,2,Valle d'Aosta / Vallée d'Aoste,Valle d'Aosta,125666,36613,29.14,0.3
1476,2021-03-27,VDA,333,164,169,302,31,ITC,ITC2,2,Valle d'Aosta / Vallée d'Aoste,Valle d'Aosta,125666,36946,29.4,0.26
1477,2021-03-10,VDA,438,183,255,225,213,ITC,ITC2,2,Valle d'Aosta / Vallée d'Aoste,Valle d'Aosta,125666,37384,29.75,0.35
1478,2021-01-28,VDA,291,123,168,56,235,ITC,ITC2,2,Valle d'Aosta / Vallée d'Aoste,Valle d'Aosta,125666,37675,29.98,0.23
1479,2021-04-23,VDA,921,443,478,538,383,ITC,ITC2,2,Valle d'Aosta / Vallée d'Aoste,Valle d'Aosta,125666,38596,30.71,0.73
1480,2021-03-04,VDA,291,139,152,42,249,ITC,ITC2,2,Valle d'Aosta / Vallée d'Aoste,Valle d'Aosta,125666,38887,30.94,0.23
1481,2021-05-07,VDA,564,245,319,533,31,ITC,ITC2,2,Valle d'Aosta / Vallée d'Aoste,Valle d'Aosta,125666,39451,31.39,0.45
1482,2021-04-06,VDA,741,381,360,629,112,ITC,ITC2,2,Valle d'Aosta / Vallée d'Aoste,Valle d'Aosta,125666,40192,31.98,0.59
1483,2021-01-04,VDA,142,59,83,142,0,ITC,ITC2,2,Valle d'Aosta / Vallée d'Aoste,Valle d'Aosta,125666,40334,32.1,0.11
1484,2021-03-09,VDA,206,96,110,174,32,ITC,ITC2,2,Valle d'Aosta / Vallée d'Aoste,Valle d'Aosta,125666,40540,32.26,0.16
1485,2021-03-11,VDA,197,76,121,66,131,ITC,ITC2,2,Valle d'Aosta / Vallée d'Aoste,Valle d'Aosta,125666,40737,32.42,0.16
1486,2021-06-02,VDA,1215,688,527,814,401,ITC,ITC2,2,Valle d'Aosta / Vallée d'Aoste,Valle d'Aosta,125666,41952,33.38,0.97
1487,2021-05-20,VDA,807,363,444,367,440,ITC,ITC2,2,Valle d'Aosta / Vallée d'Aoste,Valle d'Aosta,125666,42759,34.03,0.64
1488,2021-03-24,VDA,515,230,285,258,257,ITC,ITC2,2,Valle d'Aosta / Vallée d'Aoste,Valle d'Aosta,125666,43274,34.44,0.41
1489,2021-02-16,VDA,325,53,272,320,5,ITC,ITC2,2,Valle d'Aosta / Vallée d'Aoste,Valle d'Aosta,125666,43599,34.69,0.26
1490,2021-04-07,VDA,910,474,436,681,229,ITC,ITC2,2,Valle d'Aosta / Vallée d'Aoste,Valle d'Aosta,125666,44509,35.42,0.72
1491,2021-02-09,VDA,251,84,167,68,183,ITC,ITC2,2,Valle d'Aosta / Vallée d'Aoste,Valle d'Aosta,125666,44760,35.62,0.2
1492,2021-05-15,VDA,1065,614,451,380,685,ITC,ITC2,2,Valle d'Aosta / Vallée d'Aoste,Valle d'Aosta,125666,45825,36.47,0.85
1493,2021-02-23,VDA,216,123,93,216,0,ITC,ITC2,2,Valle d'Aosta / Vallée d'Aoste,Valle d'Aosta,125666,46041,36.64,0.17
1494,2021-04-28,VDA,1218,632,586,715,503,ITC,ITC2,2,Valle d'Aosta / Vallée d'Aoste,Valle d'Aosta,125666,47259,37.61,0.97
1495,2021-02-06,VDA,289,104,185,92,197,ITC,ITC2,2,Valle d'Aosta / Vallée d'Aoste,Valle d'Aosta,125666,47548,37.84,0.23
1496,2021-04-11,VDA,479,208,271,479,0,ITC,ITC2,2,Valle d'Aosta / Vallée d'Aoste,Valle d'Aosta,125666,48027,38.22,0.38
1497,2021-05-05,VDA,1038,566,472,456,582,ITC,ITC2,2,Valle d'Aosta / Vallée d'Aoste,Valle d'Aosta,125666,49065,39.04,0.83
1498,2021-01-25,VDA,147,65,82,0,147,ITC,ITC2,2,Valle d'Aosta / Vallée d'Aoste,Valle d'Aosta,125666,49212,39.16,0.12
1499,2021-05-12,VDA,1138,549,589,468,670,ITC,ITC2,2,Valle d'Aosta / Vallée d'Aoste,Valle d'Aosta,125666,50350,40.07,0.91
1500,2021-02-11,VDA,231,107,124,222,9,ITC,ITC2,2,Valle d'Aosta / Vallée d'Aoste,Valle d'Aosta,125666,50581,40.25,0.18
1501,2021-04-16,VDA,599,261,338,597,2,ITC,ITC2,2,Valle d'Aosta / Vallée d'Aoste,Valle d'Aosta,125666,51180,40.73,0.48
1502,2021-04-02,VDA,873,344,529,648,225,ITC,ITC2,2,Valle d'Aosta / Vallée d'Aoste,Valle d'Aosta,125666,52053,41.42,0.69
1503,2021-02-18,VDA,349,153,196,261,88,ITC,ITC2,2,Valle d'Aosta / Vallée d'Aoste,Valle d'Aosta,125666,52402,41.7,0.28
1504,2021-04-21,VDA,868,410,458,620,248,ITC,ITC2,2,Valle d'Aosta / Vallée d'Aoste,Valle d'Aosta,125666,53270,42.39,0.69
1505,2021-03-02,VDA,339,166,173,336,3,ITC,ITC2,2,Valle d'Aosta / Vallée d'Aoste,Valle d'Aosta,125666,53609,42.66,0.27
1506,2021-01-11,VDA,325,112,213,325,0,ITC,ITC2,2,Valle d'Aosta / Vallée d'Aoste,Valle d'Aosta,125666,53934,42.92,0.26
1507,2021-05-22,VDA,940,494,446,540,400,ITC,ITC2,2,Valle d'Aosta / Vallée d'Aoste,Valle d'Aosta,125666,54874,43.67,0.75
1508,2021-04-09,VDA,237,111,126,204,33,ITC,ITC2,2,Valle d'Aosta / Vallée d'Aoste,Valle d'Aosta,125666,55111,43.86,0.19
1509,2021-05-29,VDA,798,434,364,561,237,ITC,ITC2,2,Valle d'Aosta / Vallée d'Aoste,Valle d'Aosta,125666,55909,44.49,0.64
1510,2021-02-25,VDA,201,101,100,194,7,ITC,ITC2,2,Valle d'Aosta / Vallée d'Aoste,Valle d'Aosta,125666,56110,44.65,0.16
1511,2021-01-06,VDA,65,33,32,65,0,ITC,ITC2,2,Valle d'Aosta / Vallée d'Aoste,Valle d'Aosta,125666,56175,44.7,0.05
1512,2021-02-28,VDA,260,86,174,77,183,ITC,ITC2,2,Valle d'Aosta / Vallée d'Aoste,Valle d'Aosta,125666,56435,44.91,0.21
1513,2021-05-03,VDA,839,400,439,488,351,ITC,ITC2,2,Valle d'Aosta / Vallée d'Aoste,Valle d'Aosta,125666,57274,45.58,0.67
1514,2021-03-07,VDA,64,30,34,11,53,ITC,ITC2,2,Valle d'Aosta / Vallée d'Aoste,Valle d'Aosta,125666,57338,45.63,0.05
1515,2021-01-30,VDA,439,202,237,14,425,ITC,ITC2,2,Valle d'Aosta / Vallée d'Aoste,Valle d'Aosta,125666,57777,45.98,0.35
1516,2021-04-26,VDA,715,327,388,545,170,ITC,ITC2,2,Valle d'Aosta / Vallée d'Aoste,Valle d'Aosta,125666,58492,46.55,0.57
1517,2021-01-09,VDA,443,199,244,443,0,ITC,ITC2,2,Valle d'Aosta / Vallée d'Aoste,Valle d'Aosta,125666,58935,46.9,0.35
1518,2021-03-14,VDA,392,200,192,392,0,ITC,ITC2,2,Valle d'Aosta / Vallée d'Aoste,Valle d'Aosta,125666,59327,47.21,0.31
1519,2021-03-23,VDA,379,150,229,245,134,ITC,ITC2,2,Valle d'Aosta / Vallée d'Aoste,Valle d'Aosta,125666,59706,47.51,0.3
1520,2021-02-08,VDA,223,83,140,25,198,ITC,ITC2,2,Valle d'Aosta / Vallée d'Aoste,Valle d'Aosta,125666,59929,47.69,0.18
1521,2021-03-19,VDA,322,85,237,286,36,ITC,ITC2,2,Valle d'Aosta / Vallée d'Aoste,Valle d'Aosta,125666,60251,47.95,0.26
1522,2021-01-13,VDA,337,110,227,337,0,ITC,ITC2,2,Valle d'Aosta / Vallée d'Aoste,Valle d'Aosta,125666,60588,48.21,0.27
1523,2021-03-18,VDA,136,43,93,99,37,ITC,ITC2,2,Valle d'Aosta / Vallée d'Aoste,Valle d'Aosta,125666,60724,48.32,0.11
1524,2021-05-26,VDA,1209,587,622,576,633,ITC,ITC2,2,Valle d'Aosta / Vallée d'Aoste,Valle d'Aosta,125666,61933,49.28,0.96
1525,2021-05-31,VDA,879,395,484,500,379,ITC,ITC2,2,Valle d'Aosta / Vallée d'Aoste,Valle d'Aosta,125666,62812,49.98,0.7
1526,2021-04-18,VDA,522,254,268,518,4,ITC,ITC2,2,Valle d'Aosta / Vallée d'Aoste,Valle d'Aosta,125666,63334,50.4,0.42
1527,2021-05-24,VDA,1135,516,619,688,447,ITC,ITC2,2,Valle d'Aosta / Vallée d'Aoste,Valle d'Aosta,125666,64469,51.3,0.9
1528,2021-05-10,VDA,782,381,401,547,235,ITC,ITC2,2,Valle d'Aosta / Vallée d'Aoste,Valle d'Aosta,125666,65251,51.92,0.62
1529,2021-03-21,VDA,355,165,190,355,0,ITC,ITC2,2,Valle d'Aosta / Vallée d'Aoste,Valle d'Aosta,125666,65606,52.21,0.28
1530,2021-04-04,VDA,572,253,319,571,1,ITC,ITC2,2,Valle d'Aosta / Vallée d'Aoste,Valle d'Aosta,125666,66178,52.66,0.46
1531,2021-02-13,VDA,216,196,20,215,1,ITC,ITC2,2,Valle d'Aosta / Vallée d'Aoste,Valle d'Aosta,125666,66394,52.83,0.17
1532,2021-05-16,VDA,688,341,347,347,341,ITC,ITC2,2,Valle d'Aosta / Vallée d'Aoste,Valle d'Aosta,125666,67082,53.38,0.55
1533,2021-02-05,VDA,294,102,192,101,193,ITC,ITC2,2,Valle d'Aosta / Vallée d'Aoste,Valle d'Aosta,125666,67376,53.62,0.23
1534,2021-05-18,VDA,969,484,485,353,616,ITC,ITC2,2,Valle d'Aosta / Vallée d'Aoste,Valle d'Aosta,125666,68345,54.39,0.77
1535,2021-04-12,VDA,486,186,300,323,163,ITC,ITC2,2,Valle d'Aosta / Vallée d'Aoste,Valle d'Aosta,125666,68831,54.77,0.39
1536,2021-02-21,VDA,18,3,15,0,18,ITC,ITC2,2,Valle d'Aosta / Vallée d'Aoste,Valle d'Aosta,125666,68849,54.79,0.01
1537,2021-06-03,VDA,1304,665,639,895,409,ITC,ITC2,2,Valle d'Aosta / Vallée d'Aoste,Valle d'Aosta,125666,70153,55.82,1.04
1538,2021-05-17,VDA,809,417,392,375,434,ITC,ITC2,2,Valle d'Aosta / Vallée d'Aoste,Valle d'Aosta,125666,70962,56.47,0.64
1539,2021-02-04,VDA,294,86,208,8,286,ITC,ITC2,2,Valle d'Aosta / Vallée d'Aoste,Valle d'Aosta,125666,71256,56.7,0.23
1540,2021-04-30,VDA,831,355,476,485,346,ITC,ITC2,2,Valle d'Aosta / Vallée d'Aoste,Valle d'Aosta,125666,72087,57.36,0.66
1541,2021-01-18,VDA,213,74,139,213,0,ITC,ITC2,2,Valle d'Aosta / Vallée d'Aoste,Valle d'Aosta,125666,72300,57.53,0.17
1542,2021-01-20,VDA,23,8,15,23,0,ITC,ITC2,2,Valle d'Aosta / Vallée d'Aoste,Valle d'Aosta,125666,72323,57.55,0.02
1543,2021-05-14,VDA,960,442,518,291,669,ITC,ITC2,2,Valle d'Aosta / Vallée d'Aoste,Valle d'Aosta,125666,73283,58.32,0.76
1544,2021-02-01,VDA,404,127,277,87,317,ITC,ITC2,2,Valle d'Aosta / Vallée d'Aoste,Valle d'Aosta,125666,73687,58.64,0.32
1545,2021-03-30,VDA,402,223,179,382,20,ITC,ITC2,2,Valle d'Aosta / Vallée d'Aoste,Valle d'Aosta,125666,74089,58.96,0.32
1546,2021-02-07,VDA,292,120,172,190,102,ITC,ITC2,2,Valle d'Aosta / Vallée d'Aoste,Valle d'Aosta,125666,74381,59.19,0.23
1547,2021-05-01,VDA,940,563,377,456,484,ITC,ITC2,2,Valle d'Aosta / Vallée d'Aoste,Valle d'Aosta,125666,75321,59.94,0.75
1548,2021-01-02,VDA,6,5,1,6,0,ITC,ITC2,2,Valle d'Aosta / Vallée d'Aoste,Valle d'Aosta,125666,75327,59.94,0.0
1549,2021-03-26,VDA,498,204,294,491,7,ITC,ITC2,2,Valle d'Aosta / Vallée d'Aoste,Valle d'Aosta,125666,75825,60.34,0.4
1550,2021-01-21,VDA,33,12,21,33,0,ITC,ITC2,2,Valle d'Aosta / Vallée d'Aoste,Valle d'Aosta,125666,75858,60.36,0.03
1551,2021-03-28,VDA,522,212,310,521,1,ITC,ITC2,2,Valle d'Aosta / Vallée d'Aoste,Valle d'Aosta,125666,76380,60.78,0.42
1552,2021-02-20,VDA,251,210,41,241,10,ITC,ITC2,2,Valle d'Aosta / Vallée d'Aoste,Valle d'Aosta,125666,76631,60.98,0.2
1553,2021-04-25,VDA,849,408,441,710,139,ITC,ITC2,2,Valle d'Aosta / Vallée d'Aoste,Valle d'Aosta,125666,77480,61.66,0.68
1554,2021-02-27,VDA,231,85,146,124,107,ITC,ITC2,2,Valle d'Aosta / Vallée d'Aoste,Valle d'Aosta,125666,77711,61.84,0.18
1555,2021-04-04,LAZ,17463,8036,9427,12197,5266,ITI,ITI4,12,Lazio,Lazio,5879082,17463,0.3,0.3
1556,2021-02-20,LAZ,9205,4274,4931,8438,767,ITI,ITI4,12,Lazio,Lazio,5879082,26668,0.45,0.16
1557,2021-06-02,LAZ,43007,21334,21673,31651,11356,ITI,ITI4,12,Lazio,Lazio,5879082,69675,1.19,0.73
1558,2021-03-01,LAZ,17087,7346,9741,13202,3885,ITI,ITI4,12,Lazio,Lazio,5879082,86762,1.48,0.29
1559,2021-04-16,LAZ,34394,15676,18718,22335,12059,ITI,ITI4,12,Lazio,Lazio,5879082,121156,2.06,0.59
1560,2021-02-25,LAZ,12654,5518,7136,11604,1050,ITI,ITI4,12,Lazio,Lazio,5879082,133810,2.28,0.22
1561,2021-05-21,LAZ,50255,23627,26628,37393,12862,ITI,ITI4,12,Lazio,Lazio,5879082,184065,3.13,0.85
1562,2021-03-27,LAZ,26018,10401,15617,19548,6470,ITI,ITI4,12,Lazio,Lazio,5879082,210083,3.57,0.44
1563,2021-05-23,LAZ,47023,22783,24240,39683,7340,ITI,ITI4,12,Lazio,Lazio,5879082,257106,4.37,0.8
1564,2021-05-09,LAZ,37524,17249,20275,26258,11266,ITI,ITI4,12,Lazio,Lazio,5879082,294630,5.01,0.64
1565,2021-03-21,LAZ,17858,6826,11032,12807,5051,ITI,ITI4,12,Lazio,Lazio,5879082,312488,5.32,0.3
1566,2021-04-09,LAZ,27297,12266,15031,19074,8223,ITI,ITI4,12,Lazio,Lazio,5879082,339785,5.78,0.46
1567,2021-03-04,LAZ,18655,8014,10641,13639,5016,ITI,ITI4,12,Lazio,Lazio,5879082,358440,6.1,0.32
1568,2020-12-30,LAZ,1630,629,1001,1630,0,ITI,ITI4,12,Lazio,Lazio,5879082,360070,6.12,0.03
1569,2021-03-06,LAZ,18303,7051,11252,14046,4257,ITI,ITI4,12,Lazio,Lazio,5879082,378373,6.44,0.31
1570,2021-01-29,LAZ,8042,3079,4963,813,7229,ITI,ITI4,12,Lazio,Lazio,5879082,386415,6.57,0.14
1571,2021-05-12,LAZ,47398,21472,25926,30879,16519,ITI,ITI4,12,Lazio,Lazio,5879082,433813,7.38,0.81
1572,2021-01-30,LAZ,7009,2891,4118,807,6202,ITI,ITI4,12,Lazio,Lazio,5879082,440822,7.5,0.12
1573,2021-01-13,LAZ,5691,2150,3541,5691,0,ITI,ITI4,12,Lazio,Lazio,5879082,446513,7.59,0.1
1574,2021-04-25,LAZ,24512,11241,13271,16702,7810,ITI,ITI4,12,Lazio,Lazio,5879082,471025,8.01,0.42
1575,2020-12-27,LAZ,274,132,142,274,0,ITI,ITI4,12,Lazio,Lazio,5879082,471299,8.02,0.0
1576,2021-05-17,LAZ,43781,19995,23786,35335,8446,ITI,ITI4,12,Lazio,Lazio,5879082,515080,8.76,0.74
1577,2021-02-11,LAZ,6998,3012,3986,6467,531,ITI,ITI4,12,Lazio,Lazio,5879082,522078,8.88,0.12
1578,2021-05-24,LAZ,42813,19171,23642,34024,8789,ITI,ITI4,12,Lazio,Lazio,5879082,564891,9.61,0.73
1579,2021-02-06,LAZ,6136,2474,3662,817,5319,ITI,ITI4,12,Lazio,Lazio,5879082,571027,9.71,0.1
1580,2021-04-11,LAZ,19115,8431,10684,13234,5881,ITI,ITI4,12,Lazio,Lazio,5879082,590142,10.04,0.33
1581,2021-02-13,LAZ,6608,2626,3982,6194,414,ITI,ITI4,12,Lazio,Lazio,5879082,596750,10.15,0.11
1582,2021-01-08,LAZ,7728,2894,4834,7728,0,ITI,ITI4,12,Lazio,Lazio,5879082,604478,10.28,0.13
1583,2021-01-01,LAZ,3554,1382,2172,3554,0,ITI,ITI4,12,Lazio,Lazio,5879082,608032,10.34,0.06
1584,2021-04-30,LAZ,41234,18256,22978,27062,14172,ITI,ITI4,12,Lazio,Lazio,5879082,649266,11.04,0.7
1585,2021-05-07,LAZ,48147,22569,25578,30430,17717,ITI,ITI4,12,Lazio,Lazio,5879082,697413,11.86,0.82
1586,2021-03-18,LAZ,14225,6077,8148,7835,6390,ITI,ITI4,12,Lazio,Lazio,5879082,711638,12.1,0.24
1587,2021-02-03,LAZ,6488,2488,4000,964,5524,ITI,ITI4,12,Lazio,Lazio,5879082,718126,12.21,0.11
1588,2021-04-18,LAZ,23773,10556,13217,16139,7634,ITI,ITI4,12,Lazio,Lazio,5879082,741899,12.62,0.4
1589,2021-05-02,LAZ,32619,14333,18286,23258,9361,ITI,ITI4,12,Lazio,Lazio,5879082,774518,13.17,0.55
1590,2021-02-27,LAZ,11427,4268,7159,10472,955,ITI,ITI4,12,Lazio,Lazio,5879082,785945,13.37,0.19
1591,2021-03-13,LAZ,21457,8432,13025,15563,5894,ITI,ITI4,12,Lazio,Lazio,5879082,807402,13.73,0.36
1592,2021-01-22,LAZ,4002,1633,2369,487,3515,ITI,ITI4,12,Lazio,Lazio,5879082,811404,13.8,0.07
1593,2021-03-11,LAZ,23809,10586,13223,17580,6229,ITI,ITI4,12,Lazio,Lazio,5879082,835213,14.21,0.4
1594,2021-01-20,LAZ,4806,1942,2864,3263,1543,ITI,ITI4,12,Lazio,Lazio,5879082,840019,14.29,0.08
1595,2021-05-14,LAZ,50732,23157,27575,32520,18212,ITI,ITI4,12,Lazio,Lazio,5879082,890751,15.15,0.86
1596,2021-03-25,LAZ,26916,11511,15405,20312,6604,ITI,ITI4,12,Lazio,Lazio,5879082,917667,15.61,0.46
1597,2021-01-27,LAZ,6114,2387,3727,997,5117,ITI,ITI4,12,Lazio,Lazio,5879082,923781,15.71,0.1
1598,2021-03-16,LAZ,13538,5732,7806,7094,6444,ITI,ITI4,12,Lazio,Lazio,5879082,937319,15.94,0.23
1599,2021-03-09,LAZ,20873,8939,11934,15676,5197,ITI,ITI4,12,Lazio,Lazio,5879082,958192,16.3,0.36
1600,2021-01-11,LAZ,5531,2105,3426,5531,0,ITI,ITI4,12,Lazio,Lazio,5879082,963723,16.39,0.09
1601,2021-05-05,LAZ,46708,21425,25283,30903,15805,ITI,ITI4,12,Lazio,Lazio,5879082,1010431,17.19,0.79
1602,2021-03-02,LAZ,16987,7429,9558,13053,3934,ITI,ITI4,12,Lazio,Lazio,5879082,1027418,17.48,0.29
1603,2021-04-28,LAZ,32855,14999,17856,21307,11548,ITI,ITI4,12,Lazio,Lazio,5879082,1060273,18.03,0.56
1604,2021-01-25,LAZ,8111,3246,4865,770,7341,ITI,ITI4,12,Lazio,Lazio,5879082,1068384,18.17,0.14
1605,2021-01-18,LAZ,6267,2557,3710,5289,978,ITI,ITI4,12,Lazio,Lazio,5879082,1074651,18.28,0.11
1606,2021-05-31,LAZ,49511,21204,28307,31223,18288,ITI,ITI4,12,Lazio,Lazio,5879082,1124162,19.12,0.84
1607,2021-03-28,LAZ,18837,7541,11296,13527,5310,ITI,ITI4,12,Lazio,Lazio,5879082,1142999,19.44,0.32
1608,2021-04-27,LAZ,30629,13821,16808,19785,10844,ITI,ITI4,12,Lazio,Lazio,5879082,1173628,19.96,0.52
1609,2021-02-22,LAZ,11456,4990,6466,10954,502,ITI,ITI4,12,Lazio,Lazio,5879082,1185084,20.16,0.19
1610,2021-01-23,LAZ,7212,2869,4343,583,6629,ITI,ITI4,12,Lazio,Lazio,5879082,1192296,20.28,0.12
1611,2021-01-06,LAZ,5122,1961,3161,5122,0,ITI,ITI4,12,Lazio,Lazio,5879082,1197418,20.37,0.09
1612,2021-04-01,LAZ,28403,13046,15357,21263,7140,ITI,ITI4,12,Lazio,Lazio,5879082,1225821,20.85,0.48
1613,2021-04-15,LAZ,31907,14300,17607,21103,10804,ITI,ITI4,12,Lazio,Lazio,5879082,1257728,21.39,0.54
1614,2021-02-10,LAZ,8187,3398,4789,4850,3337,ITI,ITI4,12,Lazio,Lazio,5879082,1265915,21.53,0.14
1615,2021-01-04,LAZ,7481,2908,4573,7481,0,ITI,ITI4,12,Lazio,Lazio,5879082,1273396,21.66,0.13
1616,2021-03-30,LAZ,25254,11583,13671,18106,7148,ITI,ITI4,12,Lazio,Lazio,5879082,1298650,22.09,0.43
1617,2021-05-19,LAZ,46447,21210,25237,36638,9809,ITI,ITI4,12,Lazio,Lazio,5879082,1345097,22.88,0.79
1618,2021-02-08,LAZ,9739,4153,5586,4508,5231,ITI,ITI4,12,Lazio,Lazio,5879082,1354836,23.05,0.17
1619,2021-04-13,LAZ,25661,11869,13792,17955,7706,ITI,ITI4,12,Lazio,Lazio,5879082,1380497,23.48,0.44
1620,2021-01-03,LAZ,5250,1972,3278,5250,0,ITI,ITI4,12,Lazio,Lazio,5879082,1385747,23.57,0.09
1621,2021-01-10,LAZ,4039,1700,2339,4039,0,ITI,ITI4,12,Lazio,Lazio,5879082,1389786,23.64,0.07
1622,2021-04-20,LAZ,30998,14226,16772,19717,11281,ITI,ITI4,12,Lazio,Lazio,5879082,1420784,24.17,0.53
1623,2021-03-08,LAZ,20074,8321,11753,14801,5273,ITI,ITI4,12,Lazio,Lazio,5879082,1440858,24.51,0.34
1624,2021-01-17,LAZ,4894,2028,2866,4682,212,ITI,ITI4,12,Lazio,Lazio,5879082,1445752,24.59,0.08
1625,2021-04-29,LAZ,38570,17214,21356,25346,13224,ITI,ITI4,12,Lazio,Lazio,5879082,1484322,25.25,0.66
1626,2021-01-26,LAZ,7958,3125,4833,724,7234,ITI,ITI4,12,Lazio,Lazio,5879082,1492280,25.38,0.14
1627,2021-05-08,LAZ,45176,20614,24562,29814,15362,ITI,ITI4,12,Lazio,Lazio,5879082,1537456,26.15,0.77
1628,2021-02-18,LAZ,10017,4976,5041,9208,809,ITI,ITI4,12,Lazio,Lazio,5879082,1547473,26.32,0.17
1629,2021-04-23,LAZ,37654,18082,19572,22404,15250,ITI,ITI4,12,Lazio,Lazio,5879082,1585127,26.96,0.64
1630,2021-02-01,LAZ,5675,2177,3498,354,5321,ITI,ITI4,12,Lazio,Lazio,5879082,1590802,27.06,0.1
1631,2021-04-06,LAZ,23879,10653,13226,16776,7103,ITI,ITI4,12,Lazio,Lazio,5879082,1614681,27.46,0.41
1632,2021-01-15,LAZ,6574,2705,3869,6574,0,ITI,ITI4,12,Lazio,Lazio,5879082,1621255,27.58,0.11
1633,2021-03-20,LAZ,18224,6810,11414,12340,5884,ITI,ITI4,12,Lazio,Lazio,5879082,1639479,27.89,0.31
1634,2021-05-04,LAZ,39750,18279,21471,26274,13476,ITI,ITI4,12,Lazio,Lazio,5879082,1679229,28.56,0.68
1635,2021-02-24,LAZ,12046,5204,6842,11052,994,ITI,ITI4,12,Lazio,Lazio,5879082,1691275,28.77,0.2
1636,2021-01-05,LAZ,7374,2802,4572,7374,0,ITI,ITI4,12,Lazio,Lazio,5879082,1698649,28.89,0.13
1637,2021-02-07,LAZ,4942,2023,2919,387,4555,ITI,ITI4,12,Lazio,Lazio,5879082,1703591,28.98,0.08
1638,2021-05-03,LAZ,39103,17639,21464,26532,12571,ITI,ITI4,12,Lazio,Lazio,5879082,1742694,29.64,0.67
1639,2021-05-30,LAZ,41030,17513,23517,33804,7226,ITI,ITI4,12,Lazio,Lazio,5879082,1783724,30.34,0.7
1640,2021-04-24,LAZ,33338,15026,18312,20590,12748,ITI,ITI4,12,Lazio,Lazio,5879082,1817062,30.91,0.57
1641,2021-01-14,LAZ,5473,2142,3331,5473,0,ITI,ITI4,12,Lazio,Lazio,5879082,1822535,31.0,0.09
1642,2021-04-26,LAZ,29181,13432,15749,19979,9202,ITI,ITI4,12,Lazio,Lazio,5879082,1851716,31.5,0.5
1643,2021-01-16,LAZ,5645,2280,3365,5645,0,ITI,ITI4,12,Lazio,Lazio,5879082,1857361,31.59,0.1
1644,2021-05-16,LAZ,50895,24506,26389,37421,13474,ITI,ITI4,12,Lazio,Lazio,5879082,1908256,32.46,0.87
1645,2021-02-12,LAZ,6844,2845,3999,6432,412,ITI,ITI4,12,Lazio,Lazio,5879082,1915100,32.57,0.12
1646,2021-04-10,LAZ,23812,10315,13497,16630,7182,ITI,ITI4,12,Lazio,Lazio,5879082,1938912,32.98,0.41
1647,2021-02-05,LAZ,7278,2960,4318,1183,6095,ITI,ITI4,12,Lazio,Lazio,5879082,1946190,33.1,0.12
1648,2021-04-03,LAZ,24686,11093,13593,17987,6699,ITI,ITI4,12,Lazio,Lazio,5879082,1970876,33.52,0.42
1649,2020-12-31,LAZ,5293,2121,3172,5293,0,ITI,ITI4,12,Lazio,Lazio,5879082,1976169,33.61,0.09
1650,2021-02-19,LAZ,10047,5081,4966,9216,831,ITI,ITI4,12,Lazio,Lazio,5879082,1986216,33.78,0.17
1651,2021-04-08,LAZ,26651,12174,14477,18969,7682,ITI,ITI4,12,Lazio,Lazio,5879082,2012867,34.24,0.45
1652,2021-03-22,LAZ,21703,9067,12636,15040,6663,ITI,ITI4,12,Lazio,Lazio,5879082,2034570,34.61,0.37
1653,2021-03-05,LAZ,18793,7962,10831,14060,4733,ITI,ITI4,12,Lazio,Lazio,5879082,2053363,34.93,0.32
1654,2021-05-29,LAZ,51236,22848,28388,40865,10371,ITI,ITI4,12,Lazio,Lazio,5879082,2104599,35.8,0.87
1655,2021-05-15,LAZ,57058,27248,29810,40616,16442,ITI,ITI4,12,Lazio,Lazio,5879082,2161657,36.77,0.97
1656,2021-03-19,LAZ,17214,7363,9851,10886,6328,ITI,ITI4,12,Lazio,Lazio,5879082,2178871,37.06,0.29
1657,2021-05-25,LAZ,46185,21187,24998,35427,10758,ITI,ITI4,12,Lazio,Lazio,5879082,2225056,37.85,0.79
1658,2021-04-12,LAZ,23758,10677,13081,16861,6897,ITI,ITI4,12,Lazio,Lazio,5879082,2248814,38.25,0.4
1659,2021-02-21,LAZ,6987,3179,3808,6525,462,ITI,ITI4,12,Lazio,Lazio,5879082,2255801,38.37,0.12
1660,2021-02-28,LAZ,10248,4007,6241,9734,514,ITI,ITI4,12,Lazio,Lazio,5879082,2266049,38.54,0.17
1661,2021-01-09,LAZ,6296,2561,3735,6296,0,ITI,ITI4,12,Lazio,Lazio,5879082,2272345,38.65,0.11
1662,2021-02-26,LAZ,13075,5700,7375,11713,1362,ITI,ITI4,12,Lazio,Lazio,5879082,2285420,38.87,0.22
1663,2021-05-01,LAZ,37920,17069,20851,25970,11950,ITI,ITI4,12,Lazio,Lazio,5879082,2323340,39.52,0.64
1664,2021-04-17,LAZ,32307,14176,18131,20360,11947,ITI,ITI4,12,Lazio,Lazio,5879082,2355647,40.07,0.55
1665,2021-03-12,LAZ,22901,10128,12773,16587,6314,ITI,ITI4,12,Lazio,Lazio,5879082,2378548,40.46,0.39
1666,2021-01-21,LAZ,5601,2348,3253,548,5053,ITI,ITI4,12,Lazio,Lazio,5879082,2384149,40.55,0.1
1667,2021-01-07,LAZ,7747,2902,4845,7747,0,ITI,ITI4,12,Lazio,Lazio,5879082,2391896,40.68,0.13
1668,2021-06-01,LAZ,46882,22208,24674,29575,17307,ITI,ITI4,12,Lazio,Lazio,5879082,2438778,41.48,0.8
1669,2021-04-05,LAZ,19769,8992,10777,13591,6178,ITI,ITI4,12,Lazio,Lazio,5879082,2458547,41.82,0.34
1670,2021-04-19,LAZ,30061,13661,16400,19383,10678,ITI,ITI4,12,Lazio,Lazio,5879082,2488608,42.33,0.51
1671,2021-02-14,LAZ,5773,2370,3403,5303,470,ITI,ITI4,12,Lazio,Lazio,5879082,2494381,42.43,0.1
1672,2021-01-02,LAZ,6707,2631,4076,6707,0,ITI,ITI4,12,Lazio,Lazio,5879082,2501088,42.54,0.11
1673,2021-04-22,LAZ,38529,18929,19600,23952,14577,ITI,ITI4,12,Lazio,Lazio,5879082,2539617,43.2,0.66
1674,2021-03-10,LAZ,22021,9489,12532,16375,5646,ITI,ITI4,12,Lazio,Lazio,5879082,2561638,43.57,0.37
1675,2021-01-12,LAZ,5413,1981,3432,5413,0,ITI,ITI4,12,Lazio,Lazio,5879082,2567051,43.66,0.09
1676,2021-03-17,LAZ,13786,5896,7890,7531,6255,ITI,ITI4,12,Lazio,Lazio,5879082,2580837,43.9,0.23
1677,2021-03-03,LAZ,17396,7438,9958,13102,4294,ITI,ITI4,12,Lazio,Lazio,5879082,2598233,44.19,0.3
1678,2021-05-06,LAZ,48629,22616,26013,31105,17524,ITI,ITI4,12,Lazio,Lazio,5879082,2646862,45.02,0.83
1679,2021-01-19,LAZ,4768,1954,2814,4314,454,ITI,ITI4,12,Lazio,Lazio,5879082,2651630,45.1,0.08
1680,2021-04-02,LAZ,28546,13375,15171,21218,7328,ITI,ITI4,12,Lazio,Lazio,5879082,2680176,45.59,0.49
1681,2021-01-28,LAZ,8279,3165,5114,782,7497,ITI,ITI4,12,Lazio,Lazio,5879082,2688455,45.73,0.14
1682,2021-03-15,LAZ,19276,8332,10944,12537,6739,ITI,ITI4,12,Lazio,Lazio,5879082,2707731,46.06,0.33
1683,2021-01-24,LAZ,5694,2229,3465,612,5082,ITI,ITI4,12,Lazio,Lazio,5879082,2713425,46.15,0.1
1684,2021-05-18,LAZ,44136,20123,24013,34810,9326,ITI,ITI4,12,Lazio,Lazio,5879082,2757561,46.9,0.75
1685,2021-03-29,LAZ,23960,10760,13200,16923,7037,ITI,ITI4,12,Lazio,Lazio,5879082,2781521,47.31,0.41
1686,2021-06-03,LAZ,52520,26043,26477,37006,15514,ITI,ITI4,12,Lazio,Lazio,5879082,2834041,48.21,0.89
1687,2021-04-21,LAZ,32977,14973,18004,20613,12364,ITI,ITI4,12,Lazio,Lazio,5879082,2867018,48.77,0.56
1688,2021-05-20,LAZ,50670,24180,26490,37412,13258,ITI,ITI4,12,Lazio,Lazio,5879082,2917688,49.63,0.86
1689,2021-02-09,LAZ,8797,3768,5029,4580,4217,ITI,ITI4,12,Lazio,Lazio,5879082,2926485,49.78,0.15
1690,2021-03-31,LAZ,26105,12045,14060,19012,7093,ITI,ITI4,12,Lazio,Lazio,5879082,2952590,50.22,0.44
1691,2021-03-26,LAZ,28227,12253,15974,21384,6843,ITI,ITI4,12,Lazio,Lazio,5879082,2980817,50.7,0.48
1692,2021-03-14,LAZ,17103,6614,10489,11949,5154,ITI,ITI4,12,Lazio,Lazio,5879082,2997920,50.99,0.29
1693,2021-05-26,LAZ,46072,20588,25484,34927,11145,ITI,ITI4,12,Lazio,Lazio,5879082,3043992,51.78,0.78
1694,2021-03-23,LAZ,23503,10229,13274,16926,6577,ITI,ITI4,12,Lazio,Lazio,5879082,3067495,52.18,0.4
1695,2021-02-15,LAZ,8025,3540,4485,7394,631,ITI,ITI4,12,Lazio,Lazio,5879082,3075520,52.31,0.14
1696,2021-05-28,LAZ,55860,25555,30305,43384,12476,ITI,ITI4,12,Lazio,Lazio,5879082,3131380,53.26,0.95
1697,2021-02-17,LAZ,9181,4603,4578,8307,874,ITI,ITI4,12,Lazio,Lazio,5879082,3140561,53.42,0.16
1698,2020-12-29,LAZ,488,176,312,488,0,ITI,ITI4,12,Lazio,Lazio,5879082,3141049,53.43,0.01
1699,2021-03-24,LAZ,25877,11298,14579,19640,6237,ITI,ITI4,12,Lazio,Lazio,5879082,3166926,53.87,0.44
1700,2021-05-27,LAZ,56230,25398,30832,43834,12396,ITI,ITI4,12,Lazio,Lazio,5879082,3223156,54.82,0.96
1701,2021-03-07,LAZ,14111,5442,8669,10518,3593,ITI,ITI4,12,Lazio,Lazio,5879082,3237267,55.06,0.24
1702,2021-02-16,LAZ,8354,4033,4321,7749,605,ITI,ITI4,12,Lazio,Lazio,5879082,3245621,55.21,0.14
1703,2021-02-04,LAZ,6302,2481,3821,987,5315,ITI,ITI4,12,Lazio,Lazio,5879082,3251923,55.31,0.11
1704,2021-05-22,LAZ,54669,26647,28022,44251,10418,ITI,ITI4,12,Lazio,Lazio,5879082,3306592,56.24,0.93
1705,2021-05-11,LAZ,47916,21962,25954,31521,16395,ITI,ITI4,12,Lazio,Lazio,5879082,3354508,57.06,0.82
1706,2021-01-31,LAZ,4459,1854,2605,476,3983,ITI,ITI4,12,Lazio,Lazio,5879082,3358967,57.13,0.08
1707,2021-05-13,LAZ,49501,22178,27323,31860,17641,ITI,ITI4,12,Lazio,Lazio,5879082,3408468,57.98,0.84
1708,2021-04-07,LAZ,24959,11321,13638,17655,7304,ITI,ITI4,12,Lazio,Lazio,5879082,3433427,58.4,0.42
1709,2021-02-02,LAZ,5909,2213,3696,637,5272,ITI,ITI4,12,Lazio,Lazio,5879082,3439336,58.5,0.1
1710,2021-04-14,LAZ,29270,13261,16009,19149,10121,ITI,ITI4,12,Lazio,Lazio,5879082,3468606,59.0,0.5
1711,2021-05-10,LAZ,44316,20233,24083,30943,13373,ITI,ITI4,12,Lazio,Lazio,5879082,3512922,59.75,0.75
1712,2020-12-28,LAZ,959,412,547,959,0,ITI,ITI4,12,Lazio,Lazio,5879082,3513881,59.77,0.02
1713,2021-02-23,LAZ,11087,4780,6307,10326,761,ITI,ITI4,12,Lazio,Lazio,5879082,3524968,59.96,0.19
1714,2021-06-03,TOS,29889,14357,15532,25623,4266,ITI,ITI1,9,Toscana,Toscana,3729641,29889,0.8,0.8
1715,2021-02-16,TOS,9279,3339,5940,8558,721,ITI,ITI1,9,Toscana,Toscana,3729641,39168,1.05,0.25
1716,2021-04-21,TOS,29599,12663,16936,17515,12084,ITI,ITI1,9,Toscana,Toscana,3729641,68767,1.84,0.79
1717,2021-02-25,TOS,10634,4306,6328,9635,999,ITI,ITI1,9,Toscana,Toscana,3729641,79401,2.13,0.29
1718,2021-04-30,TOS,40096,17740,22356,20240,19856,ITI,ITI1,9,Toscana,Toscana,3729641,119497,3.2,1.08
1719,2021-04-25,TOS,11054,5248,5806,8917,2137,ITI,ITI1,9,Toscana,Toscana,3729641,130551,3.5,0.3
1720,2021-03-26,TOS,20405,9161,11244,14644,5761,ITI,ITI1,9,Toscana,Toscana,3729641,150956,4.05,0.55
1721,2021-05-29,TOS,31432,15196,16236,23344,8088,ITI,ITI1,9,Toscana,Toscana,3729641,182388,4.89,0.84
1722,2021-03-09,TOS,10674,4152,6522,5122,5552,ITI,ITI1,9,Toscana,Toscana,3729641,193062,5.18,0.29
1723,2021-04-09,TOS,24531,10546,13985,21122,3409,ITI,ITI1,9,Toscana,Toscana,3729641,217593,5.83,0.66
1724,2021-02-04,TOS,4253,1594,2659,961,3292,ITI,ITI1,9,Toscana,Toscana,3729641,221846,5.95,0.11
1725,2021-03-23,TOS,9093,4102,4991,6819,2274,ITI,ITI1,9,Toscana,Toscana,3729641,230939,6.19,0.24
1726,2021-05-12,TOS,34123,15545,18578,14160,19963,ITI,ITI1,9,Toscana,Toscana,3729641,265062,7.11,0.91
1727,2021-01-18,TOS,1119,636,483,1021,98,ITI,ITI1,9,Toscana,Toscana,3729641,266181,7.14,0.03
1728,2021-05-22,TOS,25961,12629,13332,21704,4257,ITI,ITI1,9,Toscana,Toscana,3729641,292142,7.83,0.7
1729,2021-02-09,TOS,4488,1468,3020,3877,611,ITI,ITI1,9,Toscana,Toscana,3729641,296630,7.95,0.12
1730,2021-05-05,TOS,30093,13426,16667,15646,14447,ITI,ITI1,9,Toscana,Toscana,3729641,326723,8.76,0.81
1731,2021-02-11,TOS,5383,2021,3362,5141,242,ITI,ITI1,9,Toscana,Toscana,3729641,332106,8.9,0.14
1732,2021-01-25,TOS,5127,1896,3231,248,4879,ITI,ITI1,9,Toscana,Toscana,3729641,337233,9.04,0.14
1733,2021-05-07,TOS,32078,14671,17407,11989,20089,ITI,ITI1,9,Toscana,Toscana,3729641,369311,9.9,0.86
1734,2021-01-09,TOS,4485,1596,2889,4485,0,ITI,ITI1,9,Toscana,Toscana,3729641,373796,10.02,0.12
1735,2021-04-04,TOS,13910,6601,7309,13657,253,ITI,ITI1,9,Toscana,Toscana,3729641,387706,10.4,0.37
1736,2021-03-18,TOS,9970,3981,5989,6005,3965,ITI,ITI1,9,Toscana,Toscana,3729641,397676,10.66,0.27
1737,2021-04-07,TOS,35636,15293,20343,28387,7249,ITI,ITI1,9,Toscana,Toscana,3729641,433312,11.62,0.96
1738,2021-04-14,TOS,20160,8335,11825,15051,5109,ITI,ITI1,9,Toscana,Toscana,3729641,453472,12.16,0.54
1739,2021-04-16,TOS,28955,12889,16066,22045,6910,ITI,ITI1,9,Toscana,Toscana,3729641,482427,12.93,0.78
1740,2021-03-02,TOS,10598,3798,6800,7154,3444,ITI,ITI1,9,Toscana,Toscana,3729641,493025,13.22,0.28
1741,2021-01-04,TOS,5065,1894,3171,5065,0,ITI,ITI1,9,Toscana,Toscana,3729641,498090,13.35,0.14
1742,2021-03-04,TOS,17626,6760,10866,14544,3082,ITI,ITI1,9,Toscana,Toscana,3729641,515716,13.83,0.47
1743,2021-01-06,TOS,4520,1460,3060,4520,0,ITI,ITI1,9,Toscana,Toscana,3729641,520236,13.95,0.12
1744,2021-03-19,TOS,10136,4457,5679,7271,2865,ITI,ITI1,9,Toscana,Toscana,3729641,530372,14.22,0.27
1745,2021-01-21,TOS,1589,686,903,867,722,ITI,ITI1,9,Toscana,Toscana,3729641,531961,14.26,0.04
1746,2021-06-02,TOS,27226,13435,13791,21740,5486,ITI,ITI1,9,Toscana,Toscana,3729641,559187,14.99,0.73
1747,2021-02-08,TOS,4097,1360,2737,3638,459,ITI,ITI1,9,Toscana,Toscana,3729641,563284,15.1,0.11
1748,2021-04-13,TOS,8490,3508,4982,6032,2458,ITI,ITI1,9,Toscana,Toscana,3729641,571774,15.33,0.23
1749,2021-05-26,TOS,35179,16775,18404,20168,15011,ITI,ITI1,9,Toscana,Toscana,3729641,606953,16.27,0.94
1750,2021-03-30,TOS,16861,7498,9363,13297,3564,ITI,ITI1,9,Toscana,Toscana,3729641,623814,16.73,0.45
1751,2021-05-14,TOS,33252,15382,17870,20633,12619,ITI,ITI1,9,Toscana,Toscana,3729641,657066,17.62,0.89
1752,2021-01-28,TOS,6282,1882,4400,354,5928,ITI,ITI1,9,Toscana,Toscana,3729641,663348,17.79,0.17
1753,2021-05-19,TOS,27768,13442,14326,18872,8896,ITI,ITI1,9,Toscana,Toscana,3729641,691116,18.53,0.74
1754,2021-04-06,TOS,22170,9774,12396,18456,3714,ITI,ITI1,9,Toscana,Toscana,3729641,713286,19.12,0.59
1755,2021-05-03,TOS,11933,5510,6423,10614,1319,ITI,ITI1,9,Toscana,Toscana,3729641,725219,19.44,0.32
1756,2021-05-17,TOS,29477,14631,14846,20806,8671,ITI,ITI1,9,Toscana,Toscana,3729641,754696,20.24,0.79
1757,2021-03-21,TOS,3231,1573,1658,1798,1433,ITI,ITI1,9,Toscana,Toscana,3729641,757927,20.32,0.09
1758,2021-01-23,TOS,3949,1354,2595,640,3309,ITI,ITI1,9,Toscana,Toscana,3729641,761876,20.43,0.11
1759,2021-03-28,TOS,6212,2808,3404,5958,254,ITI,ITI1,9,Toscana,Toscana,3729641,768088,20.59,0.17
1760,2021-01-30,TOS,4622,1622,3000,198,4424,ITI,ITI1,9,Toscana,Toscana,3729641,772710,20.72,0.12
1761,2021-05-10,TOS,26138,12350,13788,15521,10617,ITI,ITI1,9,Toscana,Toscana,3729641,798848,21.42,0.7
1762,2021-03-14,TOS,7173,2561,4612,3238,3935,ITI,ITI1,9,Toscana,Toscana,3729641,806021,21.61,0.19
1763,2021-02-06,TOS,4527,1550,2977,1294,3233,ITI,ITI1,9,Toscana,Toscana,3729641,810548,21.73,0.12
1764,2021-01-11,TOS,5094,1691,3403,5094,0,ITI,ITI1,9,Toscana,Toscana,3729641,815642,21.87,0.14
1765,2021-02-23,TOS,7721,3324,4397,7560,161,ITI,ITI1,9,Toscana,Toscana,3729641,823363,22.08,0.21
1766,2021-04-23,TOS,25676,11429,14247,9361,16315,ITI,ITI1,9,Toscana,Toscana,3729641,849039,22.76,0.69
1767,2021-05-02,TOS,11167,4931,6236,9204,1963,ITI,ITI1,9,Toscana,Toscana,3729641,860206,23.06,0.3
1768,2021-01-20,TOS,1331,637,694,1083,248,ITI,ITI1,9,Toscana,Toscana,3729641,861537,23.1,0.04
1769,2021-05-15,TOS,29298,13830,15468,23558,5740,ITI,ITI1,9,Toscana,Toscana,3729641,890835,23.89,0.79
1770,2021-04-28,TOS,19119,8187,10932,3830,15289,ITI,ITI1,9,Toscana,Toscana,3729641,909954,24.4,0.51
1771,2021-02-18,TOS,8819,3284,5535,7924,895,ITI,ITI1,9,Toscana,Toscana,3729641,918773,24.63,0.24
1772,2020-12-30,TOS,327,104,223,327,0,ITI,ITI1,9,Toscana,Toscana,3729641,919100,24.64,0.01
1773,2021-02-01,TOS,5509,1958,3551,521,4988,ITI,ITI1,9,Toscana,Toscana,3729641,924609,24.79,0.15
1774,2021-04-26,TOS,10153,4943,5210,7598,2555,ITI,ITI1,9,Toscana,Toscana,3729641,934762,25.06,0.27
1775,2021-01-02,TOS,3497,1096,2401,3497,0,ITI,ITI1,9,Toscana,Toscana,3729641,938259,25.16,0.09
1776,2021-03-07,TOS,5647,2357,3290,2105,3542,ITI,ITI1,9,Toscana,Toscana,3729641,943906,25.31,0.15
1777,2021-01-16,TOS,3271,1046,2225,3271,0,ITI,ITI1,9,Toscana,Toscana,3729641,947177,25.4,0.09
1778,2021-05-31,TOS,30024,14396,15628,19353,10671,ITI,ITI1,9,Toscana,Toscana,3729641,977201,26.2,0.81
1779,2021-04-11,TOS,3642,1679,1963,3487,155,ITI,ITI1,9,Toscana,Toscana,3729641,980843,26.3,0.1
1780,2021-02-20,TOS,4640,1789,2851,4127,513,ITI,ITI1,9,Toscana,Toscana,3729641,985483,26.42,0.12
1781,2021-01-13,TOS,4062,1398,2664,4062,0,ITI,ITI1,9,Toscana,Toscana,3729641,989545,26.53,0.11
1782,2021-01-22,TOS,2866,1064,1802,528,2338,ITI,ITI1,9,Toscana,Toscana,3729641,992411,26.61,0.08
1783,2021-03-27,TOS,8860,4150,4710,8645,215,ITI,ITI1,9,Toscana,Toscana,3729641,1001271,26.85,0.24
1784,2021-05-25,TOS,33814,16216,17598,19336,14478,ITI,ITI1,9,Toscana,Toscana,3729641,1035085,27.75,0.91
1785,2021-03-22,TOS,4890,2451,2439,4446,444,ITI,ITI1,9,Toscana,Toscana,3729641,1039975,27.88,0.13
1786,2021-04-02,TOS,31945,13535,18410,23921,8024,ITI,ITI1,9,Toscana,Toscana,3729641,1071920,28.74,0.86
1787,2021-03-16,TOS,4903,1884,3019,2653,2250,ITI,ITI1,9,Toscana,Toscana,3729641,1076823,28.87,0.13
1788,2021-02-27,TOS,1983,756,1227,1081,902,ITI,ITI1,9,Toscana,Toscana,3729641,1078806,28.93,0.05
1789,2021-01-17,TOS,2536,871,1665,2023,513,ITI,ITI1,9,Toscana,Toscana,3729641,1081342,28.99,0.07
1790,2021-05-30,TOS,28623,13929,14694,21703,6920,ITI,ITI1,9,Toscana,Toscana,3729641,1109965,29.76,0.77
1791,2020-12-31,TOS,804,202,602,804,0,ITI,ITI1,9,Toscana,Toscana,3729641,1110769,29.78,0.02
1792,2021-04-01,TOS,26905,11108,15797,16301,10604,ITI,ITI1,9,Toscana,Toscana,3729641,1137674,30.5,0.72
1793,2021-01-27,TOS,4835,1573,3262,206,4629,ITI,ITI1,9,Toscana,Toscana,3729641,1142509,30.63,0.13
1794,2021-03-17,TOS,11421,4586,6835,6893,4528,ITI,ITI1,9,Toscana,Toscana,3729641,1153930,30.94,0.31
1795,2021-05-28,TOS,29811,13701,16110,17478,12333,ITI,ITI1,9,Toscana,Toscana,3729641,1183741,31.74,0.8
1796,2021-04-08,TOS,29655,12538,17117,23275,6380,ITI,ITI1,9,Toscana,Toscana,3729641,1213396,32.53,0.8
1797,2021-04-15,TOS,24393,10192,14201,15866,8527,ITI,ITI1,9,Toscana,Toscana,3729641,1237789,33.19,0.65
1798,2021-02-17,TOS,8175,3169,5006,7423,752,ITI,ITI1,9,Toscana,Toscana,3729641,1245964,33.41,0.22
1799,2021-04-22,TOS,35722,15303,20419,18282,17440,ITI,ITI1,9,Toscana,Toscana,3729641,1281686,34.36,0.96
1800,2021-02-24,TOS,10372,4467,5905,10171,201,ITI,ITI1,9,Toscana,Toscana,3729641,1292058,34.64,0.28
1801,2021-03-03,TOS,18193,6509,11684,14587,3606,ITI,ITI1,9,Toscana,Toscana,3729641,1310251,35.13,0.49
1802,2021-01-05,TOS,5249,1755,3494,5249,0,ITI,ITI1,9,Toscana,Toscana,3729641,1315500,35.27,0.14
1803,2021-01-12,TOS,3581,1398,2183,3581,0,ITI,ITI1,9,Toscana,Toscana,3729641,1319081,35.37,0.1
1804,2021-01-19,TOS,1104,531,573,1104,0,ITI,ITI1,9,Toscana,Toscana,3729641,1320185,35.4,0.03
1805,2021-05-21,TOS,28599,13226,15373,17445,11154,ITI,ITI1,9,Toscana,Toscana,3729641,1348784,36.16,0.77
1806,2021-03-01,TOS,4472,1733,2739,832,3640,ITI,ITI1,9,Toscana,Toscana,3729641,1353256,36.28,0.12
1807,2021-05-04,TOS,18301,8207,10094,12854,5447,ITI,ITI1,9,Toscana,Toscana,3729641,1371557,36.77,0.49
1808,2021-02-12,TOS,7606,2683,4923,7393,213,ITI,ITI1,9,Toscana,Toscana,3729641,1379163,36.98,0.2
1809,2021-04-17,TOS,20533,9206,11327,18411,2122,ITI,ITI1,9,Toscana,Toscana,3729641,1399696,37.53,0.55
1810,2021-03-11,TOS,15495,5993,9502,12169,3326,ITI,ITI1,9,Toscana,Toscana,3729641,1415191,37.94,0.42
1811,2020-12-27,TOS,620,267,353,620,0,ITI,ITI1,9,Toscana,Toscana,3729641,1415811,37.96,0.02
1812,2021-05-08,TOS,29141,13108,16033,13693,15448,ITI,ITI1,9,Toscana,Toscana,3729641,1444952,38.74,0.78
1813,2021-01-14,TOS,3255,1179,2076,3255,0,ITI,ITI1,9,Toscana,Toscana,3729641,1448207,38.83,0.09
1814,2021-02-03,TOS,4221,1452,2769,241,3980,ITI,ITI1,9,Toscana,Toscana,3729641,1452428,38.94,0.11
1815,2021-03-25,TOS,23613,10123,13490,15274,8339,ITI,ITI1,9,Toscana,Toscana,3729641,1476041,39.58,0.63
1816,2021-05-13,TOS,34860,15330,19530,13721,21139,ITI,ITI1,9,Toscana,Toscana,3729641,1510901,40.51,0.93
1817,2021-04-29,TOS,39333,17708,21625,19237,20096,ITI,ITI1,9,Toscana,Toscana,3729641,1550234,41.57,1.05
1818,2021-03-10,TOS,18014,7073,10941,13996,4018,ITI,ITI1,9,Toscana,Toscana,3729641,1568248,42.05,0.48
1819,2021-03-24,TOS,19687,8004,11683,10230,9457,ITI,ITI1,9,Toscana,Toscana,3729641,1587935,42.58,0.53
1820,2021-01-03,TOS,3335,1051,2284,3335,0,ITI,ITI1,9,Toscana,Toscana,3729641,1591270,42.67,0.09
1821,2021-02-15,TOS,8771,3375,5396,7946,825,ITI,ITI1,9,Toscana,Toscana,3729641,1600041,42.9,0.24
1822,2021-02-22,TOS,9818,4254,5564,9541,277,ITI,ITI1,9,Toscana,Toscana,3729641,1609859,43.16,0.26
1823,2021-04-24,TOS,13435,6164,7271,5991,7444,ITI,ITI1,9,Toscana,Toscana,3729641,1623294,43.52,0.36
1824,2021-03-12,TOS,16521,6220,10301,12993,3528,ITI,ITI1,9,Toscana,Toscana,3729641,1639815,43.97,0.44
1825,2021-05-16,TOS,26660,12879,13781,24200,2460,ITI,ITI1,9,Toscana,Toscana,3729641,1666475,44.68,0.71
1826,2021-03-13,TOS,9275,3301,5974,5312,3963,ITI,ITI1,9,Toscana,Toscana,3729641,1675750,44.93,0.25
1827,2021-05-09,TOS,22515,9760,12755,9656,12859,ITI,ITI1,9,Toscana,Toscana,3729641,1698265,45.53,0.6
1828,2021-02-05,TOS,5749,2245,3504,1924,3825,ITI,ITI1,9,Toscana,Toscana,3729641,1704014,45.69,0.15
1829,2021-05-11,TOS,27937,12980,14957,12480,15457,ITI,ITI1,9,Toscana,Toscana,3729641,1731951,46.44,0.75
1830,2021-01-29,TOS,6144,1700,4444,304,5840,ITI,ITI1,9,Toscana,Toscana,3729641,1738095,46.6,0.16
1831,2021-01-31,TOS,3050,1129,1921,106,2944,ITI,ITI1,9,Toscana,Toscana,3729641,1741145,46.68,0.08
1832,2021-04-05,TOS,15279,6823,8456,14542,737,ITI,ITI1,9,Toscana,Toscana,3729641,1756424,47.09,0.41
1833,2021-05-18,TOS,28701,14144,14557,19987,8714,ITI,ITI1,9,Toscana,Toscana,3729641,1785125,47.86,0.77
1834,2021-02-07,TOS,2805,952,1853,885,1920,ITI,ITI1,9,Toscana,Toscana,3729641,1787930,47.94,0.08
1835,2021-03-20,TOS,6490,2884,3606,5354,1136,ITI,ITI1,9,Toscana,Toscana,3729641,1794420,48.11,0.17
1836,2021-03-29,TOS,9391,4588,4803,9067,324,ITI,ITI1,9,Toscana,Toscana,3729641,1803811,48.36,0.25
1837,2021-02-14,TOS,9000,2569,6431,8890,110,ITI,ITI1,9,Toscana,Toscana,3729641,1812811,48.61,0.24
1838,2021-04-27,TOS,10347,4910,5437,3866,6481,ITI,ITI1,9,Toscana,Toscana,3729641,1823158,48.88,0.28
1839,2021-03-08,TOS,6371,2630,3741,1551,4820,ITI,ITI1,9,Toscana,Toscana,3729641,1829529,49.05,0.17
1840,2021-04-10,TOS,11722,5348,6374,10977,745,ITI,ITI1,9,Toscana,Toscana,3729641,1841251,49.37,0.31
1841,2021-02-19,TOS,8291,2952,5339,7781,510,ITI,ITI1,9,Toscana,Toscana,3729641,1849542,49.59,0.22
1842,2021-01-01,TOS,2369,787,1582,2369,0,ITI,ITI1,9,Toscana,Toscana,3729641,1851911,49.65,0.06
1843,2021-03-06,TOS,7094,2838,4256,2901,4193,ITI,ITI1,9,Toscana,Toscana,3729641,1859005,49.84,0.19
1844,2021-01-15,TOS,3878,1347,2531,3878,0,ITI,ITI1,9,Toscana,Toscana,3729641,1862883,49.95,0.1
1845,2021-06-01,TOS,26679,13191,13488,23005,3674,ITI,ITI1,9,Toscana,Toscana,3729641,1889562,50.66,0.72
1846,2021-04-12,TOS,2612,1183,1429,1958,654,ITI,ITI1,9,Toscana,Toscana,3729641,1892174,50.73,0.07
1847,2021-03-31,TOS,32575,13135,19440,20418,12157,ITI,ITI1,9,Toscana,Toscana,3729641,1924749,51.61,0.87
1848,2021-02-28,TOS,1649,667,982,922,727,ITI,ITI1,9,Toscana,Toscana,3729641,1926398,51.65,0.04
1849,2021-05-24,TOS,33367,16400,16967,24090,9277,ITI,ITI1,9,Toscana,Toscana,3729641,1959765,52.55,0.89
1850,2021-02-13,TOS,7785,2360,5425,7558,227,ITI,ITI1,9,Toscana,Toscana,3729641,1967550,52.75,0.21
1851,2021-04-18,TOS,8338,4083,4255,7342,996,ITI,ITI1,9,Toscana,Toscana,3729641,1975888,52.98,0.22
1852,2021-02-10,TOS,4263,1281,2982,3740,523,ITI,ITI1,9,Toscana,Toscana,3729641,1980151,53.09,0.11
1853,2021-05-23,TOS,28368,13642,14726,25804,2564,ITI,ITI1,9,Toscana,Toscana,3729641,2008519,53.85,0.76
1854,2021-05-06,TOS,31326,13612,17714,14171,17155,ITI,ITI1,9,Toscana,Toscana,3729641,2039845,54.69,0.84
1855,2021-01-24,TOS,3349,1073,2276,201,3148,ITI,ITI1,9,Toscana,Toscana,3729641,2043194,54.78,0.09
1856,2021-01-26,TOS,5393,1792,3601,220,5173,ITI,ITI1,9,Toscana,Toscana,3729641,2048587,54.93,0.14
1857,2021-05-20,TOS,29476,13675,15801,18895,10581,ITI,ITI1,9,Toscana,Toscana,3729641,2078063,55.72,0.79
1858,2021-03-05,TOS,16494,6336,10158,11752,4742,ITI,ITI1,9,Toscana,Toscana,3729641,2094557,56.16,0.44
1859,2021-02-02,TOS,3742,1475,2267,195,3547,ITI,ITI1,9,Toscana,Toscana,3729641,2098299,56.26,0.1
1860,2021-05-01,TOS,23309,10061,13248,14135,9174,ITI,ITI1,9,Toscana,Toscana,3729641,2121608,56.89,0.62
1861,2021-05-27,TOS,27887,12812,15075,13249,14638,ITI,ITI1,9,Toscana,Toscana,3729641,2149495,57.63,0.75
1862,2021-01-08,TOS,5946,1642,4304,5946,0,ITI,ITI1,9,Toscana,Toscana,3729641,2155441,57.79,0.16
1863,2021-04-20,TOS,18157,8111,10046,12599,5558,ITI,ITI1,9,Toscana,Toscana,3729641,2173598,58.28,0.49
1864,2021-03-15,TOS,8356,3332,5024,3913,4443,ITI,ITI1,9,Toscana,Toscana,3729641,2181954,58.5,0.22
1865,2021-01-10,TOS,3001,1104,1897,3001,0,ITI,ITI1,9,Toscana,Toscana,3729641,2184955,58.58,0.08
1866,2021-04-03,TOS,15014,6646,8368,13888,1126,ITI,ITI1,9,Toscana,Toscana,3729641,2199969,58.99,0.4
1867,2021-02-26,TOS,10076,3833,6243,8870,1206,ITI,ITI1,9,Toscana,Toscana,3729641,2210045,59.26,0.27
1868,2021-04-19,TOS,9091,4505,4586,8063,1028,ITI,ITI1,9,Toscana,Toscana,3729641,2219136,59.5,0.24
1869,2021-01-07,TOS,6018,1751,4267,6018,0,ITI,ITI1,9,Toscana,Toscana,3729641,2225154,59.66,0.16
1870,2021-02-21,TOS,5105,2089,3016,4935,170,ITI,ITI1,9,Toscana,Toscana,3729641,2230259,59.8,0.14
1871,2021-01-31,MOL,268,70,198,6,262,ITF,ITF2,14,Molise,Molise,305617,268,0.09,0.09
1872,2021-04-05,MOL,391,189,202,292,99,ITF,ITF2,14,Molise,Molise,305617,659,0.22,0.13
1873,2021-03-31,MOL,2193,919,1274,1374,819,ITF,ITF2,14,Molise,Molise,305617,2852,0.93,0.72
1874,2021-06-03,MOL,3078,1478,1600,2587,491,ITF,ITF2,14,Molise,Molise,305617,5930,1.94,1.01
1875,2021-02-12,MOL,330,149,181,208,122,ITF,ITF2,14,Molise,Molise,305617,6260,2.05,0.11
1876,2021-03-15,MOL,832,338,494,587,245,ITF,ITF2,14,Molise,Molise,305617,7092,2.32,0.27
1877,2021-05-08,MOL,2972,1453,1519,1728,1244,ITF,ITF2,14,Molise,Molise,305617,10064,3.29,0.97
1878,2021-05-22,MOL,1307,706,601,1225,82,ITF,ITF2,14,Molise,Molise,305617,11371,3.72,0.43
1879,2021-03-02,MOL,667,383,284,509,158,ITF,ITF2,14,Molise,Molise,305617,12038,3.94,0.22
1880,2021-04-21,MOL,1862,788,1074,967,895,ITF,ITF2,14,Molise,Molise,305617,13900,4.55,0.61
1881,2021-05-03,MOL,2484,1164,1320,2321,163,ITF,ITF2,14,Molise,Molise,305617,16384,5.36,0.81
1882,2021-05-10,MOL,2889,1285,1604,2516,373,ITF,ITF2,14,Molise,Molise,305617,19273,6.31,0.95
1883,2021-01-17,MOL,78,38,40,48,30,ITF,ITF2,14,Molise,Molise,305617,19351,6.33,0.03
1884,2021-04-10,MOL,2635,1259,1376,2483,152,ITF,ITF2,14,Molise,Molise,305617,21986,7.19,0.86
1885,2021-02-05,MOL,593,269,324,55,538,ITF,ITF2,14,Molise,Molise,305617,22579,7.39,0.19
1886,2021-04-12,MOL,1299,557,742,1048,251,ITF,ITF2,14,Molise,Molise,305617,23878,7.81,0.43
1887,2021-03-07,MOL,1132,501,631,1130,2,ITF,ITF2,14,Molise,Molise,305617,25010,8.18,0.37
1888,2021-03-10,MOL,1737,720,1017,1687,50,ITF,ITF2,14,Molise,Molise,305617,26747,8.75,0.57
1889,2021-05-13,MOL,3037,1409,1628,2580,457,ITF,ITF2,14,Molise,Molise,305617,29784,9.75,0.99
1890,2021-02-21,MOL,573,227,346,571,2,ITF,ITF2,14,Molise,Molise,305617,30357,9.93,0.19
1891,2021-04-26,MOL,1157,521,636,826,331,ITF,ITF2,14,Molise,Molise,305617,31514,10.31,0.38
1892,2021-02-04,MOL,758,295,463,77,681,ITF,ITF2,14,Molise,Molise,305617,32272,10.56,0.25
1893,2021-05-18,MOL,1645,877,768,990,655,ITF,ITF2,14,Molise,Molise,305617,33917,11.1,0.54
1894,2021-03-22,MOL,1146,439,707,903,243,ITF,ITF2,14,Molise,Molise,305617,35063,11.47,0.37
1895,2021-05-25,MOL,1960,885,1075,1330,630,ITF,ITF2,14,Molise,Molise,305617,37023,12.11,0.64
1896,2021-02-07,MOL,66,32,34,19,47,ITF,ITF2,14,Molise,Molise,305617,37089,12.14,0.02
1897,2021-04-17,MOL,3051,1500,1551,1565,1486,ITF,ITF2,14,Molise,Molise,305617,40140,13.13,1.0
1898,2021-05-01,MOL,2641,1266,1375,420,2221,ITF,ITF2,14,Molise,Molise,305617,42781,14.0,0.86
1899,2021-03-05,MOL,1219,649,570,1015,204,ITF,ITF2,14,Molise,Molise,305617,44000,14.4,0.4
1900,2021-02-26,MOL,563,260,303,490,73,ITF,ITF2,14,Molise,Molise,305617,44563,14.58,0.18
1901,2021-03-19,MOL,1184,482,702,757,427,ITF,ITF2,14,Molise,Molise,305617,45747,14.97,0.39
1902,2021-01-14,MOL,646,239,407,646,0,ITF,ITF2,14,Molise,Molise,305617,46393,15.18,0.21
1903,2021-04-19,MOL,1827,842,985,1049,778,ITF,ITF2,14,Molise,Molise,305617,48220,15.78,0.6
1904,2021-02-28,MOL,831,333,498,789,42,ITF,ITF2,14,Molise,Molise,305617,49051,16.05,0.27
1905,2021-01-09,MOL,450,152,298,450,0,ITF,ITF2,14,Molise,Molise,305617,49501,16.2,0.15
1906,2021-04-24,MOL,2546,1199,1347,705,1841,ITF,ITF2,14,Molise,Molise,305617,52047,17.03,0.83
1907,2021-01-21,MOL,6,2,4,6,0,ITF,ITF2,14,Molise,Molise,305617,52053,17.03,0.0
1908,2021-03-12,MOL,1459,637,822,1423,36,ITF,ITF2,14,Molise,Molise,305617,53512,17.51,0.48
1909,2021-01-28,MOL,613,217,396,17,596,ITF,ITF2,14,Molise,Molise,305617,54125,17.71,0.2
1910,2021-01-12,MOL,336,114,222,336,0,ITF,ITF2,14,Molise,Molise,305617,54461,17.82,0.11
1911,2021-02-24,MOL,666,278,388,333,333,ITF,ITF2,14,Molise,Molise,305617,55127,18.04,0.22
1912,2021-03-03,MOL,672,316,356,590,82,ITF,ITF2,14,Molise,Molise,305617,55799,18.26,0.22
1913,2021-01-05,MOL,449,180,269,449,0,ITF,ITF2,14,Molise,Molise,305617,56248,18.4,0.15
1914,2021-03-29,MOL,2033,835,1198,1547,486,ITF,ITF2,14,Molise,Molise,305617,58281,19.07,0.67
1915,2021-04-07,MOL,1688,847,841,1413,275,ITF,ITF2,14,Molise,Molise,305617,59969,19.62,0.55
1916,2021-02-23,MOL,582,223,359,363,219,ITF,ITF2,14,Molise,Molise,305617,60551,19.81,0.19
1917,2021-01-07,MOL,598,209,389,598,0,ITF,ITF2,14,Molise,Molise,305617,61149,20.01,0.2
1918,2021-04-02,MOL,1453,708,745,676,777,ITF,ITF2,14,Molise,Molise,305617,62602,20.48,0.48
1919,2021-02-11,MOL,293,133,160,257,36,ITF,ITF2,14,Molise,Molise,305617,62895,20.58,0.1
1920,2021-05-06,MOL,2679,1214,1465,2081,598,ITF,ITF2,14,Molise,Molise,305617,65574,21.46,0.88
1921,2021-01-26,MOL,450,184,266,8,442,ITF,ITF2,14,Molise,Molise,305617,66024,21.6,0.15
1922,2021-03-17,MOL,908,385,523,576,332,ITF,ITF2,14,Molise,Molise,305617,66932,21.9,0.3
1923,2021-05-20,MOL,2572,1325,1247,2397,175,ITF,ITF2,14,Molise,Molise,305617,69504,22.74,0.84
1924,2021-04-14,MOL,1806,767,1039,1145,661,ITF,ITF2,14,Molise,Molise,305617,71310,23.33,0.59
1925,2021-02-16,MOL,156,70,86,150,6,ITF,ITF2,14,Molise,Molise,305617,71466,23.38,0.05
1926,2021-05-27,MOL,2825,1342,1483,1991,834,ITF,ITF2,14,Molise,Molise,305617,74291,24.31,0.92
1927,2021-02-09,MOL,359,170,189,197,162,ITF,ITF2,14,Molise,Molise,305617,74650,24.43,0.12
1928,2021-01-04,MOL,314,131,183,314,0,ITF,ITF2,14,Molise,Molise,305617,74964,24.53,0.1
1929,2021-05-29,MOL,2289,1194,1095,1935,354,ITF,ITF2,14,Molise,Molise,305617,77253,25.28,0.75
1930,2021-02-25,MOL,541,239,302,473,68,ITF,ITF2,14,Molise,Molise,305617,77794,25.45,0.18
1931,2021-04-30,MOL,2935,1554,1381,829,2106,ITF,ITF2,14,Molise,Molise,305617,80729,26.42,0.96
1932,2021-05-09,MOL,2051,932,1119,1955,96,ITF,ITF2,14,Molise,Molise,305617,82780,27.09,0.67
1933,2021-03-06,MOL,1728,807,921,1569,159,ITF,ITF2,14,Molise,Molise,305617,84508,27.65,0.57
1934,2021-02-19,MOL,169,93,76,167,2,ITF,ITF2,14,Molise,Molise,305617,84677,27.71,0.06
1935,2021-06-01,MOL,2547,1307,1240,2470,77,ITF,ITF2,14,Molise,Molise,305617,87224,28.54,0.83
1936,2021-05-15,MOL,2979,1398,1581,2595,384,ITF,ITF2,14,Molise,Molise,305617,90203,29.52,0.97
1937,2021-02-02,MOL,539,176,363,216,323,ITF,ITF2,14,Molise,Molise,305617,90742,29.69,0.18
1938,2021-04-28,MOL,1683,913,770,466,1217,ITF,ITF2,14,Molise,Molise,305617,92425,30.24,0.55
1939,2021-05-05,MOL,2413,1042,1371,2272,141,ITF,ITF2,14,Molise,Molise,305617,94838,31.03,0.79
1940,2021-05-04,MOL,2704,1181,1523,2576,128,ITF,ITF2,14,Molise,Molise,305617,97542,31.92,0.88
1941,2021-01-10,MOL,270,72,198,270,0,ITF,ITF2,14,Molise,Molise,305617,97812,32.0,0.09
1942,2021-05-31,MOL,2234,1067,1167,1916,318,ITF,ITF2,14,Molise,Molise,305617,100046,32.74,0.73
1943,2021-02-20,MOL,1018,441,577,998,20,ITF,ITF2,14,Molise,Molise,305617,101064,33.07,0.33
1944,2021-06-02,MOL,2618,1281,1337,2592,26,ITF,ITF2,14,Molise,Molise,305617,103682,33.93,0.86
1945,2021-04-27,MOL,1593,767,826,465,1128,ITF,ITF2,14,Molise,Molise,305617,105275,34.45,0.52
1946,2021-05-16,MOL,1246,570,676,1064,182,ITF,ITF2,14,Molise,Molise,305617,106521,34.85,0.41
1947,2021-05-17,MOL,2228,1092,1136,1732,496,ITF,ITF2,14,Molise,Molise,305617,108749,35.58,0.73
1948,2021-03-21,MOL,1246,542,704,479,767,ITF,ITF2,14,Molise,Molise,305617,109995,35.99,0.41
1949,2021-03-14,MOL,596,240,356,17,579,ITF,ITF2,14,Molise,Molise,305617,110591,36.19,0.2
1950,2021-03-28,MOL,1626,747,879,524,1102,ITF,ITF2,14,Molise,Molise,305617,112217,36.72,0.53
1951,2021-01-30,MOL,461,158,303,12,449,ITF,ITF2,14,Molise,Molise,305617,112678,36.87,0.15
1952,2021-02-06,MOL,429,179,250,29,400,ITF,ITF2,14,Molise,Molise,305617,113107,37.01,0.14
1953,2021-04-09,MOL,2318,1248,1070,2127,191,ITF,ITF2,14,Molise,Molise,305617,115425,37.77,0.76
1954,2021-01-18,MOL,114,48,66,114,0,ITF,ITF2,14,Molise,Molise,305617,115539,37.81,0.04
1955,2021-04-13,MOL,1630,718,912,1043,587,ITF,ITF2,14,Molise,Molise,305617,117169,38.34,0.53
1956,2021-03-27,MOL,2743,1273,1470,1310,1433,ITF,ITF2,14,Molise,Molise,305617,119912,39.24,0.9
1957,2021-04-25,MOL,792,395,397,559,233,ITF,ITF2,14,Molise,Molise,305617,120704,39.5,0.26
1958,2021-03-13,MOL,1189,594,595,200,989,ITF,ITF2,14,Molise,Molise,305617,121893,39.88,0.39
1959,2021-01-15,MOL,538,242,296,538,0,ITF,ITF2,14,Molise,Molise,305617,122431,40.06,0.18
1960,2021-05-12,MOL,2847,1291,1556,2751,96,ITF,ITF2,14,Molise,Molise,305617,125278,40.99,0.93
1961,2021-05-26,MOL,1528,684,844,783,745,ITF,ITF2,14,Molise,Molise,305617,126806,41.49,0.5
1962,2021-02-08,MOL,334,141,193,216,118,ITF,ITF2,14,Molise,Molise,305617,127140,41.6,0.11
1963,2021-03-23,MOL,1642,694,948,1435,207,ITF,ITF2,14,Molise,Molise,305617,128782,42.14,0.54
1964,2021-02-22,MOL,265,129,136,250,15,ITF,ITF2,14,Molise,Molise,305617,129047,42.23,0.09
1965,2020-12-27,MOL,50,20,30,50,0,ITF,ITF2,14,Molise,Molise,305617,129097,42.24,0.02
1966,2021-05-24,MOL,1951,847,1104,1285,666,ITF,ITF2,14,Molise,Molise,305617,131048,42.88,0.64
1967,2021-04-04,MOL,253,141,112,238,15,ITF,ITF2,14,Molise,Molise,305617,131301,42.96,0.08
1968,2021-02-27,MOL,1366,568,798,1347,19,ITF,ITF2,14,Molise,Molise,305617,132667,43.41,0.45
1969,2021-02-13,MOL,132,80,52,132,0,ITF,ITF2,14,Molise,Molise,305617,132799,43.45,0.04
1970,2021-04-18,MOL,1083,483,600,149,934,ITF,ITF2,14,Molise,Molise,305617,133882,43.81,0.35
1971,2021-01-08,MOL,429,141,288,429,0,ITF,ITF2,14,Molise,Molise,305617,134311,43.95,0.14
1972,2021-05-19,MOL,2335,1205,1130,1912,423,ITF,ITF2,14,Molise,Molise,305617,136646,44.71,0.76
1973,2021-03-30,MOL,2003,857,1146,1491,512,ITF,ITF2,14,Molise,Molise,305617,138649,45.37,0.66
1974,2021-02-01,MOL,562,201,361,14,548,ITF,ITF2,14,Molise,Molise,305617,139211,45.55,0.18
1975,2021-04-06,MOL,1494,701,793,1151,343,ITF,ITF2,14,Molise,Molise,305617,140705,46.04,0.49
1976,2021-02-15,MOL,144,70,74,141,3,ITF,ITF2,14,Molise,Molise,305617,140849,46.09,0.05
1977,2021-04-16,MOL,2430,1033,1397,1198,1232,ITF,ITF2,14,Molise,Molise,305617,143279,46.88,0.8
1978,2021-04-23,MOL,2049,882,1167,1390,659,ITF,ITF2,14,Molise,Molise,305617,145328,47.55,0.67
1979,2021-03-11,MOL,1463,636,827,1457,6,ITF,ITF2,14,Molise,Molise,305617,146791,48.03,0.48
1980,2021-01-06,MOL,689,260,429,689,0,ITF,ITF2,14,Molise,Molise,305617,147480,48.26,0.23
1981,2021-01-13,MOL,474,160,314,474,0,ITF,ITF2,14,Molise,Molise,305617,147954,48.41,0.16
1982,2021-03-04,MOL,850,417,433,526,324,ITF,ITF2,14,Molise,Molise,305617,148804,48.69,0.28
1983,2021-01-20,MOL,18,8,10,18,0,ITF,ITF2,14,Molise,Molise,305617,148822,48.7,0.01
1984,2021-05-02,MOL,1890,930,960,587,1303,ITF,ITF2,14,Molise,Molise,305617,150712,49.31,0.62
1985,2021-01-29,MOL,421,136,285,6,415,ITF,ITF2,14,Molise,Molise,305617,151133,49.45,0.14
1986,2021-05-11,MOL,3206,1414,1792,2956,250,ITF,ITF2,14,Molise,Molise,305617,154339,50.5,1.05
1987,2021-03-16,MOL,614,230,384,267,347,ITF,ITF2,14,Molise,Molise,305617,154953,50.7,0.2
1988,2021-01-11,MOL,557,194,363,557,0,ITF,ITF2,14,Molise,Molise,305617,155510,50.88,0.18
1989,2021-01-25,MOL,319,130,189,3,316,ITF,ITF2,14,Molise,Molise,305617,155829,50.99,0.1
1990,2021-04-20,MOL,2318,1025,1293,1220,1098,ITF,ITF2,14,Molise,Molise,305617,158147,51.75,0.76
1991,2021-05-23,MOL,1698,863,835,1693,5,ITF,ITF2,14,Molise,Molise,305617,159845,52.3,0.56
1992,2021-04-03,MOL,1770,850,920,1735,35,ITF,ITF2,14,Molise,Molise,305617,161615,52.88,0.58
1993,2021-05-28,MOL,2465,1288,1177,1956,509,ITF,ITF2,14,Molise,Molise,305617,164080,53.69,0.81
1994,2021-04-08,MOL,1766,903,863,1564,202,ITF,ITF2,14,Molise,Molise,305617,165846,54.27,0.58
1995,2021-04-22,MOL,1844,863,981,1065,779,ITF,ITF2,14,Molise,Molise,305617,167690,54.87,0.6
1996,2021-05-07,MOL,2641,1226,1415,2044,597,ITF,ITF2,14,Molise,Molise,305617,170331,55.73,0.86
1997,2021-03-18,MOL,1156,476,680,692,464,ITF,ITF2,14,Molise,Molise,305617,171487,56.11,0.38
1998,2021-05-21,MOL,2018,1011,1007,1707,311,ITF,ITF2,14,Molise,Molise,305617,173505,56.77,0.66
1999,2021-01-27,MOL,674,251,423,8,666,ITF,ITF2,14,Molise,Molise,305617,174179,56.99,0.22
2000,2021-04-01,MOL,1469,667,802,743,726,ITF,ITF2,14,Molise,Molise,305617,175648,57.47,0.48
2001,2021-02-10,MOL,150,78,72,130,20,ITF,ITF2,14,Molise,Molise,305617,175798,57.52,0.05
2002,2021-01-22,MOL,126,35,91,126,0,ITF,ITF2,14,Molise,Molise,305617,175924,57.56,0.04
2003,2021-03-01,MOL,661,274,387,447,214,ITF,ITF2,14,Molise,Molise,305617,176585,57.78,0.22
2004,2021-04-29,MOL,2237,1144,1093,890,1347,ITF,ITF2,14,Molise,Molise,305617,178822,58.51,0.73
2005,2021-03-24,MOL,1631,658,973,1229,402,ITF,ITF2,14,Molise,Molise,305617,180453,59.05,0.53
2006,2021-01-19,MOL,173,63,110,162,11,ITF,ITF2,14,Molise,Molise,305617,180626,59.1,0.06
2007,2021-03-26,MOL,2575,1045,1530,1933,642,ITF,ITF2,14,Molise,Molise,305617,183201,59.94,0.84
2008,2021-01-16,MOL,420,166,254,420,0,ITF,ITF2,14,Molise,Molise,305617,183621,60.08,0.14
2009,2021-04-11,MOL,1196,591,605,1182,14,ITF,ITF2,14,Molise,Molise,305617,184817,60.47,0.39
2010,2021-03-25,MOL,1806,730,1076,1309,497,ITF,ITF2,14,Molise,Molise,305617,186623,61.06,0.59
2011,2021-03-08,MOL,1379,522,857,1239,140,ITF,ITF2,14,Molise,Molise,305617,188002,61.52,0.45
2012,2021-05-30,MOL,1822,903,919,1538,284,ITF,ITF2,14,Molise,Molise,305617,189824,62.11,0.6
2013,2021-03-20,MOL,2321,968,1353,1000,1321,ITF,ITF2,14,Molise,Molise,305617,192145,62.87,0.76
2014,2021-02-18,MOL,319,74,245,306,13,ITF,ITF2,14,Molise,Molise,305617,192464,62.98,0.1
2015,2021-03-09,MOL,1329,579,750,1177,152,ITF,ITF2,14,Molise,Molise,305617,193793,63.41,0.43
2016,2021-05-14,MOL,2644,1215,1429,1926,718,ITF,ITF2,14,Molise,Molise,305617,196437,64.28,0.87
2017,2021-02-03,MOL,731,249,482,338,393,ITF,ITF2,14,Molise,Molise,305617,197168,64.51,0.24
2018,2021-02-17,MOL,72,32,40,57,15,ITF,ITF2,14,Molise,Molise,305617,197240,64.54,0.02
2019,2021-04-15,MOL,1924,793,1131,1080,844,ITF,ITF2,14,Molise,Molise,305617,199164,65.17,0.63
2020,2021-01-17,BAS,328,133,195,327,1,ITF,ITF5,17,Basilicata,Basilicata,559084,328,0.06,0.06
2021,2021-04-20,BAS,4033,1920,2113,2202,1831,ITF,ITF5,17,Basilicata,Basilicata,559084,4361,0.78,0.72
2022,2021-01-08,BAS,554,219,335,554,0,ITF,ITF5,17,Basilicata,Basilicata,559084,4915,0.88,0.1
2023,2021-03-17,BAS,1452,609,843,27,1425,ITF,ITF5,17,Basilicata,Basilicata,559084,6367,1.14,0.26
2024,2021-04-29,BAS,4831,2385,2446,4410,421,ITF,ITF5,17,Basilicata,Basilicata,559084,11198,2.0,0.86
2025,2021-04-08,BAS,764,348,416,754,10,ITF,ITF5,17,Basilicata,Basilicata,559084,11962,2.14,0.14
2026,2021-05-11,BAS,2654,1353,1301,1621,1033,ITF,ITF5,17,Basilicata,Basilicata,559084,14616,2.61,0.47
2027,2021-05-28,BAS,3604,1802,1802,948,2656,ITF,ITF5,17,Basilicata,Basilicata,559084,18220,3.26,0.64
2028,2021-03-22,BAS,1175,531,644,628,547,ITF,ITF5,17,Basilicata,Basilicata,559084,19395,3.47,0.21
2029,2021-05-25,BAS,4191,2107,2084,873,3318,ITF,ITF5,17,Basilicata,Basilicata,559084,23586,4.22,0.75
2030,2021-04-15,BAS,3386,1659,1727,2632,754,ITF,ITF5,17,Basilicata,Basilicata,559084,26972,4.82,0.61
2031,2021-01-03,BAS,901,344,557,901,0,ITF,ITF5,17,Basilicata,Basilicata,559084,27873,4.99,0.16
2032,2021-03-29,BAS,2435,881,1554,2149,286,ITF,ITF5,17,Basilicata,Basilicata,559084,30308,5.42,0.44
2033,2021-01-05,BAS,946,409,537,946,0,ITF,ITF5,17,Basilicata,Basilicata,559084,31254,5.59,0.17
2034,2021-02-24,BAS,1803,743,1060,1734,69,ITF,ITF5,17,Basilicata,Basilicata,559084,33057,5.91,0.32
2035,2021-03-13,BAS,1796,889,907,751,1045,ITF,ITF5,17,Basilicata,Basilicata,559084,34853,6.23,0.32
2036,2021-02-07,BAS,373,159,214,49,324,ITF,ITF5,17,Basilicata,Basilicata,559084,35226,6.3,0.07
2037,2021-05-20,BAS,5855,2964,2891,2890,2965,ITF,ITF5,17,Basilicata,Basilicata,559084,41081,7.35,1.05
2038,2021-05-04,BAS,4137,1991,2146,3614,523,ITF,ITF5,17,Basilicata,Basilicata,559084,45218,8.09,0.74
2039,2021-03-08,BAS,1456,710,746,844,612,ITF,ITF5,17,Basilicata,Basilicata,559084,46674,8.35,0.26
2040,2021-03-01,BAS,547,284,263,381,166,ITF,ITF5,17,Basilicata,Basilicata,559084,47221,8.45,0.1
2041,2021-04-13,BAS,2113,1052,1061,1295,818,ITF,ITF5,17,Basilicata,Basilicata,559084,49334,8.82,0.38
2042,2021-05-13,BAS,5982,2966,3016,3385,2597,ITF,ITF5,17,Basilicata,Basilicata,559084,55316,9.89,1.07
2043,2021-01-26,BAS,797,352,445,101,696,ITF,ITF5,17,Basilicata,Basilicata,559084,56113,10.04,0.14
2044,2021-01-24,BAS,837,300,537,58,779,ITF,ITF5,17,Basilicata,Basilicata,559084,56950,10.19,0.15
2045,2021-03-25,BAS,1879,601,1278,1533,346,ITF,ITF5,17,Basilicata,Basilicata,559084,58829,10.52,0.34
2046,2021-05-21,BAS,4574,2319,2255,1493,3081,ITF,ITF5,17,Basilicata,Basilicata,559084,63403,11.34,0.82
2047,2021-02-03,BAS,666,300,366,32,634,ITF,ITF5,17,Basilicata,Basilicata,559084,64069,11.46,0.12
2048,2021-06-01,BAS,6133,2922,3211,3059,3074,ITF,ITF5,17,Basilicata,Basilicata,559084,70202,12.56,1.1
2049,2021-04-12,BAS,2170,1051,1119,1679,491,ITF,ITF5,17,Basilicata,Basilicata,559084,72372,12.94,0.39
2050,2020-12-27,BAS,106,41,65,106,0,ITF,ITF5,17,Basilicata,Basilicata,559084,72478,12.96,0.02
2051,2021-02-15,BAS,622,232,390,580,42,ITF,ITF5,17,Basilicata,Basilicata,559084,73100,13.07,0.11
2052,2021-05-27,BAS,3598,1852,1746,1073,2525,ITF,ITF5,17,Basilicata,Basilicata,559084,76698,13.72,0.64
2053,2021-02-10,BAS,548,238,310,496,52,ITF,ITF5,17,Basilicata,Basilicata,559084,77246,13.82,0.1
2054,2021-01-27,BAS,411,175,236,113,298,ITF,ITF5,17,Basilicata,Basilicata,559084,77657,13.89,0.07
2055,2021-04-01,BAS,2802,1126,1676,2083,719,ITF,ITF5,17,Basilicata,Basilicata,559084,80459,14.39,0.5
2056,2021-04-19,BAS,4163,1910,2253,2526,1637,ITF,ITF5,17,Basilicata,Basilicata,559084,84622,15.14,0.74
2057,2021-05-30,BAS,2771,1420,1351,921,1850,ITF,ITF5,17,Basilicata,Basilicata,559084,87393,15.63,0.5
2058,2021-04-03,BAS,1807,749,1058,1472,335,ITF,ITF5,17,Basilicata,Basilicata,559084,89200,15.95,0.32
2059,2021-02-05,BAS,984,443,541,64,920,ITF,ITF5,17,Basilicata,Basilicata,559084,90184,16.13,0.18
2060,2021-05-16,BAS,4969,2466,2503,2858,2111,ITF,ITF5,17,Basilicata,Basilicata,559084,95153,17.02,0.89
2061,2021-05-23,BAS,4572,2338,2234,1590,2982,ITF,ITF5,17,Basilicata,Basilicata,559084,99725,17.84,0.82
2062,2021-03-27,BAS,2230,851,1379,1815,415,ITF,ITF5,17,Basilicata,Basilicata,559084,101955,18.24,0.4
2063,2021-01-07,BAS,640,319,321,640,0,ITF,ITF5,17,Basilicata,Basilicata,559084,102595,18.35,0.11
2064,2021-02-19,BAS,1622,737,885,1560,62,ITF,ITF5,17,Basilicata,Basilicata,559084,104217,18.64,0.29
2065,2021-02-12,BAS,775,332,443,744,31,ITF,ITF5,17,Basilicata,Basilicata,559084,104992,18.78,0.14
2066,2021-04-10,BAS,1032,378,654,950,82,ITF,ITF5,17,Basilicata,Basilicata,559084,106024,18.96,0.18
2067,2021-01-10,BAS,77,24,53,77,0,ITF,ITF5,17,Basilicata,Basilicata,559084,106101,18.98,0.01
2068,2021-03-15,BAS,2352,983,1369,521,1831,ITF,ITF5,17,Basilicata,Basilicata,559084,108453,19.4,0.42
2069,2021-04-27,BAS,4726,2242,2484,4401,325,ITF,ITF5,17,Basilicata,Basilicata,559084,113179,20.24,0.85
2070,2021-01-19,BAS,199,84,115,199,0,ITF,ITF5,17,Basilicata,Basilicata,559084,113378,20.28,0.04
2071,2021-03-24,BAS,1753,688,1065,1358,395,ITF,ITF5,17,Basilicata,Basilicata,559084,115131,20.59,0.31
2072,2021-04-22,BAS,5035,2345,2690,3433,1602,ITF,ITF5,17,Basilicata,Basilicata,559084,120166,21.49,0.9
2073,2021-02-17,BAS,1135,493,642,1059,76,ITF,ITF5,17,Basilicata,Basilicata,559084,121301,21.7,0.2
2074,2021-04-05,BAS,723,233,490,421,302,ITF,ITF5,17,Basilicata,Basilicata,559084,122024,21.83,0.13
2075,2021-02-14,BAS,151,48,103,151,0,ITF,ITF5,17,Basilicata,Basilicata,559084,122175,21.85,0.03
2076,2021-03-03,BAS,1745,815,930,1186,559,ITF,ITF5,17,Basilicata,Basilicata,559084,123920,22.16,0.31
2077,2021-01-31,BAS,77,24,53,0,77,ITF,ITF5,17,Basilicata,Basilicata,559084,123997,22.18,0.01
2078,2021-03-20,BAS,1287,567,720,275,1012,ITF,ITF5,17,Basilicata,Basilicata,559084,125284,22.41,0.23
2079,2021-01-29,BAS,615,230,385,63,552,ITF,ITF5,17,Basilicata,Basilicata,559084,125899,22.52,0.11
2080,2021-01-15,BAS,813,350,463,813,0,ITF,ITF5,17,Basilicata,Basilicata,559084,126712,22.66,0.15
2081,2021-03-06,BAS,1354,536,818,758,596,ITF,ITF5,17,Basilicata,Basilicata,559084,128066,22.91,0.24
2082,2021-05-09,BAS,4686,2341,2345,2991,1695,ITF,ITF5,17,Basilicata,Basilicata,559084,132752,23.74,0.84
2083,2021-03-05,BAS,1855,857,998,1109,746,ITF,ITF5,17,Basilicata,Basilicata,559084,134607,24.08,0.33
2084,2021-04-24,BAS,4544,2197,2347,3532,1012,ITF,ITF5,17,Basilicata,Basilicata,559084,139151,24.89,0.81
2085,2021-05-08,BAS,4834,2399,2435,3428,1406,ITF,ITF5,17,Basilicata,Basilicata,559084,143985,25.75,0.86
2086,2021-02-11,BAS,951,401,550,868,83,ITF,ITF5,17,Basilicata,Basilicata,559084,144936,25.92,0.17
2087,2021-03-26,BAS,1957,703,1254,1696,261,ITF,ITF5,17,Basilicata,Basilicata,559084,146893,26.27,0.35
2088,2021-06-02,BAS,5951,2796,3155,4414,1537,ITF,ITF5,17,Basilicata,Basilicata,559084,152844,27.34,1.06
2089,2021-02-20,BAS,1161,531,630,1043,118,ITF,ITF5,17,Basilicata,Basilicata,559084,154005,27.55,0.21
2090,2021-05-24,BAS,4825,2340,2485,1103,3722,ITF,ITF5,17,Basilicata,Basilicata,559084,158830,28.41,0.86
2091,2021-02-22,BAS,1790,773,1017,1737,53,ITF,ITF5,17,Basilicata,Basilicata,559084,160620,28.73,0.32
2092,2021-05-01,BAS,4703,2135,2568,3952,751,ITF,ITF5,17,Basilicata,Basilicata,559084,165323,29.57,0.84
2093,2021-02-26,BAS,2149,904,1245,2069,80,ITF,ITF5,17,Basilicata,Basilicata,559084,167472,29.95,0.38
2094,2021-05-18,BAS,5897,2856,3041,3403,2494,ITF,ITF5,17,Basilicata,Basilicata,559084,173369,31.01,1.05
2095,2021-01-12,BAS,217,88,129,217,0,ITF,ITF5,17,Basilicata,Basilicata,559084,173586,31.05,0.04
2096,2021-03-21,BAS,1046,481,565,352,694,ITF,ITF5,17,Basilicata,Basilicata,559084,174632,31.24,0.19
2097,2021-05-29,BAS,3012,1511,1501,831,2181,ITF,ITF5,17,Basilicata,Basilicata,559084,177644,31.77,0.54
2098,2021-01-13,BAS,916,387,529,916,0,ITF,ITF5,17,Basilicata,Basilicata,559084,178560,31.94,0.16
2099,2021-01-30,BAS,704,227,477,128,576,ITF,ITF5,17,Basilicata,Basilicata,559084,179264,32.06,0.13
2100,2021-02-23,BAS,1901,771,1130,1763,138,ITF,ITF5,17,Basilicata,Basilicata,559084,181165,32.4,0.34
2101,2021-03-31,BAS,3095,1258,1837,2313,782,ITF,ITF5,17,Basilicata,Basilicata,559084,184260,32.96,0.55
2102,2021-06-03,BAS,4936,2262,2674,3759,1177,ITF,ITF5,17,Basilicata,Basilicata,559084,189196,33.84,0.88
2103,2021-02-08,BAS,557,193,364,151,406,ITF,ITF5,17,Basilicata,Basilicata,559084,189753,33.94,0.1
2104,2021-05-19,BAS,2870,1498,1372,1194,1676,ITF,ITF5,17,Basilicata,Basilicata,559084,192623,34.45,0.51
2105,2021-04-28,BAS,4704,2158,2546,4263,441,ITF,ITF5,17,Basilicata,Basilicata,559084,197327,35.29,0.84
2106,2021-03-02,BAS,794,383,411,659,135,ITF,ITF5,17,Basilicata,Basilicata,559084,198121,35.44,0.14
2107,2021-04-21,BAS,3921,1835,2086,2271,1650,ITF,ITF5,17,Basilicata,Basilicata,559084,202042,36.14,0.7
2108,2021-01-25,BAS,1023,429,594,74,949,ITF,ITF5,17,Basilicata,Basilicata,559084,203065,36.32,0.18
2109,2021-01-18,BAS,463,157,306,364,99,ITF,ITF5,17,Basilicata,Basilicata,559084,203528,36.4,0.08
2110,2021-03-16,BAS,1904,801,1103,229,1675,ITF,ITF5,17,Basilicata,Basilicata,559084,205432,36.74,0.34
2111,2021-05-05,BAS,4337,2050,2287,3447,890,ITF,ITF5,17,Basilicata,Basilicata,559084,209769,37.52,0.78
2112,2021-01-04,BAS,607,271,336,607,0,ITF,ITF5,17,Basilicata,Basilicata,559084,210376,37.63,0.11
2113,2021-01-21,BAS,30,10,20,30,0,ITF,ITF5,17,Basilicata,Basilicata,559084,210406,37.63,0.01
2114,2021-05-03,BAS,4514,2044,2470,3687,827,ITF,ITF5,17,Basilicata,Basilicata,559084,214920,38.44,0.81
2115,2021-03-30,BAS,2739,1156,1583,2394,345,ITF,ITF5,17,Basilicata,Basilicata,559084,217659,38.93,0.49
2116,2021-03-10,BAS,1677,840,837,838,839,ITF,ITF5,17,Basilicata,Basilicata,559084,219336,39.23,0.3
2117,2021-05-06,BAS,5054,2435,2619,3485,1569,ITF,ITF5,17,Basilicata,Basilicata,559084,224390,40.14,0.9
2118,2021-02-02,BAS,367,143,224,175,192,ITF,ITF5,17,Basilicata,Basilicata,559084,224757,40.2,0.07
2119,2021-01-16,BAS,721,304,417,721,0,ITF,ITF5,17,Basilicata,Basilicata,559084,225478,40.33,0.13
2120,2021-02-28,BAS,804,343,461,775,29,ITF,ITF5,17,Basilicata,Basilicata,559084,226282,40.47,0.14
2121,2021-01-09,BAS,557,160,397,557,0,ITF,ITF5,17,Basilicata,Basilicata,559084,226839,40.57,0.1
2122,2021-05-07,BAS,4650,2284,2366,3295,1355,ITF,ITF5,17,Basilicata,Basilicata,559084,231489,41.41,0.83
2123,2021-03-18,BAS,1349,563,786,25,1324,ITF,ITF5,17,Basilicata,Basilicata,559084,232838,41.65,0.24
2124,2021-02-16,BAS,905,377,528,807,98,ITF,ITF5,17,Basilicata,Basilicata,559084,233743,41.81,0.16
2125,2021-04-07,BAS,1218,549,669,1181,37,ITF,ITF5,17,Basilicata,Basilicata,559084,234961,42.03,0.22
2126,2021-04-06,BAS,1267,461,806,1082,185,ITF,ITF5,17,Basilicata,Basilicata,559084,236228,42.25,0.23
2127,2021-02-01,BAS,242,91,151,46,196,ITF,ITF5,17,Basilicata,Basilicata,559084,236470,42.3,0.04
2128,2021-05-26,BAS,4523,2280,2243,1759,2764,ITF,ITF5,17,Basilicata,Basilicata,559084,240993,43.1,0.81
2129,2021-05-12,BAS,4722,2324,2398,2839,1883,ITF,ITF5,17,Basilicata,Basilicata,559084,245715,43.95,0.84
2130,2021-03-23,BAS,1582,608,974,1409,173,ITF,ITF5,17,Basilicata,Basilicata,559084,247297,44.23,0.28
2131,2021-01-02,BAS,949,380,569,949,0,ITF,ITF5,17,Basilicata,Basilicata,559084,248246,44.4,0.17
2132,2021-04-26,BAS,4464,2164,2300,4244,220,ITF,ITF5,17,Basilicata,Basilicata,559084,252710,45.2,0.8
2133,2021-02-21,BAS,284,113,171,284,0,ITF,ITF5,17,Basilicata,Basilicata,559084,252994,45.25,0.05
2134,2021-03-07,BAS,887,309,578,849,38,ITF,ITF5,17,Basilicata,Basilicata,559084,253881,45.41,0.16
2135,2021-05-14,BAS,5906,2797,3109,3374,2532,ITF,ITF5,17,Basilicata,Basilicata,559084,259787,46.47,1.06
2136,2021-04-02,BAS,2318,1046,1272,1714,604,ITF,ITF5,17,Basilicata,Basilicata,559084,262105,46.88,0.41
2137,2021-02-04,BAS,1096,442,654,63,1033,ITF,ITF5,17,Basilicata,Basilicata,559084,263201,47.08,0.2
2138,2021-04-09,BAS,1152,350,802,1089,63,ITF,ITF5,17,Basilicata,Basilicata,559084,264353,47.28,0.21
2139,2021-05-15,BAS,6527,3341,3186,3955,2572,ITF,ITF5,17,Basilicata,Basilicata,559084,270880,48.45,1.17
2140,2021-02-27,BAS,1992,860,1132,1828,164,ITF,ITF5,17,Basilicata,Basilicata,559084,272872,48.81,0.36
2141,2021-04-11,BAS,849,330,519,787,62,ITF,ITF5,17,Basilicata,Basilicata,559084,273721,48.96,0.15
2142,2021-04-04,BAS,610,225,385,197,413,ITF,ITF5,17,Basilicata,Basilicata,559084,274331,49.07,0.11
2143,2021-05-22,BAS,5488,2723,2765,1937,3551,ITF,ITF5,17,Basilicata,Basilicata,559084,279819,50.05,0.98
2144,2021-02-13,BAS,799,313,486,738,61,ITF,ITF5,17,Basilicata,Basilicata,559084,280618,50.19,0.14
2145,2021-04-18,BAS,3720,1847,1873,2353,1367,ITF,ITF5,17,Basilicata,Basilicata,559084,284338,50.86,0.67
2146,2021-05-31,BAS,4068,1937,2131,1701,2367,ITF,ITF5,17,Basilicata,Basilicata,559084,288406,51.59,0.73
2147,2021-05-10,BAS,4807,2384,2423,2767,2040,ITF,ITF5,17,Basilicata,Basilicata,559084,293213,52.45,0.86
2148,2021-04-23,BAS,4537,2186,2351,3537,1000,ITF,ITF5,17,Basilicata,Basilicata,559084,297750,53.26,0.81
2149,2021-03-19,BAS,2290,992,1298,262,2028,ITF,ITF5,17,Basilicata,Basilicata,559084,300040,53.67,0.41
2150,2021-01-28,BAS,903,401,502,119,784,ITF,ITF5,17,Basilicata,Basilicata,559084,300943,53.83,0.16
2151,2021-01-14,BAS,969,413,556,969,0,ITF,ITF5,17,Basilicata,Basilicata,559084,301912,54.0,0.17
2152,2021-04-25,BAS,2986,1458,1528,2933,53,ITF,ITF5,17,Basilicata,Basilicata,559084,304898,54.54,0.53
2153,2021-03-04,BAS,1879,892,987,1084,795,ITF,ITF5,17,Basilicata,Basilicata,559084,306777,54.87,0.34
2154,2021-01-22,BAS,67,24,43,67,0,ITF,ITF5,17,Basilicata,Basilicata,559084,306844,54.88,0.01
2155,2021-05-02,BAS,4179,2000,2179,3551,628,ITF,ITF5,17,Basilicata,Basilicata,559084,311023,55.63,0.75
2156,2021-04-17,BAS,3461,1655,1806,2199,1262,ITF,ITF5,17,Basilicata,Basilicata,559084,314484,56.25,0.62
2157,2021-01-23,BAS,719,303,416,33,686,ITF,ITF5,17,Basilicata,Basilicata,559084,315203,56.38,0.13
2158,2021-04-14,BAS,2042,998,1044,1367,675,ITF,ITF5,17,Basilicata,Basilicata,559084,317245,56.74,0.37
2159,2021-02-09,BAS,491,213,278,316,175,ITF,ITF5,17,Basilicata,Basilicata,559084,317736,56.83,0.09
2160,2021-03-11,BAS,1790,924,866,831,959,ITF,ITF5,17,Basilicata,Basilicata,559084,319526,57.15,0.32
2161,2021-01-06,BAS,294,129,165,294,0,ITF,ITF5,17,Basilicata,Basilicata,559084,319820,57.2,0.05
2162,2021-03-28,BAS,2139,741,1398,2122,17,ITF,ITF5,17,Basilicata,Basilicata,559084,321959,57.59,0.38
2163,2021-03-09,BAS,1394,709,685,790,604,ITF,ITF5,17,Basilicata,Basilicata,559084,323353,57.84,0.25
2164,2021-01-11,BAS,183,66,117,183,0,ITF,ITF5,17,Basilicata,Basilicata,559084,323536,57.87,0.03
2165,2021-04-16,BAS,3319,1632,1687,2421,898,ITF,ITF5,17,Basilicata,Basilicata,559084,326855,58.46,0.59
2166,2021-02-18,BAS,1070,401,669,855,215,ITF,ITF5,17,Basilicata,Basilicata,559084,327925,58.65,0.19
2167,2021-03-14,BAS,1010,477,533,541,469,ITF,ITF5,17,Basilicata,Basilicata,559084,328935,58.83,0.18
2168,2021-05-17,BAS,5539,2733,2806,3406,2133,ITF,ITF5,17,Basilicata,Basilicata,559084,334474,59.83,0.99
2169,2021-03-12,BAS,1902,978,924,803,1099,ITF,ITF5,17,Basilicata,Basilicata,559084,336376,60.17,0.34
2170,2021-01-20,BAS,84,22,62,84,0,ITF,ITF5,17,Basilicata,Basilicata,559084,336460,60.18,0.02
2171,2021-02-25,BAS,1787,736,1051,1741,46,ITF,ITF5,17,Basilicata,Basilicata,559084,338247,60.5,0.32
2172,2021-02-06,BAS,902,367,535,146,756,ITF,ITF5,17,Basilicata,Basilicata,559084,339149,60.66,0.16
2173,2021-04-30,BAS,5284,2373,2911,4121,1163,ITF,ITF5,17,Basilicata,Basilicata,559084,344433,61.61,0.95
2174,2021-01-23,PIE,4257,1325,2932,879,3378,ITC,ITC1,1,Piemonte,Piemonte,4356406,4257,0.1,0.1
2175,2021-03-23,PIE,13073,5448,7625,6828,6245,ITC,ITC1,1,Piemonte,Piemonte,4356406,17330,0.4,0.3
2176,2021-05-05,PIE,32124,15032,17092,19115,13009,ITC,ITC1,1,Piemonte,Piemonte,4356406,49454,1.14,0.74
2177,2021-05-17,PIE,30612,14371,16241,17674,12938,ITC,ITC1,1,Piemonte,Piemonte,4356406,80066,1.84,0.7
2178,2021-03-28,PIE,16054,6899,9155,8433,7621,ITC,ITC1,1,Piemonte,Piemonte,4356406,96120,2.21,0.37
2179,2021-01-18,PIE,6166,2048,4118,5917,249,ITC,ITC1,1,Piemonte,Piemonte,4356406,102286,2.35,0.14
2180,2021-05-31,PIE,28783,13840,14943,20464,8319,ITC,ITC1,1,Piemonte,Piemonte,4356406,131069,3.01,0.66
2181,2021-01-01,PIE,1038,395,643,1038,0,ITC,ITC1,1,Piemonte,Piemonte,4356406,132107,3.03,0.02
2182,2021-02-11,PIE,6764,2107,4657,3006,3758,ITC,ITC1,1,Piemonte,Piemonte,4356406,138871,3.19,0.16
2183,2021-04-09,PIE,25847,11387,14460,21338,4509,ITC,ITC1,1,Piemonte,Piemonte,4356406,164718,3.78,0.59
2184,2021-04-02,PIE,20130,8298,11832,11703,8427,ITC,ITC1,1,Piemonte,Piemonte,4356406,184848,4.24,0.46
2185,2021-05-29,PIE,32658,15167,17491,20513,12145,ITC,ITC1,1,Piemonte,Piemonte,4356406,217506,4.99,0.75
2186,2020-12-30,PIE,730,322,408,730,0,ITC,ITC1,1,Piemonte,Piemonte,4356406,218236,5.01,0.02
2187,2021-02-25,PIE,12218,5252,6966,11671,547,ITC,ITC1,1,Piemonte,Piemonte,4356406,230454,5.29,0.28
2188,2021-02-18,PIE,4790,2093,2697,4360,430,ITC,ITC1,1,Piemonte,Piemonte,4356406,235244,5.4,0.11
2189,2021-04-16,PIE,28388,13206,15182,23404,4984,ITC,ITC1,1,Piemonte,Piemonte,4356406,263632,6.05,0.65
2190,2021-01-13,PIE,10080,3223,6857,10080,0,ITC,ITC1,1,Piemonte,Piemonte,4356406,273712,6.28,0.23
2191,2021-01-06,PIE,3116,1111,2005,3116,0,ITC,ITC1,1,Piemonte,Piemonte,4356406,276828,6.35,0.07
2192,2021-04-23,PIE,27434,12597,14837,20672,6762,ITC,ITC1,1,Piemonte,Piemonte,4356406,304262,6.98,0.63
2193,2021-03-18,PIE,11756,4803,6953,4029,7727,ITC,ITC1,1,Piemonte,Piemonte,4356406,316018,7.25,0.27
2194,2021-03-20,PIE,11921,4898,7023,6023,5898,ITC,ITC1,1,Piemonte,Piemonte,4356406,327939,7.53,0.27
2195,2021-03-02,PIE,11202,4506,6696,10386,816,ITC,ITC1,1,Piemonte,Piemonte,4356406,339141,7.78,0.26
2196,2021-02-13,PIE,4153,1334,2819,2931,1222,ITC,ITC1,1,Piemonte,Piemonte,4356406,343294,7.88,0.1
2197,2021-05-26,PIE,32271,14771,17500,15576,16695,ITC,ITC1,1,Piemonte,Piemonte,4356406,375565,8.62,0.74
2198,2021-01-27,PIE,4196,1453,2743,999,3197,ITC,ITC1,1,Piemonte,Piemonte,4356406,379761,8.72,0.1
2199,2021-05-09,PIE,27051,12897,14154,13444,13607,ITC,ITC1,1,Piemonte,Piemonte,4356406,406812,9.34,0.62
2200,2021-05-14,PIE,33272,16191,17081,17914,15358,ITC,ITC1,1,Piemonte,Piemonte,4356406,440084,10.1,0.76
2201,2021-05-21,PIE,35840,16607,19233,20356,15484,ITC,ITC1,1,Piemonte,Piemonte,4356406,475924,10.92,0.82
2202,2020-12-28,PIE,1,1,0,1,0,ITC,ITC1,1,Piemonte,Piemonte,4356406,475925,10.92,0.0
2203,2021-04-18,PIE,22951,10817,12134,20197,2754,ITC,ITC1,1,Piemonte,Piemonte,4356406,498876,11.45,0.53
2204,2021-01-15,PIE,9114,3012,6102,9114,0,ITC,ITC1,1,Piemonte,Piemonte,4356406,507990,11.66,0.21
2205,2021-02-04,PIE,10203,3339,6864,588,9615,ITC,ITC1,1,Piemonte,Piemonte,4356406,518193,11.89,0.23
2206,2021-04-30,PIE,31770,14277,17493,18444,13326,ITC,ITC1,1,Piemonte,Piemonte,4356406,549963,12.62,0.73
2207,2021-03-11,PIE,13773,5075,8698,10676,3097,ITC,ITC1,1,Piemonte,Piemonte,4356406,563736,12.94,0.32
2208,2021-01-20,PIE,6616,2089,4527,5899,717,ITC,ITC1,1,Piemonte,Piemonte,4356406,570352,13.09,0.15
2209,2021-03-25,PIE,17062,7203,9859,8423,8639,ITC,ITC1,1,Piemonte,Piemonte,4356406,587414,13.48,0.39
2210,2021-02-03,PIE,10199,3303,6896,611,9588,ITC,ITC1,1,Piemonte,Piemonte,4356406,597613,13.72,0.23
2211,2021-02-27,PIE,12691,4851,7840,12346,345,ITC,ITC1,1,Piemonte,Piemonte,4356406,610304,14.01,0.29
2212,2021-04-25,PIE,20223,9303,10920,17722,2501,ITC,ITC1,1,Piemonte,Piemonte,4356406,630527,14.47,0.46
2213,2021-05-02,PIE,25045,11263,13782,14300,10745,ITC,ITC1,1,Piemonte,Piemonte,4356406,655572,15.05,0.57
2214,2021-03-13,PIE,13044,4720,8324,11600,1444,ITC,ITC1,1,Piemonte,Piemonte,4356406,668616,15.35,0.3
2215,2021-01-08,PIE,5531,1761,3770,5531,0,ITC,ITC1,1,Piemonte,Piemonte,4356406,674147,15.47,0.13
2216,2021-01-16,PIE,7771,2630,5141,7771,0,ITC,ITC1,1,Piemonte,Piemonte,4356406,681918,15.65,0.18
2217,2021-03-21,PIE,10723,4738,5985,4189,6534,ITC,ITC1,1,Piemonte,Piemonte,4356406,692641,15.9,0.25
2218,2021-03-30,PIE,16891,7033,9858,9020,7871,ITC,ITC1,1,Piemonte,Piemonte,4356406,709532,16.29,0.39
2219,2021-01-25,PIE,6215,1938,4277,983,5232,ITC,ITC1,1,Piemonte,Piemonte,4356406,715747,16.43,0.14
2220,2021-05-28,PIE,34642,16314,18328,18935,15707,ITC,ITC1,1,Piemonte,Piemonte,4356406,750389,17.22,0.8
2221,2021-01-04,PIE,5564,1679,3885,5564,0,ITC,ITC1,1,Piemonte,Piemonte,4356406,755953,17.35,0.13
2222,2021-04-28,PIE,25986,11711,14275,15954,10032,ITC,ITC1,1,Piemonte,Piemonte,4356406,781939,17.95,0.6
2223,2021-02-23,PIE,9234,3713,5521,8653,581,ITC,ITC1,1,Piemonte,Piemonte,4356406,791173,18.16,0.21
2224,2021-04-11,PIE,20824,9317,11507,18663,2161,ITC,ITC1,1,Piemonte,Piemonte,4356406,811997,18.64,0.48
2225,2021-02-06,PIE,7995,2666,5329,400,7595,ITC,ITC1,1,Piemonte,Piemonte,4356406,819992,18.82,0.18
2226,2021-03-09,PIE,13967,5429,8538,11625,2342,ITC,ITC1,1,Piemonte,Piemonte,4356406,833959,19.14,0.32
2227,2021-02-20,PIE,3833,1253,2580,3659,174,ITC,ITC1,1,Piemonte,Piemonte,4356406,837792,19.23,0.09
2228,2021-06-02,PIE,26450,12973,13477,22034,4416,ITC,ITC1,1,Piemonte,Piemonte,4356406,864242,19.84,0.61
2229,2021-02-22,PIE,8482,3472,5010,7892,590,ITC,ITC1,1,Piemonte,Piemonte,4356406,872724,20.03,0.19
2230,2021-03-14,PIE,8205,3336,4869,5308,2897,ITC,ITC1,1,Piemonte,Piemonte,4356406,880929,20.22,0.19
2231,2021-05-10,PIE,28669,13737,14932,15655,13014,ITC,ITC1,1,Piemonte,Piemonte,4356406,909598,20.88,0.66
2232,2021-05-19,PIE,32921,15132,17789,21974,10947,ITC,ITC1,1,Piemonte,Piemonte,4356406,942519,21.64,0.76
2233,2021-01-30,PIE,5980,2136,3844,218,5762,ITC,ITC1,1,Piemonte,Piemonte,4356406,948499,21.77,0.14
2234,2021-03-16,PIE,10520,4268,6252,4463,6057,ITC,ITC1,1,Piemonte,Piemonte,4356406,959019,22.01,0.24
2235,2021-05-12,PIE,31696,15066,16630,18933,12763,ITC,ITC1,1,Piemonte,Piemonte,4356406,990715,22.74,0.73
2236,2021-02-08,PIE,6917,2356,4561,666,6251,ITC,ITC1,1,Piemonte,Piemonte,4356406,997632,22.9,0.16
2237,2021-02-01,PIE,8645,3055,5590,579,8066,ITC,ITC1,1,Piemonte,Piemonte,4356406,1006277,23.1,0.2
2238,2021-04-01,PIE,19330,8073,11257,11210,8120,ITC,ITC1,1,Piemonte,Piemonte,4356406,1025607,23.54,0.44
2239,2021-05-30,PIE,27697,13184,14513,18373,9324,ITC,ITC1,1,Piemonte,Piemonte,4356406,1053304,24.18,0.64
2240,2021-02-17,PIE,4793,2156,2637,3803,990,ITC,ITC1,1,Piemonte,Piemonte,4356406,1058097,24.29,0.11
2241,2021-02-26,PIE,12293,4933,7360,11556,737,ITC,ITC1,1,Piemonte,Piemonte,4356406,1070390,24.57,0.28
2242,2021-04-26,PIE,19756,8731,11025,15357,4399,ITC,ITC1,1,Piemonte,Piemonte,4356406,1090146,25.02,0.45
2243,2021-05-24,PIE,28616,13130,15486,16978,11638,ITC,ITC1,1,Piemonte,Piemonte,4356406,1118762,25.68,0.66
2244,2021-05-07,PIE,32943,15548,17395,18900,14043,ITC,ITC1,1,Piemonte,Piemonte,4356406,1151705,26.44,0.76
2245,2021-03-04,PIE,14496,5734,8762,11548,2948,ITC,ITC1,1,Piemonte,Piemonte,4356406,1166201,26.77,0.33
2246,2021-04-20,PIE,25453,11655,13798,19109,6344,ITC,ITC1,1,Piemonte,Piemonte,4356406,1191654,27.35,0.58
2247,2021-02-15,PIE,4432,1597,2835,3227,1205,ITC,ITC1,1,Piemonte,Piemonte,4356406,1196086,27.46,0.1
2248,2021-02-05,PIE,9601,3138,6463,659,8942,ITC,ITC1,1,Piemonte,Piemonte,4356406,1205687,27.68,0.22
2249,2021-03-27,PIE,18384,7827,10557,9553,8831,ITC,ITC1,1,Piemonte,Piemonte,4356406,1224071,28.1,0.42
2250,2021-03-10,PIE,13635,5169,8466,11341,2294,ITC,ITC1,1,Piemonte,Piemonte,4356406,1237706,28.41,0.31
2251,2021-01-19,PIE,6466,2105,4361,6454,12,ITC,ITC1,1,Piemonte,Piemonte,4356406,1244172,28.56,0.15
2252,2021-04-14,PIE,27703,12559,15144,23182,4521,ITC,ITC1,1,Piemonte,Piemonte,4356406,1271875,29.2,0.64
2253,2021-05-23,PIE,28683,13125,15558,15748,12935,ITC,ITC1,1,Piemonte,Piemonte,4356406,1300558,29.85,0.66
2254,2021-03-03,PIE,12120,4644,7476,11301,819,ITC,ITC1,1,Piemonte,Piemonte,4356406,1312678,30.13,0.28
2255,2021-05-06,PIE,33218,15630,17588,19760,13458,ITC,ITC1,1,Piemonte,Piemonte,4356406,1345896,30.89,0.76
2256,2021-02-12,PIE,6891,2215,4676,3930,2961,ITC,ITC1,1,Piemonte,Piemonte,4356406,1352787,31.05,0.16
2257,2021-01-26,PIE,6331,1879,4452,735,5596,ITC,ITC1,1,Piemonte,Piemonte,4356406,1359118,31.2,0.15
2258,2021-05-08,PIE,34117,16184,17933,18488,15629,ITC,ITC1,1,Piemonte,Piemonte,4356406,1393235,31.98,0.78
2259,2021-01-10,PIE,5214,2275,2939,5214,0,ITC,ITC1,1,Piemonte,Piemonte,4356406,1398449,32.1,0.12
2260,2021-04-22,PIE,27628,12711,14917,20931,6697,ITC,ITC1,1,Piemonte,Piemonte,4356406,1426077,32.74,0.63
2261,2021-04-05,PIE,14746,6233,8513,12189,2557,ITC,ITC1,1,Piemonte,Piemonte,4356406,1440823,33.07,0.34
2262,2021-03-19,PIE,11019,4511,6508,4414,6605,ITC,ITC1,1,Piemonte,Piemonte,4356406,1451842,33.33,0.25
2263,2021-02-10,PIE,7535,2371,5164,1316,6219,ITC,ITC1,1,Piemonte,Piemonte,4356406,1459377,33.5,0.17
2264,2021-04-08,PIE,25142,10929,14213,20412,4730,ITC,ITC1,1,Piemonte,Piemonte,4356406,1484519,34.08,0.58
2265,2021-04-15,PIE,29632,13572,16060,24150,5482,ITC,ITC1,1,Piemonte,Piemonte,4356406,1514151,34.76,0.68
2266,2021-04-17,PIE,30428,14133,16295,27114,3314,ITC,ITC1,1,Piemonte,Piemonte,4356406,1544579,35.46,0.7
2267,2021-04-10,PIE,30163,13416,16747,25884,4279,ITC,ITC1,1,Piemonte,Piemonte,4356406,1574742,36.15,0.69
2268,2021-01-05,PIE,5381,1603,3778,5381,0,ITC,ITC1,1,Piemonte,Piemonte,4356406,1580123,36.27,0.12
2269,2021-01-07,PIE,5387,1739,3648,5387,0,ITC,ITC1,1,Piemonte,Piemonte,4356406,1585510,36.39,0.12
2270,2021-03-05,PIE,15268,5961,9307,11451,3817,ITC,ITC1,1,Piemonte,Piemonte,4356406,1600778,36.75,0.35
2271,2020-12-31,PIE,3909,1334,2575,3909,0,ITC,ITC1,1,Piemonte,Piemonte,4356406,1604687,36.84,0.09
2272,2021-03-06,PIE,13994,5211,8783,11205,2789,ITC,ITC1,1,Piemonte,Piemonte,4356406,1618681,37.16,0.32
2273,2021-01-22,PIE,3867,1249,2618,2526,1341,ITC,ITC1,1,Piemonte,Piemonte,4356406,1622548,37.25,0.09
2274,2021-05-13,PIE,35377,17286,18091,20518,14859,ITC,ITC1,1,Piemonte,Piemonte,4356406,1657925,38.06,0.81
2275,2021-05-27,PIE,36936,17104,19832,19047,17889,ITC,ITC1,1,Piemonte,Piemonte,4356406,1694861,38.91,0.85
2276,2021-03-24,PIE,15505,6341,9164,6378,9127,ITC,ITC1,1,Piemonte,Piemonte,4356406,1710366,39.26,0.36
2277,2021-03-31,PIE,19106,8102,11004,10413,8693,ITC,ITC1,1,Piemonte,Piemonte,4356406,1729472,39.7,0.44
2278,2021-05-01,PIE,28526,12993,15533,16728,11798,ITC,ITC1,1,Piemonte,Piemonte,4356406,1757998,40.35,0.65
2279,2021-01-21,PIE,6923,2318,4605,3427,3496,ITC,ITC1,1,Piemonte,Piemonte,4356406,1764921,40.51,0.16
2280,2021-05-15,PIE,33610,15674,17936,19975,13635,ITC,ITC1,1,Piemonte,Piemonte,4356406,1798531,41.28,0.77
2281,2021-05-20,PIE,38279,17703,20576,13556,24723,ITC,ITC1,1,Piemonte,Piemonte,4356406,1836810,42.16,0.88
2282,2021-02-02,PIE,10241,3509,6732,816,9425,ITC,ITC1,1,Piemonte,Piemonte,4356406,1847051,42.4,0.24
2283,2021-02-16,PIE,3967,1756,2211,3209,758,ITC,ITC1,1,Piemonte,Piemonte,4356406,1851018,42.49,0.09
2284,2021-03-07,PIE,11976,4658,7318,11099,877,ITC,ITC1,1,Piemonte,Piemonte,4356406,1862994,42.76,0.27
2285,2021-02-24,PIE,11409,4629,6780,10904,505,ITC,ITC1,1,Piemonte,Piemonte,4356406,1874403,43.03,0.26
2286,2021-02-19,PIE,5535,2175,3360,5034,501,ITC,ITC1,1,Piemonte,Piemonte,4356406,1879938,43.15,0.13
2287,2021-04-24,PIE,27447,12419,15028,21808,5639,ITC,ITC1,1,Piemonte,Piemonte,4356406,1907385,43.78,0.63
2288,2021-05-03,PIE,26646,12161,14485,12508,14138,ITC,ITC1,1,Piemonte,Piemonte,4356406,1934031,44.4,0.61
2289,2021-05-16,PIE,28111,12762,15349,15055,13056,ITC,ITC1,1,Piemonte,Piemonte,4356406,1962142,45.04,0.65
2290,2021-04-29,PIE,48286,21842,26444,35668,12618,ITC,ITC1,1,Piemonte,Piemonte,4356406,2010428,46.15,1.11
2291,2021-03-08,PIE,13947,5294,8653,11233,2714,ITC,ITC1,1,Piemonte,Piemonte,4356406,2024375,46.47,0.32
2292,2021-05-04,PIE,28482,13076,15406,16396,12086,ITC,ITC1,1,Piemonte,Piemonte,4356406,2052857,47.12,0.65
2293,2021-04-27,PIE,22573,10205,12368,17436,5137,ITC,ITC1,1,Piemonte,Piemonte,4356406,2075430,47.64,0.52
2294,2021-01-17,PIE,3518,1168,2350,2870,648,ITC,ITC1,1,Piemonte,Piemonte,4356406,2078948,47.72,0.08
2295,2021-03-15,PIE,10658,4162,6496,5037,5621,ITC,ITC1,1,Piemonte,Piemonte,4356406,2089606,47.97,0.24
2296,2021-05-11,PIE,31976,15401,16575,18836,13140,ITC,ITC1,1,Piemonte,Piemonte,4356406,2121582,48.7,0.73
2297,2021-01-24,PIE,3153,959,2194,434,2719,ITC,ITC1,1,Piemonte,Piemonte,4356406,2124735,48.77,0.07
2298,2021-03-22,PIE,11510,4880,6630,3904,7606,ITC,ITC1,1,Piemonte,Piemonte,4356406,2136245,49.04,0.26
2299,2021-01-31,PIE,4113,1753,2360,112,4001,ITC,ITC1,1,Piemonte,Piemonte,4356406,2140358,49.13,0.09
2300,2021-02-07,PIE,3088,974,2114,445,2643,ITC,ITC1,1,Piemonte,Piemonte,4356406,2143446,49.2,0.07
2301,2021-04-13,PIE,25929,11608,14321,22469,3460,ITC,ITC1,1,Piemonte,Piemonte,4356406,2169375,49.8,0.6
2302,2021-01-03,PIE,3063,967,2096,3063,0,ITC,ITC1,1,Piemonte,Piemonte,4356406,2172438,49.87,0.07
2303,2021-05-18,PIE,31768,14577,17191,19318,12450,ITC,ITC1,1,Piemonte,Piemonte,4356406,2204206,50.6,0.73
2304,2021-03-29,PIE,15161,6385,8776,8549,6612,ITC,ITC1,1,Piemonte,Piemonte,4356406,2219367,50.94,0.35
2305,2021-04-12,PIE,22924,10353,12571,19934,2990,ITC,ITC1,1,Piemonte,Piemonte,4356406,2242291,51.47,0.53
2306,2021-06-01,PIE,28859,14441,14418,24696,4163,ITC,ITC1,1,Piemonte,Piemonte,4356406,2271150,52.13,0.66
2307,2021-01-02,PIE,3545,1134,2411,3545,0,ITC,ITC1,1,Piemonte,Piemonte,4356406,2274695,52.21,0.08
2308,2021-01-14,PIE,9766,3152,6614,9766,0,ITC,ITC1,1,Piemonte,Piemonte,4356406,2284461,52.44,0.22
2309,2021-06-03,PIE,33218,17005,16213,29327,3891,ITC,ITC1,1,Piemonte,Piemonte,4356406,2317679,53.2,0.76
2310,2021-04-21,PIE,25728,11825,13903,20395,5333,ITC,ITC1,1,Piemonte,Piemonte,4356406,2343407,53.79,0.59
2311,2021-04-04,PIE,9254,4059,5195,6541,2713,ITC,ITC1,1,Piemonte,Piemonte,4356406,2352661,54.0,0.21
2312,2021-01-11,PIE,8744,2980,5764,8744,0,ITC,ITC1,1,Piemonte,Piemonte,4356406,2361405,54.21,0.2
2313,2021-04-06,PIE,20240,8810,11430,15044,5196,ITC,ITC1,1,Piemonte,Piemonte,4356406,2381645,54.67,0.46
2314,2020-12-27,PIE,913,369,544,913,0,ITC,ITC1,1,Piemonte,Piemonte,4356406,2382558,54.69,0.02
2315,2021-04-03,PIE,19430,8156,11274,10883,8547,ITC,ITC1,1,Piemonte,Piemonte,4356406,2401988,55.14,0.45
2316,2021-01-29,PIE,5943,1886,4057,455,5488,ITC,ITC1,1,Piemonte,Piemonte,4356406,2407931,55.27,0.14
2317,2021-01-12,PIE,10089,3415,6674,10089,0,ITC,ITC1,1,Piemonte,Piemonte,4356406,2418020,55.5,0.23
2318,2021-03-17,PIE,12518,5055,7463,5224,7294,ITC,ITC1,1,Piemonte,Piemonte,4356406,2430538,55.79,0.29
2319,2021-02-28,PIE,10816,4060,6756,10576,240,ITC,ITC1,1,Piemonte,Piemonte,4356406,2441354,56.04,0.25
2320,2021-01-28,PIE,5591,1809,3782,384,5207,ITC,ITC1,1,Piemonte,Piemonte,4356406,2446945,56.17,0.13
2321,2021-05-22,PIE,33307,15050,18257,17197,16110,ITC,ITC1,1,Piemonte,Piemonte,4356406,2480252,56.93,0.76
2322,2021-02-09,PIE,7392,2316,5076,722,6670,ITC,ITC1,1,Piemonte,Piemonte,4356406,2487644,57.1,0.17
2323,2021-03-12,PIE,13949,5184,8765,11014,2935,ITC,ITC1,1,Piemonte,Piemonte,4356406,2501593,57.42,0.32
2324,2021-03-26,PIE,17748,6982,10766,8840,8908,ITC,ITC1,1,Piemonte,Piemonte,4356406,2519341,57.83,0.41
2325,2021-04-07,PIE,23606,9995,13611,18143,5463,ITC,ITC1,1,Piemonte,Piemonte,4356406,2542947,58.37,0.54
2326,2021-03-01,PIE,12042,4845,7197,11233,809,ITC,ITC1,1,Piemonte,Piemonte,4356406,2554989,58.65,0.28
2327,2021-05-25,PIE,31002,14365,16637,15962,15040,ITC,ITC1,1,Piemonte,Piemonte,4356406,2585991,59.36,0.71
2328,2021-02-14,PIE,1476,498,978,876,600,ITC,ITC1,1,Piemonte,Piemonte,4356406,2587467,59.39,0.03
2329,2021-04-19,PIE,22533,10763,11770,18169,4364,ITC,ITC1,1,Piemonte,Piemonte,4356406,2610000,59.91,0.52
2330,2021-01-09,PIE,6184,2185,3999,6184,0,ITC,ITC1,1,Piemonte,Piemonte,4356406,2616184,60.05,0.14
2331,2021-02-21,PIE,5090,2083,3007,4988,102,ITC,ITC1,1,Piemonte,Piemonte,4356406,2621274,60.17,0.12
2332,2021-01-31,MAR,1920,770,1150,105,1815,ITI,ITI3,11,Marche,Marche,1525271,1920,0.13,0.13
2333,2021-02-09,MAR,124,42,82,46,78,ITI,ITI3,11,Marche,Marche,1525271,2044,0.13,0.01
2334,2021-04-14,MAR,10214,4563,5651,9842,372,ITI,ITI3,11,Marche,Marche,1525271,12258,0.8,0.67
2335,2021-04-09,MAR,9560,4189,5371,9360,200,ITI,ITI3,11,Marche,Marche,1525271,21818,1.43,0.63
2336,2021-03-24,MAR,7032,2983,4049,3364,3668,ITI,ITI3,11,Marche,Marche,1525271,28850,1.89,0.46
2337,2021-03-10,MAR,5666,2400,3266,4529,1137,ITI,ITI3,11,Marche,Marche,1525271,34516,2.26,0.37
2338,2021-01-19,MAR,228,83,145,142,86,ITI,ITI3,11,Marche,Marche,1525271,34744,2.28,0.01
2339,2021-05-13,MAR,12601,5694,6907,7102,5499,ITI,ITI3,11,Marche,Marche,1525271,47345,3.1,0.83
2340,2021-02-21,MAR,376,141,235,375,1,ITI,ITI3,11,Marche,Marche,1525271,47721,3.13,0.02
2341,2021-01-02,MAR,453,139,314,453,0,ITI,ITI3,11,Marche,Marche,1525271,48174,3.16,0.03
2342,2021-03-07,MAR,5179,2106,3073,4425,754,ITI,ITI3,11,Marche,Marche,1525271,53353,3.5,0.34
2343,2021-05-17,MAR,11853,5568,6285,7690,4163,ITI,ITI3,11,Marche,Marche,1525271,65206,4.28,0.78
2344,2021-05-01,MAR,9318,3924,5394,3576,5742,ITI,ITI3,11,Marche,Marche,1525271,74524,4.89,0.61
2345,2021-03-05,MAR,6171,2856,3315,4703,1468,ITI,ITI3,11,Marche,Marche,1525271,80695,5.29,0.4
2346,2021-01-07,MAR,1807,636,1171,1807,0,ITI,ITI3,11,Marche,Marche,1525271,82502,5.41,0.12
2347,2021-04-24,MAR,12023,5303,6720,7559,4464,ITI,ITI3,11,Marche,Marche,1525271,94525,6.2,0.79
2348,2021-02-26,MAR,3630,1499,2131,3154,476,ITI,ITI3,11,Marche,Marche,1525271,98155,6.44,0.24
2349,2021-01-21,MAR,899,255,644,585,314,ITI,ITI3,11,Marche,Marche,1525271,99054,6.49,0.06
2350,2021-03-12,MAR,4640,1972,2668,3402,1238,ITI,ITI3,11,Marche,Marche,1525271,103694,6.8,0.3
2351,2021-01-14,MAR,2010,692,1318,2010,0,ITI,ITI3,11,Marche,Marche,1525271,105704,6.93,0.13
2352,2021-05-08,MAR,12270,5477,6793,5023,7247,ITI,ITI3,11,Marche,Marche,1525271,117974,7.73,0.8
2353,2021-04-02,MAR,6875,2973,3902,6135,740,ITI,ITI3,11,Marche,Marche,1525271,124849,8.19,0.45
2354,2021-01-28,MAR,2086,725,1361,165,1921,ITI,ITI3,11,Marche,Marche,1525271,126935,8.32,0.14
2355,2021-04-04,MAR,3824,1792,2032,2655,1169,ITI,ITI3,11,Marche,Marche,1525271,130759,8.57,0.25
2356,2021-04-05,MAR,5688,2355,3333,4419,1269,ITI,ITI3,11,Marche,Marche,1525271,136447,8.95,0.37
2357,2021-03-19,MAR,3835,1597,2238,339,3496,ITI,ITI3,11,Marche,Marche,1525271,140282,9.2,0.25
2358,2021-03-02,MAR,4953,1941,3012,4387,566,ITI,ITI3,11,Marche,Marche,1525271,145235,9.52,0.32
2359,2021-05-22,MAR,11933,5718,6215,7485,4448,ITI,ITI3,11,Marche,Marche,1525271,157168,10.3,0.78
2360,2021-05-29,MAR,12789,6195,6594,8261,4528,ITI,ITI3,11,Marche,Marche,1525271,169957,11.14,0.84
2361,2021-02-18,MAR,2101,745,1356,1815,286,ITI,ITI3,11,Marche,Marche,1525271,172058,11.28,0.14
2362,2021-02-25,MAR,3510,1434,2076,3331,179,ITI,ITI3,11,Marche,Marche,1525271,175568,11.51,0.23
2363,2021-04-26,MAR,8980,3983,4997,5958,3022,ITI,ITI3,11,Marche,Marche,1525271,184548,12.1,0.59
2364,2021-05-10,MAR,9447,4336,5111,4895,4552,ITI,ITI3,11,Marche,Marche,1525271,193995,12.72,0.62
2365,2021-03-14,MAR,2500,1032,1468,1907,593,ITI,ITI3,11,Marche,Marche,1525271,196495,12.88,0.16
2366,2021-01-23,MAR,557,190,367,123,434,ITI,ITI3,11,Marche,Marche,1525271,197052,12.92,0.04
2367,2021-03-28,MAR,4126,1739,2387,2435,1691,ITI,ITI3,11,Marche,Marche,1525271,201178,13.19,0.27
2368,2021-02-19,MAR,1962,712,1250,1827,135,ITI,ITI3,11,Marche,Marche,1525271,203140,13.32,0.13
2369,2020-12-31,MAR,385,180,205,385,0,ITI,ITI3,11,Marche,Marche,1525271,203525,13.34,0.03
2370,2021-05-15,MAR,13965,6376,7589,8076,5889,ITI,ITI3,11,Marche,Marche,1525271,217490,14.26,0.92
2371,2021-02-04,MAR,2341,809,1532,112,2229,ITI,ITI3,11,Marche,Marche,1525271,219831,14.41,0.15
2372,2021-03-26,MAR,6331,2606,3725,3523,2808,ITI,ITI3,11,Marche,Marche,1525271,226162,14.83,0.42
2373,2021-01-12,MAR,1227,413,814,1227,0,ITI,ITI3,11,Marche,Marche,1525271,227389,14.91,0.08
2374,2021-05-03,MAR,10196,4605,5591,4789,5407,ITI,ITI3,11,Marche,Marche,1525271,237585,15.58,0.67
2375,2021-03-21,MAR,4505,1873,2632,1629,2876,ITI,ITI3,11,Marche,Marche,1525271,242090,15.87,0.3
2376,2021-01-30,MAR,1905,668,1237,29,1876,ITI,ITI3,11,Marche,Marche,1525271,243995,16.0,0.12
2377,2021-05-12,MAR,10421,4684,5737,4921,5500,ITI,ITI3,11,Marche,Marche,1525271,254416,16.68,0.68
2378,2021-05-20,MAR,12365,5814,6551,7666,4699,ITI,ITI3,11,Marche,Marche,1525271,266781,17.49,0.81
2379,2021-02-07,MAR,1868,734,1134,344,1524,ITI,ITI3,11,Marche,Marche,1525271,268649,17.61,0.12
2380,2021-04-07,MAR,7810,3435,4375,7475,335,ITI,ITI3,11,Marche,Marche,1525271,276459,18.13,0.51
2381,2021-04-16,MAR,10082,4702,5380,9557,525,ITI,ITI3,11,Marche,Marche,1525271,286541,18.79,0.66
2382,2021-01-04,MAR,1506,568,938,1506,0,ITI,ITI3,11,Marche,Marche,1525271,288047,18.88,0.1
2383,2020-12-30,MAR,17,5,12,17,0,ITI,ITI3,11,Marche,Marche,1525271,288064,18.89,0.0
2384,2021-06-01,MAR,12050,6154,5896,9962,2088,ITI,ITI3,11,Marche,Marche,1525271,300114,19.68,0.79
2385,2021-04-12,MAR,8567,3772,4795,8083,484,ITI,ITI3,11,Marche,Marche,1525271,308681,20.24,0.56
2386,2021-02-02,MAR,1191,397,794,72,1119,ITI,ITI3,11,Marche,Marche,1525271,309872,20.32,0.08
2387,2021-01-16,MAR,2005,723,1282,2005,0,ITI,ITI3,11,Marche,Marche,1525271,311877,20.45,0.13
2388,2021-04-28,MAR,10734,4890,5844,6003,4731,ITI,ITI3,11,Marche,Marche,1525271,322611,21.15,0.7
2389,2021-01-18,MAR,673,230,443,547,126,ITI,ITI3,11,Marche,Marche,1525271,323284,21.2,0.04
2390,2021-03-29,MAR,5860,2567,3293,3435,2425,ITI,ITI3,11,Marche,Marche,1525271,329144,21.58,0.38
2391,2021-05-27,MAR,13729,6817,6912,9428,4301,ITI,ITI3,11,Marche,Marche,1525271,342873,22.48,0.9
2392,2021-03-31,MAR,7374,3086,4288,4350,3024,ITI,ITI3,11,Marche,Marche,1525271,350247,22.96,0.48
2393,2021-06-03,MAR,14488,7396,7092,12272,2216,ITI,ITI3,11,Marche,Marche,1525271,364735,23.91,0.95
2394,2021-02-16,MAR,1287,475,812,1257,30,ITI,ITI3,11,Marche,Marche,1525271,366022,24.0,0.08
2395,2021-02-23,MAR,3267,1397,1870,3211,56,ITI,ITI3,11,Marche,Marche,1525271,369289,24.21,0.21
2396,2021-01-06,MAR,2181,792,1389,2181,0,ITI,ITI3,11,Marche,Marche,1525271,371470,24.35,0.14
2397,2021-05-09,MAR,8769,3985,4784,3638,5131,ITI,ITI3,11,Marche,Marche,1525271,380239,24.93,0.57
2398,2021-03-06,MAR,5700,2623,3077,4433,1267,ITI,ITI3,11,Marche,Marche,1525271,385939,25.3,0.37
2399,2021-05-18,MAR,11061,5257,5804,7657,3404,ITI,ITI3,11,Marche,Marche,1525271,397000,26.03,0.73
2400,2021-03-17,MAR,3428,1494,1934,107,3321,ITI,ITI3,11,Marche,Marche,1525271,400428,26.25,0.22
2401,2021-02-28,MAR,2836,1251,1585,2830,6,ITI,ITI3,11,Marche,Marche,1525271,403264,26.44,0.19
2402,2021-05-24,MAR,10794,5110,5684,8120,2674,ITI,ITI3,11,Marche,Marche,1525271,414058,27.15,0.71
2403,2021-05-31,MAR,11780,5941,5839,8851,2929,ITI,ITI3,11,Marche,Marche,1525271,425838,27.92,0.77
2404,2021-04-30,MAR,13939,6100,7839,5398,8541,ITI,ITI3,11,Marche,Marche,1525271,439777,28.83,0.91
2405,2021-03-11,MAR,6591,2784,3807,5221,1370,ITI,ITI3,11,Marche,Marche,1525271,446368,29.26,0.43
2406,2021-05-14,MAR,13492,6217,7275,6720,6772,ITI,ITI3,11,Marche,Marche,1525271,459860,30.15,0.88
2407,2021-02-27,MAR,3356,1435,1921,3147,209,ITI,ITI3,11,Marche,Marche,1525271,463216,30.37,0.22
2408,2021-03-18,MAR,3389,1475,1914,162,3227,ITI,ITI3,11,Marche,Marche,1525271,466605,30.59,0.22
2409,2021-05-23,MAR,9208,4282,4926,7537,1671,ITI,ITI3,11,Marche,Marche,1525271,475813,31.2,0.6
2410,2021-02-10,MAR,1439,452,987,1080,359,ITI,ITI3,11,Marche,Marche,1525271,477252,31.29,0.09
2411,2021-02-12,MAR,1582,618,964,1430,152,ITI,ITI3,11,Marche,Marche,1525271,478834,31.39,0.1
2412,2021-04-17,MAR,11699,5315,6384,10626,1073,ITI,ITI3,11,Marche,Marche,1525271,490533,32.16,0.77
2413,2021-05-05,MAR,11647,5299,6348,5218,6429,ITI,ITI3,11,Marche,Marche,1525271,502180,32.92,0.76
2414,2021-02-13,MAR,1063,453,610,1011,52,ITI,ITI3,11,Marche,Marche,1525271,503243,32.99,0.07
2415,2021-04-18,MAR,8820,4131,4689,7899,921,ITI,ITI3,11,Marche,Marche,1525271,512063,33.57,0.58
2416,2021-01-27,MAR,2118,780,1338,122,1996,ITI,ITI3,11,Marche,Marche,1525271,514181,33.71,0.14
2417,2021-01-10,MAR,1737,699,1038,1737,0,ITI,ITI3,11,Marche,Marche,1525271,515918,33.82,0.11
2418,2021-04-23,MAR,11159,5140,6019,8104,3055,ITI,ITI3,11,Marche,Marche,1525271,527077,34.56,0.73
2419,2021-01-13,MAR,2105,746,1359,2105,0,ITI,ITI3,11,Marche,Marche,1525271,529182,34.69,0.14
2420,2021-01-15,MAR,1771,500,1271,1771,0,ITI,ITI3,11,Marche,Marche,1525271,530953,34.81,0.12
2421,2021-04-25,MAR,8599,3993,4606,7024,1575,ITI,ITI3,11,Marche,Marche,1525271,539552,35.37,0.56
2422,2021-05-02,MAR,8899,3936,4963,3161,5738,ITI,ITI3,11,Marche,Marche,1525271,548451,35.96,0.58
2423,2021-03-20,MAR,4135,1740,2395,1049,3086,ITI,ITI3,11,Marche,Marche,1525271,552586,36.23,0.27
2424,2021-01-22,MAR,487,167,320,194,293,ITI,ITI3,11,Marche,Marche,1525271,553073,36.26,0.03
2425,2021-05-21,MAR,12951,6113,6838,6695,6256,ITI,ITI3,11,Marche,Marche,1525271,566024,37.11,0.85
2426,2021-04-01,MAR,7576,3182,4394,4160,3416,ITI,ITI3,11,Marche,Marche,1525271,573600,37.61,0.5
2427,2021-02-17,MAR,1785,662,1123,1668,117,ITI,ITI3,11,Marche,Marche,1525271,575385,37.72,0.12
2428,2021-04-22,MAR,10795,4930,5865,9217,1578,ITI,ITI3,11,Marche,Marche,1525271,586180,38.43,0.71
2429,2021-03-03,MAR,6643,3046,3597,5761,882,ITI,ITI3,11,Marche,Marche,1525271,592823,38.87,0.44
2430,2021-01-05,MAR,1562,586,976,1562,0,ITI,ITI3,11,Marche,Marche,1525271,594385,38.97,0.1
2431,2021-03-27,MAR,7379,3073,4306,5021,2358,ITI,ITI3,11,Marche,Marche,1525271,601764,39.45,0.48
2432,2021-05-16,MAR,10898,4957,5941,6670,4228,ITI,ITI3,11,Marche,Marche,1525271,612662,40.17,0.71
2433,2021-04-10,MAR,10916,4620,6296,10603,313,ITI,ITI3,11,Marche,Marche,1525271,623578,40.88,0.72
2434,2021-02-05,MAR,2155,653,1502,440,1715,ITI,ITI3,11,Marche,Marche,1525271,625733,41.02,0.14
2435,2021-05-30,MAR,9732,4689,5043,6742,2990,ITI,ITI3,11,Marche,Marche,1525271,635465,41.66,0.64
2436,2021-02-06,MAR,2461,901,1560,522,1939,ITI,ITI3,11,Marche,Marche,1525271,637926,41.82,0.16
2437,2021-05-28,MAR,13954,6734,7220,9094,4860,ITI,ITI3,11,Marche,Marche,1525271,651880,42.74,0.91
2438,2021-04-08,MAR,7522,3285,4237,7195,327,ITI,ITI3,11,Marche,Marche,1525271,659402,43.23,0.49
2439,2021-04-15,MAR,10376,4674,5702,9811,565,ITI,ITI3,11,Marche,Marche,1525271,669778,43.91,0.68
2440,2021-02-24,MAR,3486,1515,1971,3408,78,ITI,ITI3,11,Marche,Marche,1525271,673264,44.14,0.23
2441,2021-05-04,MAR,10845,4789,6056,4950,5895,ITI,ITI3,11,Marche,Marche,1525271,684109,44.85,0.71
2442,2021-03-22,MAR,5655,2376,3279,2527,3128,ITI,ITI3,11,Marche,Marche,1525271,689764,45.22,0.37
2443,2021-01-24,MAR,881,339,542,5,876,ITI,ITI3,11,Marche,Marche,1525271,690645,45.28,0.06
2444,2021-03-04,MAR,6486,2868,3618,5093,1393,ITI,ITI3,11,Marche,Marche,1525271,697131,45.71,0.43
2445,2021-03-13,MAR,5766,2656,3110,1809,3957,ITI,ITI3,11,Marche,Marche,1525271,702897,46.08,0.38
2446,2021-01-29,MAR,1990,729,1261,167,1823,ITI,ITI3,11,Marche,Marche,1525271,704887,46.21,0.13
2447,2021-04-11,MAR,7116,3115,4001,6830,286,ITI,ITI3,11,Marche,Marche,1525271,712003,46.68,0.47
2448,2021-02-20,MAR,4121,1705,2416,4010,111,ITI,ITI3,11,Marche,Marche,1525271,716124,46.95,0.27
2449,2021-03-25,MAR,6656,2772,3884,3247,3409,ITI,ITI3,11,Marche,Marche,1525271,722780,47.39,0.44
2450,2021-01-20,MAR,403,100,303,384,19,ITI,ITI3,11,Marche,Marche,1525271,723183,47.41,0.03
2451,2021-02-03,MAR,2124,741,1383,119,2005,ITI,ITI3,11,Marche,Marche,1525271,725307,47.55,0.14
2452,2021-04-29,MAR,13246,6061,7185,7149,6097,ITI,ITI3,11,Marche,Marche,1525271,738553,48.42,0.87
2453,2021-05-26,MAR,11803,5916,5887,8620,3183,ITI,ITI3,11,Marche,Marche,1525271,750356,49.19,0.77
2454,2021-03-30,MAR,7418,3044,4374,4603,2815,ITI,ITI3,11,Marche,Marche,1525271,757774,49.68,0.49
2455,2021-02-01,MAR,1362,479,883,98,1264,ITI,ITI3,11,Marche,Marche,1525271,759136,49.77,0.09
2456,2021-03-23,MAR,5789,2529,3260,2262,3527,ITI,ITI3,11,Marche,Marche,1525271,764925,50.15,0.38
2457,2021-05-19,MAR,11470,5272,6198,8561,2909,ITI,ITI3,11,Marche,Marche,1525271,776395,50.9,0.75
2458,2021-02-15,MAR,967,412,555,954,13,ITI,ITI3,11,Marche,Marche,1525271,777362,50.97,0.06
2459,2021-04-06,MAR,8879,3693,5186,8066,813,ITI,ITI3,11,Marche,Marche,1525271,786241,51.55,0.58
2460,2021-02-08,MAR,833,258,575,371,462,ITI,ITI3,11,Marche,Marche,1525271,787074,51.6,0.05
2461,2020-12-27,MAR,201,98,103,201,0,ITI,ITI3,11,Marche,Marche,1525271,787275,51.62,0.01
2462,2021-03-09,MAR,5428,2290,3138,4548,880,ITI,ITI3,11,Marche,Marche,1525271,792703,51.97,0.36
2463,2021-06-02,MAR,11913,5943,5970,11236,677,ITI,ITI3,11,Marche,Marche,1525271,804616,52.75,0.78
2464,2021-04-13,MAR,9838,4259,5579,9605,233,ITI,ITI3,11,Marche,Marche,1525271,814454,53.4,0.65
2465,2021-02-22,MAR,3413,1499,1914,3338,75,ITI,ITI3,11,Marche,Marche,1525271,817867,53.62,0.22
2466,2021-01-03,MAR,897,349,548,897,0,ITI,ITI3,11,Marche,Marche,1525271,818764,53.68,0.06
2467,2021-03-08,MAR,6264,2744,3520,5262,1002,ITI,ITI3,11,Marche,Marche,1525271,825028,54.09,0.41
2468,2021-04-27,MAR,9400,4309,5091,5413,3987,ITI,ITI3,11,Marche,Marche,1525271,834428,54.71,0.62
2469,2021-03-15,MAR,4401,2026,2375,1311,3090,ITI,ITI3,11,Marche,Marche,1525271,838829,55.0,0.29
2470,2021-01-26,MAR,2016,746,1270,92,1924,ITI,ITI3,11,Marche,Marche,1525271,840845,55.13,0.13
2471,2021-02-14,MAR,738,301,437,738,0,ITI,ITI3,11,Marche,Marche,1525271,841583,55.18,0.05
2472,2021-04-19,MAR,9601,4497,5104,8020,1581,ITI,ITI3,11,Marche,Marche,1525271,851184,55.81,0.63
2473,2021-01-09,MAR,1709,605,1104,1709,0,ITI,ITI3,11,Marche,Marche,1525271,852893,55.92,0.11
2474,2021-04-21,MAR,10781,4967,5814,9587,1194,ITI,ITI3,11,Marche,Marche,1525271,863674,56.62,0.71
2475,2021-03-16,MAR,3471,1485,1986,290,3181,ITI,ITI3,11,Marche,Marche,1525271,867145,56.85,0.23
2476,2021-02-11,MAR,1987,657,1330,1598,389,ITI,ITI3,11,Marche,Marche,1525271,869132,56.98,0.13
2477,2021-05-07,MAR,12838,5805,7033,3660,9178,ITI,ITI3,11,Marche,Marche,1525271,881970,57.82,0.84
2478,2021-01-25,MAR,1596,559,1037,96,1500,ITI,ITI3,11,Marche,Marche,1525271,883566,57.93,0.1
2479,2021-04-20,MAR,10697,4995,5702,9280,1417,ITI,ITI3,11,Marche,Marche,1525271,894263,58.63,0.7
2480,2021-01-08,MAR,1576,588,988,1576,0,ITI,ITI3,11,Marche,Marche,1525271,895839,58.73,0.1
2481,2021-05-11,MAR,10622,4832,5790,5678,4944,ITI,ITI3,11,Marche,Marche,1525271,906461,59.43,0.7
2482,2021-01-11,MAR,1176,411,765,1176,0,ITI,ITI3,11,Marche,Marche,1525271,907637,59.51,0.08
2483,2021-03-01,MAR,3724,1487,2237,3476,248,ITI,ITI3,11,Marche,Marche,1525271,911361,59.75,0.24
2484,2021-05-06,MAR,12655,5820,6835,5582,7073,ITI,ITI3,11,Marche,Marche,1525271,924016,60.58,0.83
2485,2021-04-03,MAR,7573,3204,4369,6903,670,ITI,ITI3,11,Marche,Marche,1525271,931589,61.08,0.5
2486,2021-05-25,MAR,11646,5744,5902,8717,2929,ITI,ITI3,11,Marche,Marche,1525271,943235,61.84,0.76
2487,2021-01-17,MAR,1607,687,920,1550,57,ITI,ITI3,11,Marche,Marche,1525271,944842,61.95,0.11
2488,2021-01-25,FVG,1583,567,1016,194,1389,ITH,ITH4,6,Friuli-Venezia Giulia,Friuli Venezia Giulia,1215220,1583,0.13,0.13
2489,2021-04-28,FVG,7259,3201,4058,3795,3464,ITH,ITH4,6,Friuli-Venezia Giulia,Friuli Venezia Giulia,1215220,8842,0.73,0.6
2490,2021-01-16,FVG,1230,360,870,1230,0,ITH,ITH4,6,Friuli-Venezia Giulia,Friuli Venezia Giulia,1215220,10072,0.83,0.1
2491,2021-05-28,FVG,9872,4583,5289,5945,3927,ITH,ITH4,6,Friuli-Venezia Giulia,Friuli Venezia Giulia,1215220,19944,1.64,0.81
2492,2021-03-25,FVG,5309,2261,3048,3176,2133,ITH,ITH4,6,Friuli-Venezia Giulia,Friuli Venezia Giulia,1215220,25253,2.08,0.44
2493,2021-03-30,FVG,7093,3141,3952,6171,922,ITH,ITH4,6,Friuli-Venezia Giulia,Friuli Venezia Giulia,1215220,32346,2.66,0.58
2494,2021-02-06,FVG,1154,338,816,22,1132,ITH,ITH4,6,Friuli-Venezia Giulia,Friuli Venezia Giulia,1215220,33500,2.76,0.09
2495,2021-01-04,FVG,1507,558,949,1507,0,ITH,ITH4,6,Friuli-Venezia Giulia,Friuli Venezia Giulia,1215220,35007,2.88,0.12
2496,2021-02-23,FVG,2633,1267,1366,2453,180,ITH,ITH4,6,Friuli-Venezia Giulia,Friuli Venezia Giulia,1215220,37640,3.1,0.22
2497,2021-03-09,FVG,3861,1589,2272,1114,2747,ITH,ITH4,6,Friuli-Venezia Giulia,Friuli Venezia Giulia,1215220,41501,3.42,0.32
2498,2021-03-13,FVG,2935,1120,1815,1664,1271,ITH,ITH4,6,Friuli-Venezia Giulia,Friuli Venezia Giulia,1215220,44436,3.66,0.24
2499,2021-05-16,FVG,9942,4761,5181,8546,1396,ITH,ITH4,6,Friuli-Venezia Giulia,Friuli Venezia Giulia,1215220,54378,4.47,0.82
2500,2021-01-06,FVG,710,264,446,710,0,ITH,ITH4,6,Friuli-Venezia Giulia,Friuli Venezia Giulia,1215220,55088,4.53,0.06
2501,2020-12-30,FVG,626,244,382,626,0,ITH,ITH4,6,Friuli-Venezia Giulia,Friuli Venezia Giulia,1215220,55714,4.58,0.05
2502,2021-02-25,FVG,3160,1651,1509,3135,25,ITH,ITH4,6,Friuli-Venezia Giulia,Friuli Venezia Giulia,1215220,58874,4.84,0.26
2503,2021-02-18,FVG,3218,1492,1726,2811,407,ITH,ITH4,6,Friuli-Venezia Giulia,Friuli Venezia Giulia,1215220,62092,5.11,0.26
2504,2021-04-02,FVG,6566,2915,3651,4733,1833,ITH,ITH4,6,Friuli-Venezia Giulia,Friuli Venezia Giulia,1215220,68658,5.65,0.54
2505,2021-04-16,FVG,6913,2997,3916,4989,1924,ITH,ITH4,6,Friuli-Venezia Giulia,Friuli Venezia Giulia,1215220,75571,6.22,0.57
2506,2021-02-11,FVG,1930,664,1266,1738,192,ITH,ITH4,6,Friuli-Venezia Giulia,Friuli Venezia Giulia,1215220,77501,6.38,0.16
2507,2021-04-09,FVG,7763,3528,4235,6519,1244,ITH,ITH4,6,Friuli-Venezia Giulia,Friuli Venezia Giulia,1215220,85264,7.02,0.64
2508,2021-04-23,FVG,7455,3375,4080,3599,3856,ITH,ITH4,6,Friuli-Venezia Giulia,Friuli Venezia Giulia,1215220,92719,7.63,0.61
2509,2021-03-20,FVG,3340,1351,1989,1249,2091,ITH,ITH4,6,Friuli-Venezia Giulia,Friuli Venezia Giulia,1215220,96059,7.9,0.27
2510,2021-03-18,FVG,3372,1421,1951,1691,1681,ITH,ITH4,6,Friuli-Venezia Giulia,Friuli Venezia Giulia,1215220,99431,8.18,0.28
2511,2021-01-13,FVG,2650,834,1816,2650,0,ITH,ITH4,6,Friuli-Venezia Giulia,Friuli Venezia Giulia,1215220,102081,8.4,0.22
2512,2021-03-04,FVG,3446,1595,1851,2788,658,ITH,ITH4,6,Friuli-Venezia Giulia,Friuli Venezia Giulia,1215220,105527,8.68,0.28
2513,2021-05-24,FVG,11010,5268,5742,7516,3494,ITH,ITH4,6,Friuli-Venezia Giulia,Friuli Venezia Giulia,1215220,116537,9.59,0.91
2514,2021-03-21,FVG,2602,937,1665,2193,409,ITH,ITH4,6,Friuli-Venezia Giulia,Friuli Venezia Giulia,1215220,119139,9.8,0.21
2515,2021-02-15,FVG,2453,911,1542,2201,252,ITH,ITH4,6,Friuli-Venezia Giulia,Friuli Venezia Giulia,1215220,121592,10.01,0.2
2516,2021-04-20,FVG,7106,3059,4047,3203,3903,ITH,ITH4,6,Friuli-Venezia Giulia,Friuli Venezia Giulia,1215220,128698,10.59,0.58
2517,2021-05-07,FVG,10566,4830,5736,7087,3479,ITH,ITH4,6,Friuli-Venezia Giulia,Friuli Venezia Giulia,1215220,139264,11.46,0.87
2518,2021-04-08,FVG,7211,3016,4195,5289,1922,ITH,ITH4,6,Friuli-Venezia Giulia,Friuli Venezia Giulia,1215220,146475,12.05,0.59
2519,2021-02-10,FVG,1352,496,856,1266,86,ITH,ITH4,6,Friuli-Venezia Giulia,Friuli Venezia Giulia,1215220,147827,12.16,0.11
2520,2021-02-03,FVG,2647,791,1856,23,2624,ITH,ITH4,6,Friuli-Venezia Giulia,Friuli Venezia Giulia,1215220,150474,12.38,0.22
2521,2021-05-21,FVG,11054,4920,6134,8168,2886,ITH,ITH4,6,Friuli-Venezia Giulia,Friuli Venezia Giulia,1215220,161528,13.29,0.91
2522,2021-05-14,FVG,10597,5247,5350,8124,2473,ITH,ITH4,6,Friuli-Venezia Giulia,Friuli Venezia Giulia,1215220,172125,14.16,0.87
2523,2021-04-11,FVG,3433,1520,1913,2527,906,ITH,ITH4,6,Friuli-Venezia Giulia,Friuli Venezia Giulia,1215220,175558,14.45,0.28
2524,2021-01-08,FVG,2322,747,1575,2322,0,ITH,ITH4,6,Friuli-Venezia Giulia,Friuli Venezia Giulia,1215220,177880,14.64,0.19
2525,2021-02-27,FVG,3528,1200,2328,3527,1,ITH,ITH4,6,Friuli-Venezia Giulia,Friuli Venezia Giulia,1215220,181408,14.93,0.29
2526,2021-04-25,FVG,2363,990,1373,2352,11,ITH,ITH4,6,Friuli-Venezia Giulia,Friuli Venezia Giulia,1215220,183771,15.12,0.19
2527,2021-02-20,FVG,2068,933,1135,1924,144,ITH,ITH4,6,Friuli-Venezia Giulia,Friuli Venezia Giulia,1215220,185839,15.29,0.17
2528,2021-04-30,FVG,7305,3218,4087,3692,3613,ITH,ITH4,6,Friuli-Venezia Giulia,Friuli Venezia Giulia,1215220,193144,15.89,0.6
2529,2021-02-04,FVG,2725,808,1917,35,2690,ITH,ITH4,6,Friuli-Venezia Giulia,Friuli Venezia Giulia,1215220,195869,16.12,0.22
2530,2021-03-11,FVG,3356,1414,1942,1605,1751,ITH,ITH4,6,Friuli-Venezia Giulia,Friuli Venezia Giulia,1215220,199225,16.39,0.28
2531,2021-01-20,FVG,748,320,428,13,735,ITH,ITH4,6,Friuli-Venezia Giulia,Friuli Venezia Giulia,1215220,199973,16.46,0.06
2532,2021-05-31,FVG,8253,4039,4214,6348,1905,ITH,ITH4,6,Friuli-Venezia Giulia,Friuli Venezia Giulia,1215220,208226,17.13,0.68
2533,2021-01-15,FVG,2021,605,1416,2021,0,ITH,ITH4,6,Friuli-Venezia Giulia,Friuli Venezia Giulia,1215220,210247,17.3,0.17
2534,2021-01-22,FVG,90,30,60,0,90,ITH,ITH4,6,Friuli-Venezia Giulia,Friuli Venezia Giulia,1215220,210337,17.31,0.01
2535,2021-03-06,FVG,3500,1196,2304,3175,325,ITH,ITH4,6,Friuli-Venezia Giulia,Friuli Venezia Giulia,1215220,213837,17.6,0.29
2536,2021-04-18,FVG,6038,2799,3239,5631,407,ITH,ITH4,6,Friuli-Venezia Giulia,Friuli Venezia Giulia,1215220,219875,18.09,0.5
2537,2021-04-27,FVG,8077,3703,4374,3619,4458,ITH,ITH4,6,Friuli-Venezia Giulia,Friuli Venezia Giulia,1215220,227952,18.76,0.66
2538,2021-03-23,FVG,3753,1559,2194,1613,2140,ITH,ITH4,6,Friuli-Venezia Giulia,Friuli Venezia Giulia,1215220,231705,19.07,0.31
2539,2021-01-23,FVG,816,324,492,4,812,ITH,ITH4,6,Friuli-Venezia Giulia,Friuli Venezia Giulia,1215220,232521,19.13,0.07
2540,2021-05-05,FVG,9709,4231,5478,6268,3441,ITH,ITH4,6,Friuli-Venezia Giulia,Friuli Venezia Giulia,1215220,242230,19.93,0.8
2541,2021-04-01,FVG,6315,2993,3322,5300,1015,ITH,ITH4,6,Friuli-Venezia Giulia,Friuli Venezia Giulia,1215220,248545,20.45,0.52
2542,2021-01-18,FVG,1961,606,1355,1867,94,ITH,ITH4,6,Friuli-Venezia Giulia,Friuli Venezia Giulia,1215220,250506,20.61,0.16
2543,2021-03-28,FVG,4814,2277,2537,4673,141,ITH,ITH4,6,Friuli-Venezia Giulia,Friuli Venezia Giulia,1215220,255320,21.01,0.4
2544,2021-05-17,FVG,8770,4074,4696,6290,2480,ITH,ITH4,6,Friuli-Venezia Giulia,Friuli Venezia Giulia,1215220,264090,21.73,0.72
2545,2021-01-03,FVG,312,122,190,312,0,ITH,ITH4,6,Friuli-Venezia Giulia,Friuli Venezia Giulia,1215220,264402,21.76,0.03
2546,2021-02-22,FVG,2485,1193,1292,2067,418,ITH,ITH4,6,Friuli-Venezia Giulia,Friuli Venezia Giulia,1215220,266887,21.96,0.2
2547,2021-04-13,FVG,7362,3289,4073,5758,1604,ITH,ITH4,6,Friuli-Venezia Giulia,Friuli Venezia Giulia,1215220,274249,22.57,0.61
2548,2021-03-16,FVG,3153,1287,1866,1073,2080,ITH,ITH4,6,Friuli-Venezia Giulia,Friuli Venezia Giulia,1215220,277402,22.83,0.26
2549,2021-05-12,FVG,10672,4937,5735,9317,1355,ITH,ITH4,6,Friuli-Venezia Giulia,Friuli Venezia Giulia,1215220,288074,23.71,0.88
2550,2021-05-19,FVG,11724,5746,5978,9481,2243,ITH,ITH4,6,Friuli-Venezia Giulia,Friuli Venezia Giulia,1215220,299798,24.67,0.96
2551,2021-03-14,FVG,1397,549,848,1145,252,ITH,ITH4,6,Friuli-Venezia Giulia,Friuli Venezia Giulia,1215220,301195,24.79,0.11
2552,2021-02-01,FVG,2097,688,1409,16,2081,ITH,ITH4,6,Friuli-Venezia Giulia,Friuli Venezia Giulia,1215220,303292,24.96,0.17
2553,2021-02-08,FVG,2357,694,1663,92,2265,ITH,ITH4,6,Friuli-Venezia Giulia,Friuli Venezia Giulia,1215220,305649,25.15,0.19
2554,2021-02-19,FVG,3251,1289,1962,2824,427,ITH,ITH4,6,Friuli-Venezia Giulia,Friuli Venezia Giulia,1215220,308900,25.42,0.27
2555,2021-04-24,FVG,6674,2945,3729,5432,1242,ITH,ITH4,6,Friuli-Venezia Giulia,Friuli Venezia Giulia,1215220,315574,25.97,0.55
2556,2021-05-03,FVG,7181,3271,3910,3407,3774,ITH,ITH4,6,Friuli-Venezia Giulia,Friuli Venezia Giulia,1215220,322755,26.56,0.59
2557,2021-02-28,FVG,2685,1002,1683,2292,393,ITH,ITH4,6,Friuli-Venezia Giulia,Friuli Venezia Giulia,1215220,325440,26.78,0.22
2558,2021-02-13,FVG,566,179,387,560,6,ITH,ITH4,6,Friuli-Venezia Giulia,Friuli Venezia Giulia,1215220,326006,26.83,0.05
2559,2021-03-02,FVG,4219,1519,2700,2720,1499,ITH,ITH4,6,Friuli-Venezia Giulia,Friuli Venezia Giulia,1215220,330225,27.17,0.35
2560,2021-01-27,FVG,1272,425,847,450,822,ITH,ITH4,6,Friuli-Venezia Giulia,Friuli Venezia Giulia,1215220,331497,27.28,0.1
2561,2021-05-09,FVG,7348,3297,4051,3493,3855,ITH,ITH4,6,Friuli-Venezia Giulia,Friuli Venezia Giulia,1215220,338845,27.88,0.6
2562,2021-05-26,FVG,12706,6299,6407,9428,3278,ITH,ITH4,6,Friuli-Venezia Giulia,Friuli Venezia Giulia,1215220,351551,28.93,1.05
2563,2021-05-02,FVG,6838,3210,3628,3939,2899,ITH,ITH4,6,Friuli-Venezia Giulia,Friuli Venezia Giulia,1215220,358389,29.49,0.56
2564,2021-04-29,FVG,6695,2937,3758,4163,2532,ITH,ITH4,6,Friuli-Venezia Giulia,Friuli Venezia Giulia,1215220,365084,30.04,0.55
2565,2021-02-24,FVG,2520,1084,1436,2502,18,ITH,ITH4,6,Friuli-Venezia Giulia,Friuli Venezia Giulia,1215220,367604,30.25,0.21
2566,2021-04-15,FVG,6487,2859,3628,5216,1271,ITH,ITH4,6,Friuli-Venezia Giulia,Friuli Venezia Giulia,1215220,374091,30.78,0.53
2567,2021-02-12,FVG,1193,428,765,1146,47,ITH,ITH4,6,Friuli-Venezia Giulia,Friuli Venezia Giulia,1215220,375284,30.88,0.1
2568,2021-03-03,FVG,3639,1627,2012,2365,1274,ITH,ITH4,6,Friuli-Venezia Giulia,Friuli Venezia Giulia,1215220,378923,31.18,0.3
2569,2021-01-28,FVG,2239,794,1445,354,1885,ITH,ITH4,6,Friuli-Venezia Giulia,Friuli Venezia Giulia,1215220,381162,31.37,0.18
2570,2021-05-08,FVG,10252,4635,5617,5474,4778,ITH,ITH4,6,Friuli-Venezia Giulia,Friuli Venezia Giulia,1215220,391414,32.21,0.84
2571,2021-05-29,FVG,11896,5785,6111,6985,4911,ITH,ITH4,6,Friuli-Venezia Giulia,Friuli Venezia Giulia,1215220,403310,33.19,0.98
2572,2021-05-22,FVG,11508,5167,6341,7285,4223,ITH,ITH4,6,Friuli-Venezia Giulia,Friuli Venezia Giulia,1215220,414818,34.14,0.95
2573,2021-01-12,FVG,2260,713,1547,2260,0,ITH,ITH4,6,Friuli-Venezia Giulia,Friuli Venezia Giulia,1215220,417078,34.32,0.19
2574,2021-01-29,FVG,2414,814,1600,264,2150,ITH,ITH4,6,Friuli-Venezia Giulia,Friuli Venezia Giulia,1215220,419492,34.52,0.2
2575,2021-04-03,FVG,3983,1969,2014,2655,1328,ITH,ITH4,6,Friuli-Venezia Giulia,Friuli Venezia Giulia,1215220,423475,34.85,0.33
2576,2021-04-07,FVG,7499,3324,4175,6718,781,ITH,ITH4,6,Friuli-Venezia Giulia,Friuli Venezia Giulia,1215220,430974,35.46,0.62
2577,2021-04-17,FVG,7447,3232,4215,5965,1482,ITH,ITH4,6,Friuli-Venezia Giulia,Friuli Venezia Giulia,1215220,438421,36.08,0.61
2578,2021-04-10,FVG,4986,2164,2822,3761,1225,ITH,ITH4,6,Friuli-Venezia Giulia,Friuli Venezia Giulia,1215220,443407,36.49,0.41
2579,2021-05-23,FVG,10260,4850,5410,6113,4147,ITH,ITH4,6,Friuli-Venezia Giulia,Friuli Venezia Giulia,1215220,453667,37.33,0.84
2580,2021-05-06,FVG,11864,5513,6351,7911,3953,ITH,ITH4,6,Friuli-Venezia Giulia,Friuli Venezia Giulia,1215220,465531,38.31,0.98
2581,2021-03-17,FVG,3233,1266,1967,743,2490,ITH,ITH4,6,Friuli-Venezia Giulia,Friuli Venezia Giulia,1215220,468764,38.57,0.27
2582,2021-02-16,FVG,2516,1135,1381,2400,116,ITH,ITH4,6,Friuli-Venezia Giulia,Friuli Venezia Giulia,1215220,471280,38.78,0.21
2583,2021-05-20,FVG,12411,6092,6319,9990,2421,ITH,ITH4,6,Friuli-Venezia Giulia,Friuli Venezia Giulia,1215220,483691,39.8,1.02
2584,2021-05-15,FVG,12593,6071,6522,7916,4677,ITH,ITH4,6,Friuli-Venezia Giulia,Friuli Venezia Giulia,1215220,496284,40.84,1.04
2585,2021-01-21,FVG,896,345,551,1,895,ITH,ITH4,6,Friuli-Venezia Giulia,Friuli Venezia Giulia,1215220,497180,40.91,0.07
2586,2021-03-26,FVG,5801,2425,3376,3789,2012,ITH,ITH4,6,Friuli-Venezia Giulia,Friuli Venezia Giulia,1215220,502981,41.39,0.48
2587,2021-05-01,FVG,7187,3244,3943,6144,1043,ITH,ITH4,6,Friuli-Venezia Giulia,Friuli Venezia Giulia,1215220,510168,41.98,0.59
2588,2021-03-12,FVG,3938,1544,2394,2557,1381,ITH,ITH4,6,Friuli-Venezia Giulia,Friuli Venezia Giulia,1215220,514106,42.31,0.32
2589,2021-05-13,FVG,11006,5288,5718,9006,2000,ITH,ITH4,6,Friuli-Venezia Giulia,Friuli Venezia Giulia,1215220,525112,43.21,0.91
2590,2021-02-09,FVG,1842,555,1287,1556,286,ITH,ITH4,6,Friuli-Venezia Giulia,Friuli Venezia Giulia,1215220,526954,43.36,0.15
2591,2021-03-24,FVG,3766,1530,2236,2286,1480,ITH,ITH4,6,Friuli-Venezia Giulia,Friuli Venezia Giulia,1215220,530720,43.67,0.31
2592,2021-01-26,FVG,1977,647,1330,217,1760,ITH,ITH4,6,Friuli-Venezia Giulia,Friuli Venezia Giulia,1215220,532697,43.84,0.16
2593,2021-01-09,FVG,2513,841,1672,2513,0,ITH,ITH4,6,Friuli-Venezia Giulia,Friuli Venezia Giulia,1215220,535210,44.04,0.21
2594,2021-03-07,FVG,2547,932,1615,2546,1,ITH,ITH4,6,Friuli-Venezia Giulia,Friuli Venezia Giulia,1215220,537757,44.25,0.21
2595,2021-04-19,FVG,6705,3131,3574,3293,3412,ITH,ITH4,6,Friuli-Venezia Giulia,Friuli Venezia Giulia,1215220,544462,44.8,0.55
2596,2021-02-26,FVG,3735,2093,1642,3587,148,ITH,ITH4,6,Friuli-Venezia Giulia,Friuli Venezia Giulia,1215220,548197,45.11,0.31
2597,2021-02-17,FVG,2353,999,1354,1873,480,ITH,ITH4,6,Friuli-Venezia Giulia,Friuli Venezia Giulia,1215220,550550,45.3,0.19
2598,2021-05-30,FVG,11038,4978,6060,7459,3579,ITH,ITH4,6,Friuli-Venezia Giulia,Friuli Venezia Giulia,1215220,561588,46.21,0.91
2599,2021-04-26,FVG,5455,2449,3006,3806,1649,ITH,ITH4,6,Friuli-Venezia Giulia,Friuli Venezia Giulia,1215220,567043,46.66,0.45
2600,2021-01-14,FVG,2584,789,1795,2584,0,ITH,ITH4,6,Friuli-Venezia Giulia,Friuli Venezia Giulia,1215220,569627,46.87,0.21
2601,2021-03-10,FVG,3358,1493,1865,1566,1792,ITH,ITH4,6,Friuli-Venezia Giulia,Friuli Venezia Giulia,1215220,572985,47.15,0.28
2602,2021-01-05,FVG,1678,551,1127,1678,0,ITH,ITH4,6,Friuli-Venezia Giulia,Friuli Venezia Giulia,1215220,574663,47.29,0.14
2603,2021-03-27,FVG,4985,2560,2425,3574,1411,ITH,ITH4,6,Friuli-Venezia Giulia,Friuli Venezia Giulia,1215220,579648,47.7,0.41
2604,2021-02-05,FVG,2614,785,1829,90,2524,ITH,ITH4,6,Friuli-Venezia Giulia,Friuli Venezia Giulia,1215220,582262,47.91,0.22
2605,2021-04-14,FVG,7216,3119,4097,5504,1712,ITH,ITH4,6,Friuli-Venezia Giulia,Friuli Venezia Giulia,1215220,589478,48.51,0.59
2606,2021-06-03,FVG,10088,5298,4790,8494,1594,ITH,ITH4,6,Friuli-Venezia Giulia,Friuli Venezia Giulia,1215220,599566,49.34,0.83
2607,2021-01-19,FVG,6,2,4,6,0,ITH,ITH4,6,Friuli-Venezia Giulia,Friuli Venezia Giulia,1215220,599572,49.34,0.0
2608,2021-01-24,FVG,305,119,186,1,304,ITH,ITH4,6,Friuli-Venezia Giulia,Friuli Venezia Giulia,1215220,599877,49.36,0.03
2609,2021-03-22,FVG,3540,1343,2197,1586,1954,ITH,ITH4,6,Friuli-Venezia Giulia,Friuli Venezia Giulia,1215220,603417,49.65,0.29
2610,2021-01-31,FVG,2714,836,1878,385,2329,ITH,ITH4,6,Friuli-Venezia Giulia,Friuli Venezia Giulia,1215220,606131,49.88,0.22
2611,2021-05-04,FVG,9511,4286,5225,6158,3353,ITH,ITH4,6,Friuli-Venezia Giulia,Friuli Venezia Giulia,1215220,615642,50.66,0.78
2612,2021-03-08,FVG,4063,1593,2470,1978,2085,ITH,ITH4,6,Friuli-Venezia Giulia,Friuli Venezia Giulia,1215220,619705,51.0,0.33
2613,2021-01-17,FVG,1716,523,1193,1716,0,ITH,ITH4,6,Friuli-Venezia Giulia,Friuli Venezia Giulia,1215220,621421,51.14,0.14
2614,2021-03-15,FVG,3765,1636,2129,1446,2319,ITH,ITH4,6,Friuli-Venezia Giulia,Friuli Venezia Giulia,1215220,625186,51.45,0.31
2615,2021-05-11,FVG,8953,4290,4663,7165,1788,ITH,ITH4,6,Friuli-Venezia Giulia,Friuli Venezia Giulia,1215220,634139,52.18,0.74
2616,2021-06-02,FVG,9179,4842,4337,8908,271,ITH,ITH4,6,Friuli-Venezia Giulia,Friuli Venezia Giulia,1215220,643318,52.94,0.76
2617,2021-02-07,FVG,1561,483,1078,385,1176,ITH,ITH4,6,Friuli-Venezia Giulia,Friuli Venezia Giulia,1215220,644879,53.07,0.13
2618,2021-05-18,FVG,10559,5269,5290,8542,2017,ITH,ITH4,6,Friuli-Venezia Giulia,Friuli Venezia Giulia,1215220,655438,53.94,0.87
2619,2021-06-01,FVG,9403,4698,4705,7342,2061,ITH,ITH4,6,Friuli-Venezia Giulia,Friuli Venezia Giulia,1215220,664841,54.71,0.77
2620,2021-03-29,FVG,6874,3001,3873,5295,1579,ITH,ITH4,6,Friuli-Venezia Giulia,Friuli Venezia Giulia,1215220,671715,55.28,0.57
2621,2021-01-02,FVG,1216,470,746,1216,0,ITH,ITH4,6,Friuli-Venezia Giulia,Friuli Venezia Giulia,1215220,672931,55.38,0.1
2622,2021-01-30,FVG,2275,745,1530,270,2005,ITH,ITH4,6,Friuli-Venezia Giulia,Friuli Venezia Giulia,1215220,675206,55.56,0.19
2623,2021-04-21,FVG,7746,3453,4293,4066,3680,ITH,ITH4,6,Friuli-Venezia Giulia,Friuli Venezia Giulia,1215220,682952,56.2,0.64
2624,2021-01-11,FVG,1882,608,1274,1882,0,ITH,ITH4,6,Friuli-Venezia Giulia,Friuli Venezia Giulia,1215220,684834,56.35,0.15
2625,2021-03-01,FVG,2957,1041,1916,2905,52,ITH,ITH4,6,Friuli-Venezia Giulia,Friuli Venezia Giulia,1215220,687791,56.6,0.24
2626,2020-12-27,FVG,262,149,113,262,0,ITH,ITH4,6,Friuli-Venezia Giulia,Friuli Venezia Giulia,1215220,688053,56.62,0.02
2627,2021-04-05,FVG,2868,1425,1443,2853,15,ITH,ITH4,6,Friuli-Venezia Giulia,Friuli Venezia Giulia,1215220,690921,56.86,0.24
2628,2021-01-10,FVG,2939,918,2021,2939,0,ITH,ITH4,6,Friuli-Venezia Giulia,Friuli Venezia Giulia,1215220,693860,57.1,0.24
2629,2021-04-22,FVG,6768,3076,3692,3082,3686,ITH,ITH4,6,Friuli-Venezia Giulia,Friuli Venezia Giulia,1215220,700628,57.65,0.56
2630,2021-03-19,FVG,3234,1339,1895,1301,1933,ITH,ITH4,6,Friuli-Venezia Giulia,Friuli Venezia Giulia,1215220,703862,57.92,0.27
2631,2021-01-07,FVG,2091,717,1374,2091,0,ITH,ITH4,6,Friuli-Venezia Giulia,Friuli Venezia Giulia,1215220,705953,58.09,0.17
2632,2021-03-05,FVG,3736,1478,2258,2663,1073,ITH,ITH4,6,Friuli-Venezia Giulia,Friuli Venezia Giulia,1215220,709689,58.4,0.31
2633,2020-12-31,FVG,1053,384,669,1053,0,ITH,ITH4,6,Friuli-Venezia Giulia,Friuli Venezia Giulia,1215220,710742,58.49,0.09
2634,2021-02-02,FVG,2467,806,1661,217,2250,ITH,ITH4,6,Friuli-Venezia Giulia,Friuli Venezia Giulia,1215220,713209,58.69,0.2
2635,2021-03-31,FVG,8033,3503,4530,7187,846,ITH,ITH4,6,Friuli-Venezia Giulia,Friuli Venezia Giulia,1215220,721242,59.35,0.66
2636,2021-04-06,FVG,6278,2771,3507,5128,1150,ITH,ITH4,6,Friuli-Venezia Giulia,Friuli Venezia Giulia,1215220,727520,59.87,0.52
2637,2021-05-25,FVG,12455,6072,6383,9277,3178,ITH,ITH4,6,Friuli-Venezia Giulia,Friuli Venezia Giulia,1215220,739975,60.89,1.02
2638,2021-05-10,FVG,7911,3514,4397,6372,1539,ITH,ITH4,6,Friuli-Venezia Giulia,Friuli Venezia Giulia,1215220,747886,61.54,0.65
2639,2021-05-27,FVG,12228,5767,6461,7169,5059,ITH,ITH4,6,Friuli-Venezia Giulia,Friuli Venezia Giulia,1215220,760114,62.55,1.01
2640,2021-02-21,FVG,801,281,520,423,378,ITH,ITH4,6,Friuli-Venezia Giulia,Friuli Venezia Giulia,1215220,760915,62.62,0.07
2641,2021-04-12,FVG,7253,3181,4072,6122,1131,ITH,ITH4,6,Friuli-Venezia Giulia,Friuli Venezia Giulia,1215220,768168,63.21,0.6
2642,2021-01-23,PAT,577,334,243,388,189,ITH,ITH2,4,Provincia Autonoma Trento,P.A. Trento,541380,577,0.11,0.11
2643,2021-05-05,PAT,4972,2575,2397,4689,283,ITH,ITH2,4,Provincia Autonoma Trento,P.A. Trento,541380,5549,1.02,0.92
2644,2021-03-23,PAT,2444,943,1501,1704,740,ITH,ITH2,4,Provincia Autonoma Trento,P.A. Trento,541380,7993,1.48,0.45
2645,2021-04-01,PAT,2893,1227,1666,1800,1093,ITH,ITH2,4,Provincia Autonoma Trento,P.A. Trento,541380,10886,2.01,0.53
2646,2021-05-17,PAT,4292,2121,2171,3942,350,ITH,ITH2,4,Provincia Autonoma Trento,P.A. Trento,541380,15178,2.8,0.79
2647,2021-04-14,PAT,3115,1464,1651,2379,736,ITH,ITH2,4,Provincia Autonoma Trento,P.A. Trento,541380,18293,3.38,0.58
2648,2021-03-28,PAT,748,292,456,746,2,ITH,ITH2,4,Provincia Autonoma Trento,P.A. Trento,541380,19041,3.52,0.14
2649,2021-01-18,PAT,643,154,489,588,55,ITH,ITH2,4,Provincia Autonoma Trento,P.A. Trento,541380,19684,3.64,0.12
2650,2021-05-22,PAT,3239,1589,1650,919,2320,ITH,ITH2,4,Provincia Autonoma Trento,P.A. Trento,541380,22923,4.23,0.6
2651,2021-05-29,PAT,2219,1156,1063,815,1404,ITH,ITH2,4,Provincia Autonoma Trento,P.A. Trento,541380,25142,4.64,0.41
2652,2021-04-02,PAT,2801,1146,1655,2126,675,ITH,ITH2,4,Provincia Autonoma Trento,P.A. Trento,541380,27943,5.16,0.52
2653,2021-04-09,PAT,2707,1144,1563,1508,1199,ITH,ITH2,4,Provincia Autonoma Trento,P.A. Trento,541380,30650,5.66,0.5
2654,2021-02-11,PAT,1132,365,767,796,336,ITH,ITH2,4,Provincia Autonoma Trento,P.A. Trento,541380,31782,5.87,0.21
2655,2021-02-25,PAT,1641,643,998,1200,441,ITH,ITH2,4,Provincia Autonoma Trento,P.A. Trento,541380,33423,6.17,0.3
2656,2020-12-30,PAT,7,3,4,7,0,ITH,ITH2,4,Provincia Autonoma Trento,P.A. Trento,541380,33430,6.17,0.0
2657,2021-04-16,PAT,2837,1344,1493,2692,145,ITH,ITH2,4,Provincia Autonoma Trento,P.A. Trento,541380,36267,6.7,0.52
2658,2021-02-18,PAT,1205,426,779,1143,62,ITH,ITH2,4,Provincia Autonoma Trento,P.A. Trento,541380,37472,6.92,0.22
2659,2021-01-06,PAT,42,13,29,42,0,ITH,ITH2,4,Provincia Autonoma Trento,P.A. Trento,541380,37514,6.93,0.01
2660,2021-01-28,PAT,530,147,383,48,482,ITH,ITH2,4,Provincia Autonoma Trento,P.A. Trento,541380,38044,7.03,0.1
2661,2021-04-23,PAT,3600,1749,1851,3546,54,ITH,ITH2,4,Provincia Autonoma Trento,P.A. Trento,541380,41644,7.69,0.66
2662,2021-01-13,PAT,421,123,298,421,0,ITH,ITH2,4,Provincia Autonoma Trento,P.A. Trento,541380,42065,7.77,0.08
2663,2021-03-18,PAT,2319,957,1362,1239,1080,ITH,ITH2,4,Provincia Autonoma Trento,P.A. Trento,541380,44384,8.2,0.43
2664,2021-03-02,PAT,1304,440,864,928,376,ITH,ITH2,4,Provincia Autonoma Trento,P.A. Trento,541380,45688,8.44,0.24
2665,2021-02-13,PAT,537,333,204,172,365,ITH,ITH2,4,Provincia Autonoma Trento,P.A. Trento,541380,46225,8.54,0.1
2666,2021-05-26,PAT,3902,1837,2065,1219,2683,ITH,ITH2,4,Provincia Autonoma Trento,P.A. Trento,541380,50127,9.26,0.72
2667,2021-01-27,PAT,802,277,525,91,711,ITH,ITH2,4,Provincia Autonoma Trento,P.A. Trento,541380,50929,9.41,0.15
2668,2021-05-14,PAT,5302,2535,2767,3931,1371,ITH,ITH2,4,Provincia Autonoma Trento,P.A. Trento,541380,56231,10.39,0.98
2669,2021-05-31,PAT,4327,2010,2317,1506,2821,ITH,ITH2,4,Provincia Autonoma Trento,P.A. Trento,541380,60558,11.19,0.8
2670,2021-04-18,PAT,1855,845,1010,1846,9,ITH,ITH2,4,Provincia Autonoma Trento,P.A. Trento,541380,62413,11.53,0.34
2671,2021-03-06,PAT,783,277,506,632,151,ITH,ITH2,4,Provincia Autonoma Trento,P.A. Trento,541380,63196,11.67,0.14
2672,2021-01-01,PAT,213,50,163,213,0,ITH,ITH2,4,Provincia Autonoma Trento,P.A. Trento,541380,63409,11.71,0.04
2673,2021-03-26,PAT,3156,1226,1930,2557,599,ITH,ITH2,4,Provincia Autonoma Trento,P.A. Trento,541380,66565,12.3,0.58
2674,2021-02-04,PAT,975,304,671,421,554,ITH,ITH2,4,Provincia Autonoma Trento,P.A. Trento,541380,67540,12.48,0.18
2675,2021-04-30,PAT,4911,2397,2514,4766,145,ITH,ITH2,4,Provincia Autonoma Trento,P.A. Trento,541380,72451,13.38,0.91
2676,2021-03-11,PAT,2295,851,1444,1473,822,ITH,ITH2,4,Provincia Autonoma Trento,P.A. Trento,541380,74746,13.81,0.42
2677,2021-01-20,PAT,291,73,218,279,12,ITH,ITH2,4,Provincia Autonoma Trento,P.A. Trento,541380,75037,13.86,0.05
2678,2021-02-20,PAT,407,245,162,123,284,ITH,ITH2,4,Provincia Autonoma Trento,P.A. Trento,541380,75444,13.94,0.08
2679,2021-04-11,PAT,2340,1135,1205,2249,91,ITH,ITH2,4,Provincia Autonoma Trento,P.A. Trento,541380,77784,14.37,0.43
2680,2021-01-08,PAT,1449,313,1136,1449,0,ITH,ITH2,4,Provincia Autonoma Trento,P.A. Trento,541380,79233,14.64,0.27
2681,2021-02-27,PAT,1029,457,572,608,421,ITH,ITH2,4,Provincia Autonoma Trento,P.A. Trento,541380,80262,14.83,0.19
2682,2021-04-25,PAT,1970,939,1031,1963,7,ITH,ITH2,4,Provincia Autonoma Trento,P.A. Trento,541380,82232,15.19,0.36
2683,2021-05-03,PAT,4235,2179,2056,4082,153,ITH,ITH2,4,Provincia Autonoma Trento,P.A. Trento,541380,86467,15.97,0.78
2684,2021-01-16,PAT,319,148,171,319,0,ITH,ITH2,4,Provincia Autonoma Trento,P.A. Trento,541380,86786,16.03,0.06
2685,2021-04-28,PAT,4241,1972,2269,4103,138,ITH,ITH2,4,Provincia Autonoma Trento,P.A. Trento,541380,91027,16.81,0.78
2686,2021-01-25,PAT,817,215,602,23,794,ITH,ITH2,4,Provincia Autonoma Trento,P.A. Trento,541380,91844,16.96,0.15
2687,2021-03-30,PAT,2387,973,1414,1750,637,ITH,ITH2,4,Provincia Autonoma Trento,P.A. Trento,541380,94231,17.41,0.44
2688,2021-05-28,PAT,3407,1598,1809,1352,2055,ITH,ITH2,4,Provincia Autonoma Trento,P.A. Trento,541380,97638,18.04,0.63
2689,2021-03-25,PAT,2873,1103,1770,1824,1049,ITH,ITH2,4,Provincia Autonoma Trento,P.A. Trento,541380,100511,18.57,0.53
2690,2021-02-23,PAT,1108,395,713,897,211,ITH,ITH2,4,Provincia Autonoma Trento,P.A. Trento,541380,101619,18.77,0.2
2691,2021-02-06,PAT,574,298,276,433,141,ITH,ITH2,4,Provincia Autonoma Trento,P.A. Trento,541380,102193,18.88,0.11
2692,2021-01-04,PAT,870,227,643,870,0,ITH,ITH2,4,Provincia Autonoma Trento,P.A. Trento,541380,103063,19.04,0.16
2693,2021-05-02,PAT,3512,1955,1557,3475,37,ITH,ITH2,4,Provincia Autonoma Trento,P.A. Trento,541380,106575,19.69,0.65
2694,2021-03-13,PAT,830,380,450,782,48,ITH,ITH2,4,Provincia Autonoma Trento,P.A. Trento,541380,107405,19.84,0.15
2695,2021-05-19,PAT,5090,2452,2638,3840,1250,ITH,ITH2,4,Provincia Autonoma Trento,P.A. Trento,541380,112495,20.78,0.94
2696,2021-04-13,PAT,2553,1058,1495,2046,507,ITH,ITH2,4,Provincia Autonoma Trento,P.A. Trento,541380,115048,21.25,0.47
2697,2021-03-14,PAT,107,65,42,20,87,ITH,ITH2,4,Provincia Autonoma Trento,P.A. Trento,541380,115155,21.27,0.02
2698,2021-03-07,PAT,22,6,16,22,0,ITH,ITH2,4,Provincia Autonoma Trento,P.A. Trento,541380,115177,21.27,0.0
2699,2021-01-09,PAT,190,40,150,190,0,ITH,ITH2,4,Provincia Autonoma Trento,P.A. Trento,541380,115367,21.31,0.04
2700,2021-03-09,PAT,1581,589,992,938,643,ITH,ITH2,4,Provincia Autonoma Trento,P.A. Trento,541380,116948,21.6,0.29
2701,2021-05-12,PAT,3297,1491,1806,2114,1183,ITH,ITH2,4,Provincia Autonoma Trento,P.A. Trento,541380,120245,22.21,0.61
2702,2021-03-16,PAT,1391,506,885,608,783,ITH,ITH2,4,Provincia Autonoma Trento,P.A. Trento,541380,121636,22.47,0.26
2703,2021-02-01,PAT,1220,335,885,92,1128,ITH,ITH2,4,Provincia Autonoma Trento,P.A. Trento,541380,122856,22.69,0.23
2704,2021-02-08,PAT,1151,318,833,342,809,ITH,ITH2,4,Provincia Autonoma Trento,P.A. Trento,541380,124007,22.91,0.21
2705,2021-02-17,PAT,1110,425,685,1020,90,ITH,ITH2,4,Provincia Autonoma Trento,P.A. Trento,541380,125117,23.11,0.21
2706,2021-05-30,PAT,1769,871,898,927,842,ITH,ITH2,4,Provincia Autonoma Trento,P.A. Trento,541380,126886,23.44,0.33
2707,2021-02-26,PAT,1218,435,783,923,295,ITH,ITH2,4,Provincia Autonoma Trento,P.A. Trento,541380,128104,23.66,0.22
2708,2021-01-14,PAT,700,203,497,700,0,ITH,ITH2,4,Provincia Autonoma Trento,P.A. Trento,541380,128804,23.79,0.13
2709,2021-04-26,PAT,2648,1246,1402,2554,94,ITH,ITH2,4,Provincia Autonoma Trento,P.A. Trento,541380,131452,24.28,0.49
2710,2021-03-21,PAT,129,69,60,129,0,ITH,ITH2,4,Provincia Autonoma Trento,P.A. Trento,541380,131581,24.3,0.02
2711,2021-05-24,PAT,4377,2009,2368,1344,3033,ITH,ITH2,4,Provincia Autonoma Trento,P.A. Trento,541380,135958,25.11,0.81
2712,2021-03-04,PAT,2358,793,1565,1580,778,ITH,ITH2,4,Provincia Autonoma Trento,P.A. Trento,541380,138316,25.55,0.44
2713,2021-05-07,PAT,5986,3079,2907,5148,838,ITH,ITH2,4,Provincia Autonoma Trento,P.A. Trento,541380,144302,26.65,1.11
2714,2021-04-20,PAT,2876,1375,1501,2839,37,ITH,ITH2,4,Provincia Autonoma Trento,P.A. Trento,541380,147178,27.19,0.53
2715,2021-01-22,PAT,1668,433,1235,329,1339,ITH,ITH2,4,Provincia Autonoma Trento,P.A. Trento,541380,148846,27.49,0.31
2716,2021-03-27,PAT,1615,709,906,1362,253,ITH,ITH2,4,Provincia Autonoma Trento,P.A. Trento,541380,150461,27.79,0.3
2717,2021-02-05,PAT,802,272,530,283,519,ITH,ITH2,4,Provincia Autonoma Trento,P.A. Trento,541380,151263,27.94,0.15
2718,2021-01-05,PAT,709,232,477,709,0,ITH,ITH2,4,Provincia Autonoma Trento,P.A. Trento,541380,151972,28.07,0.13
2719,2021-01-19,PAT,405,77,328,405,0,ITH,ITH2,4,Provincia Autonoma Trento,P.A. Trento,541380,152377,28.15,0.07
2720,2021-03-10,PAT,2411,928,1483,1490,921,ITH,ITH2,4,Provincia Autonoma Trento,P.A. Trento,541380,154788,28.59,0.45
2721,2021-06-03,PAT,3956,1853,2103,1026,2930,ITH,ITH2,4,Provincia Autonoma Trento,P.A. Trento,541380,158744,29.32,0.73
2722,2021-03-20,PAT,873,402,471,670,203,ITH,ITH2,4,Provincia Autonoma Trento,P.A. Trento,541380,159617,29.48,0.16
2723,2021-02-12,PAT,1010,340,670,589,421,ITH,ITH2,4,Provincia Autonoma Trento,P.A. Trento,541380,160627,29.67,0.19
2724,2021-03-03,PAT,1656,622,1034,1139,517,ITH,ITH2,4,Provincia Autonoma Trento,P.A. Trento,541380,162283,29.98,0.31
2725,2021-05-08,PAT,3153,1721,1432,2734,419,ITH,ITH2,4,Provincia Autonoma Trento,P.A. Trento,541380,165436,30.56,0.58
2726,2021-05-09,PAT,2322,1210,1112,1978,344,ITH,ITH2,4,Provincia Autonoma Trento,P.A. Trento,541380,167758,30.99,0.43
2727,2021-01-10,PAT,84,19,65,84,0,ITH,ITH2,4,Provincia Autonoma Trento,P.A. Trento,541380,167842,31.0,0.02
2728,2021-04-22,PAT,3146,1468,1678,3102,44,ITH,ITH2,4,Provincia Autonoma Trento,P.A. Trento,541380,170988,31.58,0.58
2729,2021-04-05,PAT,35,17,18,33,2,ITH,ITH2,4,Provincia Autonoma Trento,P.A. Trento,541380,171023,31.59,0.01
2730,2021-05-21,PAT,5023,2410,2613,3325,1698,ITH,ITH2,4,Provincia Autonoma Trento,P.A. Trento,541380,176046,32.52,0.93
2731,2021-02-03,PAT,846,314,532,414,432,ITH,ITH2,4,Provincia Autonoma Trento,P.A. Trento,541380,176892,32.67,0.16
2732,2021-05-23,PAT,1953,993,960,447,1506,ITH,ITH2,4,Provincia Autonoma Trento,P.A. Trento,541380,178845,33.04,0.36
2733,2021-02-10,PAT,852,291,561,510,342,ITH,ITH2,4,Provincia Autonoma Trento,P.A. Trento,541380,179697,33.19,0.16
2734,2021-04-08,PAT,3114,1294,1820,1996,1118,ITH,ITH2,4,Provincia Autonoma Trento,P.A. Trento,541380,182811,33.77,0.58
2735,2021-04-10,PAT,2797,1307,1490,2003,794,ITH,ITH2,4,Provincia Autonoma Trento,P.A. Trento,541380,185608,34.28,0.52
2736,2020-12-31,PAT,1624,449,1175,1624,0,ITH,ITH2,4,Provincia Autonoma Trento,P.A. Trento,541380,187232,34.58,0.3
2737,2021-03-05,PAT,2244,703,1541,1678,566,ITH,ITH2,4,Provincia Autonoma Trento,P.A. Trento,541380,189476,35.0,0.41
2738,2021-04-17,PAT,2203,1120,1083,2146,57,ITH,ITH2,4,Provincia Autonoma Trento,P.A. Trento,541380,191679,35.41,0.41
2739,2021-01-15,PAT,595,132,463,595,0,ITH,ITH2,4,Provincia Autonoma Trento,P.A. Trento,541380,192274,35.52,0.11
2740,2021-03-24,PAT,2376,940,1436,1556,820,ITH,ITH2,4,Provincia Autonoma Trento,P.A. Trento,541380,194650,35.95,0.44
2741,2021-05-13,PAT,3406,1579,1827,2305,1101,ITH,ITH2,4,Provincia Autonoma Trento,P.A. Trento,541380,198056,36.58,0.63
2742,2021-01-26,PAT,542,154,388,27,515,ITH,ITH2,4,Provincia Autonoma Trento,P.A. Trento,541380,198598,36.68,0.1
2743,2021-02-09,PAT,916,287,629,442,474,ITH,ITH2,4,Provincia Autonoma Trento,P.A. Trento,541380,199514,36.85,0.17
2744,2021-05-01,PAT,4837,2463,2374,4802,35,ITH,ITH2,4,Provincia Autonoma Trento,P.A. Trento,541380,204351,37.75,0.89
2745,2021-03-12,PAT,2506,936,1570,1701,805,ITH,ITH2,4,Provincia Autonoma Trento,P.A. Trento,541380,206857,38.21,0.46
2746,2021-01-21,PAT,352,95,257,228,124,ITH,ITH2,4,Provincia Autonoma Trento,P.A. Trento,541380,207209,38.27,0.07
2747,2021-05-20,PAT,4998,2353,2645,3373,1625,ITH,ITH2,4,Provincia Autonoma Trento,P.A. Trento,541380,212207,39.2,0.92
2748,2021-03-17,PAT,2067,790,1277,1199,868,ITH,ITH2,4,Provincia Autonoma Trento,P.A. Trento,541380,214274,39.58,0.38
2749,2021-05-06,PAT,5505,2726,2779,4726,779,ITH,ITH2,4,Provincia Autonoma Trento,P.A. Trento,541380,219779,40.6,1.02
2750,2021-02-02,PAT,907,240,667,190,717,ITH,ITH2,4,Provincia Autonoma Trento,P.A. Trento,541380,220686,40.76,0.17
2751,2021-04-19,PAT,2622,1235,1387,2600,22,ITH,ITH2,4,Provincia Autonoma Trento,P.A. Trento,541380,223308,41.25,0.48
2752,2021-04-03,PAT,1138,471,667,971,167,ITH,ITH2,4,Provincia Autonoma Trento,P.A. Trento,541380,224446,41.46,0.21
2753,2021-04-24,PAT,3507,1682,1825,3494,13,ITH,ITH2,4,Provincia Autonoma Trento,P.A. Trento,541380,227953,42.11,0.65
2754,2021-02-19,PAT,928,358,570,869,59,ITH,ITH2,4,Provincia Autonoma Trento,P.A. Trento,541380,228881,42.28,0.17
2755,2021-02-28,PAT,242,121,121,242,0,ITH,ITH2,4,Provincia Autonoma Trento,P.A. Trento,541380,229123,42.32,0.04
2756,2021-05-16,PAT,1321,729,592,1083,238,ITH,ITH2,4,Provincia Autonoma Trento,P.A. Trento,541380,230444,42.57,0.24
2757,2021-04-15,PAT,3182,1437,1745,3028,154,ITH,ITH2,4,Provincia Autonoma Trento,P.A. Trento,541380,233626,43.15,0.59
2758,2021-04-29,PAT,4621,2232,2389,4412,209,ITH,ITH2,4,Provincia Autonoma Trento,P.A. Trento,541380,238247,44.01,0.85
2759,2021-02-24,PAT,1318,523,795,922,396,ITH,ITH2,4,Provincia Autonoma Trento,P.A. Trento,541380,239565,44.25,0.24
2760,2021-04-27,PAT,3880,1866,2014,3813,67,ITH,ITH2,4,Provincia Autonoma Trento,P.A. Trento,541380,243445,44.97,0.72
2761,2021-05-04,PAT,4475,2422,2053,4385,90,ITH,ITH2,4,Provincia Autonoma Trento,P.A. Trento,541380,247920,45.79,0.83
2762,2021-03-08,PAT,1398,433,965,1045,353,ITH,ITH2,4,Provincia Autonoma Trento,P.A. Trento,541380,249318,46.05,0.26
2763,2021-03-15,PAT,1410,545,865,946,464,ITH,ITH2,4,Provincia Autonoma Trento,P.A. Trento,541380,250728,46.31,0.26
2764,2021-01-17,PAT,251,195,56,251,0,ITH,ITH2,4,Provincia Autonoma Trento,P.A. Trento,541380,250979,46.36,0.05
2765,2021-05-11,PAT,3694,1749,1945,2849,845,ITH,ITH2,4,Provincia Autonoma Trento,P.A. Trento,541380,254673,47.04,0.68
2766,2021-03-22,PAT,2306,973,1333,1431,875,ITH,ITH2,4,Provincia Autonoma Trento,P.A. Trento,541380,256979,47.47,0.43
2767,2021-01-24,PAT,547,276,271,224,323,ITH,ITH2,4,Provincia Autonoma Trento,P.A. Trento,541380,257526,47.57,0.1
2768,2021-01-31,PAT,75,15,60,1,74,ITH,ITH2,4,Provincia Autonoma Trento,P.A. Trento,541380,257601,47.58,0.01
2769,2021-06-02,PAT,2533,1214,1319,769,1764,ITH,ITH2,4,Provincia Autonoma Trento,P.A. Trento,541380,260134,48.05,0.47
2770,2021-01-03,PAT,492,160,332,492,0,ITH,ITH2,4,Provincia Autonoma Trento,P.A. Trento,541380,260626,48.14,0.09
2771,2021-02-22,PAT,745,259,486,661,84,ITH,ITH2,4,Provincia Autonoma Trento,P.A. Trento,541380,261371,48.28,0.14
2772,2021-05-18,PAT,4245,2008,2237,3403,842,ITH,ITH2,4,Provincia Autonoma Trento,P.A. Trento,541380,265616,49.06,0.78
2773,2021-03-29,PAT,2461,958,1503,1726,735,ITH,ITH2,4,Provincia Autonoma Trento,P.A. Trento,541380,268077,49.52,0.45
2774,2021-04-12,PAT,3087,1408,1679,2591,496,ITH,ITH2,4,Provincia Autonoma Trento,P.A. Trento,541380,271164,50.09,0.57
2775,2021-06-01,PAT,3695,1740,1955,1076,2619,ITH,ITH2,4,Provincia Autonoma Trento,P.A. Trento,541380,274859,50.77,0.68
2776,2021-01-02,PAT,502,143,359,502,0,ITH,ITH2,4,Provincia Autonoma Trento,P.A. Trento,541380,275361,50.86,0.09
2777,2021-04-21,PAT,2893,1349,1544,2843,50,ITH,ITH2,4,Provincia Autonoma Trento,P.A. Trento,541380,278254,51.4,0.53
2778,2021-02-16,PAT,663,244,419,658,5,ITH,ITH2,4,Provincia Autonoma Trento,P.A. Trento,541380,278917,51.52,0.12
2779,2021-05-10,PAT,3205,1644,1561,2701,504,ITH,ITH2,4,Provincia Autonoma Trento,P.A. Trento,541380,282122,52.11,0.59
2780,2021-01-11,PAT,730,221,509,730,0,ITH,ITH2,4,Provincia Autonoma Trento,P.A. Trento,541380,282852,52.25,0.13
2781,2021-01-30,PAT,386,132,254,152,234,ITH,ITH2,4,Provincia Autonoma Trento,P.A. Trento,541380,283238,52.32,0.07
2782,2021-04-06,PAT,2258,949,1309,1493,765,ITH,ITH2,4,Provincia Autonoma Trento,P.A. Trento,541380,285496,52.73,0.42
2783,2021-02-15,PAT,533,187,346,419,114,ITH,ITH2,4,Provincia Autonoma Trento,P.A. Trento,541380,286029,52.83,0.1
2784,2021-01-29,PAT,1353,331,1022,55,1298,ITH,ITH2,4,Provincia Autonoma Trento,P.A. Trento,541380,287382,53.08,0.25
2785,2021-01-12,PAT,505,158,347,505,0,ITH,ITH2,4,Provincia Autonoma Trento,P.A. Trento,541380,287887,53.18,0.09
2786,2021-04-07,PAT,2599,1012,1587,1658,941,ITH,ITH2,4,Provincia Autonoma Trento,P.A. Trento,541380,290486,53.66,0.48
2787,2021-03-19,PAT,2423,915,1508,1571,852,ITH,ITH2,4,Provincia Autonoma Trento,P.A. Trento,541380,292909,54.1,0.45
2788,2021-01-07,PAT,1270,310,960,1270,0,ITH,ITH2,4,Provincia Autonoma Trento,P.A. Trento,541380,294179,54.34,0.23
2789,2021-03-31,PAT,2567,983,1584,1710,857,ITH,ITH2,4,Provincia Autonoma Trento,P.A. Trento,541380,296746,54.81,0.47
2790,2021-05-15,PAT,1567,815,752,679,888,ITH,ITH2,4,Provincia Autonoma Trento,P.A. Trento,541380,298313,55.1,0.29
2791,2021-03-01,PAT,1237,454,783,942,295,ITH,ITH2,4,Provincia Autonoma Trento,P.A. Trento,541380,299550,55.33,0.23
2792,2020-12-27,PAT,103,40,63,103,0,ITH,ITH2,4,Provincia Autonoma Trento,P.A. Trento,541380,299653,55.35,0.02
2793,2021-05-25,PAT,4747,2261,2486,1856,2891,ITH,ITH2,4,Provincia Autonoma Trento,P.A. Trento,541380,304400,56.23,0.88
2794,2021-02-14,PAT,246,186,60,11,235,ITH,ITH2,4,Provincia Autonoma Trento,P.A. Trento,541380,304646,56.27,0.05
2795,2021-05-27,PAT,4206,1969,2237,1232,2974,ITH,ITH2,4,Provincia Autonoma Trento,P.A. Trento,541380,308852,57.05,0.78
2796,2021-02-21,PAT,155,92,63,43,112,ITH,ITH2,4,Provincia Autonoma Trento,P.A. Trento,541380,309007,57.08,0.03
2797,2021-04-23,VEN,31151,13800,17351,22449,8702,ITH,ITH3,5,Veneto,Veneto,4905854,31151,0.63,0.63
2798,2021-02-18,VEN,5828,2455,3373,5764,64,ITH,ITH3,5,Veneto,Veneto,4905854,36979,0.75,0.12
2799,2021-04-18,VEN,17517,7255,10262,9945,7572,ITH,ITH3,5,Veneto,Veneto,4905854,54496,1.11,0.36
2800,2021-01-06,VEN,8132,2385,5747,8132,0,ITH,ITH3,5,Veneto,Veneto,4905854,62628,1.28,0.17
2801,2021-05-22,VEN,34670,16637,18033,13311,21359,ITH,ITH3,5,Veneto,Veneto,4905854,97298,1.98,0.71
2802,2021-01-28,VEN,9209,2662,6547,173,9036,ITH,ITH3,5,Veneto,Veneto,4905854,106507,2.17,0.19
2803,2021-04-02,VEN,23977,10550,13427,17646,6331,ITH,ITH3,5,Veneto,Veneto,4905854,130484,2.66,0.49
2804,2021-01-11,VEN,7238,2101,5137,7238,0,ITH,ITH3,5,Veneto,Veneto,4905854,137722,2.81,0.15
2805,2021-03-02,VEN,11483,4622,6861,8175,3308,ITH,ITH3,5,Veneto,Veneto,4905854,149205,3.04,0.23
2806,2021-05-26,VEN,30478,14849,15629,14310,16168,ITH,ITH3,5,Veneto,Veneto,4905854,179683,3.66,0.62
2807,2021-01-16,VEN,4611,1542,3069,4611,0,ITH,ITH3,5,Veneto,Veneto,4905854,184294,3.76,0.09
2808,2021-03-14,VEN,15167,5936,9231,14273,894,ITH,ITH3,5,Veneto,Veneto,4905854,199461,4.07,0.31
2809,2021-05-10,VEN,36380,17011,19369,26537,9843,ITH,ITH3,5,Veneto,Veneto,4905854,235841,4.81,0.74
2810,2021-03-07,VEN,4475,1756,2719,3914,561,ITH,ITH3,5,Veneto,Veneto,4905854,240316,4.9,0.09
2811,2021-05-03,VEN,40612,19774,20838,34183,6429,ITH,ITH3,5,Veneto,Veneto,4905854,280928,5.73,0.83
2812,2021-01-23,VEN,4050,1246,2804,31,4019,ITH,ITH3,5,Veneto,Veneto,4905854,284978,5.81,0.08
2813,2021-03-21,VEN,11984,4754,7230,8522,3462,ITH,ITH3,5,Veneto,Veneto,4905854,296962,6.05,0.24
2814,2021-01-30,VEN,8747,2672,6075,693,8054,ITH,ITH3,5,Veneto,Veneto,4905854,305709,6.23,0.18
2815,2021-05-17,VEN,26372,12941,13431,16433,9939,ITH,ITH3,5,Veneto,Veneto,4905854,332081,6.77,0.54
2816,2021-02-06,VEN,4095,1354,2741,709,3386,ITH,ITH3,5,Veneto,Veneto,4905854,336176,6.85,0.08
2817,2021-04-11,VEN,21002,8873,12129,14695,6307,ITH,ITH3,5,Veneto,Veneto,4905854,357178,7.28,0.43
2818,2021-01-01,VEN,1528,471,1057,1528,0,ITH,ITH3,5,Veneto,Veneto,4905854,358706,7.31,0.03
2819,2021-04-13,VEN,14019,6319,7700,8534,5485,ITH,ITH3,5,Veneto,Veneto,4905854,372725,7.6,0.29
2820,2021-01-03,VEN,5157,1562,3595,5157,0,ITH,ITH3,5,Veneto,Veneto,4905854,377882,7.7,0.11
2821,2021-04-14,VEN,15881,6883,8998,9255,6626,ITH,ITH3,5,Veneto,Veneto,4905854,393763,8.03,0.32
2822,2021-05-31,VEN,31173,15954,15219,21599,9574,ITH,ITH3,5,Veneto,Veneto,4905854,424936,8.66,0.64
2823,2021-03-28,VEN,31250,13586,17664,27614,3636,ITH,ITH3,5,Veneto,Veneto,4905854,456186,9.3,0.64
2824,2021-03-11,VEN,19701,8773,10928,14129,5572,ITH,ITH3,5,Veneto,Veneto,4905854,475887,9.7,0.4
2825,2021-05-14,VEN,46321,22035,24286,25656,20665,ITH,ITH3,5,Veneto,Veneto,4905854,522208,10.64,0.94
2826,2021-05-02,VEN,37220,17254,19966,26885,10335,ITH,ITH3,5,Veneto,Veneto,4905854,559428,11.4,0.76
2827,2021-03-06,VEN,10627,4316,6311,7365,3262,ITH,ITH3,5,Veneto,Veneto,4905854,570055,11.62,0.22
2828,2021-05-05,VEN,43975,21090,22885,37448,6527,ITH,ITH3,5,Veneto,Veneto,4905854,614030,12.52,0.9
2829,2021-03-16,VEN,12516,5347,7169,6902,5614,ITH,ITH3,5,Veneto,Veneto,4905854,626546,12.77,0.26
2830,2021-03-23,VEN,22148,10186,11962,17429,4719,ITH,ITH3,5,Veneto,Veneto,4905854,648694,13.22,0.45
2831,2021-05-19,VEN,32383,14855,17528,16648,15735,ITH,ITH3,5,Veneto,Veneto,4905854,681077,13.88,0.66
2832,2021-02-01,VEN,8557,2500,6057,161,8396,ITH,ITH3,5,Veneto,Veneto,4905854,689634,14.06,0.17
2833,2021-04-06,VEN,28870,13273,15597,23802,5068,ITH,ITH3,5,Veneto,Veneto,4905854,718504,14.65,0.59
2834,2021-01-09,VEN,7927,2539,5388,7927,0,ITH,ITH3,5,Veneto,Veneto,4905854,726431,14.81,0.16
2835,2021-04-04,VEN,7775,3531,4244,6624,1151,ITH,ITH3,5,Veneto,Veneto,4905854,734206,14.97,0.16
2836,2021-05-24,VEN,32650,16126,16524,7741,24909,ITH,ITH3,5,Veneto,Veneto,4905854,766856,15.63,0.67
2837,2021-02-13,VEN,3267,1474,1793,3247,20,ITH,ITH3,5,Veneto,Veneto,4905854,770123,15.7,0.07
2838,2021-05-12,VEN,36341,17582,18759,31266,5075,ITH,ITH3,5,Veneto,Veneto,4905854,806464,16.44,0.74
2839,2021-03-30,VEN,35886,15238,20648,30637,5249,ITH,ITH3,5,Veneto,Veneto,4905854,842350,17.17,0.73
2840,2021-02-08,VEN,4976,1541,3435,1929,3047,ITH,ITH3,5,Veneto,Veneto,4905854,847326,17.27,0.1
2841,2021-02-15,VEN,4386,1821,2565,4146,240,ITH,ITH3,5,Veneto,Veneto,4905854,851712,17.36,0.09
2842,2021-05-28,VEN,45173,22153,23020,24684,20489,ITH,ITH3,5,Veneto,Veneto,4905854,896885,18.28,0.92
2843,2021-05-21,VEN,44550,21909,22641,20856,23694,ITH,ITH3,5,Veneto,Veneto,4905854,941435,19.19,0.91
2844,2021-02-16,VEN,6639,2870,3769,6462,177,ITH,ITH3,5,Veneto,Veneto,4905854,948074,19.33,0.14
2845,2021-05-29,VEN,32269,16323,15946,25204,7065,ITH,ITH3,5,Veneto,Veneto,4905854,980343,19.98,0.66
2846,2021-04-16,VEN,24422,10482,13940,12539,11883,ITH,ITH3,5,Veneto,Veneto,4905854,1004765,20.48,0.5
2847,2021-01-13,VEN,5985,1606,4379,5985,0,ITH,ITH3,5,Veneto,Veneto,4905854,1010750,20.6,0.12
2848,2021-01-08,VEN,9404,2835,6569,9404,0,ITH,ITH3,5,Veneto,Veneto,4905854,1020154,20.79,0.19
2849,2021-04-25,VEN,18313,8148,10165,13480,4833,ITH,ITH3,5,Veneto,Veneto,4905854,1038467,21.17,0.37
2850,2021-04-21,VEN,32316,13175,19141,16250,16066,ITH,ITH3,5,Veneto,Veneto,4905854,1070783,21.83,0.66
2851,2021-02-11,VEN,4012,1238,2774,3384,628,ITH,ITH3,5,Veneto,Veneto,4905854,1074795,21.91,0.08
2852,2021-01-25,VEN,6468,2075,4393,159,6309,ITH,ITH3,5,Veneto,Veneto,4905854,1081263,22.04,0.13
2853,2021-04-20,VEN,22406,9487,12919,8405,14001,ITH,ITH3,5,Veneto,Veneto,4905854,1103669,22.5,0.46
2854,2021-05-07,VEN,48146,23084,25062,39514,8632,ITH,ITH3,5,Veneto,Veneto,4905854,1151815,23.48,0.98
2855,2021-03-18,VEN,12611,5137,7474,7385,5226,ITH,ITH3,5,Veneto,Veneto,4905854,1164426,23.74,0.26
2856,2021-01-27,VEN,7138,2062,5076,241,6897,ITH,ITH3,5,Veneto,Veneto,4905854,1171564,23.88,0.15
2857,2021-02-25,VEN,7899,3339,4560,7294,605,ITH,ITH3,5,Veneto,Veneto,4905854,1179463,24.04,0.16
2858,2021-04-09,VEN,31098,13693,17405,22761,8337,ITH,ITH3,5,Veneto,Veneto,4905854,1210561,24.68,0.63
2859,2020-12-30,VEN,699,245,454,699,0,ITH,ITH3,5,Veneto,Veneto,4905854,1211260,24.69,0.01
2860,2021-03-04,VEN,12921,4830,8091,9449,3472,ITH,ITH3,5,Veneto,Veneto,4905854,1224181,24.95,0.26
2861,2021-01-15,VEN,5874,1819,4055,5874,0,ITH,ITH3,5,Veneto,Veneto,4905854,1230055,25.07,0.12
2862,2021-03-15,VEN,16601,7266,9335,11384,5217,ITH,ITH3,5,Veneto,Veneto,4905854,1246656,25.41,0.34
2863,2021-05-18,VEN,26685,12424,14261,13236,13449,ITH,ITH3,5,Veneto,Veneto,4905854,1273341,25.96,0.54
2864,2021-03-24,VEN,22020,9504,12516,15212,6808,ITH,ITH3,5,Veneto,Veneto,4905854,1295361,26.4,0.45
2865,2021-02-09,VEN,5246,1889,3357,3446,1800,ITH,ITH3,5,Veneto,Veneto,4905854,1300607,26.51,0.11
2866,2021-03-26,VEN,29539,13117,16422,24072,5467,ITH,ITH3,5,Veneto,Veneto,4905854,1330146,27.11,0.6
2867,2021-03-09,VEN,16463,7381,9082,10144,6319,ITH,ITH3,5,Veneto,Veneto,4905854,1346609,27.45,0.34
2868,2021-01-04,VEN,6736,2033,4703,6736,0,ITH,ITH3,5,Veneto,Veneto,4905854,1353345,27.59,0.14
2869,2021-02-20,VEN,6424,2014,4410,6353,71,ITH,ITH3,5,Veneto,Veneto,4905854,1359769,27.72,0.13
2870,2021-06-02,VEN,20285,10229,10056,15948,4337,ITH,ITH3,5,Veneto,Veneto,4905854,1380054,28.13,0.41
2871,2021-05-09,VEN,34933,16059,18874,24872,10061,ITH,ITH3,5,Veneto,Veneto,4905854,1414987,28.84,0.71
2872,2021-03-20,VEN,12944,5340,7604,10849,2095,ITH,ITH3,5,Veneto,Veneto,4905854,1427931,29.11,0.26
2873,2021-01-10,VEN,5032,1671,3361,5032,0,ITH,ITH3,5,Veneto,Veneto,4905854,1432963,29.21,0.1
2874,2021-05-23,VEN,34455,16448,18007,11068,23387,ITH,ITH3,5,Veneto,Veneto,4905854,1467418,29.91,0.7
2875,2021-03-08,VEN,13549,6195,7354,9480,4069,ITH,ITH3,5,Veneto,Veneto,4905854,1480967,30.19,0.28
2876,2021-03-27,VEN,32048,13987,18061,26243,5805,ITH,ITH3,5,Veneto,Veneto,4905854,1513015,30.84,0.65
2877,2021-02-19,VEN,7322,3140,4182,7118,204,ITH,ITH3,5,Veneto,Veneto,4905854,1520337,30.99,0.15
2878,2021-06-01,VEN,26686,13392,13294,16371,10315,ITH,ITH3,5,Veneto,Veneto,4905854,1547023,31.53,0.54
2879,2021-02-21,VEN,4633,1209,3424,4628,5,ITH,ITH3,5,Veneto,Veneto,4905854,1551656,31.63,0.09
2880,2021-04-26,VEN,20708,9450,11258,15567,5141,ITH,ITH3,5,Veneto,Veneto,4905854,1572364,32.05,0.42
2881,2021-04-27,VEN,28111,12748,15363,21194,6917,ITH,ITH3,5,Veneto,Veneto,4905854,1600475,32.62,0.57
2882,2021-02-22,VEN,7013,3040,3973,6626,387,ITH,ITH3,5,Veneto,Veneto,4905854,1607488,32.77,0.14
2883,2021-02-05,VEN,8373,2535,5838,1415,6958,ITH,ITH3,5,Veneto,Veneto,4905854,1615861,32.94,0.17
2884,2021-01-19,VEN,1309,472,837,1159,150,ITH,ITH3,5,Veneto,Veneto,4905854,1617170,32.96,0.03
2885,2021-05-01,VEN,38777,18207,20570,29849,8928,ITH,ITH3,5,Veneto,Veneto,4905854,1655947,33.75,0.79
2886,2021-01-02,VEN,5743,1766,3977,5743,0,ITH,ITH3,5,Veneto,Veneto,4905854,1661690,33.87,0.12
2887,2021-02-27,VEN,8988,2691,6297,8141,847,ITH,ITH3,5,Veneto,Veneto,4905854,1670678,34.05,0.18
2888,2021-01-22,VEN,1080,332,748,25,1055,ITH,ITH3,5,Veneto,Veneto,4905854,1671758,34.08,0.02
2889,2021-05-04,VEN,42794,20269,22525,34786,8008,ITH,ITH3,5,Veneto,Veneto,4905854,1714552,34.95,0.87
2890,2021-05-11,VEN,32936,16417,16519,28246,4690,ITH,ITH3,5,Veneto,Veneto,4905854,1747488,35.62,0.67
2891,2021-01-24,VEN,4117,1219,2898,28,4089,ITH,ITH3,5,Veneto,Veneto,4905854,1751605,35.7,0.08
2892,2021-01-31,VEN,4769,1562,3207,392,4377,ITH,ITH3,5,Veneto,Veneto,4905854,1756374,35.8,0.1
2893,2021-03-29,VEN,31402,13634,17768,27568,3834,ITH,ITH3,5,Veneto,Veneto,4905854,1787776,36.44,0.64
2894,2021-04-10,VEN,27444,11971,15473,18963,8481,ITH,ITH3,5,Veneto,Veneto,4905854,1815220,37.0,0.56
2895,2021-05-30,VEN,22453,11228,11225,15817,6636,ITH,ITH3,5,Veneto,Veneto,4905854,1837673,37.46,0.46
2896,2021-02-26,VEN,8294,3271,5023,7036,1258,ITH,ITH3,5,Veneto,Veneto,4905854,1845967,37.63,0.17
2897,2021-01-14,VEN,7062,1924,5138,7062,0,ITH,ITH3,5,Veneto,Veneto,4905854,1853029,37.77,0.14
2898,2021-03-12,VEN,18572,8124,10448,11826,6746,ITH,ITH3,5,Veneto,Veneto,4905854,1871601,38.15,0.38
2899,2021-01-07,VEN,8358,2318,6040,8358,0,ITH,ITH3,5,Veneto,Veneto,4905854,1879959,38.32,0.17
2900,2021-05-25,VEN,27244,13094,14150,11483,15761,ITH,ITH3,5,Veneto,Veneto,4905854,1907203,38.88,0.56
2901,2021-04-05,VEN,19137,8367,10770,13697,5440,ITH,ITH3,5,Veneto,Veneto,4905854,1926340,39.27,0.39
2902,2021-02-14,VEN,125,56,69,112,13,ITH,ITH3,5,Veneto,Veneto,4905854,1926465,39.27,0.0
2903,2021-02-28,VEN,4136,1389,2747,3299,837,ITH,ITH3,5,Veneto,Veneto,4905854,1930601,39.35,0.08
2904,2020-12-27,VEN,880,395,485,880,0,ITH,ITH3,5,Veneto,Veneto,4905854,1931481,39.37,0.02
2905,2021-04-24,VEN,24731,10817,13914,15652,9079,ITH,ITH3,5,Veneto,Veneto,4905854,1956212,39.88,0.5
2906,2021-04-17,VEN,22404,9078,13326,15122,7282,ITH,ITH3,5,Veneto,Veneto,4905854,1978616,40.33,0.46
2907,2021-03-05,VEN,13286,4978,8308,9625,3661,ITH,ITH3,5,Veneto,Veneto,4905854,1991902,40.6,0.27
2908,2021-01-21,VEN,2293,719,1574,21,2272,ITH,ITH3,5,Veneto,Veneto,4905854,1994195,40.65,0.05
2909,2021-05-13,VEN,43973,21705,22268,34101,9872,ITH,ITH3,5,Veneto,Veneto,4905854,2038168,41.55,0.9
2910,2021-04-07,VEN,35894,16113,19781,28566,7328,ITH,ITH3,5,Veneto,Veneto,4905854,2074062,42.28,0.73
2911,2021-02-02,VEN,6508,1878,4630,396,6112,ITH,ITH3,5,Veneto,Veneto,4905854,2080570,42.41,0.13
2912,2021-03-31,VEN,38659,16261,22398,31165,7494,ITH,ITH3,5,Veneto,Veneto,4905854,2119229,43.2,0.79
2913,2021-03-13,VEN,17180,7259,9921,14047,3133,ITH,ITH3,5,Veneto,Veneto,4905854,2136409,43.55,0.35
2914,2021-03-22,VEN,18093,8134,9959,13050,5043,ITH,ITH3,5,Veneto,Veneto,4905854,2154502,43.92,0.37
2915,2021-05-20,VEN,44423,21093,23330,20246,24177,ITH,ITH3,5,Veneto,Veneto,4905854,2198925,44.82,0.91
2916,2021-02-07,VEN,2315,862,1453,714,1601,ITH,ITH3,5,Veneto,Veneto,4905854,2201240,44.87,0.05
2917,2021-03-01,VEN,9394,3716,5678,7572,1822,ITH,ITH3,5,Veneto,Veneto,4905854,2210634,45.06,0.19
2918,2021-01-29,VEN,9019,2788,6231,367,8652,ITH,ITH3,5,Veneto,Veneto,4905854,2219653,45.24,0.18
2919,2021-04-03,VEN,21943,9627,12316,14226,7717,ITH,ITH3,5,Veneto,Veneto,4905854,2241596,45.69,0.45
2920,2021-02-12,VEN,4314,1447,2867,3742,572,ITH,ITH3,5,Veneto,Veneto,4905854,2245910,45.78,0.09
2921,2021-05-08,VEN,41201,18636,22565,29410,11791,ITH,ITH3,5,Veneto,Veneto,4905854,2287111,46.62,0.84
2922,2021-02-17,VEN,6022,2772,3250,5928,94,ITH,ITH3,5,Veneto,Veneto,4905854,2293133,46.74,0.12
2923,2021-04-01,VEN,25199,11054,14145,18788,6411,ITH,ITH3,5,Veneto,Veneto,4905854,2318332,47.26,0.51
2924,2021-04-15,VEN,20829,8597,12232,10020,10809,ITH,ITH3,5,Veneto,Veneto,4905854,2339161,47.68,0.42
2925,2021-02-10,VEN,4751,1588,3163,3697,1054,ITH,ITH3,5,Veneto,Veneto,4905854,2343912,47.78,0.1
2926,2021-04-08,VEN,32320,14348,17972,24439,7881,ITH,ITH3,5,Veneto,Veneto,4905854,2376232,48.44,0.66
2927,2021-01-05,VEN,7329,2182,5147,7329,0,ITH,ITH3,5,Veneto,Veneto,4905854,2383561,48.59,0.15
2928,2021-02-24,VEN,8614,3678,4936,8128,486,ITH,ITH3,5,Veneto,Veneto,4905854,2392175,48.76,0.18
2929,2021-03-03,VEN,12044,4597,7447,8546,3498,ITH,ITH3,5,Veneto,Veneto,4905854,2404219,49.01,0.25
2930,2021-04-22,VEN,31927,13897,18030,16182,15745,ITH,ITH3,5,Veneto,Veneto,4905854,2436146,49.66,0.65
2931,2021-03-17,VEN,14643,5991,8652,7849,6794,ITH,ITH3,5,Veneto,Veneto,4905854,2450789,49.96,0.3
2932,2021-01-12,VEN,5230,1516,3714,5230,0,ITH,ITH3,5,Veneto,Veneto,4905854,2456019,50.06,0.11
2933,2021-05-06,VEN,46692,21912,24780,38252,8440,ITH,ITH3,5,Veneto,Veneto,4905854,2502711,51.01,0.95
2934,2021-05-27,VEN,45566,22381,23185,22940,22626,ITH,ITH3,5,Veneto,Veneto,4905854,2548277,51.94,0.93
2935,2021-03-19,VEN,13790,5668,8122,7697,6093,ITH,ITH3,5,Veneto,Veneto,4905854,2562067,52.22,0.28
2936,2021-02-23,VEN,7375,3250,4125,7105,270,ITH,ITH3,5,Veneto,Veneto,4905854,2569442,52.38,0.15
2937,2021-02-04,VEN,7387,2024,5363,553,6834,ITH,ITH3,5,Veneto,Veneto,4905854,2576829,52.53,0.15
2938,2021-04-28,VEN,32375,15159,17216,23352,9023,ITH,ITH3,5,Veneto,Veneto,4905854,2609204,53.19,0.66
2939,2021-01-18,VEN,2762,776,1986,2563,199,ITH,ITH3,5,Veneto,Veneto,4905854,2611966,53.24,0.06
2940,2021-04-30,VEN,49924,23442,26482,34274,15650,ITH,ITH3,5,Veneto,Veneto,4905854,2661890,54.26,1.02
2941,2021-01-20,VEN,1038,368,670,386,652,ITH,ITH3,5,Veneto,Veneto,4905854,2662928,54.28,0.02
2942,2021-03-25,VEN,25838,10951,14887,19718,6120,ITH,ITH3,5,Veneto,Veneto,4905854,2688766,54.81,0.53
2943,2021-02-03,VEN,5938,1664,4274,480,5458,ITH,ITH3,5,Veneto,Veneto,4905854,2694704,54.93,0.12
2944,2021-05-16,VEN,28399,14002,14397,21320,7079,ITH,ITH3,5,Veneto,Veneto,4905854,2723103,55.51,0.58
2945,2021-01-17,VEN,1933,781,1152,1584,349,ITH,ITH3,5,Veneto,Veneto,4905854,2725036,55.55,0.04
2946,2021-04-29,VEN,50208,23354,26854,37025,13183,ITH,ITH3,5,Veneto,Veneto,4905854,2775244,56.57,1.02
2947,2020-12-31,VEN,3220,1042,2178,3220,0,ITH,ITH3,5,Veneto,Veneto,4905854,2778464,56.64,0.07
2948,2021-04-12,VEN,14903,6335,8568,6684,8219,ITH,ITH3,5,Veneto,Veneto,4905854,2793367,56.94,0.3
2949,2021-04-19,VEN,21526,8916,12610,5117,16409,ITH,ITH3,5,Veneto,Veneto,4905854,2814893,57.38,0.44
2950,2021-03-10,VEN,18935,8637,10298,13254,5681,ITH,ITH3,5,Veneto,Veneto,4905854,2833828,57.76,0.39
2951,2021-06-03,VEN,52330,26827,25503,41286,11044,ITH,ITH3,5,Veneto,Veneto,4905854,2886158,58.83,1.07
2952,2021-05-15,VEN,36067,17442,18625,26141,9926,ITH,ITH3,5,Veneto,Veneto,4905854,2922225,59.57,0.74
2953,2021-01-26,VEN,6917,2091,4826,152,6765,ITH,ITH3,5,Veneto,Veneto,4905854,2929142,59.71,0.14
2954,2021-02-13,SAR,1456,565,891,1454,2,ITG,ITG2,20,Sardegna,Sardegna,1639591,1456,0.09,0.09
2955,2021-02-18,SAR,1878,732,1146,1814,64,ITG,ITG2,20,Sardegna,Sardegna,1639591,3334,0.2,0.11
2956,2021-05-31,SAR,11065,5190,5875,8230,2835,ITG,ITG2,20,Sardegna,Sardegna,1639591,14399,0.88,0.67
2957,2021-04-18,SAR,5127,2225,2902,2258,2869,ITG,ITG2,20,Sardegna,Sardegna,1639591,19526,1.19,0.31
2958,2021-05-10,SAR,9732,4336,5396,7195,2537,ITG,ITG2,20,Sardegna,Sardegna,1639591,29258,1.78,0.59
2959,2021-04-23,SAR,12845,5735,7110,7384,5461,ITG,ITG2,20,Sardegna,Sardegna,1639591,42103,2.57,0.78
2960,2021-03-02,SAR,2865,1459,1406,1712,1153,ITG,ITG2,20,Sardegna,Sardegna,1639591,44968,2.74,0.17
2961,2021-04-28,SAR,9015,4273,4742,5316,3699,ITG,ITG2,20,Sardegna,Sardegna,1639591,53983,3.29,0.55
2962,2021-04-21,SAR,12074,5557,6517,6541,5533,ITG,ITG2,20,Sardegna,Sardegna,1639591,66057,4.03,0.74
2963,2021-03-09,SAR,5153,2373,2780,4424,729,ITG,ITG2,20,Sardegna,Sardegna,1639591,71210,4.34,0.31
2964,2021-05-05,SAR,10148,4641,5507,8138,2010,ITG,ITG2,20,Sardegna,Sardegna,1639591,81358,4.96,0.62
2965,2021-01-18,SAR,904,326,578,780,124,ITG,ITG2,20,Sardegna,Sardegna,1639591,82262,5.02,0.06
2966,2021-03-16,SAR,4374,1949,2425,3452,922,ITG,ITG2,20,Sardegna,Sardegna,1639591,86636,5.28,0.27
2967,2021-01-11,SAR,1183,505,678,1183,0,ITG,ITG2,20,Sardegna,Sardegna,1639591,87819,5.36,0.07
2968,2021-01-25,SAR,588,212,376,22,566,ITG,ITG2,20,Sardegna,Sardegna,1639591,88407,5.39,0.04
2969,2021-02-23,SAR,1519,1010,509,1285,234,ITG,ITG2,20,Sardegna,Sardegna,1639591,89926,5.48,0.09
2970,2021-05-19,SAR,14853,7285,7568,11389,3464,ITG,ITG2,20,Sardegna,Sardegna,1639591,104779,6.39,0.91
2971,2021-02-08,SAR,1470,533,937,856,614,ITG,ITG2,20,Sardegna,Sardegna,1639591,106249,6.48,0.09
2972,2021-04-15,SAR,11821,5525,6296,6865,4956,ITG,ITG2,20,Sardegna,Sardegna,1639591,118070,7.2,0.72
2973,2021-01-23,SAR,60,22,38,0,60,ITG,ITG2,20,Sardegna,Sardegna,1639591,118130,7.2,0.0
2974,2021-03-28,SAR,4620,1815,2805,4541,79,ITG,ITG2,20,Sardegna,Sardegna,1639591,122750,7.49,0.28
2975,2021-03-11,SAR,6036,2726,3310,4835,1201,ITG,ITG2,20,Sardegna,Sardegna,1639591,128786,7.85,0.37
2976,2021-01-06,SAR,1615,549,1066,1615,0,ITG,ITG2,20,Sardegna,Sardegna,1639591,130401,7.95,0.1
2977,2021-02-22,SAR,1639,949,690,1411,228,ITG,ITG2,20,Sardegna,Sardegna,1639591,132040,8.05,0.1
2978,2021-05-14,SAR,13889,6375,7514,10705,3184,ITG,ITG2,20,Sardegna,Sardegna,1639591,145929,8.9,0.85
2979,2021-01-27,SAR,1411,496,915,79,1332,ITG,ITG2,20,Sardegna,Sardegna,1639591,147340,8.99,0.09
2980,2020-12-28,SAR,65,25,40,65,0,ITG,ITG2,20,Sardegna,Sardegna,1639591,147405,8.99,0.0
2981,2021-03-23,SAR,6157,2640,3517,5079,1078,ITG,ITG2,20,Sardegna,Sardegna,1639591,153562,9.37,0.38
2982,2021-05-12,SAR,10775,5033,5742,7696,3079,ITG,ITG2,20,Sardegna,Sardegna,1639591,164337,10.02,0.66
2983,2021-04-06,SAR,7446,3113,4333,5018,2428,ITG,ITG2,20,Sardegna,Sardegna,1639591,171783,10.48,0.45
2984,2021-02-01,SAR,1524,605,919,225,1299,ITG,ITG2,20,Sardegna,Sardegna,1639591,173307,10.57,0.09
2985,2021-05-26,SAR,14287,7096,7191,9809,4478,ITG,ITG2,20,Sardegna,Sardegna,1639591,187594,11.44,0.87
2986,2020-12-27,SAR,65,34,31,65,0,ITG,ITG2,20,Sardegna,Sardegna,1639591,187659,11.45,0.0
2987,2021-02-15,SAR,958,349,609,927,31,ITG,ITG2,20,Sardegna,Sardegna,1639591,188617,11.5,0.06
2988,2021-01-16,SAR,1492,525,967,1492,0,ITG,ITG2,20,Sardegna,Sardegna,1639591,190109,11.59,0.09
2989,2021-05-07,SAR,14126,6457,7669,9626,4500,ITG,ITG2,20,Sardegna,Sardegna,1639591,204235,12.46,0.86
2990,2021-03-18,SAR,7255,3070,4185,5652,1603,ITG,ITG2,20,Sardegna,Sardegna,1639591,211490,12.9,0.44
2991,2021-03-25,SAR,8795,3704,5091,7490,1305,ITG,ITG2,20,Sardegna,Sardegna,1639591,220285,13.44,0.54
2992,2021-05-21,SAR,20560,10037,10523,15065,5495,ITG,ITG2,20,Sardegna,Sardegna,1639591,240845,14.69,1.25
2993,2021-02-03,SAR,1119,419,700,426,693,ITG,ITG2,20,Sardegna,Sardegna,1639591,241964,14.76,0.07
2994,2021-05-16,SAR,8177,3812,4365,6017,2160,ITG,ITG2,20,Sardegna,Sardegna,1639591,250141,15.26,0.5
2995,2021-02-11,SAR,1315,490,825,1204,111,ITG,ITG2,20,Sardegna,Sardegna,1639591,251456,15.34,0.08
2996,2021-05-29,SAR,17702,8501,9201,13296,4406,ITG,ITG2,20,Sardegna,Sardegna,1639591,269158,16.42,1.08
2997,2021-05-24,SAR,13596,6511,7085,8433,5163,ITG,ITG2,20,Sardegna,Sardegna,1639591,282754,17.25,0.83
2998,2021-06-02,SAR,5908,2810,3098,5166,742,ITG,ITG2,20,Sardegna,Sardegna,1639591,288662,17.61,0.36
2999,2021-02-20,SAR,2041,855,1186,1707,334,ITG,ITG2,20,Sardegna,Sardegna,1639591,290703,17.73,0.12
3000,2021-01-08,SAR,3258,1184,2074,3258,0,ITG,ITG2,20,Sardegna,Sardegna,1639591,293961,17.93,0.2
3001,2021-04-20,SAR,10992,4992,6000,7778,3214,ITG,ITG2,20,Sardegna,Sardegna,1639591,304953,18.6,0.67
3002,2021-03-21,SAR,4030,1809,2221,2590,1440,ITG,ITG2,20,Sardegna,Sardegna,1639591,308983,18.85,0.25
3003,2021-01-30,SAR,3863,1392,2471,362,3501,ITG,ITG2,20,Sardegna,Sardegna,1639591,312846,19.08,0.24
3004,2021-03-04,SAR,4002,1953,2049,2747,1255,ITG,ITG2,20,Sardegna,Sardegna,1639591,316848,19.32,0.24
3005,2021-01-13,SAR,573,178,395,573,0,ITG,ITG2,20,Sardegna,Sardegna,1639591,317421,19.36,0.03
3006,2021-05-28,SAR,17308,8259,9049,13438,3870,ITG,ITG2,20,Sardegna,Sardegna,1639591,334729,20.42,1.06
3007,2021-04-25,SAR,4497,2269,2228,3718,779,ITG,ITG2,20,Sardegna,Sardegna,1639591,339226,20.69,0.27
3008,2021-03-06,SAR,2639,1079,1560,858,1781,ITG,ITG2,20,Sardegna,Sardegna,1639591,341865,20.85,0.16
3009,2021-01-15,SAR,1563,573,990,1563,0,ITG,ITG2,20,Sardegna,Sardegna,1639591,343428,20.95,0.1
3010,2021-05-09,SAR,6127,2874,3253,5201,926,ITG,ITG2,20,Sardegna,Sardegna,1639591,349555,21.32,0.37
3011,2021-04-09,SAR,12261,5436,6825,7909,4352,ITG,ITG2,20,Sardegna,Sardegna,1639591,361816,22.07,0.75
3012,2021-02-04,SAR,2271,816,1455,916,1355,ITG,ITG2,20,Sardegna,Sardegna,1639591,364087,22.21,0.14
3013,2021-04-02,SAR,8987,3547,5440,5745,3242,ITG,ITG2,20,Sardegna,Sardegna,1639591,373074,22.75,0.55
3014,2021-04-11,SAR,5393,2442,2951,4273,1120,ITG,ITG2,20,Sardegna,Sardegna,1639591,378467,23.08,0.33
3015,2021-04-04,SAR,1,0,1,0,1,ITG,ITG2,20,Sardegna,Sardegna,1639591,378468,23.08,0.0
3016,2021-01-01,SAR,32,17,15,32,0,ITG,ITG2,20,Sardegna,Sardegna,1639591,378500,23.09,0.0
3017,2021-02-27,SAR,1921,647,1274,1366,555,ITG,ITG2,20,Sardegna,Sardegna,1639591,380421,23.2,0.12
3018,2021-01-10,SAR,2183,750,1433,2183,0,ITG,ITG2,20,Sardegna,Sardegna,1639591,382604,23.34,0.13
3019,2021-04-27,SAR,7606,3547,4059,5565,2041,ITG,ITG2,20,Sardegna,Sardegna,1639591,390210,23.8,0.46
3020,2021-03-15,SAR,2688,1219,1469,2315,373,ITG,ITG2,20,Sardegna,Sardegna,1639591,392898,23.96,0.16
3021,2021-01-19,SAR,747,270,477,692,55,ITG,ITG2,20,Sardegna,Sardegna,1639591,393645,24.01,0.05
3022,2021-03-24,SAR,7287,2998,4289,5928,1359,ITG,ITG2,20,Sardegna,Sardegna,1639591,400932,24.45,0.44
3023,2021-05-22,SAR,24298,11625,12673,19367,4931,ITG,ITG2,20,Sardegna,Sardegna,1639591,425230,25.94,1.48
3024,2021-01-04,SAR,592,217,375,592,0,ITG,ITG2,20,Sardegna,Sardegna,1639591,425822,25.97,0.04
3025,2021-04-16,SAR,14441,6488,7953,9098,5343,ITG,ITG2,20,Sardegna,Sardegna,1639591,440263,26.85,0.88
3026,2021-03-30,SAR,8642,3462,5180,6368,2274,ITG,ITG2,20,Sardegna,Sardegna,1639591,448905,27.38,0.53
3027,2021-03-13,SAR,2755,1076,1679,2474,281,ITG,ITG2,20,Sardegna,Sardegna,1639591,451660,27.55,0.17
3028,2021-02-17,SAR,1407,577,830,1333,74,ITG,ITG2,20,Sardegna,Sardegna,1639591,453067,27.63,0.09
3029,2020-12-29,SAR,57,32,25,57,0,ITG,ITG2,20,Sardegna,Sardegna,1639591,453124,27.64,0.0
3030,2021-04-22,SAR,10489,4646,5843,5570,4919,ITG,ITG2,20,Sardegna,Sardegna,1639591,463613,28.28,0.64
3031,2021-03-03,SAR,3859,2073,1786,2611,1248,ITG,ITG2,20,Sardegna,Sardegna,1639591,467472,28.51,0.24
3032,2021-01-31,SAR,2121,750,1371,48,2073,ITG,ITG2,20,Sardegna,Sardegna,1639591,469593,28.64,0.13
3033,2021-02-14,SAR,539,263,276,537,2,ITG,ITG2,20,Sardegna,Sardegna,1639591,470132,28.67,0.03
3034,2021-04-05,SAR,2036,784,1252,2035,1,ITG,ITG2,20,Sardegna,Sardegna,1639591,472168,28.8,0.12
3035,2021-01-03,SAR,90,36,54,90,0,ITG,ITG2,20,Sardegna,Sardegna,1639591,472258,28.8,0.01
3036,2021-03-29,SAR,4425,1559,2866,3837,588,ITG,ITG2,20,Sardegna,Sardegna,1639591,476683,29.07,0.27
3037,2021-01-05,SAR,1327,446,881,1327,0,ITG,ITG2,20,Sardegna,Sardegna,1639591,478010,29.15,0.08
3038,2021-03-31,SAR,10154,4050,6104,7707,2447,ITG,ITG2,20,Sardegna,Sardegna,1639591,488164,29.77,0.62
3039,2021-05-18,SAR,13752,6640,7112,9291,4461,ITG,ITG2,20,Sardegna,Sardegna,1639591,501916,30.61,0.84
3040,2021-05-01,SAR,9902,4759,5143,5445,4457,ITG,ITG2,20,Sardegna,Sardegna,1639591,511818,31.22,0.6
3041,2021-02-26,SAR,2800,1108,1692,2494,306,ITG,ITG2,20,Sardegna,Sardegna,1639591,514618,31.39,0.17
3042,2021-04-14,SAR,8250,3902,4348,7013,1237,ITG,ITG2,20,Sardegna,Sardegna,1639591,522868,31.89,0.5
3043,2021-04-13,SAR,7606,3593,4013,5781,1825,ITG,ITG2,20,Sardegna,Sardegna,1639591,530474,32.35,0.46
3044,2021-03-08,SAR,4008,1790,2218,2788,1220,ITG,ITG2,20,Sardegna,Sardegna,1639591,534482,32.6,0.24
3045,2021-05-04,SAR,9537,4385,5152,7684,1853,ITG,ITG2,20,Sardegna,Sardegna,1639591,544019,33.18,0.58
3046,2021-03-01,SAR,2162,1055,1107,1503,659,ITG,ITG2,20,Sardegna,Sardegna,1639591,546181,33.31,0.13
3047,2021-01-24,SAR,90,34,56,5,85,ITG,ITG2,20,Sardegna,Sardegna,1639591,546271,33.32,0.01
3048,2021-03-10,SAR,6012,2919,3093,5162,850,ITG,ITG2,20,Sardegna,Sardegna,1639591,552283,33.68,0.37
3049,2021-05-06,SAR,12943,6008,6935,9798,3145,ITG,ITG2,20,Sardegna,Sardegna,1639591,565226,34.47,0.79
3050,2021-05-13,SAR,11408,5284,6124,8428,2980,ITG,ITG2,20,Sardegna,Sardegna,1639591,576634,35.17,0.7
3051,2021-01-26,SAR,1336,453,883,27,1309,ITG,ITG2,20,Sardegna,Sardegna,1639591,577970,35.25,0.08
3052,2021-04-01,SAR,10101,4026,6075,7088,3013,ITG,ITG2,20,Sardegna,Sardegna,1639591,588071,35.87,0.62
3053,2021-02-10,SAR,1959,765,1194,1441,518,ITG,ITG2,20,Sardegna,Sardegna,1639591,590030,35.99,0.12
3054,2021-04-19,SAR,10181,4617,5564,8762,1419,ITG,ITG2,20,Sardegna,Sardegna,1639591,600211,36.61,0.62
3055,2021-01-02,SAR,60,21,39,60,0,ITG,ITG2,20,Sardegna,Sardegna,1639591,600271,36.61,0.0
3056,2021-04-26,SAR,6820,3263,3557,5945,875,ITG,ITG2,20,Sardegna,Sardegna,1639591,607091,37.03,0.42
3057,2021-02-21,SAR,1589,710,879,1559,30,ITG,ITG2,20,Sardegna,Sardegna,1639591,608680,37.12,0.1
3058,2021-05-27,SAR,16258,8185,8073,11548,4710,ITG,ITG2,20,Sardegna,Sardegna,1639591,624938,38.12,0.99
3059,2021-02-16,SAR,700,289,411,673,27,ITG,ITG2,20,Sardegna,Sardegna,1639591,625638,38.16,0.04
3060,2021-04-12,SAR,6990,3179,3811,5276,1714,ITG,ITG2,20,Sardegna,Sardegna,1639591,632628,38.58,0.43
3061,2021-06-01,SAR,13661,6341,7320,9507,4154,ITG,ITG2,20,Sardegna,Sardegna,1639591,646289,39.42,0.83
3062,2021-02-28,SAR,368,169,199,142,226,ITG,ITG2,20,Sardegna,Sardegna,1639591,646657,39.44,0.02
3063,2021-05-08,SAR,13075,5960,7115,10788,2287,ITG,ITG2,20,Sardegna,Sardegna,1639591,659732,40.24,0.8
3064,2021-05-15,SAR,13758,6417,7341,10325,3433,ITG,ITG2,20,Sardegna,Sardegna,1639591,673490,41.08,0.84
3065,2021-01-17,SAR,860,277,583,859,1,ITG,ITG2,20,Sardegna,Sardegna,1639591,674350,41.13,0.05
3066,2021-04-29,SAR,11112,5108,6004,6759,4353,ITG,ITG2,20,Sardegna,Sardegna,1639591,685462,41.81,0.68
3067,2021-03-17,SAR,6556,2849,3707,4949,1607,ITG,ITG2,20,Sardegna,Sardegna,1639591,692018,42.21,0.4
3068,2021-03-26,SAR,8091,3180,4911,6566,1525,ITG,ITG2,20,Sardegna,Sardegna,1639591,700109,42.7,0.49
3069,2021-04-08,SAR,13426,5924,7502,8307,5119,ITG,ITG2,20,Sardegna,Sardegna,1639591,713535,43.52,0.82
3070,2021-05-11,SAR,8648,3989,4659,6317,2331,ITG,ITG2,20,Sardegna,Sardegna,1639591,722183,44.05,0.53
3071,2021-05-25,SAR,13676,6680,6996,8344,5332,ITG,ITG2,20,Sardegna,Sardegna,1639591,735859,44.88,0.83
3072,2021-03-22,SAR,3551,1363,2188,3038,513,ITG,ITG2,20,Sardegna,Sardegna,1639591,739410,45.1,0.22
3073,2021-01-12,SAR,865,408,457,865,0,ITG,ITG2,20,Sardegna,Sardegna,1639591,740275,45.15,0.05
3074,2021-02-05,SAR,1897,749,1148,433,1464,ITG,ITG2,20,Sardegna,Sardegna,1639591,742172,45.27,0.12
3075,2021-04-03,SAR,4663,1802,2861,2696,1967,ITG,ITG2,20,Sardegna,Sardegna,1639591,746835,45.55,0.28
3076,2021-05-30,SAR,9725,4836,4889,7369,2356,ITG,ITG2,20,Sardegna,Sardegna,1639591,756560,46.14,0.59
3077,2021-03-27,SAR,5719,2177,3542,5296,423,ITG,ITG2,20,Sardegna,Sardegna,1639591,762279,46.49,0.35
3078,2021-05-23,SAR,9964,4805,5159,7720,2244,ITG,ITG2,20,Sardegna,Sardegna,1639591,772243,47.1,0.61
3079,2021-02-19,SAR,1499,473,1026,1443,56,ITG,ITG2,20,Sardegna,Sardegna,1639591,773742,47.19,0.09
3080,2021-02-12,SAR,2237,933,1304,2178,59,ITG,ITG2,20,Sardegna,Sardegna,1639591,775979,47.33,0.14
3081,2021-04-10,SAR,10489,4748,5741,8554,1935,ITG,ITG2,20,Sardegna,Sardegna,1639591,786468,47.97,0.64
3082,2021-01-07,SAR,3112,1077,2035,3112,0,ITG,ITG2,20,Sardegna,Sardegna,1639591,789580,48.16,0.19
3083,2020-12-31,SAR,32,16,16,32,0,ITG,ITG2,20,Sardegna,Sardegna,1639591,789612,48.16,0.0
3084,2021-03-20,SAR,5194,2074,3120,2917,2277,ITG,ITG2,20,Sardegna,Sardegna,1639591,794806,48.48,0.32
3085,2021-01-29,SAR,2955,1069,1886,48,2907,ITG,ITG2,20,Sardegna,Sardegna,1639591,797761,48.66,0.18
3086,2021-03-05,SAR,5036,2445,2591,2682,2354,ITG,ITG2,20,Sardegna,Sardegna,1639591,802797,48.96,0.31
3087,2021-04-24,SAR,10366,4851,5515,8028,2338,ITG,ITG2,20,Sardegna,Sardegna,1639591,813163,49.6,0.63
3088,2021-01-28,SAR,2970,1045,1925,69,2901,ITG,ITG2,20,Sardegna,Sardegna,1639591,816133,49.78,0.18
3089,2021-03-14,SAR,607,376,231,607,0,ITG,ITG2,20,Sardegna,Sardegna,1639591,816740,49.81,0.04
3090,2021-05-17,SAR,12114,5688,6426,9224,2890,ITG,ITG2,20,Sardegna,Sardegna,1639591,828854,50.55,0.74
3091,2021-02-25,SAR,2899,1255,1644,2294,605,ITG,ITG2,20,Sardegna,Sardegna,1639591,831753,50.73,0.18
3092,2021-04-30,SAR,11128,5297,5831,6919,4209,ITG,ITG2,20,Sardegna,Sardegna,1639591,842881,51.41,0.68
3093,2021-02-06,SAR,1970,697,1273,569,1401,ITG,ITG2,20,Sardegna,Sardegna,1639591,844851,51.53,0.12
3094,2021-01-20,SAR,210,77,133,208,2,ITG,ITG2,20,Sardegna,Sardegna,1639591,845061,51.54,0.01
3095,2021-05-02,SAR,5884,2669,3215,5303,581,ITG,ITG2,20,Sardegna,Sardegna,1639591,850945,51.9,0.36
3096,2021-02-24,SAR,2412,1293,1119,2223,189,ITG,ITG2,20,Sardegna,Sardegna,1639591,853357,52.05,0.15
3097,2021-02-07,SAR,1117,395,722,228,889,ITG,ITG2,20,Sardegna,Sardegna,1639591,854474,52.12,0.07
3098,2021-05-20,SAR,15854,7500,8354,11305,4549,ITG,ITG2,20,Sardegna,Sardegna,1639591,870328,53.08,0.97
3099,2021-01-21,SAR,126,60,66,94,32,ITG,ITG2,20,Sardegna,Sardegna,1639591,870454,53.09,0.01
3100,2021-06-03,SAR,15495,7103,8392,10283,5212,ITG,ITG2,20,Sardegna,Sardegna,1639591,885949,54.03,0.95
3101,2021-02-09,SAR,2287,837,1450,1290,997,ITG,ITG2,20,Sardegna,Sardegna,1639591,888236,54.17,0.14
3102,2021-02-02,SAR,1482,655,827,241,1241,ITG,ITG2,20,Sardegna,Sardegna,1639591,889718,54.26,0.09
3103,2021-03-07,SAR,1657,750,907,1117,540,ITG,ITG2,20,Sardegna,Sardegna,1639591,891375,54.37,0.1
3104,2021-04-07,SAR,13478,5986,7492,7830,5648,ITG,ITG2,20,Sardegna,Sardegna,1639591,904853,55.19,0.82
3105,2021-01-09,SAR,4026,1417,2609,4026,0,ITG,ITG2,20,Sardegna,Sardegna,1639591,908879,55.43,0.25
3106,2021-01-22,SAR,83,47,36,55,28,ITG,ITG2,20,Sardegna,Sardegna,1639591,908962,55.44,0.01
3107,2021-04-17,SAR,10079,4500,5579,5482,4597,ITG,ITG2,20,Sardegna,Sardegna,1639591,919041,56.05,0.61
3108,2021-05-03,SAR,8180,3817,4363,6584,1596,ITG,ITG2,20,Sardegna,Sardegna,1639591,927221,56.55,0.5
3109,2021-03-12,SAR,6699,2796,3903,5342,1357,ITG,ITG2,20,Sardegna,Sardegna,1639591,933920,56.96,0.41
3110,2021-03-19,SAR,7269,3049,4220,5054,2215,ITG,ITG2,20,Sardegna,Sardegna,1639591,941189,57.4,0.44
3111,2021-01-14,SAR,1105,426,679,1105,0,ITG,ITG2,20,Sardegna,Sardegna,1639591,942294,57.47,0.07
3112,2021-02-25,CAL,2875,1548,1327,2281,594,ITF,ITF6,18,Calabria,Calabria,1947131,2875,0.15,0.15
3113,2021-05-04,CAL,16321,7519,8802,11695,4626,ITF,ITF6,18,Calabria,Calabria,1947131,19196,0.99,0.84
3114,2021-01-22,CAL,658,274,384,656,2,ITF,ITF6,18,Calabria,Calabria,1947131,19854,1.02,0.03
3115,2021-03-06,CAL,8418,4335,4083,7626,792,ITF,ITF6,18,Calabria,Calabria,1947131,28272,1.45,0.43
3116,2021-05-09,CAL,9666,4498,5168,6137,3529,ITF,ITF6,18,Calabria,Calabria,1947131,37938,1.95,0.5
3117,2021-04-18,CAL,5837,2788,3049,4930,907,ITF,ITF6,18,Calabria,Calabria,1947131,43775,2.25,0.3
3118,2021-02-13,CAL,1396,603,793,1031,365,ITF,ITF6,18,Calabria,Calabria,1947131,45171,2.32,0.07
3119,2021-04-04,CAL,1762,886,876,1262,500,ITF,ITF6,18,Calabria,Calabria,1947131,46933,2.41,0.09
3120,2021-03-18,CAL,4399,2054,2345,2345,2054,ITF,ITF6,18,Calabria,Calabria,1947131,51332,2.64,0.23
3121,2021-01-27,CAL,1457,733,724,396,1061,ITF,ITF6,18,Calabria,Calabria,1947131,52789,2.71,0.07
3122,2021-02-20,CAL,1418,760,658,1100,318,ITF,ITF6,18,Calabria,Calabria,1947131,54207,2.78,0.07
3123,2021-03-11,CAL,7254,3417,3837,5992,1262,ITF,ITF6,18,Calabria,Calabria,1947131,61461,3.16,0.37
3124,2021-05-31,CAL,15105,7203,7902,7268,7837,ITF,ITF6,18,Calabria,Calabria,1947131,76566,3.93,0.78
3125,2021-05-16,CAL,13772,6725,7047,9958,3814,ITF,ITF6,18,Calabria,Calabria,1947131,90338,4.64,0.71
3126,2021-05-14,CAL,19942,9588,10354,13072,6870,ITF,ITF6,18,Calabria,Calabria,1947131,110280,5.66,1.02
3127,2021-02-03,CAL,2765,1429,1336,580,2185,ITF,ITF6,18,Calabria,Calabria,1947131,113045,5.81,0.14
3128,2021-04-30,CAL,14916,7319,7597,10597,4319,ITF,ITF6,18,Calabria,Calabria,1947131,127961,6.57,0.77
3129,2021-01-18,CAL,1265,570,695,1044,221,ITF,ITF6,18,Calabria,Calabria,1947131,129226,6.64,0.06
3130,2021-03-27,CAL,8570,3882,4688,4588,3982,ITF,ITF6,18,Calabria,Calabria,1947131,137796,7.08,0.44
3131,2021-04-13,CAL,6777,3268,3509,5467,1310,ITF,ITF6,18,Calabria,Calabria,1947131,144573,7.42,0.35
3132,2021-01-06,CAL,930,502,428,930,0,ITF,ITF6,18,Calabria,Calabria,1947131,145503,7.47,0.05
3133,2021-01-13,CAL,2033,1023,1010,2033,0,ITF,ITF6,18,Calabria,Calabria,1947131,147536,7.58,0.1
3134,2021-04-16,CAL,10297,5008,5289,8645,1652,ITF,ITF6,18,Calabria,Calabria,1947131,157833,8.11,0.53
3135,2021-02-18,CAL,1822,825,997,1596,226,ITF,ITF6,18,Calabria,Calabria,1947131,159655,8.2,0.09
3136,2021-04-23,CAL,12900,6337,6563,9442,3458,ITF,ITF6,18,Calabria,Calabria,1947131,172555,8.86,0.66
3137,2021-01-15,CAL,2795,1258,1537,2795,0,ITF,ITF6,18,Calabria,Calabria,1947131,175350,9.01,0.14
3138,2021-03-20,CAL,6695,3069,3626,4195,2500,ITF,ITF6,18,Calabria,Calabria,1947131,182045,9.35,0.34
3139,2021-03-13,CAL,6843,2989,3854,5874,969,ITF,ITF6,18,Calabria,Calabria,1947131,188888,9.7,0.35
3140,2021-01-23,CAL,400,186,214,358,42,ITF,ITF6,18,Calabria,Calabria,1947131,189288,9.72,0.02
3141,2021-03-28,CAL,2592,1198,1394,1505,1087,ITF,ITF6,18,Calabria,Calabria,1947131,191880,9.85,0.13
3142,2021-01-30,CAL,2180,1149,1031,358,1822,ITF,ITF6,18,Calabria,Calabria,1947131,194060,9.97,0.11
3143,2021-02-17,CAL,1832,797,1035,1621,211,ITF,ITF6,18,Calabria,Calabria,1947131,195892,10.06,0.09
3144,2021-04-08,CAL,9391,4426,4965,5804,3587,ITF,ITF6,18,Calabria,Calabria,1947131,205283,10.54,0.48
3145,2021-04-01,CAL,8493,3843,4650,3979,4514,ITF,ITF6,18,Calabria,Calabria,1947131,213776,10.98,0.44
3146,2021-05-21,CAL,21327,10858,10469,13963,7364,ITF,ITF6,18,Calabria,Calabria,1947131,235103,12.07,1.1
3147,2021-02-11,CAL,2329,1040,1289,1082,1247,ITF,ITF6,18,Calabria,Calabria,1947131,237432,12.19,0.12
3148,2021-05-23,CAL,11365,5547,5818,7033,4332,ITF,ITF6,18,Calabria,Calabria,1947131,248797,12.78,0.58
3149,2021-02-06,CAL,2906,1337,1569,442,2464,ITF,ITF6,18,Calabria,Calabria,1947131,251703,12.93,0.15
3150,2021-04-15,CAL,7593,3721,3872,5982,1611,ITF,ITF6,18,Calabria,Calabria,1947131,259296,13.32,0.39
3151,2021-02-10,CAL,2509,1078,1431,884,1625,ITF,ITF6,18,Calabria,Calabria,1947131,261805,13.45,0.13
3152,2021-05-28,CAL,20883,10129,10754,11471,9412,ITF,ITF6,18,Calabria,Calabria,1947131,282688,14.52,1.07
3153,2021-02-01,CAL,2497,1193,1304,244,2253,ITF,ITF6,18,Calabria,Calabria,1947131,285185,14.65,0.13
3154,2021-05-26,CAL,18483,9136,9347,10278,8205,ITF,ITF6,18,Calabria,Calabria,1947131,303668,15.6,0.95
3155,2021-03-30,CAL,6146,2637,3509,3439,2707,ITF,ITF6,18,Calabria,Calabria,1947131,309814,15.91,0.32
3156,2021-05-19,CAL,18449,9139,9310,11429,7020,ITF,ITF6,18,Calabria,Calabria,1947131,328263,16.86,0.95
3157,2021-03-23,CAL,5253,2459,2794,3444,1809,ITF,ITF6,18,Calabria,Calabria,1947131,333516,17.13,0.27
3158,2021-05-12,CAL,16319,7923,8396,10892,5427,ITF,ITF6,18,Calabria,Calabria,1947131,349835,17.97,0.84
3159,2020-12-27,CAL,281,156,125,281,0,ITF,ITF6,18,Calabria,Calabria,1947131,350116,17.98,0.01
3160,2021-02-15,CAL,1140,539,601,991,149,ITF,ITF6,18,Calabria,Calabria,1947131,351256,18.04,0.06
3161,2021-04-06,CAL,7463,3372,4091,4178,3285,ITF,ITF6,18,Calabria,Calabria,1947131,358719,18.42,0.38
3162,2021-03-04,CAL,5465,3183,2282,4668,797,ITF,ITF6,18,Calabria,Calabria,1947131,364184,18.7,0.28
3163,2021-01-29,CAL,2049,988,1061,230,1819,ITF,ITF6,18,Calabria,Calabria,1947131,366233,18.81,0.11
3164,2021-05-02,CAL,12499,5834,6665,10662,1837,ITF,ITF6,18,Calabria,Calabria,1947131,378732,19.45,0.64
3165,2021-05-07,CAL,16084,7582,8502,9715,6369,ITF,ITF6,18,Calabria,Calabria,1947131,394816,20.28,0.83
3166,2021-05-24,CAL,17627,8780,8847,9958,7669,ITF,ITF6,18,Calabria,Calabria,1947131,412443,21.18,0.91
3167,2021-01-08,CAL,2136,1024,1112,2136,0,ITF,ITF6,18,Calabria,Calabria,1947131,414579,21.29,0.11
3168,2021-02-27,CAL,3989,2053,1936,3610,379,ITF,ITF6,18,Calabria,Calabria,1947131,418568,21.5,0.2
3169,2021-01-25,CAL,1069,513,556,147,922,ITF,ITF6,18,Calabria,Calabria,1947131,419637,21.55,0.05
3170,2021-01-11,CAL,2158,1042,1116,2158,0,ITF,ITF6,18,Calabria,Calabria,1947131,421795,21.66,0.11
3171,2021-05-05,CAL,13597,6507,7090,8488,5109,ITF,ITF6,18,Calabria,Calabria,1947131,435392,22.36,0.7
3172,2021-03-02,CAL,4369,2490,1879,3613,756,ITF,ITF6,18,Calabria,Calabria,1947131,439761,22.59,0.22
3173,2021-03-16,CAL,3835,1883,1952,2175,1660,ITF,ITF6,18,Calabria,Calabria,1947131,443596,22.78,0.2
3174,2021-03-01,CAL,2723,1545,1178,2269,454,ITF,ITF6,18,Calabria,Calabria,1947131,446319,22.92,0.14
3175,2021-01-10,CAL,930,524,406,930,0,ITF,ITF6,18,Calabria,Calabria,1947131,447249,22.97,0.05
3176,2021-01-04,CAL,1051,517,534,1051,0,ITF,ITF6,18,Calabria,Calabria,1947131,448300,23.02,0.05
3177,2021-01-31,CAL,1109,555,554,154,955,ITF,ITF6,18,Calabria,Calabria,1947131,449409,23.08,0.06
3178,2020-12-28,CAL,6,2,4,6,0,ITF,ITF6,18,Calabria,Calabria,1947131,449415,23.08,0.0
3179,2021-04-09,CAL,7933,3714,4219,5009,2924,ITF,ITF6,18,Calabria,Calabria,1947131,457348,23.49,0.41
3180,2021-06-03,CAL,14060,6574,7486,9505,4555,ITF,ITF6,18,Calabria,Calabria,1947131,471408,24.21,0.72
3181,2021-04-11,CAL,4166,1895,2271,2223,1943,ITF,ITF6,18,Calabria,Calabria,1947131,475574,24.42,0.21
3182,2021-01-03,CAL,6,3,3,6,0,ITF,ITF6,18,Calabria,Calabria,1947131,475580,24.42,0.0
3183,2021-03-08,CAL,5412,2900,2512,4350,1062,ITF,ITF6,18,Calabria,Calabria,1947131,480992,24.7,0.28
3184,2021-01-20,CAL,1399,626,773,1398,1,ITF,ITF6,18,Calabria,Calabria,1947131,482391,24.77,0.07
3185,2021-01-26,CAL,1808,861,947,278,1530,ITF,ITF6,18,Calabria,Calabria,1947131,484199,24.87,0.09
3186,2021-04-05,CAL,3501,1648,1853,2602,899,ITF,ITF6,18,Calabria,Calabria,1947131,487700,25.05,0.18
3187,2021-05-25,CAL,16336,7971,8365,10250,6086,ITF,ITF6,18,Calabria,Calabria,1947131,504036,25.89,0.84
3188,2021-04-22,CAL,9620,4795,4825,6778,2842,ITF,ITF6,18,Calabria,Calabria,1947131,513656,26.38,0.49
3189,2021-01-09,CAL,1924,1040,884,1924,0,ITF,ITF6,18,Calabria,Calabria,1947131,515580,26.48,0.1
3190,2021-04-10,CAL,11361,5125,6236,6559,4802,ITF,ITF6,18,Calabria,Calabria,1947131,526941,27.06,0.58
3191,2021-02-05,CAL,3800,1710,2090,490,3310,ITF,ITF6,18,Calabria,Calabria,1947131,530741,27.26,0.2
3192,2021-03-26,CAL,7896,3737,4159,4778,3118,ITF,ITF6,18,Calabria,Calabria,1947131,538637,27.66,0.41
3193,2021-04-24,CAL,18994,9476,9518,15585,3409,ITF,ITF6,18,Calabria,Calabria,1947131,557631,28.64,0.98
3194,2021-02-26,CAL,3063,1632,1431,2610,453,ITF,ITF6,18,Calabria,Calabria,1947131,560694,28.8,0.16
3195,2021-01-07,CAL,2186,1066,1120,2186,0,ITF,ITF6,18,Calabria,Calabria,1947131,562880,28.91,0.11
3196,2021-04-17,CAL,10844,5080,5764,9047,1797,ITF,ITF6,18,Calabria,Calabria,1947131,573724,29.47,0.56
3197,2021-05-01,CAL,16696,7962,8734,12433,4263,ITF,ITF6,18,Calabria,Calabria,1947131,590420,30.32,0.86
3198,2021-03-05,CAL,6228,3612,2616,5655,573,ITF,ITF6,18,Calabria,Calabria,1947131,596648,30.64,0.32
3199,2021-03-12,CAL,5115,2452,2663,4045,1070,ITF,ITF6,18,Calabria,Calabria,1947131,601763,30.91,0.26
3200,2021-01-14,CAL,2635,1248,1387,2635,0,ITF,ITF6,18,Calabria,Calabria,1947131,604398,31.04,0.14
3201,2021-03-10,CAL,6552,3314,3238,5273,1279,ITF,ITF6,18,Calabria,Calabria,1947131,610950,31.38,0.34
3202,2021-05-13,CAL,15870,7612,8258,11211,4659,ITF,ITF6,18,Calabria,Calabria,1947131,626820,32.19,0.82
3203,2021-05-30,CAL,10924,5242,5682,6773,4151,ITF,ITF6,18,Calabria,Calabria,1947131,637744,32.75,0.56
3204,2021-05-17,CAL,15071,7531,7540,10358,4713,ITF,ITF6,18,Calabria,Calabria,1947131,652815,33.53,0.77
3205,2021-02-04,CAL,3557,1694,1863,652,2905,ITF,ITF6,18,Calabria,Calabria,1947131,656372,33.71,0.18
3206,2021-02-21,CAL,609,286,323,532,77,ITF,ITF6,18,Calabria,Calabria,1947131,656981,33.74,0.03
3207,2021-04-25,CAL,15831,8032,7799,14694,1137,ITF,ITF6,18,Calabria,Calabria,1947131,672812,34.55,0.81
3208,2021-05-29,CAL,19016,8826,10190,9191,9825,ITF,ITF6,18,Calabria,Calabria,1947131,691828,35.53,0.98
3209,2021-01-05,CAL,1467,686,781,1467,0,ITF,ITF6,18,Calabria,Calabria,1947131,693295,35.61,0.08
3210,2021-03-14,CAL,2704,1066,1638,2289,415,ITF,ITF6,18,Calabria,Calabria,1947131,695999,35.74,0.14
3211,2021-02-12,CAL,1710,667,1043,945,765,ITF,ITF6,18,Calabria,Calabria,1947131,697709,35.83,0.09
3212,2021-04-03,CAL,8872,3808,5064,4282,4590,ITF,ITF6,18,Calabria,Calabria,1947131,706581,36.29,0.46
3213,2021-01-28,CAL,2234,1108,1126,83,2151,ITF,ITF6,18,Calabria,Calabria,1947131,708815,36.4,0.11
3214,2021-05-22,CAL,22044,10502,11542,14220,7824,ITF,ITF6,18,Calabria,Calabria,1947131,730859,37.54,1.13
3215,2021-04-02,CAL,8131,3706,4425,4336,3795,ITF,ITF6,18,Calabria,Calabria,1947131,738990,37.95,0.42
3216,2021-05-08,CAL,18273,8326,9947,10470,7803,ITF,ITF6,18,Calabria,Calabria,1947131,757263,38.89,0.94
3217,2021-03-19,CAL,4188,1948,2240,1900,2288,ITF,ITF6,18,Calabria,Calabria,1947131,761451,39.11,0.22
3218,2021-01-12,CAL,2063,1020,1043,2063,0,ITF,ITF6,18,Calabria,Calabria,1947131,763514,39.21,0.11
3219,2021-02-24,CAL,1848,942,906,1373,475,ITF,ITF6,18,Calabria,Calabria,1947131,765362,39.31,0.09
3220,2021-03-03,CAL,5002,2732,2270,3930,1072,ITF,ITF6,18,Calabria,Calabria,1947131,770364,39.56,0.26
3221,2021-05-03,CAL,14737,6754,7983,10537,4200,ITF,ITF6,18,Calabria,Calabria,1947131,785101,40.32,0.76
3222,2021-03-21,CAL,4454,1925,2529,2729,1725,ITF,ITF6,18,Calabria,Calabria,1947131,789555,40.55,0.23
3223,2021-03-07,CAL,3331,1701,1630,3242,89,ITF,ITF6,18,Calabria,Calabria,1947131,792886,40.72,0.17
3224,2021-05-10,CAL,13132,6093,7039,7734,5398,ITF,ITF6,18,Calabria,Calabria,1947131,806018,41.4,0.67
3225,2021-05-20,CAL,16894,8434,8460,11290,5604,ITF,ITF6,18,Calabria,Calabria,1947131,822912,42.26,0.87
3226,2021-02-07,CAL,859,427,432,147,712,ITF,ITF6,18,Calabria,Calabria,1947131,823771,42.31,0.04
3227,2021-03-15,CAL,3547,1682,1865,2112,1435,ITF,ITF6,18,Calabria,Calabria,1947131,827318,42.49,0.18
3228,2021-05-18,CAL,15375,7679,7696,11914,3461,ITF,ITF6,18,Calabria,Calabria,1947131,842693,43.28,0.79
3229,2021-03-22,CAL,4883,2290,2593,3130,1753,ITF,ITF6,18,Calabria,Calabria,1947131,847576,43.53,0.25
3230,2021-04-14,CAL,8154,3926,4228,6707,1447,ITF,ITF6,18,Calabria,Calabria,1947131,855730,43.95,0.42
3231,2021-02-16,CAL,1735,732,1003,1456,279,ITF,ITF6,18,Calabria,Calabria,1947131,857465,44.04,0.09
3232,2021-02-09,CAL,2146,905,1241,947,1199,ITF,ITF6,18,Calabria,Calabria,1947131,859611,44.15,0.11
3233,2021-05-27,CAL,17419,8572,8847,9731,7688,ITF,ITF6,18,Calabria,Calabria,1947131,877030,45.04,0.89
3234,2021-03-29,CAL,5686,2404,3282,3930,1756,ITF,ITF6,18,Calabria,Calabria,1947131,882716,45.33,0.29
3235,2021-05-11,CAL,15125,7314,7811,10349,4776,ITF,ITF6,18,Calabria,Calabria,1947131,897841,46.11,0.78
3236,2021-01-24,CAL,44,18,26,39,5,ITF,ITF6,18,Calabria,Calabria,1947131,897885,46.11,0.0
3237,2021-02-23,CAL,1590,753,837,1475,115,ITF,ITF6,18,Calabria,Calabria,1947131,899475,46.19,0.08
3238,2021-04-07,CAL,6516,2944,3572,3716,2800,ITF,ITF6,18,Calabria,Calabria,1947131,905991,46.53,0.33
3239,2021-02-14,CAL,462,210,252,432,30,ITF,ITF6,18,Calabria,Calabria,1947131,906453,46.55,0.02
3240,2021-03-17,CAL,3979,1769,2210,2138,1841,ITF,ITF6,18,Calabria,Calabria,1947131,910432,46.76,0.2
3241,2021-05-06,CAL,13251,6269,6982,8992,4259,ITF,ITF6,18,Calabria,Calabria,1947131,923683,47.44,0.68
3242,2021-04-19,CAL,7838,3781,4057,6174,1664,ITF,ITF6,18,Calabria,Calabria,1947131,931521,47.84,0.4
3243,2021-02-08,CAL,1849,735,1114,662,1187,ITF,ITF6,18,Calabria,Calabria,1947131,933370,47.94,0.09
3244,2021-04-20,CAL,7845,3956,3889,6119,1726,ITF,ITF6,18,Calabria,Calabria,1947131,941215,48.34,0.4
3245,2021-04-21,CAL,11564,5806,5758,8630,2934,ITF,ITF6,18,Calabria,Calabria,1947131,952779,48.93,0.59
3246,2021-03-31,CAL,8812,4003,4809,4855,3957,ITF,ITF6,18,Calabria,Calabria,1947131,961591,49.39,0.45
3247,2021-03-09,CAL,6308,3247,3061,5329,979,ITF,ITF6,18,Calabria,Calabria,1947131,967899,49.71,0.32
3248,2021-04-27,CAL,9945,4889,5056,8004,1941,ITF,ITF6,18,Calabria,Calabria,1947131,977844,50.22,0.51
3249,2021-03-25,CAL,7386,3463,3923,4547,2839,ITF,ITF6,18,Calabria,Calabria,1947131,985230,50.6,0.38
3250,2021-06-01,CAL,12695,5868,6827,7832,4863,ITF,ITF6,18,Calabria,Calabria,1947131,997925,51.25,0.65
3251,2021-02-19,CAL,1508,681,827,1247,261,ITF,ITF6,18,Calabria,Calabria,1947131,999433,51.33,0.08
3252,2021-04-28,CAL,12521,6060,6461,9663,2858,ITF,ITF6,18,Calabria,Calabria,1947131,1011954,51.97,0.64
3253,2021-01-16,CAL,2394,1120,1274,2394,0,ITF,ITF6,18,Calabria,Calabria,1947131,1014348,52.09,0.12
3254,2021-01-21,CAL,960,445,515,930,30,ITF,ITF6,18,Calabria,Calabria,1947131,1015308,52.14,0.05
3255,2021-04-26,CAL,10198,5066,5132,7777,2421,ITF,ITF6,18,Calabria,Calabria,1947131,1025506,52.67,0.52
3256,2021-02-28,CAL,2305,1045,1260,2153,152,ITF,ITF6,18,Calabria,Calabria,1947131,1027811,52.79,0.12
3257,2021-02-22,CAL,2032,1029,1003,1475,557,ITF,ITF6,18,Calabria,Calabria,1947131,1029843,52.89,0.1
3258,2021-06-02,CAL,7656,3695,3961,5777,1879,ITF,ITF6,18,Calabria,Calabria,1947131,1037499,53.28,0.39
3259,2021-03-24,CAL,7607,3464,4143,4368,3239,ITF,ITF6,18,Calabria,Calabria,1947131,1045106,53.67,0.39
3260,2021-04-12,CAL,6899,3349,3550,5248,1651,ITF,ITF6,18,Calabria,Calabria,1947131,1052005,54.03,0.35
3261,2021-01-19,CAL,1111,490,621,1101,10,ITF,ITF6,18,Calabria,Calabria,1947131,1053116,54.09,0.06
3262,2021-01-17,CAL,867,418,449,801,66,ITF,ITF6,18,Calabria,Calabria,1947131,1053983,54.13,0.04
3263,2021-04-29,CAL,11825,5744,6081,8309,3516,ITF,ITF6,18,Calabria,Calabria,1947131,1065808,54.74,0.61
3264,2021-05-15,CAL,26834,12856,13978,20063,6771,ITF,ITF6,18,Calabria,Calabria,1947131,1092642,56.12,1.38
3265,2021-02-02,CAL,2287,1114,1173,177,2110,ITF,ITF6,18,Calabria,Calabria,1947131,1094929,56.23,0.12
3266,2021-01-02,CAL,166,94,72,166,0,ITF,ITF6,18,Calabria,Calabria,1947131,1095095,56.24,0.01
