,data,area,Vaccinazioni giornaliere,sesso_maschile,sesso_femminile,prima_dose,seconda_dose,codice_NUTS1,codice_NUTS2,codice_regione_ISTAT,nome_area,Regione,popolazione,Totale vaccinazioni,Totale vaccinazioni ogni cento ab,Vaccinazioni giornaliere ogni cento ab
0,2021-01-18,CAM,957,399,558,713,244,ITF,ITF3,15,Campania,Campania,5801692,957,0.02,0.02
1,2021-04-30,CAM,42230,20132,22098,25782,16448,ITF,ITF3,15,Campania,Campania,5801692,43187,0.74,0.73
2,2021-05-17,CAM,49217,21605,27612,24078,25139,ITF,ITF3,15,Campania,Campania,5801692,92404,1.59,0.85
3,2021-02-04,CAM,7943,3429,4514,1308,6635,ITF,ITF3,15,Campania,Campania,5801692,100347,1.73,0.14
4,2021-01-01,CAM,919,506,413,919,0,ITF,ITF3,15,Campania,Campania,5801692,101266,1.75,0.02
5,2021-04-13,CAM,26599,12682,13917,21069,5530,ITF,ITF3,15,Campania,Campania,5801692,127865,2.2,0.46
6,2021-03-28,CAM,15551,7499,8052,13928,1623,ITF,ITF3,15,Campania,Campania,5801692,143416,2.47,0.27
7,2021-05-16,CAM,51098,23191,27907,33567,17531,ITF,ITF3,15,Campania,Campania,5801692,194514,3.35,0.88
8,2021-02-03,CAM,8903,4003,4900,878,8025,ITF,ITF3,15,Campania,Campania,5801692,203417,3.51,0.15
9,2021-03-11,CAM,17578,8670,8908,10300,7278,ITF,ITF3,15,Campania,Campania,5801692,220995,3.81,0.3
10,2021-02-20,CAM,8573,3080,5493,8270,303,ITF,ITF3,15,Campania,Campania,5801692,229568,3.96,0.15
11,2021-04-11,CAM,17521,8604,8917,15439,2082,ITF,ITF3,15,Campania,Campania,5801692,247089,4.26,0.3
12,2021-02-06,CAM,5340,2665,2675,2102,3238,ITF,ITF3,15,Campania,Campania,5801692,252429,4.35,0.09
13,2021-04-28,CAM,36394,17613,18781,26644,9750,ITF,ITF3,15,Campania,Campania,5801692,288823,4.98,0.63
14,2021-01-03,CAM,3837,2009,1828,3837,0,ITF,ITF3,15,Campania,Campania,5801692,292660,5.04,0.07
15,2021-03-25,CAM,19990,9334,10656,16487,3503,ITF,ITF3,15,Campania,Campania,5801692,312650,5.39,0.34
16,2021-01-20,CAM,1257,650,607,1257,0,ITF,ITF3,15,Campania,Campania,5801692,313907,5.41,0.02
17,2021-02-25,CAM,12425,4478,7947,11237,1188,ITF,ITF3,15,Campania,Campania,5801692,326332,5.62,0.21
18,2021-04-09,CAM,29844,13965,15879,23717,6127,ITF,ITF3,15,Campania,Campania,5801692,356176,6.14,0.51
19,2021-01-22,CAM,1524,776,748,673,851,ITF,ITF3,15,Campania,Campania,5801692,357700,6.17,0.03
20,2021-03-06,CAM,16308,6752,9556,10639,5669,ITF,ITF3,15,Campania,Campania,5801692,374008,6.45,0.28
21,2021-01-30,CAM,10721,5079,5642,38,10683,ITF,ITF3,15,Campania,Campania,5801692,384729,6.63,0.18
22,2021-01-23,CAM,3838,2028,1810,273,3565,ITF,ITF3,15,Campania,Campania,5801692,388567,6.7,0.07
23,2021-04-08,CAM,28265,13637,14628,22431,5834,ITF,ITF3,15,Campania,Campania,5801692,416832,7.18,0.49
24,2021-04-01,CAM,24337,11685,12652,20204,4133,ITF,ITF3,15,Campania,Campania,5801692,441169,7.6,0.42
25,2021-05-21,CAM,63368,29334,34034,43174,20194,ITF,ITF3,15,Campania,Campania,5801692,504537,8.7,1.09
26,2021-01-16,CAM,3369,1675,1694,3369,0,ITF,ITF3,15,Campania,Campania,5801692,507906,8.75,0.06
27,2021-03-21,CAM,9983,4592,5391,7593,2390,ITF,ITF3,15,Campania,Campania,5801692,517889,8.93,0.17
28,2021-02-10,CAM,6904,3413,3491,6728,176,ITF,ITF3,15,Campania,Campania,5801692,524793,9.05,0.12
29,2021-05-28,CAM,70896,33964,36932,26627,44269,ITF,ITF3,15,Campania,Campania,5801692,595689,10.27,1.22
30,2021-05-14,CAM,60793,27463,33330,36305,24488,ITF,ITF3,15,Campania,Campania,5801692,656482,11.32,1.05
31,2021-01-04,CAM,5825,2962,2863,5825,0,ITF,ITF3,15,Campania,Campania,5801692,662307,11.42,0.1
32,2021-03-09,CAM,13880,6637,7243,10095,3785,ITF,ITF3,15,Campania,Campania,5801692,676187,11.65,0.24
33,2021-02-22,CAM,10680,3294,7386,10417,263,ITF,ITF3,15,Campania,Campania,5801692,686867,11.84,0.18
34,2021-02-13,CAM,5508,2550,2958,5291,217,ITF,ITF3,15,Campania,Campania,5801692,692375,11.93,0.09
35,2021-04-04,CAM,7958,4012,3946,6914,1044,ITF,ITF3,15,Campania,Campania,5801692,700333,12.07,0.14
36,2021-01-27,CAM,7738,3820,3918,162,7576,ITF,ITF3,15,Campania,Campania,5801692,708071,12.2,0.13
37,2021-03-18,CAM,12172,5378,6794,5984,6188,ITF,ITF3,15,Campania,Campania,5801692,720243,12.41,0.21
38,2021-01-06,CAM,7652,3749,3903,7652,0,ITF,ITF3,15,Campania,Campania,5801692,727895,12.55,0.13
39,2021-02-11,CAM,6278,2704,3574,6212,66,ITF,ITF3,15,Campania,Campania,5801692,734173,12.65,0.11
40,2021-04-16,CAM,34301,16552,17749,23643,10658,ITF,ITF3,15,Campania,Campania,5801692,768474,13.25,0.59
41,2021-02-18,CAM,9080,3812,5268,8372,708,ITF,ITF3,15,Campania,Campania,5801692,777554,13.4,0.16
42,2021-01-15,CAM,4980,2381,2599,4980,0,ITF,ITF3,15,Campania,Campania,5801692,782534,13.49,0.09
43,2021-03-13,CAM,14249,6795,7454,8967,5282,ITF,ITF3,15,Campania,Campania,5801692,796783,13.73,0.25
44,2021-04-25,CAM,30716,15170,15546,25327,5389,ITF,ITF3,15,Campania,Campania,5801692,827499,14.26,0.53
45,2021-01-13,CAM,8020,3666,4354,8020,0,ITF,ITF3,15,Campania,Campania,5801692,835519,14.4,0.14
46,2021-04-18,CAM,27214,13281,13933,18316,8898,ITF,ITF3,15,Campania,Campania,5801692,862733,14.87,0.47
47,2021-01-08,CAM,10455,4968,5487,10455,0,ITF,ITF3,15,Campania,Campania,5801692,873188,15.05,0.18
48,2021-04-23,CAM,32296,15506,16790,23161,9135,ITF,ITF3,15,Campania,Campania,5801692,905484,15.61,0.56
49,2021-03-04,CAM,14658,5352,9306,8765,5893,ITF,ITF3,15,Campania,Campania,5801692,920142,15.86,0.25
50,2021-05-24,CAM,31061,14888,16173,16175,14886,ITF,ITF3,15,Campania,Campania,5801692,951203,16.4,0.54
51,2021-05-07,CAM,59696,29176,30520,43762,15934,ITF,ITF3,15,Campania,Campania,5801692,1010899,17.42,1.03
52,2021-02-27,CAM,13950,4473,9477,12308,1642,ITF,ITF3,15,Campania,Campania,5801692,1024849,17.66,0.24
53,2021-05-02,CAM,43472,21532,21940,32133,11339,ITF,ITF3,15,Campania,Campania,5801692,1068321,18.41,0.75
54,2021-04-27,CAM,32098,15586,16512,24179,7919,ITF,ITF3,15,Campania,Campania,5801692,1100419,18.97,0.55
55,2021-03-22,CAM,12741,5921,6820,10701,2040,ITF,ITF3,15,Campania,Campania,5801692,1113160,19.19,0.22
56,2021-02-07,CAM,2929,1382,1547,2158,771,ITF,ITF3,15,Campania,Campania,5801692,1116089,19.24,0.05
57,2021-05-26,CAM,51990,25375,26615,21128,30862,ITF,ITF3,15,Campania,Campania,5801692,1168079,20.13,0.9
58,2021-03-02,CAM,12756,4554,8202,8411,4345,ITF,ITF3,15,Campania,Campania,5801692,1180835,20.35,0.22
59,2021-01-11,CAM,4072,1871,2201,4072,0,ITF,ITF3,15,Campania,Campania,5801692,1184907,20.42,0.07
60,2020-12-27,CAM,720,422,298,720,0,ITF,ITF3,15,Campania,Campania,5801692,1185627,20.44,0.01
61,2021-04-20,CAM,31986,15488,16498,20681,11305,ITF,ITF3,15,Campania,Campania,5801692,1217613,20.99,0.55
62,2021-03-01,CAM,12130,4247,7883,8017,4113,ITF,ITF3,15,Campania,Campania,5801692,1229743,21.2,0.21
63,2021-04-06,CAM,24372,11421,12951,19851,4521,ITF,ITF3,15,Campania,Campania,5801692,1254115,21.62,0.42
64,2021-03-16,CAM,8086,3519,4567,3772,4314,ITF,ITF3,15,Campania,Campania,5801692,1262201,21.76,0.14
65,2021-01-25,CAM,5744,2926,2818,164,5580,ITF,ITF3,15,Campania,Campania,5801692,1267945,21.85,0.1
66,2021-03-23,CAM,15336,7055,8281,12823,2513,ITF,ITF3,15,Campania,Campania,5801692,1283281,22.12,0.26
67,2021-05-19,CAM,51008,22493,28515,34513,16495,ITF,ITF3,15,Campania,Campania,5801692,1334289,23.0,0.88
68,2021-05-12,CAM,40790,19911,20879,31655,9135,ITF,ITF3,15,Campania,Campania,5801692,1375079,23.7,0.7
69,2021-05-05,CAM,51123,24835,26288,44747,6376,ITF,ITF3,15,Campania,Campania,5801692,1426202,24.58,0.88
70,2021-02-08,CAM,5113,2449,2664,4310,803,ITF,ITF3,15,Campania,Campania,5801692,1431315,24.67,0.09
71,2021-02-01,CAM,3985,1813,2172,110,3875,ITF,ITF3,15,Campania,Campania,5801692,1435300,24.74,0.07
72,2021-03-30,CAM,21728,10272,11456,18770,2958,ITF,ITF3,15,Campania,Campania,5801692,1457028,25.11,0.37
73,2021-05-13,CAM,55378,24807,30571,39389,15989,ITF,ITF3,15,Campania,Campania,5801692,1512406,26.07,0.95
74,2021-01-31,CAM,8067,3711,4356,23,8044,ITF,ITF3,15,Campania,Campania,5801692,1520473,26.21,0.14
75,2021-05-04,CAM,48432,23331,25101,39544,8888,ITF,ITF3,15,Campania,Campania,5801692,1568905,27.04,0.83
76,2021-03-31,CAM,22682,10906,11776,19243,3439,ITF,ITF3,15,Campania,Campania,5801692,1591587,27.43,0.39
77,2021-03-29,CAM,18947,9134,9813,17401,1546,ITF,ITF3,15,Campania,Campania,5801692,1610534,27.76,0.33
78,2021-05-15,CAM,62602,29026,33576,43937,18665,ITF,ITF3,15,Campania,Campania,5801692,1673136,28.84,1.08
79,2021-02-23,CAM,11003,3388,7615,10477,526,ITF,ITF3,15,Campania,Campania,5801692,1684139,29.03,0.19
80,2021-03-12,CAM,14247,7096,7151,8165,6082,ITF,ITF3,15,Campania,Campania,5801692,1698386,29.27,0.25
81,2021-03-10,CAM,15248,7378,7870,8415,6833,ITF,ITF3,15,Campania,Campania,5801692,1713634,29.54,0.26
82,2021-03-27,CAM,21271,10030,11241,17407,3864,ITF,ITF3,15,Campania,Campania,5801692,1734905,29.9,0.37
83,2021-02-21,CAM,5834,2239,3595,5609,225,ITF,ITF3,15,Campania,Campania,5801692,1740739,30.0,0.1
84,2021-03-20,CAM,13880,6428,7452,10141,3739,ITF,ITF3,15,Campania,Campania,5801692,1754619,30.24,0.24
85,2021-05-09,CAM,43176,20277,22899,32086,11090,ITF,ITF3,15,Campania,Campania,5801692,1797795,30.99,0.74
86,2021-01-05,CAM,7238,3637,3601,7238,0,ITF,ITF3,15,Campania,Campania,5801692,1805033,31.11,0.12
87,2021-02-17,CAM,7388,3210,4178,6328,1060,ITF,ITF3,15,Campania,Campania,5801692,1812421,31.24,0.13
88,2021-03-14,CAM,8502,3721,4781,4363,4139,ITF,ITF3,15,Campania,Campania,5801692,1820923,31.39,0.15
89,2021-04-26,CAM,33992,16632,17360,28369,5623,ITF,ITF3,15,Campania,Campania,5801692,1854915,31.97,0.59
90,2021-04-17,CAM,36172,17506,18666,24666,11506,ITF,ITF3,15,Campania,Campania,5801692,1891087,32.6,0.62
91,2021-02-19,CAM,9570,3559,6011,8920,650,ITF,ITF3,15,Campania,Campania,5801692,1900657,32.76,0.16
92,2020-12-31,CAM,1490,811,679,1490,0,ITF,ITF3,15,Campania,Campania,5801692,1902147,32.79,0.03
93,2021-02-26,CAM,13339,4230,9109,12004,1335,ITF,ITF3,15,Campania,Campania,5801692,1915486,33.02,0.23
94,2021-04-24,CAM,36318,17513,18805,25072,11246,ITF,ITF3,15,Campania,Campania,5801692,1951804,33.64,0.63
95,2021-04-10,CAM,28341,13486,14855,23427,4914,ITF,ITF3,15,Campania,Campania,5801692,1980145,34.13,0.49
96,2021-01-07,CAM,8910,4166,4744,8910,0,ITF,ITF3,15,Campania,Campania,5801692,1989055,34.28,0.15
97,2021-03-05,CAM,16482,6348,10134,9819,6663,ITF,ITF3,15,Campania,Campania,5801692,2005537,34.57,0.28
98,2021-01-14,CAM,7073,2977,4096,7073,0,ITF,ITF3,15,Campania,Campania,5801692,2012610,34.69,0.12
99,2021-01-19,CAM,1095,474,621,1092,3,ITF,ITF3,15,Campania,Campania,5801692,2013705,34.71,0.02
100,2021-05-18,CAM,52048,23142,28906,32507,19541,ITF,ITF3,15,Campania,Campania,5801692,2065753,35.61,0.9
101,2021-04-29,CAM,41283,20007,21276,24819,16464,ITF,ITF3,15,Campania,Campania,5801692,2107036,36.32,0.71
102,2021-04-14,CAM,27641,13332,14309,19076,8565,ITF,ITF3,15,Campania,Campania,5801692,2134677,36.79,0.48
103,2021-01-02,CAM,3673,1962,1711,3673,0,ITF,ITF3,15,Campania,Campania,5801692,2138350,36.86,0.06
104,2021-04-12,CAM,23302,10916,12386,20266,3036,ITF,ITF3,15,Campania,Campania,5801692,2161652,37.26,0.4
105,2021-04-05,CAM,11637,5543,6094,9214,2423,ITF,ITF3,15,Campania,Campania,5801692,2173289,37.46,0.2
106,2021-05-25,CAM,45945,21929,24016,22883,23062,ITF,ITF3,15,Campania,Campania,5801692,2219234,38.25,0.79
107,2021-04-22,CAM,33936,16526,17410,21535,12401,ITF,ITF3,15,Campania,Campania,5801692,2253170,38.84,0.58
108,2021-01-09,CAM,10567,5024,5543,10567,0,ITF,ITF3,15,Campania,Campania,5801692,2263737,39.02,0.18
109,2021-05-22,CAM,67828,32437,35391,46439,21389,ITF,ITF3,15,Campania,Campania,5801692,2331565,40.19,1.17
110,2021-02-05,CAM,7260,3463,3797,2133,5127,ITF,ITF3,15,Campania,Campania,5801692,2338825,40.31,0.13
111,2021-01-21,CAM,2092,1115,977,676,1416,ITF,ITF3,15,Campania,Campania,5801692,2340917,40.35,0.04
112,2021-03-26,CAM,19455,8927,10528,15642,3813,ITF,ITF3,15,Campania,Campania,5801692,2360372,40.68,0.34
113,2021-05-01,CAM,46320,22653,23667,30222,16098,ITF,ITF3,15,Campania,Campania,5801692,2406692,41.48,0.8
114,2021-02-15,CAM,5470,2516,2954,5297,173,ITF,ITF3,15,Campania,Campania,5801692,2412162,41.58,0.09
115,2021-01-10,CAM,8165,3736,4429,8165,0,ITF,ITF3,15,Campania,Campania,5801692,2420327,41.72,0.14
116,2021-04-21,CAM,30215,14720,15495,17990,12225,ITF,ITF3,15,Campania,Campania,5801692,2450542,42.24,0.52
117,2021-02-24,CAM,11786,4149,7637,11098,688,ITF,ITF3,15,Campania,Campania,5801692,2462328,42.44,0.2
118,2021-04-15,CAM,34337,16658,17679,24440,9897,ITF,ITF3,15,Campania,Campania,5801692,2496665,43.03,0.59
119,2021-05-10,CAM,35403,16371,19032,25495,9908,ITF,ITF3,15,Campania,Campania,5801692,2532068,43.64,0.61
120,2021-03-07,CAM,11912,5344,6568,8069,3843,ITF,ITF3,15,Campania,Campania,5801692,2543980,43.85,0.21
121,2021-05-03,CAM,40741,19882,20859,28896,11845,ITF,ITF3,15,Campania,Campania,5801692,2584721,44.55,0.7
122,2021-01-24,CAM,4128,2123,2005,383,3745,ITF,ITF3,15,Campania,Campania,5801692,2588849,44.62,0.07
123,2021-03-08,CAM,14539,6715,7824,9763,4776,ITF,ITF3,15,Campania,Campania,5801692,2603388,44.87,0.25
124,2021-05-11,CAM,39834,19231,20603,30466,9368,ITF,ITF3,15,Campania,Campania,5801692,2643222,45.56,0.69
125,2021-04-07,CAM,24755,11781,12974,20032,4723,ITF,ITF3,15,Campania,Campania,5801692,2667977,45.99,0.43
126,2021-04-02,CAM,21731,10410,11321,19410,2321,ITF,ITF3,15,Campania,Campania,5801692,2689708,46.36,0.37
127,2021-02-02,CAM,5723,2804,2919,444,5279,ITF,ITF3,15,Campania,Campania,5801692,2695431,46.46,0.1
128,2021-03-17,CAM,11588,5099,6489,5008,6580,ITF,ITF3,15,Campania,Campania,5801692,2707019,46.66,0.2
129,2021-03-03,CAM,13921,5494,8427,7291,6630,ITF,ITF3,15,Campania,Campania,5801692,2720940,46.9,0.24
130,2021-01-12,CAM,5214,2563,2651,5214,0,ITF,ITF3,15,Campania,Campania,5801692,2726154,46.99,0.09
131,2021-05-06,CAM,57249,27890,29359,42808,14441,ITF,ITF3,15,Campania,Campania,5801692,2783403,47.98,0.99
132,2021-02-28,CAM,10412,3206,7206,8512,1900,ITF,ITF3,15,Campania,Campania,5801692,2793815,48.16,0.18
133,2021-02-14,CAM,3928,1923,2005,3894,34,ITF,ITF3,15,Campania,Campania,5801692,2797743,48.22,0.07
134,2021-04-19,CAM,30729,14818,15911,19162,11567,ITF,ITF3,15,Campania,Campania,5801692,2828472,48.75,0.53
135,2021-01-17,CAM,1155,551,604,702,453,ITF,ITF3,15,Campania,Campania,5801692,2829627,48.77,0.02
136,2021-03-15,CAM,12932,6089,6843,8188,4744,ITF,ITF3,15,Campania,Campania,5801692,2842559,49.0,0.22
137,2021-02-16,CAM,5440,2411,3029,4669,771,ITF,ITF3,15,Campania,Campania,5801692,2847999,49.09,0.09
138,2021-02-09,CAM,4643,2202,2441,4391,252,ITF,ITF3,15,Campania,Campania,5801692,2852642,49.17,0.08
139,2021-05-27,CAM,72268,34743,37525,26194,46074,ITF,ITF3,15,Campania,Campania,5801692,2924910,50.41,1.25
140,2021-03-24,CAM,17618,8082,9536,14661,2957,ITF,ITF3,15,Campania,Campania,5801692,2942528,50.72,0.3
141,2021-05-20,CAM,60440,27823,32617,43081,17359,ITF,ITF3,15,Campania,Campania,5801692,3002968,51.76,1.04
142,2021-02-12,CAM,6529,2861,3668,6343,186,ITF,ITF3,15,Campania,Campania,5801692,3009497,51.87,0.11
143,2021-04-03,CAM,21115,10315,10800,18735,2380,ITF,ITF3,15,Campania,Campania,5801692,3030612,52.24,0.36
144,2021-05-23,CAM,58714,28615,30099,37838,20876,ITF,ITF3,15,Campania,Campania,5801692,3089326,53.25,1.01
145,2021-01-29,CAM,10052,4812,5240,47,10005,ITF,ITF3,15,Campania,Campania,5801692,3099378,53.42,0.17
146,2021-03-19,CAM,11036,4870,6166,7165,3871,ITF,ITF3,15,Campania,Campania,5801692,3110414,53.61,0.19
147,2021-01-28,CAM,8832,4121,4711,134,8698,ITF,ITF3,15,Campania,Campania,5801692,3119246,53.76,0.15
148,2021-05-08,CAM,56334,27095,29239,40527,15807,ITF,ITF3,15,Campania,Campania,5801692,3175580,54.74,0.97
149,2021-01-26,CAM,7340,3726,3614,351,6989,ITF,ITF3,15,Campania,Campania,5801692,3182920,54.86,0.13
150,2021-02-24,BAS,1803,743,1060,1734,69,ITF,ITF5,17,Basilicata,Basilicata,559084,1803,0.32,0.32
151,2021-03-13,BAS,1794,888,906,749,1045,ITF,ITF5,17,Basilicata,Basilicata,559084,3597,0.64,0.32
152,2021-02-07,BAS,373,159,214,49,324,ITF,ITF5,17,Basilicata,Basilicata,559084,3970,0.71,0.07
153,2021-05-20,BAS,5856,2965,2891,2891,2965,ITF,ITF5,17,Basilicata,Basilicata,559084,9826,1.76,1.05
154,2021-04-15,BAS,3386,1659,1727,2632,754,ITF,ITF5,17,Basilicata,Basilicata,559084,13212,2.36,0.61
155,2021-01-03,BAS,901,344,557,901,0,ITF,ITF5,17,Basilicata,Basilicata,559084,14113,2.52,0.16
156,2021-03-29,BAS,2435,881,1554,2149,286,ITF,ITF5,17,Basilicata,Basilicata,559084,16548,2.96,0.44
157,2021-01-05,BAS,946,409,537,946,0,ITF,ITF5,17,Basilicata,Basilicata,559084,17494,3.13,0.17
158,2021-02-22,BAS,1790,773,1017,1737,53,ITF,ITF5,17,Basilicata,Basilicata,559084,19284,3.45,0.32
159,2021-05-01,BAS,4701,2135,2566,3950,751,ITF,ITF5,17,Basilicata,Basilicata,559084,23985,4.29,0.84
160,2021-02-26,BAS,2149,904,1245,2069,80,ITF,ITF5,17,Basilicata,Basilicata,559084,26134,4.67,0.38
161,2021-05-18,BAS,5897,2856,3041,3403,2494,ITF,ITF5,17,Basilicata,Basilicata,559084,32031,5.73,1.05
162,2021-01-17,BAS,328,133,195,327,1,ITF,ITF5,17,Basilicata,Basilicata,559084,32359,5.79,0.06
163,2021-04-20,BAS,4035,1921,2114,2203,1832,ITF,ITF5,17,Basilicata,Basilicata,559084,36394,6.51,0.72
164,2021-01-08,BAS,554,219,335,554,0,ITF,ITF5,17,Basilicata,Basilicata,559084,36948,6.61,0.1
165,2021-03-17,BAS,1452,609,843,27,1425,ITF,ITF5,17,Basilicata,Basilicata,559084,38400,6.87,0.26
166,2021-04-29,BAS,4833,2385,2448,4411,422,ITF,ITF5,17,Basilicata,Basilicata,559084,43233,7.73,0.86
167,2021-03-25,BAS,1879,601,1278,1533,346,ITF,ITF5,17,Basilicata,Basilicata,559084,45112,8.07,0.34
168,2021-05-21,BAS,4647,2353,2294,1546,3101,ITF,ITF5,17,Basilicata,Basilicata,559084,49759,8.9,0.83
169,2021-02-03,BAS,666,300,366,32,634,ITF,ITF5,17,Basilicata,Basilicata,559084,50425,9.02,0.12
170,2021-04-12,BAS,2173,1052,1121,1680,493,ITF,ITF5,17,Basilicata,Basilicata,559084,52598,9.41,0.39
171,2021-02-10,BAS,547,237,310,495,52,ITF,ITF5,17,Basilicata,Basilicata,559084,53145,9.51,0.1
172,2021-01-27,BAS,411,175,236,113,298,ITF,ITF5,17,Basilicata,Basilicata,559084,53556,9.58,0.07
173,2021-04-01,BAS,2808,1134,1674,2091,717,ITF,ITF5,17,Basilicata,Basilicata,559084,56364,10.08,0.5
174,2021-04-19,BAS,4163,1910,2253,2526,1637,ITF,ITF5,17,Basilicata,Basilicata,559084,60527,10.83,0.74
175,2021-01-22,BAS,67,24,43,67,0,ITF,ITF5,17,Basilicata,Basilicata,559084,60594,10.84,0.01
176,2021-05-02,BAS,4180,2000,2180,3552,628,ITF,ITF5,17,Basilicata,Basilicata,559084,64774,11.59,0.75
177,2021-04-17,BAS,3461,1655,1806,2199,1262,ITF,ITF5,17,Basilicata,Basilicata,559084,68235,12.2,0.62
178,2021-04-08,BAS,764,348,416,754,10,ITF,ITF5,17,Basilicata,Basilicata,559084,68999,12.34,0.14
179,2021-05-11,BAS,2655,1353,1302,1621,1034,ITF,ITF5,17,Basilicata,Basilicata,559084,71654,12.82,0.47
180,2021-05-28,BAS,3588,1793,1795,935,2653,ITF,ITF5,17,Basilicata,Basilicata,559084,75242,13.46,0.64
181,2021-03-22,BAS,1175,531,644,628,547,ITF,ITF5,17,Basilicata,Basilicata,559084,76417,13.67,0.21
182,2021-05-25,BAS,4192,2108,2084,873,3319,ITF,ITF5,17,Basilicata,Basilicata,559084,80609,14.42,0.75
183,2021-05-04,BAS,4134,1990,2144,3611,523,ITF,ITF5,17,Basilicata,Basilicata,559084,84743,15.16,0.74
184,2021-03-08,BAS,1454,709,745,843,611,ITF,ITF5,17,Basilicata,Basilicata,559084,86197,15.42,0.26
185,2021-03-01,BAS,547,284,263,381,166,ITF,ITF5,17,Basilicata,Basilicata,559084,86744,15.52,0.1
186,2021-04-13,BAS,2146,1063,1083,1326,820,ITF,ITF5,17,Basilicata,Basilicata,559084,88890,15.9,0.38
187,2021-05-13,BAS,5982,2966,3016,3385,2597,ITF,ITF5,17,Basilicata,Basilicata,559084,94872,16.97,1.07
188,2021-01-26,BAS,796,352,444,101,695,ITF,ITF5,17,Basilicata,Basilicata,559084,95668,17.11,0.14
189,2021-01-24,BAS,837,300,537,58,779,ITF,ITF5,17,Basilicata,Basilicata,559084,96505,17.26,0.15
190,2021-04-22,BAS,5037,2346,2691,3434,1603,ITF,ITF5,17,Basilicata,Basilicata,559084,101542,18.16,0.9
191,2021-02-17,BAS,1135,493,642,1059,76,ITF,ITF5,17,Basilicata,Basilicata,559084,102677,18.37,0.2
192,2021-04-05,BAS,723,233,490,421,302,ITF,ITF5,17,Basilicata,Basilicata,559084,103400,18.49,0.13
193,2021-02-14,BAS,151,48,103,151,0,ITF,ITF5,17,Basilicata,Basilicata,559084,103551,18.52,0.03
194,2021-03-03,BAS,1744,814,930,1186,558,ITF,ITF5,17,Basilicata,Basilicata,559084,105295,18.83,0.31
195,2021-01-31,BAS,77,24,53,0,77,ITF,ITF5,17,Basilicata,Basilicata,559084,105372,18.85,0.01
196,2021-01-10,BAS,77,24,53,77,0,ITF,ITF5,17,Basilicata,Basilicata,559084,105449,18.86,0.01
197,2021-03-15,BAS,2351,983,1368,521,1830,ITF,ITF5,17,Basilicata,Basilicata,559084,107800,19.28,0.42
198,2021-04-27,BAS,4724,2242,2482,4399,325,ITF,ITF5,17,Basilicata,Basilicata,559084,112524,20.13,0.84
199,2021-01-19,BAS,199,84,115,199,0,ITF,ITF5,17,Basilicata,Basilicata,559084,112723,20.16,0.04
200,2021-03-24,BAS,1745,680,1065,1350,395,ITF,ITF5,17,Basilicata,Basilicata,559084,114468,20.47,0.31
201,2021-05-08,BAS,4837,2399,2438,3430,1407,ITF,ITF5,17,Basilicata,Basilicata,559084,119305,21.34,0.87
202,2021-04-02,BAS,2319,1046,1273,1714,605,ITF,ITF5,17,Basilicata,Basilicata,559084,121624,21.75,0.41
203,2021-03-20,BAS,1287,567,720,275,1012,ITF,ITF5,17,Basilicata,Basilicata,559084,122911,21.98,0.23
204,2021-01-29,BAS,614,229,385,63,551,ITF,ITF5,17,Basilicata,Basilicata,559084,123525,22.09,0.11
205,2021-01-15,BAS,813,350,463,813,0,ITF,ITF5,17,Basilicata,Basilicata,559084,124338,22.24,0.15
206,2021-03-06,BAS,1353,535,818,758,595,ITF,ITF5,17,Basilicata,Basilicata,559084,125691,22.48,0.24
207,2021-05-09,BAS,4686,2341,2345,2991,1695,ITF,ITF5,17,Basilicata,Basilicata,559084,130377,23.32,0.84
208,2021-03-05,BAS,1855,857,998,1109,746,ITF,ITF5,17,Basilicata,Basilicata,559084,132232,23.65,0.33
209,2021-04-24,BAS,4544,2197,2347,3532,1012,ITF,ITF5,17,Basilicata,Basilicata,559084,136776,24.46,0.81
210,2021-04-03,BAS,1807,749,1058,1472,335,ITF,ITF5,17,Basilicata,Basilicata,559084,138583,24.79,0.32
211,2021-02-05,BAS,984,443,541,64,920,ITF,ITF5,17,Basilicata,Basilicata,559084,139567,24.96,0.18
212,2021-05-16,BAS,4969,2466,2503,2858,2111,ITF,ITF5,17,Basilicata,Basilicata,559084,144536,25.85,0.89
213,2021-05-23,BAS,4515,2300,2215,1534,2981,ITF,ITF5,17,Basilicata,Basilicata,559084,149051,26.66,0.81
214,2021-03-27,BAS,2225,849,1376,1816,409,ITF,ITF5,17,Basilicata,Basilicata,559084,151276,27.06,0.4
215,2021-01-07,BAS,640,319,321,640,0,ITF,ITF5,17,Basilicata,Basilicata,559084,151916,27.17,0.11
216,2021-02-19,BAS,1622,737,885,1560,62,ITF,ITF5,17,Basilicata,Basilicata,559084,153538,27.46,0.29
217,2021-02-12,BAS,775,332,443,744,31,ITF,ITF5,17,Basilicata,Basilicata,559084,154313,27.6,0.14
218,2021-04-10,BAS,1032,378,654,950,82,ITF,ITF5,17,Basilicata,Basilicata,559084,155345,27.79,0.18
219,2021-02-11,BAS,951,401,550,868,83,ITF,ITF5,17,Basilicata,Basilicata,559084,156296,27.96,0.17
220,2021-03-26,BAS,1957,703,1254,1696,261,ITF,ITF5,17,Basilicata,Basilicata,559084,158253,28.31,0.35
221,2021-02-20,BAS,1161,531,630,1043,118,ITF,ITF5,17,Basilicata,Basilicata,559084,159414,28.51,0.21
222,2021-05-24,BAS,4824,2340,2484,1103,3721,ITF,ITF5,17,Basilicata,Basilicata,559084,164238,29.38,0.86
223,2021-01-23,BAS,718,303,415,33,685,ITF,ITF5,17,Basilicata,Basilicata,559084,164956,29.5,0.13
224,2021-04-14,BAS,2049,1002,1047,1375,674,ITF,ITF5,17,Basilicata,Basilicata,559084,167005,29.87,0.37
225,2021-02-09,BAS,491,213,278,316,175,ITF,ITF5,17,Basilicata,Basilicata,559084,167496,29.96,0.09
226,2021-03-11,BAS,1787,921,866,828,959,ITF,ITF5,17,Basilicata,Basilicata,559084,169283,30.28,0.32
227,2021-01-06,BAS,294,129,165,294,0,ITF,ITF5,17,Basilicata,Basilicata,559084,169577,30.33,0.05
228,2021-03-28,BAS,2139,741,1398,2122,17,ITF,ITF5,17,Basilicata,Basilicata,559084,171716,30.71,0.38
229,2021-01-04,BAS,607,271,336,607,0,ITF,ITF5,17,Basilicata,Basilicata,559084,172323,30.82,0.11
230,2021-01-21,BAS,30,10,20,30,0,ITF,ITF5,17,Basilicata,Basilicata,559084,172353,30.83,0.01
231,2021-05-03,BAS,4514,2044,2470,3687,827,ITF,ITF5,17,Basilicata,Basilicata,559084,176867,31.64,0.81
232,2021-03-30,BAS,2739,1156,1583,2394,345,ITF,ITF5,17,Basilicata,Basilicata,559084,179606,32.13,0.49
233,2020-12-27,BAS,106,41,65,106,0,ITF,ITF5,17,Basilicata,Basilicata,559084,179712,32.14,0.02
234,2021-02-15,BAS,622,232,390,580,42,ITF,ITF5,17,Basilicata,Basilicata,559084,180334,32.26,0.11
235,2021-05-27,BAS,3601,1853,1748,1078,2523,ITF,ITF5,17,Basilicata,Basilicata,559084,183935,32.9,0.64
236,2021-01-16,BAS,721,304,417,721,0,ITF,ITF5,17,Basilicata,Basilicata,559084,184656,33.03,0.13
237,2021-02-28,BAS,804,343,461,775,29,ITF,ITF5,17,Basilicata,Basilicata,559084,185460,33.17,0.14
238,2021-01-09,BAS,557,160,397,557,0,ITF,ITF5,17,Basilicata,Basilicata,559084,186017,33.27,0.1
239,2021-05-07,BAS,4644,2283,2361,3288,1356,ITF,ITF5,17,Basilicata,Basilicata,559084,190661,34.1,0.83
240,2021-03-18,BAS,1349,563,786,25,1324,ITF,ITF5,17,Basilicata,Basilicata,559084,192010,34.34,0.24
241,2021-04-28,BAS,4704,2158,2546,4263,441,ITF,ITF5,17,Basilicata,Basilicata,559084,196714,35.19,0.84
242,2021-03-02,BAS,803,389,414,658,145,ITF,ITF5,17,Basilicata,Basilicata,559084,197517,35.33,0.14
243,2021-04-21,BAS,3921,1835,2086,2271,1650,ITF,ITF5,17,Basilicata,Basilicata,559084,201438,36.03,0.7
244,2021-01-25,BAS,1023,429,594,74,949,ITF,ITF5,17,Basilicata,Basilicata,559084,202461,36.21,0.18
245,2021-01-18,BAS,463,157,306,364,99,ITF,ITF5,17,Basilicata,Basilicata,559084,202924,36.3,0.08
246,2021-03-16,BAS,1902,801,1101,228,1674,ITF,ITF5,17,Basilicata,Basilicata,559084,204826,36.64,0.34
247,2021-05-05,BAS,4334,2047,2287,3444,890,ITF,ITF5,17,Basilicata,Basilicata,559084,209160,37.41,0.78
248,2021-03-09,BAS,1392,707,685,788,604,ITF,ITF5,17,Basilicata,Basilicata,559084,210552,37.66,0.25
249,2021-01-11,BAS,183,66,117,183,0,ITF,ITF5,17,Basilicata,Basilicata,559084,210735,37.69,0.03
250,2021-03-14,BAS,1008,477,531,539,469,ITF,ITF5,17,Basilicata,Basilicata,559084,211743,37.87,0.18
251,2021-05-17,BAS,5542,2735,2807,3409,2133,ITF,ITF5,17,Basilicata,Basilicata,559084,217285,38.86,0.99
252,2021-03-12,BAS,1899,976,923,800,1099,ITF,ITF5,17,Basilicata,Basilicata,559084,219184,39.2,0.34
253,2021-01-20,BAS,84,22,62,84,0,ITF,ITF5,17,Basilicata,Basilicata,559084,219268,39.22,0.02
254,2021-02-25,BAS,1787,736,1051,1741,46,ITF,ITF5,17,Basilicata,Basilicata,559084,221055,39.54,0.32
255,2021-02-06,BAS,902,367,535,146,756,ITF,ITF5,17,Basilicata,Basilicata,559084,221957,39.7,0.16
256,2021-04-30,BAS,5284,2373,2911,4121,1163,ITF,ITF5,17,Basilicata,Basilicata,559084,227241,40.65,0.95
257,2021-01-12,BAS,217,88,129,217,0,ITF,ITF5,17,Basilicata,Basilicata,559084,227458,40.68,0.04
258,2021-03-21,BAS,1046,481,565,352,694,ITF,ITF5,17,Basilicata,Basilicata,559084,228504,40.87,0.19
259,2021-01-13,BAS,916,387,529,916,0,ITF,ITF5,17,Basilicata,Basilicata,559084,229420,41.03,0.16
260,2021-01-30,BAS,704,227,477,128,576,ITF,ITF5,17,Basilicata,Basilicata,559084,230124,41.16,0.13
261,2021-03-10,BAS,1674,837,837,835,839,ITF,ITF5,17,Basilicata,Basilicata,559084,231798,41.46,0.3
262,2021-05-06,BAS,5053,2435,2618,3484,1569,ITF,ITF5,17,Basilicata,Basilicata,559084,236851,42.36,0.9
263,2021-02-02,BAS,367,143,224,175,192,ITF,ITF5,17,Basilicata,Basilicata,559084,237218,42.43,0.07
264,2021-02-23,BAS,1901,771,1130,1763,138,ITF,ITF5,17,Basilicata,Basilicata,559084,239119,42.77,0.34
265,2021-03-31,BAS,3095,1258,1837,2313,782,ITF,ITF5,17,Basilicata,Basilicata,559084,242214,43.32,0.55
266,2021-02-08,BAS,557,193,364,151,406,ITF,ITF5,17,Basilicata,Basilicata,559084,242771,43.42,0.1
267,2021-05-19,BAS,2870,1498,1372,1194,1676,ITF,ITF5,17,Basilicata,Basilicata,559084,245641,43.94,0.51
268,2021-03-19,BAS,2290,992,1298,262,2028,ITF,ITF5,17,Basilicata,Basilicata,559084,247931,44.35,0.41
269,2021-01-28,BAS,903,401,502,119,784,ITF,ITF5,17,Basilicata,Basilicata,559084,248834,44.51,0.16
270,2021-01-14,BAS,969,413,556,969,0,ITF,ITF5,17,Basilicata,Basilicata,559084,249803,44.68,0.17
271,2021-04-25,BAS,2985,1458,1527,2932,53,ITF,ITF5,17,Basilicata,Basilicata,559084,252788,45.21,0.53
272,2021-01-02,BAS,949,380,569,949,0,ITF,ITF5,17,Basilicata,Basilicata,559084,253737,45.38,0.17
273,2021-04-26,BAS,4464,2164,2300,4244,220,ITF,ITF5,17,Basilicata,Basilicata,559084,258201,46.18,0.8
274,2021-02-21,BAS,284,113,171,284,0,ITF,ITF5,17,Basilicata,Basilicata,559084,258485,46.23,0.05
275,2021-03-07,BAS,887,309,578,849,38,ITF,ITF5,17,Basilicata,Basilicata,559084,259372,46.39,0.16
276,2021-05-14,BAS,5906,2797,3109,3374,2532,ITF,ITF5,17,Basilicata,Basilicata,559084,265278,47.45,1.06
277,2021-05-22,BAS,5601,2786,2815,2049,3552,ITF,ITF5,17,Basilicata,Basilicata,559084,270879,48.45,1.0
278,2021-02-13,BAS,799,313,486,738,61,ITF,ITF5,17,Basilicata,Basilicata,559084,271678,48.59,0.14
279,2021-04-18,BAS,3720,1847,1873,2353,1367,ITF,ITF5,17,Basilicata,Basilicata,559084,275398,49.26,0.67
280,2021-02-18,BAS,1070,401,669,855,215,ITF,ITF5,17,Basilicata,Basilicata,559084,276468,49.45,0.19
281,2021-05-10,BAS,4806,2383,2423,2766,2040,ITF,ITF5,17,Basilicata,Basilicata,559084,281274,50.31,0.86
282,2021-04-23,BAS,4530,2179,2351,3530,1000,ITF,ITF5,17,Basilicata,Basilicata,559084,285804,51.12,0.81
283,2021-02-04,BAS,1095,442,653,63,1032,ITF,ITF5,17,Basilicata,Basilicata,559084,286899,51.32,0.2
284,2021-04-09,BAS,1153,350,803,1090,63,ITF,ITF5,17,Basilicata,Basilicata,559084,288052,51.52,0.21
285,2021-05-15,BAS,6527,3341,3186,3955,2572,ITF,ITF5,17,Basilicata,Basilicata,559084,294579,52.69,1.17
286,2021-02-27,BAS,1991,859,1132,1827,164,ITF,ITF5,17,Basilicata,Basilicata,559084,296570,53.05,0.36
287,2021-04-11,BAS,848,330,518,786,62,ITF,ITF5,17,Basilicata,Basilicata,559084,297418,53.2,0.15
288,2021-04-04,BAS,610,225,385,197,413,ITF,ITF5,17,Basilicata,Basilicata,559084,298028,53.31,0.11
289,2021-04-16,BAS,3320,1633,1687,2421,899,ITF,ITF5,17,Basilicata,Basilicata,559084,301348,53.9,0.59
290,2021-02-16,BAS,905,377,528,807,98,ITF,ITF5,17,Basilicata,Basilicata,559084,302253,54.06,0.16
291,2021-04-07,BAS,1218,549,669,1181,37,ITF,ITF5,17,Basilicata,Basilicata,559084,303471,54.28,0.22
292,2021-04-06,BAS,1267,461,806,1083,184,ITF,ITF5,17,Basilicata,Basilicata,559084,304738,54.51,0.23
293,2021-02-01,BAS,242,91,151,46,196,ITF,ITF5,17,Basilicata,Basilicata,559084,304980,54.55,0.04
294,2021-05-26,BAS,4474,2248,2226,1707,2767,ITF,ITF5,17,Basilicata,Basilicata,559084,309454,55.35,0.8
295,2021-05-12,BAS,4722,2324,2398,2839,1883,ITF,ITF5,17,Basilicata,Basilicata,559084,314176,56.19,0.84
296,2021-03-23,BAS,1584,608,976,1409,175,ITF,ITF5,17,Basilicata,Basilicata,559084,315760,56.48,0.28
297,2021-03-04,BAS,1877,892,985,1082,795,ITF,ITF5,17,Basilicata,Basilicata,559084,317637,56.81,0.34
298,2021-04-26,LIG,10450,4916,5534,7824,2626,ITC,ITC3,7,Liguria,Liguria,1550640,10450,0.67,0.67
299,2021-02-21,LIG,869,491,378,865,4,ITC,ITC3,7,Liguria,Liguria,1550640,11319,0.73,0.06
300,2021-02-04,LIG,2817,986,1831,179,2638,ITC,ITC3,7,Liguria,Liguria,1550640,14136,0.91,0.18
301,2021-01-18,LIG,2135,745,1390,1978,157,ITC,ITC3,7,Liguria,Liguria,1550640,16271,1.05,0.14
302,2021-03-26,LIG,9122,3854,5268,5968,3154,ITC,ITC3,7,Liguria,Liguria,1550640,25393,1.64,0.59
303,2021-02-18,LIG,2762,1126,1636,2431,331,ITC,ITC3,7,Liguria,Liguria,1550640,28155,1.82,0.18
304,2021-05-14,LIG,12881,5649,7232,8583,4298,ITC,ITC3,7,Liguria,Liguria,1550640,41036,2.65,0.83
305,2021-02-20,LIG,1336,637,699,1335,1,ITC,ITC3,7,Liguria,Liguria,1550640,42372,2.73,0.09
306,2021-02-02,LIG,2668,1005,1663,134,2534,ITC,ITC3,7,Liguria,Liguria,1550640,45040,2.9,0.17
307,2021-05-15,LIG,7171,3188,3983,4298,2873,ITC,ITC3,7,Liguria,Liguria,1550640,52211,3.37,0.46
308,2021-01-16,LIG,1278,557,721,1278,0,ITC,ITC3,7,Liguria,Liguria,1550640,53489,3.45,0.08
309,2021-04-28,LIG,14448,6520,7928,6460,7988,ITC,ITC3,7,Liguria,Liguria,1550640,67937,4.38,0.93
310,2020-12-30,LIG,12,5,7,12,0,ITC,ITC3,7,Liguria,Liguria,1550640,67949,4.38,0.0
311,2021-04-11,LIG,4249,1931,2318,4000,249,ITC,ITC3,7,Liguria,Liguria,1550640,72198,4.66,0.27
312,2021-03-31,LIG,11844,5207,6637,9074,2770,ITC,ITC3,7,Liguria,Liguria,1550640,84042,5.42,0.76
313,2021-04-09,LIG,12423,5556,6867,10684,1739,ITC,ITC3,7,Liguria,Liguria,1550640,96465,6.22,0.8
314,2020-12-28,LIG,80,30,50,80,0,ITC,ITC3,7,Liguria,Liguria,1550640,96545,6.23,0.01
315,2021-02-25,LIG,3455,1349,2106,3325,130,ITC,ITC3,7,Liguria,Liguria,1550640,100000,6.45,0.22
316,2021-04-30,LIG,14350,6392,7958,5780,8570,ITC,ITC3,7,Liguria,Liguria,1550640,114350,7.37,0.93
317,2021-03-06,LIG,3304,1842,1462,2599,705,ITC,ITC3,7,Liguria,Liguria,1550640,117654,7.59,0.21
318,2021-03-14,LIG,1658,752,906,1054,604,ITC,ITC3,7,Liguria,Liguria,1550640,119312,7.69,0.11
319,2021-01-23,LIG,809,295,514,153,656,ITC,ITC3,7,Liguria,Liguria,1550640,120121,7.75,0.05
320,2021-05-17,LIG,11837,5364,6473,8535,3302,ITC,ITC3,7,Liguria,Liguria,1550640,131958,8.51,0.76
321,2021-01-30,LIG,1661,567,1094,25,1636,ITC,ITC3,7,Liguria,Liguria,1550640,133619,8.62,0.11
322,2021-03-28,LIG,1142,511,631,391,751,ITC,ITC3,7,Liguria,Liguria,1550640,134761,8.69,0.07
323,2021-05-10,LIG,12506,5505,7001,6132,6374,ITC,ITC3,7,Liguria,Liguria,1550640,147267,9.5,0.81
324,2021-05-03,LIG,13269,5920,7349,6457,6812,ITC,ITC3,7,Liguria,Liguria,1550640,160536,10.35,0.86
325,2021-03-21,LIG,552,221,331,69,483,ITC,ITC3,7,Liguria,Liguria,1550640,161088,10.39,0.04
326,2021-02-06,LIG,1892,768,1124,145,1747,ITC,ITC3,7,Liguria,Liguria,1550640,162980,10.51,0.12
327,2021-01-02,LIG,691,245,446,691,0,ITC,ITC3,7,Liguria,Liguria,1550640,163671,10.56,0.04
328,2021-03-07,LIG,1857,1084,773,1556,301,ITC,ITC3,7,Liguria,Liguria,1550640,165528,10.67,0.12
329,2021-03-09,LIG,5932,2754,3178,4502,1430,ITC,ITC3,7,Liguria,Liguria,1550640,171460,11.06,0.38
330,2021-01-21,LIG,1103,385,718,672,431,ITC,ITC3,7,Liguria,Liguria,1550640,172563,11.13,0.07
331,2021-01-14,LIG,2981,1055,1926,2981,0,ITC,ITC3,7,Liguria,Liguria,1550640,175544,11.32,0.19
332,2021-03-12,LIG,6150,2814,3336,3681,2469,ITC,ITC3,7,Liguria,Liguria,1550640,181694,11.72,0.4
333,2021-01-28,LIG,2847,971,1876,39,2808,ITC,ITC3,7,Liguria,Liguria,1550640,184541,11.9,0.18
334,2021-01-09,LIG,1335,481,854,1335,0,ITC,ITC3,7,Liguria,Liguria,1550640,185876,11.99,0.09
335,2021-04-04,LIG,756,366,390,507,249,ITC,ITC3,7,Liguria,Liguria,1550640,186632,12.04,0.05
336,2021-02-13,LIG,1080,508,572,800,280,ITC,ITC3,7,Liguria,Liguria,1550640,187712,12.11,0.07
337,2021-04-23,LIG,14675,6639,8036,8555,6120,ITC,ITC3,7,Liguria,Liguria,1550640,202387,13.05,0.95
338,2021-04-16,LIG,11973,5281,6692,10162,1811,ITC,ITC3,7,Liguria,Liguria,1550640,214360,13.82,0.77
339,2021-03-11,LIG,6352,3054,3298,4346,2006,ITC,ITC3,7,Liguria,Liguria,1550640,220712,14.23,0.41
340,2021-01-13,LIG,2754,1013,1741,2754,0,ITC,ITC3,7,Liguria,Liguria,1550640,223466,14.41,0.18
341,2021-02-28,LIG,1060,581,479,1051,9,ITC,ITC3,7,Liguria,Liguria,1550640,224526,14.48,0.07
342,2021-04-19,LIG,12812,5617,7195,9003,3809,ITC,ITC3,7,Liguria,Liguria,1550640,237338,15.31,0.83
343,2021-05-24,LIG,11658,5424,6234,9178,2480,ITC,ITC3,7,Liguria,Liguria,1550640,248996,16.06,0.75
344,2021-05-07,LIG,13571,6026,7545,5806,7765,ITC,ITC3,7,Liguria,Liguria,1550640,262567,16.93,0.88
345,2021-04-07,LIG,13585,6032,7553,11296,2289,ITC,ITC3,7,Liguria,Liguria,1550640,276152,17.81,0.88
346,2021-02-23,LIG,3806,1559,2247,3697,109,ITC,ITC3,7,Liguria,Liguria,1550640,279958,18.05,0.25
347,2021-03-04,LIG,4738,2118,2620,3891,847,ITC,ITC3,7,Liguria,Liguria,1550640,284696,18.36,0.31
348,2021-05-02,LIG,3872,1768,2104,500,3372,ITC,ITC3,7,Liguria,Liguria,1550640,288568,18.61,0.25
349,2021-05-27,LIG,16257,8201,8056,12371,3886,ITC,ITC3,7,Liguria,Liguria,1550640,304825,19.66,1.05
350,2021-02-09,LIG,1937,690,1247,257,1680,ITC,ITC3,7,Liguria,Liguria,1550640,306762,19.78,0.12
351,2021-02-16,LIG,2397,954,1443,2004,393,ITC,ITC3,7,Liguria,Liguria,1550640,309159,19.94,0.15
352,2021-04-14,LIG,13029,5659,7370,10826,2203,ITC,ITC3,7,Liguria,Liguria,1550640,322188,20.78,0.84
353,2021-01-04,LIG,2617,855,1762,2617,0,ITC,ITC3,7,Liguria,Liguria,1550640,324805,20.95,0.17
354,2021-03-02,LIG,4074,1689,2385,3764,310,ITC,ITC3,7,Liguria,Liguria,1550640,328879,21.21,0.26
355,2021-04-21,LIG,14246,6432,7814,8923,5323,ITC,ITC3,7,Liguria,Liguria,1550640,343125,22.13,0.92
356,2021-05-05,LIG,13710,6138,7572,5292,8418,ITC,ITC3,7,Liguria,Liguria,1550640,356835,23.01,0.88
357,2021-03-16,LIG,6073,2722,3351,2349,3724,ITC,ITC3,7,Liguria,Liguria,1550640,362908,23.4,0.39
358,2021-01-11,LIG,2654,990,1664,2654,0,ITC,ITC3,7,Liguria,Liguria,1550640,365562,23.57,0.17
359,2021-01-25,LIG,2725,889,1836,478,2247,ITC,ITC3,7,Liguria,Liguria,1550640,368287,23.75,0.18
360,2021-05-12,LIG,11938,5353,6585,6598,5340,ITC,ITC3,7,Liguria,Liguria,1550640,380225,24.52,0.77
361,2021-05-19,LIG,13518,5944,7574,10410,3108,ITC,ITC3,7,Liguria,Liguria,1550640,393743,25.39,0.87
362,2021-03-23,LIG,9036,4082,4954,5827,3209,ITC,ITC3,7,Liguria,Liguria,1550640,402779,25.98,0.58
363,2021-02-01,LIG,2558,923,1635,90,2468,ITC,ITC3,7,Liguria,Liguria,1550640,405337,26.14,0.16
364,2021-05-26,LIG,16120,7994,8126,11967,4153,ITC,ITC3,7,Liguria,Liguria,1550640,421457,27.18,1.04
365,2021-03-30,LIG,12147,5379,6768,8758,3389,ITC,ITC3,7,Liguria,Liguria,1550640,433604,27.96,0.78
366,2021-05-09,LIG,2822,1242,1580,1112,1710,ITC,ITC3,7,Liguria,Liguria,1550640,436426,28.14,0.18
367,2021-01-22,LIG,1818,604,1214,1332,486,ITC,ITC3,7,Liguria,Liguria,1550640,438244,28.26,0.12
368,2021-05-04,LIG,13603,6081,7522,5376,8227,ITC,ITC3,7,Liguria,Liguria,1550640,451847,29.14,0.88
369,2021-04-05,LIG,3976,1751,2225,2327,1649,ITC,ITC3,7,Liguria,Liguria,1550640,455823,29.4,0.26
370,2021-03-25,LIG,9594,4080,5514,6201,3393,ITC,ITC3,7,Liguria,Liguria,1550640,465417,30.01,0.62
371,2021-03-08,LIG,5622,2456,3166,3933,1689,ITC,ITC3,7,Liguria,Liguria,1550640,471039,30.38,0.36
372,2021-02-19,LIG,3213,1305,1908,3037,176,ITC,ITC3,7,Liguria,Liguria,1550640,474252,30.58,0.21
373,2021-01-01,LIG,144,55,89,144,0,ITC,ITC3,7,Liguria,Liguria,1550640,474396,30.59,0.01
374,2021-04-13,LIG,13052,5860,7192,11031,2021,ITC,ITC3,7,Liguria,Liguria,1550640,487448,31.44,0.84
375,2021-03-27,LIG,3921,1538,2383,2525,1396,ITC,ITC3,7,Liguria,Liguria,1550640,491369,31.69,0.25
376,2021-05-13,LIG,13038,5850,7188,8823,4215,ITC,ITC3,7,Liguria,Liguria,1550640,504407,32.53,0.84
377,2021-03-10,LIG,5878,2840,3038,3972,1906,ITC,ITC3,7,Liguria,Liguria,1550640,510285,32.91,0.38
378,2021-03-19,LIG,5296,2235,3061,2149,3147,ITC,ITC3,7,Liguria,Liguria,1550640,515581,33.25,0.34
379,2021-05-08,LIG,7537,3332,4205,2323,5214,ITC,ITC3,7,Liguria,Liguria,1550640,523118,33.74,0.49
380,2021-02-11,LIG,1974,767,1207,1103,871,ITC,ITC3,7,Liguria,Liguria,1550640,525092,33.86,0.13
381,2021-05-22,LIG,6551,3195,3356,4943,1608,ITC,ITC3,7,Liguria,Liguria,1550640,531643,34.29,0.42
382,2021-04-02,LIG,11671,5117,6554,9185,2486,ITC,ITC3,7,Liguria,Liguria,1550640,543314,35.04,0.75
383,2021-04-08,LIG,13727,6157,7570,11683,2044,ITC,ITC3,7,Liguria,Liguria,1550640,557041,35.92,0.89
384,2021-02-17,LIG,2689,1181,1508,2263,426,ITC,ITC3,7,Liguria,Liguria,1550640,559730,36.1,0.17
385,2021-01-05,LIG,2879,896,1983,2879,0,ITC,ITC3,7,Liguria,Liguria,1550640,562609,36.28,0.19
386,2021-04-22,LIG,13823,6196,7627,8749,5074,ITC,ITC3,7,Liguria,Liguria,1550640,576432,37.17,0.89
387,2021-04-17,LIG,7383,3217,4166,6633,750,ITC,ITC3,7,Liguria,Liguria,1550640,583815,37.65,0.48
388,2021-01-07,LIG,3229,1095,2134,3229,0,ITC,ITC3,7,Liguria,Liguria,1550640,587044,37.86,0.21
389,2021-05-01,LIG,7134,3255,3879,1332,5802,ITC,ITC3,7,Liguria,Liguria,1550640,594178,38.32,0.46
390,2021-03-05,LIG,4869,2150,2719,3737,1132,ITC,ITC3,7,Liguria,Liguria,1550640,599047,38.63,0.31
391,2021-04-24,LIG,8170,3785,4385,5018,3152,ITC,ITC3,7,Liguria,Liguria,1550640,607217,39.16,0.53
392,2021-02-22,LIG,3334,1467,1867,3192,142,ITC,ITC3,7,Liguria,Liguria,1550640,610551,39.37,0.22
393,2021-04-27,LIG,14739,6677,8062,7160,7579,ITC,ITC3,7,Liguria,Liguria,1550640,625290,40.32,0.95
394,2021-04-29,LIG,15551,6975,8576,6732,8819,ITC,ITC3,7,Liguria,Liguria,1550640,640841,41.33,1.0
395,2021-01-17,LIG,862,300,562,862,0,ITC,ITC3,7,Liguria,Liguria,1550640,641703,41.38,0.06
396,2021-04-12,LIG,12383,5475,6908,10364,2019,ITC,ITC3,7,Liguria,Liguria,1550640,654086,42.18,0.8
397,2021-01-19,LIG,1371,438,933,1281,90,ITC,ITC3,7,Liguria,Liguria,1550640,655457,42.27,0.09
398,2021-03-24,LIG,8942,3834,5108,5654,3288,ITC,ITC3,7,Liguria,Liguria,1550640,664399,42.85,0.58
399,2021-04-18,LIG,2584,1151,1433,2115,469,ITC,ITC3,7,Liguria,Liguria,1550640,666983,43.01,0.17
400,2021-01-27,LIG,1744,603,1141,141,1603,ITC,ITC3,7,Liguria,Liguria,1550640,668727,43.13,0.11
401,2021-05-21,LIG,12839,5952,6887,9714,3125,ITC,ITC3,7,Liguria,Liguria,1550640,681566,43.95,0.83
402,2021-03-18,LIG,4982,2124,2858,2009,2973,ITC,ITC3,7,Liguria,Liguria,1550640,686548,44.28,0.32
403,2021-04-01,LIG,12378,5468,6910,9608,2770,ITC,ITC3,7,Liguria,Liguria,1550640,698926,45.07,0.8
404,2021-01-26,LIG,2484,803,1681,13,2471,ITC,ITC3,7,Liguria,Liguria,1550640,701410,45.23,0.16
405,2021-01-06,LIG,1660,616,1044,1660,0,ITC,ITC3,7,Liguria,Liguria,1550640,703070,45.34,0.11
406,2021-01-15,LIG,2256,754,1502,2256,0,ITC,ITC3,7,Liguria,Liguria,1550640,705326,45.49,0.15
407,2021-04-25,LIG,1936,921,1015,1521,415,ITC,ITC3,7,Liguria,Liguria,1550640,707262,45.61,0.12
408,2021-03-13,LIG,3827,1616,2211,2972,855,ITC,ITC3,7,Liguria,Liguria,1550640,711089,45.86,0.25
409,2021-03-20,LIG,2316,995,1321,1142,1174,ITC,ITC3,7,Liguria,Liguria,1550640,713405,46.01,0.15
410,2021-02-03,LIG,2315,791,1524,55,2260,ITC,ITC3,7,Liguria,Liguria,1550640,715720,46.16,0.15
411,2021-05-16,LIG,3694,1855,1839,2134,1560,ITC,ITC3,7,Liguria,Liguria,1550640,719414,46.39,0.24
412,2021-02-05,LIG,2675,986,1689,304,2371,ITC,ITC3,7,Liguria,Liguria,1550640,722089,46.57,0.17
413,2021-04-10,LIG,7887,3558,4329,6973,914,ITC,ITC3,7,Liguria,Liguria,1550640,729976,47.08,0.51
414,2020-12-31,LIG,989,354,635,989,0,ITC,ITC3,7,Liguria,Liguria,1550640,730965,47.14,0.06
415,2021-01-31,LIG,624,270,354,9,615,ITC,ITC3,7,Liguria,Liguria,1550640,731589,47.18,0.04
416,2021-04-06,LIG,13171,5857,7314,10931,2240,ITC,ITC3,7,Liguria,Liguria,1550640,744760,48.03,0.85
417,2021-02-08,LIG,1977,742,1235,306,1671,ITC,ITC3,7,Liguria,Liguria,1550640,746737,48.16,0.13
418,2020-12-27,LIG,135,56,79,135,0,ITC,ITC3,7,Liguria,Liguria,1550640,746872,48.17,0.01
419,2021-02-15,LIG,2263,839,1424,1866,397,ITC,ITC3,7,Liguria,Liguria,1550640,749135,48.31,0.15
420,2021-01-03,LIG,734,230,504,734,0,ITC,ITC3,7,Liguria,Liguria,1550640,749869,48.36,0.05
421,2021-04-20,LIG,13775,6304,7471,9426,4349,ITC,ITC3,7,Liguria,Liguria,1550640,763644,49.25,0.89
422,2021-01-10,LIG,648,262,386,648,0,ITC,ITC3,7,Liguria,Liguria,1550640,764292,49.29,0.04
423,2021-03-01,LIG,3507,1430,2077,3385,122,ITC,ITC3,7,Liguria,Liguria,1550640,767799,49.51,0.23
424,2021-01-24,LIG,756,237,519,113,643,ITC,ITC3,7,Liguria,Liguria,1550640,768555,49.56,0.05
425,2021-03-15,LIG,7299,3075,4224,4598,2701,ITC,ITC3,7,Liguria,Liguria,1550640,775854,50.03,0.47
426,2021-05-28,LIG,15641,7769,7872,11450,4191,ITC,ITC3,7,Liguria,Liguria,1550640,791495,51.04,1.01
427,2021-04-15,LIG,11820,5221,6599,9968,1852,ITC,ITC3,7,Liguria,Liguria,1550640,803315,51.81,0.76
428,2021-03-03,LIG,4582,1847,2735,3556,1026,ITC,ITC3,7,Liguria,Liguria,1550640,807897,52.1,0.3
429,2021-02-24,LIG,3763,1560,2203,3505,258,ITC,ITC3,7,Liguria,Liguria,1550640,811660,52.34,0.24
430,2020-12-29,LIG,125,33,92,125,0,ITC,ITC3,7,Liguria,Liguria,1550640,811785,52.35,0.01
431,2021-01-12,LIG,2460,886,1574,2460,0,ITC,ITC3,7,Liguria,Liguria,1550640,814245,52.51,0.16
432,2021-01-20,LIG,1550,555,995,1538,12,ITC,ITC3,7,Liguria,Liguria,1550640,815795,52.61,0.1
433,2021-01-29,LIG,3079,1064,2015,67,3012,ITC,ITC3,7,Liguria,Liguria,1550640,818874,52.81,0.2
434,2021-05-11,LIG,13662,6174,7488,7069,6593,ITC,ITC3,7,Liguria,Liguria,1550640,832536,53.69,0.88
435,2021-03-29,LIG,10440,4511,5929,7310,3130,ITC,ITC3,7,Liguria,Liguria,1550640,842976,54.36,0.67
436,2021-01-08,LIG,2926,999,1927,2926,0,ITC,ITC3,7,Liguria,Liguria,1550640,845902,54.55,0.19
437,2021-02-27,LIG,1888,921,967,1759,129,ITC,ITC3,7,Liguria,Liguria,1550640,847790,54.67,0.12
438,2021-02-10,LIG,2312,837,1475,1020,1292,ITC,ITC3,7,Liguria,Liguria,1550640,850102,54.82,0.15
439,2021-05-06,LIG,14475,6408,8067,6174,8301,ITC,ITC3,7,Liguria,Liguria,1550640,864577,55.76,0.93
440,2021-03-17,LIG,5553,2369,3184,2474,3079,ITC,ITC3,7,Liguria,Liguria,1550640,870130,56.11,0.36
441,2021-05-25,LIG,13713,6597,7116,10734,2979,ITC,ITC3,7,Liguria,Liguria,1550640,883843,57.0,0.88
442,2021-03-22,LIG,7666,3401,4265,4730,2936,ITC,ITC3,7,Liguria,Liguria,1550640,891509,57.49,0.49
443,2021-05-18,LIG,13338,6017,7321,10052,3286,ITC,ITC3,7,Liguria,Liguria,1550640,904847,58.35,0.86
444,2021-02-14,LIG,233,122,111,233,0,ITC,ITC3,7,Liguria,Liguria,1550640,905080,58.37,0.02
445,2021-02-07,LIG,407,153,254,2,405,ITC,ITC3,7,Liguria,Liguria,1550640,905487,58.39,0.03
446,2021-05-20,LIG,12808,5939,6869,8791,4017,ITC,ITC3,7,Liguria,Liguria,1550640,918295,59.22,0.83
447,2021-05-23,LIG,2305,1119,1186,1182,1123,ITC,ITC3,7,Liguria,Liguria,1550640,920600,59.37,0.15
448,2021-04-03,LIG,5406,2498,2908,4463,943,ITC,ITC3,7,Liguria,Liguria,1550640,926006,59.72,0.35
449,2021-02-12,LIG,1931,691,1240,899,1032,ITC,ITC3,7,Liguria,Liguria,1550640,927937,59.84,0.12
450,2021-02-26,LIG,3767,1524,2243,3439,328,ITC,ITC3,7,Liguria,Liguria,1550640,931704,60.09,0.24
451,2021-05-12,LAZ,47393,21470,25923,30877,16516,ITI,ITI4,12,Lazio,Lazio,5879082,47393,0.81,0.81
452,2021-01-30,LAZ,7009,2891,4118,807,6202,ITI,ITI4,12,Lazio,Lazio,5879082,54402,0.93,0.12
453,2021-01-13,LAZ,5677,2147,3530,5677,0,ITI,ITI4,12,Lazio,Lazio,5879082,60079,1.02,0.1
454,2021-04-25,LAZ,24470,11198,13272,16660,7810,ITI,ITI4,12,Lazio,Lazio,5879082,84549,1.44,0.42
455,2020-12-27,LAZ,273,131,142,273,0,ITI,ITI4,12,Lazio,Lazio,5879082,84822,1.44,0.0
456,2021-04-08,LAZ,26647,12172,14475,18965,7682,ITI,ITI4,12,Lazio,Lazio,5879082,111469,1.9,0.45
457,2021-03-21,LAZ,17857,6826,11031,12807,5050,ITI,ITI4,12,Lazio,Lazio,5879082,129326,2.2,0.3
458,2021-04-09,LAZ,27295,12266,15029,19074,8221,ITI,ITI4,12,Lazio,Lazio,5879082,156621,2.66,0.46
459,2021-03-04,LAZ,18653,8014,10639,13637,5016,ITI,ITI4,12,Lazio,Lazio,5879082,175274,2.98,0.32
460,2020-12-30,LAZ,1630,629,1001,1630,0,ITI,ITI4,12,Lazio,Lazio,5879082,176904,3.01,0.03
461,2021-03-06,LAZ,18295,7049,11246,14038,4257,ITI,ITI4,12,Lazio,Lazio,5879082,195199,3.32,0.31
462,2021-01-29,LAZ,8042,3079,4963,813,7229,ITI,ITI4,12,Lazio,Lazio,5879082,203241,3.46,0.14
463,2021-02-18,LAZ,10017,4976,5041,9208,809,ITI,ITI4,12,Lazio,Lazio,5879082,213258,3.63,0.17
464,2021-04-23,LAZ,37624,18057,19567,22390,15234,ITI,ITI4,12,Lazio,Lazio,5879082,250882,4.27,0.64
465,2021-02-01,LAZ,5675,2177,3498,354,5321,ITI,ITI4,12,Lazio,Lazio,5879082,256557,4.36,0.1
466,2021-04-06,LAZ,23878,10653,13225,16776,7102,ITI,ITI4,12,Lazio,Lazio,5879082,280435,4.77,0.41
467,2021-01-15,LAZ,6572,2704,3868,6572,0,ITI,ITI4,12,Lazio,Lazio,5879082,287007,4.88,0.11
468,2021-03-20,LAZ,18224,6810,11414,12340,5884,ITI,ITI4,12,Lazio,Lazio,5879082,305231,5.19,0.31
469,2021-04-04,LAZ,17463,8036,9427,12197,5266,ITI,ITI4,12,Lazio,Lazio,5879082,322694,5.49,0.3
470,2021-02-20,LAZ,9203,4272,4931,8436,767,ITI,ITI4,12,Lazio,Lazio,5879082,331897,5.65,0.16
471,2021-03-01,LAZ,17084,7344,9740,13199,3885,ITI,ITI4,12,Lazio,Lazio,5879082,348981,5.94,0.29
472,2021-04-30,LAZ,41223,18255,22968,27056,14167,ITI,ITI4,12,Lazio,Lazio,5879082,390204,6.64,0.7
473,2021-05-07,LAZ,48123,22558,25565,30417,17706,ITI,ITI4,12,Lazio,Lazio,5879082,438327,7.46,0.82
474,2021-03-18,LAZ,14224,6077,8147,7834,6390,ITI,ITI4,12,Lazio,Lazio,5879082,452551,7.7,0.24
475,2021-02-03,LAZ,6488,2488,4000,964,5524,ITI,ITI4,12,Lazio,Lazio,5879082,459039,7.81,0.11
476,2021-03-11,LAZ,23792,10581,13211,17563,6229,ITI,ITI4,12,Lazio,Lazio,5879082,482831,8.21,0.4
477,2021-01-20,LAZ,4806,1942,2864,3263,1543,ITI,ITI4,12,Lazio,Lazio,5879082,487637,8.29,0.08
478,2021-05-14,LAZ,50716,23147,27569,32511,18205,ITI,ITI4,12,Lazio,Lazio,5879082,538353,9.16,0.86
479,2021-03-25,LAZ,26913,11510,15403,20312,6601,ITI,ITI4,12,Lazio,Lazio,5879082,565266,9.61,0.46
480,2021-01-27,LAZ,6114,2387,3727,997,5117,ITI,ITI4,12,Lazio,Lazio,5879082,571380,9.72,0.1
481,2021-05-26,LAZ,45853,20477,25376,34870,10983,ITI,ITI4,12,Lazio,Lazio,5879082,617233,10.5,0.78
482,2021-03-23,LAZ,23496,10225,13271,16919,6577,ITI,ITI4,12,Lazio,Lazio,5879082,640729,10.9,0.4
483,2021-02-15,LAZ,8024,3540,4484,7393,631,ITI,ITI4,12,Lazio,Lazio,5879082,648753,11.03,0.14
484,2021-05-28,LAZ,54406,24861,29545,42446,11960,ITI,ITI4,12,Lazio,Lazio,5879082,703159,11.96,0.93
485,2021-02-17,LAZ,9181,4603,4578,8307,874,ITI,ITI4,12,Lazio,Lazio,5879082,712340,12.12,0.16
486,2021-03-27,LAZ,26009,10395,15614,19539,6470,ITI,ITI4,12,Lazio,Lazio,5879082,738349,12.56,0.44
487,2021-05-23,LAZ,46946,22707,24239,39684,7262,ITI,ITI4,12,Lazio,Lazio,5879082,785295,13.36,0.8
488,2021-05-09,LAZ,37521,17248,20273,26256,11265,ITI,ITI4,12,Lazio,Lazio,5879082,822816,14.0,0.64
489,2021-05-16,LAZ,50893,24505,26388,37419,13474,ITI,ITI4,12,Lazio,Lazio,5879082,873709,14.86,0.87
490,2021-04-16,LAZ,34391,15674,18717,22332,12059,ITI,ITI4,12,Lazio,Lazio,5879082,908100,15.45,0.58
491,2021-02-25,LAZ,12655,5518,7137,11605,1050,ITI,ITI4,12,Lazio,Lazio,5879082,920755,15.66,0.22
492,2021-05-21,LAZ,50214,23595,26619,37378,12836,ITI,ITI4,12,Lazio,Lazio,5879082,970969,16.52,0.85
493,2021-05-17,LAZ,43762,19981,23781,35327,8435,ITI,ITI4,12,Lazio,Lazio,5879082,1014731,17.26,0.74
494,2021-02-11,LAZ,6998,3012,3986,6467,531,ITI,ITI4,12,Lazio,Lazio,5879082,1021729,17.38,0.12
495,2021-05-24,LAZ,42732,19118,23614,33991,8741,ITI,ITI4,12,Lazio,Lazio,5879082,1064461,18.11,0.73
496,2021-02-06,LAZ,6136,2474,3662,817,5319,ITI,ITI4,12,Lazio,Lazio,5879082,1070597,18.21,0.1
497,2021-04-11,LAZ,19115,8431,10684,13234,5881,ITI,ITI4,12,Lazio,Lazio,5879082,1089712,18.54,0.33
498,2021-02-13,LAZ,6608,2626,3982,6194,414,ITI,ITI4,12,Lazio,Lazio,5879082,1096320,18.65,0.11
499,2021-01-08,LAZ,7728,2894,4834,7728,0,ITI,ITI4,12,Lazio,Lazio,5879082,1104048,18.78,0.13
500,2021-01-01,LAZ,3554,1382,2172,3554,0,ITI,ITI4,12,Lazio,Lazio,5879082,1107602,18.84,0.06
501,2021-01-23,LAZ,7212,2869,4343,583,6629,ITI,ITI4,12,Lazio,Lazio,5879082,1114814,18.96,0.12
502,2021-01-06,LAZ,5122,1961,3161,5122,0,ITI,ITI4,12,Lazio,Lazio,5879082,1119936,19.05,0.09
503,2021-04-01,LAZ,28404,13047,15357,21264,7140,ITI,ITI4,12,Lazio,Lazio,5879082,1148340,19.53,0.48
504,2021-04-15,LAZ,31909,14301,17608,21105,10804,ITI,ITI4,12,Lazio,Lazio,5879082,1180249,20.08,0.54
505,2021-02-10,LAZ,8187,3398,4789,4850,3337,ITI,ITI4,12,Lazio,Lazio,5879082,1188436,20.21,0.14
506,2021-03-28,LAZ,18837,7541,11296,13527,5310,ITI,ITI4,12,Lazio,Lazio,5879082,1207273,20.54,0.32
507,2021-04-27,LAZ,30609,13808,16801,19772,10837,ITI,ITI4,12,Lazio,Lazio,5879082,1237882,21.06,0.52
508,2021-02-22,LAZ,11456,4990,6466,10954,502,ITI,ITI4,12,Lazio,Lazio,5879082,1249338,21.25,0.19
509,2021-04-13,LAZ,25658,11868,13790,17953,7705,ITI,ITI4,12,Lazio,Lazio,5879082,1274996,21.69,0.44
510,2021-01-03,LAZ,5250,1972,3278,5250,0,ITI,ITI4,12,Lazio,Lazio,5879082,1280246,21.78,0.09
511,2021-01-10,LAZ,4039,1700,2339,4039,0,ITI,ITI4,12,Lazio,Lazio,5879082,1284285,21.84,0.07
512,2021-04-20,LAZ,30992,14225,16767,19711,11281,ITI,ITI4,12,Lazio,Lazio,5879082,1315277,22.37,0.53
513,2021-03-08,LAZ,20062,8314,11748,14789,5273,ITI,ITI4,12,Lazio,Lazio,5879082,1335339,22.71,0.34
514,2021-01-04,LAZ,7481,2908,4573,7481,0,ITI,ITI4,12,Lazio,Lazio,5879082,1342820,22.84,0.13
515,2021-03-30,LAZ,25256,11584,13672,18108,7148,ITI,ITI4,12,Lazio,Lazio,5879082,1368076,23.27,0.43
516,2021-05-19,LAZ,46428,21199,25229,36626,9802,ITI,ITI4,12,Lazio,Lazio,5879082,1414504,24.06,0.79
517,2021-02-08,LAZ,9739,4153,5586,4508,5231,ITI,ITI4,12,Lazio,Lazio,5879082,1424243,24.23,0.17
518,2021-03-16,LAZ,13538,5732,7806,7094,6444,ITI,ITI4,12,Lazio,Lazio,5879082,1437781,24.46,0.23
519,2021-03-09,LAZ,20869,8938,11931,15672,5197,ITI,ITI4,12,Lazio,Lazio,5879082,1458650,24.81,0.35
520,2021-01-11,LAZ,5530,2105,3425,5530,0,ITI,ITI4,12,Lazio,Lazio,5879082,1464180,24.9,0.09
521,2021-05-05,LAZ,46702,21424,25278,30898,15804,ITI,ITI4,12,Lazio,Lazio,5879082,1510882,25.7,0.79
522,2021-03-02,LAZ,16989,7431,9558,13055,3934,ITI,ITI4,12,Lazio,Lazio,5879082,1527871,25.99,0.29
523,2021-04-28,LAZ,32836,14989,17847,21292,11544,ITI,ITI4,12,Lazio,Lazio,5879082,1560707,26.55,0.56
524,2021-01-25,LAZ,8111,3246,4865,770,7341,ITI,ITI4,12,Lazio,Lazio,5879082,1568818,26.68,0.14
525,2021-01-18,LAZ,6267,2557,3710,5289,978,ITI,ITI4,12,Lazio,Lazio,5879082,1575085,26.79,0.11
526,2021-01-17,LAZ,4894,2028,2866,4682,212,ITI,ITI4,12,Lazio,Lazio,5879082,1579979,26.87,0.08
527,2021-04-29,LAZ,38535,17195,21340,25321,13214,ITI,ITI4,12,Lazio,Lazio,5879082,1618514,27.53,0.66
528,2021-01-26,LAZ,7958,3125,4833,724,7234,ITI,ITI4,12,Lazio,Lazio,5879082,1626472,27.67,0.14
529,2021-05-08,LAZ,45161,20604,24557,29803,15358,ITI,ITI4,12,Lazio,Lazio,5879082,1671633,28.43,0.77
530,2021-03-26,LAZ,28226,12252,15974,21383,6843,ITI,ITI4,12,Lazio,Lazio,5879082,1699859,28.91,0.48
531,2020-12-29,LAZ,488,176,312,488,0,ITI,ITI4,12,Lazio,Lazio,5879082,1700347,28.92,0.01
532,2021-03-24,LAZ,25878,11298,14580,19641,6237,ITI,ITI4,12,Lazio,Lazio,5879082,1726225,29.36,0.44
533,2021-05-27,LAZ,55845,25193,30652,43634,12211,ITI,ITI4,12,Lazio,Lazio,5879082,1782070,30.31,0.95
534,2021-03-07,LAZ,14099,5435,8664,10506,3593,ITI,ITI4,12,Lazio,Lazio,5879082,1796169,30.55,0.24
535,2021-05-10,LAZ,44119,20107,24012,30748,13371,ITI,ITI4,12,Lazio,Lazio,5879082,1840288,31.3,0.75
536,2021-03-22,LAZ,21696,9064,12632,15035,6661,ITI,ITI4,12,Lazio,Lazio,5879082,1861984,31.67,0.37
537,2021-03-05,LAZ,18793,7962,10831,14060,4733,ITI,ITI4,12,Lazio,Lazio,5879082,1880777,31.99,0.32
538,2021-04-18,LAZ,23772,10556,13216,16138,7634,ITI,ITI4,12,Lazio,Lazio,5879082,1904549,32.4,0.4
539,2021-05-02,LAZ,32620,14333,18287,23259,9361,ITI,ITI4,12,Lazio,Lazio,5879082,1937169,32.95,0.55
540,2021-02-27,LAZ,11427,4268,7159,10472,955,ITI,ITI4,12,Lazio,Lazio,5879082,1948596,33.14,0.19
541,2021-03-13,LAZ,21420,8412,13008,15526,5894,ITI,ITI4,12,Lazio,Lazio,5879082,1970016,33.51,0.36
542,2021-01-22,LAZ,4002,1633,2369,487,3515,ITI,ITI4,12,Lazio,Lazio,5879082,1974018,33.58,0.07
543,2021-05-25,LAZ,46084,21139,24945,35372,10712,ITI,ITI4,12,Lazio,Lazio,5879082,2020102,34.36,0.78
544,2021-04-12,LAZ,23756,10676,13080,16859,6897,ITI,ITI4,12,Lazio,Lazio,5879082,2043858,34.76,0.4
545,2021-02-21,LAZ,6986,3178,3808,6525,461,ITI,ITI4,12,Lazio,Lazio,5879082,2050844,34.88,0.12
546,2021-02-28,LAZ,10248,4007,6241,9734,514,ITI,ITI4,12,Lazio,Lazio,5879082,2061092,35.06,0.17
547,2021-01-09,LAZ,6294,2561,3733,6294,0,ITI,ITI4,12,Lazio,Lazio,5879082,2067386,35.17,0.11
548,2021-02-12,LAZ,6843,2845,3998,6432,411,ITI,ITI4,12,Lazio,Lazio,5879082,2074229,35.28,0.12
549,2021-04-10,LAZ,23808,10314,13494,16626,7182,ITI,ITI4,12,Lazio,Lazio,5879082,2098037,35.69,0.4
550,2021-02-05,LAZ,7277,2960,4317,1183,6094,ITI,ITI4,12,Lazio,Lazio,5879082,2105314,35.81,0.12
551,2021-04-03,LAZ,24687,11094,13593,17988,6699,ITI,ITI4,12,Lazio,Lazio,5879082,2130001,36.23,0.42
552,2020-12-31,LAZ,5293,2121,3172,5293,0,ITI,ITI4,12,Lazio,Lazio,5879082,2135294,36.32,0.09
553,2021-02-19,LAZ,10312,5198,5114,9463,849,ITI,ITI4,12,Lazio,Lazio,5879082,2145606,36.5,0.18
554,2021-05-11,LAZ,47894,21958,25936,31511,16383,ITI,ITI4,12,Lazio,Lazio,5879082,2193500,37.31,0.81
555,2021-01-31,LAZ,4458,1853,2605,475,3983,ITI,ITI4,12,Lazio,Lazio,5879082,2197958,37.39,0.08
556,2021-05-13,LAZ,49484,22170,27314,31855,17629,ITI,ITI4,12,Lazio,Lazio,5879082,2247442,38.23,0.84
557,2021-04-07,LAZ,24957,11318,13639,17653,7304,ITI,ITI4,12,Lazio,Lazio,5879082,2272399,38.65,0.42
558,2021-02-02,LAZ,5909,2213,3696,637,5272,ITI,ITI4,12,Lazio,Lazio,5879082,2278308,38.75,0.1
559,2020-12-28,LAZ,959,412,547,959,0,ITI,ITI4,12,Lazio,Lazio,5879082,2279267,38.77,0.02
560,2021-05-04,LAZ,39749,18278,21471,26275,13474,ITI,ITI4,12,Lazio,Lazio,5879082,2319016,39.45,0.68
561,2021-02-24,LAZ,12047,5204,6843,11053,994,ITI,ITI4,12,Lazio,Lazio,5879082,2331063,39.65,0.2
562,2021-01-05,LAZ,7374,2802,4572,7374,0,ITI,ITI4,12,Lazio,Lazio,5879082,2338437,39.78,0.13
563,2021-02-07,LAZ,4942,2023,2919,387,4555,ITI,ITI4,12,Lazio,Lazio,5879082,2343379,39.86,0.08
564,2021-05-03,LAZ,39092,17637,21455,26527,12565,ITI,ITI4,12,Lazio,Lazio,5879082,2382471,40.52,0.66
565,2021-03-14,LAZ,17084,6606,10478,11930,5154,ITI,ITI4,12,Lazio,Lazio,5879082,2399555,40.82,0.29
566,2021-05-15,LAZ,57035,27243,29792,40611,16424,ITI,ITI4,12,Lazio,Lazio,5879082,2456590,41.79,0.97
567,2021-03-19,LAZ,17214,7363,9851,10887,6327,ITI,ITI4,12,Lazio,Lazio,5879082,2473804,42.08,0.29
568,2021-02-04,LAZ,6302,2481,3821,987,5315,ITI,ITI4,12,Lazio,Lazio,5879082,2480106,42.19,0.11
569,2021-04-24,LAZ,33269,14965,18304,20522,12747,ITI,ITI4,12,Lazio,Lazio,5879082,2513375,42.75,0.57
570,2021-01-14,LAZ,5473,2142,3331,5473,0,ITI,ITI4,12,Lazio,Lazio,5879082,2518848,42.84,0.09
571,2021-04-26,LAZ,29135,13401,15734,19933,9202,ITI,ITI4,12,Lazio,Lazio,5879082,2547983,43.34,0.5
572,2021-01-16,LAZ,5645,2280,3365,5645,0,ITI,ITI4,12,Lazio,Lazio,5879082,2553628,43.44,0.1
573,2021-04-21,LAZ,32973,14973,18000,20611,12362,ITI,ITI4,12,Lazio,Lazio,5879082,2586601,44.0,0.56
574,2021-05-20,LAZ,50646,24164,26482,37405,13241,ITI,ITI4,12,Lazio,Lazio,5879082,2637247,44.86,0.86
575,2021-02-09,LAZ,8797,3768,5029,4580,4217,ITI,ITI4,12,Lazio,Lazio,5879082,2646044,45.01,0.15
576,2021-03-31,LAZ,26108,12046,14062,19015,7093,ITI,ITI4,12,Lazio,Lazio,5879082,2672152,45.45,0.44
577,2021-02-23,LAZ,11087,4780,6307,10326,761,ITI,ITI4,12,Lazio,Lazio,5879082,2683239,45.64,0.19
578,2021-04-05,LAZ,19889,9047,10842,13670,6219,ITI,ITI4,12,Lazio,Lazio,5879082,2703128,45.98,0.34
579,2021-04-19,LAZ,30059,13661,16398,19383,10676,ITI,ITI4,12,Lazio,Lazio,5879082,2733187,46.49,0.51
580,2021-02-14,LAZ,5772,2370,3402,5302,470,ITI,ITI4,12,Lazio,Lazio,5879082,2738959,46.59,0.1
581,2021-01-02,LAZ,6707,2631,4076,6707,0,ITI,ITI4,12,Lazio,Lazio,5879082,2745666,46.7,0.11
582,2021-03-03,LAZ,17393,7436,9957,13099,4294,ITI,ITI4,12,Lazio,Lazio,5879082,2763059,47.0,0.3
583,2021-05-06,LAZ,48621,22614,26007,31101,17520,ITI,ITI4,12,Lazio,Lazio,5879082,2811680,47.83,0.83
584,2021-01-19,LAZ,4768,1954,2814,4314,454,ITI,ITI4,12,Lazio,Lazio,5879082,2816448,47.91,0.08
585,2021-04-02,LAZ,28532,13368,15164,21204,7328,ITI,ITI4,12,Lazio,Lazio,5879082,2844980,48.39,0.49
586,2021-01-28,LAZ,8279,3165,5114,782,7497,ITI,ITI4,12,Lazio,Lazio,5879082,2853259,48.53,0.14
587,2021-03-15,LAZ,19273,8330,10943,12534,6739,ITI,ITI4,12,Lazio,Lazio,5879082,2872532,48.86,0.33
588,2021-01-24,LAZ,5694,2229,3465,612,5082,ITI,ITI4,12,Lazio,Lazio,5879082,2878226,48.96,0.1
589,2021-05-18,LAZ,44111,20111,24000,34796,9315,ITI,ITI4,12,Lazio,Lazio,5879082,2922337,49.71,0.75
590,2021-03-29,LAZ,23956,10756,13200,16923,7033,ITI,ITI4,12,Lazio,Lazio,5879082,2946293,50.11,0.41
591,2021-04-22,LAZ,38490,18915,19575,23948,14542,ITI,ITI4,12,Lazio,Lazio,5879082,2984783,50.77,0.65
592,2021-03-10,LAZ,22011,9484,12527,16365,5646,ITI,ITI4,12,Lazio,Lazio,5879082,3006794,51.14,0.37
593,2021-01-12,LAZ,5395,1976,3419,5395,0,ITI,ITI4,12,Lazio,Lazio,5879082,3012189,51.24,0.09
594,2021-03-17,LAZ,13786,5896,7890,7531,6255,ITI,ITI4,12,Lazio,Lazio,5879082,3025975,51.47,0.23
595,2021-02-16,LAZ,8354,4033,4321,7749,605,ITI,ITI4,12,Lazio,Lazio,5879082,3034329,51.61,0.14
596,2021-02-26,LAZ,13076,5700,7376,11714,1362,ITI,ITI4,12,Lazio,Lazio,5879082,3047405,51.83,0.22
597,2021-05-01,LAZ,37911,17063,20848,25967,11944,ITI,ITI4,12,Lazio,Lazio,5879082,3085316,52.48,0.64
598,2021-04-17,LAZ,32303,14175,18128,20357,11946,ITI,ITI4,12,Lazio,Lazio,5879082,3117619,53.03,0.55
599,2021-03-12,LAZ,22895,10128,12767,16581,6314,ITI,ITI4,12,Lazio,Lazio,5879082,3140514,53.42,0.39
600,2021-01-21,LAZ,5600,2348,3252,548,5052,ITI,ITI4,12,Lazio,Lazio,5879082,3146114,53.51,0.1
601,2021-01-07,LAZ,7746,2902,4844,7746,0,ITI,ITI4,12,Lazio,Lazio,5879082,3153860,53.65,0.13
602,2021-05-22,LAZ,54553,26551,28002,44229,10324,ITI,ITI4,12,Lazio,Lazio,5879082,3208413,54.57,0.93
603,2021-04-14,LAZ,29270,13262,16008,19149,10121,ITI,ITI4,12,Lazio,Lazio,5879082,3237683,55.07,0.5
604,2021-04-05,MAR,5688,2355,3333,4419,1269,ITI,ITI3,11,Marche,Marche,1525271,5688,0.37,0.37
605,2021-03-19,MAR,3835,1597,2238,339,3496,ITI,ITI3,11,Marche,Marche,1525271,9523,0.62,0.25
606,2021-03-02,MAR,4953,1941,3012,4387,566,ITI,ITI3,11,Marche,Marche,1525271,14476,0.95,0.32
607,2021-05-22,MAR,11933,5718,6215,7485,4448,ITI,ITI3,11,Marche,Marche,1525271,26409,1.73,0.78
608,2021-05-05,MAR,11643,5298,6345,5215,6428,ITI,ITI3,11,Marche,Marche,1525271,38052,2.49,0.76
609,2021-05-08,MAR,12269,5476,6793,5021,7248,ITI,ITI3,11,Marche,Marche,1525271,50321,3.3,0.8
610,2021-04-02,MAR,6875,2973,3902,6135,740,ITI,ITI3,11,Marche,Marche,1525271,57196,3.75,0.45
611,2021-01-28,MAR,2086,725,1361,165,1921,ITI,ITI3,11,Marche,Marche,1525271,59282,3.89,0.14
612,2021-04-04,MAR,3824,1792,2032,2655,1169,ITI,ITI3,11,Marche,Marche,1525271,63106,4.14,0.25
613,2021-03-17,MAR,3428,1494,1934,107,3321,ITI,ITI3,11,Marche,Marche,1525271,66534,4.36,0.22
614,2021-02-28,MAR,2836,1251,1585,2830,6,ITI,ITI3,11,Marche,Marche,1525271,69370,4.55,0.19
615,2021-05-24,MAR,10796,5111,5685,8122,2674,ITI,ITI3,11,Marche,Marche,1525271,80166,5.26,0.71
616,2021-02-11,MAR,1987,657,1330,1598,389,ITI,ITI3,11,Marche,Marche,1525271,82153,5.39,0.13
617,2021-01-31,MAR,1920,770,1150,105,1815,ITI,ITI3,11,Marche,Marche,1525271,84073,5.51,0.13
618,2021-02-09,MAR,124,42,82,46,78,ITI,ITI3,11,Marche,Marche,1525271,84197,5.52,0.01
619,2021-04-14,MAR,10215,4564,5651,9843,372,ITI,ITI3,11,Marche,Marche,1525271,94412,6.19,0.67
620,2021-04-09,MAR,9559,4189,5370,9358,201,ITI,ITI3,11,Marche,Marche,1525271,103971,6.82,0.63
621,2021-01-06,MAR,2181,792,1389,2181,0,ITI,ITI3,11,Marche,Marche,1525271,106152,6.96,0.14
622,2021-04-26,MAR,8980,3983,4997,5958,3022,ITI,ITI3,11,Marche,Marche,1525271,115132,7.55,0.59
623,2021-05-10,MAR,9447,4336,5111,4895,4552,ITI,ITI3,11,Marche,Marche,1525271,124579,8.17,0.62
624,2021-03-14,MAR,2500,1032,1468,1907,593,ITI,ITI3,11,Marche,Marche,1525271,127079,8.33,0.16
625,2021-01-23,MAR,557,190,367,123,434,ITI,ITI3,11,Marche,Marche,1525271,127636,8.37,0.04
626,2021-03-28,MAR,4126,1739,2387,2435,1691,ITI,ITI3,11,Marche,Marche,1525271,131762,8.64,0.27
627,2021-01-12,MAR,1227,413,814,1227,0,ITI,ITI3,11,Marche,Marche,1525271,132989,8.72,0.08
628,2021-05-03,MAR,10196,4605,5591,4789,5407,ITI,ITI3,11,Marche,Marche,1525271,143185,9.39,0.67
629,2021-03-21,MAR,4505,1873,2632,1629,2876,ITI,ITI3,11,Marche,Marche,1525271,147690,9.68,0.3
630,2021-01-30,MAR,1905,668,1237,29,1876,ITI,ITI3,11,Marche,Marche,1525271,149595,9.81,0.12
631,2021-02-06,MAR,2460,900,1560,522,1938,ITI,ITI3,11,Marche,Marche,1525271,152055,9.97,0.16
632,2021-01-26,MAR,2016,746,1270,92,1924,ITI,ITI3,11,Marche,Marche,1525271,154071,10.1,0.13
633,2021-02-14,MAR,738,301,437,738,0,ITI,ITI3,11,Marche,Marche,1525271,154809,10.15,0.05
634,2021-04-19,MAR,9603,4498,5105,8022,1581,ITI,ITI3,11,Marche,Marche,1525271,164412,10.78,0.63
635,2021-01-09,MAR,1709,605,1104,1709,0,ITI,ITI3,11,Marche,Marche,1525271,166121,10.89,0.11
636,2021-04-21,MAR,10781,4967,5814,9587,1194,ITI,ITI3,11,Marche,Marche,1525271,176902,11.6,0.71
637,2021-03-16,MAR,3471,1485,1986,290,3181,ITI,ITI3,11,Marche,Marche,1525271,180373,11.83,0.23
638,2021-01-11,MAR,1176,411,765,1176,0,ITI,ITI3,11,Marche,Marche,1525271,181549,11.9,0.08
639,2021-05-01,MAR,9318,3924,5394,3576,5742,ITI,ITI3,11,Marche,Marche,1525271,190867,12.51,0.61
640,2021-03-05,MAR,6178,2859,3319,4709,1469,ITI,ITI3,11,Marche,Marche,1525271,197045,12.92,0.41
641,2021-01-07,MAR,1807,636,1171,1807,0,ITI,ITI3,11,Marche,Marche,1525271,198852,13.04,0.12
642,2021-04-24,MAR,12026,5304,6722,7560,4466,ITI,ITI3,11,Marche,Marche,1525271,210878,13.83,0.79
643,2021-02-26,MAR,3630,1499,2131,3154,476,ITI,ITI3,11,Marche,Marche,1525271,214508,14.06,0.24
644,2021-01-21,MAR,898,254,644,585,313,ITI,ITI3,11,Marche,Marche,1525271,215406,14.12,0.06
645,2021-03-12,MAR,4641,1972,2669,3403,1238,ITI,ITI3,11,Marche,Marche,1525271,220047,14.43,0.3
646,2021-01-14,MAR,2010,692,1318,2010,0,ITI,ITI3,11,Marche,Marche,1525271,222057,14.56,0.13
647,2021-03-24,MAR,7033,2984,4049,3365,3668,ITI,ITI3,11,Marche,Marche,1525271,229090,15.02,0.46
648,2021-03-10,MAR,5668,2401,3267,4531,1137,ITI,ITI3,11,Marche,Marche,1525271,234758,15.39,0.37
649,2021-01-19,MAR,228,83,145,142,86,ITI,ITI3,11,Marche,Marche,1525271,234986,15.41,0.01
650,2021-05-13,MAR,12601,5694,6907,7102,5499,ITI,ITI3,11,Marche,Marche,1525271,247587,16.23,0.83
651,2021-02-21,MAR,376,141,235,375,1,ITI,ITI3,11,Marche,Marche,1525271,247963,16.26,0.02
652,2021-01-02,MAR,453,139,314,453,0,ITI,ITI3,11,Marche,Marche,1525271,248416,16.29,0.03
653,2021-03-07,MAR,5182,2108,3074,4428,754,ITI,ITI3,11,Marche,Marche,1525271,253598,16.63,0.34
654,2021-05-17,MAR,11854,5568,6286,7691,4163,ITI,ITI3,11,Marche,Marche,1525271,265452,17.4,0.78
655,2021-02-18,MAR,2101,745,1356,1815,286,ITI,ITI3,11,Marche,Marche,1525271,267553,17.54,0.14
656,2021-02-25,MAR,3510,1434,2076,3331,179,ITI,ITI3,11,Marche,Marche,1525271,271063,17.77,0.23
657,2021-04-23,MAR,11159,5140,6019,8104,3055,ITI,ITI3,11,Marche,Marche,1525271,282222,18.5,0.73
658,2021-04-12,MAR,8567,3772,4795,8083,484,ITI,ITI3,11,Marche,Marche,1525271,290789,19.06,0.56
659,2021-02-02,MAR,1193,397,796,73,1120,ITI,ITI3,11,Marche,Marche,1525271,291982,19.14,0.08
660,2021-01-16,MAR,2005,723,1282,2005,0,ITI,ITI3,11,Marche,Marche,1525271,293987,19.27,0.13
661,2021-05-20,MAR,12367,5816,6551,7668,4699,ITI,ITI3,11,Marche,Marche,1525271,306354,20.09,0.81
662,2021-02-07,MAR,1868,734,1134,344,1524,ITI,ITI3,11,Marche,Marche,1525271,308222,20.21,0.12
663,2021-04-07,MAR,7810,3435,4375,7475,335,ITI,ITI3,11,Marche,Marche,1525271,316032,20.72,0.51
664,2021-04-16,MAR,10081,4702,5379,9556,525,ITI,ITI3,11,Marche,Marche,1525271,326113,21.38,0.66
665,2021-01-04,MAR,1503,565,938,1503,0,ITI,ITI3,11,Marche,Marche,1525271,327616,21.48,0.1
666,2020-12-30,MAR,17,5,12,17,0,ITI,ITI3,11,Marche,Marche,1525271,327633,21.48,0.0
667,2021-03-04,MAR,6487,2869,3618,5094,1393,ITI,ITI3,11,Marche,Marche,1525271,334120,21.91,0.43
668,2021-03-29,MAR,5860,2567,3293,3435,2425,ITI,ITI3,11,Marche,Marche,1525271,339980,22.29,0.38
669,2021-05-27,MAR,13737,6821,6916,9436,4301,ITI,ITI3,11,Marche,Marche,1525271,353717,23.19,0.9
670,2021-03-31,MAR,7374,3087,4287,4350,3024,ITI,ITI3,11,Marche,Marche,1525271,361091,23.67,0.48
671,2021-02-16,MAR,1287,475,812,1257,30,ITI,ITI3,11,Marche,Marche,1525271,362378,23.76,0.08
672,2021-02-23,MAR,3267,1397,1870,3211,56,ITI,ITI3,11,Marche,Marche,1525271,365645,23.97,0.21
673,2021-04-28,MAR,10734,4890,5844,6003,4731,ITI,ITI3,11,Marche,Marche,1525271,376379,24.68,0.7
674,2021-01-18,MAR,673,230,443,547,126,ITI,ITI3,11,Marche,Marche,1525271,377052,24.72,0.04
675,2021-05-12,MAR,10422,4684,5738,4921,5501,ITI,ITI3,11,Marche,Marche,1525271,387474,25.4,0.68
676,2021-05-09,MAR,8770,3986,4784,3639,5131,ITI,ITI3,11,Marche,Marche,1525271,396244,25.98,0.57
677,2021-03-06,MAR,5701,2623,3078,4434,1267,ITI,ITI3,11,Marche,Marche,1525271,401945,26.35,0.37
678,2021-05-18,MAR,11062,5257,5805,7658,3404,ITI,ITI3,11,Marche,Marche,1525271,413007,27.08,0.73
679,2021-05-07,MAR,12837,5805,7032,3660,9177,ITI,ITI3,11,Marche,Marche,1525271,425844,27.92,0.84
680,2021-01-25,MAR,1595,558,1037,97,1498,ITI,ITI3,11,Marche,Marche,1525271,427439,28.02,0.1
681,2021-04-20,MAR,10699,4996,5703,9282,1417,ITI,ITI3,11,Marche,Marche,1525271,438138,28.73,0.7
682,2021-01-08,MAR,1576,588,988,1576,0,ITI,ITI3,11,Marche,Marche,1525271,439714,28.83,0.1
683,2021-04-03,MAR,7573,3204,4369,6903,670,ITI,ITI3,11,Marche,Marche,1525271,447287,29.33,0.5
684,2021-02-13,MAR,1063,453,610,1011,52,ITI,ITI3,11,Marche,Marche,1525271,448350,29.39,0.07
685,2021-04-18,MAR,8820,4131,4689,7899,921,ITI,ITI3,11,Marche,Marche,1525271,457170,29.97,0.58
686,2021-01-27,MAR,2118,780,1338,122,1996,ITI,ITI3,11,Marche,Marche,1525271,459288,30.11,0.14
687,2021-01-10,MAR,1737,699,1038,1737,0,ITI,ITI3,11,Marche,Marche,1525271,461025,30.23,0.11
688,2021-02-19,MAR,1962,712,1250,1827,135,ITI,ITI3,11,Marche,Marche,1525271,462987,30.35,0.13
689,2020-12-31,MAR,385,180,205,385,0,ITI,ITI3,11,Marche,Marche,1525271,463372,30.38,0.03
690,2021-05-15,MAR,13967,6376,7591,8076,5891,ITI,ITI3,11,Marche,Marche,1525271,477339,31.3,0.92
691,2021-02-04,MAR,2341,809,1532,112,2229,ITI,ITI3,11,Marche,Marche,1525271,479680,31.45,0.15
692,2021-03-26,MAR,6331,2606,3725,3523,2808,ITI,ITI3,11,Marche,Marche,1525271,486011,31.86,0.42
693,2021-05-21,MAR,12951,6113,6838,6695,6256,ITI,ITI3,11,Marche,Marche,1525271,498962,32.71,0.85
694,2021-04-01,MAR,7578,3183,4395,4162,3416,ITI,ITI3,11,Marche,Marche,1525271,506540,33.21,0.5
695,2021-02-17,MAR,1786,663,1123,1669,117,ITI,ITI3,11,Marche,Marche,1525271,508326,33.33,0.12
696,2021-04-22,MAR,10795,4931,5864,9217,1578,ITI,ITI3,11,Marche,Marche,1525271,519121,34.03,0.71
697,2021-03-03,MAR,6644,3047,3597,5762,882,ITI,ITI3,11,Marche,Marche,1525271,525765,34.47,0.44
698,2021-01-05,MAR,1562,586,976,1562,0,ITI,ITI3,11,Marche,Marche,1525271,527327,34.57,0.1
699,2021-04-17,MAR,11699,5315,6384,10626,1073,ITI,ITI3,11,Marche,Marche,1525271,539026,35.34,0.77
700,2021-03-01,MAR,3724,1487,2237,3476,248,ITI,ITI3,11,Marche,Marche,1525271,542750,35.58,0.24
701,2021-05-06,MAR,12655,5820,6835,5582,7073,ITI,ITI3,11,Marche,Marche,1525271,555405,36.41,0.83
702,2021-04-30,MAR,13939,6100,7839,5398,8541,ITI,ITI3,11,Marche,Marche,1525271,569344,37.33,0.91
703,2021-03-11,MAR,6596,2784,3812,5226,1370,ITI,ITI3,11,Marche,Marche,1525271,575940,37.76,0.43
704,2021-05-14,MAR,13492,6217,7275,6720,6772,ITI,ITI3,11,Marche,Marche,1525271,589432,38.64,0.88
705,2021-01-13,MAR,2105,746,1359,2105,0,ITI,ITI3,11,Marche,Marche,1525271,591537,38.78,0.14
706,2021-01-15,MAR,1771,500,1271,1771,0,ITI,ITI3,11,Marche,Marche,1525271,593308,38.9,0.12
707,2021-04-25,MAR,8600,3994,4606,7025,1575,ITI,ITI3,11,Marche,Marche,1525271,601908,39.46,0.56
708,2021-05-02,MAR,8898,3936,4962,3160,5738,ITI,ITI3,11,Marche,Marche,1525271,610806,40.05,0.58
709,2021-03-20,MAR,4135,1740,2395,1049,3086,ITI,ITI3,11,Marche,Marche,1525271,614941,40.32,0.27
710,2021-01-22,MAR,487,167,320,194,293,ITI,ITI3,11,Marche,Marche,1525271,615428,40.35,0.03
711,2021-02-27,MAR,3357,1435,1922,3147,210,ITI,ITI3,11,Marche,Marche,1525271,618785,40.57,0.22
712,2021-03-18,MAR,3389,1475,1914,162,3227,ITI,ITI3,11,Marche,Marche,1525271,622174,40.79,0.22
713,2021-05-23,MAR,9208,4282,4926,7537,1671,ITI,ITI3,11,Marche,Marche,1525271,631382,41.39,0.6
714,2021-02-10,MAR,1439,452,987,1080,359,ITI,ITI3,11,Marche,Marche,1525271,632821,41.49,0.09
715,2021-02-12,MAR,1582,618,964,1430,152,ITI,ITI3,11,Marche,Marche,1525271,634403,41.59,0.1
716,2021-03-15,MAR,4401,2026,2375,1311,3090,ITI,ITI3,11,Marche,Marche,1525271,638804,41.88,0.29
717,2021-05-26,MAR,11809,5916,5893,8625,3184,ITI,ITI3,11,Marche,Marche,1525271,650613,42.66,0.77
718,2021-03-30,MAR,7418,3044,4374,4603,2815,ITI,ITI3,11,Marche,Marche,1525271,658031,43.14,0.49
719,2021-02-01,MAR,1362,479,883,98,1264,ITI,ITI3,11,Marche,Marche,1525271,659393,43.23,0.09
720,2021-03-23,MAR,5789,2529,3260,2262,3527,ITI,ITI3,11,Marche,Marche,1525271,665182,43.61,0.38
721,2021-05-19,MAR,11471,5272,6199,8562,2909,ITI,ITI3,11,Marche,Marche,1525271,676653,44.36,0.75
722,2021-02-15,MAR,967,412,555,954,13,ITI,ITI3,11,Marche,Marche,1525271,677620,44.43,0.06
723,2021-04-06,MAR,8879,3693,5186,8066,813,ITI,ITI3,11,Marche,Marche,1525271,686499,45.01,0.58
724,2021-02-08,MAR,833,258,575,371,462,ITI,ITI3,11,Marche,Marche,1525271,687332,45.06,0.05
725,2020-12-27,MAR,200,97,103,200,0,ITI,ITI3,11,Marche,Marche,1525271,687532,45.08,0.01
726,2021-03-09,MAR,5429,2293,3136,4549,880,ITI,ITI3,11,Marche,Marche,1525271,692961,45.43,0.36
727,2021-04-13,MAR,9838,4259,5579,9605,233,ITI,ITI3,11,Marche,Marche,1525271,702799,46.08,0.65
728,2021-02-22,MAR,3414,1500,1914,3338,76,ITI,ITI3,11,Marche,Marche,1525271,706213,46.3,0.22
729,2021-01-03,MAR,896,348,548,896,0,ITI,ITI3,11,Marche,Marche,1525271,707109,46.36,0.06
730,2021-03-08,MAR,6266,2746,3520,5264,1002,ITI,ITI3,11,Marche,Marche,1525271,713375,46.77,0.41
731,2021-04-27,MAR,9401,4309,5092,5413,3988,ITI,ITI3,11,Marche,Marche,1525271,722776,47.39,0.62
732,2021-05-28,MAR,13834,6679,7155,8996,4838,ITI,ITI3,11,Marche,Marche,1525271,736610,48.29,0.91
733,2021-04-08,MAR,7522,3285,4237,7195,327,ITI,ITI3,11,Marche,Marche,1525271,744132,48.79,0.49
734,2021-04-15,MAR,10377,4674,5703,9812,565,ITI,ITI3,11,Marche,Marche,1525271,754509,49.47,0.68
735,2021-02-24,MAR,3486,1515,1971,3408,78,ITI,ITI3,11,Marche,Marche,1525271,757995,49.7,0.23
736,2021-03-13,MAR,5763,2653,3110,1806,3957,ITI,ITI3,11,Marche,Marche,1525271,763758,50.07,0.38
737,2021-01-29,MAR,1991,730,1261,167,1824,ITI,ITI3,11,Marche,Marche,1525271,765749,50.2,0.13
738,2021-05-11,MAR,10623,4832,5791,5678,4945,ITI,ITI3,11,Marche,Marche,1525271,776372,50.9,0.7
739,2021-04-11,MAR,7117,3115,4002,6831,286,ITI,ITI3,11,Marche,Marche,1525271,783489,51.37,0.47
740,2021-02-20,MAR,4121,1705,2416,4010,111,ITI,ITI3,11,Marche,Marche,1525271,787610,51.64,0.27
741,2021-03-25,MAR,6656,2772,3884,3247,3409,ITI,ITI3,11,Marche,Marche,1525271,794266,52.07,0.44
742,2021-01-20,MAR,398,100,298,384,14,ITI,ITI3,11,Marche,Marche,1525271,794664,52.1,0.03
743,2021-02-03,MAR,2124,741,1383,119,2005,ITI,ITI3,11,Marche,Marche,1525271,796788,52.24,0.14
744,2021-04-29,MAR,13246,6061,7185,7149,6097,ITI,ITI3,11,Marche,Marche,1525271,810034,53.11,0.87
745,2021-05-04,MAR,10844,4789,6055,4949,5895,ITI,ITI3,11,Marche,Marche,1525271,820878,53.82,0.71
746,2021-03-22,MAR,5655,2376,3279,2527,3128,ITI,ITI3,11,Marche,Marche,1525271,826533,54.19,0.37
747,2021-01-24,MAR,880,339,541,5,875,ITI,ITI3,11,Marche,Marche,1525271,827413,54.25,0.06
748,2021-03-27,MAR,7377,3072,4305,5019,2358,ITI,ITI3,11,Marche,Marche,1525271,834790,54.73,0.48
749,2021-05-16,MAR,10897,4957,5940,6670,4227,ITI,ITI3,11,Marche,Marche,1525271,845687,55.45,0.71
750,2021-04-10,MAR,10917,4620,6297,10603,314,ITI,ITI3,11,Marche,Marche,1525271,856604,56.16,0.72
751,2021-02-05,MAR,2155,653,1502,440,1715,ITI,ITI3,11,Marche,Marche,1525271,858759,56.3,0.14
752,2021-05-25,MAR,11667,5756,5911,8719,2948,ITI,ITI3,11,Marche,Marche,1525271,870426,57.07,0.76
753,2021-01-17,MAR,1606,687,919,1550,56,ITI,ITI3,11,Marche,Marche,1525271,872032,57.17,0.11
754,2021-03-04,EMR,16433,5345,11088,13421,3012,ITH,ITH5,8,Emilia-Romagna,Emilia-Romagna,4459477,16433,0.37,0.37
755,2021-05-24,EMR,27559,12529,15030,16387,11172,ITH,ITH5,8,Emilia-Romagna,Emilia-Romagna,4459477,43992,0.99,0.62
756,2021-01-29,EMR,10414,3497,6917,290,10124,ITH,ITH5,8,Emilia-Romagna,Emilia-Romagna,4459477,54406,1.22,0.23
757,2021-02-15,EMR,2903,850,2053,2778,125,ITH,ITH5,8,Emilia-Romagna,Emilia-Romagna,4459477,57309,1.29,0.07
758,2021-01-13,EMR,9074,2940,6134,9074,0,ITH,ITH5,8,Emilia-Romagna,Emilia-Romagna,4459477,66383,1.49,0.2
759,2021-04-23,EMR,29547,13807,15740,14670,14877,ITH,ITH5,8,Emilia-Romagna,Emilia-Romagna,4459477,95930,2.15,0.66
760,2021-01-11,EMR,9349,3273,6076,9349,0,ITH,ITH5,8,Emilia-Romagna,Emilia-Romagna,4459477,105279,2.36,0.21
761,2021-05-26,EMR,32576,14380,18196,10142,22434,ITH,ITH5,8,Emilia-Romagna,Emilia-Romagna,4459477,137855,3.09,0.73
762,2021-02-13,EMR,3627,1085,2542,3029,598,ITH,ITH5,8,Emilia-Romagna,Emilia-Romagna,4459477,141482,3.17,0.08
763,2021-05-09,EMR,24210,11591,12619,17249,6961,ITH,ITH5,8,Emilia-Romagna,Emilia-Romagna,4459477,165692,3.72,0.54
764,2021-01-27,EMR,8362,2947,5415,463,7899,ITH,ITH5,8,Emilia-Romagna,Emilia-Romagna,4459477,174054,3.9,0.19
765,2021-04-11,EMR,15259,6926,8333,12214,3045,ITH,ITH5,8,Emilia-Romagna,Emilia-Romagna,4459477,189313,4.25,0.34
766,2021-02-11,EMR,4250,1416,2834,3410,840,ITH,ITH5,8,Emilia-Romagna,Emilia-Romagna,4459477,193563,4.34,0.1
767,2021-03-08,EMR,12173,5062,7111,9500,2673,ITH,ITH5,8,Emilia-Romagna,Emilia-Romagna,4459477,205736,4.61,0.27
768,2021-04-20,EMR,22593,10392,12201,14243,8350,ITH,ITH5,8,Emilia-Romagna,Emilia-Romagna,4459477,228329,5.12,0.51
769,2021-01-08,EMR,10865,3580,7285,10865,0,ITH,ITH5,8,Emilia-Romagna,Emilia-Romagna,4459477,239194,5.36,0.24
770,2021-01-25,EMR,6456,2145,4311,207,6249,ITH,ITH5,8,Emilia-Romagna,Emilia-Romagna,4459477,245650,5.51,0.14
771,2021-05-12,EMR,38153,17943,20210,28550,9603,ITH,ITH5,8,Emilia-Romagna,Emilia-Romagna,4459477,283803,6.36,0.86
772,2021-03-16,EMR,12240,5026,7214,4932,7308,ITH,ITH5,8,Emilia-Romagna,Emilia-Romagna,4459477,296043,6.64,0.27
773,2021-03-09,EMR,14702,5983,8719,10746,3956,ITH,ITH5,8,Emilia-Romagna,Emilia-Romagna,4459477,310745,6.97,0.33
774,2021-05-23,EMR,25309,11777,13532,13772,11537,ITH,ITH5,8,Emilia-Romagna,Emilia-Romagna,4459477,336054,7.54,0.57
775,2021-02-01,EMR,10320,3610,6710,362,9958,ITH,ITH5,8,Emilia-Romagna,Emilia-Romagna,4459477,346374,7.77,0.23
776,2021-03-23,EMR,18698,8069,10629,12011,6687,ITH,ITH5,8,Emilia-Romagna,Emilia-Romagna,4459477,365072,8.19,0.42
777,2021-01-18,EMR,3127,879,2248,2449,678,ITH,ITH5,8,Emilia-Romagna,Emilia-Romagna,4459477,368199,8.26,0.07
778,2021-05-05,EMR,29364,13654,15710,18127,11237,ITH,ITH5,8,Emilia-Romagna,Emilia-Romagna,4459477,397563,8.92,0.66
779,2021-01-30,EMR,10077,3519,6558,141,9936,ITH,ITH5,8,Emilia-Romagna,Emilia-Romagna,4459477,407640,9.14,0.23
780,2021-04-04,EMR,9885,4718,5167,7616,2269,ITH,ITH5,8,Emilia-Romagna,Emilia-Romagna,4459477,417525,9.36,0.22
781,2021-03-20,EMR,16086,6831,9255,9122,6964,ITH,ITH5,8,Emilia-Romagna,Emilia-Romagna,4459477,433611,9.72,0.36
782,2020-12-27,EMR,970,372,598,970,0,ITH,ITH5,8,Emilia-Romagna,Emilia-Romagna,4459477,434581,9.75,0.02
783,2021-04-06,EMR,24617,11110,13507,19880,4737,ITH,ITH5,8,Emilia-Romagna,Emilia-Romagna,4459477,459198,10.3,0.55
784,2021-05-07,EMR,34517,16603,17914,22715,11802,ITH,ITH5,8,Emilia-Romagna,Emilia-Romagna,4459477,493715,11.07,0.77
785,2021-02-10,EMR,4019,1383,2636,2764,1255,ITH,ITH5,8,Emilia-Romagna,Emilia-Romagna,4459477,497734,11.16,0.09
786,2021-04-08,EMR,30824,14130,16694,25524,5300,ITH,ITH5,8,Emilia-Romagna,Emilia-Romagna,4459477,528558,11.85,0.69
787,2021-02-17,EMR,6538,2764,3774,5766,772,ITH,ITH5,8,Emilia-Romagna,Emilia-Romagna,4459477,535096,12.0,0.15
788,2021-03-25,EMR,21388,9346,12042,14400,6988,ITH,ITH5,8,Emilia-Romagna,Emilia-Romagna,4459477,556484,12.48,0.48
789,2021-05-21,EMR,37476,16731,20745,20803,16673,ITH,ITH5,8,Emilia-Romagna,Emilia-Romagna,4459477,593960,13.32,0.84
790,2021-03-30,EMR,23286,10292,12994,18249,5037,ITH,ITH5,8,Emilia-Romagna,Emilia-Romagna,4459477,617246,13.84,0.52
791,2021-05-19,EMR,33215,14758,18457,18206,15009,ITH,ITH5,8,Emilia-Romagna,Emilia-Romagna,4459477,650461,14.59,0.74
792,2021-01-04,EMR,7310,2526,4784,7310,0,ITH,ITH5,8,Emilia-Romagna,Emilia-Romagna,4459477,657771,14.75,0.16
793,2021-01-03,EMR,2762,943,1819,2762,0,ITH,ITH5,8,Emilia-Romagna,Emilia-Romagna,4459477,660533,14.81,0.06
794,2021-05-16,EMR,25665,12086,13579,18568,7097,ITH,ITH5,8,Emilia-Romagna,Emilia-Romagna,4459477,686198,15.39,0.58
795,2021-03-13,EMR,16074,6307,9767,10761,5313,ITH,ITH5,8,Emilia-Romagna,Emilia-Romagna,4459477,702272,15.75,0.36
796,2021-05-02,EMR,25448,11591,13857,13461,11987,ITH,ITH5,8,Emilia-Romagna,Emilia-Romagna,4459477,727720,16.32,0.57
797,2021-02-18,EMR,7039,2892,4147,6456,583,ITH,ITH5,8,Emilia-Romagna,Emilia-Romagna,4459477,734759,16.48,0.16
798,2021-03-27,EMR,21600,9045,12555,14695,6905,ITH,ITH5,8,Emilia-Romagna,Emilia-Romagna,4459477,756359,16.96,0.48
799,2021-01-22,EMR,1829,477,1352,1088,741,ITH,ITH5,8,Emilia-Romagna,Emilia-Romagna,4459477,758188,17.0,0.04
800,2021-04-13,EMR,23641,11086,12555,19343,4298,ITH,ITH5,8,Emilia-Romagna,Emilia-Romagna,4459477,781829,17.53,0.53
801,2021-02-08,EMR,5227,1532,3695,2315,2912,ITH,ITH5,8,Emilia-Romagna,Emilia-Romagna,4459477,787056,17.65,0.12
802,2021-02-22,EMR,7481,3091,4390,7209,272,ITH,ITH5,8,Emilia-Romagna,Emilia-Romagna,4459477,794537,17.82,0.17
803,2021-04-18,EMR,17494,8392,9102,12568,4926,ITH,ITH5,8,Emilia-Romagna,Emilia-Romagna,4459477,812031,18.21,0.39
804,2021-01-10,EMR,7168,2683,4485,7168,0,ITH,ITH5,8,Emilia-Romagna,Emilia-Romagna,4459477,819199,18.37,0.16
805,2021-03-06,EMR,20625,5882,14743,17895,2730,ITH,ITH5,8,Emilia-Romagna,Emilia-Romagna,4459477,839824,18.83,0.46
806,2021-02-20,EMR,5317,2094,3223,5054,263,ITH,ITH5,8,Emilia-Romagna,Emilia-Romagna,4459477,845141,18.95,0.12
807,2021-03-01,EMR,10092,3578,6514,7836,2256,ITH,ITH5,8,Emilia-Romagna,Emilia-Romagna,4459477,855233,19.18,0.23
808,2021-05-04,EMR,28557,13379,15178,14904,13653,ITH,ITH5,8,Emilia-Romagna,Emilia-Romagna,4459477,883790,19.82,0.64
809,2021-04-27,EMR,29858,13806,16052,17398,12460,ITH,ITH5,8,Emilia-Romagna,Emilia-Romagna,4459477,913648,20.49,0.67
810,2021-01-15,EMR,7746,2403,5343,7746,0,ITH,ITH5,8,Emilia-Romagna,Emilia-Romagna,4459477,921394,20.66,0.17
811,2021-02-27,EMR,10967,3999,6968,9229,1738,ITH,ITH5,8,Emilia-Romagna,Emilia-Romagna,4459477,932361,20.91,0.25
812,2021-04-25,EMR,22324,10222,12102,14816,7508,ITH,ITH5,8,Emilia-Romagna,Emilia-Romagna,4459477,954685,21.41,0.5
813,2021-03-28,EMR,13455,6001,7454,9591,3864,ITH,ITH5,8,Emilia-Romagna,Emilia-Romagna,4459477,968140,21.71,0.3
814,2021-02-06,EMR,7600,2406,5194,2131,5469,ITH,ITH5,8,Emilia-Romagna,Emilia-Romagna,4459477,975740,21.88,0.17
815,2021-01-23,EMR,2447,870,1577,443,2004,ITH,ITH5,8,Emilia-Romagna,Emilia-Romagna,4459477,978187,21.94,0.05
816,2021-05-20,EMR,39568,17996,21572,18552,21016,ITH,ITH5,8,Emilia-Romagna,Emilia-Romagna,4459477,1017755,22.82,0.89
817,2021-03-17,EMR,13714,5690,8024,5869,7845,ITH,ITH5,8,Emilia-Romagna,Emilia-Romagna,4459477,1031469,23.13,0.31
818,2021-05-15,EMR,32975,14866,18109,22631,10344,ITH,ITH5,8,Emilia-Romagna,Emilia-Romagna,4459477,1064444,23.87,0.74
819,2021-02-02,EMR,9484,3053,6431,527,8957,ITH,ITH5,8,Emilia-Romagna,Emilia-Romagna,4459477,1073928,24.08,0.21
820,2021-04-05,EMR,14859,6809,8050,11968,2891,ITH,ITH5,8,Emilia-Romagna,Emilia-Romagna,4459477,1088787,24.42,0.33
821,2021-01-31,EMR,7696,2762,4934,241,7455,ITH,ITH5,8,Emilia-Romagna,Emilia-Romagna,4459477,1096483,24.59,0.17
822,2021-04-22,EMR,29006,13421,15585,14952,14054,ITH,ITH5,8,Emilia-Romagna,Emilia-Romagna,4459477,1125489,25.24,0.65
823,2021-03-02,EMR,11858,3906,7952,9829,2029,ITH,ITH5,8,Emilia-Romagna,Emilia-Romagna,4459477,1137347,25.5,0.27
824,2021-03-19,EMR,15843,6915,8928,7876,7967,ITH,ITH5,8,Emilia-Romagna,Emilia-Romagna,4459477,1153190,25.86,0.36
825,2021-05-28,EMR,39567,18232,21335,17338,22229,ITH,ITH5,8,Emilia-Romagna,Emilia-Romagna,4459477,1192757,26.75,0.89
826,2021-01-12,EMR,9475,3124,6351,9475,0,ITH,ITH5,8,Emilia-Romagna,Emilia-Romagna,4459477,1202232,26.96,0.21
827,2021-04-24,EMR,28572,13212,15360,14360,14212,ITH,ITH5,8,Emilia-Romagna,Emilia-Romagna,4459477,1230804,27.6,0.64
828,2021-05-11,EMR,35183,16499,18684,27929,7254,ITH,ITH5,8,Emilia-Romagna,Emilia-Romagna,4459477,1265987,28.39,0.79
829,2021-03-21,EMR,11919,5273,6646,7315,4604,ITH,ITH5,8,Emilia-Romagna,Emilia-Romagna,4459477,1277906,28.66,0.27
830,2021-04-07,EMR,25801,11733,14068,19790,6011,ITH,ITH5,8,Emilia-Romagna,Emilia-Romagna,4459477,1303707,29.23,0.58
831,2021-01-06,EMR,8285,2954,5331,8285,0,ITH,ITH5,8,Emilia-Romagna,Emilia-Romagna,4459477,1311992,29.42,0.19
832,2021-04-30,EMR,36513,16736,19777,21728,14785,ITH,ITH5,8,Emilia-Romagna,Emilia-Romagna,4459477,1348505,30.24,0.82
833,2021-03-11,EMR,17250,7135,10115,11400,5850,ITH,ITH5,8,Emilia-Romagna,Emilia-Romagna,4459477,1365755,30.63,0.39
834,2021-04-16,EMR,28855,13565,15290,20021,8834,ITH,ITH5,8,Emilia-Romagna,Emilia-Romagna,4459477,1394610,31.27,0.65
835,2021-02-25,EMR,9228,3497,5731,8274,954,ITH,ITH5,8,Emilia-Romagna,Emilia-Romagna,4459477,1403838,31.48,0.21
836,2021-04-15,EMR,29016,13807,15209,19346,9670,ITH,ITH5,8,Emilia-Romagna,Emilia-Romagna,4459477,1432854,32.13,0.65
837,2021-01-20,EMR,1325,270,1055,1324,1,ITH,ITH5,8,Emilia-Romagna,Emilia-Romagna,4459477,1434179,32.16,0.03
838,2021-03-10,EMR,18727,7683,11044,13084,5643,ITH,ITH5,8,Emilia-Romagna,Emilia-Romagna,4459477,1452906,32.58,0.42
839,2021-01-07,EMR,10272,3406,6866,10272,0,ITH,ITH5,8,Emilia-Romagna,Emilia-Romagna,4459477,1463178,32.81,0.23
840,2021-02-19,EMR,7327,3010,4317,6813,514,ITH,ITH5,8,Emilia-Romagna,Emilia-Romagna,4459477,1470505,32.97,0.16
841,2020-12-31,EMR,2213,779,1434,2213,0,ITH,ITH5,8,Emilia-Romagna,Emilia-Romagna,4459477,1472718,33.02,0.05
842,2021-04-03,EMR,19936,8766,11170,16196,3740,ITH,ITH5,8,Emilia-Romagna,Emilia-Romagna,4459477,1492654,33.47,0.45
843,2021-04-28,EMR,32650,15077,17573,19765,12885,ITH,ITH5,8,Emilia-Romagna,Emilia-Romagna,4459477,1525304,34.2,0.73
844,2021-03-18,EMR,13673,5806,7867,5673,8000,ITH,ITH5,8,Emilia-Romagna,Emilia-Romagna,4459477,1538977,34.51,0.31
845,2021-05-14,EMR,36714,16905,19809,27168,9546,ITH,ITH5,8,Emilia-Romagna,Emilia-Romagna,4459477,1575691,35.33,0.82
846,2021-02-03,EMR,9355,2995,6360,984,8371,ITH,ITH5,8,Emilia-Romagna,Emilia-Romagna,4459477,1585046,35.54,0.21
847,2021-04-01,EMR,23875,10729,13146,19339,4536,ITH,ITH5,8,Emilia-Romagna,Emilia-Romagna,4459477,1608921,36.08,0.54
848,2021-02-14,EMR,1401,378,1023,1281,120,ITH,ITH5,8,Emilia-Romagna,Emilia-Romagna,4459477,1610322,36.11,0.03
849,2021-03-22,EMR,17462,7651,9811,10598,6864,ITH,ITH5,8,Emilia-Romagna,Emilia-Romagna,4459477,1627784,36.5,0.39
850,2021-05-25,EMR,24639,10996,13643,11507,13132,ITH,ITH5,8,Emilia-Romagna,Emilia-Romagna,4459477,1652423,37.05,0.55
851,2021-05-10,EMR,33536,15964,17572,26308,7228,ITH,ITH5,8,Emilia-Romagna,Emilia-Romagna,4459477,1685959,37.81,0.75
852,2021-02-23,EMR,8215,3219,4996,7829,386,ITH,ITH5,8,Emilia-Romagna,Emilia-Romagna,4459477,1694174,37.99,0.18
853,2021-01-21,EMR,2164,729,1435,819,1345,ITH,ITH5,8,Emilia-Romagna,Emilia-Romagna,4459477,1696338,38.04,0.05
854,2021-01-26,EMR,8334,3000,5334,215,8119,ITH,ITH5,8,Emilia-Romagna,Emilia-Romagna,4459477,1704672,38.23,0.19
855,2021-03-24,EMR,21062,9296,11766,13692,7370,ITH,ITH5,8,Emilia-Romagna,Emilia-Romagna,4459477,1725734,38.7,0.47
856,2021-05-06,EMR,35453,16383,19070,22414,13039,ITH,ITH5,8,Emilia-Romagna,Emilia-Romagna,4459477,1761187,39.49,0.8
857,2021-04-02,EMR,23304,10493,12811,18842,4462,ITH,ITH5,8,Emilia-Romagna,Emilia-Romagna,4459477,1784491,40.02,0.52
858,2021-03-26,EMR,23412,9900,13512,16977,6435,ITH,ITH5,8,Emilia-Romagna,Emilia-Romagna,4459477,1807903,40.54,0.52
859,2021-03-05,EMR,17682,5752,11930,14233,3449,ITH,ITH5,8,Emilia-Romagna,Emilia-Romagna,4459477,1825585,40.94,0.4
860,2021-03-03,EMR,15828,5249,10579,13352,2476,ITH,ITH5,8,Emilia-Romagna,Emilia-Romagna,4459477,1841413,41.29,0.35
861,2021-02-16,EMR,5768,2444,3324,5237,531,ITH,ITH5,8,Emilia-Romagna,Emilia-Romagna,4459477,1847181,41.42,0.13
862,2021-04-21,EMR,23919,10952,12967,14184,9735,ITH,ITH5,8,Emilia-Romagna,Emilia-Romagna,4459477,1871100,41.96,0.54
863,2021-01-28,EMR,10249,3339,6910,349,9900,ITH,ITH5,8,Emilia-Romagna,Emilia-Romagna,4459477,1881349,42.19,0.23
864,2021-05-27,EMR,36046,15824,20222,8559,27487,ITH,ITH5,8,Emilia-Romagna,Emilia-Romagna,4459477,1917395,43.0,0.81
865,2021-05-08,EMR,31163,14568,16595,19754,11409,ITH,ITH5,8,Emilia-Romagna,Emilia-Romagna,4459477,1948558,43.69,0.7
866,2021-01-14,EMR,8128,2593,5535,8128,0,ITH,ITH5,8,Emilia-Romagna,Emilia-Romagna,4459477,1956686,43.88,0.18
867,2021-04-12,EMR,19217,8993,10224,14774,4443,ITH,ITH5,8,Emilia-Romagna,Emilia-Romagna,4459477,1975903,44.31,0.43
868,2021-01-09,EMR,9984,3450,6534,9984,0,ITH,ITH5,8,Emilia-Romagna,Emilia-Romagna,4459477,1985887,44.53,0.22
869,2021-03-07,EMR,6861,2640,4221,5344,1517,ITH,ITH5,8,Emilia-Romagna,Emilia-Romagna,4459477,1992748,44.69,0.15
870,2021-05-03,EMR,27847,13162,14685,16974,10873,ITH,ITH5,8,Emilia-Romagna,Emilia-Romagna,4459477,2020595,45.31,0.62
871,2021-01-16,EMR,5626,1718,3908,5626,0,ITH,ITH5,8,Emilia-Romagna,Emilia-Romagna,4459477,2026221,45.44,0.13
872,2021-03-14,EMR,8696,3744,4952,4899,3797,ITH,ITH5,8,Emilia-Romagna,Emilia-Romagna,4459477,2034917,45.63,0.2
873,2021-04-19,EMR,20882,9788,11094,14611,6271,ITH,ITH5,8,Emilia-Romagna,Emilia-Romagna,4459477,2055799,46.1,0.47
874,2021-02-28,EMR,6823,2527,4296,4977,1846,ITH,ITH5,8,Emilia-Romagna,Emilia-Romagna,4459477,2062622,46.25,0.15
875,2021-04-26,EMR,27854,12911,14943,18549,9305,ITH,ITH5,8,Emilia-Romagna,Emilia-Romagna,4459477,2090476,46.88,0.62
876,2021-02-07,EMR,4793,1537,3256,1732,3061,ITH,ITH5,8,Emilia-Romagna,Emilia-Romagna,4459477,2095269,46.98,0.11
877,2021-03-29,EMR,21196,9441,11755,16545,4651,ITH,ITH5,8,Emilia-Romagna,Emilia-Romagna,4459477,2116465,47.46,0.48
878,2021-05-18,EMR,28127,12804,15323,17758,10369,ITH,ITH5,8,Emilia-Romagna,Emilia-Romagna,4459477,2144592,48.09,0.63
879,2021-05-17,EMR,30766,14596,16170,21349,9417,ITH,ITH5,8,Emilia-Romagna,Emilia-Romagna,4459477,2175358,48.78,0.69
880,2021-02-21,EMR,4450,1708,2742,4010,440,ITH,ITH5,8,Emilia-Romagna,Emilia-Romagna,4459477,2179808,48.88,0.1
881,2021-01-02,EMR,2372,913,1459,2372,0,ITH,ITH5,8,Emilia-Romagna,Emilia-Romagna,4459477,2182180,48.93,0.05
882,2021-02-26,EMR,7866,2996,4870,6821,1045,ITH,ITH5,8,Emilia-Romagna,Emilia-Romagna,4459477,2190046,49.11,0.18
883,2021-02-12,EMR,5321,1679,3642,3918,1403,ITH,ITH5,8,Emilia-Romagna,Emilia-Romagna,4459477,2195367,49.23,0.12
884,2021-04-10,EMR,20906,9291,11615,16763,4143,ITH,ITH5,8,Emilia-Romagna,Emilia-Romagna,4459477,2216273,49.7,0.47
885,2021-04-17,EMR,27027,12931,14096,17731,9296,ITH,ITH5,8,Emilia-Romagna,Emilia-Romagna,4459477,2243300,50.3,0.61
886,2021-05-13,EMR,35484,16339,19145,27732,7752,ITH,ITH5,8,Emilia-Romagna,Emilia-Romagna,4459477,2278784,51.1,0.8
887,2021-03-15,EMR,13267,6090,7177,6768,6499,ITH,ITH5,8,Emilia-Romagna,Emilia-Romagna,4459477,2292051,51.4,0.3
888,2021-02-04,EMR,9938,3207,6731,1250,8688,ITH,ITH5,8,Emilia-Romagna,Emilia-Romagna,4459477,2301989,51.62,0.22
889,2021-05-22,EMR,32676,14019,18657,16745,15931,ITH,ITH5,8,Emilia-Romagna,Emilia-Romagna,4459477,2334665,52.35,0.73
890,2021-04-09,EMR,25505,11567,13938,19814,5691,ITH,ITH5,8,Emilia-Romagna,Emilia-Romagna,4459477,2360170,52.92,0.57
891,2021-02-09,EMR,4153,1248,2905,2307,1846,ITH,ITH5,8,Emilia-Romagna,Emilia-Romagna,4459477,2364323,53.02,0.09
892,2021-05-01,EMR,28380,12764,15616,15611,12769,ITH,ITH5,8,Emilia-Romagna,Emilia-Romagna,4459477,2392703,53.65,0.64
893,2021-02-05,EMR,9316,2966,6350,1637,7679,ITH,ITH5,8,Emilia-Romagna,Emilia-Romagna,4459477,2402019,53.86,0.21
894,2021-04-14,EMR,27005,12824,14181,20907,6098,ITH,ITH5,8,Emilia-Romagna,Emilia-Romagna,4459477,2429024,54.47,0.61
895,2021-01-24,EMR,2443,885,1558,298,2145,ITH,ITH5,8,Emilia-Romagna,Emilia-Romagna,4459477,2431467,54.52,0.05
896,2021-01-17,EMR,2890,887,2003,2644,246,ITH,ITH5,8,Emilia-Romagna,Emilia-Romagna,4459477,2434357,54.59,0.06
897,2021-01-19,EMR,2045,505,1540,2028,17,ITH,ITH5,8,Emilia-Romagna,Emilia-Romagna,4459477,2436402,54.63,0.05
898,2021-02-24,EMR,9327,3558,5769,8443,884,ITH,ITH5,8,Emilia-Romagna,Emilia-Romagna,4459477,2445729,54.84,0.21
899,2021-01-05,EMR,9362,3170,6192,9362,0,ITH,ITH5,8,Emilia-Romagna,Emilia-Romagna,4459477,2455091,55.05,0.21
900,2021-04-29,EMR,44720,21012,23708,27178,17542,ITH,ITH5,8,Emilia-Romagna,Emilia-Romagna,4459477,2499811,56.06,1.0
901,2021-03-12,EMR,18114,7551,10563,11397,6717,ITH,ITH5,8,Emilia-Romagna,Emilia-Romagna,4459477,2517925,56.46,0.41
902,2021-03-31,EMR,25131,10949,14182,19675,5456,ITH,ITH5,8,Emilia-Romagna,Emilia-Romagna,4459477,2543056,57.03,0.56
903,2021-02-24,ABR,3305,1441,1864,3129,176,ITF,ITF1,13,Abruzzo,Abruzzo,1304970,3305,0.25,0.25
904,2021-05-16,ABR,9580,4139,5441,5764,3816,ITF,ITF1,13,Abruzzo,Abruzzo,1304970,12885,0.99,0.73
905,2021-01-21,ABR,157,47,110,157,0,ITF,ITF1,13,Abruzzo,Abruzzo,1304970,13042,1.0,0.01
906,2021-02-07,ABR,777,307,470,201,576,ITF,ITF1,13,Abruzzo,Abruzzo,1304970,13819,1.06,0.06
907,2021-05-20,ABR,12546,5784,6762,7330,5216,ITF,ITF1,13,Abruzzo,Abruzzo,1304970,26365,2.02,0.96
908,2021-01-22,ABR,118,57,61,118,0,ITF,ITF1,13,Abruzzo,Abruzzo,1304970,26483,2.03,0.01
909,2021-03-27,ABR,6121,2620,3501,3636,2485,ITF,ITF1,13,Abruzzo,Abruzzo,1304970,32604,2.5,0.47
910,2021-03-12,ABR,6014,1985,4029,4432,1582,ITF,ITF1,13,Abruzzo,Abruzzo,1304970,38618,2.96,0.46
911,2021-02-25,ABR,3042,1330,1712,2514,528,ITF,ITF1,13,Abruzzo,Abruzzo,1304970,41660,3.19,0.23
912,2021-02-05,ABR,1534,521,1013,788,746,ITF,ITF1,13,Abruzzo,Abruzzo,1304970,43194,3.31,0.12
913,2021-05-18,ABR,12119,5664,6455,7736,4383,ITF,ITF1,13,Abruzzo,Abruzzo,1304970,55313,4.24,0.93
914,2021-02-22,ABR,2642,1173,1469,2612,30,ITF,ITF1,13,Abruzzo,Abruzzo,1304970,57955,4.44,0.2
915,2021-01-19,ABR,111,55,56,91,20,ITF,ITF1,13,Abruzzo,Abruzzo,1304970,58066,4.45,0.01
916,2021-05-01,ABR,10744,5051,5693,5769,4975,ITF,ITF1,13,Abruzzo,Abruzzo,1304970,68810,5.27,0.82
917,2021-04-29,ABR,12669,5850,6819,9574,3095,ITF,ITF1,13,Abruzzo,Abruzzo,1304970,81479,6.24,0.97
918,2021-01-17,ABR,187,59,128,180,7,ITF,ITF1,13,Abruzzo,Abruzzo,1304970,81666,6.26,0.01
919,2021-03-17,ABR,4540,1873,2667,2800,1740,ITF,ITF1,13,Abruzzo,Abruzzo,1304970,86206,6.61,0.35
920,2021-02-03,ABR,2061,717,1344,419,1642,ITF,ITF1,13,Abruzzo,Abruzzo,1304970,88267,6.76,0.16
921,2021-02-28,ABR,1704,510,1194,1702,2,ITF,ITF1,13,Abruzzo,Abruzzo,1304970,89971,6.89,0.13
922,2021-04-12,ABR,6223,2949,3274,5049,1174,ITF,ITF1,13,Abruzzo,Abruzzo,1304970,96194,7.37,0.48
923,2021-02-10,ABR,947,312,635,503,444,ITF,ITF1,13,Abruzzo,Abruzzo,1304970,97141,7.44,0.07
924,2021-01-02,ABR,548,218,330,548,0,ITF,ITF1,13,Abruzzo,Abruzzo,1304970,97689,7.49,0.04
925,2021-04-26,ABR,8564,4067,4497,7349,1215,ITF,ITF1,13,Abruzzo,Abruzzo,1304970,106253,8.14,0.66
926,2021-04-19,ABR,6227,2857,3370,3856,2371,ITF,ITF1,13,Abruzzo,Abruzzo,1304970,112480,8.62,0.48
927,2021-02-21,ABR,1218,550,668,1217,1,ITF,ITF1,13,Abruzzo,Abruzzo,1304970,113698,8.71,0.09
928,2021-01-05,ABR,1614,604,1010,1614,0,ITF,ITF1,13,Abruzzo,Abruzzo,1304970,115312,8.84,0.12
929,2021-01-03,ABR,471,185,286,471,0,ITF,ITF1,13,Abruzzo,Abruzzo,1304970,115783,8.87,0.04
930,2021-04-15,ABR,7787,3652,4135,5947,1840,ITF,ITF1,13,Abruzzo,Abruzzo,1304970,123570,9.47,0.6
931,2021-03-29,ABR,5624,2524,3100,2985,2639,ITF,ITF1,13,Abruzzo,Abruzzo,1304970,129194,9.9,0.43
932,2021-04-03,ABR,5085,2221,2864,3489,1596,ITF,ITF1,13,Abruzzo,Abruzzo,1304970,134279,10.29,0.39
933,2021-02-12,ABR,1228,567,661,1039,189,ITF,ITF1,13,Abruzzo,Abruzzo,1304970,135507,10.38,0.09
934,2021-04-10,ABR,8771,4057,4714,6263,2508,ITF,ITF1,13,Abruzzo,Abruzzo,1304970,144278,11.06,0.67
935,2021-05-23,ABR,9875,4696,5179,7189,2686,ITF,ITF1,13,Abruzzo,Abruzzo,1304970,154153,11.81,0.76
936,2021-01-07,ABR,1603,552,1051,1603,0,ITF,ITF1,13,Abruzzo,Abruzzo,1304970,155756,11.94,0.12
937,2021-04-17,ABR,7346,3398,3948,4293,3053,ITF,ITF1,13,Abruzzo,Abruzzo,1304970,163102,12.5,0.56
938,2021-02-19,ABR,3300,1551,1749,3200,100,ITF,ITF1,13,Abruzzo,Abruzzo,1304970,166402,12.75,0.25
939,2021-03-22,ABR,4281,1852,2429,2311,1970,ITF,ITF1,13,Abruzzo,Abruzzo,1304970,170683,13.08,0.33
940,2021-05-11,ABR,10737,5097,5640,5909,4828,ITF,ITF1,13,Abruzzo,Abruzzo,1304970,181420,13.9,0.82
941,2021-04-08,ABR,7346,3322,4024,5060,2286,ITF,ITF1,13,Abruzzo,Abruzzo,1304970,188766,14.47,0.56
942,2021-01-12,ABR,1804,666,1138,1804,0,ITF,ITF1,13,Abruzzo,Abruzzo,1304970,190570,14.6,0.14
943,2021-05-25,ABR,11215,5197,6018,8092,3123,ITF,ITF1,13,Abruzzo,Abruzzo,1304970,201785,15.46,0.86
944,2021-05-15,ABR,11423,5174,6249,6127,5296,ITF,ITF1,13,Abruzzo,Abruzzo,1304970,213208,16.34,0.88
945,2021-03-03,ABR,4622,1880,2742,3716,906,ITF,ITF1,13,Abruzzo,Abruzzo,1304970,217830,16.69,0.35
946,2021-04-22,ABR,6662,3193,3469,4981,1681,ITF,ITF1,13,Abruzzo,Abruzzo,1304970,224492,17.2,0.51
947,2021-02-17,ABR,2071,948,1123,1789,282,ITF,ITF1,13,Abruzzo,Abruzzo,1304970,226563,17.36,0.16
948,2021-04-05,ABR,2693,1147,1546,1813,880,ITF,ITF1,13,Abruzzo,Abruzzo,1304970,229256,17.57,0.21
949,2021-01-31,ABR,1501,487,1014,286,1215,ITF,ITF1,13,Abruzzo,Abruzzo,1304970,230757,17.68,0.12
950,2021-03-15,ABR,3628,1393,2235,1820,1808,ITF,ITF1,13,Abruzzo,Abruzzo,1304970,234385,17.96,0.28
951,2021-01-10,ABR,1139,409,730,1139,0,ITF,ITF1,13,Abruzzo,Abruzzo,1304970,235524,18.05,0.09
952,2021-01-15,ABR,379,149,230,379,0,ITF,ITF1,13,Abruzzo,Abruzzo,1304970,235903,18.08,0.03
953,2021-04-27,ABR,9084,4370,4714,6616,2468,ITF,ITF1,13,Abruzzo,Abruzzo,1304970,244987,18.77,0.7
954,2021-02-09,ABR,908,311,597,499,409,ITF,ITF1,13,Abruzzo,Abruzzo,1304970,245895,18.84,0.07
955,2021-03-24,ABR,6387,2786,3601,4134,2253,ITF,ITF1,13,Abruzzo,Abruzzo,1304970,252282,19.33,0.49
956,2021-01-24,ABR,50,22,28,6,44,ITF,ITF1,13,Abruzzo,Abruzzo,1304970,252332,19.34,0.0
957,2021-05-04,ABR,10720,5050,5670,7102,3618,ITF,ITF1,13,Abruzzo,Abruzzo,1304970,263052,20.16,0.82
958,2021-03-08,ABR,5121,1666,3455,4149,972,ITF,ITF1,13,Abruzzo,Abruzzo,1304970,268173,20.55,0.39
959,2021-03-01,ABR,3477,1384,2093,2725,752,ITF,ITF1,13,Abruzzo,Abruzzo,1304970,271650,20.82,0.27
960,2021-02-02,ABR,1778,672,1106,222,1556,ITF,ITF1,13,Abruzzo,Abruzzo,1304970,273428,20.95,0.14
961,2021-03-31,ABR,6648,2879,3769,4581,2067,ITF,ITF1,13,Abruzzo,Abruzzo,1304970,280076,21.46,0.51
962,2021-05-13,ABR,11149,5043,6106,7188,3961,ITF,ITF1,13,Abruzzo,Abruzzo,1304970,291225,22.32,0.85
963,2021-03-10,ABR,4947,1638,3309,3991,956,ITF,ITF1,13,Abruzzo,Abruzzo,1304970,296172,22.7,0.38
964,2021-01-26,ABR,1542,567,975,30,1512,ITF,ITF1,13,Abruzzo,Abruzzo,1304970,297714,22.81,0.12
965,2021-05-06,ABR,13018,6076,6942,7988,5030,ITF,ITF1,13,Abruzzo,Abruzzo,1304970,310732,23.81,1.0
966,2020-12-27,ABR,37,19,18,37,0,ITF,ITF1,13,Abruzzo,Abruzzo,1304970,310769,23.81,0.0
967,2021-05-27,ABR,12937,5880,7057,8241,4696,ITF,ITF1,13,Abruzzo,Abruzzo,1304970,323706,24.81,0.99
968,2021-04-07,ABR,7130,3283,3847,4405,2725,ITF,ITF1,13,Abruzzo,Abruzzo,1304970,330836,25.35,0.55
969,2021-02-11,ABR,815,261,554,772,43,ITF,ITF1,13,Abruzzo,Abruzzo,1304970,331651,25.41,0.06
970,2021-05-24,ABR,12182,5786,6396,8877,3305,ITF,ITF1,13,Abruzzo,Abruzzo,1304970,343833,26.35,0.93
971,2021-03-26,ABR,5305,2263,3042,3231,2074,ITF,ITF1,13,Abruzzo,Abruzzo,1304970,349138,26.75,0.41
972,2021-04-20,ABR,5589,2689,2900,4179,1410,ITF,ITF1,13,Abruzzo,Abruzzo,1304970,354727,27.18,0.43
973,2021-04-25,ABR,9067,4621,4446,8257,810,ITF,ITF1,13,Abruzzo,Abruzzo,1304970,363794,27.88,0.69
974,2021-01-08,ABR,1525,507,1018,1525,0,ITF,ITF1,13,Abruzzo,Abruzzo,1304970,365319,27.99,0.12
975,2021-03-28,ABR,2415,1017,1398,2044,371,ITF,ITF1,13,Abruzzo,Abruzzo,1304970,367734,28.18,0.19
976,2021-01-23,ABR,263,114,149,57,206,ITF,ITF1,13,Abruzzo,Abruzzo,1304970,367997,28.2,0.02
977,2021-04-14,ABR,6502,2896,3606,4423,2079,ITF,ITF1,13,Abruzzo,Abruzzo,1304970,374499,28.7,0.5
978,2021-03-11,ABR,5446,2193,3253,4307,1139,ITF,ITF1,13,Abruzzo,Abruzzo,1304970,379945,29.12,0.42
979,2021-01-06,ABR,1830,664,1166,1830,0,ITF,ITF1,13,Abruzzo,Abruzzo,1304970,381775,29.26,0.14
980,2021-01-04,ABR,1401,575,826,1401,0,ITF,ITF1,13,Abruzzo,Abruzzo,1304970,383176,29.36,0.11
981,2021-04-16,ABR,7535,3488,4047,5618,1917,ITF,ITF1,13,Abruzzo,Abruzzo,1304970,390711,29.94,0.58
982,2021-05-03,ABR,11110,5241,5869,7260,3850,ITF,ITF1,13,Abruzzo,Abruzzo,1304970,401821,30.79,0.85
983,2021-03-13,ABR,4124,1420,2704,3082,1042,ITF,ITF1,13,Abruzzo,Abruzzo,1304970,405945,31.11,0.32
984,2021-03-30,ABR,5056,2197,2859,3232,1824,ITF,ITF1,13,Abruzzo,Abruzzo,1304970,411001,31.5,0.39
985,2021-03-20,ABR,4787,2197,2590,2618,2169,ITF,ITF1,13,Abruzzo,Abruzzo,1304970,415788,31.86,0.37
986,2021-01-29,ABR,1386,449,937,74,1312,ITF,ITF1,13,Abruzzo,Abruzzo,1304970,417174,31.97,0.11
987,2021-03-19,ABR,5794,2584,3210,2774,3020,ITF,ITF1,13,Abruzzo,Abruzzo,1304970,422968,32.41,0.44
988,2021-05-08,ABR,10302,4876,5426,6466,3836,ITF,ITF1,13,Abruzzo,Abruzzo,1304970,433270,33.2,0.79
989,2021-01-14,ABR,530,189,341,530,0,ITF,ITF1,13,Abruzzo,Abruzzo,1304970,433800,33.24,0.04
990,2021-03-05,ABR,5348,1957,3391,4651,697,ITF,ITF1,13,Abruzzo,Abruzzo,1304970,439148,33.65,0.41
991,2021-04-24,ABR,8710,3970,4740,7179,1531,ITF,ITF1,13,Abruzzo,Abruzzo,1304970,447858,34.32,0.67
992,2021-01-16,ABR,928,428,500,928,0,ITF,ITF1,13,Abruzzo,Abruzzo,1304970,448786,34.39,0.07
993,2021-01-09,ABR,1483,565,918,1483,0,ITF,ITF1,13,Abruzzo,Abruzzo,1304970,450269,34.5,0.11
994,2021-03-25,ABR,5686,2561,3125,3070,2616,ITF,ITF1,13,Abruzzo,Abruzzo,1304970,455955,34.94,0.44
995,2021-05-21,ABR,13009,6332,6677,8029,4980,ITF,ITF1,13,Abruzzo,Abruzzo,1304970,468964,35.94,1.0
996,2021-03-18,ABR,3896,1651,2245,2065,1831,ITF,ITF1,13,Abruzzo,Abruzzo,1304970,472860,36.24,0.3
997,2021-05-07,ABR,12206,5709,6497,7775,4431,ITF,ITF1,13,Abruzzo,Abruzzo,1304970,485066,37.17,0.94
998,2021-02-26,ABR,3914,1670,2244,2946,968,ITF,ITF1,13,Abruzzo,Abruzzo,1304970,488980,37.47,0.3
999,2021-02-23,ABR,2782,1275,1507,2771,11,ITF,ITF1,13,Abruzzo,Abruzzo,1304970,491762,37.68,0.21
1000,2021-02-08,ABR,1197,396,801,487,710,ITF,ITF1,13,Abruzzo,Abruzzo,1304970,492959,37.78,0.09
1001,2021-04-13,ABR,5880,2753,3127,4680,1200,ITF,ITF1,13,Abruzzo,Abruzzo,1304970,498839,38.23,0.45
1002,2021-05-19,ABR,10694,5110,5584,7655,3039,ITF,ITF1,13,Abruzzo,Abruzzo,1304970,509533,39.05,0.82
1003,2021-01-30,ABR,1510,567,943,69,1441,ITF,ITF1,13,Abruzzo,Abruzzo,1304970,511043,39.16,0.12
1004,2021-03-21,ABR,2134,913,1221,843,1291,ITF,ITF1,13,Abruzzo,Abruzzo,1304970,513177,39.32,0.16
1005,2021-05-28,ABR,13811,6203,7608,7499,6312,ITF,ITF1,13,Abruzzo,Abruzzo,1304970,526988,40.38,1.06
1006,2021-01-13,ABR,1253,440,813,1253,0,ITF,ITF1,13,Abruzzo,Abruzzo,1304970,528241,40.48,0.1
1007,2021-03-04,ABR,5937,2358,3579,5016,921,ITF,ITF1,13,Abruzzo,Abruzzo,1304970,534178,40.93,0.45
1008,2021-04-09,ABR,8791,4139,4652,6252,2539,ITF,ITF1,13,Abruzzo,Abruzzo,1304970,542969,41.61,0.67
1009,2021-04-04,ABR,1630,767,863,1501,129,ITF,ITF1,13,Abruzzo,Abruzzo,1304970,544599,41.73,0.12
1010,2021-04-02,ABR,6684,3093,3591,5197,1487,ITF,ITF1,13,Abruzzo,Abruzzo,1304970,551283,42.24,0.51
1011,2021-02-04,ABR,1679,615,1064,609,1070,ITF,ITF1,13,Abruzzo,Abruzzo,1304970,552962,42.37,0.13
1012,2021-02-27,ABR,2813,1339,1474,2547,266,ITF,ITF1,13,Abruzzo,Abruzzo,1304970,555775,42.59,0.22
1013,2021-03-06,ABR,4176,1357,2819,3606,570,ITF,ITF1,13,Abruzzo,Abruzzo,1304970,559951,42.91,0.32
1014,2021-02-06,ABR,1610,742,868,602,1008,ITF,ITF1,13,Abruzzo,Abruzzo,1304970,561561,43.03,0.12
1015,2021-03-14,ABR,1883,731,1152,1216,667,ITF,ITF1,13,Abruzzo,Abruzzo,1304970,563444,43.18,0.14
1016,2021-05-17,ABR,11025,5039,5986,6166,4859,ITF,ITF1,13,Abruzzo,Abruzzo,1304970,574469,44.02,0.84
1017,2021-01-20,ABR,447,156,291,445,2,ITF,ITF1,13,Abruzzo,Abruzzo,1304970,574916,44.06,0.03
1018,2021-05-02,ABR,10422,5087,5335,5212,5210,ITF,ITF1,13,Abruzzo,Abruzzo,1304970,585338,44.85,0.8
1019,2021-04-30,ABR,12391,5803,6588,6702,5689,ITF,ITF1,13,Abruzzo,Abruzzo,1304970,597729,45.8,0.95
1020,2021-02-20,ABR,4777,1842,2935,4701,76,ITF,ITF1,13,Abruzzo,Abruzzo,1304970,602506,46.17,0.37
1021,2021-01-18,ABR,122,48,74,46,76,ITF,ITF1,13,Abruzzo,Abruzzo,1304970,602628,46.18,0.01
1022,2021-05-12,ABR,9616,4586,5030,6046,3570,ITF,ITF1,13,Abruzzo,Abruzzo,1304970,612244,46.92,0.74
1023,2021-03-16,ABR,3484,1452,2032,1830,1654,ITF,ITF1,13,Abruzzo,Abruzzo,1304970,615728,47.18,0.27
1024,2021-05-05,ABR,11572,5541,6031,6443,5129,ITF,ITF1,13,Abruzzo,Abruzzo,1304970,627300,48.07,0.89
1025,2021-03-09,ABR,5168,1795,3373,4229,939,ITF,ITF1,13,Abruzzo,Abruzzo,1304970,632468,48.47,0.4
1026,2021-04-28,ABR,9510,4585,4925,7486,2024,ITF,ITF1,13,Abruzzo,Abruzzo,1304970,641978,49.19,0.73
1027,2021-02-01,ABR,1632,573,1059,271,1361,ITF,ITF1,13,Abruzzo,Abruzzo,1304970,643610,49.32,0.13
1028,2021-03-23,ABR,4782,2143,2639,2216,2566,ITF,ITF1,13,Abruzzo,Abruzzo,1304970,648392,49.69,0.37
1029,2021-03-02,ABR,3963,1676,2287,3279,684,ITF,ITF1,13,Abruzzo,Abruzzo,1304970,652355,49.99,0.3
1030,2021-01-11,ABR,1551,557,994,1551,0,ITF,ITF1,13,Abruzzo,Abruzzo,1304970,653906,50.11,0.12
1031,2021-02-16,ABR,1918,842,1076,1906,12,ITF,ITF1,13,Abruzzo,Abruzzo,1304970,655824,50.26,0.15
1032,2021-04-21,ABR,6384,3100,3284,4710,1674,ITF,ITF1,13,Abruzzo,Abruzzo,1304970,662208,50.75,0.49
1033,2021-04-06,ABR,7682,3581,4101,5363,2319,ITF,ITF1,13,Abruzzo,Abruzzo,1304970,669890,51.33,0.59
1034,2021-02-15,ABR,1794,831,963,1752,42,ITF,ITF1,13,Abruzzo,Abruzzo,1304970,671684,51.47,0.14
1035,2021-03-07,ABR,2516,628,1888,2516,0,ITF,ITF1,13,Abruzzo,Abruzzo,1304970,674200,51.66,0.19
1036,2021-01-27,ABR,1364,515,849,39,1325,ITF,ITF1,13,Abruzzo,Abruzzo,1304970,675564,51.77,0.1
1037,2021-05-14,ABR,10601,5076,5525,5443,5158,ITF,ITF1,13,Abruzzo,Abruzzo,1304970,686165,52.58,0.81
1038,2021-04-01,ABR,5521,2442,3079,3434,2087,ITF,ITF1,13,Abruzzo,Abruzzo,1304970,691686,53.0,0.42
1039,2021-02-18,ABR,2288,933,1355,2158,130,ITF,ITF1,13,Abruzzo,Abruzzo,1304970,693974,53.18,0.18
1040,2021-05-22,ABR,13060,6349,6711,8168,4892,ITF,ITF1,13,Abruzzo,Abruzzo,1304970,707034,54.18,1.0
1041,2021-04-18,ABR,5812,2727,3085,4870,942,ITF,ITF1,13,Abruzzo,Abruzzo,1304970,712846,54.63,0.45
1042,2021-04-23,ABR,7372,3385,3987,5070,2302,ITF,ITF1,13,Abruzzo,Abruzzo,1304970,720218,55.19,0.56
1043,2021-05-10,ABR,10109,4786,5323,5458,4651,ITF,ITF1,13,Abruzzo,Abruzzo,1304970,730327,55.97,0.77
1044,2021-02-13,ABR,848,383,465,436,412,ITF,ITF1,13,Abruzzo,Abruzzo,1304970,731175,56.03,0.06
1045,2021-01-28,ABR,1433,495,938,12,1421,ITF,ITF1,13,Abruzzo,Abruzzo,1304970,732608,56.14,0.11
1046,2021-05-09,ABR,9154,4090,5064,4282,4872,ITF,ITF1,13,Abruzzo,Abruzzo,1304970,741762,56.84,0.7
1047,2021-04-11,ABR,5330,2606,2724,4847,483,ITF,ITF1,13,Abruzzo,Abruzzo,1304970,747092,57.25,0.41
1048,2021-05-26,ABR,13308,5906,7402,8381,4927,ITF,ITF1,13,Abruzzo,Abruzzo,1304970,760400,58.27,1.02
1049,2021-01-25,ABR,1603,632,971,19,1584,ITF,ITF1,13,Abruzzo,Abruzzo,1304970,762003,58.39,0.12
1050,2021-04-30,CAL,14910,7318,7592,10603,4307,ITF,ITF6,18,Calabria,Calabria,1947131,14910,0.77,0.77
1051,2021-01-18,CAL,1262,568,694,1043,219,ITF,ITF6,18,Calabria,Calabria,1947131,16172,0.83,0.06
1052,2021-03-27,CAL,8598,3904,4694,4588,4010,ITF,ITF6,18,Calabria,Calabria,1947131,24770,1.27,0.44
1053,2021-04-13,CAL,6850,3338,3512,5541,1309,ITF,ITF6,18,Calabria,Calabria,1947131,31620,1.62,0.35
1054,2021-02-20,CAL,1415,758,657,1097,318,ITF,ITF6,18,Calabria,Calabria,1947131,33035,1.7,0.07
1055,2021-03-11,CAL,7244,3416,3828,5982,1262,ITF,ITF6,18,Calabria,Calabria,1947131,40279,2.07,0.37
1056,2021-05-16,CAL,13774,6725,7049,9960,3814,ITF,ITF6,18,Calabria,Calabria,1947131,54053,2.78,0.71
1057,2021-05-14,CAL,19944,9588,10356,13073,6871,ITF,ITF6,18,Calabria,Calabria,1947131,73997,3.8,1.02
1058,2021-02-03,CAL,2764,1429,1335,581,2183,ITF,ITF6,18,Calabria,Calabria,1947131,76761,3.94,0.14
1059,2021-04-11,CAL,4166,1895,2271,2223,1943,ITF,ITF6,18,Calabria,Calabria,1947131,80927,4.16,0.21
1060,2021-01-03,CAL,6,3,3,6,0,ITF,ITF6,18,Calabria,Calabria,1947131,80933,4.16,0.0
1061,2021-03-08,CAL,5386,2878,2508,4324,1062,ITF,ITF6,18,Calabria,Calabria,1947131,86319,4.43,0.28
1062,2021-01-20,CAL,1398,625,773,1397,1,ITF,ITF6,18,Calabria,Calabria,1947131,87717,4.5,0.07
1063,2021-03-25,CAL,7383,3461,3922,4549,2834,ITF,ITF6,18,Calabria,Calabria,1947131,95100,4.88,0.38
1064,2021-02-25,CAL,2866,1545,1321,2280,586,ITF,ITF6,18,Calabria,Calabria,1947131,97966,5.03,0.15
1065,2021-05-04,CAL,16283,7481,8802,11655,4628,ITF,ITF6,18,Calabria,Calabria,1947131,114249,5.87,0.84
1066,2021-01-22,CAL,658,274,384,656,2,ITF,ITF6,18,Calabria,Calabria,1947131,114907,5.9,0.03
1067,2021-03-06,CAL,8343,4304,4039,7551,792,ITF,ITF6,18,Calabria,Calabria,1947131,123250,6.33,0.43
1068,2021-05-09,CAL,9672,4501,5171,6139,3533,ITF,ITF6,18,Calabria,Calabria,1947131,132922,6.83,0.5
1069,2021-01-23,CAL,400,186,214,358,42,ITF,ITF6,18,Calabria,Calabria,1947131,133322,6.85,0.02
1070,2021-03-28,CAL,2567,1183,1384,1433,1134,ITF,ITF6,18,Calabria,Calabria,1947131,135889,6.98,0.13
1071,2021-01-30,CAL,2178,1149,1029,358,1820,ITF,ITF6,18,Calabria,Calabria,1947131,138067,7.09,0.11
1072,2021-02-17,CAL,1831,796,1035,1620,211,ITF,ITF6,18,Calabria,Calabria,1947131,139898,7.18,0.09
1073,2021-04-08,CAL,9476,4463,5013,5837,3639,ITF,ITF6,18,Calabria,Calabria,1947131,149374,7.67,0.49
1074,2021-04-01,CAL,8550,3872,4678,3979,4571,ITF,ITF6,18,Calabria,Calabria,1947131,157924,8.11,0.44
1075,2021-05-21,CAL,21316,10849,10467,13955,7361,ITF,ITF6,18,Calabria,Calabria,1947131,179240,9.21,1.09
1076,2021-02-06,CAL,2906,1337,1569,442,2464,ITF,ITF6,18,Calabria,Calabria,1947131,182146,9.35,0.15
1077,2021-04-15,CAL,7605,3725,3880,5981,1624,ITF,ITF6,18,Calabria,Calabria,1947131,189751,9.75,0.39
1078,2021-02-10,CAL,2509,1078,1431,884,1625,ITF,ITF6,18,Calabria,Calabria,1947131,192260,9.87,0.13
1079,2021-05-28,CAL,20897,10134,10763,11463,9434,ITF,ITF6,18,Calabria,Calabria,1947131,213157,10.95,1.07
1080,2021-03-09,CAL,6242,3224,3018,5263,979,ITF,ITF6,18,Calabria,Calabria,1947131,219399,11.27,0.32
1081,2021-04-27,CAL,9930,4885,5045,7989,1941,ITF,ITF6,18,Calabria,Calabria,1947131,229329,11.78,0.51
1082,2021-02-22,CAL,2031,1028,1003,1475,556,ITF,ITF6,18,Calabria,Calabria,1947131,231360,11.88,0.1
1083,2021-04-18,CAL,5838,2789,3049,4931,907,ITF,ITF6,18,Calabria,Calabria,1947131,237198,12.18,0.3
1084,2021-02-13,CAL,1394,603,791,1031,363,ITF,ITF6,18,Calabria,Calabria,1947131,238592,12.25,0.07
1085,2021-04-04,CAL,1763,887,876,1262,501,ITF,ITF6,18,Calabria,Calabria,1947131,240355,12.34,0.09
1086,2021-03-18,CAL,4368,2037,2331,2342,2026,ITF,ITF6,18,Calabria,Calabria,1947131,244723,12.57,0.22
1087,2021-01-27,CAL,1456,733,723,396,1060,ITF,ITF6,18,Calabria,Calabria,1947131,246179,12.64,0.07
1088,2021-01-06,CAL,928,501,427,928,0,ITF,ITF6,18,Calabria,Calabria,1947131,247107,12.69,0.05
1089,2021-01-13,CAL,2031,1023,1008,2031,0,ITF,ITF6,18,Calabria,Calabria,1947131,249138,12.8,0.1
1090,2021-04-16,CAL,10350,5058,5292,8698,1652,ITF,ITF6,18,Calabria,Calabria,1947131,259488,13.33,0.53
1091,2021-02-18,CAL,1822,825,997,1596,226,ITF,ITF6,18,Calabria,Calabria,1947131,261310,13.42,0.09
1092,2021-04-23,CAL,12864,6336,6528,9454,3410,ITF,ITF6,18,Calabria,Calabria,1947131,274174,14.08,0.66
1093,2021-01-15,CAL,2795,1258,1537,2795,0,ITF,ITF6,18,Calabria,Calabria,1947131,276969,14.22,0.14
1094,2021-03-20,CAL,6692,3067,3625,4196,2496,ITF,ITF6,18,Calabria,Calabria,1947131,283661,14.57,0.34
1095,2021-03-13,CAL,6829,2980,3849,5861,968,ITF,ITF6,18,Calabria,Calabria,1947131,290490,14.92,0.35
1096,2021-04-25,CAL,15835,8033,7802,14698,1137,ITF,ITF6,18,Calabria,Calabria,1947131,306325,15.73,0.81
1097,2021-05-07,CAL,16071,7575,8496,9702,6369,ITF,ITF6,18,Calabria,Calabria,1947131,322396,16.56,0.83
1098,2021-05-24,CAL,17676,8804,8872,10003,7673,ITF,ITF6,18,Calabria,Calabria,1947131,340072,17.47,0.91
1099,2021-01-08,CAL,2134,1022,1112,2134,0,ITF,ITF6,18,Calabria,Calabria,1947131,342206,17.57,0.11
1100,2021-02-27,CAL,3926,2020,1906,3547,379,ITF,ITF6,18,Calabria,Calabria,1947131,346132,17.78,0.2
1101,2021-03-04,CAL,5455,3177,2278,4659,796,ITF,ITF6,18,Calabria,Calabria,1947131,351587,18.06,0.28
1102,2021-01-29,CAL,2044,984,1060,230,1814,ITF,ITF6,18,Calabria,Calabria,1947131,353631,18.16,0.1
1103,2021-05-02,CAL,12503,5836,6667,10663,1840,ITF,ITF6,18,Calabria,Calabria,1947131,366134,18.8,0.64
1104,2021-03-29,CAL,5687,2405,3282,3931,1756,ITF,ITF6,18,Calabria,Calabria,1947131,371821,19.1,0.29
1105,2021-01-04,CAL,1051,517,534,1051,0,ITF,ITF6,18,Calabria,Calabria,1947131,372872,19.15,0.05
1106,2021-01-25,CAL,1068,514,554,148,920,ITF,ITF6,18,Calabria,Calabria,1947131,373940,19.2,0.05
1107,2021-01-11,CAL,2155,1041,1114,2155,0,ITF,ITF6,18,Calabria,Calabria,1947131,376095,19.32,0.11
1108,2021-05-05,CAL,13613,6517,7096,8487,5126,ITF,ITF6,18,Calabria,Calabria,1947131,389708,20.01,0.7
1109,2021-03-02,CAL,4367,2489,1878,3611,756,ITF,ITF6,18,Calabria,Calabria,1947131,394075,20.24,0.22
1110,2021-03-16,CAL,3833,1882,1951,2174,1659,ITF,ITF6,18,Calabria,Calabria,1947131,397908,20.44,0.2
1111,2021-03-01,CAL,2723,1545,1178,2269,454,ITF,ITF6,18,Calabria,Calabria,1947131,400631,20.58,0.14
1112,2021-01-10,CAL,929,524,405,929,0,ITF,ITF6,18,Calabria,Calabria,1947131,401560,20.62,0.05
1113,2021-02-01,CAL,2494,1191,1303,243,2251,ITF,ITF6,18,Calabria,Calabria,1947131,404054,20.75,0.13
1114,2021-05-26,CAL,18482,9133,9349,10290,8192,ITF,ITF6,18,Calabria,Calabria,1947131,422536,21.7,0.95
1115,2021-03-30,CAL,6182,2653,3529,3485,2697,ITF,ITF6,18,Calabria,Calabria,1947131,428718,22.02,0.32
1116,2021-05-19,CAL,18441,9136,9305,11422,7019,ITF,ITF6,18,Calabria,Calabria,1947131,447159,22.97,0.95
1117,2021-03-23,CAL,5252,2459,2793,3443,1809,ITF,ITF6,18,Calabria,Calabria,1947131,452411,23.23,0.27
1118,2021-05-12,CAL,16310,7918,8392,10886,5424,ITF,ITF6,18,Calabria,Calabria,1947131,468721,24.07,0.84
1119,2020-12-27,CAL,281,156,125,281,0,ITF,ITF6,18,Calabria,Calabria,1947131,469002,24.09,0.01
1120,2021-02-15,CAL,1140,539,601,991,149,ITF,ITF6,18,Calabria,Calabria,1947131,470142,24.15,0.06
1121,2021-04-06,CAL,7526,3395,4131,4197,3329,ITF,ITF6,18,Calabria,Calabria,1947131,477668,24.53,0.39
1122,2021-01-31,CAL,1108,555,553,154,954,ITF,ITF6,18,Calabria,Calabria,1947131,478776,24.59,0.06
1123,2020-12-28,CAL,6,2,4,6,0,ITF,ITF6,18,Calabria,Calabria,1947131,478782,24.59,0.0
1124,2021-04-09,CAL,7936,3716,4220,5010,2926,ITF,ITF6,18,Calabria,Calabria,1947131,486718,25.0,0.41
1125,2021-03-31,CAL,8871,4027,4844,4916,3955,ITF,ITF6,18,Calabria,Calabria,1947131,495589,25.45,0.46
1126,2021-02-19,CAL,1508,681,827,1247,261,ITF,ITF6,18,Calabria,Calabria,1947131,497097,25.53,0.08
1127,2021-04-28,CAL,12531,6060,6471,9673,2858,ITF,ITF6,18,Calabria,Calabria,1947131,509628,26.17,0.64
1128,2021-01-16,CAL,2394,1120,1274,2394,0,ITF,ITF6,18,Calabria,Calabria,1947131,512022,26.3,0.12
1129,2021-05-15,CAL,26669,12748,13921,19898,6771,ITF,ITF6,18,Calabria,Calabria,1947131,538691,27.67,1.37
1130,2021-02-02,CAL,2288,1114,1174,177,2111,ITF,ITF6,18,Calabria,Calabria,1947131,540979,27.78,0.12
1131,2021-03-10,CAL,6547,3309,3238,5268,1279,ITF,ITF6,18,Calabria,Calabria,1947131,547526,28.12,0.34
1132,2021-05-13,CAL,15871,7612,8259,11213,4658,ITF,ITF6,18,Calabria,Calabria,1947131,563397,28.93,0.82
1133,2021-05-17,CAL,15078,7534,7544,10356,4722,ITF,ITF6,18,Calabria,Calabria,1947131,578475,29.71,0.77
1134,2021-02-04,CAL,3475,1659,1816,652,2823,ITF,ITF6,18,Calabria,Calabria,1947131,581950,29.89,0.18
1135,2021-02-21,CAL,609,286,323,532,77,ITF,ITF6,18,Calabria,Calabria,1947131,582559,29.92,0.03
1136,2021-02-11,CAL,2331,1041,1290,1082,1249,ITF,ITF6,18,Calabria,Calabria,1947131,584890,30.04,0.12
1137,2021-05-23,CAL,11370,5553,5817,7038,4332,ITF,ITF6,18,Calabria,Calabria,1947131,596260,30.62,0.58
1138,2021-01-05,CAL,1462,682,780,1462,0,ITF,ITF6,18,Calabria,Calabria,1947131,597722,30.7,0.08
1139,2021-03-14,CAL,2687,1060,1627,2274,413,ITF,ITF6,18,Calabria,Calabria,1947131,600409,30.84,0.14
1140,2021-04-24,CAL,19018,9488,9530,15592,3426,ITF,ITF6,18,Calabria,Calabria,1947131,619427,31.81,0.98
1141,2021-02-26,CAL,3061,1631,1430,2609,452,ITF,ITF6,18,Calabria,Calabria,1947131,622488,31.97,0.16
1142,2021-01-07,CAL,2183,1064,1119,2183,0,ITF,ITF6,18,Calabria,Calabria,1947131,624671,32.08,0.11
1143,2021-04-17,CAL,10846,5083,5763,9047,1799,ITF,ITF6,18,Calabria,Calabria,1947131,635517,32.64,0.56
1144,2021-05-01,CAL,16613,7920,8693,12415,4198,ITF,ITF6,18,Calabria,Calabria,1947131,652130,33.49,0.85
1145,2021-03-05,CAL,6217,3608,2609,5644,573,ITF,ITF6,18,Calabria,Calabria,1947131,658347,33.81,0.32
1146,2021-03-12,CAL,5111,2452,2659,4041,1070,ITF,ITF6,18,Calabria,Calabria,1947131,663458,34.07,0.26
1147,2021-01-14,CAL,2634,1248,1386,2634,0,ITF,ITF6,18,Calabria,Calabria,1947131,666092,34.21,0.14
1148,2021-01-21,CAL,960,445,515,930,30,ITF,ITF6,18,Calabria,Calabria,1947131,667052,34.26,0.05
1149,2021-03-24,CAL,7591,3455,4136,4358,3233,ITF,ITF6,18,Calabria,Calabria,1947131,674643,34.65,0.39
1150,2021-04-12,CAL,6901,3349,3552,5248,1653,ITF,ITF6,18,Calabria,Calabria,1947131,681544,35.0,0.35
1151,2021-01-19,CAL,1111,490,621,1101,10,ITF,ITF6,18,Calabria,Calabria,1947131,682655,35.06,0.06
1152,2021-01-17,CAL,867,418,449,801,66,ITF,ITF6,18,Calabria,Calabria,1947131,683522,35.1,0.04
1153,2021-04-29,CAL,11792,5734,6058,8286,3506,ITF,ITF6,18,Calabria,Calabria,1947131,695314,35.71,0.61
1154,2021-01-26,CAL,1806,859,947,278,1528,ITF,ITF6,18,Calabria,Calabria,1947131,697120,35.8,0.09
1155,2021-04-05,CAL,3501,1648,1853,2602,899,ITF,ITF6,18,Calabria,Calabria,1947131,700621,35.98,0.18
1156,2021-05-25,CAL,16429,8004,8425,10330,6099,ITF,ITF6,18,Calabria,Calabria,1947131,717050,36.83,0.84
1157,2021-04-22,CAL,9620,4798,4822,6778,2842,ITF,ITF6,18,Calabria,Calabria,1947131,726670,37.32,0.49
1158,2021-01-09,CAL,1923,1040,883,1923,0,ITF,ITF6,18,Calabria,Calabria,1947131,728593,37.42,0.1
1159,2021-04-10,CAL,11373,5126,6247,6559,4814,ITF,ITF6,18,Calabria,Calabria,1947131,739966,38.0,0.58
1160,2021-02-05,CAL,3800,1710,2090,490,3310,ITF,ITF6,18,Calabria,Calabria,1947131,743766,38.2,0.2
1161,2021-03-26,CAL,7744,3674,4070,4626,3118,ITF,ITF6,18,Calabria,Calabria,1947131,751510,38.6,0.4
1162,2021-02-08,CAL,1847,733,1114,661,1186,ITF,ITF6,18,Calabria,Calabria,1947131,753357,38.69,0.09
1163,2021-04-20,CAL,7837,3947,3890,6109,1728,ITF,ITF6,18,Calabria,Calabria,1947131,761194,39.09,0.4
1164,2021-04-21,CAL,11562,5811,5751,8638,2924,ITF,ITF6,18,Calabria,Calabria,1947131,772756,39.69,0.59
1165,2021-01-12,CAL,2063,1020,1043,2063,0,ITF,ITF6,18,Calabria,Calabria,1947131,774819,39.79,0.11
1166,2021-02-24,CAL,1847,942,905,1372,475,ITF,ITF6,18,Calabria,Calabria,1947131,776666,39.89,0.09
1167,2021-03-03,CAL,4999,2729,2270,3928,1071,ITF,ITF6,18,Calabria,Calabria,1947131,781665,40.14,0.26
1168,2021-05-03,CAL,14740,6755,7985,10534,4206,ITF,ITF6,18,Calabria,Calabria,1947131,796405,40.9,0.76
1169,2021-03-21,CAL,4453,1925,2528,2728,1725,ITF,ITF6,18,Calabria,Calabria,1947131,800858,41.13,0.23
1170,2021-03-07,CAL,3314,1683,1631,3225,89,ITF,ITF6,18,Calabria,Calabria,1947131,804172,41.3,0.17
1171,2021-05-10,CAL,13139,6094,7045,7736,5403,ITF,ITF6,18,Calabria,Calabria,1947131,817311,41.98,0.67
1172,2021-05-11,CAL,15125,7313,7812,10351,4774,ITF,ITF6,18,Calabria,Calabria,1947131,832436,42.75,0.78
1173,2021-01-24,CAL,44,18,26,39,5,ITF,ITF6,18,Calabria,Calabria,1947131,832480,42.75,0.0
1174,2021-02-23,CAL,1590,753,837,1475,115,ITF,ITF6,18,Calabria,Calabria,1947131,834070,42.84,0.08
1175,2021-04-07,CAL,6436,2905,3531,3714,2722,ITF,ITF6,18,Calabria,Calabria,1947131,840506,43.17,0.33
1176,2021-02-14,CAL,461,209,252,431,30,ITF,ITF6,18,Calabria,Calabria,1947131,840967,43.19,0.02
1177,2021-03-17,CAL,3938,1753,2185,2102,1836,ITF,ITF6,18,Calabria,Calabria,1947131,844905,43.39,0.2
1178,2021-05-06,CAL,13273,6276,6997,8987,4286,ITF,ITF6,18,Calabria,Calabria,1947131,858178,44.07,0.68
1179,2021-04-19,CAL,7822,3773,4049,6174,1648,ITF,ITF6,18,Calabria,Calabria,1947131,866000,44.48,0.4
1180,2021-02-28,CAL,2255,1026,1229,2103,152,ITF,ITF6,18,Calabria,Calabria,1947131,868255,44.59,0.12
1181,2021-05-20,CAL,16898,8438,8460,11293,5605,ITF,ITF6,18,Calabria,Calabria,1947131,885153,45.46,0.87
1182,2021-02-07,CAL,859,427,432,147,712,ITF,ITF6,18,Calabria,Calabria,1947131,886012,45.5,0.04
1183,2021-03-15,CAL,3542,1682,1860,2107,1435,ITF,ITF6,18,Calabria,Calabria,1947131,889554,45.69,0.18
1184,2021-05-18,CAL,15549,7787,7762,12082,3467,ITF,ITF6,18,Calabria,Calabria,1947131,905103,46.48,0.8
1185,2021-03-22,CAL,4880,2289,2591,3129,1751,ITF,ITF6,18,Calabria,Calabria,1947131,909983,46.73,0.25
1186,2021-04-14,CAL,8157,3930,4227,6702,1455,ITF,ITF6,18,Calabria,Calabria,1947131,918140,47.15,0.42
1187,2021-02-16,CAL,1734,732,1002,1456,278,ITF,ITF6,18,Calabria,Calabria,1947131,919874,47.24,0.09
1188,2021-02-09,CAL,2147,905,1242,948,1199,ITF,ITF6,18,Calabria,Calabria,1947131,922021,47.35,0.11
1189,2021-05-27,CAL,17446,8588,8858,9744,7702,ITF,ITF6,18,Calabria,Calabria,1947131,939467,48.25,0.9
1190,2021-02-12,CAL,1710,667,1043,945,765,ITF,ITF6,18,Calabria,Calabria,1947131,941177,48.34,0.09
1191,2021-04-03,CAL,8886,3815,5071,4267,4619,ITF,ITF6,18,Calabria,Calabria,1947131,950063,48.79,0.46
1192,2021-01-28,CAL,2234,1108,1126,83,2151,ITF,ITF6,18,Calabria,Calabria,1947131,952297,48.91,0.11
1193,2021-05-22,CAL,22069,10519,11550,14222,7847,ITF,ITF6,18,Calabria,Calabria,1947131,974366,50.04,1.13
1194,2021-04-02,CAL,8153,3712,4441,4329,3824,ITF,ITF6,18,Calabria,Calabria,1947131,982519,50.46,0.42
1195,2021-05-08,CAL,18265,8321,9944,10454,7811,ITF,ITF6,18,Calabria,Calabria,1947131,1000784,51.4,0.94
1196,2021-03-19,CAL,4186,1947,2239,1900,2286,ITF,ITF6,18,Calabria,Calabria,1947131,1004970,51.61,0.21
1197,2021-04-26,CAL,10207,5075,5132,7786,2421,ITF,ITF6,18,Calabria,Calabria,1947131,1015177,52.14,0.52
1198,2021-01-02,CAL,166,94,72,166,0,ITF,ITF6,18,Calabria,Calabria,1947131,1015343,52.15,0.01
1199,2021-03-10,MOL,1737,720,1017,1687,50,ITF,ITF2,14,Molise,Molise,305617,1737,0.57,0.57
1200,2021-05-13,MOL,3037,1409,1628,2580,457,ITF,ITF2,14,Molise,Molise,305617,4774,1.56,0.99
1201,2021-02-21,MOL,573,227,346,571,2,ITF,ITF2,14,Molise,Molise,305617,5347,1.75,0.19
1202,2021-04-26,MOL,1157,521,636,826,331,ITF,ITF2,14,Molise,Molise,305617,6504,2.13,0.38
1203,2021-02-04,MOL,758,295,463,77,681,ITF,ITF2,14,Molise,Molise,305617,7262,2.38,0.25
1204,2021-01-17,MOL,78,38,40,48,30,ITF,ITF2,14,Molise,Molise,305617,7340,2.4,0.03
1205,2021-04-10,MOL,2635,1259,1376,2483,152,ITF,ITF2,14,Molise,Molise,305617,9975,3.26,0.86
1206,2021-02-05,MOL,593,269,324,55,538,ITF,ITF2,14,Molise,Molise,305617,10568,3.46,0.19
1207,2021-04-12,MOL,1299,557,742,1048,251,ITF,ITF2,14,Molise,Molise,305617,11867,3.88,0.43
1208,2021-03-07,MOL,1132,501,631,1130,2,ITF,ITF2,14,Molise,Molise,305617,12999,4.25,0.37
1209,2021-02-19,MOL,169,93,76,167,2,ITF,ITF2,14,Molise,Molise,305617,13168,4.31,0.06
1210,2021-05-15,MOL,2979,1398,1581,2595,384,ITF,ITF2,14,Molise,Molise,305617,16147,5.28,0.97
1211,2021-02-02,MOL,539,176,363,216,323,ITF,ITF2,14,Molise,Molise,305617,16686,5.46,0.18
1212,2021-04-28,MOL,1683,913,770,466,1217,ITF,ITF2,14,Molise,Molise,305617,18369,6.01,0.55
1213,2021-01-16,MOL,420,166,254,420,0,ITF,ITF2,14,Molise,Molise,305617,18789,6.15,0.14
1214,2021-01-31,MOL,268,70,198,6,262,ITF,ITF2,14,Molise,Molise,305617,19057,6.24,0.09
1215,2021-04-05,MOL,391,189,202,292,99,ITF,ITF2,14,Molise,Molise,305617,19448,6.36,0.13
1216,2021-03-31,MOL,2193,919,1274,1374,819,ITF,ITF2,14,Molise,Molise,305617,21641,7.08,0.72
1217,2021-04-17,MOL,3051,1500,1551,1565,1486,ITF,ITF2,14,Molise,Molise,305617,24692,8.08,1.0
1218,2021-05-01,MOL,2640,1265,1375,419,2221,ITF,ITF2,14,Molise,Molise,305617,27332,8.94,0.86
1219,2021-03-05,MOL,1219,649,570,1015,204,ITF,ITF2,14,Molise,Molise,305617,28551,9.34,0.4
1220,2021-02-26,MOL,563,260,303,490,73,ITF,ITF2,14,Molise,Molise,305617,29114,9.53,0.18
1221,2021-03-19,MOL,1184,482,702,757,427,ITF,ITF2,14,Molise,Molise,305617,30298,9.91,0.39
1222,2021-01-14,MOL,646,239,407,646,0,ITF,ITF2,14,Molise,Molise,305617,30944,10.13,0.21
1223,2021-04-24,MOL,2540,1197,1343,699,1841,ITF,ITF2,14,Molise,Molise,305617,33484,10.96,0.83
1224,2021-01-21,MOL,6,2,4,6,0,ITF,ITF2,14,Molise,Molise,305617,33490,10.96,0.0
1225,2021-03-12,MOL,1459,637,822,1423,36,ITF,ITF2,14,Molise,Molise,305617,34949,11.44,0.48
1226,2021-01-28,MOL,613,217,396,17,596,ITF,ITF2,14,Molise,Molise,305617,35562,11.64,0.2
1227,2021-04-29,MOL,2237,1144,1093,890,1347,ITF,ITF2,14,Molise,Molise,305617,37799,12.37,0.73
1228,2021-03-24,MOL,1631,658,973,1229,402,ITF,ITF2,14,Molise,Molise,305617,39430,12.9,0.53
1229,2021-01-19,MOL,173,63,110,162,11,ITF,ITF2,14,Molise,Molise,305617,39603,12.96,0.06
1230,2021-03-26,MOL,2575,1045,1530,1933,642,ITF,ITF2,14,Molise,Molise,305617,42178,13.8,0.84
1231,2021-05-03,MOL,2480,1162,1318,2317,163,ITF,ITF2,14,Molise,Molise,305617,44658,14.61,0.81
1232,2021-05-10,MOL,2888,1285,1603,2515,373,ITF,ITF2,14,Molise,Molise,305617,47546,15.56,0.94
1233,2021-02-12,MOL,330,149,181,208,122,ITF,ITF2,14,Molise,Molise,305617,47876,15.67,0.11
1234,2021-03-15,MOL,832,338,494,587,245,ITF,ITF2,14,Molise,Molise,305617,48708,15.94,0.27
1235,2021-05-08,MOL,2972,1453,1519,1728,1244,ITF,ITF2,14,Molise,Molise,305617,51680,16.91,0.97
1236,2021-05-22,MOL,1307,706,601,1225,82,ITF,ITF2,14,Molise,Molise,305617,52987,17.34,0.43
1237,2021-03-02,MOL,667,383,284,509,158,ITF,ITF2,14,Molise,Molise,305617,53654,17.56,0.22
1238,2021-04-21,MOL,1862,788,1074,967,895,ITF,ITF2,14,Molise,Molise,305617,55516,18.17,0.61
1239,2021-05-18,MOL,1645,877,768,990,655,ITF,ITF2,14,Molise,Molise,305617,57161,18.7,0.54
1240,2021-03-22,MOL,1146,439,707,903,243,ITF,ITF2,14,Molise,Molise,305617,58307,19.08,0.37
1241,2021-05-25,MOL,1959,885,1074,1329,630,ITF,ITF2,14,Molise,Molise,305617,60266,19.72,0.64
1242,2021-02-07,MOL,66,32,34,19,47,ITF,ITF2,14,Molise,Molise,305617,60332,19.74,0.02
1243,2021-01-07,MOL,598,209,389,598,0,ITF,ITF2,14,Molise,Molise,305617,60930,19.94,0.2
1244,2021-04-02,MOL,1453,708,745,676,777,ITF,ITF2,14,Molise,Molise,305617,62383,20.41,0.48
1245,2021-02-11,MOL,293,133,160,257,36,ITF,ITF2,14,Molise,Molise,305617,62676,20.51,0.1
1246,2021-03-29,MOL,2033,835,1198,1547,486,ITF,ITF2,14,Molise,Molise,305617,64709,21.17,0.67
1247,2021-04-07,MOL,1688,847,841,1413,275,ITF,ITF2,14,Molise,Molise,305617,66397,21.73,0.55
1248,2021-02-23,MOL,582,223,359,363,219,ITF,ITF2,14,Molise,Molise,305617,66979,21.92,0.19
1249,2021-05-20,MOL,2528,1284,1244,2397,131,ITF,ITF2,14,Molise,Molise,305617,69507,22.74,0.83
1250,2021-04-14,MOL,1806,767,1039,1145,661,ITF,ITF2,14,Molise,Molise,305617,71313,23.33,0.59
1251,2021-02-16,MOL,156,70,86,150,6,ITF,ITF2,14,Molise,Molise,305617,71469,23.39,0.05
1252,2021-05-27,MOL,2825,1342,1483,1991,834,ITF,ITF2,14,Molise,Molise,305617,74294,24.31,0.92
1253,2021-02-09,MOL,359,170,189,197,162,ITF,ITF2,14,Molise,Molise,305617,74653,24.43,0.12
1254,2021-01-04,MOL,314,131,183,314,0,ITF,ITF2,14,Molise,Molise,305617,74967,24.53,0.1
1255,2021-05-06,MOL,2679,1214,1465,2081,598,ITF,ITF2,14,Molise,Molise,305617,77646,25.41,0.88
1256,2021-01-26,MOL,450,184,266,8,442,ITF,ITF2,14,Molise,Molise,305617,78096,25.55,0.15
1257,2021-03-17,MOL,908,385,523,576,332,ITF,ITF2,14,Molise,Molise,305617,79004,25.85,0.3
1258,2021-01-12,MOL,336,114,222,336,0,ITF,ITF2,14,Molise,Molise,305617,79340,25.96,0.11
1259,2021-02-24,MOL,666,278,388,333,333,ITF,ITF2,14,Molise,Molise,305617,80006,26.18,0.22
1260,2021-03-03,MOL,672,316,356,590,82,ITF,ITF2,14,Molise,Molise,305617,80678,26.4,0.22
1261,2021-01-05,MOL,449,180,269,449,0,ITF,ITF2,14,Molise,Molise,305617,81127,26.55,0.15
1262,2021-02-25,MOL,541,239,302,473,68,ITF,ITF2,14,Molise,Molise,305617,81668,26.72,0.18
1263,2021-04-30,MOL,2935,1554,1381,829,2106,ITF,ITF2,14,Molise,Molise,305617,84603,27.68,0.96
1264,2021-05-09,MOL,2051,932,1119,1955,96,ITF,ITF2,14,Molise,Molise,305617,86654,28.35,0.67
1265,2021-03-06,MOL,1728,807,921,1569,159,ITF,ITF2,14,Molise,Molise,305617,88382,28.92,0.57
1266,2021-04-11,MOL,1196,591,605,1182,14,ITF,ITF2,14,Molise,Molise,305617,89578,29.31,0.39
1267,2021-03-25,MOL,1806,730,1076,1309,497,ITF,ITF2,14,Molise,Molise,305617,91384,29.9,0.59
1268,2021-03-08,MOL,1379,522,857,1239,140,ITF,ITF2,14,Molise,Molise,305617,92763,30.35,0.45
1269,2021-04-09,MOL,2318,1248,1070,2127,191,ITF,ITF2,14,Molise,Molise,305617,95081,31.11,0.76
1270,2021-01-18,MOL,114,48,66,114,0,ITF,ITF2,14,Molise,Molise,305617,95195,31.15,0.04
1271,2021-04-13,MOL,1630,718,912,1043,587,ITF,ITF2,14,Molise,Molise,305617,96825,31.68,0.53
1272,2021-03-27,MOL,2743,1273,1470,1310,1433,ITF,ITF2,14,Molise,Molise,305617,99568,32.58,0.9
1273,2021-04-19,MOL,1827,842,985,1049,778,ITF,ITF2,14,Molise,Molise,305617,101395,33.18,0.6
1274,2021-02-28,MOL,829,331,498,787,42,ITF,ITF2,14,Molise,Molise,305617,102224,33.45,0.27
1275,2021-01-09,MOL,450,152,298,450,0,ITF,ITF2,14,Molise,Molise,305617,102674,33.6,0.15
1276,2021-05-24,MOL,1951,847,1104,1285,666,ITF,ITF2,14,Molise,Molise,305617,104625,34.23,0.64
1277,2021-05-12,MOL,2846,1291,1555,2750,96,ITF,ITF2,14,Molise,Molise,305617,107471,35.17,0.93
1278,2021-05-26,MOL,1497,675,822,783,714,ITF,ITF2,14,Molise,Molise,305617,108968,35.66,0.49
1279,2021-02-08,MOL,334,141,193,216,118,ITF,ITF2,14,Molise,Molise,305617,109302,35.76,0.11
1280,2021-03-23,MOL,1642,694,948,1435,207,ITF,ITF2,14,Molise,Molise,305617,110944,36.3,0.54
1281,2021-02-22,MOL,265,129,136,250,15,ITF,ITF2,14,Molise,Molise,305617,111209,36.39,0.09
1282,2020-12-27,MOL,50,20,30,50,0,ITF,ITF2,14,Molise,Molise,305617,111259,36.4,0.02
1283,2021-05-17,MOL,2228,1092,1136,1732,496,ITF,ITF2,14,Molise,Molise,305617,113487,37.13,0.73
1284,2021-03-21,MOL,1246,542,704,479,767,ITF,ITF2,14,Molise,Molise,305617,114733,37.54,0.41
1285,2021-03-14,MOL,595,239,356,17,578,ITF,ITF2,14,Molise,Molise,305617,115328,37.74,0.19
1286,2021-03-28,MOL,1626,747,879,524,1102,ITF,ITF2,14,Molise,Molise,305617,116954,38.27,0.53
1287,2021-01-30,MOL,461,158,303,12,449,ITF,ITF2,14,Molise,Molise,305617,117415,38.42,0.15
1288,2021-02-06,MOL,429,179,250,29,400,ITF,ITF2,14,Molise,Molise,305617,117844,38.56,0.14
1289,2021-02-18,MOL,319,74,245,306,13,ITF,ITF2,14,Molise,Molise,305617,118163,38.66,0.1
1290,2021-03-09,MOL,1329,579,750,1177,152,ITF,ITF2,14,Molise,Molise,305617,119492,39.1,0.43
1291,2021-05-14,MOL,2644,1215,1429,1926,718,ITF,ITF2,14,Molise,Molise,305617,122136,39.96,0.87
1292,2021-02-03,MOL,731,249,482,338,393,ITF,ITF2,14,Molise,Molise,305617,122867,40.2,0.24
1293,2021-05-05,MOL,2413,1042,1371,2272,141,ITF,ITF2,14,Molise,Molise,305617,125280,40.99,0.79
1294,2021-05-04,MOL,2703,1180,1523,2575,128,ITF,ITF2,14,Molise,Molise,305617,127983,41.88,0.88
1295,2021-01-10,MOL,270,72,198,270,0,ITF,ITF2,14,Molise,Molise,305617,128253,41.97,0.09
1296,2021-03-01,MOL,661,274,387,447,214,ITF,ITF2,14,Molise,Molise,305617,128914,42.18,0.22
1297,2021-04-25,MOL,792,395,397,559,233,ITF,ITF2,14,Molise,Molise,305617,129706,42.44,0.26
1298,2021-03-13,MOL,1189,594,595,200,989,ITF,ITF2,14,Molise,Molise,305617,130895,42.83,0.39
1299,2021-01-15,MOL,538,242,296,538,0,ITF,ITF2,14,Molise,Molise,305617,131433,43.01,0.18
1300,2021-02-20,MOL,1018,441,577,998,20,ITF,ITF2,14,Molise,Molise,305617,132451,43.34,0.33
1301,2021-04-27,MOL,1593,767,826,465,1128,ITF,ITF2,14,Molise,Molise,305617,134044,43.86,0.52
1302,2021-05-16,MOL,1246,570,676,1064,182,ITF,ITF2,14,Molise,Molise,305617,135290,44.27,0.41
1303,2021-01-22,MOL,126,35,91,126,0,ITF,ITF2,14,Molise,Molise,305617,135416,44.31,0.04
1304,2021-05-28,MOL,2409,1263,1146,1910,499,ITF,ITF2,14,Molise,Molise,305617,137825,45.1,0.79
1305,2021-04-08,MOL,1766,903,863,1564,202,ITF,ITF2,14,Molise,Molise,305617,139591,45.68,0.58
1306,2021-04-22,MOL,1844,863,981,1065,779,ITF,ITF2,14,Molise,Molise,305617,141435,46.28,0.6
1307,2021-02-17,MOL,72,32,40,57,15,ITF,ITF2,14,Molise,Molise,305617,141507,46.3,0.02
1308,2021-05-07,MOL,2641,1226,1415,2044,597,ITF,ITF2,14,Molise,Molise,305617,144148,47.17,0.86
1309,2021-03-18,MOL,1156,476,680,692,464,ITF,ITF2,14,Molise,Molise,305617,145304,47.54,0.38
1310,2021-05-21,MOL,2018,1011,1007,1707,311,ITF,ITF2,14,Molise,Molise,305617,147322,48.2,0.66
1311,2021-01-27,MOL,674,251,423,8,666,ITF,ITF2,14,Molise,Molise,305617,147996,48.43,0.22
1312,2021-04-01,MOL,1469,667,802,743,726,ITF,ITF2,14,Molise,Molise,305617,149465,48.91,0.48
1313,2021-02-10,MOL,150,78,72,130,20,ITF,ITF2,14,Molise,Molise,305617,149615,48.96,0.05
1314,2021-05-19,MOL,2335,1205,1130,1912,423,ITF,ITF2,14,Molise,Molise,305617,151950,49.72,0.76
1315,2021-03-30,MOL,2003,857,1146,1491,512,ITF,ITF2,14,Molise,Molise,305617,153953,50.37,0.66
1316,2021-02-01,MOL,562,201,361,14,548,ITF,ITF2,14,Molise,Molise,305617,154515,50.56,0.18
1317,2021-04-06,MOL,1494,701,793,1151,343,ITF,ITF2,14,Molise,Molise,305617,156009,51.05,0.49
1318,2021-02-15,MOL,144,70,74,141,3,ITF,ITF2,14,Molise,Molise,305617,156153,51.09,0.05
1319,2021-03-04,MOL,850,417,433,526,324,ITF,ITF2,14,Molise,Molise,305617,157003,51.37,0.28
1320,2021-01-20,MOL,18,8,10,18,0,ITF,ITF2,14,Molise,Molise,305617,157021,51.38,0.01
1321,2021-05-02,MOL,1889,930,959,586,1303,ITF,ITF2,14,Molise,Molise,305617,158910,52.0,0.62
1322,2021-01-29,MOL,421,136,285,6,415,ITF,ITF2,14,Molise,Molise,305617,159331,52.13,0.14
1323,2021-05-11,MOL,3205,1413,1792,2955,250,ITF,ITF2,14,Molise,Molise,305617,162536,53.18,1.05
1324,2021-03-16,MOL,614,230,384,267,347,ITF,ITF2,14,Molise,Molise,305617,163150,53.38,0.2
1325,2021-01-11,MOL,557,194,363,557,0,ITF,ITF2,14,Molise,Molise,305617,163707,53.57,0.18
1326,2021-01-25,MOL,319,130,189,3,316,ITF,ITF2,14,Molise,Molise,305617,164026,53.67,0.1
1327,2021-04-20,MOL,2318,1025,1293,1220,1098,ITF,ITF2,14,Molise,Molise,305617,166344,54.43,0.76
1328,2021-05-23,MOL,1698,863,835,1693,5,ITF,ITF2,14,Molise,Molise,305617,168042,54.98,0.56
1329,2021-04-03,MOL,1770,850,920,1735,35,ITF,ITF2,14,Molise,Molise,305617,169812,55.56,0.58
1330,2021-04-16,MOL,2430,1033,1397,1198,1232,ITF,ITF2,14,Molise,Molise,305617,172242,56.36,0.8
1331,2021-04-23,MOL,2049,882,1167,1390,659,ITF,ITF2,14,Molise,Molise,305617,174291,57.03,0.67
1332,2021-03-11,MOL,1463,636,827,1457,6,ITF,ITF2,14,Molise,Molise,305617,175754,57.51,0.48
1333,2021-01-06,MOL,689,260,429,689,0,ITF,ITF2,14,Molise,Molise,305617,176443,57.73,0.23
1334,2021-01-13,MOL,474,160,314,474,0,ITF,ITF2,14,Molise,Molise,305617,176917,57.89,0.16
1335,2021-04-04,MOL,253,141,112,238,15,ITF,ITF2,14,Molise,Molise,305617,177170,57.97,0.08
1336,2021-02-27,MOL,1366,568,798,1347,19,ITF,ITF2,14,Molise,Molise,305617,178536,58.42,0.45
1337,2021-02-13,MOL,132,80,52,132,0,ITF,ITF2,14,Molise,Molise,305617,178668,58.46,0.04
1338,2021-04-18,MOL,1083,483,600,149,934,ITF,ITF2,14,Molise,Molise,305617,179751,58.82,0.35
1339,2021-01-08,MOL,429,141,288,429,0,ITF,ITF2,14,Molise,Molise,305617,180180,58.96,0.14
1340,2021-03-20,MOL,2321,968,1353,1000,1321,ITF,ITF2,14,Molise,Molise,305617,182501,59.72,0.76
1341,2021-04-15,MOL,1923,793,1130,1079,844,ITF,ITF2,14,Molise,Molise,305617,184424,60.34,0.63
1342,2021-03-04,FVG,3445,1595,1850,2787,658,ITH,ITH4,6,Friuli-Venezia Giulia,Friuli Venezia Giulia,1215220,3445,0.28,0.28
1343,2021-05-24,FVG,10948,5248,5700,7492,3456,ITH,ITH4,6,Friuli-Venezia Giulia,Friuli Venezia Giulia,1215220,14393,1.18,0.9
1344,2021-03-21,FVG,2602,937,1665,2193,409,ITH,ITH4,6,Friuli-Venezia Giulia,Friuli Venezia Giulia,1215220,16995,1.4,0.21
1345,2021-02-15,FVG,2452,911,1541,2201,251,ITH,ITH4,6,Friuli-Venezia Giulia,Friuli Venezia Giulia,1215220,19447,1.6,0.2
1346,2021-04-20,FVG,7106,3059,4047,3203,3903,ITH,ITH4,6,Friuli-Venezia Giulia,Friuli Venezia Giulia,1215220,26553,2.19,0.58
1347,2021-05-07,FVG,10525,4809,5716,7058,3467,ITH,ITH4,6,Friuli-Venezia Giulia,Friuli Venezia Giulia,1215220,37078,3.05,0.87
1348,2021-04-23,FVG,7455,3375,4080,3599,3856,ITH,ITH4,6,Friuli-Venezia Giulia,Friuli Venezia Giulia,1215220,44533,3.66,0.61
1349,2021-03-20,FVG,3340,1351,1989,1249,2091,ITH,ITH4,6,Friuli-Venezia Giulia,Friuli Venezia Giulia,1215220,47873,3.94,0.27
1350,2021-03-18,FVG,3371,1421,1950,1690,1681,ITH,ITH4,6,Friuli-Venezia Giulia,Friuli Venezia Giulia,1215220,51244,4.22,0.28
1351,2021-01-13,FVG,2650,834,1816,2650,0,ITH,ITH4,6,Friuli-Venezia Giulia,Friuli Venezia Giulia,1215220,53894,4.43,0.22
1352,2021-02-13,FVG,567,179,388,561,6,ITH,ITH4,6,Friuli-Venezia Giulia,Friuli Venezia Giulia,1215220,54461,4.48,0.05
1353,2021-03-02,FVG,4220,1519,2701,2721,1499,ITH,ITH4,6,Friuli-Venezia Giulia,Friuli Venezia Giulia,1215220,58681,4.83,0.35
1354,2021-01-27,FVG,1272,425,847,450,822,ITH,ITH4,6,Friuli-Venezia Giulia,Friuli Venezia Giulia,1215220,59953,4.93,0.1
1355,2021-05-09,FVG,7327,3291,4036,3474,3853,ITH,ITH4,6,Friuli-Venezia Giulia,Friuli Venezia Giulia,1215220,67280,5.54,0.6
1356,2021-05-26,FVG,12533,6230,6303,9348,3185,ITH,ITH4,6,Friuli-Venezia Giulia,Friuli Venezia Giulia,1215220,79813,6.57,1.03
1357,2021-01-25,FVG,1582,567,1015,194,1388,ITH,ITH4,6,Friuli-Venezia Giulia,Friuli Venezia Giulia,1215220,81395,6.7,0.13
1358,2021-04-28,FVG,7246,3194,4052,3782,3464,ITH,ITH4,6,Friuli-Venezia Giulia,Friuli Venezia Giulia,1215220,88641,7.29,0.6
1359,2021-01-16,FVG,1230,360,870,1230,0,ITH,ITH4,6,Friuli-Venezia Giulia,Friuli Venezia Giulia,1215220,89871,7.4,0.1
1360,2021-05-28,FVG,9464,4365,5099,5697,3767,ITH,ITH4,6,Friuli-Venezia Giulia,Friuli Venezia Giulia,1215220,99335,8.17,0.78
1361,2021-03-25,FVG,5309,2261,3048,3176,2133,ITH,ITH4,6,Friuli-Venezia Giulia,Friuli Venezia Giulia,1215220,104644,8.61,0.44
1362,2021-03-30,FVG,7094,3142,3952,6172,922,ITH,ITH4,6,Friuli-Venezia Giulia,Friuli Venezia Giulia,1215220,111738,9.19,0.58
1363,2021-04-11,FVG,3433,1520,1913,2527,906,ITH,ITH4,6,Friuli-Venezia Giulia,Friuli Venezia Giulia,1215220,115171,9.48,0.28
1364,2021-01-08,FVG,2322,747,1575,2322,0,ITH,ITH4,6,Friuli-Venezia Giulia,Friuli Venezia Giulia,1215220,117493,9.67,0.19
1365,2021-02-27,FVG,3528,1200,2328,3527,1,ITH,ITH4,6,Friuli-Venezia Giulia,Friuli Venezia Giulia,1215220,121021,9.96,0.29
1366,2021-04-25,FVG,2362,990,1372,2351,11,ITH,ITH4,6,Friuli-Venezia Giulia,Friuli Venezia Giulia,1215220,123383,10.15,0.19
1367,2021-02-20,FVG,2068,933,1135,1924,144,ITH,ITH4,6,Friuli-Venezia Giulia,Friuli Venezia Giulia,1215220,125451,10.32,0.17
1368,2021-01-15,FVG,2021,605,1416,2021,0,ITH,ITH4,6,Friuli-Venezia Giulia,Friuli Venezia Giulia,1215220,127472,10.49,0.17
1369,2021-01-22,FVG,90,30,60,0,90,ITH,ITH4,6,Friuli-Venezia Giulia,Friuli Venezia Giulia,1215220,127562,10.5,0.01
1370,2021-03-06,FVG,3499,1196,2303,3174,325,ITH,ITH4,6,Friuli-Venezia Giulia,Friuli Venezia Giulia,1215220,131061,10.78,0.29
1371,2021-04-18,FVG,6038,2799,3239,5631,407,ITH,ITH4,6,Friuli-Venezia Giulia,Friuli Venezia Giulia,1215220,137099,11.28,0.5
1372,2021-01-30,FVG,2275,745,1530,270,2005,ITH,ITH4,6,Friuli-Venezia Giulia,Friuli Venezia Giulia,1215220,139374,11.47,0.19
1373,2021-04-21,FVG,7702,3439,4263,4022,3680,ITH,ITH4,6,Friuli-Venezia Giulia,Friuli Venezia Giulia,1215220,147076,12.1,0.63
1374,2021-01-11,FVG,1882,608,1274,1882,0,ITH,ITH4,6,Friuli-Venezia Giulia,Friuli Venezia Giulia,1215220,148958,12.26,0.15
1375,2021-03-01,FVG,2957,1041,1916,2905,52,ITH,ITH4,6,Friuli-Venezia Giulia,Friuli Venezia Giulia,1215220,151915,12.5,0.24
1376,2020-12-27,FVG,262,149,113,262,0,ITH,ITH4,6,Friuli-Venezia Giulia,Friuli Venezia Giulia,1215220,152177,12.52,0.02
1377,2021-04-06,FVG,6276,2771,3505,5126,1150,ITH,ITH4,6,Friuli-Venezia Giulia,Friuli Venezia Giulia,1215220,158453,13.04,0.52
1378,2021-01-06,FVG,710,264,446,710,0,ITH,ITH4,6,Friuli-Venezia Giulia,Friuli Venezia Giulia,1215220,159163,13.1,0.06
1379,2020-12-30,FVG,626,244,382,626,0,ITH,ITH4,6,Friuli-Venezia Giulia,Friuli Venezia Giulia,1215220,159789,13.15,0.05
1380,2021-02-25,FVG,3160,1651,1509,3135,25,ITH,ITH4,6,Friuli-Venezia Giulia,Friuli Venezia Giulia,1215220,162949,13.41,0.26
1381,2021-02-18,FVG,3217,1492,1725,2811,406,ITH,ITH4,6,Friuli-Venezia Giulia,Friuli Venezia Giulia,1215220,166166,13.67,0.26
1382,2021-04-02,FVG,6566,2915,3651,4733,1833,ITH,ITH4,6,Friuli-Venezia Giulia,Friuli Venezia Giulia,1215220,172732,14.21,0.54
1383,2021-04-16,FVG,6910,2995,3915,4987,1923,ITH,ITH4,6,Friuli-Venezia Giulia,Friuli Venezia Giulia,1215220,179642,14.78,0.57
1384,2021-02-11,FVG,1930,664,1266,1738,192,ITH,ITH4,6,Friuli-Venezia Giulia,Friuli Venezia Giulia,1215220,181572,14.94,0.16
1385,2021-04-09,FVG,7762,3528,4234,6518,1244,ITH,ITH4,6,Friuli-Venezia Giulia,Friuli Venezia Giulia,1215220,189334,15.58,0.64
1386,2021-02-06,FVG,1154,338,816,22,1132,ITH,ITH4,6,Friuli-Venezia Giulia,Friuli Venezia Giulia,1215220,190488,15.68,0.09
1387,2021-01-04,FVG,1507,558,949,1507,0,ITH,ITH4,6,Friuli-Venezia Giulia,Friuli Venezia Giulia,1215220,191995,15.8,0.12
1388,2021-02-23,FVG,2617,1252,1365,2437,180,ITH,ITH4,6,Friuli-Venezia Giulia,Friuli Venezia Giulia,1215220,194612,16.01,0.22
1389,2021-03-09,FVG,3855,1589,2266,1108,2747,ITH,ITH4,6,Friuli-Venezia Giulia,Friuli Venezia Giulia,1215220,198467,16.33,0.32
1390,2021-03-13,FVG,2934,1119,1815,1663,1271,ITH,ITH4,6,Friuli-Venezia Giulia,Friuli Venezia Giulia,1215220,201401,16.57,0.24
1391,2021-05-16,FVG,9939,4759,5180,8545,1394,ITH,ITH4,6,Friuli-Venezia Giulia,Friuli Venezia Giulia,1215220,211340,17.39,0.82
1392,2021-04-08,FVG,7207,3014,4193,5287,1920,ITH,ITH4,6,Friuli-Venezia Giulia,Friuli Venezia Giulia,1215220,218547,17.98,0.59
1393,2021-02-10,FVG,1352,496,856,1266,86,ITH,ITH4,6,Friuli-Venezia Giulia,Friuli Venezia Giulia,1215220,219899,18.1,0.11
1394,2021-02-03,FVG,2647,791,1856,23,2624,ITH,ITH4,6,Friuli-Venezia Giulia,Friuli Venezia Giulia,1215220,222546,18.31,0.22
1395,2021-05-21,FVG,10975,4889,6086,8110,2865,ITH,ITH4,6,Friuli-Venezia Giulia,Friuli Venezia Giulia,1215220,233521,19.22,0.9
1396,2021-05-14,FVG,10554,5228,5326,8082,2472,ITH,ITH4,6,Friuli-Venezia Giulia,Friuli Venezia Giulia,1215220,244075,20.08,0.87
1397,2021-01-18,FVG,1961,606,1355,1867,94,ITH,ITH4,6,Friuli-Venezia Giulia,Friuli Venezia Giulia,1215220,246036,20.25,0.16
1398,2021-03-28,FVG,4809,2273,2536,4669,140,ITH,ITH4,6,Friuli-Venezia Giulia,Friuli Venezia Giulia,1215220,250845,20.64,0.4
1399,2021-05-17,FVG,8767,4073,4694,6290,2477,ITH,ITH4,6,Friuli-Venezia Giulia,Friuli Venezia Giulia,1215220,259612,21.36,0.72
1400,2021-03-23,FVG,3753,1558,2195,1613,2140,ITH,ITH4,6,Friuli-Venezia Giulia,Friuli Venezia Giulia,1215220,263365,21.67,0.31
1401,2021-01-23,FVG,816,324,492,4,812,ITH,ITH4,6,Friuli-Venezia Giulia,Friuli Venezia Giulia,1215220,264181,21.74,0.07
1402,2021-05-05,FVG,9705,4230,5475,6264,3441,ITH,ITH4,6,Friuli-Venezia Giulia,Friuli Venezia Giulia,1215220,273886,22.54,0.8
1403,2021-04-01,FVG,6315,2993,3322,5300,1015,ITH,ITH4,6,Friuli-Venezia Giulia,Friuli Venezia Giulia,1215220,280201,23.06,0.52
1404,2021-03-16,FVG,3153,1287,1866,1073,2080,ITH,ITH4,6,Friuli-Venezia Giulia,Friuli Venezia Giulia,1215220,283354,23.32,0.26
1405,2021-05-12,FVG,10666,4936,5730,9311,1355,ITH,ITH4,6,Friuli-Venezia Giulia,Friuli Venezia Giulia,1215220,294020,24.19,0.88
1406,2021-05-19,FVG,11692,5736,5956,9466,2226,ITH,ITH4,6,Friuli-Venezia Giulia,Friuli Venezia Giulia,1215220,305712,25.16,0.96
1407,2021-03-14,FVG,1395,547,848,1143,252,ITH,ITH4,6,Friuli-Venezia Giulia,Friuli Venezia Giulia,1215220,307107,25.27,0.11
1408,2021-02-01,FVG,2097,688,1409,16,2081,ITH,ITH4,6,Friuli-Venezia Giulia,Friuli Venezia Giulia,1215220,309204,25.44,0.17
1409,2021-02-08,FVG,2357,694,1663,92,2265,ITH,ITH4,6,Friuli-Venezia Giulia,Friuli Venezia Giulia,1215220,311561,25.64,0.19
1410,2021-01-03,FVG,312,122,190,312,0,ITH,ITH4,6,Friuli-Venezia Giulia,Friuli Venezia Giulia,1215220,311873,25.66,0.03
1411,2021-02-22,FVG,2484,1193,1291,2067,417,ITH,ITH4,6,Friuli-Venezia Giulia,Friuli Venezia Giulia,1215220,314357,25.87,0.2
1412,2021-04-13,FVG,7362,3289,4073,5758,1604,ITH,ITH4,6,Friuli-Venezia Giulia,Friuli Venezia Giulia,1215220,321719,26.47,0.61
1413,2021-04-27,FVG,8076,3703,4373,3619,4457,ITH,ITH4,6,Friuli-Venezia Giulia,Friuli Venezia Giulia,1215220,329795,27.14,0.66
1414,2021-02-19,FVG,3251,1289,1962,2824,427,ITH,ITH4,6,Friuli-Venezia Giulia,Friuli Venezia Giulia,1215220,333046,27.41,0.27
1415,2021-04-24,FVG,6674,2945,3729,5432,1242,ITH,ITH4,6,Friuli-Venezia Giulia,Friuli Venezia Giulia,1215220,339720,27.96,0.55
1416,2021-05-03,FVG,7178,3270,3908,3404,3774,ITH,ITH4,6,Friuli-Venezia Giulia,Friuli Venezia Giulia,1215220,346898,28.55,0.59
1417,2021-02-28,FVG,2684,1002,1682,2291,393,ITH,ITH4,6,Friuli-Venezia Giulia,Friuli Venezia Giulia,1215220,349582,28.77,0.22
1418,2021-04-05,FVG,2868,1425,1443,2853,15,ITH,ITH4,6,Friuli-Venezia Giulia,Friuli Venezia Giulia,1215220,352450,29.0,0.24
1419,2021-01-10,FVG,2939,918,2021,2939,0,ITH,ITH4,6,Friuli-Venezia Giulia,Friuli Venezia Giulia,1215220,355389,29.24,0.24
1420,2021-04-22,FVG,6755,3073,3682,3079,3676,ITH,ITH4,6,Friuli-Venezia Giulia,Friuli Venezia Giulia,1215220,362144,29.8,0.56
1421,2021-03-19,FVG,3234,1339,1895,1301,1933,ITH,ITH4,6,Friuli-Venezia Giulia,Friuli Venezia Giulia,1215220,365378,30.07,0.27
1422,2021-01-12,FVG,2260,713,1547,2260,0,ITH,ITH4,6,Friuli-Venezia Giulia,Friuli Venezia Giulia,1215220,367638,30.25,0.19
1423,2021-01-29,FVG,2414,814,1600,264,2150,ITH,ITH4,6,Friuli-Venezia Giulia,Friuli Venezia Giulia,1215220,370052,30.45,0.2
1424,2021-04-03,FVG,3983,1969,2014,2655,1328,ITH,ITH4,6,Friuli-Venezia Giulia,Friuli Venezia Giulia,1215220,374035,30.78,0.33
1425,2021-04-07,FVG,7494,3321,4173,6713,781,ITH,ITH4,6,Friuli-Venezia Giulia,Friuli Venezia Giulia,1215220,381529,31.4,0.62
1426,2021-04-30,FVG,7303,3217,4086,3690,3613,ITH,ITH4,6,Friuli-Venezia Giulia,Friuli Venezia Giulia,1215220,388832,32.0,0.6
1427,2021-02-04,FVG,2725,808,1917,35,2690,ITH,ITH4,6,Friuli-Venezia Giulia,Friuli Venezia Giulia,1215220,391557,32.22,0.22
1428,2021-03-11,FVG,3355,1413,1942,1605,1750,ITH,ITH4,6,Friuli-Venezia Giulia,Friuli Venezia Giulia,1215220,394912,32.5,0.28
1429,2021-01-20,FVG,748,320,428,13,735,ITH,ITH4,6,Friuli-Venezia Giulia,Friuli Venezia Giulia,1215220,395660,32.56,0.06
1430,2021-05-06,FVG,11837,5501,6336,7884,3953,ITH,ITH4,6,Friuli-Venezia Giulia,Friuli Venezia Giulia,1215220,407497,33.53,0.97
1431,2021-03-17,FVG,3231,1265,1966,743,2488,ITH,ITH4,6,Friuli-Venezia Giulia,Friuli Venezia Giulia,1215220,410728,33.8,0.27
1432,2021-02-16,FVG,2516,1135,1381,2400,116,ITH,ITH4,6,Friuli-Venezia Giulia,Friuli Venezia Giulia,1215220,413244,34.01,0.21
1433,2021-05-20,FVG,12361,6069,6292,9948,2413,ITH,ITH4,6,Friuli-Venezia Giulia,Friuli Venezia Giulia,1215220,425605,35.02,1.02
1434,2021-05-22,FVG,11466,5148,6318,7262,4204,ITH,ITH4,6,Friuli-Venezia Giulia,Friuli Venezia Giulia,1215220,437071,35.97,0.94
1435,2021-05-25,FVG,12305,6002,6303,9141,3164,ITH,ITH4,6,Friuli-Venezia Giulia,Friuli Venezia Giulia,1215220,449376,36.98,1.01
1436,2021-05-10,FVG,7910,3514,4396,6371,1539,ITH,ITH4,6,Friuli-Venezia Giulia,Friuli Venezia Giulia,1215220,457286,37.63,0.65
1437,2021-05-27,FVG,12046,5688,6358,7055,4991,ITH,ITH4,6,Friuli-Venezia Giulia,Friuli Venezia Giulia,1215220,469332,38.62,0.99
1438,2021-05-02,FVG,6836,3210,3626,3937,2899,ITH,ITH4,6,Friuli-Venezia Giulia,Friuli Venezia Giulia,1215220,476168,39.18,0.56
1439,2021-04-29,FVG,6683,2932,3751,4162,2521,ITH,ITH4,6,Friuli-Venezia Giulia,Friuli Venezia Giulia,1215220,482851,39.73,0.55
1440,2021-02-24,FVG,2519,1083,1436,2501,18,ITH,ITH4,6,Friuli-Venezia Giulia,Friuli Venezia Giulia,1215220,485370,39.94,0.21
1441,2021-04-15,FVG,6487,2859,3628,5216,1271,ITH,ITH4,6,Friuli-Venezia Giulia,Friuli Venezia Giulia,1215220,491857,40.47,0.53
1442,2021-04-17,FVG,7447,3232,4215,5965,1482,ITH,ITH4,6,Friuli-Venezia Giulia,Friuli Venezia Giulia,1215220,499304,41.09,0.61
1443,2021-04-10,FVG,4985,2164,2821,3760,1225,ITH,ITH4,6,Friuli-Venezia Giulia,Friuli Venezia Giulia,1215220,504289,41.5,0.41
1444,2021-05-23,FVG,10243,4841,5402,6109,4134,ITH,ITH4,6,Friuli-Venezia Giulia,Friuli Venezia Giulia,1215220,514532,42.34,0.84
1445,2021-01-07,FVG,2090,717,1373,2090,0,ITH,ITH4,6,Friuli-Venezia Giulia,Friuli Venezia Giulia,1215220,516622,42.51,0.17
1446,2021-03-05,FVG,3736,1478,2258,2663,1073,ITH,ITH4,6,Friuli-Venezia Giulia,Friuli Venezia Giulia,1215220,520358,42.82,0.31
1447,2021-02-12,FVG,1193,428,765,1146,47,ITH,ITH4,6,Friuli-Venezia Giulia,Friuli Venezia Giulia,1215220,521551,42.92,0.1
1448,2021-03-03,FVG,3639,1627,2012,2365,1274,ITH,ITH4,6,Friuli-Venezia Giulia,Friuli Venezia Giulia,1215220,525190,43.22,0.3
1449,2021-01-28,FVG,2239,794,1445,354,1885,ITH,ITH4,6,Friuli-Venezia Giulia,Friuli Venezia Giulia,1215220,527429,43.4,0.18
1450,2021-05-08,FVG,10243,4629,5614,5465,4778,ITH,ITH4,6,Friuli-Venezia Giulia,Friuli Venezia Giulia,1215220,537672,44.24,0.84
1451,2021-01-24,FVG,305,119,186,1,304,ITH,ITH4,6,Friuli-Venezia Giulia,Friuli Venezia Giulia,1215220,537977,44.27,0.03
1452,2021-03-22,FVG,3541,1343,2198,1586,1955,ITH,ITH4,6,Friuli-Venezia Giulia,Friuli Venezia Giulia,1215220,541518,44.56,0.29
1453,2021-01-31,FVG,2715,836,1879,385,2330,ITH,ITH4,6,Friuli-Venezia Giulia,Friuli Venezia Giulia,1215220,544233,44.78,0.22
1454,2021-05-04,FVG,9501,4283,5218,6149,3352,ITH,ITH4,6,Friuli-Venezia Giulia,Friuli Venezia Giulia,1215220,553734,45.57,0.78
1455,2021-03-08,FVG,4065,1594,2471,1977,2088,ITH,ITH4,6,Friuli-Venezia Giulia,Friuli Venezia Giulia,1215220,557799,45.9,0.33
1456,2021-01-17,FVG,1716,523,1193,1716,0,ITH,ITH4,6,Friuli-Venezia Giulia,Friuli Venezia Giulia,1215220,559515,46.04,0.14
1457,2021-03-15,FVG,3765,1636,2129,1446,2319,ITH,ITH4,6,Friuli-Venezia Giulia,Friuli Venezia Giulia,1215220,563280,46.35,0.31
1458,2021-05-11,FVG,8910,4267,4643,7122,1788,ITH,ITH4,6,Friuli-Venezia Giulia,Friuli Venezia Giulia,1215220,572190,47.09,0.73
1459,2021-02-07,FVG,1561,483,1078,386,1175,ITH,ITH4,6,Friuli-Venezia Giulia,Friuli Venezia Giulia,1215220,573751,47.21,0.13
1460,2021-05-18,FVG,10555,5266,5289,8539,2016,ITH,ITH4,6,Friuli-Venezia Giulia,Friuli Venezia Giulia,1215220,584306,48.08,0.87
1461,2021-03-29,FVG,6874,3001,3873,5294,1580,ITH,ITH4,6,Friuli-Venezia Giulia,Friuli Venezia Giulia,1215220,591180,48.65,0.57
1462,2021-01-02,FVG,1216,470,746,1216,0,ITH,ITH4,6,Friuli-Venezia Giulia,Friuli Venezia Giulia,1215220,592396,48.75,0.1
1463,2021-02-21,FVG,801,281,520,423,378,ITH,ITH4,6,Friuli-Venezia Giulia,Friuli Venezia Giulia,1215220,593197,48.81,0.07
1464,2021-05-13,FVG,10993,5281,5712,8995,1998,ITH,ITH4,6,Friuli-Venezia Giulia,Friuli Venezia Giulia,1215220,604190,49.72,0.9
1465,2021-02-09,FVG,1842,555,1287,1556,286,ITH,ITH4,6,Friuli-Venezia Giulia,Friuli Venezia Giulia,1215220,606032,49.87,0.15
1466,2021-03-24,FVG,3766,1530,2236,2286,1480,ITH,ITH4,6,Friuli-Venezia Giulia,Friuli Venezia Giulia,1215220,609798,50.18,0.31
1467,2021-01-26,FVG,1977,647,1330,217,1760,ITH,ITH4,6,Friuli-Venezia Giulia,Friuli Venezia Giulia,1215220,611775,50.34,0.16
1468,2021-03-31,FVG,8030,3500,4530,7185,845,ITH,ITH4,6,Friuli-Venezia Giulia,Friuli Venezia Giulia,1215220,619805,51.0,0.66
1469,2021-02-26,FVG,3734,2092,1642,3586,148,ITH,ITH4,6,Friuli-Venezia Giulia,Friuli Venezia Giulia,1215220,623539,51.31,0.31
1470,2021-02-17,FVG,2353,999,1354,1873,480,ITH,ITH4,6,Friuli-Venezia Giulia,Friuli Venezia Giulia,1215220,625892,51.5,0.19
1471,2021-04-26,FVG,5444,2445,2999,3796,1648,ITH,ITH4,6,Friuli-Venezia Giulia,Friuli Venezia Giulia,1215220,631336,51.95,0.45
1472,2021-01-14,FVG,2584,789,1795,2584,0,ITH,ITH4,6,Friuli-Venezia Giulia,Friuli Venezia Giulia,1215220,633920,52.17,0.21
1473,2021-03-10,FVG,3358,1493,1865,1566,1792,ITH,ITH4,6,Friuli-Venezia Giulia,Friuli Venezia Giulia,1215220,637278,52.44,0.28
1474,2021-01-05,FVG,1678,551,1127,1678,0,ITH,ITH4,6,Friuli-Venezia Giulia,Friuli Venezia Giulia,1215220,638956,52.58,0.14
1475,2021-03-27,FVG,4984,2560,2424,3573,1411,ITH,ITH4,6,Friuli-Venezia Giulia,Friuli Venezia Giulia,1215220,643940,52.99,0.41
1476,2021-02-05,FVG,2614,785,1829,90,2524,ITH,ITH4,6,Friuli-Venezia Giulia,Friuli Venezia Giulia,1215220,646554,53.2,0.22
1477,2021-04-14,FVG,7214,3117,4097,5502,1712,ITH,ITH4,6,Friuli-Venezia Giulia,Friuli Venezia Giulia,1215220,653768,53.8,0.59
1478,2021-01-19,FVG,6,2,4,6,0,ITH,ITH4,6,Friuli-Venezia Giulia,Friuli Venezia Giulia,1215220,653774,53.8,0.0
1479,2021-01-09,FVG,2513,841,1672,2513,0,ITH,ITH4,6,Friuli-Venezia Giulia,Friuli Venezia Giulia,1215220,656287,54.01,0.21
1480,2021-03-07,FVG,2547,932,1615,2546,1,ITH,ITH4,6,Friuli-Venezia Giulia,Friuli Venezia Giulia,1215220,658834,54.22,0.21
1481,2021-04-19,FVG,6705,3131,3574,3293,3412,ITH,ITH4,6,Friuli-Venezia Giulia,Friuli Venezia Giulia,1215220,665539,54.77,0.55
1482,2021-05-15,FVG,12590,6069,6521,7913,4677,ITH,ITH4,6,Friuli-Venezia Giulia,Friuli Venezia Giulia,1215220,678129,55.8,1.04
1483,2021-01-21,FVG,896,345,551,1,895,ITH,ITH4,6,Friuli-Venezia Giulia,Friuli Venezia Giulia,1215220,679025,55.88,0.07
1484,2021-03-26,FVG,5799,2424,3375,3787,2012,ITH,ITH4,6,Friuli-Venezia Giulia,Friuli Venezia Giulia,1215220,684824,56.35,0.48
1485,2021-05-01,FVG,7185,3244,3941,6142,1043,ITH,ITH4,6,Friuli-Venezia Giulia,Friuli Venezia Giulia,1215220,692009,56.95,0.59
1486,2021-03-12,FVG,3938,1544,2394,2557,1381,ITH,ITH4,6,Friuli-Venezia Giulia,Friuli Venezia Giulia,1215220,695947,57.27,0.32
1487,2021-02-02,FVG,2467,806,1661,217,2250,ITH,ITH4,6,Friuli-Venezia Giulia,Friuli Venezia Giulia,1215220,698414,57.47,0.2
1488,2020-12-31,FVG,1053,384,669,1053,0,ITH,ITH4,6,Friuli-Venezia Giulia,Friuli Venezia Giulia,1215220,699467,57.56,0.09
1489,2021-04-12,FVG,7253,3181,4072,6122,1131,ITH,ITH4,6,Friuli-Venezia Giulia,Friuli Venezia Giulia,1215220,706720,58.16,0.6
1490,2021-03-02,PIE,11201,4505,6696,10385,816,ITC,ITC1,1,Piemonte,Piemonte,4356406,11201,0.26,0.26
1491,2021-02-13,PIE,4153,1334,2819,2931,1222,ITC,ITC1,1,Piemonte,Piemonte,4356406,15354,0.35,0.1
1492,2021-05-26,PIE,31917,14547,17370,15496,16421,ITC,ITC1,1,Piemonte,Piemonte,4356406,47271,1.09,0.73
1493,2021-01-27,PIE,4196,1453,2743,999,3197,ITC,ITC1,1,Piemonte,Piemonte,4356406,51467,1.18,0.1
1494,2021-05-09,PIE,26986,12857,14129,13380,13606,ITC,ITC1,1,Piemonte,Piemonte,4356406,78453,1.8,0.62
1495,2021-04-23,PIE,27432,12596,14836,20670,6762,ITC,ITC1,1,Piemonte,Piemonte,4356406,105885,2.43,0.63
1496,2021-03-18,PIE,11756,4803,6953,4029,7727,ITC,ITC1,1,Piemonte,Piemonte,4356406,117641,2.7,0.27
1497,2021-03-20,PIE,11919,4898,7021,6021,5898,ITC,ITC1,1,Piemonte,Piemonte,4356406,129560,2.97,0.27
1498,2021-05-24,PIE,28428,13020,15408,16940,11488,ITC,ITC1,1,Piemonte,Piemonte,4356406,157988,3.63,0.65
1499,2021-05-07,PIE,32893,15529,17364,18853,14040,ITC,ITC1,1,Piemonte,Piemonte,4356406,190881,4.38,0.76
1500,2021-03-04,PIE,14494,5733,8761,11547,2947,ITC,ITC1,1,Piemonte,Piemonte,4356406,205375,4.71,0.33
1501,2021-04-20,PIE,25450,11653,13797,19106,6344,ITC,ITC1,1,Piemonte,Piemonte,4356406,230825,5.3,0.58
1502,2021-02-15,PIE,4432,1597,2835,3227,1205,ITC,ITC1,1,Piemonte,Piemonte,4356406,235257,5.4,0.1
1503,2021-01-23,PIE,4257,1325,2932,879,3378,ITC,ITC1,1,Piemonte,Piemonte,4356406,239514,5.5,0.1
1504,2021-03-23,PIE,13067,5447,7620,6823,6244,ITC,ITC1,1,Piemonte,Piemonte,4356406,252581,5.8,0.3
1505,2021-05-05,PIE,32096,15020,17076,19088,13008,ITC,ITC1,1,Piemonte,Piemonte,4356406,284677,6.53,0.74
1506,2021-04-01,PIE,19329,8073,11256,11209,8120,ITC,ITC1,1,Piemonte,Piemonte,4356406,304006,6.98,0.44
1507,2020-12-28,PIE,1,1,0,1,0,ITC,ITC1,1,Piemonte,Piemonte,4356406,304007,6.98,0.0
1508,2021-04-18,PIE,22950,10817,12133,20196,2754,ITC,ITC1,1,Piemonte,Piemonte,4356406,326957,7.51,0.53
1509,2021-01-15,PIE,8970,2955,6015,8970,0,ITC,ITC1,1,Piemonte,Piemonte,4356406,335927,7.71,0.21
1510,2021-03-06,PIE,13994,5211,8783,11205,2789,ITC,ITC1,1,Piemonte,Piemonte,4356406,349921,8.03,0.32
1511,2021-01-22,PIE,3867,1249,2618,2526,1341,ITC,ITC1,1,Piemonte,Piemonte,4356406,353788,8.12,0.09
1512,2021-02-27,PIE,12691,4851,7840,12346,345,ITC,ITC1,1,Piemonte,Piemonte,4356406,366479,8.41,0.29
1513,2021-04-25,PIE,20223,9303,10920,17722,2501,ITC,ITC1,1,Piemonte,Piemonte,4356406,386702,8.88,0.46
1514,2021-05-02,PIE,25039,11258,13781,14294,10745,ITC,ITC1,1,Piemonte,Piemonte,4356406,411741,9.45,0.57
1515,2021-03-13,PIE,13042,4720,8322,11598,1444,ITC,ITC1,1,Piemonte,Piemonte,4356406,424783,9.75,0.3
1516,2021-01-08,PIE,5531,1761,3770,5531,0,ITC,ITC1,1,Piemonte,Piemonte,4356406,430314,9.88,0.13
1517,2021-04-21,PIE,25701,11813,13888,20369,5332,ITC,ITC1,1,Piemonte,Piemonte,4356406,456015,10.47,0.59
1518,2021-04-04,PIE,9254,4059,5195,6541,2713,ITC,ITC1,1,Piemonte,Piemonte,4356406,465269,10.68,0.21
1519,2021-01-11,PIE,8744,2980,5764,8744,0,ITC,ITC1,1,Piemonte,Piemonte,4356406,474013,10.88,0.2
1520,2021-04-06,PIE,20238,8809,11429,15042,5196,ITC,ITC1,1,Piemonte,Piemonte,4356406,494251,11.35,0.46
1521,2020-12-27,PIE,913,369,544,913,0,ITC,ITC1,1,Piemonte,Piemonte,4356406,495164,11.37,0.02
1522,2021-02-11,PIE,6764,2107,4657,3006,3758,ITC,ITC1,1,Piemonte,Piemonte,4356406,501928,11.52,0.16
1523,2021-04-09,PIE,25846,11386,14460,21337,4509,ITC,ITC1,1,Piemonte,Piemonte,4356406,527774,12.11,0.59
1524,2021-04-02,PIE,20130,8298,11832,11703,8427,ITC,ITC1,1,Piemonte,Piemonte,4356406,547904,12.58,0.46
1525,2020-12-30,PIE,730,322,408,730,0,ITC,ITC1,1,Piemonte,Piemonte,4356406,548634,12.59,0.02
1526,2021-02-25,PIE,12218,5252,6966,11671,547,ITC,ITC1,1,Piemonte,Piemonte,4356406,560852,12.87,0.28
1527,2021-02-18,PIE,4789,2093,2696,4359,430,ITC,ITC1,1,Piemonte,Piemonte,4356406,565641,12.98,0.11
1528,2021-04-16,PIE,28345,13189,15156,23403,4942,ITC,ITC1,1,Piemonte,Piemonte,4356406,593986,13.63,0.65
1529,2021-01-13,PIE,10080,3223,6857,10080,0,ITC,ITC1,1,Piemonte,Piemonte,4356406,604066,13.87,0.23
1530,2021-01-06,PIE,3116,1111,2005,3116,0,ITC,ITC1,1,Piemonte,Piemonte,4356406,607182,13.94,0.07
1531,2021-05-17,PIE,30605,14370,16235,17667,12938,ITC,ITC1,1,Piemonte,Piemonte,4356406,637787,14.64,0.7
1532,2021-03-28,PIE,16053,6899,9154,8433,7620,ITC,ITC1,1,Piemonte,Piemonte,4356406,653840,15.01,0.37
1533,2021-01-18,PIE,6165,2047,4118,5916,249,ITC,ITC1,1,Piemonte,Piemonte,4356406,660005,15.15,0.14
1534,2021-01-01,PIE,1038,395,643,1038,0,ITC,ITC1,1,Piemonte,Piemonte,4356406,661043,15.17,0.02
1535,2021-05-14,PIE,33222,16167,17055,17884,15338,ITC,ITC1,1,Piemonte,Piemonte,4356406,694265,15.94,0.76
1536,2021-05-21,PIE,35731,16532,19199,20314,15417,ITC,ITC1,1,Piemonte,Piemonte,4356406,729996,16.76,0.82
1537,2021-01-04,PIE,5564,1679,3885,5564,0,ITC,ITC1,1,Piemonte,Piemonte,4356406,735560,16.88,0.13
1538,2021-04-28,PIE,25958,11691,14267,15954,10004,ITC,ITC1,1,Piemonte,Piemonte,4356406,761518,17.48,0.6
1539,2021-02-23,PIE,9233,3713,5520,8653,580,ITC,ITC1,1,Piemonte,Piemonte,4356406,770751,17.69,0.21
1540,2021-04-11,PIE,20823,9316,11507,18662,2161,ITC,ITC1,1,Piemonte,Piemonte,4356406,791574,18.17,0.48
1541,2021-02-06,PIE,7995,2666,5329,400,7595,ITC,ITC1,1,Piemonte,Piemonte,4356406,799569,18.35,0.18
1542,2021-03-09,PIE,13964,5429,8535,11622,2342,ITC,ITC1,1,Piemonte,Piemonte,4356406,813533,18.67,0.32
1543,2021-02-20,PIE,3833,1253,2580,3659,174,ITC,ITC1,1,Piemonte,Piemonte,4356406,817366,18.76,0.09
1544,2021-01-16,PIE,7771,2630,5141,7771,0,ITC,ITC1,1,Piemonte,Piemonte,4356406,825137,18.94,0.18
1545,2021-03-21,PIE,10723,4738,5985,4189,6534,ITC,ITC1,1,Piemonte,Piemonte,4356406,835860,19.19,0.25
1546,2021-03-30,PIE,16891,7033,9858,9020,7871,ITC,ITC1,1,Piemonte,Piemonte,4356406,852751,19.57,0.39
1547,2021-01-25,PIE,6215,1938,4277,983,5232,ITC,ITC1,1,Piemonte,Piemonte,4356406,858966,19.72,0.14
1548,2021-05-28,PIE,34088,16047,18041,18543,15545,ITC,ITC1,1,Piemonte,Piemonte,4356406,893054,20.5,0.78
1549,2021-03-14,PIE,8204,3335,4869,5308,2896,ITC,ITC1,1,Piemonte,Piemonte,4356406,901258,20.69,0.19
1550,2021-05-10,PIE,28540,13680,14860,15526,13014,ITC,ITC1,1,Piemonte,Piemonte,4356406,929798,21.34,0.66
1551,2021-05-19,PIE,32846,15105,17741,21931,10915,ITC,ITC1,1,Piemonte,Piemonte,4356406,962644,22.1,0.75
1552,2021-01-30,PIE,5980,2136,3844,218,5762,ITC,ITC1,1,Piemonte,Piemonte,4356406,968624,22.23,0.14
1553,2021-03-16,PIE,10520,4268,6252,4463,6057,ITC,ITC1,1,Piemonte,Piemonte,4356406,979144,22.48,0.24
1554,2021-05-12,PIE,31612,15031,16581,18923,12689,ITC,ITC1,1,Piemonte,Piemonte,4356406,1010756,23.2,0.73
1555,2021-02-08,PIE,6916,2355,4561,666,6250,ITC,ITC1,1,Piemonte,Piemonte,4356406,1017672,23.36,0.16
1556,2021-02-01,PIE,8643,3054,5589,578,8065,ITC,ITC1,1,Piemonte,Piemonte,4356406,1026315,23.56,0.2
1557,2021-02-22,PIE,8480,3471,5009,7890,590,ITC,ITC1,1,Piemonte,Piemonte,4356406,1034795,23.75,0.19
1558,2021-04-13,PIE,25924,11605,14319,22466,3458,ITC,ITC1,1,Piemonte,Piemonte,4356406,1060719,24.35,0.6
1559,2021-02-17,PIE,4793,2156,2637,3803,990,ITC,ITC1,1,Piemonte,Piemonte,4356406,1065512,24.46,0.11
1560,2021-02-26,PIE,12293,4933,7360,11556,737,ITC,ITC1,1,Piemonte,Piemonte,4356406,1077805,24.74,0.28
1561,2021-04-26,PIE,19746,8729,11017,15351,4395,ITC,ITC1,1,Piemonte,Piemonte,4356406,1097551,25.19,0.45
1562,2021-01-14,PIE,9766,3152,6614,9766,0,ITC,ITC1,1,Piemonte,Piemonte,4356406,1107317,25.42,0.22
1563,2021-04-03,PIE,19430,8156,11274,10883,8547,ITC,ITC1,1,Piemonte,Piemonte,4356406,1126747,25.86,0.45
1564,2021-01-29,PIE,5943,1886,4057,455,5488,ITC,ITC1,1,Piemonte,Piemonte,4356406,1132690,26.0,0.14
1565,2021-01-12,PIE,10089,3415,6674,10089,0,ITC,ITC1,1,Piemonte,Piemonte,4356406,1142779,26.23,0.23
1566,2021-03-17,PIE,12518,5055,7463,5224,7294,ITC,ITC1,1,Piemonte,Piemonte,4356406,1155297,26.52,0.29
1567,2021-02-28,PIE,10816,4060,6756,10576,240,ITC,ITC1,1,Piemonte,Piemonte,4356406,1166113,26.77,0.25
1568,2021-01-10,PIE,5214,2275,2939,5214,0,ITC,ITC1,1,Piemonte,Piemonte,4356406,1171327,26.89,0.12
1569,2021-04-22,PIE,27621,12708,14913,20928,6693,ITC,ITC1,1,Piemonte,Piemonte,4356406,1198948,27.52,0.63
1570,2021-04-05,PIE,14746,6233,8513,12189,2557,ITC,ITC1,1,Piemonte,Piemonte,4356406,1213694,27.86,0.34
1571,2021-03-19,PIE,11019,4511,6508,4414,6605,ITC,ITC1,1,Piemonte,Piemonte,4356406,1224713,28.11,0.25
1572,2021-02-04,PIE,10203,3339,6864,588,9615,ITC,ITC1,1,Piemonte,Piemonte,4356406,1234916,28.35,0.23
1573,2021-04-30,PIE,31754,14261,17493,18428,13326,ITC,ITC1,1,Piemonte,Piemonte,4356406,1266670,29.08,0.73
1574,2021-03-11,PIE,13773,5077,8696,10677,3096,ITC,ITC1,1,Piemonte,Piemonte,4356406,1280443,29.39,0.32
1575,2021-01-20,PIE,6615,2089,4526,5898,717,ITC,ITC1,1,Piemonte,Piemonte,4356406,1287058,29.54,0.15
1576,2021-03-25,PIE,17062,7203,9859,8423,8639,ITC,ITC1,1,Piemonte,Piemonte,4356406,1304120,29.94,0.39
1577,2021-02-03,PIE,10199,3303,6896,611,9588,ITC,ITC1,1,Piemonte,Piemonte,4356406,1314319,30.17,0.23
1578,2021-05-13,PIE,35349,17261,18088,20519,14830,ITC,ITC1,1,Piemonte,Piemonte,4356406,1349668,30.98,0.81
1579,2021-05-27,PIE,36701,17009,19692,18941,17760,ITC,ITC1,1,Piemonte,Piemonte,4356406,1386369,31.82,0.84
1580,2021-03-24,PIE,15505,6341,9164,6378,9127,ITC,ITC1,1,Piemonte,Piemonte,4356406,1401874,32.18,0.36
1581,2021-03-31,PIE,19106,8102,11004,10413,8693,ITC,ITC1,1,Piemonte,Piemonte,4356406,1420980,32.62,0.44
1582,2021-03-01,PIE,12041,4845,7196,11232,809,ITC,ITC1,1,Piemonte,Piemonte,4356406,1433021,32.89,0.28
1583,2021-05-25,PIE,30824,14274,16550,15874,14950,ITC,ITC1,1,Piemonte,Piemonte,4356406,1463845,33.6,0.71
1584,2021-02-14,PIE,1476,498,978,876,600,ITC,ITC1,1,Piemonte,Piemonte,4356406,1465321,33.64,0.03
1585,2021-04-19,PIE,22531,10762,11769,18167,4364,ITC,ITC1,1,Piemonte,Piemonte,4356406,1487852,34.15,0.52
1586,2021-01-09,PIE,6184,2185,3999,6184,0,ITC,ITC1,1,Piemonte,Piemonte,4356406,1494036,34.3,0.14
1587,2021-02-05,PIE,9456,3080,6376,657,8799,ITC,ITC1,1,Piemonte,Piemonte,4356406,1503492,34.51,0.22
1588,2021-03-27,PIE,18383,7827,10556,9552,8831,ITC,ITC1,1,Piemonte,Piemonte,4356406,1521875,34.93,0.42
1589,2021-03-10,PIE,13631,5167,8464,11337,2294,ITC,ITC1,1,Piemonte,Piemonte,4356406,1535506,35.25,0.31
1590,2021-01-19,PIE,6466,2105,4361,6454,12,ITC,ITC1,1,Piemonte,Piemonte,4356406,1541972,35.4,0.15
1591,2021-04-14,PIE,27701,12558,15143,23180,4521,ITC,ITC1,1,Piemonte,Piemonte,4356406,1569673,36.03,0.64
1592,2021-02-10,PIE,7534,2371,5163,1316,6218,ITC,ITC1,1,Piemonte,Piemonte,4356406,1577207,36.2,0.17
1593,2021-04-08,PIE,25142,10929,14213,20412,4730,ITC,ITC1,1,Piemonte,Piemonte,4356406,1602349,36.78,0.58
1594,2021-04-15,PIE,29587,13566,16021,24109,5478,ITC,ITC1,1,Piemonte,Piemonte,4356406,1631936,37.46,0.68
1595,2021-04-17,PIE,30370,14106,16264,27058,3312,ITC,ITC1,1,Piemonte,Piemonte,4356406,1662306,38.16,0.7
1596,2021-04-10,PIE,30163,13416,16747,25884,4279,ITC,ITC1,1,Piemonte,Piemonte,4356406,1692469,38.85,0.69
1597,2021-01-05,PIE,5381,1603,3778,5381,0,ITC,ITC1,1,Piemonte,Piemonte,4356406,1697850,38.97,0.12
1598,2021-01-07,PIE,5387,1739,3648,5387,0,ITC,ITC1,1,Piemonte,Piemonte,4356406,1703237,39.1,0.12
1599,2021-03-05,PIE,15267,5960,9307,11450,3817,ITC,ITC1,1,Piemonte,Piemonte,4356406,1718504,39.45,0.35
1600,2020-12-31,PIE,3909,1334,2575,3909,0,ITC,ITC1,1,Piemonte,Piemonte,4356406,1722413,39.54,0.09
1601,2021-05-23,PIE,28629,13086,15543,15744,12885,ITC,ITC1,1,Piemonte,Piemonte,4356406,1751042,40.19,0.66
1602,2021-03-03,PIE,12120,4644,7476,11301,819,ITC,ITC1,1,Piemonte,Piemonte,4356406,1763162,40.47,0.28
1603,2021-05-06,PIE,33169,15627,17542,19748,13421,ITC,ITC1,1,Piemonte,Piemonte,4356406,1796331,41.23,0.76
1604,2021-02-12,PIE,6891,2215,4676,3930,2961,ITC,ITC1,1,Piemonte,Piemonte,4356406,1803222,41.39,0.16
1605,2021-01-26,PIE,6331,1879,4452,735,5596,ITC,ITC1,1,Piemonte,Piemonte,4356406,1809553,41.54,0.15
1606,2021-05-08,PIE,33840,16055,17785,18214,15626,ITC,ITC1,1,Piemonte,Piemonte,4356406,1843393,42.31,0.78
1607,2021-01-28,PIE,5591,1809,3782,384,5207,ITC,ITC1,1,Piemonte,Piemonte,4356406,1848984,42.44,0.13
1608,2021-03-08,PIE,13945,5292,8653,11232,2713,ITC,ITC1,1,Piemonte,Piemonte,4356406,1862929,42.76,0.32
1609,2021-05-04,PIE,28438,13054,15384,16384,12054,ITC,ITC1,1,Piemonte,Piemonte,4356406,1891367,43.42,0.65
1610,2021-04-27,PIE,22563,10201,12362,17435,5128,ITC,ITC1,1,Piemonte,Piemonte,4356406,1913930,43.93,0.52
1611,2021-01-17,PIE,3518,1168,2350,2870,648,ITC,ITC1,1,Piemonte,Piemonte,4356406,1917448,44.01,0.08
1612,2021-03-15,PIE,10655,4161,6494,5036,5619,ITC,ITC1,1,Piemonte,Piemonte,4356406,1928103,44.26,0.24
1613,2021-05-11,PIE,31940,15387,16553,18821,13119,ITC,ITC1,1,Piemonte,Piemonte,4356406,1960043,44.99,0.73
1614,2021-01-24,PIE,3153,959,2194,434,2719,ITC,ITC1,1,Piemonte,Piemonte,4356406,1963196,45.06,0.07
1615,2021-03-22,PIE,11477,4864,6613,3871,7606,ITC,ITC1,1,Piemonte,Piemonte,4356406,1974673,45.33,0.26
1616,2021-01-31,PIE,4113,1753,2360,112,4001,ITC,ITC1,1,Piemonte,Piemonte,4356406,1978786,45.42,0.09
1617,2021-02-07,PIE,3088,974,2114,445,2643,ITC,ITC1,1,Piemonte,Piemonte,4356406,1981874,45.49,0.07
1618,2021-01-03,PIE,3063,967,2096,3063,0,ITC,ITC1,1,Piemonte,Piemonte,4356406,1984937,45.56,0.07
1619,2021-05-18,PIE,31757,14572,17185,19307,12450,ITC,ITC1,1,Piemonte,Piemonte,4356406,2016694,46.29,0.73
1620,2021-03-29,PIE,15160,6384,8776,8547,6613,ITC,ITC1,1,Piemonte,Piemonte,4356406,2031854,46.64,0.35
1621,2021-04-12,PIE,22921,10351,12570,19931,2990,ITC,ITC1,1,Piemonte,Piemonte,4356406,2054775,47.17,0.53
1622,2021-01-02,PIE,3545,1134,2411,3545,0,ITC,ITC1,1,Piemonte,Piemonte,4356406,2058320,47.25,0.08
1623,2021-02-21,PIE,5090,2083,3007,4988,102,ITC,ITC1,1,Piemonte,Piemonte,4356406,2063410,47.36,0.12
1624,2021-05-20,PIE,38158,17626,20532,13502,24656,ITC,ITC1,1,Piemonte,Piemonte,4356406,2101568,48.24,0.88
1625,2021-02-02,PIE,10241,3509,6732,816,9425,ITC,ITC1,1,Piemonte,Piemonte,4356406,2111809,48.48,0.24
1626,2021-02-16,PIE,3967,1756,2211,3209,758,ITC,ITC1,1,Piemonte,Piemonte,4356406,2115776,48.57,0.09
1627,2021-04-07,PIE,23605,9994,13611,18141,5464,ITC,ITC1,1,Piemonte,Piemonte,4356406,2139381,49.11,0.54
1628,2021-02-24,PIE,11409,4629,6780,10904,505,ITC,ITC1,1,Piemonte,Piemonte,4356406,2150790,49.37,0.26
1629,2021-02-19,PIE,5535,2175,3360,5034,501,ITC,ITC1,1,Piemonte,Piemonte,4356406,2156325,49.5,0.13
1630,2021-04-24,PIE,27427,12411,15016,21795,5632,ITC,ITC1,1,Piemonte,Piemonte,4356406,2183752,50.13,0.63
1631,2021-05-03,PIE,26624,12152,14472,12492,14132,ITC,ITC1,1,Piemonte,Piemonte,4356406,2210376,50.74,0.61
1632,2021-05-16,PIE,28110,12762,15348,15054,13056,ITC,ITC1,1,Piemonte,Piemonte,4356406,2238486,51.38,0.65
1633,2021-04-29,PIE,48267,21836,26431,35666,12601,ITC,ITC1,1,Piemonte,Piemonte,4356406,2286753,52.49,1.11
1634,2021-03-07,PIE,11974,4657,7317,11097,877,ITC,ITC1,1,Piemonte,Piemonte,4356406,2298727,52.77,0.27
1635,2021-05-01,PIE,28524,12991,15533,16726,11798,ITC,ITC1,1,Piemonte,Piemonte,4356406,2327251,53.42,0.65
1636,2021-01-21,PIE,6923,2318,4605,3427,3496,ITC,ITC1,1,Piemonte,Piemonte,4356406,2334174,53.58,0.16
1637,2021-05-15,PIE,33550,15652,17898,19938,13612,ITC,ITC1,1,Piemonte,Piemonte,4356406,2367724,54.35,0.77
1638,2021-02-09,PIE,7391,2316,5075,722,6669,ITC,ITC1,1,Piemonte,Piemonte,4356406,2375115,54.52,0.17
1639,2021-05-22,PIE,33218,14990,18228,17165,16053,ITC,ITC1,1,Piemonte,Piemonte,4356406,2408333,55.28,0.76
1640,2021-03-12,PIE,13949,5184,8765,11014,2935,ITC,ITC1,1,Piemonte,Piemonte,4356406,2422282,55.6,0.32
1641,2021-03-26,PIE,17748,6982,10766,8840,8908,ITC,ITC1,1,Piemonte,Piemonte,4356406,2440030,56.01,0.41
1642,2021-03-14,LOM,14876,5349,9527,11590,3286,ITC,ITC4,3,Lombardia,Lombardia,10060574,14876,0.15,0.15
1643,2021-05-17,LOM,94479,45257,49222,30196,64283,ITC,ITC4,3,Lombardia,Lombardia,10060574,109355,1.09,0.94
1644,2021-02-25,LOM,15223,6307,8916,13645,1578,ITC,ITC4,3,Lombardia,Lombardia,10060574,124578,1.24,0.15
1645,2021-04-30,LOM,116887,54637,62250,89696,27191,ITC,ITC4,3,Lombardia,Lombardia,10060574,241465,2.4,1.16
1646,2021-02-08,LOM,10081,2918,7163,2139,7942,ITC,ITC4,3,Lombardia,Lombardia,10060574,251546,2.5,0.1
1647,2021-05-03,LOM,83633,39727,43906,71518,12115,ITC,ITC4,3,Lombardia,Lombardia,10060574,335179,3.33,0.83
1648,2021-03-28,LOM,20474,7807,12667,14310,6164,ITC,ITC4,3,Lombardia,Lombardia,10060574,355653,3.54,0.2
1649,2021-04-16,LOM,53614,23899,29715,39275,14339,ITC,ITC4,3,Lombardia,Lombardia,10060574,409267,4.07,0.53
1650,2021-01-23,LOM,1114,357,757,916,198,ITC,ITC4,3,Lombardia,Lombardia,10060574,410381,4.08,0.01
1651,2021-03-11,LOM,36236,13478,22758,26321,9915,ITC,ITC4,3,Lombardia,Lombardia,10060574,446617,4.44,0.36
1652,2021-01-06,LOM,7061,2492,4569,7061,0,ITC,ITC4,3,Lombardia,Lombardia,10060574,453678,4.51,0.07
1653,2021-02-23,LOM,11773,4792,6981,11465,308,ITC,ITC4,3,Lombardia,Lombardia,10060574,465451,4.63,0.12
1654,2021-05-19,LOM,82592,39484,43108,33764,48828,ITC,ITC4,3,Lombardia,Lombardia,10060574,548043,5.45,0.82
1655,2021-02-06,LOM,15258,5533,9725,1038,14220,ITC,ITC4,3,Lombardia,Lombardia,10060574,563301,5.6,0.15
1656,2021-05-02,LOM,83495,38330,45165,61035,22460,ITC,ITC4,3,Lombardia,Lombardia,10060574,646796,6.43,0.83
1657,2021-02-04,LOM,27681,8076,19605,1998,25683,ITC,ITC4,3,Lombardia,Lombardia,10060574,674477,6.7,0.28
1658,2021-04-09,LOM,52222,22289,29933,36225,15997,ITC,ITC4,3,Lombardia,Lombardia,10060574,726699,7.22,0.52
1659,2021-04-04,LOM,7617,3232,4385,3718,3899,ITC,ITC4,3,Lombardia,Lombardia,10060574,734316,7.3,0.08
1660,2021-01-01,LOM,24,7,17,24,0,ITC,ITC4,3,Lombardia,Lombardia,10060574,734340,7.3,0.0
1661,2021-03-06,LOM,21317,9087,12230,16801,4516,ITC,ITC4,3,Lombardia,Lombardia,10060574,755657,7.51,0.21
1662,2021-01-09,LOM,12410,4573,7837,12410,0,ITC,ITC4,3,Lombardia,Lombardia,10060574,768067,7.63,0.12
1663,2021-01-27,LOM,8045,2677,5368,821,7224,ITC,ITC4,3,Lombardia,Lombardia,10060574,776112,7.71,0.08
1664,2021-05-21,LOM,93414,45071,48343,29035,64379,ITC,ITC4,3,Lombardia,Lombardia,10060574,869526,8.64,0.93
1665,2021-03-18,LOM,27428,10960,16468,16196,11232,ITC,ITC4,3,Lombardia,Lombardia,10060574,896954,8.92,0.27
1666,2021-01-16,LOM,15417,5725,9692,15417,0,ITC,ITC4,3,Lombardia,Lombardia,10060574,912371,9.07,0.15
1667,2021-03-07,LOM,12019,5347,6672,9460,2559,ITC,ITC4,3,Lombardia,Lombardia,10060574,924390,9.19,0.12
1668,2021-05-07,LOM,92054,43583,48471,69886,22168,ITC,ITC4,3,Lombardia,Lombardia,10060574,1016444,10.1,0.91
1669,2021-03-25,LOM,42653,15932,26721,30074,12579,ITC,ITC4,3,Lombardia,Lombardia,10060574,1059097,10.53,0.42
1670,2021-05-14,LOM,85443,41155,44288,55477,29966,ITC,ITC4,3,Lombardia,Lombardia,10060574,1144540,11.38,0.85
1671,2021-02-10,LOM,14392,4504,9888,7572,6820,ITC,ITC4,3,Lombardia,Lombardia,10060574,1158932,11.52,0.14
1672,2021-04-14,LOM,47139,21018,26121,34172,12967,ITC,ITC4,3,Lombardia,Lombardia,10060574,1206071,11.99,0.47
1673,2021-01-04,LOM,6080,2098,3982,6080,0,ITC,ITC4,3,Lombardia,Lombardia,10060574,1212151,12.05,0.06
1674,2021-03-30,LOM,39491,15488,24003,24704,14787,ITC,ITC4,3,Lombardia,Lombardia,10060574,1251642,12.44,0.39
1675,2021-01-30,LOM,12323,4570,7753,173,12150,ITC,ITC4,3,Lombardia,Lombardia,10060574,1263965,12.56,0.12
1676,2021-02-13,LOM,6416,2443,3973,4939,1477,ITC,ITC4,3,Lombardia,Lombardia,10060574,1270381,12.63,0.06
1677,2021-01-13,LOM,26378,8053,18325,26378,0,ITC,ITC4,3,Lombardia,Lombardia,10060574,1296759,12.89,0.26
1678,2021-03-26,LOM,41176,15616,25560,28107,13069,ITC,ITC4,3,Lombardia,Lombardia,10060574,1337935,13.3,0.41
1679,2021-05-22,LOM,70149,33645,36504,32337,37812,ITC,ITC4,3,Lombardia,Lombardia,10060574,1408084,14.0,0.7
1680,2021-05-24,LOM,88983,43187,45796,49345,39638,ITC,ITC4,3,Lombardia,Lombardia,10060574,1497067,14.88,0.88
1681,2021-02-11,LOM,17045,5004,12041,9700,7345,ITC,ITC4,3,Lombardia,Lombardia,10060574,1514112,15.05,0.17
1682,2021-02-18,LOM,14042,4927,9115,13014,1028,ITC,ITC4,3,Lombardia,Lombardia,10060574,1528154,15.19,0.14
1683,2021-02-20,LOM,9474,3905,5569,9175,299,ITC,ITC4,3,Lombardia,Lombardia,10060574,1537628,15.28,0.09
1684,2021-04-18,LOM,36343,16203,20140,31116,5227,ITC,ITC4,3,Lombardia,Lombardia,10060574,1573971,15.64,0.36
1685,2021-05-10,LOM,85181,40855,44326,63677,21504,ITC,ITC4,3,Lombardia,Lombardia,10060574,1659152,16.49,0.85
1686,2021-04-23,LOM,73365,33270,40095,56855,16510,ITC,ITC4,3,Lombardia,Lombardia,10060574,1732517,17.22,0.73
1687,2021-03-21,LOM,23577,8549,15028,18316,5261,ITC,ITC4,3,Lombardia,Lombardia,10060574,1756094,17.46,0.23
1688,2021-03-04,LOM,29418,12149,17269,20287,9131,ITC,ITC4,3,Lombardia,Lombardia,10060574,1785512,17.75,0.29
1689,2021-04-02,LOM,41138,16828,24310,26692,14446,ITC,ITC4,3,Lombardia,Lombardia,10060574,1826650,18.16,0.41
1690,2021-04-11,LOM,32187,13937,18250,24795,7392,ITC,ITC4,3,Lombardia,Lombardia,10060574,1858837,18.48,0.32
1691,2020-12-30,LOM,114,42,72,114,0,ITC,ITC4,3,Lombardia,Lombardia,10060574,1858951,18.48,0.0
1692,2021-02-27,LOM,13950,5872,8078,13308,642,ITC,ITC4,3,Lombardia,Lombardia,10060574,1872901,18.62,0.14
1693,2021-03-08,LOM,29765,11185,18580,22694,7071,ITC,ITC4,3,Lombardia,Lombardia,10060574,1902666,18.91,0.3
1694,2021-02-16,LOM,9544,3086,6458,9088,456,ITC,ITC4,3,Lombardia,Lombardia,10060574,1912210,19.01,0.09
1695,2020-12-28,LOM,107,47,60,107,0,ITC,ITC4,3,Lombardia,Lombardia,10060574,1912317,19.01,0.0
1696,2021-04-21,LOM,71655,32504,39151,57065,14590,ITC,ITC4,3,Lombardia,Lombardia,10060574,1983972,19.72,0.71
1697,2021-03-02,LOM,22850,9713,13137,19815,3035,ITC,ITC4,3,Lombardia,Lombardia,10060574,2006822,19.95,0.23
1698,2021-01-11,LOM,16174,5362,10812,16174,0,ITC,ITC4,3,Lombardia,Lombardia,10060574,2022996,20.11,0.16
1699,2021-05-26,LOM,92858,44288,48570,43406,49452,ITC,ITC4,3,Lombardia,Lombardia,10060574,2115854,21.03,0.92
1700,2021-04-06,LOM,43045,17563,25482,25092,17953,ITC,ITC4,3,Lombardia,Lombardia,10060574,2158899,21.46,0.43
1701,2021-04-28,LOM,95577,43601,51976,68726,26851,ITC,ITC4,3,Lombardia,Lombardia,10060574,2254476,22.41,0.95
1702,2021-03-16,LOM,25476,10112,15364,16418,9058,ITC,ITC4,3,Lombardia,Lombardia,10060574,2279952,22.66,0.25
1703,2021-05-12,LOM,87094,41578,45516,59741,27353,ITC,ITC4,3,Lombardia,Lombardia,10060574,2367046,23.53,0.87
1704,2021-03-09,LOM,33243,12854,20389,25817,7426,ITC,ITC4,3,Lombardia,Lombardia,10060574,2400289,23.86,0.33
1705,2021-05-05,LOM,87776,41866,45910,72548,15228,ITC,ITC4,3,Lombardia,Lombardia,10060574,2488065,24.73,0.87
1706,2021-01-18,LOM,9156,2968,6188,8175,981,ITC,ITC4,3,Lombardia,Lombardia,10060574,2497221,24.82,0.09
1707,2021-03-23,LOM,42516,15403,27113,29639,12877,ITC,ITC4,3,Lombardia,Lombardia,10060574,2539737,25.24,0.42
1708,2021-01-25,LOM,7025,2372,4653,487,6538,ITC,ITC4,3,Lombardia,Lombardia,10060574,2546762,25.31,0.07
1709,2021-02-01,LOM,16056,5317,10739,304,15752,ITC,ITC4,3,Lombardia,Lombardia,10060574,2562818,25.47,0.16
1710,2021-05-04,LOM,86764,41049,45715,72401,14363,ITC,ITC4,3,Lombardia,Lombardia,10060574,2649582,26.34,0.86
1711,2021-03-01,LOM,18797,8232,10565,17092,1705,ITC,ITC4,3,Lombardia,Lombardia,10060574,2668379,26.52,0.19
1712,2021-05-13,LOM,86826,41643,45183,58209,28617,ITC,ITC4,3,Lombardia,Lombardia,10060574,2755205,27.39,0.86
1713,2021-03-10,LOM,33243,12731,20512,25385,7858,ITC,ITC4,3,Lombardia,Lombardia,10060574,2788448,27.72,0.33
1714,2021-03-31,LOM,41974,16988,24986,26739,15235,ITC,ITC4,3,Lombardia,Lombardia,10060574,2830422,28.13,0.42
1715,2021-01-26,LOM,8376,2721,5655,371,8005,ITC,ITC4,3,Lombardia,Lombardia,10060574,2838798,28.22,0.08
1716,2021-01-20,LOM,5608,1373,4235,5493,115,ITC,ITC4,3,Lombardia,Lombardia,10060574,2844406,28.27,0.06
1717,2021-04-15,LOM,49377,21835,27542,35565,13812,ITC,ITC4,3,Lombardia,Lombardia,10060574,2893783,28.76,0.49
1718,2021-01-03,LOM,854,316,538,854,0,ITC,ITC4,3,Lombardia,Lombardia,10060574,2894637,28.77,0.01
1719,2021-03-29,LOM,40013,15512,24501,25181,14832,ITC,ITC4,3,Lombardia,Lombardia,10060574,2934650,29.17,0.4
1720,2021-03-12,LOM,35249,12955,22294,25044,10205,ITC,ITC4,3,Lombardia,Lombardia,10060574,2969899,29.52,0.35
1721,2021-04-13,LOM,47576,21238,26338,33508,14068,ITC,ITC4,3,Lombardia,Lombardia,10060574,3017475,29.99,0.47
1722,2021-01-22,LOM,3105,866,2239,3035,70,ITC,ITC4,3,Lombardia,Lombardia,10060574,3020580,30.02,0.03
1723,2021-03-27,LOM,32348,12325,20023,23717,8631,ITC,ITC4,3,Lombardia,Lombardia,10060574,3052928,30.35,0.32
1724,2021-01-05,LOM,7821,2566,5255,7821,0,ITC,ITC4,3,Lombardia,Lombardia,10060574,3060749,30.42,0.08
1725,2021-01-28,LOM,12196,3693,8503,777,11419,ITC,ITC4,3,Lombardia,Lombardia,10060574,3072945,30.54,0.12
1726,2021-04-25,LOM,51446,23599,27847,46730,4716,ITC,ITC4,3,Lombardia,Lombardia,10060574,3124391,31.06,0.51
1727,2021-02-03,LOM,25577,7908,17669,1151,24426,ITC,ITC4,3,Lombardia,Lombardia,10060574,3149968,31.31,0.25
1728,2021-04-01,LOM,42906,17207,25699,26741,16165,ITC,ITC4,3,Lombardia,Lombardia,10060574,3192874,31.74,0.43
1729,2021-04-26,LOM,87923,40915,47008,68764,19159,ITC,ITC4,3,Lombardia,Lombardia,10060574,3280797,32.61,0.87
1730,2021-04-12,LOM,47225,20572,26653,32893,14332,ITC,ITC4,3,Lombardia,Lombardia,10060574,3328022,33.08,0.47
1731,2021-05-23,LOM,60718,28912,31806,26787,33931,ITC,ITC4,3,Lombardia,Lombardia,10060574,3388740,33.68,0.6
1732,2021-04-03,LOM,36237,14859,21378,26160,10077,ITC,ITC4,3,Lombardia,Lombardia,10060574,3424977,34.04,0.36
1733,2021-02-12,LOM,13946,4355,9591,9027,4919,ITC,ITC4,3,Lombardia,Lombardia,10060574,3438923,34.18,0.14
1734,2021-04-10,LOM,52373,21698,30675,40580,11793,ITC,ITC4,3,Lombardia,Lombardia,10060574,3491296,34.7,0.52
1735,2021-02-19,LOM,14115,5369,8746,13435,680,ITC,ITC4,3,Lombardia,Lombardia,10060574,3505411,34.84,0.14
1736,2021-04-17,LOM,48365,21250,27115,37596,10769,ITC,ITC4,3,Lombardia,Lombardia,10060574,3553776,35.32,0.48
1737,2021-02-26,LOM,18382,7557,10825,16516,1866,ITC,ITC4,3,Lombardia,Lombardia,10060574,3572158,35.51,0.18
1738,2020-12-31,LOM,714,301,413,714,0,ITC,ITC4,3,Lombardia,Lombardia,10060574,3572872,35.51,0.01
1739,2021-01-07,LOM,11761,3636,8125,11761,0,ITC,ITC4,3,Lombardia,Lombardia,10060574,3584633,35.63,0.12
1740,2021-02-22,LOM,11894,4808,7086,11586,308,ITC,ITC4,3,Lombardia,Lombardia,10060574,3596527,35.75,0.12
1741,2021-05-18,LOM,87919,41998,45921,32534,55385,ITC,ITC4,3,Lombardia,Lombardia,10060574,3684446,36.62,0.87
1742,2021-02-24,LOM,14676,5928,8748,13748,928,ITC,ITC4,3,Lombardia,Lombardia,10060574,3699122,36.77,0.15
1743,2021-02-07,LOM,7308,2821,4487,340,6968,ITC,ITC4,3,Lombardia,Lombardia,10060574,3706430,36.84,0.07
1744,2021-01-19,LOM,8125,2348,5777,7651,474,ITC,ITC4,3,Lombardia,Lombardia,10060574,3714555,36.92,0.08
1745,2021-05-20,LOM,94109,45473,48636,31757,62352,ITC,ITC4,3,Lombardia,Lombardia,10060574,3808664,37.86,0.94
1746,2021-04-08,LOM,52327,21754,30573,35872,16455,ITC,ITC4,3,Lombardia,Lombardia,10060574,3860991,38.38,0.52
1747,2021-02-17,LOM,11969,3746,8223,10579,1390,ITC,ITC4,3,Lombardia,Lombardia,10060574,3872960,38.5,0.12
1748,2021-03-22,LOM,40305,14291,26014,29761,10544,ITC,ITC4,3,Lombardia,Lombardia,10060574,3913265,38.9,0.4
1749,2021-04-22,LOM,73776,33330,40446,57483,16293,ITC,ITC4,3,Lombardia,Lombardia,10060574,3987041,39.63,0.73
1750,2021-04-05,LOM,27387,11697,15690,19277,8110,ITC,ITC4,3,Lombardia,Lombardia,10060574,4014428,39.9,0.27
1751,2021-01-31,LOM,9747,3763,5984,34,9713,ITC,ITC4,3,Lombardia,Lombardia,10060574,4024175,40.0,0.1
1752,2021-05-25,LOM,90565,43324,47241,44530,46035,ITC,ITC4,3,Lombardia,Lombardia,10060574,4114740,40.9,0.9
1753,2021-01-08,LOM,12698,3916,8782,12698,0,ITC,ITC4,3,Lombardia,Lombardia,10060574,4127438,41.03,0.13
1754,2021-01-15,LOM,25207,7431,17776,25207,0,ITC,ITC4,3,Lombardia,Lombardia,10060574,4152645,41.28,0.25
1755,2021-05-16,LOM,68449,32391,36058,36484,31965,ITC,ITC4,3,Lombardia,Lombardia,10060574,4221094,41.96,0.68
1756,2021-03-13,LOM,27172,9765,17407,21076,6096,ITC,ITC4,3,Lombardia,Lombardia,10060574,4248266,42.23,0.27
1757,2021-02-05,LOM,25616,7442,18174,2397,23219,ITC,ITC4,3,Lombardia,Lombardia,10060574,4273882,42.48,0.25
1758,2021-05-01,LOM,95876,43646,52230,66746,29130,ITC,ITC4,3,Lombardia,Lombardia,10060574,4369758,43.43,0.95
1759,2021-01-21,LOM,5342,1569,3773,4653,689,ITC,ITC4,3,Lombardia,Lombardia,10060574,4375100,43.49,0.05
1760,2021-02-15,LOM,8916,3120,5796,8495,421,ITC,ITC4,3,Lombardia,Lombardia,10060574,4384016,43.58,0.09
1761,2020-12-27,LOM,717,413,304,717,0,ITC,ITC4,3,Lombardia,Lombardia,10060574,4384733,43.58,0.01
1762,2021-05-27,LOM,93764,44998,48766,41108,52656,ITC,ITC4,3,Lombardia,Lombardia,10060574,4478497,44.52,0.93
1763,2021-01-02,LOM,199,72,127,199,0,ITC,ITC4,3,Lombardia,Lombardia,10060574,4478696,44.52,0.0
1764,2021-02-28,LOM,7890,3257,4633,7674,216,ITC,ITC4,3,Lombardia,Lombardia,10060574,4486586,44.6,0.08
1765,2021-04-19,LOM,60079,27335,32744,50672,9407,ITC,ITC4,3,Lombardia,Lombardia,10060574,4546665,45.19,0.6
1766,2021-01-24,LOM,1201,459,742,537,664,ITC,ITC4,3,Lombardia,Lombardia,10060574,4547866,45.2,0.01
1767,2021-05-06,LOM,89727,42162,47565,73310,16417,ITC,ITC4,3,Lombardia,Lombardia,10060574,4637593,46.1,0.89
1768,2021-05-15,LOM,80393,38592,41801,47317,33076,ITC,ITC4,3,Lombardia,Lombardia,10060574,4717986,46.9,0.8
1769,2021-02-02,LOM,19850,6584,13266,491,19359,ITC,ITC4,3,Lombardia,Lombardia,10060574,4737836,47.09,0.2
1770,2021-05-28,LOM,91860,44172,47688,42564,49296,ITC,ITC4,3,Lombardia,Lombardia,10060574,4829696,48.01,0.91
1771,2020-12-29,LOM,104,44,60,104,0,ITC,ITC4,3,Lombardia,Lombardia,10060574,4829800,48.01,0.0
1772,2021-03-03,LOM,26944,11505,15439,19671,7273,ITC,ITC4,3,Lombardia,Lombardia,10060574,4856744,48.28,0.27
1773,2021-05-11,LOM,86650,41346,45304,60581,26069,ITC,ITC4,3,Lombardia,Lombardia,10060574,4943394,49.14,0.86
1774,2021-01-12,LOM,20220,6698,13522,20220,0,ITC,ITC4,3,Lombardia,Lombardia,10060574,4963614,49.34,0.2
1775,2021-02-14,LOM,3578,1546,2032,2944,634,ITC,ITC4,3,Lombardia,Lombardia,10060574,4967192,49.37,0.04
1776,2021-04-20,LOM,67613,30813,36800,57284,10329,ITC,ITC4,3,Lombardia,Lombardia,10060574,5034805,50.04,0.67
1777,2021-01-10,LOM,10519,3957,6562,10519,0,ITC,ITC4,3,Lombardia,Lombardia,10060574,5045324,50.15,0.1
1778,2021-04-27,LOM,85904,39948,45956,69367,16537,ITC,ITC4,3,Lombardia,Lombardia,10060574,5131228,51.0,0.85
1779,2021-04-29,LOM,115374,53538,61836,85582,29792,ITC,ITC4,3,Lombardia,Lombardia,10060574,5246602,52.15,1.15
1780,2021-01-17,LOM,8348,3347,5001,8147,201,ITC,ITC4,3,Lombardia,Lombardia,10060574,5254950,52.23,0.08
1781,2021-03-15,LOM,31570,11333,20237,23052,8518,ITC,ITC4,3,Lombardia,Lombardia,10060574,5286520,52.55,0.31
1782,2021-03-17,LOM,26237,10484,15753,15245,10992,ITC,ITC4,3,Lombardia,Lombardia,10060574,5312757,52.81,0.26
1783,2021-03-24,LOM,43307,15625,27682,31439,11868,ITC,ITC4,3,Lombardia,Lombardia,10060574,5356064,53.24,0.43
1784,2021-02-09,LOM,12285,3344,8941,4113,8172,ITC,ITC4,3,Lombardia,Lombardia,10060574,5368349,53.36,0.12
1785,2021-03-20,LOM,32512,12152,20360,22660,9852,ITC,ITC4,3,Lombardia,Lombardia,10060574,5400861,53.68,0.32
1786,2021-05-09,LOM,69512,32809,36703,56427,13085,ITC,ITC4,3,Lombardia,Lombardia,10060574,5470373,54.37,0.69
1787,2021-01-29,LOM,13439,4115,9324,654,12785,ITC,ITC4,3,Lombardia,Lombardia,10060574,5483812,54.51,0.13
1788,2021-04-24,LOM,75650,33527,42123,54589,21061,ITC,ITC4,3,Lombardia,Lombardia,10060574,5559462,55.26,0.75
1789,2021-03-05,LOM,28992,11948,17044,20585,8407,ITC,ITC4,3,Lombardia,Lombardia,10060574,5588454,55.55,0.29
1790,2021-03-19,LOM,32421,12908,19513,19216,13205,ITC,ITC4,3,Lombardia,Lombardia,10060574,5620875,55.87,0.32
1791,2021-01-14,LOM,26801,7782,19019,26801,0,ITC,ITC4,3,Lombardia,Lombardia,10060574,5647676,56.14,0.27
1792,2021-05-08,LOM,87339,40585,46754,65656,21683,ITC,ITC4,3,Lombardia,Lombardia,10060574,5735015,57.0,0.87
1793,2021-02-21,LOM,5052,1862,3190,5034,18,ITC,ITC4,3,Lombardia,Lombardia,10060574,5740067,57.06,0.05
1794,2021-04-07,LOM,50523,20876,29647,34711,15812,ITC,ITC4,3,Lombardia,Lombardia,10060574,5790590,57.56,0.5
1795,2021-03-29,PUG,12870,6001,6869,6139,6731,ITF,ITF4,16,Puglia,Puglia,4029053,12870,0.32,0.32
1796,2021-05-15,PUG,42812,18654,24158,23268,19544,ITF,ITF4,16,Puglia,Puglia,4029053,55682,1.38,1.06
1797,2021-03-12,PUG,13930,6108,7822,10004,3926,ITF,ITF4,16,Puglia,Puglia,4029053,69612,1.73,0.35
1798,2021-02-23,PUG,9349,4422,4927,8874,475,ITF,ITF4,16,Puglia,Puglia,4029053,78961,1.96,0.23
1799,2021-02-07,PUG,1579,669,910,253,1326,ITF,ITF4,16,Puglia,Puglia,4029053,80540,2.0,0.04
1800,2021-05-01,PUG,27390,12547,14843,16752,10638,ITF,ITF4,16,Puglia,Puglia,4029053,107930,2.68,0.68
1801,2021-04-12,PUG,29076,13695,15381,26252,2824,ITF,ITF4,16,Puglia,Puglia,4029053,137006,3.4,0.72
1802,2021-01-21,PUG,2132,904,1228,1271,861,ITF,ITF4,16,Puglia,Puglia,4029053,139138,3.45,0.05
1803,2021-01-02,PUG,2949,1301,1648,2949,0,ITF,ITF4,16,Puglia,Puglia,4029053,142087,3.53,0.07
1804,2021-03-26,PUG,11539,5420,6119,6894,4645,ITF,ITF4,16,Puglia,Puglia,4029053,153626,3.81,0.29
1805,2021-03-28,PUG,3527,1650,1877,1202,2325,ITF,ITF4,16,Puglia,Puglia,4029053,157153,3.9,0.09
1806,2021-03-10,PUG,14405,6246,8159,11287,3118,ITF,ITF4,16,Puglia,Puglia,4029053,171558,4.26,0.36
1807,2021-02-21,PUG,2175,472,1703,2114,61,ITF,ITF4,16,Puglia,Puglia,4029053,173733,4.31,0.05
1808,2021-02-04,PUG,5926,2366,3560,1195,4731,ITF,ITF4,16,Puglia,Puglia,4029053,179659,4.46,0.15
1809,2021-05-17,PUG,32139,14732,17407,20547,11592,ITF,ITF4,16,Puglia,Puglia,4029053,211798,5.26,0.8
1810,2021-04-24,PUG,29212,13298,15914,25263,3949,ITF,ITF4,16,Puglia,Puglia,4029053,241010,5.98,0.73
1811,2021-02-19,PUG,4731,2010,2721,4339,392,ITF,ITF4,16,Puglia,Puglia,4029053,245741,6.1,0.12
1812,2021-04-19,PUG,27500,12761,14739,24467,3033,ITF,ITF4,16,Puglia,Puglia,4029053,273241,6.78,0.68
1813,2021-01-07,PUG,5717,2457,3260,5717,0,ITF,ITF4,16,Puglia,Puglia,4029053,278958,6.92,0.14
1814,2021-01-16,PUG,2507,1033,1474,2507,0,ITF,ITF4,16,Puglia,Puglia,4029053,281465,6.99,0.06
1815,2021-03-16,PUG,9866,4684,5182,3509,6357,ITF,ITF4,16,Puglia,Puglia,4029053,291331,7.23,0.24
1816,2021-04-28,PUG,19636,8786,10850,14886,4750,ITF,ITF4,16,Puglia,Puglia,4029053,310967,7.72,0.49
1817,2021-04-02,PUG,12587,5762,6825,8068,4519,ITF,ITF4,16,Puglia,Puglia,4029053,323554,8.03,0.31
1818,2021-04-16,PUG,35825,16830,18995,32544,3281,ITF,ITF4,16,Puglia,Puglia,4029053,359379,8.92,0.89
1819,2021-02-18,PUG,4378,1846,2532,3774,604,ITF,ITF4,16,Puglia,Puglia,4029053,363757,9.03,0.11
1820,2021-02-11,PUG,3700,1402,2298,2423,1277,ITF,ITF4,16,Puglia,Puglia,4029053,367457,9.12,0.09
1821,2021-01-31,PUG,1812,827,985,74,1738,ITF,ITF4,16,Puglia,Puglia,4029053,369269,9.17,0.04
1822,2021-05-22,PUG,33872,15526,18346,23728,10144,ITF,ITF4,16,Puglia,Puglia,4029053,403141,10.01,0.84
1823,2021-04-09,PUG,21833,9386,12447,17212,4621,ITF,ITF4,16,Puglia,Puglia,4029053,424974,10.55,0.54
1824,2021-02-25,PUG,11954,5052,6902,10791,1163,ITF,ITF4,16,Puglia,Puglia,4029053,436928,10.84,0.3
1825,2021-01-19,PUG,1221,452,769,1211,10,ITF,ITF4,16,Puglia,Puglia,4029053,438149,10.87,0.03
1826,2021-04-14,PUG,31792,15010,16782,28486,3306,ITF,ITF4,16,Puglia,Puglia,4029053,469941,11.66,0.79
1827,2021-01-04,PUG,4505,2014,2491,4505,0,ITF,ITF4,16,Puglia,Puglia,4029053,474446,11.78,0.11
1828,2021-03-09,PUG,13289,5790,7499,11281,2008,ITF,ITF4,16,Puglia,Puglia,4029053,487735,12.11,0.33
1829,2021-02-14,PUG,787,348,439,663,124,ITF,ITF4,16,Puglia,Puglia,4029053,488522,12.12,0.02
1830,2021-01-28,PUG,5471,2276,3195,471,5000,ITF,ITF4,16,Puglia,Puglia,4029053,493993,12.26,0.14
1831,2021-02-26,PUG,13713,5027,8686,12679,1034,ITF,ITF4,16,Puglia,Puglia,4029053,507706,12.6,0.34
1832,2020-12-31,PUG,1634,782,852,1634,0,ITF,ITF4,16,Puglia,Puglia,4029053,509340,12.64,0.04
1833,2021-03-05,PUG,17273,6849,10424,15068,2205,ITF,ITF4,16,Puglia,Puglia,4029053,526613,13.07,0.43
1834,2021-02-28,PUG,6046,1806,4240,5860,186,ITF,ITF4,16,Puglia,Puglia,4029053,532659,13.22,0.15
1835,2021-05-03,PUG,33065,14757,18308,22450,10615,ITF,ITF4,16,Puglia,Puglia,4029053,565724,14.04,0.82
1836,2021-03-07,PUG,4920,1943,2977,4349,571,ITF,ITF4,16,Puglia,Puglia,4029053,570644,14.16,0.12
1837,2021-01-23,PUG,3040,1294,1746,886,2154,ITF,ITF4,16,Puglia,Puglia,4029053,573684,14.24,0.08
1838,2021-04-05,PUG,12683,6163,6520,12149,534,ITF,ITF4,16,Puglia,Puglia,4029053,586367,14.55,0.31
1839,2021-05-25,PUG,33077,15046,18031,20231,12846,ITF,ITF4,16,Puglia,Puglia,4029053,619444,15.37,0.82
1840,2021-03-19,PUG,7951,3648,4303,3407,4544,ITF,ITF4,16,Puglia,Puglia,4029053,627395,15.57,0.2
1841,2021-05-08,PUG,53855,22776,31079,24249,29606,ITF,ITF4,16,Puglia,Puglia,4029053,681250,16.91,1.34
1842,2021-04-17,PUG,39751,18819,20932,36185,3566,ITF,ITF4,16,Puglia,Puglia,4029053,721001,17.9,0.99
1843,2021-01-14,PUG,4069,1589,2480,4069,0,ITF,ITF4,16,Puglia,Puglia,4029053,725070,18.0,0.1
1844,2021-04-26,PUG,26035,11924,14111,22803,3232,ITF,ITF4,16,Puglia,Puglia,4029053,751105,18.64,0.65
1845,2021-01-09,PUG,4885,2250,2635,4885,0,ITF,ITF4,16,Puglia,Puglia,4029053,755990,18.76,0.12
1846,2021-03-14,PUG,3318,1429,1889,2507,811,ITF,ITF4,16,Puglia,Puglia,4029053,759308,18.85,0.08
1847,2021-05-12,PUG,36060,16007,20053,23693,12367,ITF,ITF4,16,Puglia,Puglia,4029053,795368,19.74,0.89
1848,2021-05-05,PUG,38777,16941,21836,24653,14124,ITF,ITF4,16,Puglia,Puglia,4029053,834145,20.7,0.96
1849,2021-03-30,PUG,11867,5492,6375,5973,5894,ITF,ITF4,16,Puglia,Puglia,4029053,846012,21.0,0.29
1850,2021-02-01,PUG,3965,1659,2306,375,3590,ITF,ITF4,16,Puglia,Puglia,4029053,849977,21.1,0.1
1851,2021-01-12,PUG,4212,1772,2440,4212,0,ITF,ITF4,16,Puglia,Puglia,4029053,854189,21.2,0.1
1852,2021-04-07,PUG,15325,6789,8536,8655,6670,ITF,ITF4,16,Puglia,Puglia,4029053,869514,21.58,0.38
1853,2021-05-27,PUG,37278,17189,20089,21978,15300,ITF,ITF4,16,Puglia,Puglia,4029053,906792,22.51,0.93
1854,2021-04-21,PUG,23044,10631,12413,19311,3733,ITF,ITF4,16,Puglia,Puglia,4029053,929836,23.08,0.57
1855,2021-02-16,PUG,3379,1452,1927,2735,644,ITF,ITF4,16,Puglia,Puglia,4029053,933215,23.16,0.08
1856,2021-03-02,PUG,16334,6062,10272,15036,1298,ITF,ITF4,16,Puglia,Puglia,4029053,949549,23.57,0.41
1857,2021-01-11,PUG,3753,1588,2165,3753,0,ITF,ITF4,16,Puglia,Puglia,4029053,953302,23.66,0.09
1858,2021-05-20,PUG,32536,14477,18059,20593,11943,ITF,ITF4,16,Puglia,Puglia,4029053,985838,24.47,0.81
1859,2021-05-06,PUG,39228,17124,22104,19594,19634,ITF,ITF4,16,Puglia,Puglia,4029053,1025066,25.44,0.97
1860,2021-05-13,PUG,38262,17021,21241,21245,17017,ITF,ITF4,16,Puglia,Puglia,4029053,1063328,26.39,0.95
1861,2021-03-17,PUG,10345,4702,5643,4171,6174,ITF,ITF4,16,Puglia,Puglia,4029053,1073673,26.65,0.26
1862,2021-02-09,PUG,3840,1570,2270,2168,1672,ITF,ITF4,16,Puglia,Puglia,4029053,1077513,26.74,0.1
1863,2021-03-24,PUG,12975,5982,6993,5719,7256,ITF,ITF4,16,Puglia,Puglia,4029053,1090488,27.07,0.32
1864,2021-01-26,PUG,5359,2397,2962,570,4789,ITF,ITF4,16,Puglia,Puglia,4029053,1095847,27.2,0.13
1865,2021-03-31,PUG,14047,6356,7691,8492,5555,ITF,ITF4,16,Puglia,Puglia,4029053,1109894,27.55,0.35
1866,2021-02-02,PUG,4343,1845,2498,593,3750,ITF,ITF4,16,Puglia,Puglia,4029053,1114237,27.66,0.11
1867,2021-05-19,PUG,25529,12094,13435,19298,6231,ITF,ITF4,16,Puglia,Puglia,4029053,1139766,28.29,0.63
1868,2021-03-25,PUG,10889,5291,5598,4655,6234,ITF,ITF4,16,Puglia,Puglia,4029053,1150655,28.56,0.27
1869,2021-02-10,PUG,3643,1435,2208,2133,1510,ITF,ITF4,16,Puglia,Puglia,4029053,1154298,28.65,0.09
1870,2021-05-23,PUG,17641,8248,9393,13874,3767,ITF,ITF4,16,Puglia,Puglia,4029053,1171939,29.09,0.44
1871,2021-05-28,PUG,35899,16759,19140,23426,12473,ITF,ITF4,16,Puglia,Puglia,4029053,1207838,29.98,0.89
1872,2021-01-18,PUG,1845,770,1075,1496,349,ITF,ITF4,16,Puglia,Puglia,4029053,1209683,30.02,0.05
1873,2021-04-30,PUG,34569,15456,19113,22637,11932,ITF,ITF4,16,Puglia,Puglia,4029053,1244252,30.88,0.86
1874,2021-04-13,PUG,28599,13557,15042,25202,3397,ITF,ITF4,16,Puglia,Puglia,4029053,1272851,31.59,0.71
1875,2021-03-27,PUG,12136,5701,6435,6976,5160,ITF,ITF4,16,Puglia,Puglia,4029053,1284987,31.89,0.3
1876,2021-01-05,PUG,5104,2249,2855,5104,0,ITF,ITF4,16,Puglia,Puglia,4029053,1290091,32.02,0.13
1877,2021-02-06,PUG,4546,1928,2618,1590,2956,ITF,ITF4,16,Puglia,Puglia,4029053,1294637,32.13,0.11
1878,2021-01-20,PUG,1545,540,1005,1537,8,ITF,ITF4,16,Puglia,Puglia,4029053,1296182,32.17,0.04
1879,2021-05-02,PUG,21211,9617,11594,13962,7249,ITF,ITF4,16,Puglia,Puglia,4029053,1317393,32.7,0.53
1880,2021-01-03,PUG,2007,943,1064,2007,0,ITF,ITF4,16,Puglia,Puglia,4029053,1319400,32.75,0.05
1881,2021-04-15,PUG,32366,15093,17273,28867,3499,ITF,ITF4,16,Puglia,Puglia,4029053,1351766,33.55,0.8
1882,2021-05-10,PUG,37264,16436,20828,19438,17826,ITF,ITF4,16,Puglia,Puglia,4029053,1389030,34.48,0.92
1883,2021-04-04,PUG,5940,2951,2989,5935,5,ITF,ITF4,16,Puglia,Puglia,4029053,1394970,34.62,0.15
1884,2021-03-21,PUG,2692,1226,1466,588,2104,ITF,ITF4,16,Puglia,Puglia,4029053,1397662,34.69,0.07
1885,2021-05-24,PUG,34634,16050,18584,24219,10415,ITF,ITF4,16,Puglia,Puglia,4029053,1432296,35.55,0.86
1886,2021-01-30,PUG,5528,2515,3013,411,5117,ITF,ITF4,16,Puglia,Puglia,4029053,1437824,35.69,0.14
1887,2020-12-30,PUG,1,0,1,1,0,ITF,ITF4,16,Puglia,Puglia,4029053,1437825,35.69,0.0
1888,2021-04-27,PUG,26489,11992,14497,20902,5587,ITF,ITF4,16,Puglia,Puglia,4029053,1464314,36.34,0.66
1889,2021-03-08,PUG,14600,6084,8516,12201,2399,ITF,ITF4,16,Puglia,Puglia,4029053,1478914,36.71,0.36
1890,2021-01-24,PUG,1669,749,920,153,1516,ITF,ITF4,16,Puglia,Puglia,4029053,1480583,36.75,0.04
1891,2021-05-11,PUG,32188,14161,18027,13872,18316,ITF,ITF4,16,Puglia,Puglia,4029053,1512771,37.55,0.8
1892,2021-04-11,PUG,16441,7238,9203,14785,1656,ITF,ITF4,16,Puglia,Puglia,4029053,1529212,37.95,0.41
1893,2021-04-18,PUG,22527,10770,11757,21464,1063,ITF,ITF4,16,Puglia,Puglia,4029053,1551739,38.51,0.56
1894,2021-02-20,PUG,2969,1080,1889,2713,256,ITF,ITF4,16,Puglia,Puglia,4029053,1554708,38.59,0.07
1895,2021-04-25,PUG,11174,5182,5992,10017,1157,ITF,ITF4,16,Puglia,Puglia,4029053,1565882,38.86,0.28
1896,2021-02-27,PUG,14212,4812,9400,12987,1225,ITF,ITF4,16,Puglia,Puglia,4029053,1580094,39.22,0.35
1897,2021-01-01,PUG,147,60,87,147,0,ITF,ITF4,16,Puglia,Puglia,4029053,1580241,39.22,0.0
1898,2021-03-06,PUG,15969,5965,10004,13882,2087,ITF,ITF4,16,Puglia,Puglia,4029053,1596210,39.62,0.4
1899,2021-01-08,PUG,5594,2347,3247,5594,0,ITF,ITF4,16,Puglia,Puglia,4029053,1601804,39.76,0.14
1900,2021-01-15,PUG,4552,1866,2686,4552,0,ITF,ITF4,16,Puglia,Puglia,4029053,1606356,39.87,0.11
1901,2021-01-22,PUG,1409,578,831,991,418,ITF,ITF4,16,Puglia,Puglia,4029053,1607765,39.9,0.03
1902,2021-03-11,PUG,14379,6194,8185,11271,3108,ITF,ITF4,16,Puglia,Puglia,4029053,1622144,40.26,0.36
1903,2021-02-22,PUG,9629,4536,5093,9297,332,ITF,ITF4,16,Puglia,Puglia,4029053,1631773,40.5,0.24
1904,2021-02-24,PUG,10035,4703,5332,9446,589,ITF,ITF4,16,Puglia,Puglia,4029053,1641808,40.75,0.25
1905,2021-04-29,PUG,25885,11976,13909,19228,6657,ITF,ITF4,16,Puglia,Puglia,4029053,1667693,41.39,0.64
1906,2021-04-23,PUG,29282,13606,15676,24074,5208,ITF,ITF4,16,Puglia,Puglia,4029053,1696975,42.12,0.73
1907,2021-03-04,PUG,15102,5899,9203,13713,1389,ITF,ITF4,16,Puglia,Puglia,4029053,1712077,42.49,0.37
1908,2021-05-07,PUG,49295,21982,27313,26059,23236,ITF,ITF4,16,Puglia,Puglia,4029053,1761372,43.72,1.22
1909,2021-02-15,PUG,3252,1268,1984,2632,620,ITF,ITF4,16,Puglia,Puglia,4029053,1764624,43.8,0.08
1910,2021-04-06,PUG,13578,6025,7553,6828,6750,ITF,ITF4,16,Puglia,Puglia,4029053,1778202,44.13,0.34
1911,2021-04-20,PUG,21039,9766,11273,17597,3442,ITF,ITF4,16,Puglia,Puglia,4029053,1799241,44.66,0.52
1912,2021-03-13,PUG,10380,4103,6277,8648,1732,ITF,ITF4,16,Puglia,Puglia,4029053,1809621,44.91,0.26
1913,2021-05-16,PUG,24274,10945,13329,12518,11756,ITF,ITF4,16,Puglia,Puglia,4029053,1833895,45.52,0.6
1914,2021-05-18,PUG,28111,12894,15217,15572,12539,ITF,ITF4,16,Puglia,Puglia,4029053,1862006,46.21,0.7
1915,2021-02-05,PUG,5634,2273,3361,1332,4302,ITF,ITF4,16,Puglia,Puglia,4029053,1867640,46.35,0.14
1916,2021-04-22,PUG,22888,10459,12429,18022,4866,ITF,ITF4,16,Puglia,Puglia,4029053,1890528,46.92,0.57
1917,2021-03-03,PUG,16667,6703,9964,14755,1912,ITF,ITF4,16,Puglia,Puglia,4029053,1907195,47.34,0.41
1918,2021-01-06,PUG,3945,1668,2277,3945,0,ITF,ITF4,16,Puglia,Puglia,4029053,1911140,47.43,0.1
1919,2021-05-04,PUG,34756,14658,20098,18368,16388,ITF,ITF4,16,Puglia,Puglia,4029053,1945896,48.3,0.86
1920,2021-03-22,PUG,9349,4553,4796,3705,5644,ITF,ITF4,16,Puglia,Puglia,4029053,1955245,48.53,0.23
1921,2021-03-15,PUG,11780,5622,6158,5280,6500,ITF,ITF4,16,Puglia,Puglia,4029053,1967025,48.82,0.29
1922,2021-01-17,PUG,1308,590,718,1239,69,ITF,ITF4,16,Puglia,Puglia,4029053,1968333,48.85,0.03
1923,2021-03-23,PUG,10411,4999,5412,3941,6470,ITF,ITF4,16,Puglia,Puglia,4029053,1978744,49.11,0.26
1924,2021-05-21,PUG,37624,17605,20019,28036,9588,ITF,ITF4,16,Puglia,Puglia,4029053,2016368,50.05,0.93
1925,2021-02-08,PUG,3992,1610,2382,1597,2395,ITF,ITF4,16,Puglia,Puglia,4029053,2020360,50.14,0.1
1926,2021-02-17,PUG,4272,1744,2528,3670,602,ITF,ITF4,16,Puglia,Puglia,4029053,2024632,50.25,0.11
1927,2021-05-26,PUG,36304,17063,19241,25446,10858,ITF,ITF4,16,Puglia,Puglia,4029053,2060936,51.15,0.9
1928,2021-01-13,PUG,4541,1731,2810,4541,0,ITF,ITF4,16,Puglia,Puglia,4029053,2065477,51.26,0.11
1929,2021-03-18,PUG,9401,4254,5147,3284,6117,ITF,ITF4,16,Puglia,Puglia,4029053,2074878,51.5,0.23
1930,2021-01-27,PUG,4577,1928,2649,610,3967,ITF,ITF4,16,Puglia,Puglia,4029053,2079455,51.61,0.11
1931,2021-03-01,PUG,15090,5861,9229,13720,1370,ITF,ITF4,16,Puglia,Puglia,4029053,2094545,51.99,0.37
1932,2021-01-10,PUG,2348,1061,1287,2348,0,ITF,ITF4,16,Puglia,Puglia,4029053,2096893,52.04,0.06
1933,2020-12-27,PUG,509,252,257,509,0,ITF,ITF4,16,Puglia,Puglia,4029053,2097402,52.06,0.01
1934,2021-01-25,PUG,3823,1680,2143,423,3400,ITF,ITF4,16,Puglia,Puglia,4029053,2101225,52.15,0.09
1935,2021-05-14,PUG,44440,20253,24187,28487,15953,ITF,ITF4,16,Puglia,Puglia,4029053,2145665,53.25,1.1
1936,2021-04-08,PUG,17442,7569,9873,11269,6173,ITF,ITF4,16,Puglia,Puglia,4029053,2163107,53.69,0.43
1937,2021-04-01,PUG,13496,6152,7344,7153,6343,ITF,ITF4,16,Puglia,Puglia,4029053,2176603,54.02,0.33
1938,2021-02-03,PUG,5036,2005,3031,730,4306,ITF,ITF4,16,Puglia,Puglia,4029053,2181639,54.15,0.12
1939,2021-02-13,PUG,3726,1455,2271,3031,695,ITF,ITF4,16,Puglia,Puglia,4029053,2185365,54.24,0.09
1940,2021-05-09,PUG,30439,12467,17972,14900,15539,ITF,ITF4,16,Puglia,Puglia,4029053,2215804,55.0,0.76
1941,2021-01-29,PUG,6193,2660,3533,436,5757,ITF,ITF4,16,Puglia,Puglia,4029053,2221997,55.15,0.15
1942,2021-03-20,PUG,8255,3734,4521,3666,4589,ITF,ITF4,16,Puglia,Puglia,4029053,2230252,55.35,0.2
1943,2021-02-12,PUG,4129,1644,2485,3038,1091,ITF,ITF4,16,Puglia,Puglia,4029053,2234381,55.46,0.1
1944,2021-04-10,PUG,30717,13027,17690,26494,4223,ITF,ITF4,16,Puglia,Puglia,4029053,2265098,56.22,0.76
1945,2021-04-03,PUG,10541,4633,5908,6987,3554,ITF,ITF4,16,Puglia,Puglia,4029053,2275639,56.48,0.26
1946,2021-01-09,TOS,4485,1596,2889,4485,0,ITI,ITI1,9,Toscana,Toscana,3729641,4485,0.12,0.12
1947,2021-04-04,TOS,13910,6601,7309,13657,253,ITI,ITI1,9,Toscana,Toscana,3729641,18395,0.49,0.37
1948,2021-03-18,TOS,9970,3981,5989,6005,3965,ITI,ITI1,9,Toscana,Toscana,3729641,28365,0.76,0.27
1949,2021-05-22,TOS,25891,12601,13290,21668,4223,ITI,ITI1,9,Toscana,Toscana,3729641,54256,1.45,0.69
1950,2021-02-09,TOS,4488,1468,3020,3877,611,ITI,ITI1,9,Toscana,Toscana,3729641,58744,1.58,0.12
1951,2021-05-05,TOS,30015,13368,16647,15644,14371,ITI,ITI1,9,Toscana,Toscana,3729641,88759,2.38,0.8
1952,2021-02-11,TOS,5383,2021,3362,5141,242,ITI,ITI1,9,Toscana,Toscana,3729641,94142,2.52,0.14
1953,2021-01-25,TOS,5127,1896,3231,248,4879,ITI,ITI1,9,Toscana,Toscana,3729641,99269,2.66,0.14
1954,2021-05-07,TOS,32056,14668,17388,11986,20070,ITI,ITI1,9,Toscana,Toscana,3729641,131325,3.52,0.86
1955,2021-04-02,TOS,31944,13534,18410,23921,8023,ITI,ITI1,9,Toscana,Toscana,3729641,163269,4.38,0.86
1956,2021-03-16,TOS,4903,1884,3019,2653,2250,ITI,ITI1,9,Toscana,Toscana,3729641,168172,4.51,0.13
1957,2021-02-27,TOS,1982,755,1227,1080,902,ITI,ITI1,9,Toscana,Toscana,3729641,170154,4.56,0.05
1958,2021-02-16,TOS,9279,3339,5940,8558,721,ITI,ITI1,9,Toscana,Toscana,3729641,179433,4.81,0.25
1959,2021-04-21,TOS,29597,12662,16935,17513,12084,ITI,ITI1,9,Toscana,Toscana,3729641,209030,5.6,0.79
1960,2021-02-25,TOS,10635,4306,6329,9636,999,ITI,ITI1,9,Toscana,Toscana,3729641,219665,5.89,0.29
1961,2021-04-30,TOS,39997,17685,22312,20142,19855,ITI,ITI1,9,Toscana,Toscana,3729641,259662,6.96,1.07
1962,2021-04-25,TOS,11054,5248,5806,8917,2137,ITI,ITI1,9,Toscana,Toscana,3729641,270716,7.26,0.3
1963,2021-01-13,TOS,4062,1398,2664,4062,0,ITI,ITI1,9,Toscana,Toscana,3729641,274778,7.37,0.11
1964,2021-03-19,TOS,10136,4457,5679,7271,2865,ITI,ITI1,9,Toscana,Toscana,3729641,284914,7.64,0.27
1965,2021-01-21,TOS,1589,686,903,867,722,ITI,ITI1,9,Toscana,Toscana,3729641,286503,7.68,0.04
1966,2021-02-08,TOS,4097,1360,2737,3638,459,ITI,ITI1,9,Toscana,Toscana,3729641,290600,7.79,0.11
1967,2021-04-13,TOS,8490,3508,4982,6032,2458,ITI,ITI1,9,Toscana,Toscana,3729641,299090,8.02,0.23
1968,2021-05-26,TOS,35120,16755,18365,20121,14999,ITI,ITI1,9,Toscana,Toscana,3729641,334210,8.96,0.94
1969,2021-03-30,TOS,16861,7498,9363,13297,3564,ITI,ITI1,9,Toscana,Toscana,3729641,351071,9.41,0.45
1970,2020-12-27,TOS,620,267,353,620,0,ITI,ITI1,9,Toscana,Toscana,3729641,351691,9.43,0.02
1971,2021-01-28,TOS,6282,1882,4400,354,5928,ITI,ITI1,9,Toscana,Toscana,3729641,357973,9.6,0.17
1972,2021-05-19,TOS,27739,13425,14314,18862,8877,ITI,ITI1,9,Toscana,Toscana,3729641,385712,10.34,0.74
1973,2021-04-06,TOS,22170,9774,12396,18456,3714,ITI,ITI1,9,Toscana,Toscana,3729641,407882,10.94,0.59
1974,2021-01-03,TOS,3335,1051,2284,3335,0,ITI,ITI1,9,Toscana,Toscana,3729641,411217,11.03,0.09
1975,2021-02-28,TOS,1649,667,982,922,727,ITI,ITI1,9,Toscana,Toscana,3729641,412866,11.07,0.04
1976,2021-05-24,TOS,33354,16394,16960,24087,9267,ITI,ITI1,9,Toscana,Toscana,3729641,446220,11.96,0.89
1977,2021-02-13,TOS,7785,2360,5425,7558,227,ITI,ITI1,9,Toscana,Toscana,3729641,454005,12.17,0.21
1978,2021-04-18,TOS,8333,4081,4252,7337,996,ITI,ITI1,9,Toscana,Toscana,3729641,462338,12.4,0.22
1979,2021-03-26,TOS,20404,9160,11244,14644,5760,ITI,ITI1,9,Toscana,Toscana,3729641,482742,12.94,0.55
1980,2021-03-09,TOS,10674,4152,6522,5122,5552,ITI,ITI1,9,Toscana,Toscana,3729641,493416,13.23,0.29
1981,2021-04-09,TOS,24531,10545,13986,21122,3409,ITI,ITI1,9,Toscana,Toscana,3729641,517947,13.89,0.66
1982,2021-02-04,TOS,4253,1594,2659,961,3292,ITI,ITI1,9,Toscana,Toscana,3729641,522200,14.0,0.11
1983,2021-03-23,TOS,9093,4102,4991,6819,2274,ITI,ITI1,9,Toscana,Toscana,3729641,531293,14.25,0.24
1984,2021-05-12,TOS,34123,15545,18578,14162,19961,ITI,ITI1,9,Toscana,Toscana,3729641,565416,15.16,0.91
1985,2021-01-18,TOS,1119,636,483,1021,98,ITI,ITI1,9,Toscana,Toscana,3729641,566535,15.19,0.03
1986,2021-04-07,TOS,35635,15293,20342,28387,7248,ITI,ITI1,9,Toscana,Toscana,3729641,602170,16.15,0.96
1987,2021-04-14,TOS,20155,8334,11821,15048,5107,ITI,ITI1,9,Toscana,Toscana,3729641,622325,16.69,0.54
1988,2021-04-16,TOS,28949,12887,16062,22045,6904,ITI,ITI1,9,Toscana,Toscana,3729641,651274,17.46,0.78
1989,2021-03-02,TOS,10599,3798,6801,7155,3444,ITI,ITI1,9,Toscana,Toscana,3729641,661873,17.75,0.28
1990,2021-01-04,TOS,5065,1894,3171,5065,0,ITI,ITI1,9,Toscana,Toscana,3729641,666938,17.88,0.14
1991,2021-03-04,TOS,17625,6759,10866,14543,3082,ITI,ITI1,9,Toscana,Toscana,3729641,684563,18.35,0.47
1992,2021-01-06,TOS,4520,1460,3060,4520,0,ITI,ITI1,9,Toscana,Toscana,3729641,689083,18.48,0.12
1993,2021-05-15,TOS,29289,13825,15464,23554,5735,ITI,ITI1,9,Toscana,Toscana,3729641,718372,19.26,0.79
1994,2021-04-28,TOS,19119,8187,10932,3831,15288,ITI,ITI1,9,Toscana,Toscana,3729641,737491,19.77,0.51
1995,2021-02-18,TOS,8819,3284,5535,7924,895,ITI,ITI1,9,Toscana,Toscana,3729641,746310,20.01,0.24
1996,2020-12-30,TOS,327,104,223,327,0,ITI,ITI1,9,Toscana,Toscana,3729641,746637,20.02,0.01
1997,2021-02-01,TOS,5509,1958,3551,521,4988,ITI,ITI1,9,Toscana,Toscana,3729641,752146,20.17,0.15
1998,2021-01-11,TOS,5094,1691,3403,5094,0,ITI,ITI1,9,Toscana,Toscana,3729641,757240,20.3,0.14
1999,2021-02-23,TOS,7721,3324,4397,7560,161,ITI,ITI1,9,Toscana,Toscana,3729641,764961,20.51,0.21
2000,2021-04-23,TOS,25673,11428,14245,9359,16314,ITI,ITI1,9,Toscana,Toscana,3729641,790634,21.2,0.69
2001,2021-05-02,TOS,11168,4931,6237,9205,1963,ITI,ITI1,9,Toscana,Toscana,3729641,801802,21.5,0.3
2002,2021-01-20,TOS,1331,637,694,1083,248,ITI,ITI1,9,Toscana,Toscana,3729641,803133,21.53,0.04
2003,2021-04-26,TOS,10153,4943,5210,7598,2555,ITI,ITI1,9,Toscana,Toscana,3729641,813286,21.81,0.27
2004,2021-01-02,TOS,3497,1096,2401,3497,0,ITI,ITI1,9,Toscana,Toscana,3729641,816783,21.9,0.09
2005,2021-03-07,TOS,5647,2356,3291,2105,3542,ITI,ITI1,9,Toscana,Toscana,3729641,822430,22.05,0.15
2006,2021-01-16,TOS,3271,1046,2225,3271,0,ITI,ITI1,9,Toscana,Toscana,3729641,825701,22.14,0.09
2007,2021-04-11,TOS,3642,1679,1963,3487,155,ITI,ITI1,9,Toscana,Toscana,3729641,829343,22.24,0.1
2008,2021-02-20,TOS,4641,1790,2851,4128,513,ITI,ITI1,9,Toscana,Toscana,3729641,833984,22.36,0.12
2009,2021-05-03,TOS,11932,5509,6423,10614,1318,ITI,ITI1,9,Toscana,Toscana,3729641,845916,22.68,0.32
2010,2021-05-17,TOS,29477,14631,14846,20806,8671,ITI,ITI1,9,Toscana,Toscana,3729641,875393,23.47,0.79
2011,2021-03-21,TOS,3231,1573,1658,1798,1433,ITI,ITI1,9,Toscana,Toscana,3729641,878624,23.56,0.09
2012,2021-01-23,TOS,3949,1354,2595,640,3309,ITI,ITI1,9,Toscana,Toscana,3729641,882573,23.66,0.11
2013,2021-03-28,TOS,6212,2808,3404,5958,254,ITI,ITI1,9,Toscana,Toscana,3729641,888785,23.83,0.17
2014,2021-01-30,TOS,4622,1622,3000,198,4424,ITI,ITI1,9,Toscana,Toscana,3729641,893407,23.95,0.12
2015,2021-05-10,TOS,26103,12334,13769,15492,10611,ITI,ITI1,9,Toscana,Toscana,3729641,919510,24.65,0.7
2016,2021-03-14,TOS,7207,2574,4633,3272,3935,ITI,ITI1,9,Toscana,Toscana,3729641,926717,24.85,0.19
2017,2021-02-06,TOS,4527,1550,2977,1294,3233,ITI,ITI1,9,Toscana,Toscana,3729641,931244,24.97,0.12
2018,2021-01-22,TOS,2866,1064,1802,528,2338,ITI,ITI1,9,Toscana,Toscana,3729641,934110,25.05,0.08
2019,2021-03-27,TOS,8860,4150,4710,8645,215,ITI,ITI1,9,Toscana,Toscana,3729641,942970,25.28,0.24
2020,2021-05-25,TOS,33778,16201,17577,19314,14464,ITI,ITI1,9,Toscana,Toscana,3729641,976748,26.19,0.91
2021,2021-03-22,TOS,4890,2451,2439,4446,444,ITI,ITI1,9,Toscana,Toscana,3729641,981638,26.32,0.13
2022,2021-03-31,TOS,32576,13136,19440,20419,12157,ITI,ITI1,9,Toscana,Toscana,3729641,1014214,27.19,0.87
2023,2021-02-10,TOS,4263,1281,2982,3740,523,ITI,ITI1,9,Toscana,Toscana,3729641,1018477,27.31,0.11
2024,2021-05-23,TOS,28261,13593,14668,25707,2554,ITI,ITI1,9,Toscana,Toscana,3729641,1046738,28.07,0.76
2025,2021-05-06,TOS,31268,13593,17675,14149,17119,ITI,ITI1,9,Toscana,Toscana,3729641,1078006,28.9,0.84
2026,2021-01-24,TOS,3349,1073,2276,201,3148,ITI,ITI1,9,Toscana,Toscana,3729641,1081355,28.99,0.09
2027,2021-04-19,TOS,9097,4506,4591,8069,1028,ITI,ITI1,9,Toscana,Toscana,3729641,1090452,29.24,0.24
2028,2021-05-21,TOS,28581,13220,15361,17445,11136,ITI,ITI1,9,Toscana,Toscana,3729641,1119033,30.0,0.77
2029,2021-03-01,TOS,4472,1733,2739,832,3640,ITI,ITI1,9,Toscana,Toscana,3729641,1123505,30.12,0.12
2030,2021-05-04,TOS,18299,8207,10092,12852,5447,ITI,ITI1,9,Toscana,Toscana,3729641,1141804,30.61,0.49
2031,2021-02-12,TOS,7606,2683,4923,7393,213,ITI,ITI1,9,Toscana,Toscana,3729641,1149410,30.82,0.2
2032,2021-04-17,TOS,20533,9206,11327,18411,2122,ITI,ITI1,9,Toscana,Toscana,3729641,1169943,31.37,0.55
2033,2021-01-26,TOS,5393,1792,3601,220,5173,ITI,ITI1,9,Toscana,Toscana,3729641,1175336,31.51,0.14
2034,2021-05-14,TOS,33245,15379,17866,20634,12611,ITI,ITI1,9,Toscana,Toscana,3729641,1208581,32.4,0.89
2035,2021-05-08,TOS,29120,13104,16016,13691,15429,ITI,ITI1,9,Toscana,Toscana,3729641,1237701,33.19,0.78
2036,2021-01-14,TOS,3255,1179,2076,3255,0,ITI,ITI1,9,Toscana,Toscana,3729641,1240956,33.27,0.09
2037,2021-05-28,TOS,27950,12779,15171,16053,11897,ITI,ITI1,9,Toscana,Toscana,3729641,1268906,34.02,0.75
2038,2021-04-08,TOS,29651,12535,17116,23276,6375,ITI,ITI1,9,Toscana,Toscana,3729641,1298557,34.82,0.8
2039,2021-04-15,TOS,24382,10188,14194,15861,8521,ITI,ITI1,9,Toscana,Toscana,3729641,1322939,35.47,0.65
2040,2021-02-17,TOS,8175,3169,5006,7423,752,ITI,ITI1,9,Toscana,Toscana,3729641,1331114,35.69,0.22
2041,2021-04-22,TOS,35718,15302,20416,18279,17439,ITI,ITI1,9,Toscana,Toscana,3729641,1366832,36.65,0.96
2042,2021-02-24,TOS,10372,4467,5905,10171,201,ITI,ITI1,9,Toscana,Toscana,3729641,1377204,36.93,0.28
2043,2021-03-03,TOS,18192,6509,11683,14586,3606,ITI,ITI1,9,Toscana,Toscana,3729641,1395396,37.41,0.49
2044,2021-01-05,TOS,5249,1755,3494,5249,0,ITI,ITI1,9,Toscana,Toscana,3729641,1400645,37.55,0.14
2045,2021-01-12,TOS,3581,1398,2183,3581,0,ITI,ITI1,9,Toscana,Toscana,3729641,1404226,37.65,0.1
2046,2021-01-19,TOS,1104,531,573,1104,0,ITI,ITI1,9,Toscana,Toscana,3729641,1405330,37.68,0.03
2047,2021-01-08,TOS,5946,1642,4304,5946,0,ITI,ITI1,9,Toscana,Toscana,3729641,1411276,37.84,0.16
2048,2021-04-20,TOS,18156,8111,10045,12599,5557,ITI,ITI1,9,Toscana,Toscana,3729641,1429432,38.33,0.49
2049,2021-03-15,TOS,8356,3331,5025,3914,4442,ITI,ITI1,9,Toscana,Toscana,3729641,1437788,38.55,0.22
2050,2021-01-10,TOS,3001,1104,1897,3001,0,ITI,ITI1,9,Toscana,Toscana,3729641,1440789,38.63,0.08
2051,2021-04-03,TOS,15013,6646,8367,13887,1126,ITI,ITI1,9,Toscana,Toscana,3729641,1455802,39.03,0.4
2052,2021-02-26,TOS,10076,3833,6243,8870,1206,ITI,ITI1,9,Toscana,Toscana,3729641,1465878,39.3,0.27
2053,2021-01-17,TOS,2536,871,1665,2023,513,ITI,ITI1,9,Toscana,Toscana,3729641,1468414,39.37,0.07
2054,2020-12-31,TOS,804,202,602,804,0,ITI,ITI1,9,Toscana,Toscana,3729641,1469218,39.39,0.02
2055,2021-03-11,TOS,15495,5993,9502,12169,3326,ITI,ITI1,9,Toscana,Toscana,3729641,1484713,39.81,0.42
2056,2021-05-20,TOS,29430,13646,15784,18890,10540,ITI,ITI1,9,Toscana,Toscana,3729641,1514143,40.6,0.79
2057,2021-04-01,TOS,26902,11107,15795,16299,10603,ITI,ITI1,9,Toscana,Toscana,3729641,1541045,41.32,0.72
2058,2021-01-27,TOS,4834,1572,3262,206,4628,ITI,ITI1,9,Toscana,Toscana,3729641,1545879,41.45,0.13
2059,2021-03-17,TOS,11421,4586,6835,6893,4528,ITI,ITI1,9,Toscana,Toscana,3729641,1557300,41.75,0.31
2060,2021-01-07,TOS,6018,1751,4267,6018,0,ITI,ITI1,9,Toscana,Toscana,3729641,1563318,41.92,0.16
2061,2021-01-01,TOS,2369,787,1582,2369,0,ITI,ITI1,9,Toscana,Toscana,3729641,1565687,41.98,0.06
2062,2021-03-06,TOS,7094,2838,4256,2901,4193,ITI,ITI1,9,Toscana,Toscana,3729641,1572781,42.17,0.19
2063,2021-01-15,TOS,3878,1347,2531,3878,0,ITI,ITI1,9,Toscana,Toscana,3729641,1576659,42.27,0.1
2064,2021-04-12,TOS,2612,1183,1429,1958,654,ITI,ITI1,9,Toscana,Toscana,3729641,1579271,42.34,0.07
2065,2021-02-21,TOS,5105,2089,3016,4935,170,ITI,ITI1,9,Toscana,Toscana,3729641,1584376,42.48,0.14
2066,2021-02-15,TOS,8770,3375,5395,7945,825,ITI,ITI1,9,Toscana,Toscana,3729641,1593146,42.72,0.24
2067,2021-02-22,TOS,9818,4254,5564,9541,277,ITI,ITI1,9,Toscana,Toscana,3729641,1602964,42.98,0.26
2068,2021-04-24,TOS,13433,6163,7270,5989,7444,ITI,ITI1,9,Toscana,Toscana,3729641,1616397,43.34,0.36
2069,2021-03-12,TOS,16521,6220,10301,12993,3528,ITI,ITI1,9,Toscana,Toscana,3729641,1632918,43.78,0.44
2070,2021-05-01,TOS,23305,10059,13246,14132,9173,ITI,ITI1,9,Toscana,Toscana,3729641,1656223,44.41,0.62
2071,2021-03-20,TOS,6488,2882,3606,5353,1135,ITI,ITI1,9,Toscana,Toscana,3729641,1662711,44.58,0.17
2072,2021-03-29,TOS,9391,4588,4803,9067,324,ITI,ITI1,9,Toscana,Toscana,3729641,1672102,44.83,0.25
2073,2021-02-14,TOS,9000,2569,6431,8890,110,ITI,ITI1,9,Toscana,Toscana,3729641,1681102,45.07,0.24
2074,2021-05-27,TOS,27703,12729,14974,13111,14592,ITI,ITI1,9,Toscana,Toscana,3729641,1708805,45.82,0.74
2075,2021-04-27,TOS,10346,4909,5437,3866,6480,ITI,ITI1,9,Toscana,Toscana,3729641,1719151,46.09,0.28
2076,2021-03-08,TOS,6370,2630,3740,1551,4819,ITI,ITI1,9,Toscana,Toscana,3729641,1725521,46.27,0.17
2077,2021-04-10,TOS,11722,5348,6374,10977,745,ITI,ITI1,9,Toscana,Toscana,3729641,1737243,46.58,0.31
2078,2021-02-19,TOS,8291,2952,5339,7781,510,ITI,ITI1,9,Toscana,Toscana,3729641,1745534,46.8,0.22
2079,2021-05-16,TOS,26658,12879,13779,24199,2459,ITI,ITI1,9,Toscana,Toscana,3729641,1772192,47.52,0.71
2080,2021-03-13,TOS,9275,3301,5974,5312,3963,ITI,ITI1,9,Toscana,Toscana,3729641,1781467,47.77,0.25
2081,2021-05-09,TOS,22512,9758,12754,9653,12859,ITI,ITI1,9,Toscana,Toscana,3729641,1803979,48.37,0.6
2082,2021-02-05,TOS,5749,2245,3504,1924,3825,ITI,ITI1,9,Toscana,Toscana,3729641,1809728,48.52,0.15
2083,2021-05-11,TOS,27935,12978,14957,12478,15457,ITI,ITI1,9,Toscana,Toscana,3729641,1837663,49.27,0.75
2084,2021-01-29,TOS,6144,1700,4444,304,5840,ITI,ITI1,9,Toscana,Toscana,3729641,1843807,49.44,0.16
2085,2021-01-31,TOS,3050,1129,1921,106,2944,ITI,ITI1,9,Toscana,Toscana,3729641,1846857,49.52,0.08
2086,2021-04-05,TOS,15279,6823,8456,14542,737,ITI,ITI1,9,Toscana,Toscana,3729641,1862136,49.93,0.41
2087,2021-05-18,TOS,28630,14097,14533,19976,8654,ITI,ITI1,9,Toscana,Toscana,3729641,1890766,50.7,0.77
2088,2021-02-07,TOS,2806,953,1853,885,1921,ITI,ITI1,9,Toscana,Toscana,3729641,1893572,50.77,0.08
2089,2021-02-03,TOS,4221,1452,2769,241,3980,ITI,ITI1,9,Toscana,Toscana,3729641,1897793,50.88,0.11
2090,2021-03-25,TOS,23613,10124,13489,15275,8338,ITI,ITI1,9,Toscana,Toscana,3729641,1921406,51.52,0.63
2091,2021-05-13,TOS,34800,15291,19509,13720,21080,ITI,ITI1,9,Toscana,Toscana,3729641,1956206,52.45,0.93
2092,2021-04-29,TOS,39338,17710,21628,19234,20104,ITI,ITI1,9,Toscana,Toscana,3729641,1995544,53.5,1.05
2093,2021-03-10,TOS,18013,7073,10940,13996,4017,ITI,ITI1,9,Toscana,Toscana,3729641,2013557,53.99,0.48
2094,2021-03-24,TOS,19655,7973,11682,10199,9456,ITI,ITI1,9,Toscana,Toscana,3729641,2033212,54.51,0.53
2095,2021-03-05,TOS,16492,6336,10156,11751,4741,ITI,ITI1,9,Toscana,Toscana,3729641,2049704,54.96,0.44
2096,2021-02-02,TOS,3742,1475,2267,195,3547,ITI,ITI1,9,Toscana,Toscana,3729641,2053446,55.06,0.1
2097,2021-04-14,VEN,15869,6879,8990,9242,6627,ITH,ITH3,5,Veneto,Veneto,4905854,15869,0.32,0.32
2098,2021-03-28,VEN,31249,13586,17663,27613,3636,ITH,ITH3,5,Veneto,Veneto,4905854,47118,0.96,0.64
2099,2021-03-11,VEN,19705,8773,10932,14124,5581,ITH,ITH3,5,Veneto,Veneto,4905854,66823,1.36,0.4
2100,2021-05-14,VEN,46235,21999,24236,25621,20614,ITH,ITH3,5,Veneto,Veneto,4905854,113058,2.3,0.94
2101,2021-05-17,VEN,26331,12920,13411,16420,9911,ITH,ITH3,5,Veneto,Veneto,4905854,139389,2.84,0.54
2102,2021-02-06,VEN,4095,1354,2741,709,3386,ITH,ITH3,5,Veneto,Veneto,4905854,143484,2.92,0.08
2103,2021-04-11,VEN,21002,8873,12129,14695,6307,ITH,ITH3,5,Veneto,Veneto,4905854,164486,3.35,0.43
2104,2021-01-01,VEN,1528,471,1057,1528,0,ITH,ITH3,5,Veneto,Veneto,4905854,166014,3.38,0.03
2105,2021-04-13,VEN,14020,6319,7701,8532,5488,ITH,ITH3,5,Veneto,Veneto,4905854,180034,3.67,0.29
2106,2021-01-03,VEN,5157,1562,3595,5157,0,ITH,ITH3,5,Veneto,Veneto,4905854,185191,3.77,0.11
2107,2021-03-26,VEN,29541,13117,16424,24074,5467,ITH,ITH3,5,Veneto,Veneto,4905854,214732,4.38,0.6
2108,2021-03-09,VEN,16464,7382,9082,10144,6320,ITH,ITH3,5,Veneto,Veneto,4905854,231196,4.71,0.34
2109,2021-01-04,VEN,6736,2033,4703,6736,0,ITH,ITH3,5,Veneto,Veneto,4905854,237932,4.85,0.14
2110,2021-02-20,VEN,6424,2014,4410,6353,71,ITH,ITH3,5,Veneto,Veneto,4905854,244356,4.98,0.13
2111,2021-04-23,VEN,31146,13797,17349,22445,8701,ITH,ITH3,5,Veneto,Veneto,4905854,275502,5.62,0.63
2112,2021-02-18,VEN,5828,2455,3373,5764,64,ITH,ITH3,5,Veneto,Veneto,4905854,281330,5.73,0.12
2113,2021-04-18,VEN,17518,7255,10263,9946,7572,ITH,ITH3,5,Veneto,Veneto,4905854,298848,6.09,0.36
2114,2021-01-06,VEN,8132,2385,5747,8132,0,ITH,ITH3,5,Veneto,Veneto,4905854,306980,6.26,0.17
2115,2021-05-05,VEN,43864,21043,22821,37353,6511,ITH,ITH3,5,Veneto,Veneto,4905854,350844,7.15,0.89
2116,2021-03-16,VEN,12516,5347,7169,6902,5614,ITH,ITH3,5,Veneto,Veneto,4905854,363360,7.41,0.26
2117,2021-03-23,VEN,22149,10187,11962,17429,4720,ITH,ITH3,5,Veneto,Veneto,4905854,385509,7.86,0.45
2118,2021-05-19,VEN,32214,14787,17427,16573,15641,ITH,ITH3,5,Veneto,Veneto,4905854,417723,8.51,0.66
2119,2021-02-01,VEN,8557,2500,6057,161,8396,ITH,ITH3,5,Veneto,Veneto,4905854,426280,8.69,0.17
2120,2021-04-06,VEN,28870,13271,15599,23796,5074,ITH,ITH3,5,Veneto,Veneto,4905854,455150,9.28,0.59
2121,2021-05-12,VEN,36156,17491,18665,31108,5048,ITH,ITH3,5,Veneto,Veneto,4905854,491306,10.01,0.74
2122,2021-03-30,VEN,35883,15235,20648,30634,5249,ITH,ITH3,5,Veneto,Veneto,4905854,527189,10.75,0.73
2123,2021-02-08,VEN,4976,1541,3435,1929,3047,ITH,ITH3,5,Veneto,Veneto,4905854,532165,10.85,0.1
2124,2021-02-15,VEN,4386,1821,2565,4146,240,ITH,ITH3,5,Veneto,Veneto,4905854,536551,10.94,0.09
2125,2021-02-23,VEN,7375,3250,4125,7105,270,ITH,ITH3,5,Veneto,Veneto,4905854,543926,11.09,0.15
2126,2021-02-04,VEN,7326,2017,5309,553,6773,ITH,ITH3,5,Veneto,Veneto,4905854,551252,11.24,0.15
2127,2021-04-28,VEN,32370,15156,17214,23349,9021,ITH,ITH3,5,Veneto,Veneto,4905854,583622,11.9,0.66
2128,2021-01-18,VEN,2762,776,1986,2563,199,ITH,ITH3,5,Veneto,Veneto,4905854,586384,11.95,0.06
2129,2021-04-30,VEN,49916,23439,26477,34261,15655,ITH,ITH3,5,Veneto,Veneto,4905854,636300,12.97,1.02
2130,2021-01-20,VEN,1038,368,670,386,652,ITH,ITH3,5,Veneto,Veneto,4905854,637338,12.99,0.02
2131,2021-03-25,VEN,25834,10950,14884,19714,6120,ITH,ITH3,5,Veneto,Veneto,4905854,663172,13.52,0.53
2132,2021-01-16,VEN,4611,1542,3069,4611,0,ITH,ITH3,5,Veneto,Veneto,4905854,667783,13.61,0.09
2133,2021-03-14,VEN,15165,5934,9231,14271,894,ITH,ITH3,5,Veneto,Veneto,4905854,682948,13.92,0.31
2134,2021-05-10,VEN,36323,16981,19342,26494,9829,ITH,ITH3,5,Veneto,Veneto,4905854,719271,14.66,0.74
2135,2021-03-07,VEN,4475,1756,2719,3914,561,ITH,ITH3,5,Veneto,Veneto,4905854,723746,14.75,0.09
2136,2021-05-03,VEN,40566,19755,20811,34146,6420,ITH,ITH3,5,Veneto,Veneto,4905854,764312,15.58,0.83
2137,2021-01-23,VEN,4050,1246,2804,31,4019,ITH,ITH3,5,Veneto,Veneto,4905854,768362,15.66,0.08
2138,2021-03-21,VEN,11983,4754,7229,8521,3462,ITH,ITH3,5,Veneto,Veneto,4905854,780345,15.91,0.24
2139,2021-01-30,VEN,8747,2672,6075,693,8054,ITH,ITH3,5,Veneto,Veneto,4905854,789092,16.08,0.18
2140,2021-05-22,VEN,34588,16599,17989,13267,21321,ITH,ITH3,5,Veneto,Veneto,4905854,823680,16.79,0.71
2141,2021-01-28,VEN,9209,2662,6547,173,9036,ITH,ITH3,5,Veneto,Veneto,4905854,832889,16.98,0.19
2142,2021-04-02,VEN,23974,10549,13425,17643,6331,ITH,ITH3,5,Veneto,Veneto,4905854,856863,17.47,0.49
2143,2021-01-11,VEN,7238,2101,5137,7238,0,ITH,ITH3,5,Veneto,Veneto,4905854,864101,17.61,0.15
2144,2021-03-02,VEN,11483,4622,6861,8175,3308,ITH,ITH3,5,Veneto,Veneto,4905854,875584,17.85,0.23
2145,2021-05-26,VEN,29315,14298,15017,13470,15845,ITH,ITH3,5,Veneto,Veneto,4905854,904899,18.45,0.6
2146,2021-05-02,VEN,37175,17235,19940,26851,10324,ITH,ITH3,5,Veneto,Veneto,4905854,942074,19.2,0.76
2147,2021-03-06,VEN,10633,4320,6313,7365,3268,ITH,ITH3,5,Veneto,Veneto,4905854,952707,19.42,0.22
2148,2021-04-21,VEN,32306,13173,19133,16239,16067,ITH,ITH3,5,Veneto,Veneto,4905854,985013,20.08,0.66
2149,2021-02-11,VEN,4013,1238,2775,3385,628,ITH,ITH3,5,Veneto,Veneto,4905854,989026,20.16,0.08
2150,2021-01-25,VEN,6468,2075,4393,159,6309,ITH,ITH3,5,Veneto,Veneto,4905854,995494,20.29,0.13
2151,2021-04-20,VEN,22405,9486,12919,8406,13999,ITH,ITH3,5,Veneto,Veneto,4905854,1017899,20.75,0.46
2152,2021-02-16,VEN,6639,2870,3769,6462,177,ITH,ITH3,5,Veneto,Veneto,4905854,1024538,20.88,0.14
2153,2021-04-16,VEN,24417,10479,13938,12534,11883,ITH,ITH3,5,Veneto,Veneto,4905854,1048955,21.38,0.5
2154,2021-01-13,VEN,5985,1606,4379,5985,0,ITH,ITH3,5,Veneto,Veneto,4905854,1054940,21.5,0.12
2155,2021-01-08,VEN,9403,2835,6568,9403,0,ITH,ITH3,5,Veneto,Veneto,4905854,1064343,21.7,0.19
2156,2021-04-25,VEN,18310,8146,10164,13477,4833,ITH,ITH3,5,Veneto,Veneto,4905854,1082653,22.07,0.37
2157,2021-02-25,VEN,7899,3339,4560,7294,605,ITH,ITH3,5,Veneto,Veneto,4905854,1090552,22.23,0.16
2158,2021-04-09,VEN,31096,13692,17404,22759,8337,ITH,ITH3,5,Veneto,Veneto,4905854,1121648,22.86,0.63
2159,2020-12-30,VEN,699,245,454,699,0,ITH,ITH3,5,Veneto,Veneto,4905854,1122347,22.88,0.01
2160,2021-03-04,VEN,12919,4828,8091,9448,3471,ITH,ITH3,5,Veneto,Veneto,4905854,1135266,23.14,0.26
2161,2021-05-07,VEN,47965,23004,24961,39373,8592,ITH,ITH3,5,Veneto,Veneto,4905854,1183231,24.12,0.98
2162,2021-03-18,VEN,12608,5136,7472,7382,5226,ITH,ITH3,5,Veneto,Veneto,4905854,1195839,24.38,0.26
2163,2021-01-27,VEN,7138,2062,5076,241,6897,ITH,ITH3,5,Veneto,Veneto,4905854,1202977,24.52,0.15
2164,2021-05-28,VEN,43280,21320,21960,24298,18982,ITH,ITH3,5,Veneto,Veneto,4905854,1246257,25.4,0.88
2165,2021-05-21,VEN,44298,21737,22561,20810,23488,ITH,ITH3,5,Veneto,Veneto,4905854,1290555,26.31,0.9
2166,2021-01-15,VEN,5874,1819,4055,5874,0,ITH,ITH3,5,Veneto,Veneto,4905854,1296429,26.43,0.12
2167,2021-03-15,VEN,16598,7263,9335,11381,5217,ITH,ITH3,5,Veneto,Veneto,4905854,1313027,26.76,0.34
2168,2021-05-18,VEN,26575,12390,14185,13204,13371,ITH,ITH3,5,Veneto,Veneto,4905854,1339602,27.31,0.54
2169,2021-03-24,VEN,22020,9504,12516,15212,6808,ITH,ITH3,5,Veneto,Veneto,4905854,1361622,27.76,0.45
2170,2021-02-09,VEN,5246,1889,3357,3446,1800,ITH,ITH3,5,Veneto,Veneto,4905854,1366868,27.86,0.11
2171,2021-05-27,VEN,44984,22112,22872,22710,22274,ITH,ITH3,5,Veneto,Veneto,4905854,1411852,28.78,0.92
2172,2021-02-03,VEN,5938,1664,4274,480,5458,ITH,ITH3,5,Veneto,Veneto,4905854,1417790,28.9,0.12
2173,2021-05-16,VEN,28397,14002,14395,21319,7078,ITH,ITH3,5,Veneto,Veneto,4905854,1446187,29.48,0.58
2174,2021-01-17,VEN,1933,781,1152,1584,349,ITH,ITH3,5,Veneto,Veneto,4905854,1448120,29.52,0.04
2175,2021-04-29,VEN,50223,23361,26862,37026,13197,ITH,ITH3,5,Veneto,Veneto,4905854,1498343,30.54,1.02
2176,2020-12-31,VEN,3219,1042,2177,3219,0,ITH,ITH3,5,Veneto,Veneto,4905854,1501562,30.61,0.07
2177,2021-04-12,VEN,14902,6335,8567,6684,8218,ITH,ITH3,5,Veneto,Veneto,4905854,1516464,30.91,0.3
2178,2021-04-27,VEN,28097,12745,15352,21179,6918,ITH,ITH3,5,Veneto,Veneto,4905854,1544561,31.48,0.57
2179,2021-02-22,VEN,7013,3040,3973,6626,387,ITH,ITH3,5,Veneto,Veneto,4905854,1551574,31.63,0.14
2180,2021-02-05,VEN,8371,2534,5837,1413,6958,ITH,ITH3,5,Veneto,Veneto,4905854,1559945,31.8,0.17
2181,2021-01-19,VEN,1309,472,837,1159,150,ITH,ITH3,5,Veneto,Veneto,4905854,1561254,31.82,0.03
2182,2021-05-01,VEN,38714,18180,20534,29813,8901,ITH,ITH3,5,Veneto,Veneto,4905854,1599968,32.61,0.79
2183,2021-01-02,VEN,5743,1766,3977,5743,0,ITH,ITH3,5,Veneto,Veneto,4905854,1605711,32.73,0.12
2184,2021-01-09,VEN,7927,2539,5388,7927,0,ITH,ITH3,5,Veneto,Veneto,4905854,1613638,32.89,0.16
2185,2021-04-04,VEN,7775,3531,4244,6624,1151,ITH,ITH3,5,Veneto,Veneto,4905854,1621413,33.05,0.16
2186,2021-05-24,VEN,32511,16074,16437,7693,24818,ITH,ITH3,5,Veneto,Veneto,4905854,1653924,33.71,0.66
2187,2021-02-13,VEN,3267,1474,1793,3247,20,ITH,ITH3,5,Veneto,Veneto,4905854,1657191,33.78,0.07
2188,2021-04-10,VEN,27444,11971,15473,18963,8481,ITH,ITH3,5,Veneto,Veneto,4905854,1684635,34.34,0.56
2189,2021-02-26,VEN,8292,3270,5022,7036,1256,ITH,ITH3,5,Veneto,Veneto,4905854,1692927,34.51,0.17
2190,2021-01-14,VEN,7062,1924,5138,7062,0,ITH,ITH3,5,Veneto,Veneto,4905854,1699989,34.65,0.14
2191,2021-03-12,VEN,18571,8124,10447,11825,6746,ITH,ITH3,5,Veneto,Veneto,4905854,1718560,35.03,0.38
2192,2021-01-07,VEN,8358,2318,6040,8358,0,ITH,ITH3,5,Veneto,Veneto,4905854,1726918,35.2,0.17
2193,2021-04-26,VEN,20704,9447,11257,15560,5144,ITH,ITH3,5,Veneto,Veneto,4905854,1747622,35.62,0.42
2194,2021-03-10,VEN,18937,8638,10299,13254,5683,ITH,ITH3,5,Veneto,Veneto,4905854,1766559,36.01,0.39
2195,2021-05-15,VEN,36009,17412,18597,26099,9910,ITH,ITH3,5,Veneto,Veneto,4905854,1802568,36.74,0.73
2196,2021-05-09,VEN,34913,16050,18863,24858,10055,ITH,ITH3,5,Veneto,Veneto,4905854,1837481,37.45,0.71
2197,2021-03-20,VEN,12943,5340,7603,10848,2095,ITH,ITH3,5,Veneto,Veneto,4905854,1850424,37.72,0.26
2198,2021-01-10,VEN,5032,1671,3361,5032,0,ITH,ITH3,5,Veneto,Veneto,4905854,1855456,37.82,0.1
2199,2021-05-23,VEN,34395,16425,17970,11076,23319,ITH,ITH3,5,Veneto,Veneto,4905854,1889851,38.52,0.7
2200,2021-03-19,VEN,13790,5668,8122,7697,6093,ITH,ITH3,5,Veneto,Veneto,4905854,1903641,38.8,0.28
2201,2021-02-27,VEN,8987,2691,6296,8140,847,ITH,ITH3,5,Veneto,Veneto,4905854,1912628,38.99,0.18
2202,2021-01-22,VEN,1080,332,748,25,1055,ITH,ITH3,5,Veneto,Veneto,4905854,1913708,39.01,0.02
2203,2021-05-04,VEN,42754,20248,22506,34767,7987,ITH,ITH3,5,Veneto,Veneto,4905854,1956462,39.88,0.87
2204,2021-05-11,VEN,32851,16389,16462,28176,4675,ITH,ITH3,5,Veneto,Veneto,4905854,1989313,40.55,0.67
2205,2021-01-24,VEN,4117,1219,2898,28,4089,ITH,ITH3,5,Veneto,Veneto,4905854,1993430,40.63,0.08
2206,2021-01-31,VEN,4769,1562,3207,392,4377,ITH,ITH3,5,Veneto,Veneto,4905854,1998199,40.73,0.1
2207,2021-03-29,VEN,31393,13631,17762,27559,3834,ITH,ITH3,5,Veneto,Veneto,4905854,2029592,41.37,0.64
2208,2021-03-08,VEN,13549,6195,7354,9480,4069,ITH,ITH3,5,Veneto,Veneto,4905854,2043141,41.65,0.28
2209,2021-03-27,VEN,32049,13988,18061,26243,5806,ITH,ITH3,5,Veneto,Veneto,4905854,2075190,42.3,0.65
2210,2021-02-19,VEN,7322,3140,4182,7118,204,ITH,ITH3,5,Veneto,Veneto,4905854,2082512,42.45,0.15
2211,2021-02-21,VEN,4633,1209,3424,4628,5,ITH,ITH3,5,Veneto,Veneto,4905854,2087145,42.54,0.09
2212,2021-02-17,VEN,6022,2772,3250,5928,94,ITH,ITH3,5,Veneto,Veneto,4905854,2093167,42.67,0.12
2213,2021-04-01,VEN,25186,11048,14138,18786,6400,ITH,ITH3,5,Veneto,Veneto,4905854,2118353,43.18,0.51
2214,2021-04-15,VEN,20823,8595,12228,10017,10806,ITH,ITH3,5,Veneto,Veneto,4905854,2139176,43.6,0.42
2215,2021-02-10,VEN,4751,1588,3163,3697,1054,ITH,ITH3,5,Veneto,Veneto,4905854,2143927,43.7,0.1
2216,2021-04-08,VEN,32311,14344,17967,24438,7873,ITH,ITH3,5,Veneto,Veneto,4905854,2176238,44.36,0.66
2217,2021-01-05,VEN,7329,2182,5147,7329,0,ITH,ITH3,5,Veneto,Veneto,4905854,2183567,44.51,0.15
2218,2021-02-24,VEN,8614,3678,4936,8128,486,ITH,ITH3,5,Veneto,Veneto,4905854,2192181,44.69,0.18
2219,2021-03-03,VEN,12044,4597,7447,8546,3498,ITH,ITH3,5,Veneto,Veneto,4905854,2204225,44.93,0.25
2220,2021-04-22,VEN,31888,13881,18007,16142,15746,ITH,ITH3,5,Veneto,Veneto,4905854,2236113,45.58,0.65
2221,2021-03-17,VEN,14643,5991,8652,7849,6794,ITH,ITH3,5,Veneto,Veneto,4905854,2250756,45.88,0.3
2222,2021-01-12,VEN,5230,1516,3714,5230,0,ITH,ITH3,5,Veneto,Veneto,4905854,2255986,45.99,0.11
2223,2021-05-06,VEN,46462,21795,24667,38047,8415,ITH,ITH3,5,Veneto,Veneto,4905854,2302448,46.93,0.95
2224,2020-12-27,VEN,880,395,485,880,0,ITH,ITH3,5,Veneto,Veneto,4905854,2303328,46.95,0.02
2225,2021-04-24,VEN,24731,10819,13912,15653,9078,ITH,ITH3,5,Veneto,Veneto,4905854,2328059,47.45,0.5
2226,2021-04-17,VEN,22404,9079,13325,15122,7282,ITH,ITH3,5,Veneto,Veneto,4905854,2350463,47.91,0.46
2227,2021-03-05,VEN,13286,4978,8308,9625,3661,ITH,ITH3,5,Veneto,Veneto,4905854,2363749,48.18,0.27
2228,2021-01-21,VEN,2292,719,1573,21,2271,ITH,ITH3,5,Veneto,Veneto,4905854,2366041,48.23,0.05
2229,2021-03-13,VEN,17177,7258,9919,14044,3133,ITH,ITH3,5,Veneto,Veneto,4905854,2383218,48.58,0.35
2230,2021-03-22,VEN,18089,8133,9956,13046,5043,ITH,ITH3,5,Veneto,Veneto,4905854,2401307,48.95,0.37
2231,2021-05-20,VEN,44181,20990,23191,20077,24104,ITH,ITH3,5,Veneto,Veneto,4905854,2445488,49.85,0.9
2232,2021-02-07,VEN,2315,862,1453,714,1601,ITH,ITH3,5,Veneto,Veneto,4905854,2447803,49.9,0.05
2233,2021-03-01,VEN,9393,3715,5678,7572,1821,ITH,ITH3,5,Veneto,Veneto,4905854,2457196,50.09,0.19
2234,2021-01-29,VEN,9019,2788,6231,368,8651,ITH,ITH3,5,Veneto,Veneto,4905854,2466215,50.27,0.18
2235,2021-04-03,VEN,21907,9612,12295,14191,7716,ITH,ITH3,5,Veneto,Veneto,4905854,2488122,50.72,0.45
2236,2021-02-12,VEN,4314,1447,2867,3742,572,ITH,ITH3,5,Veneto,Veneto,4905854,2492436,50.81,0.09
2237,2021-05-08,VEN,41108,18610,22498,29331,11777,ITH,ITH3,5,Veneto,Veneto,4905854,2533544,51.64,0.84
2238,2021-05-13,VEN,43751,21608,22143,33909,9842,ITH,ITH3,5,Veneto,Veneto,4905854,2577295,52.54,0.89
2239,2021-04-07,VEN,35865,16096,19769,28534,7331,ITH,ITH3,5,Veneto,Veneto,4905854,2613160,53.27,0.73
2240,2021-02-02,VEN,6508,1878,4630,396,6112,ITH,ITH3,5,Veneto,Veneto,4905854,2619668,53.4,0.13
2241,2021-03-31,VEN,38584,16225,22359,31091,7493,ITH,ITH3,5,Veneto,Veneto,4905854,2658252,54.19,0.79
2242,2021-05-25,VEN,26892,12880,14012,11434,15458,ITH,ITH3,5,Veneto,Veneto,4905854,2685144,54.73,0.55
2243,2021-04-05,VEN,19137,8367,10770,13697,5440,ITH,ITH3,5,Veneto,Veneto,4905854,2704281,55.12,0.39
2244,2021-02-14,VEN,125,56,69,112,13,ITH,ITH3,5,Veneto,Veneto,4905854,2704406,55.13,0.0
2245,2021-02-28,VEN,4136,1389,2747,3299,837,ITH,ITH3,5,Veneto,Veneto,4905854,2708542,55.21,0.08
2246,2021-04-19,VEN,21527,8917,12610,5117,16410,ITH,ITH3,5,Veneto,Veneto,4905854,2730069,55.65,0.44
2247,2021-01-26,VEN,6917,2091,4826,152,6765,ITH,ITH3,5,Veneto,Veneto,4905854,2736986,55.79,0.14
2248,2021-01-23,SAR,60,22,38,0,60,ITG,ITG2,20,Sardegna,Sardegna,1639591,60,0.0,0.0
2249,2021-03-28,SAR,4619,1814,2805,4540,79,ITG,ITG2,20,Sardegna,Sardegna,1639591,4679,0.29,0.28
2250,2021-03-11,SAR,6036,2726,3310,4835,1201,ITG,ITG2,20,Sardegna,Sardegna,1639591,10715,0.65,0.37
2251,2021-01-06,SAR,1615,549,1066,1615,0,ITG,ITG2,20,Sardegna,Sardegna,1639591,12330,0.75,0.1
2252,2021-02-22,SAR,1639,949,690,1411,228,ITG,ITG2,20,Sardegna,Sardegna,1639591,13969,0.85,0.1
2253,2021-02-23,SAR,1519,1010,509,1285,234,ITG,ITG2,20,Sardegna,Sardegna,1639591,15488,0.94,0.09
2254,2021-05-19,SAR,14822,7270,7552,11358,3464,ITG,ITG2,20,Sardegna,Sardegna,1639591,30310,1.85,0.9
2255,2021-02-08,SAR,1470,533,937,856,614,ITG,ITG2,20,Sardegna,Sardegna,1639591,31780,1.94,0.09
2256,2021-04-15,SAR,11815,5523,6292,6861,4954,ITG,ITG2,20,Sardegna,Sardegna,1639591,43595,2.66,0.72
2257,2021-01-04,SAR,592,217,375,592,0,ITG,ITG2,20,Sardegna,Sardegna,1639591,44187,2.7,0.04
2258,2021-04-16,SAR,14441,6488,7953,9098,5343,ITG,ITG2,20,Sardegna,Sardegna,1639591,58628,3.58,0.88
2259,2021-03-30,SAR,8641,3462,5179,6367,2274,ITG,ITG2,20,Sardegna,Sardegna,1639591,67269,4.1,0.53
2260,2021-03-13,SAR,2754,1075,1679,2473,281,ITG,ITG2,20,Sardegna,Sardegna,1639591,70023,4.27,0.17
2261,2021-02-13,SAR,1456,565,891,1454,2,ITG,ITG2,20,Sardegna,Sardegna,1639591,71479,4.36,0.09
2262,2021-02-18,SAR,1878,732,1146,1814,64,ITG,ITG2,20,Sardegna,Sardegna,1639591,73357,4.47,0.11
2263,2021-04-18,SAR,5155,2239,2916,2287,2868,ITG,ITG2,20,Sardegna,Sardegna,1639591,78512,4.79,0.31
2264,2021-05-14,SAR,13743,6288,7455,10630,3113,ITG,ITG2,20,Sardegna,Sardegna,1639591,92255,5.63,0.84
2265,2021-01-27,SAR,1409,494,915,79,1330,ITG,ITG2,20,Sardegna,Sardegna,1639591,93664,5.71,0.09
2266,2021-04-01,SAR,10101,4026,6075,7088,3013,ITG,ITG2,20,Sardegna,Sardegna,1639591,103765,6.33,0.62
2267,2021-01-16,SAR,1492,525,967,1492,0,ITG,ITG2,20,Sardegna,Sardegna,1639591,105257,6.42,0.09
2268,2021-05-07,SAR,14185,6479,7706,9624,4561,ITG,ITG2,20,Sardegna,Sardegna,1639591,119442,7.28,0.87
2269,2021-03-18,SAR,7255,3070,4185,5652,1603,ITG,ITG2,20,Sardegna,Sardegna,1639591,126697,7.73,0.44
2270,2021-03-25,SAR,8795,3704,5091,7490,1305,ITG,ITG2,20,Sardegna,Sardegna,1639591,135492,8.26,0.54
2271,2021-05-21,SAR,20397,9943,10454,14949,5448,ITG,ITG2,20,Sardegna,Sardegna,1639591,155889,9.51,1.24
2272,2021-02-03,SAR,1119,419,700,426,693,ITG,ITG2,20,Sardegna,Sardegna,1639591,157008,9.58,0.07
2273,2021-03-14,SAR,607,376,231,607,0,ITG,ITG2,20,Sardegna,Sardegna,1639591,157615,9.61,0.04
2274,2021-05-17,SAR,12091,5665,6426,9202,2889,ITG,ITG2,20,Sardegna,Sardegna,1639591,169706,10.35,0.74
2275,2021-02-25,SAR,2899,1255,1644,2294,605,ITG,ITG2,20,Sardegna,Sardegna,1639591,172605,10.53,0.18
2276,2021-04-30,SAR,11086,5274,5812,6877,4209,ITG,ITG2,20,Sardegna,Sardegna,1639591,183691,11.2,0.68
2277,2021-02-06,SAR,1970,697,1273,569,1401,ITG,ITG2,20,Sardegna,Sardegna,1639591,185661,11.32,0.12
2278,2021-01-20,SAR,210,77,133,208,2,ITG,ITG2,20,Sardegna,Sardegna,1639591,185871,11.34,0.01
2279,2021-05-02,SAR,5883,2669,3214,5302,581,ITG,ITG2,20,Sardegna,Sardegna,1639591,191754,11.7,0.36
2280,2021-03-02,SAR,2865,1459,1406,1712,1153,ITG,ITG2,20,Sardegna,Sardegna,1639591,194619,11.87,0.17
2281,2021-04-28,SAR,9009,4270,4739,5312,3697,ITG,ITG2,20,Sardegna,Sardegna,1639591,203628,12.42,0.55
2282,2021-04-21,SAR,12069,5555,6514,6537,5532,ITG,ITG2,20,Sardegna,Sardegna,1639591,215697,13.16,0.74
2283,2021-03-09,SAR,5645,2629,3016,4916,729,ITG,ITG2,20,Sardegna,Sardegna,1639591,221342,13.5,0.34
2284,2021-05-05,SAR,10053,4598,5455,8045,2008,ITG,ITG2,20,Sardegna,Sardegna,1639591,231395,14.11,0.61
2285,2021-01-18,SAR,904,326,578,780,124,ITG,ITG2,20,Sardegna,Sardegna,1639591,232299,14.17,0.06
2286,2021-03-16,SAR,4374,1949,2425,3452,922,ITG,ITG2,20,Sardegna,Sardegna,1639591,236673,14.43,0.27
2287,2021-01-11,SAR,1183,505,678,1183,0,ITG,ITG2,20,Sardegna,Sardegna,1639591,237856,14.51,0.07
2288,2021-01-25,SAR,588,212,376,22,566,ITG,ITG2,20,Sardegna,Sardegna,1639591,238444,14.54,0.04
2289,2021-05-10,SAR,9732,4336,5396,7195,2537,ITG,ITG2,20,Sardegna,Sardegna,1639591,248176,15.14,0.59
2290,2021-04-23,SAR,12837,5730,7107,7376,5461,ITG,ITG2,20,Sardegna,Sardegna,1639591,261013,15.92,0.78
2291,2021-03-21,SAR,4030,1809,2221,2590,1440,ITG,ITG2,20,Sardegna,Sardegna,1639591,265043,16.17,0.25
2292,2021-01-30,SAR,3863,1392,2471,362,3501,ITG,ITG2,20,Sardegna,Sardegna,1639591,268906,16.4,0.24
2293,2021-03-04,SAR,4002,1953,2049,2747,1255,ITG,ITG2,20,Sardegna,Sardegna,1639591,272908,16.64,0.24
2294,2021-01-13,SAR,573,178,395,573,0,ITG,ITG2,20,Sardegna,Sardegna,1639591,273481,16.68,0.03
2295,2021-05-28,SAR,16822,8025,8797,13065,3757,ITG,ITG2,20,Sardegna,Sardegna,1639591,290303,17.71,1.03
2296,2021-02-11,SAR,1315,490,825,1204,111,ITG,ITG2,20,Sardegna,Sardegna,1639591,291618,17.79,0.08
2297,2021-05-24,SAR,13582,6502,7080,8419,5163,ITG,ITG2,20,Sardegna,Sardegna,1639591,305200,18.61,0.83
2298,2021-02-20,SAR,2041,855,1186,1707,334,ITG,ITG2,20,Sardegna,Sardegna,1639591,307241,18.74,0.12
2299,2021-01-08,SAR,3258,1184,2074,3258,0,ITG,ITG2,20,Sardegna,Sardegna,1639591,310499,18.94,0.2
2300,2021-04-20,SAR,10939,4969,5970,7725,3214,ITG,ITG2,20,Sardegna,Sardegna,1639591,321438,19.6,0.67
2301,2021-04-09,SAR,12261,5436,6825,7909,4352,ITG,ITG2,20,Sardegna,Sardegna,1639591,333699,20.35,0.75
2302,2021-02-04,SAR,2271,816,1455,916,1355,ITG,ITG2,20,Sardegna,Sardegna,1639591,335970,20.49,0.14
2303,2021-04-02,SAR,8987,3547,5440,5745,3242,ITG,ITG2,20,Sardegna,Sardegna,1639591,344957,21.04,0.55
2304,2021-04-11,SAR,5393,2442,2951,4273,1120,ITG,ITG2,20,Sardegna,Sardegna,1639591,350350,21.37,0.33
2305,2021-04-04,SAR,1,0,1,0,1,ITG,ITG2,20,Sardegna,Sardegna,1639591,350351,21.37,0.0
2306,2021-01-01,SAR,32,17,15,32,0,ITG,ITG2,20,Sardegna,Sardegna,1639591,350383,21.37,0.0
2307,2021-02-27,SAR,1921,647,1274,1366,555,ITG,ITG2,20,Sardegna,Sardegna,1639591,352304,21.49,0.12
2308,2021-04-25,SAR,4495,2269,2226,3716,779,ITG,ITG2,20,Sardegna,Sardegna,1639591,356799,21.76,0.27
2309,2021-03-06,SAR,2639,1079,1560,858,1781,ITG,ITG2,20,Sardegna,Sardegna,1639591,359438,21.92,0.16
2310,2021-01-15,SAR,1563,573,990,1563,0,ITG,ITG2,20,Sardegna,Sardegna,1639591,361001,22.02,0.1
2311,2021-05-09,SAR,6125,2873,3252,5195,930,ITG,ITG2,20,Sardegna,Sardegna,1639591,367126,22.39,0.37
2312,2021-05-16,SAR,8176,3812,4364,6016,2160,ITG,ITG2,20,Sardegna,Sardegna,1639591,375302,22.89,0.5
2313,2021-01-10,SAR,2183,750,1433,2183,0,ITG,ITG2,20,Sardegna,Sardegna,1639591,377485,23.02,0.13
2314,2021-04-27,SAR,7605,3547,4058,5564,2041,ITG,ITG2,20,Sardegna,Sardegna,1639591,385090,23.49,0.46
2315,2021-03-15,SAR,2688,1219,1469,2315,373,ITG,ITG2,20,Sardegna,Sardegna,1639591,387778,23.65,0.16
2316,2021-01-19,SAR,747,270,477,692,55,ITG,ITG2,20,Sardegna,Sardegna,1639591,388525,23.7,0.05
2317,2021-03-24,SAR,7286,2998,4288,5927,1359,ITG,ITG2,20,Sardegna,Sardegna,1639591,395811,24.14,0.44
2318,2021-05-22,SAR,24241,11598,12643,19294,4947,ITG,ITG2,20,Sardegna,Sardegna,1639591,420052,25.62,1.48
2319,2021-02-24,SAR,2412,1293,1119,2223,189,ITG,ITG2,20,Sardegna,Sardegna,1639591,422464,25.77,0.15
2320,2021-02-07,SAR,1116,394,722,228,888,ITG,ITG2,20,Sardegna,Sardegna,1639591,423580,25.83,0.07
2321,2021-05-20,SAR,15214,7250,7964,10901,4313,ITG,ITG2,20,Sardegna,Sardegna,1639591,438794,26.76,0.93
2322,2021-01-21,SAR,126,60,66,94,32,ITG,ITG2,20,Sardegna,Sardegna,1639591,438920,26.77,0.01
2323,2021-05-03,SAR,8176,3815,4361,6580,1596,ITG,ITG2,20,Sardegna,Sardegna,1639591,447096,27.27,0.5
2324,2021-05-18,SAR,13615,6570,7045,9280,4335,ITG,ITG2,20,Sardegna,Sardegna,1639591,460711,28.1,0.83
2325,2021-05-01,SAR,9899,4758,5141,5444,4455,ITG,ITG2,20,Sardegna,Sardegna,1639591,470610,28.7,0.6
2326,2021-02-26,SAR,2800,1108,1692,2494,306,ITG,ITG2,20,Sardegna,Sardegna,1639591,473410,28.87,0.17
2327,2021-04-14,SAR,8250,3902,4348,7013,1237,ITG,ITG2,20,Sardegna,Sardegna,1639591,481660,29.38,0.5
2328,2021-02-09,SAR,2287,837,1450,1290,997,ITG,ITG2,20,Sardegna,Sardegna,1639591,483947,29.52,0.14
2329,2020-12-28,SAR,65,25,40,65,0,ITG,ITG2,20,Sardegna,Sardegna,1639591,484012,29.52,0.0
2330,2021-03-23,SAR,6156,2639,3517,5078,1078,ITG,ITG2,20,Sardegna,Sardegna,1639591,490168,29.9,0.38
2331,2021-05-12,SAR,10716,5011,5705,7637,3079,ITG,ITG2,20,Sardegna,Sardegna,1639591,500884,30.55,0.65
2332,2021-04-06,SAR,7446,3113,4333,5018,2428,ITG,ITG2,20,Sardegna,Sardegna,1639591,508330,31.0,0.45
2333,2021-02-01,SAR,1524,605,919,225,1299,ITG,ITG2,20,Sardegna,Sardegna,1639591,509854,31.1,0.09
2334,2021-05-26,SAR,14203,7060,7143,9743,4460,ITG,ITG2,20,Sardegna,Sardegna,1639591,524057,31.96,0.87
2335,2020-12-27,SAR,65,34,31,65,0,ITG,ITG2,20,Sardegna,Sardegna,1639591,524122,31.97,0.0
2336,2021-02-15,SAR,958,349,609,927,31,ITG,ITG2,20,Sardegna,Sardegna,1639591,525080,32.03,0.06
2337,2021-02-10,SAR,1959,765,1194,1441,518,ITG,ITG2,20,Sardegna,Sardegna,1639591,527039,32.14,0.12
2338,2021-04-19,SAR,10179,4615,5564,8760,1419,ITG,ITG2,20,Sardegna,Sardegna,1639591,537218,32.77,0.62
2339,2021-01-02,SAR,60,21,39,60,0,ITG,ITG2,20,Sardegna,Sardegna,1639591,537278,32.77,0.0
2340,2021-04-26,SAR,6820,3263,3557,5945,875,ITG,ITG2,20,Sardegna,Sardegna,1639591,544098,33.18,0.42
2341,2021-02-21,SAR,1589,710,879,1559,30,ITG,ITG2,20,Sardegna,Sardegna,1639591,545687,33.28,0.1
2342,2021-03-07,SAR,1657,750,907,1117,540,ITG,ITG2,20,Sardegna,Sardegna,1639591,547344,33.38,0.1
2343,2021-01-22,SAR,83,47,36,55,28,ITG,ITG2,20,Sardegna,Sardegna,1639591,547427,33.39,0.01
2344,2021-04-17,SAR,10049,4486,5563,5452,4597,ITG,ITG2,20,Sardegna,Sardegna,1639591,557476,34.0,0.61
2345,2021-02-17,SAR,1407,577,830,1333,74,ITG,ITG2,20,Sardegna,Sardegna,1639591,558883,34.09,0.09
2346,2020-12-29,SAR,57,32,25,57,0,ITG,ITG2,20,Sardegna,Sardegna,1639591,558940,34.09,0.0
2347,2021-04-22,SAR,10463,4632,5831,5545,4918,ITG,ITG2,20,Sardegna,Sardegna,1639591,569403,34.73,0.64
2348,2021-03-03,SAR,3858,2072,1786,2610,1248,ITG,ITG2,20,Sardegna,Sardegna,1639591,573261,34.96,0.24
2349,2021-01-31,SAR,2121,750,1371,48,2073,ITG,ITG2,20,Sardegna,Sardegna,1639591,575382,35.09,0.13
2350,2021-02-14,SAR,539,263,276,537,2,ITG,ITG2,20,Sardegna,Sardegna,1639591,575921,35.13,0.03
2351,2021-04-05,SAR,2036,784,1252,2035,1,ITG,ITG2,20,Sardegna,Sardegna,1639591,577957,35.25,0.12
2352,2021-04-13,SAR,7603,3592,4011,5778,1825,ITG,ITG2,20,Sardegna,Sardegna,1639591,585560,35.71,0.46
2353,2021-03-08,SAR,4008,1790,2218,2788,1220,ITG,ITG2,20,Sardegna,Sardegna,1639591,589568,35.96,0.24
2354,2021-05-04,SAR,9533,4385,5148,7681,1852,ITG,ITG2,20,Sardegna,Sardegna,1639591,599101,36.54,0.58
2355,2021-03-01,SAR,2162,1055,1107,1503,659,ITG,ITG2,20,Sardegna,Sardegna,1639591,601263,36.67,0.13
2356,2021-01-24,SAR,90,34,56,5,85,ITG,ITG2,20,Sardegna,Sardegna,1639591,601353,36.68,0.01
2357,2021-03-10,SAR,6011,2918,3093,5161,850,ITG,ITG2,20,Sardegna,Sardegna,1639591,607364,37.04,0.37
2358,2021-05-06,SAR,12795,5926,6869,9653,3142,ITG,ITG2,20,Sardegna,Sardegna,1639591,620159,37.82,0.78
2359,2021-05-13,SAR,11330,5233,6097,8357,2973,ITG,ITG2,20,Sardegna,Sardegna,1639591,631489,38.52,0.69
2360,2021-01-26,SAR,1336,453,883,27,1309,ITG,ITG2,20,Sardegna,Sardegna,1639591,632825,38.6,0.08
2361,2021-02-02,SAR,1482,655,827,241,1241,ITG,ITG2,20,Sardegna,Sardegna,1639591,634307,38.69,0.09
2362,2021-01-03,SAR,90,36,54,90,0,ITG,ITG2,20,Sardegna,Sardegna,1639591,634397,38.69,0.01
2363,2021-03-29,SAR,4425,1559,2866,3837,588,ITG,ITG2,20,Sardegna,Sardegna,1639591,638822,38.96,0.27
2364,2021-01-05,SAR,1327,446,881,1327,0,ITG,ITG2,20,Sardegna,Sardegna,1639591,640149,39.04,0.08
2365,2021-03-31,SAR,10154,4050,6104,7707,2447,ITG,ITG2,20,Sardegna,Sardegna,1639591,650303,39.66,0.62
2366,2021-02-05,SAR,1897,749,1148,433,1464,ITG,ITG2,20,Sardegna,Sardegna,1639591,652200,39.78,0.12
2367,2021-04-03,SAR,4662,1801,2861,2695,1967,ITG,ITG2,20,Sardegna,Sardegna,1639591,656862,40.06,0.28
2368,2021-03-27,SAR,5717,2177,3540,5295,422,ITG,ITG2,20,Sardegna,Sardegna,1639591,662579,40.41,0.35
2369,2021-05-23,SAR,9942,4796,5146,7719,2223,ITG,ITG2,20,Sardegna,Sardegna,1639591,672521,41.02,0.61
2370,2021-02-19,SAR,1499,473,1026,1443,56,ITG,ITG2,20,Sardegna,Sardegna,1639591,674020,41.11,0.09
2371,2021-02-12,SAR,2237,933,1304,2178,59,ITG,ITG2,20,Sardegna,Sardegna,1639591,676257,41.25,0.14
2372,2021-04-10,SAR,10489,4748,5741,8554,1935,ITG,ITG2,20,Sardegna,Sardegna,1639591,686746,41.89,0.64
2373,2021-01-07,SAR,3112,1077,2035,3112,0,ITG,ITG2,20,Sardegna,Sardegna,1639591,689858,42.08,0.19
2374,2020-12-31,SAR,32,16,16,32,0,ITG,ITG2,20,Sardegna,Sardegna,1639591,689890,42.08,0.0
2375,2021-03-20,SAR,5193,2073,3120,2916,2277,ITG,ITG2,20,Sardegna,Sardegna,1639591,695083,42.39,0.32
2376,2021-01-29,SAR,2953,1068,1885,48,2905,ITG,ITG2,20,Sardegna,Sardegna,1639591,698036,42.57,0.18
2377,2021-03-05,SAR,5036,2445,2591,2682,2354,ITG,ITG2,20,Sardegna,Sardegna,1639591,703072,42.88,0.31
2378,2021-04-24,SAR,10367,4851,5516,8028,2339,ITG,ITG2,20,Sardegna,Sardegna,1639591,713439,43.51,0.63
2379,2021-01-28,SAR,2970,1045,1925,69,2901,ITG,ITG2,20,Sardegna,Sardegna,1639591,716409,43.69,0.18
2380,2021-03-19,SAR,7269,3049,4220,5054,2215,ITG,ITG2,20,Sardegna,Sardegna,1639591,723678,44.14,0.44
2381,2021-04-12,SAR,6990,3179,3811,5276,1714,ITG,ITG2,20,Sardegna,Sardegna,1639591,730668,44.56,0.43
2382,2021-02-28,SAR,368,169,199,142,226,ITG,ITG2,20,Sardegna,Sardegna,1639591,731036,44.59,0.02
2383,2021-01-09,SAR,4026,1417,2609,4026,0,ITG,ITG2,20,Sardegna,Sardegna,1639591,735062,44.83,0.25
2384,2021-01-17,SAR,860,277,583,859,1,ITG,ITG2,20,Sardegna,Sardegna,1639591,735922,44.88,0.05
2385,2021-04-29,SAR,11104,5104,6000,6750,4354,ITG,ITG2,20,Sardegna,Sardegna,1639591,747026,45.56,0.68
2386,2021-03-17,SAR,6556,2849,3707,4949,1607,ITG,ITG2,20,Sardegna,Sardegna,1639591,753582,45.96,0.4
2387,2021-03-26,SAR,8091,3180,4911,6566,1525,ITG,ITG2,20,Sardegna,Sardegna,1639591,761673,46.46,0.49
2388,2021-04-08,SAR,13426,5924,7502,8307,5119,ITG,ITG2,20,Sardegna,Sardegna,1639591,775099,47.27,0.82
2389,2021-05-11,SAR,8648,3989,4659,6317,2331,ITG,ITG2,20,Sardegna,Sardegna,1639591,783747,47.8,0.53
2390,2021-05-25,SAR,13539,6615,6924,8252,5287,ITG,ITG2,20,Sardegna,Sardegna,1639591,797286,48.63,0.83
2391,2021-03-22,SAR,3550,1363,2187,3037,513,ITG,ITG2,20,Sardegna,Sardegna,1639591,800836,48.84,0.22
2392,2021-01-12,SAR,865,408,457,865,0,ITG,ITG2,20,Sardegna,Sardegna,1639591,801701,48.9,0.05
2393,2021-05-08,SAR,13003,5932,7071,10738,2265,ITG,ITG2,20,Sardegna,Sardegna,1639591,814704,49.69,0.79
2394,2021-05-15,SAR,13687,6385,7302,10260,3427,ITG,ITG2,20,Sardegna,Sardegna,1639591,828391,50.52,0.83
2395,2021-05-27,SAR,15840,7980,7860,11186,4654,ITG,ITG2,20,Sardegna,Sardegna,1639591,844231,51.49,0.97
2396,2021-02-16,SAR,700,289,411,673,27,ITG,ITG2,20,Sardegna,Sardegna,1639591,844931,51.53,0.04
2397,2021-03-12,SAR,6699,2796,3903,5342,1357,ITG,ITG2,20,Sardegna,Sardegna,1639591,851630,51.94,0.41
2398,2021-01-14,SAR,1105,426,679,1105,0,ITG,ITG2,20,Sardegna,Sardegna,1639591,852735,52.01,0.07
2399,2021-04-07,SAR,13476,5985,7491,7828,5648,ITG,ITG2,20,Sardegna,Sardegna,1639591,866211,52.83,0.82
2400,2021-02-18,UMB,1496,582,914,1030,466,ITI,ITI2,10,Umbria,Umbria,882015,1496,0.17,0.17
2401,2021-05-14,UMB,5237,2435,2802,3432,1805,ITI,ITI2,10,Umbria,Umbria,882015,6733,0.76,0.59
2402,2021-02-01,UMB,1285,342,943,48,1237,ITI,ITI2,10,Umbria,Umbria,882015,8018,0.91,0.15
2403,2021-04-27,UMB,5664,2403,3261,3088,2576,ITI,ITI2,10,Umbria,Umbria,882015,13682,1.55,0.64
2404,2021-01-18,UMB,614,219,395,529,85,ITI,ITI2,10,Umbria,Umbria,882015,14296,1.62,0.07
2405,2021-03-25,UMB,3904,1699,2205,2840,1064,ITI,ITI2,10,Umbria,Umbria,882015,18200,2.06,0.44
2406,2021-03-08,UMB,3672,1801,1871,2309,1363,ITI,ITI2,10,Umbria,Umbria,882015,21872,2.48,0.42
2407,2021-03-09,UMB,4051,1971,2080,2760,1291,ITI,ITI2,10,Umbria,Umbria,882015,25923,2.94,0.46
2408,2021-02-20,UMB,282,100,182,258,24,ITI,ITI2,10,Umbria,Umbria,882015,26205,2.97,0.03
2409,2021-02-03,UMB,725,174,551,67,658,ITI,ITI2,10,Umbria,Umbria,882015,26930,3.05,0.08
2410,2021-05-16,UMB,5317,2534,2783,5265,52,ITI,ITI2,10,Umbria,Umbria,882015,32247,3.66,0.6
2411,2021-03-28,UMB,1096,442,654,1072,24,ITI,ITI2,10,Umbria,Umbria,882015,33343,3.78,0.12
2412,2021-04-06,UMB,5290,2169,3121,2901,2389,ITI,ITI2,10,Umbria,Umbria,882015,38633,4.38,0.6
2413,2021-02-22,UMB,1859,778,1081,1773,86,ITI,ITI2,10,Umbria,Umbria,882015,40492,4.59,0.21
2414,2021-04-23,UMB,6607,2786,3821,3488,3119,ITI,ITI2,10,Umbria,Umbria,882015,47099,5.34,0.75
2415,2021-03-11,UMB,3565,1697,1868,2559,1006,ITI,ITI2,10,Umbria,Umbria,882015,50664,5.74,0.4
2416,2021-01-06,UMB,846,325,521,846,0,ITI,ITI2,10,Umbria,Umbria,882015,51510,5.84,0.1
2417,2021-01-20,UMB,613,222,391,613,0,ITI,ITI2,10,Umbria,Umbria,882015,52123,5.91,0.07
2418,2021-02-25,UMB,1336,497,839,1284,52,ITI,ITI2,10,Umbria,Umbria,882015,53459,6.06,0.15
2419,2021-04-16,UMB,8100,3742,4358,6263,1837,ITI,ITI2,10,Umbria,Umbria,882015,61559,6.98,0.92
2420,2021-04-30,UMB,6232,2962,3270,2843,3389,ITI,ITI2,10,Umbria,Umbria,882015,67791,7.69,0.71
2421,2021-01-13,UMB,450,139,311,450,0,ITI,ITI2,10,Umbria,Umbria,882015,68241,7.74,0.05
2422,2021-03-04,UMB,4485,1853,2632,3657,828,ITI,ITI2,10,Umbria,Umbria,882015,72726,8.25,0.51
2423,2021-05-11,UMB,6222,2826,3396,4023,2199,ITI,ITI2,10,Umbria,Umbria,882015,78948,8.95,0.71
2424,2021-01-01,UMB,274,105,169,274,0,ITI,ITI2,10,Umbria,Umbria,882015,79222,8.98,0.03
2425,2021-04-11,UMB,3102,1503,1599,3053,49,ITI,ITI2,10,Umbria,Umbria,882015,82324,9.33,0.35
2426,2021-03-27,UMB,4253,1512,2741,3913,340,ITI,ITI2,10,Umbria,Umbria,882015,86577,9.82,0.48
2427,2021-01-27,UMB,840,330,510,13,827,ITI,ITI2,10,Umbria,Umbria,882015,87417,9.91,0.1
2428,2021-04-01,UMB,4374,1836,2538,2366,2008,ITI,ITI2,10,Umbria,Umbria,882015,91791,10.41,0.5
2429,2021-01-10,UMB,1070,277,793,1070,0,ITI,ITI2,10,Umbria,Umbria,882015,92861,10.53,0.12
2430,2021-03-15,UMB,4596,1930,2666,2828,1768,ITI,ITI2,10,Umbria,Umbria,882015,97457,11.05,0.52
2431,2021-02-10,UMB,715,349,366,700,15,ITI,ITI2,10,Umbria,Umbria,882015,98172,11.13,0.08
2432,2021-05-19,UMB,9383,4196,5187,5647,3736,ITI,ITI2,10,Umbria,Umbria,882015,107555,12.19,1.06
2433,2021-03-23,UMB,3797,1685,2112,2168,1629,ITI,ITI2,10,Umbria,Umbria,882015,111352,12.62,0.43
2434,2021-02-08,UMB,637,203,434,88,549,ITI,ITI2,10,Umbria,Umbria,882015,111989,12.7,0.07
2435,2021-05-26,UMB,9578,4531,5047,8359,1219,ITI,ITI2,10,Umbria,Umbria,882015,121567,13.78,1.09
2436,2021-05-28,UMB,9360,4307,5053,7198,2162,ITI,ITI2,10,Umbria,Umbria,882015,130927,14.84,1.06
2437,2021-04-13,UMB,7676,3398,4278,6007,1669,ITI,ITI2,10,Umbria,Umbria,882015,138603,15.71,0.87
2438,2021-02-15,UMB,1368,692,676,1367,1,ITI,ITI2,10,Umbria,Umbria,882015,139971,15.87,0.16
2439,2021-04-15,UMB,7628,3483,4145,5742,1886,ITI,ITI2,10,Umbria,Umbria,882015,147599,16.73,0.86
2440,2021-02-17,UMB,1618,748,870,1267,351,ITI,ITI2,10,Umbria,Umbria,882015,149217,16.92,0.18
2441,2021-01-03,UMB,270,112,158,270,0,ITI,ITI2,10,Umbria,Umbria,882015,149487,16.95,0.03
2442,2021-05-07,UMB,10097,4692,5405,6898,3199,ITI,ITI2,10,Umbria,Umbria,882015,159584,18.09,1.14
2443,2021-03-18,UMB,2942,1164,1778,1704,1238,ITI,ITI2,10,Umbria,Umbria,882015,162526,18.43,0.33
2444,2021-04-20,UMB,5439,2356,3083,3492,1947,ITI,ITI2,10,Umbria,Umbria,882015,167965,19.04,0.62
2445,2021-05-21,UMB,8918,3635,5283,4115,4803,ITI,ITI2,10,Umbria,Umbria,882015,176883,20.05,1.01
2446,2021-05-04,UMB,5531,2543,2988,2410,3121,ITI,ITI2,10,Umbria,Umbria,882015,182414,20.68,0.63
2447,2021-03-01,UMB,1503,774,729,1389,114,ITI,ITI2,10,Umbria,Umbria,882015,183917,20.85,0.17
2448,2021-01-30,UMB,1590,490,1100,44,1546,ITI,ITI2,10,Umbria,Umbria,882015,185507,21.03,0.18
2449,2021-05-12,UMB,6440,3004,3436,4300,2140,ITI,ITI2,10,Umbria,Umbria,882015,191947,21.76,0.73
2450,2021-03-30,UMB,3948,1705,2243,2416,1532,ITI,ITI2,10,Umbria,Umbria,882015,195895,22.21,0.45
2451,2020-12-27,UMB,86,45,41,86,0,ITI,ITI2,10,Umbria,Umbria,882015,195981,22.22,0.01
2452,2021-04-08,UMB,5832,2465,3367,4037,1795,ITI,ITI2,10,Umbria,Umbria,882015,201813,22.88,0.66
2453,2021-02-06,UMB,396,138,258,34,362,ITI,ITI2,10,Umbria,Umbria,882015,202209,22.93,0.04
2454,2021-05-24,UMB,9015,4480,4535,8169,846,ITI,ITI2,10,Umbria,Umbria,882015,211224,23.95,1.02
2455,2021-04-04,UMB,59,20,39,23,36,ITI,ITI2,10,Umbria,Umbria,882015,211283,23.95,0.01
2456,2021-02-13,UMB,115,28,87,112,3,ITI,ITI2,10,Umbria,Umbria,882015,211398,23.97,0.01
2457,2021-04-18,UMB,1530,680,850,600,930,ITI,ITI2,10,Umbria,Umbria,882015,212928,24.14,0.17
2458,2021-02-27,UMB,1658,354,1304,1642,16,ITI,ITI2,10,Umbria,Umbria,882015,214586,24.33,0.19
2459,2021-01-08,UMB,1190,345,845,1190,0,ITI,ITI2,10,Umbria,Umbria,882015,215776,24.46,0.13
2460,2021-04-03,UMB,2111,716,1395,1058,1053,ITI,ITI2,10,Umbria,Umbria,882015,217887,24.7,0.24
2461,2021-05-23,UMB,5068,1855,3213,652,4416,ITI,ITI2,10,Umbria,Umbria,882015,222955,25.28,0.57
2462,2021-04-25,UMB,4364,1685,2679,4282,82,ITI,ITI2,10,Umbria,Umbria,882015,227319,25.77,0.49
2463,2021-03-06,UMB,4267,1110,3157,4124,143,ITI,ITI2,10,Umbria,Umbria,882015,231586,26.26,0.48
2464,2021-05-02,UMB,3787,1868,1919,1333,2454,ITI,ITI2,10,Umbria,Umbria,882015,235373,26.69,0.43
2465,2021-03-13,UMB,1731,524,1207,1486,245,ITI,ITI2,10,Umbria,Umbria,882015,237104,26.88,0.2
2466,2021-01-15,UMB,701,215,486,701,0,ITI,ITI2,10,Umbria,Umbria,882015,237805,26.96,0.08
2467,2021-05-09,UMB,5764,2757,3007,5373,391,ITI,ITI2,10,Umbria,Umbria,882015,243569,27.62,0.65
2468,2021-01-22,UMB,276,105,171,32,244,ITI,ITI2,10,Umbria,Umbria,882015,243845,27.65,0.03
2469,2021-03-20,UMB,2298,833,1465,2273,25,ITI,ITI2,10,Umbria,Umbria,882015,246143,27.91,0.26
2470,2021-01-29,UMB,1232,348,884,79,1153,ITI,ITI2,10,Umbria,Umbria,882015,247375,28.05,0.14
2471,2021-03-03,UMB,4438,1773,2665,3727,711,ITI,ITI2,10,Umbria,Umbria,882015,251813,28.55,0.5
2472,2021-05-01,UMB,5373,2640,2733,2146,3227,ITI,ITI2,10,Umbria,Umbria,882015,257186,29.16,0.61
2473,2021-01-28,UMB,1247,394,853,19,1228,ITI,ITI2,10,Umbria,Umbria,882015,258433,29.3,0.14
2474,2021-05-10,UMB,5982,2799,3183,3830,2152,ITI,ITI2,10,Umbria,Umbria,882015,264415,29.98,0.68
2475,2021-01-23,UMB,280,100,180,2,278,ITI,ITI2,10,Umbria,Umbria,882015,264695,30.01,0.03
2476,2021-04-29,UMB,5209,2245,2964,2883,2326,ITI,ITI2,10,Umbria,Umbria,882015,269904,30.6,0.59
2477,2021-01-17,UMB,54,17,37,54,0,ITI,ITI2,10,Umbria,Umbria,882015,269958,30.61,0.01
2478,2021-04-12,UMB,7086,3076,4010,5369,1717,ITI,ITI2,10,Umbria,Umbria,882015,277044,31.41,0.8
2479,2020-12-31,UMB,322,127,195,322,0,ITI,ITI2,10,Umbria,Umbria,882015,277366,31.45,0.04
2480,2021-03-26,UMB,4570,1682,2888,4398,172,ITI,ITI2,10,Umbria,Umbria,882015,281936,31.96,0.52
2481,2021-02-05,UMB,780,234,546,18,762,ITI,ITI2,10,Umbria,Umbria,882015,282716,32.05,0.09
2482,2021-04-10,UMB,7467,3512,3955,7332,135,ITI,ITI2,10,Umbria,Umbria,882015,290183,32.9,0.85
2483,2021-01-19,UMB,103,23,80,103,0,ITI,ITI2,10,Umbria,Umbria,882015,290286,32.91,0.01
2484,2021-03-24,UMB,4073,1760,2313,2750,1323,ITI,ITI2,10,Umbria,Umbria,882015,294359,33.37,0.46
2485,2021-01-02,UMB,304,111,193,304,0,ITI,ITI2,10,Umbria,Umbria,882015,294663,33.41,0.03
2486,2021-03-07,UMB,845,180,665,838,7,ITI,ITI2,10,Umbria,Umbria,882015,295508,33.5,0.1
2487,2021-01-11,UMB,1315,346,969,1315,0,ITI,ITI2,10,Umbria,Umbria,882015,296823,33.65,0.15
2488,2021-05-05,UMB,7173,3284,3889,3877,3296,ITI,ITI2,10,Umbria,Umbria,882015,303996,34.47,0.81
2489,2021-03-16,UMB,3538,1454,2084,1911,1627,ITI,ITI2,10,Umbria,Umbria,882015,307534,34.87,0.4
2490,2021-01-25,UMB,648,323,325,5,643,ITI,ITI2,10,Umbria,Umbria,882015,308182,34.94,0.07
2491,2021-03-29,UMB,3844,1692,2152,2365,1479,ITI,ITI2,10,Umbria,Umbria,882015,312026,35.38,0.44
2492,2021-01-31,UMB,1058,276,782,25,1033,ITI,ITI2,10,Umbria,Umbria,882015,313084,35.5,0.12
2493,2021-05-18,UMB,7708,3336,4372,3870,3838,ITI,ITI2,10,Umbria,Umbria,882015,320792,36.37,0.87
2494,2021-04-05,UMB,4250,1728,2522,2195,2055,ITI,ITI2,10,Umbria,Umbria,882015,325042,36.85,0.48
2495,2021-05-20,UMB,9820,4581,5239,6183,3637,ITI,ITI2,10,Umbria,Umbria,882015,334862,37.97,1.11
2496,2021-03-31,UMB,3903,1733,2170,2216,1687,ITI,ITI2,10,Umbria,Umbria,882015,338765,38.41,0.44
2497,2021-02-16,UMB,1308,655,653,1299,9,ITI,ITI2,10,Umbria,Umbria,882015,340073,38.56,0.15
2498,2021-05-27,UMB,9856,4778,5078,8625,1231,ITI,ITI2,10,Umbria,Umbria,882015,349929,39.67,1.12
2499,2021-04-14,UMB,8147,3673,4474,6168,1979,ITI,ITI2,10,Umbria,Umbria,882015,358076,40.6,0.92
2500,2021-04-07,UMB,5568,2289,3279,3562,2006,ITI,ITI2,10,Umbria,Umbria,882015,363644,41.23,0.63
2501,2021-01-04,UMB,810,398,412,810,0,ITI,ITI2,10,Umbria,Umbria,882015,364454,41.32,0.09
2502,2021-02-23,UMB,1693,658,1035,1651,42,ITI,ITI2,10,Umbria,Umbria,882015,366147,41.51,0.19
2503,2021-02-19,UMB,743,293,450,526,217,ITI,ITI2,10,Umbria,Umbria,882015,366890,41.6,0.08
2504,2021-04-26,UMB,5374,2328,3046,3122,2252,ITI,ITI2,10,Umbria,Umbria,882015,372264,42.21,0.61
2505,2021-05-15,UMB,4975,1872,3103,1810,3165,ITI,ITI2,10,Umbria,Umbria,882015,377239,42.77,0.56
2506,2021-01-16,UMB,221,73,148,221,0,ITI,ITI2,10,Umbria,Umbria,882015,377460,42.8,0.03
2507,2021-04-09,UMB,6791,3162,3629,6572,219,ITI,ITI2,10,Umbria,Umbria,882015,384251,43.57,0.77
2508,2021-01-24,UMB,258,106,152,1,257,ITI,ITI2,10,Umbria,Umbria,882015,384509,43.59,0.03
2509,2021-05-22,UMB,6909,2712,4197,2640,4269,ITI,ITI2,10,Umbria,Umbria,882015,391418,44.38,0.78
2510,2021-04-19,UMB,5015,2216,2799,2966,2049,ITI,ITI2,10,Umbria,Umbria,882015,396433,44.95,0.57
2511,2021-04-22,UMB,5427,2230,3197,2766,2661,ITI,ITI2,10,Umbria,Umbria,882015,401860,45.56,0.62
2512,2021-01-05,UMB,854,429,425,854,0,ITI,ITI2,10,Umbria,Umbria,882015,402714,45.66,0.1
2513,2021-01-12,UMB,838,248,590,838,0,ITI,ITI2,10,Umbria,Umbria,882015,403552,45.75,0.1
2514,2021-03-10,UMB,4013,1927,2086,2757,1256,ITI,ITI2,10,Umbria,Umbria,882015,407565,46.21,0.45
2515,2021-05-13,UMB,5896,2655,3241,3823,2073,ITI,ITI2,10,Umbria,Umbria,882015,413461,46.88,0.67
2516,2021-02-02,UMB,944,274,670,32,912,ITI,ITI2,10,Umbria,Umbria,882015,414405,46.98,0.11
2517,2021-04-28,UMB,5346,2317,3029,2964,2382,ITI,ITI2,10,Umbria,Umbria,882015,419751,47.59,0.61
2518,2021-02-12,UMB,671,224,447,665,6,ITI,ITI2,10,Umbria,Umbria,882015,420422,47.67,0.08
2519,2021-01-07,UMB,1300,387,913,1300,0,ITI,ITI2,10,Umbria,Umbria,882015,421722,47.81,0.15
2520,2021-02-26,UMB,660,253,407,652,8,ITI,ITI2,10,Umbria,Umbria,882015,422382,47.89,0.07
2521,2021-05-25,UMB,8753,4258,4495,7735,1018,ITI,ITI2,10,Umbria,Umbria,882015,431135,48.88,0.99
2522,2021-03-22,UMB,3559,1654,1905,2313,1246,ITI,ITI2,10,Umbria,Umbria,882015,434694,49.28,0.4
2523,2021-02-07,UMB,54,17,37,1,53,ITI,ITI2,10,Umbria,Umbria,882015,434748,49.29,0.01
2524,2021-02-24,UMB,1520,565,955,1505,15,ITI,ITI2,10,Umbria,Umbria,882015,436268,49.46,0.17
2525,2021-03-05,UMB,4592,1379,3213,3936,656,ITI,ITI2,10,Umbria,Umbria,882015,440860,49.98,0.52
2526,2021-05-08,UMB,8099,3729,4370,4904,3195,ITI,ITI2,10,Umbria,Umbria,882015,448959,50.9,0.92
2527,2021-05-03,UMB,5091,2271,2820,2204,2887,ITI,ITI2,10,Umbria,Umbria,882015,454050,51.48,0.58
2528,2021-01-21,UMB,610,202,408,341,269,ITI,ITI2,10,Umbria,Umbria,882015,454660,51.55,0.07
2529,2021-02-11,UMB,842,349,493,837,5,ITI,ITI2,10,Umbria,Umbria,882015,455502,51.64,0.1
2530,2021-01-09,UMB,1745,499,1246,1745,0,ITI,ITI2,10,Umbria,Umbria,882015,457247,51.84,0.2
2531,2021-04-17,UMB,6664,3058,3606,5324,1340,ITI,ITI2,10,Umbria,Umbria,882015,463911,52.6,0.76
2532,2021-04-24,UMB,4562,1963,2599,3384,1178,ITI,ITI2,10,Umbria,Umbria,882015,468473,53.11,0.52
2533,2021-03-12,UMB,2653,1040,1613,2157,496,ITI,ITI2,10,Umbria,Umbria,882015,471126,53.41,0.3
2534,2021-01-14,UMB,752,201,551,752,0,ITI,ITI2,10,Umbria,Umbria,882015,471878,53.5,0.09
2535,2021-03-19,UMB,1743,565,1178,1087,656,ITI,ITI2,10,Umbria,Umbria,882015,473621,53.7,0.2
2536,2021-03-14,UMB,66,48,18,66,0,ITI,ITI2,10,Umbria,Umbria,882015,473687,53.71,0.01
2537,2021-03-21,UMB,665,330,335,665,0,ITI,ITI2,10,Umbria,Umbria,882015,474352,53.78,0.08
2538,2021-05-17,UMB,6359,3057,3302,4186,2173,ITI,ITI2,10,Umbria,Umbria,882015,480711,54.5,0.72
2539,2021-05-06,UMB,9451,4309,5142,6145,3306,ITI,ITI2,10,Umbria,Umbria,882015,490162,55.57,1.07
2540,2021-03-17,UMB,3331,1313,2018,1859,1472,ITI,ITI2,10,Umbria,Umbria,882015,493493,55.95,0.38
2541,2021-01-26,UMB,816,390,426,18,798,ITI,ITI2,10,Umbria,Umbria,882015,494309,56.04,0.09
2542,2021-04-21,UMB,5310,2308,3002,3084,2226,ITI,ITI2,10,Umbria,Umbria,882015,499619,56.65,0.6
2543,2021-03-02,UMB,3642,1346,2296,3638,4,ITI,ITI2,10,Umbria,Umbria,882015,503261,57.06,0.41
2544,2021-02-04,UMB,733,226,507,25,708,ITI,ITI2,10,Umbria,Umbria,882015,503994,57.14,0.08
2545,2021-04-02,UMB,4278,1716,2562,3521,757,ITI,ITI2,10,Umbria,Umbria,882015,508272,57.63,0.49
2546,2021-03-03,PAB,1179,393,786,1166,13,ITH,ITH1,4,Provincia Autonoma Bolzano / Bozen,P.A. Bolzano,533050,1179,0.22,0.22
2547,2021-05-27,PAB,6002,3153,2849,3998,2004,ITH,ITH1,4,Provincia Autonoma Bolzano / Bozen,P.A. Bolzano,533050,7181,1.35,1.13
2548,2021-02-14,PAB,297,130,167,297,0,ITH,ITH1,4,Provincia Autonoma Bolzano / Bozen,P.A. Bolzano,533050,7478,1.4,0.06
2549,2021-01-28,PAB,871,308,563,10,861,ITH,ITH1,4,Provincia Autonoma Bolzano / Bozen,P.A. Bolzano,533050,8349,1.57,0.16
2550,2021-05-10,PAB,3018,1300,1718,1413,1605,ITH,ITH1,4,Provincia Autonoma Bolzano / Bozen,P.A. Bolzano,533050,11367,2.13,0.57
2551,2021-01-12,PAB,1709,459,1250,1709,0,ITH,ITH1,4,Provincia Autonoma Bolzano / Bozen,P.A. Bolzano,533050,13076,2.45,0.32
2552,2021-04-07,PAB,1777,802,975,1238,539,ITH,ITH1,4,Provincia Autonoma Bolzano / Bozen,P.A. Bolzano,533050,14853,2.79,0.33
2553,2021-03-02,PAB,695,200,495,693,2,ITH,ITH1,4,Provincia Autonoma Bolzano / Bozen,P.A. Bolzano,533050,15548,2.92,0.13
2554,2021-03-04,PAB,1711,1001,710,1482,229,ITH,ITH1,4,Provincia Autonoma Bolzano / Bozen,P.A. Bolzano,533050,17259,3.24,0.32
2555,2021-03-22,PAB,1133,514,619,1129,4,ITH,ITH1,4,Provincia Autonoma Bolzano / Bozen,P.A. Bolzano,533050,18392,3.45,0.21
2556,2021-05-25,PAB,3808,1967,1841,2935,873,ITH,ITH1,4,Provincia Autonoma Bolzano / Bozen,P.A. Bolzano,533050,22200,4.16,0.71
2557,2021-03-05,PAB,1839,625,1214,1397,442,ITH,ITH1,4,Provincia Autonoma Bolzano / Bozen,P.A. Bolzano,533050,24039,4.51,0.34
2558,2021-05-08,PAB,4416,2379,2037,3758,658,ITH,ITH1,4,Provincia Autonoma Bolzano / Bozen,P.A. Bolzano,533050,28455,5.34,0.83
2559,2021-02-16,PAB,530,205,325,530,0,ITH,ITH1,4,Provincia Autonoma Bolzano / Bozen,P.A. Bolzano,533050,28985,5.44,0.1
2560,2021-04-10,PAB,5390,2664,2726,4802,588,ITH,ITH1,4,Provincia Autonoma Bolzano / Bozen,P.A. Bolzano,533050,34375,6.45,1.01
2561,2021-04-19,PAB,1871,858,1013,1689,182,ITH,ITH1,4,Provincia Autonoma Bolzano / Bozen,P.A. Bolzano,533050,36246,6.8,0.35
2562,2021-01-07,PAB,917,327,590,917,0,ITH,ITH1,4,Provincia Autonoma Bolzano / Bozen,P.A. Bolzano,533050,37163,6.97,0.17
2563,2021-03-07,PAB,114,13,101,9,105,ITH,ITH1,4,Provincia Autonoma Bolzano / Bozen,P.A. Bolzano,533050,37277,6.99,0.02
2564,2021-01-02,PAB,91,48,43,91,0,ITH,ITH1,4,Provincia Autonoma Bolzano / Bozen,P.A. Bolzano,533050,37368,7.01,0.02
2565,2021-01-24,PAB,12,10,2,0,12,ITH,ITH1,4,Provincia Autonoma Bolzano / Bozen,P.A. Bolzano,533050,37380,7.01,0.0
2566,2021-05-15,PAB,6995,3683,3312,6700,295,ITH,ITH1,4,Provincia Autonoma Bolzano / Bozen,P.A. Bolzano,533050,44375,8.32,1.31
2567,2021-05-22,PAB,6821,3552,3269,4654,2167,ITH,ITH1,4,Provincia Autonoma Bolzano / Bozen,P.A. Bolzano,533050,51196,9.6,1.28
2568,2021-04-02,PAB,2077,837,1240,720,1357,ITH,ITH1,4,Provincia Autonoma Bolzano / Bozen,P.A. Bolzano,533050,53273,9.99,0.39
2569,2021-03-26,PAB,1644,721,923,511,1133,ITH,ITH1,4,Provincia Autonoma Bolzano / Bozen,P.A. Bolzano,533050,54917,10.3,0.31
2570,2021-02-04,PAB,1958,593,1365,8,1950,ITH,ITH1,4,Provincia Autonoma Bolzano / Bozen,P.A. Bolzano,533050,56875,10.67,0.37
2571,2021-04-09,PAB,2926,1292,1634,2196,730,ITH,ITH1,4,Provincia Autonoma Bolzano / Bozen,P.A. Bolzano,533050,59801,11.22,0.55
2572,2021-02-11,PAB,1093,431,662,239,854,ITH,ITH1,4,Provincia Autonoma Bolzano / Bozen,P.A. Bolzano,533050,60894,11.42,0.21
2573,2021-04-24,PAB,5104,2449,2655,4619,485,ITH,ITH1,4,Provincia Autonoma Bolzano / Bozen,P.A. Bolzano,533050,65998,12.38,0.96
2574,2021-04-05,PAB,301,144,157,23,278,ITH,ITH1,4,Provincia Autonoma Bolzano / Bozen,P.A. Bolzano,533050,66299,12.44,0.06
2575,2021-01-14,PAB,1946,575,1371,1946,0,ITH,ITH1,4,Provincia Autonoma Bolzano / Bozen,P.A. Bolzano,533050,68245,12.8,0.37
2576,2021-03-19,PAB,1906,773,1133,799,1107,ITH,ITH1,4,Provincia Autonoma Bolzano / Bozen,P.A. Bolzano,533050,70151,13.16,0.36
2577,2021-03-21,PAB,768,285,483,14,754,ITH,ITH1,4,Provincia Autonoma Bolzano / Bozen,P.A. Bolzano,533050,70919,13.3,0.14
2578,2021-03-10,PAB,1261,524,737,1118,143,ITH,ITH1,4,Provincia Autonoma Bolzano / Bozen,P.A. Bolzano,533050,72180,13.54,0.24
2579,2021-05-06,PAB,5181,2747,2434,2612,2569,ITH,ITH1,4,Provincia Autonoma Bolzano / Bozen,P.A. Bolzano,533050,77361,14.51,0.97
2580,2021-04-29,PAB,2630,1351,1279,1936,694,ITH,ITH1,4,Provincia Autonoma Bolzano / Bozen,P.A. Bolzano,533050,79991,15.01,0.49
2581,2021-01-26,PAB,810,291,519,1,809,ITH,ITH1,4,Provincia Autonoma Bolzano / Bozen,P.A. Bolzano,533050,80801,15.16,0.15
2582,2021-03-24,PAB,2040,977,1063,2027,13,ITH,ITH1,4,Provincia Autonoma Bolzano / Bozen,P.A. Bolzano,533050,82841,15.54,0.38
2583,2021-03-17,PAB,581,213,368,580,1,ITH,ITH1,4,Provincia Autonoma Bolzano / Bozen,P.A. Bolzano,533050,83422,15.65,0.11
2584,2021-05-13,PAB,2980,1347,1633,1050,1930,ITH,ITH1,4,Provincia Autonoma Bolzano / Bozen,P.A. Bolzano,533050,86402,16.21,0.56
2585,2021-01-19,PAB,853,371,482,723,130,ITH,ITH1,4,Provincia Autonoma Bolzano / Bozen,P.A. Bolzano,533050,87255,16.37,0.16
2586,2021-02-09,PAB,317,126,191,1,316,ITH,ITH1,4,Provincia Autonoma Bolzano / Bozen,P.A. Bolzano,533050,87572,16.43,0.06
2587,2021-02-02,PAB,1745,506,1239,8,1737,ITH,ITH1,4,Provincia Autonoma Bolzano / Bozen,P.A. Bolzano,533050,89317,16.76,0.33
2588,2021-05-18,PAB,3302,1727,1575,2138,1164,ITH,ITH1,4,Provincia Autonoma Bolzano / Bozen,P.A. Bolzano,533050,92619,17.38,0.62
2589,2021-03-29,PAB,1171,499,672,412,759,ITH,ITH1,4,Provincia Autonoma Bolzano / Bozen,P.A. Bolzano,533050,93790,17.59,0.22
2590,2021-05-01,PAB,2104,1067,1037,1944,160,ITH,ITH1,4,Provincia Autonoma Bolzano / Bozen,P.A. Bolzano,533050,95894,17.99,0.39
2591,2021-03-12,PAB,1664,734,930,1251,413,ITH,ITH1,4,Provincia Autonoma Bolzano / Bozen,P.A. Bolzano,533050,97558,18.3,0.31
2592,2021-04-28,PAB,2460,1301,1159,2455,5,ITH,ITH1,4,Provincia Autonoma Bolzano / Bozen,P.A. Bolzano,533050,100018,18.76,0.46
2593,2021-02-07,PAB,2361,1057,1304,14,2347,ITH,ITH1,4,Provincia Autonoma Bolzano / Bozen,P.A. Bolzano,533050,102379,19.21,0.44
2594,2021-01-21,PAB,952,442,510,139,813,ITH,ITH1,4,Provincia Autonoma Bolzano / Bozen,P.A. Bolzano,533050,103331,19.38,0.18
2595,2021-04-30,PAB,3337,1592,1745,1561,1776,ITH,ITH1,4,Provincia Autonoma Bolzano / Bozen,P.A. Bolzano,533050,106668,20.01,0.63
2596,2021-02-12,PAB,730,217,513,482,248,ITH,ITH1,4,Provincia Autonoma Bolzano / Bozen,P.A. Bolzano,533050,107398,20.15,0.14
2597,2021-04-17,PAB,5232,2598,2634,5188,44,ITH,ITH1,4,Provincia Autonoma Bolzano / Bozen,P.A. Bolzano,533050,112630,21.13,0.98
2598,2020-12-31,PAB,912,518,394,912,0,ITH,ITH1,4,Provincia Autonoma Bolzano / Bozen,P.A. Bolzano,533050,113542,21.3,0.17
2599,2021-04-12,PAB,2105,946,1159,2098,7,ITH,ITH1,4,Provincia Autonoma Bolzano / Bozen,P.A. Bolzano,533050,115647,21.7,0.39
2600,2021-01-09,PAB,612,326,286,612,0,ITH,ITH1,4,Provincia Autonoma Bolzano / Bozen,P.A. Bolzano,533050,116259,21.81,0.11
2601,2021-04-21,PAB,3009,1467,1542,2161,848,ITH,ITH1,4,Provincia Autonoma Bolzano / Bozen,P.A. Bolzano,533050,119268,22.37,0.56
2602,2021-02-19,PAB,2252,512,1740,2241,11,ITH,ITH1,4,Provincia Autonoma Bolzano / Bozen,P.A. Bolzano,533050,121520,22.8,0.42
2603,2021-02-26,PAB,1526,551,975,1496,30,ITH,ITH1,4,Provincia Autonoma Bolzano / Bozen,P.A. Bolzano,533050,123046,23.08,0.29
2604,2021-04-26,PAB,1541,771,770,1536,5,ITH,ITH1,4,Provincia Autonoma Bolzano / Bozen,P.A. Bolzano,533050,124587,23.37,0.29
2605,2021-01-16,PAB,2840,1265,1575,2840,0,ITH,ITH1,4,Provincia Autonoma Bolzano / Bozen,P.A. Bolzano,533050,127427,23.91,0.53
2606,2021-05-03,PAB,1829,846,983,417,1412,ITH,ITH1,4,Provincia Autonoma Bolzano / Bozen,P.A. Bolzano,533050,129256,24.25,0.34
2607,2021-01-23,PAB,197,117,80,0,197,ITH,ITH1,4,Provincia Autonoma Bolzano / Bozen,P.A. Bolzano,533050,129453,24.29,0.04
2608,2021-05-17,PAB,3109,1499,1610,2425,684,ITH,ITH1,4,Provincia Autonoma Bolzano / Bozen,P.A. Bolzano,533050,132562,24.87,0.58
2609,2021-03-14,PAB,758,336,422,25,733,ITH,ITH1,4,Provincia Autonoma Bolzano / Bozen,P.A. Bolzano,533050,133320,25.01,0.14
2610,2021-03-16,PAB,1290,532,758,124,1166,ITH,ITH1,4,Provincia Autonoma Bolzano / Bozen,P.A. Bolzano,533050,134610,25.25,0.24
2611,2021-05-14,PAB,5087,2290,2797,3071,2016,ITH,ITH1,4,Provincia Autonoma Bolzano / Bozen,P.A. Bolzano,533050,139697,26.21,0.95
2612,2021-02-01,PAB,1451,440,1011,12,1439,ITH,ITH1,4,Provincia Autonoma Bolzano / Bozen,P.A. Bolzano,533050,141148,26.48,0.27
2613,2021-05-23,PAB,4332,2302,2030,4324,8,ITH,ITH1,4,Provincia Autonoma Bolzano / Bozen,P.A. Bolzano,533050,145480,27.29,0.81
2614,2021-02-10,PAB,1635,604,1031,26,1609,ITH,ITH1,4,Provincia Autonoma Bolzano / Bozen,P.A. Bolzano,533050,147115,27.6,0.31
2615,2021-01-30,PAB,498,245,253,4,494,ITH,ITH1,4,Provincia Autonoma Bolzano / Bozen,P.A. Bolzano,533050,147613,27.69,0.09
2616,2021-04-25,PAB,3069,1496,1573,2398,671,ITH,ITH1,4,Provincia Autonoma Bolzano / Bozen,P.A. Bolzano,533050,150682,28.27,0.58
2617,2021-01-13,PAB,1691,557,1134,1691,0,ITH,ITH1,4,Provincia Autonoma Bolzano / Bozen,P.A. Bolzano,533050,152373,28.59,0.32
2618,2021-04-08,PAB,2754,1336,1418,2551,203,ITH,ITH1,4,Provincia Autonoma Bolzano / Bozen,P.A. Bolzano,533050,155127,29.1,0.52
2619,2020-12-27,PAB,144,65,79,144,0,ITH,ITH1,4,Provincia Autonoma Bolzano / Bozen,P.A. Bolzano,533050,155271,29.13,0.03
2620,2021-04-23,PAB,4540,2149,2391,3249,1291,ITH,ITH1,4,Provincia Autonoma Bolzano / Bozen,P.A. Bolzano,533050,159811,29.98,0.85
2621,2021-01-11,PAB,1569,513,1056,1569,0,ITH,ITH1,4,Provincia Autonoma Bolzano / Bozen,P.A. Bolzano,533050,161380,30.27,0.29
2622,2021-04-06,PAB,2249,1117,1132,2146,103,ITH,ITH1,4,Provincia Autonoma Bolzano / Bozen,P.A. Bolzano,533050,163629,30.7,0.42
2623,2021-03-20,PAB,1757,848,909,1132,625,ITH,ITH1,4,Provincia Autonoma Bolzano / Bozen,P.A. Bolzano,533050,165386,31.03,0.33
2624,2021-01-05,PAB,830,286,544,830,0,ITH,ITH1,4,Provincia Autonoma Bolzano / Bozen,P.A. Bolzano,533050,166216,31.18,0.16
2625,2021-05-20,PAB,4673,2301,2372,3217,1456,ITH,ITH1,4,Provincia Autonoma Bolzano / Bozen,P.A. Bolzano,533050,170889,32.06,0.88
2626,2021-03-31,PAB,1831,693,1138,820,1011,ITH,ITH1,4,Provincia Autonoma Bolzano / Bozen,P.A. Bolzano,533050,172720,32.4,0.34
2627,2021-04-14,PAB,3593,1645,1948,3502,91,ITH,ITH1,4,Provincia Autonoma Bolzano / Bozen,P.A. Bolzano,533050,176313,33.08,0.67
2628,2021-02-23,PAB,769,324,445,763,6,ITH,ITH1,4,Provincia Autonoma Bolzano / Bozen,P.A. Bolzano,533050,177082,33.22,0.14
2629,2021-01-04,PAB,508,201,307,508,0,ITH,ITH1,4,Provincia Autonoma Bolzano / Bozen,P.A. Bolzano,533050,177590,33.32,0.1
2630,2021-02-18,PAB,1839,457,1382,1832,7,ITH,ITH1,4,Provincia Autonoma Bolzano / Bozen,P.A. Bolzano,533050,179429,33.66,0.34
2631,2020-12-30,PAB,388,182,206,388,0,ITH,ITH1,4,Provincia Autonoma Bolzano / Bozen,P.A. Bolzano,533050,179817,33.73,0.07
2632,2021-04-27,PAB,2226,1013,1213,1150,1076,ITH,ITH1,4,Provincia Autonoma Bolzano / Bozen,P.A. Bolzano,533050,182043,34.15,0.42
2633,2021-03-15,PAB,1192,451,741,710,482,ITH,ITH1,4,Provincia Autonoma Bolzano / Bozen,P.A. Bolzano,533050,183235,34.37,0.22
2634,2021-01-10,PAB,2,2,0,2,0,ITH,ITH1,4,Provincia Autonoma Bolzano / Bozen,P.A. Bolzano,533050,183237,34.38,0.0
2635,2021-03-08,PAB,1200,526,674,1173,27,ITH,ITH1,4,Provincia Autonoma Bolzano / Bozen,P.A. Bolzano,533050,184437,34.6,0.23
2636,2021-05-09,PAB,4233,2404,1829,3080,1153,ITH,ITH1,4,Provincia Autonoma Bolzano / Bozen,P.A. Bolzano,533050,188670,35.39,0.79
2637,2021-03-06,PAB,3969,2079,1890,3758,211,ITH,ITH1,4,Provincia Autonoma Bolzano / Bozen,P.A. Bolzano,533050,192639,36.14,0.74
2638,2021-05-11,PAB,2842,1334,1508,1320,1522,ITH,ITH1,4,Provincia Autonoma Bolzano / Bozen,P.A. Bolzano,533050,195481,36.67,0.53
2639,2021-01-29,PAB,1497,510,987,24,1473,ITH,ITH1,4,Provincia Autonoma Bolzano / Bozen,P.A. Bolzano,533050,196978,36.95,0.28
2640,2021-01-06,PAB,59,18,41,59,0,ITH,ITH1,4,Provincia Autonoma Bolzano / Bozen,P.A. Bolzano,533050,197037,36.96,0.01
2641,2021-05-19,PAB,3561,1815,1746,1798,1763,ITH,ITH1,4,Provincia Autonoma Bolzano / Bozen,P.A. Bolzano,533050,200598,37.63,0.67
2642,2021-01-20,PAB,617,252,365,409,208,ITH,ITH1,4,Provincia Autonoma Bolzano / Bozen,P.A. Bolzano,533050,201215,37.75,0.12
2643,2021-03-11,PAB,1681,823,858,1143,538,ITH,ITH1,4,Provincia Autonoma Bolzano / Bozen,P.A. Bolzano,533050,202896,38.06,0.32
2644,2021-02-22,PAB,526,143,383,514,12,ITH,ITH1,4,Provincia Autonoma Bolzano / Bozen,P.A. Bolzano,533050,203422,38.16,0.1
2645,2021-01-03,PAB,41,16,25,41,0,ITH,ITH1,4,Provincia Autonoma Bolzano / Bozen,P.A. Bolzano,533050,203463,38.17,0.01
2646,2021-01-18,PAB,1772,687,1085,1767,5,ITH,ITH1,4,Provincia Autonoma Bolzano / Bozen,P.A. Bolzano,533050,205235,38.5,0.33
2647,2021-05-05,PAB,4154,1945,2209,2038,2116,ITH,ITH1,4,Provincia Autonoma Bolzano / Bozen,P.A. Bolzano,533050,209389,39.28,0.78
2648,2021-01-25,PAB,487,183,304,3,484,ITH,ITH1,4,Provincia Autonoma Bolzano / Bozen,P.A. Bolzano,533050,209876,39.37,0.09
2649,2021-03-23,PAB,1552,759,793,1551,1,ITH,ITH1,4,Provincia Autonoma Bolzano / Bozen,P.A. Bolzano,533050,211428,39.66,0.29
2650,2021-05-07,PAB,4180,2055,2125,3662,518,ITH,ITH1,4,Provincia Autonoma Bolzano / Bozen,P.A. Bolzano,533050,215608,40.45,0.78
2651,2021-04-01,PAB,2786,1407,1379,2642,144,ITH,ITH1,4,Provincia Autonoma Bolzano / Bozen,P.A. Bolzano,533050,218394,40.97,0.52
2652,2021-03-25,PAB,2141,1059,1082,1698,443,ITH,ITH1,4,Provincia Autonoma Bolzano / Bozen,P.A. Bolzano,533050,220535,41.37,0.4
2653,2021-01-27,PAB,84,28,56,1,83,ITH,ITH1,4,Provincia Autonoma Bolzano / Bozen,P.A. Bolzano,533050,220619,41.39,0.02
2654,2021-05-26,PAB,4769,2405,2364,2846,1923,ITH,ITH1,4,Provincia Autonoma Bolzano / Bozen,P.A. Bolzano,533050,225388,42.28,0.89
2655,2021-02-15,PAB,72,42,30,26,46,ITH,ITH1,4,Provincia Autonoma Bolzano / Bozen,P.A. Bolzano,533050,225460,42.3,0.01
2656,2021-05-28,PAB,5504,2787,2717,3668,1836,ITH,ITH1,4,Provincia Autonoma Bolzano / Bozen,P.A. Bolzano,533050,230964,43.33,1.03
2657,2021-04-22,PAB,2923,1500,1423,1981,942,ITH,ITH1,4,Provincia Autonoma Bolzano / Bozen,P.A. Bolzano,533050,233887,43.88,0.55
2658,2021-02-17,PAB,156,51,105,139,17,ITH,ITH1,4,Provincia Autonoma Bolzano / Bozen,P.A. Bolzano,533050,234043,43.91,0.03
2659,2021-02-13,PAB,318,79,239,312,6,ITH,ITH1,4,Provincia Autonoma Bolzano / Bozen,P.A. Bolzano,533050,234361,43.97,0.06
2660,2021-04-11,PAB,2720,1291,1429,2543,177,ITH,ITH1,4,Provincia Autonoma Bolzano / Bozen,P.A. Bolzano,533050,237081,44.48,0.51
2661,2021-05-24,PAB,1442,761,681,1109,333,ITH,ITH1,4,Provincia Autonoma Bolzano / Bozen,P.A. Bolzano,533050,238523,44.75,0.27
2662,2021-01-01,PAB,6,5,1,6,0,ITH,ITH1,4,Provincia Autonoma Bolzano / Bozen,P.A. Bolzano,533050,238529,44.75,0.0
2663,2021-02-27,PAB,2458,759,1699,2448,10,ITH,ITH1,4,Provincia Autonoma Bolzano / Bozen,P.A. Bolzano,533050,240987,45.21,0.46
2664,2021-02-20,PAB,1802,540,1262,1784,18,ITH,ITH1,4,Provincia Autonoma Bolzano / Bozen,P.A. Bolzano,533050,242789,45.55,0.34
2665,2021-04-18,PAB,3110,1607,1503,2100,1010,ITH,ITH1,4,Provincia Autonoma Bolzano / Bozen,P.A. Bolzano,533050,245899,46.13,0.58
2666,2021-01-15,PAB,3282,1228,2054,3282,0,ITH,ITH1,4,Provincia Autonoma Bolzano / Bozen,P.A. Bolzano,533050,249181,46.75,0.62
2667,2021-01-08,PAB,1521,479,1042,1521,0,ITH,ITH1,4,Provincia Autonoma Bolzano / Bozen,P.A. Bolzano,533050,250702,47.03,0.29
2668,2021-02-06,PAB,2626,1171,1455,19,2607,ITH,ITH1,4,Provincia Autonoma Bolzano / Bozen,P.A. Bolzano,533050,253328,47.52,0.49
2669,2021-03-28,PAB,569,212,357,11,558,ITH,ITH1,4,Provincia Autonoma Bolzano / Bozen,P.A. Bolzano,533050,253897,47.63,0.11
2670,2021-03-13,PAB,2885,1459,1426,2784,101,ITH,ITH1,4,Provincia Autonoma Bolzano / Bozen,P.A. Bolzano,533050,256782,48.17,0.54
2671,2021-05-02,PAB,2457,1288,1169,1536,921,ITH,ITH1,4,Provincia Autonoma Bolzano / Bozen,P.A. Bolzano,533050,259239,48.63,0.46
2672,2021-03-27,PAB,3049,1553,1496,1543,1506,ITH,ITH1,4,Provincia Autonoma Bolzano / Bozen,P.A. Bolzano,533050,262288,49.21,0.57
2673,2021-04-20,PAB,1560,783,777,1559,1,ITH,ITH1,4,Provincia Autonoma Bolzano / Bozen,P.A. Bolzano,533050,263848,49.5,0.29
2674,2021-03-01,PAB,922,221,701,921,1,ITH,ITH1,4,Provincia Autonoma Bolzano / Bozen,P.A. Bolzano,533050,264770,49.67,0.17
2675,2021-01-17,PAB,2328,1044,1284,2317,11,ITH,ITH1,4,Provincia Autonoma Bolzano / Bozen,P.A. Bolzano,533050,267098,50.11,0.44
2676,2021-05-04,PAB,3447,1843,1604,2410,1037,ITH,ITH1,4,Provincia Autonoma Bolzano / Bozen,P.A. Bolzano,533050,270545,50.75,0.65
2677,2021-05-12,PAB,3776,2048,1728,3623,153,ITH,ITH1,4,Provincia Autonoma Bolzano / Bozen,P.A. Bolzano,533050,274321,51.46,0.71
2678,2021-03-09,PAB,1194,543,651,1192,2,ITH,ITH1,4,Provincia Autonoma Bolzano / Bozen,P.A. Bolzano,533050,275515,51.69,0.22
2679,2021-03-18,PAB,1302,531,771,226,1076,ITH,ITH1,4,Provincia Autonoma Bolzano / Bozen,P.A. Bolzano,533050,276817,51.93,0.24
2680,2021-02-03,PAB,1503,478,1025,5,1498,ITH,ITH1,4,Provincia Autonoma Bolzano / Bozen,P.A. Bolzano,533050,278320,52.21,0.28
2681,2021-05-21,PAB,6830,3729,3101,5056,1774,ITH,ITH1,4,Provincia Autonoma Bolzano / Bozen,P.A. Bolzano,533050,285150,53.49,1.28
2682,2021-05-16,PAB,2024,931,1093,1330,694,ITH,ITH1,4,Provincia Autonoma Bolzano / Bozen,P.A. Bolzano,533050,287174,53.87,0.38
2683,2021-04-16,PAB,2949,1418,1531,2438,511,ITH,ITH1,4,Provincia Autonoma Bolzano / Bozen,P.A. Bolzano,533050,290123,54.43,0.55
2684,2021-02-25,PAB,1498,549,949,1497,1,ITH,ITH1,4,Provincia Autonoma Bolzano / Bozen,P.A. Bolzano,533050,291621,54.71,0.28
2685,2021-03-30,PAB,1298,532,766,218,1080,ITH,ITH1,4,Provincia Autonoma Bolzano / Bozen,P.A. Bolzano,533050,292919,54.95,0.24
2686,2021-02-08,PAB,2,1,1,1,1,ITH,ITH1,4,Provincia Autonoma Bolzano / Bozen,P.A. Bolzano,533050,292921,54.95,0.0
2687,2021-04-13,PAB,2391,1130,1261,2384,7,ITH,ITH1,4,Provincia Autonoma Bolzano / Bozen,P.A. Bolzano,533050,295312,55.4,0.45
2688,2021-04-03,PAB,831,364,467,22,809,ITH,ITH1,4,Provincia Autonoma Bolzano / Bozen,P.A. Bolzano,533050,296143,55.56,0.16
2689,2021-02-24,PAB,1367,406,961,1355,12,ITH,ITH1,4,Provincia Autonoma Bolzano / Bozen,P.A. Bolzano,533050,297510,55.81,0.26
2690,2021-04-15,PAB,4399,2307,2092,4136,263,ITH,ITH1,4,Provincia Autonoma Bolzano / Bozen,P.A. Bolzano,533050,301909,56.64,0.83
2691,2021-02-05,PAB,3195,1181,2014,8,3187,ITH,ITH1,4,Provincia Autonoma Bolzano / Bozen,P.A. Bolzano,533050,305104,57.24,0.6
2692,2021-01-22,PAB,248,143,105,124,124,ITH,ITH1,4,Provincia Autonoma Bolzano / Bozen,P.A. Bolzano,533050,305352,57.28,0.05
2693,2021-04-15,VDA,810,377,433,671,139,ITC,ITC2,2,Valle d'Aosta / Vallée d'Aoste,Valle d'Aosta,125666,810,0.64,0.64
2694,2021-03-29,VDA,493,233,260,453,40,ITC,ITC2,2,Valle d'Aosta / Vallée d'Aoste,Valle d'Aosta,125666,1303,1.04,0.39
2695,2021-03-12,VDA,531,175,356,305,226,ITC,ITC2,2,Valle d'Aosta / Vallée d'Aoste,Valle d'Aosta,125666,1834,1.46,0.42
2696,2021-02-22,VDA,316,94,222,213,103,ITC,ITC2,2,Valle d'Aosta / Vallée d'Aoste,Valle d'Aosta,125666,2150,1.71,0.25
2697,2021-04-29,VDA,1291,634,657,757,534,ITC,ITC2,2,Valle d'Aosta / Vallée d'Aoste,Valle d'Aosta,125666,3441,2.74,1.03
2698,2021-01-19,VDA,256,77,179,256,0,ITC,ITC2,2,Valle d'Aosta / Vallée d'Aoste,Valle d'Aosta,125666,3697,2.94,0.2
2699,2021-04-14,VDA,941,430,511,717,224,ITC,ITC2,2,Valle d'Aosta / Vallée d'Aoste,Valle d'Aosta,125666,4638,3.69,0.75
2700,2021-04-13,VDA,373,171,202,329,44,ITC,ITC2,2,Valle d'Aosta / Vallée d'Aoste,Valle d'Aosta,125666,5011,3.99,0.3
2701,2021-03-27,VDA,333,164,169,302,31,ITC,ITC2,2,Valle d'Aosta / Vallée d'Aoste,Valle d'Aosta,125666,5344,4.25,0.26
2702,2021-03-10,VDA,438,183,255,225,213,ITC,ITC2,2,Valle d'Aosta / Vallée d'Aoste,Valle d'Aosta,125666,5782,4.6,0.35
2703,2021-02-21,VDA,18,3,15,0,18,ITC,ITC2,2,Valle d'Aosta / Vallée d'Aoste,Valle d'Aosta,125666,5800,4.62,0.01
2704,2021-05-28,VDA,659,298,361,250,409,ITC,ITC2,2,Valle d'Aosta / Vallée d'Aoste,Valle d'Aosta,125666,6459,5.14,0.52
2705,2021-03-25,VDA,389,154,235,379,10,ITC,ITC2,2,Valle d'Aosta / Vallée d'Aoste,Valle d'Aosta,125666,6848,5.45,0.31
2706,2021-02-10,VDA,248,77,171,141,107,ITC,ITC2,2,Valle d'Aosta / Vallée d'Aoste,Valle d'Aosta,125666,7096,5.65,0.2
2707,2021-02-19,VDA,292,102,190,268,24,ITC,ITC2,2,Valle d'Aosta / Vallée d'Aoste,Valle d'Aosta,125666,7388,5.88,0.23
2708,2021-01-07,VDA,275,111,164,275,0,ITC,ITC2,2,Valle d'Aosta / Vallée d'Aoste,Valle d'Aosta,125666,7663,6.1,0.22
2709,2021-04-24,VDA,722,400,322,555,167,ITC,ITC2,2,Valle d'Aosta / Vallée d'Aoste,Valle d'Aosta,125666,8385,6.67,0.57
2710,2021-04-19,VDA,751,325,426,542,209,ITC,ITC2,2,Valle d'Aosta / Vallée d'Aoste,Valle d'Aosta,125666,9136,7.27,0.6
2711,2021-04-27,VDA,978,423,555,686,292,ITC,ITC2,2,Valle d'Aosta / Vallée d'Aoste,Valle d'Aosta,125666,10114,8.05,0.78
2712,2021-03-08,VDA,482,231,251,237,245,ITC,ITC2,2,Valle d'Aosta / Vallée d'Aoste,Valle d'Aosta,125666,10596,8.43,0.38
2713,2021-05-11,VDA,645,325,320,494,151,ITC,ITC2,2,Valle d'Aosta / Vallée d'Aoste,Valle d'Aosta,125666,11241,8.95,0.51
2714,2021-05-04,VDA,1135,510,625,462,673,ITC,ITC2,2,Valle d'Aosta / Vallée d'Aoste,Valle d'Aosta,125666,12376,9.85,0.9
2715,2021-03-15,VDA,362,123,239,159,203,ITC,ITC2,2,Valle d'Aosta / Vallée d'Aoste,Valle d'Aosta,125666,12738,10.14,0.29
2716,2021-01-17,VDA,131,56,75,131,0,ITC,ITC2,2,Valle d'Aosta / Vallée d'Aoste,Valle d'Aosta,125666,12869,10.24,0.1
2717,2021-01-31,VDA,291,91,200,58,233,ITC,ITC2,2,Valle d'Aosta / Vallée d'Aoste,Valle d'Aosta,125666,13160,10.47,0.23
2718,2021-03-22,VDA,560,205,355,333,227,ITC,ITC2,2,Valle d'Aosta / Vallée d'Aoste,Valle d'Aosta,125666,13720,10.92,0.45
2719,2021-05-16,VDA,688,341,347,347,341,ITC,ITC2,2,Valle d'Aosta / Vallée d'Aoste,Valle d'Aosta,125666,14408,11.47,0.55
2720,2021-02-05,VDA,294,102,192,101,193,ITC,ITC2,2,Valle d'Aosta / Vallée d'Aoste,Valle d'Aosta,125666,14702,11.7,0.23
2721,2021-05-18,VDA,969,484,485,353,616,ITC,ITC2,2,Valle d'Aosta / Vallée d'Aoste,Valle d'Aosta,125666,15671,12.47,0.77
2722,2021-04-12,VDA,486,186,300,323,163,ITC,ITC2,2,Valle d'Aosta / Vallée d'Aoste,Valle d'Aosta,125666,16157,12.86,0.39
2723,2021-02-07,VDA,292,120,172,190,102,ITC,ITC2,2,Valle d'Aosta / Vallée d'Aoste,Valle d'Aosta,125666,16449,13.09,0.23
2724,2021-05-06,VDA,1063,509,554,679,384,ITC,ITC2,2,Valle d'Aosta / Vallée d'Aoste,Valle d'Aosta,125666,17512,13.94,0.85
2725,2021-03-31,VDA,555,302,253,529,26,ITC,ITC2,2,Valle d'Aosta / Vallée d'Aoste,Valle d'Aosta,125666,18067,14.38,0.44
2726,2021-05-27,VDA,1089,497,592,586,503,ITC,ITC2,2,Valle d'Aosta / Vallée d'Aoste,Valle d'Aosta,125666,19156,15.24,0.87
2727,2021-05-13,VDA,1139,556,583,540,599,ITC,ITC2,2,Valle d'Aosta / Vallée d'Aoste,Valle d'Aosta,125666,20295,16.15,0.91
2728,2021-02-02,VDA,272,70,202,2,270,ITC,ITC2,2,Valle d'Aosta / Vallée d'Aoste,Valle d'Aosta,125666,20567,16.37,0.22
2729,2021-05-20,VDA,807,363,444,367,440,ITC,ITC2,2,Valle d'Aosta / Vallée d'Aoste,Valle d'Aosta,125666,21374,17.01,0.64
2730,2021-04-20,VDA,932,430,502,738,194,ITC,ITC2,2,Valle d'Aosta / Vallée d'Aoste,Valle d'Aosta,125666,22306,17.75,0.74
2731,2021-02-15,VDA,264,136,128,229,35,ITC,ITC2,2,Valle d'Aosta / Vallée d'Aoste,Valle d'Aosta,125666,22570,17.96,0.21
2732,2021-02-14,VDA,48,16,32,1,47,ITC,ITC2,2,Valle d'Aosta / Vallée d'Aoste,Valle d'Aosta,125666,22618,18.0,0.04
2733,2021-02-03,VDA,351,114,237,14,337,ITC,ITC2,2,Valle d'Aosta / Vallée d'Aoste,Valle d'Aosta,125666,22969,18.28,0.28
2734,2021-04-01,VDA,776,394,382,764,12,ITC,ITC2,2,Valle d'Aosta / Vallée d'Aoste,Valle d'Aosta,125666,23745,18.9,0.62
2735,2021-04-08,VDA,584,282,302,441,143,ITC,ITC2,2,Valle d'Aosta / Vallée d'Aoste,Valle d'Aosta,125666,24329,19.36,0.46
2736,2021-02-24,VDA,183,82,101,164,19,ITC,ITC2,2,Valle d'Aosta / Vallée d'Aoste,Valle d'Aosta,125666,24512,19.51,0.15
2737,2021-01-27,VDA,151,71,80,79,72,ITC,ITC2,2,Valle d'Aosta / Vallée d'Aoste,Valle d'Aosta,125666,24663,19.63,0.12
2738,2020-12-27,VDA,20,9,11,20,0,ITC,ITC2,2,Valle d'Aosta / Vallée d'Aoste,Valle d'Aosta,125666,24683,19.64,0.02
2739,2021-03-01,VDA,181,66,115,147,34,ITC,ITC2,2,Valle d'Aosta / Vallée d'Aoste,Valle d'Aosta,125666,24864,19.79,0.14
2740,2021-01-10,VDA,220,71,149,220,0,ITC,ITC2,2,Valle d'Aosta / Vallée d'Aoste,Valle d'Aosta,125666,25084,19.96,0.18
2741,2021-05-25,VDA,1115,530,585,541,574,ITC,ITC2,2,Valle d'Aosta / Vallée d'Aoste,Valle d'Aosta,125666,26199,20.85,0.89
2742,2021-05-08,VDA,904,540,364,526,378,ITC,ITC2,2,Valle d'Aosta / Vallée d'Aoste,Valle d'Aosta,125666,27103,21.57,0.72
2743,2021-04-05,VDA,461,222,239,457,4,ITC,ITC2,2,Valle d'Aosta / Vallée d'Aoste,Valle d'Aosta,125666,27564,21.93,0.37
2744,2021-05-21,VDA,917,433,484,531,386,ITC,ITC2,2,Valle d'Aosta / Vallée d'Aoste,Valle d'Aosta,125666,28481,22.66,0.73
2745,2021-02-17,VDA,327,144,183,227,100,ITC,ITC2,2,Valle d'Aosta / Vallée d'Aoste,Valle d'Aosta,125666,28808,22.92,0.26
2746,2021-04-17,VDA,638,407,231,636,2,ITC,ITC2,2,Valle d'Aosta / Vallée d'Aoste,Valle d'Aosta,125666,29446,23.43,0.51
2747,2021-01-05,VDA,150,54,96,150,0,ITC,ITC2,2,Valle d'Aosta / Vallée d'Aoste,Valle d'Aosta,125666,29596,23.55,0.12
2748,2021-01-14,VDA,237,69,168,237,0,ITC,ITC2,2,Valle d'Aosta / Vallée d'Aoste,Valle d'Aosta,125666,29833,23.74,0.19
2749,2021-04-10,VDA,404,190,214,399,5,ITC,ITC2,2,Valle d'Aosta / Vallée d'Aoste,Valle d'Aosta,125666,30237,24.06,0.32
2750,2021-02-26,VDA,207,58,149,122,85,ITC,ITC2,2,Valle d'Aosta / Vallée d'Aoste,Valle d'Aosta,125666,30444,24.23,0.16
2751,2020-12-31,VDA,18,4,14,18,0,ITC,ITC2,2,Valle d'Aosta / Vallée d'Aoste,Valle d'Aosta,125666,30462,24.24,0.01
2752,2021-03-05,VDA,275,124,151,53,222,ITC,ITC2,2,Valle d'Aosta / Vallée d'Aoste,Valle d'Aosta,125666,30737,24.46,0.22
2753,2021-03-20,VDA,208,86,122,172,36,ITC,ITC2,2,Valle d'Aosta / Vallée d'Aoste,Valle d'Aosta,125666,30945,24.62,0.17
2754,2021-05-09,VDA,574,287,287,444,130,ITC,ITC2,2,Valle d'Aosta / Vallée d'Aoste,Valle d'Aosta,125666,31519,25.08,0.46
2755,2021-04-03,VDA,676,341,335,661,15,ITC,ITC2,2,Valle d'Aosta / Vallée d'Aoste,Valle d'Aosta,125666,32195,25.62,0.54
2756,2021-05-23,VDA,999,465,534,658,341,ITC,ITC2,2,Valle d'Aosta / Vallée d'Aoste,Valle d'Aosta,125666,33194,26.41,0.79
2757,2021-01-29,VDA,318,138,180,2,316,ITC,ITC2,2,Valle d'Aosta / Vallée d'Aoste,Valle d'Aosta,125666,33512,26.67,0.25
2758,2021-02-12,VDA,263,96,167,217,46,ITC,ITC2,2,Valle d'Aosta / Vallée d'Aoste,Valle d'Aosta,125666,33775,26.88,0.21
2759,2021-05-02,VDA,765,345,420,605,160,ITC,ITC2,2,Valle d'Aosta / Vallée d'Aoste,Valle d'Aosta,125666,34540,27.49,0.61
2760,2021-01-08,VDA,299,130,169,299,0,ITC,ITC2,2,Valle d'Aosta / Vallée d'Aoste,Valle d'Aosta,125666,34839,27.72,0.24
2761,2021-03-06,VDA,22,4,18,22,0,ITC,ITC2,2,Valle d'Aosta / Vallée d'Aoste,Valle d'Aosta,125666,34861,27.74,0.02
2762,2021-03-13,VDA,145,86,59,145,0,ITC,ITC2,2,Valle d'Aosta / Vallée d'Aoste,Valle d'Aosta,125666,35006,27.86,0.12
2763,2021-01-15,VDA,218,82,136,218,0,ITC,ITC2,2,Valle d'Aosta / Vallée d'Aoste,Valle d'Aosta,125666,35224,28.03,0.17
2764,2021-01-22,VDA,56,21,35,20,36,ITC,ITC2,2,Valle d'Aosta / Vallée d'Aoste,Valle d'Aosta,125666,35280,28.07,0.04
2765,2021-01-16,VDA,236,80,156,236,0,ITC,ITC2,2,Valle d'Aosta / Vallée d'Aoste,Valle d'Aosta,125666,35516,28.26,0.19
2766,2021-05-19,VDA,993,498,495,418,575,ITC,ITC2,2,Valle d'Aosta / Vallée d'Aoste,Valle d'Aosta,125666,36509,29.05,0.79
2767,2021-03-16,VDA,180,37,143,118,62,ITC,ITC2,2,Valle d'Aosta / Vallée d'Aoste,Valle d'Aosta,125666,36689,29.2,0.14
2768,2021-05-17,VDA,809,417,392,375,434,ITC,ITC2,2,Valle d'Aosta / Vallée d'Aoste,Valle d'Aosta,125666,37498,29.84,0.64
2769,2021-02-04,VDA,294,86,208,8,286,ITC,ITC2,2,Valle d'Aosta / Vallée d'Aoste,Valle d'Aosta,125666,37792,30.07,0.23
2770,2021-04-30,VDA,831,355,476,485,346,ITC,ITC2,2,Valle d'Aosta / Vallée d'Aoste,Valle d'Aosta,125666,38623,30.73,0.66
2771,2021-01-18,VDA,213,74,139,213,0,ITC,ITC2,2,Valle d'Aosta / Vallée d'Aoste,Valle d'Aosta,125666,38836,30.9,0.17
2772,2021-05-15,VDA,1065,614,451,380,685,ITC,ITC2,2,Valle d'Aosta / Vallée d'Aoste,Valle d'Aosta,125666,39901,31.75,0.85
2773,2021-02-23,VDA,216,123,93,216,0,ITC,ITC2,2,Valle d'Aosta / Vallée d'Aoste,Valle d'Aosta,125666,40117,31.92,0.17
2774,2021-04-28,VDA,1218,632,586,715,503,ITC,ITC2,2,Valle d'Aosta / Vallée d'Aoste,Valle d'Aosta,125666,41335,32.89,0.97
2775,2021-02-06,VDA,289,104,185,92,197,ITC,ITC2,2,Valle d'Aosta / Vallée d'Aoste,Valle d'Aosta,125666,41624,33.12,0.23
2776,2021-04-11,VDA,479,208,271,479,0,ITC,ITC2,2,Valle d'Aosta / Vallée d'Aoste,Valle d'Aosta,125666,42103,33.5,0.38
2777,2021-01-20,VDA,23,8,15,23,0,ITC,ITC2,2,Valle d'Aosta / Vallée d'Aoste,Valle d'Aosta,125666,42126,33.52,0.02
2778,2021-04-22,VDA,1067,449,618,684,383,ITC,ITC2,2,Valle d'Aosta / Vallée d'Aoste,Valle d'Aosta,125666,43193,34.37,0.85
2779,2021-03-03,VDA,255,118,137,187,68,ITC,ITC2,2,Valle d'Aosta / Vallée d'Aoste,Valle d'Aosta,125666,43448,34.57,0.2
2780,2021-01-12,VDA,302,72,230,302,0,ITC,ITC2,2,Valle d'Aosta / Vallée d'Aoste,Valle d'Aosta,125666,43750,34.81,0.24
2781,2021-03-17,VDA,433,185,248,273,160,ITC,ITC2,2,Valle d'Aosta / Vallée d'Aoste,Valle d'Aosta,125666,44183,35.16,0.34
2782,2021-01-26,VDA,139,48,91,0,139,ITC,ITC2,2,Valle d'Aosta / Vallée d'Aoste,Valle d'Aosta,125666,44322,35.27,0.11
2783,2021-02-11,VDA,231,107,124,222,9,ITC,ITC2,2,Valle d'Aosta / Vallée d'Aoste,Valle d'Aosta,125666,44553,35.45,0.18
2784,2021-04-16,VDA,599,261,338,597,2,ITC,ITC2,2,Valle d'Aosta / Vallée d'Aoste,Valle d'Aosta,125666,45152,35.93,0.48
2785,2021-04-02,VDA,873,344,529,648,225,ITC,ITC2,2,Valle d'Aosta / Vallée d'Aoste,Valle d'Aosta,125666,46025,36.62,0.69
2786,2021-02-18,VDA,349,153,196,261,88,ITC,ITC2,2,Valle d'Aosta / Vallée d'Aoste,Valle d'Aosta,125666,46374,36.9,0.28
2787,2021-03-24,VDA,515,230,285,258,257,ITC,ITC2,2,Valle d'Aosta / Vallée d'Aoste,Valle d'Aosta,125666,46889,37.31,0.41
2788,2021-02-16,VDA,325,53,272,320,5,ITC,ITC2,2,Valle d'Aosta / Vallée d'Aoste,Valle d'Aosta,125666,47214,37.57,0.26
2789,2021-04-07,VDA,910,474,436,681,229,ITC,ITC2,2,Valle d'Aosta / Vallée d'Aoste,Valle d'Aosta,125666,48124,38.3,0.72
2790,2021-02-09,VDA,251,84,167,68,183,ITC,ITC2,2,Valle d'Aosta / Vallée d'Aoste,Valle d'Aosta,125666,48375,38.49,0.2
2791,2021-05-01,VDA,938,562,376,454,484,ITC,ITC2,2,Valle d'Aosta / Vallée d'Aoste,Valle d'Aosta,125666,49313,39.24,0.75
2792,2021-01-02,VDA,6,5,1,6,0,ITC,ITC2,2,Valle d'Aosta / Vallée d'Aoste,Valle d'Aosta,125666,49319,39.25,0.0
2793,2021-03-26,VDA,498,204,294,491,7,ITC,ITC2,2,Valle d'Aosta / Vallée d'Aoste,Valle d'Aosta,125666,49817,39.64,0.4
2794,2021-01-21,VDA,33,12,21,33,0,ITC,ITC2,2,Valle d'Aosta / Vallée d'Aoste,Valle d'Aosta,125666,49850,39.67,0.03
2795,2021-03-28,VDA,522,212,310,521,1,ITC,ITC2,2,Valle d'Aosta / Vallée d'Aoste,Valle d'Aosta,125666,50372,40.08,0.42
2796,2021-02-20,VDA,251,210,41,241,10,ITC,ITC2,2,Valle d'Aosta / Vallée d'Aoste,Valle d'Aosta,125666,50623,40.28,0.2
2797,2021-01-28,VDA,290,123,167,56,234,ITC,ITC2,2,Valle d'Aosta / Vallée d'Aoste,Valle d'Aosta,125666,50913,40.51,0.23
2798,2021-04-23,VDA,921,443,478,538,383,ITC,ITC2,2,Valle d'Aosta / Vallée d'Aoste,Valle d'Aosta,125666,51834,41.25,0.73
2799,2021-03-04,VDA,291,139,152,42,249,ITC,ITC2,2,Valle d'Aosta / Vallée d'Aoste,Valle d'Aosta,125666,52125,41.48,0.23
2800,2021-05-07,VDA,564,245,319,533,31,ITC,ITC2,2,Valle d'Aosta / Vallée d'Aoste,Valle d'Aosta,125666,52689,41.93,0.45
2801,2021-04-06,VDA,741,381,360,629,112,ITC,ITC2,2,Valle d'Aosta / Vallée d'Aoste,Valle d'Aosta,125666,53430,42.52,0.59
2802,2021-05-05,VDA,1038,566,472,456,582,ITC,ITC2,2,Valle d'Aosta / Vallée d'Aoste,Valle d'Aosta,125666,54468,43.34,0.83
2803,2021-01-25,VDA,147,65,82,0,147,ITC,ITC2,2,Valle d'Aosta / Vallée d'Aoste,Valle d'Aosta,125666,54615,43.46,0.12
2804,2021-05-12,VDA,1137,549,588,467,670,ITC,ITC2,2,Valle d'Aosta / Vallée d'Aoste,Valle d'Aosta,125666,55752,44.37,0.9
2805,2021-01-04,VDA,142,59,83,142,0,ITC,ITC2,2,Valle d'Aosta / Vallée d'Aoste,Valle d'Aosta,125666,55894,44.48,0.11
2806,2021-03-09,VDA,206,96,110,174,32,ITC,ITC2,2,Valle d'Aosta / Vallée d'Aoste,Valle d'Aosta,125666,56100,44.64,0.16
2807,2021-03-11,VDA,197,76,121,66,131,ITC,ITC2,2,Valle d'Aosta / Vallée d'Aoste,Valle d'Aosta,125666,56297,44.8,0.16
2808,2021-04-18,VDA,522,254,268,518,4,ITC,ITC2,2,Valle d'Aosta / Vallée d'Aoste,Valle d'Aosta,125666,56819,45.21,0.42
2809,2021-04-25,VDA,849,408,441,710,139,ITC,ITC2,2,Valle d'Aosta / Vallée d'Aoste,Valle d'Aosta,125666,57668,45.89,0.68
2810,2021-05-24,VDA,1135,516,619,688,447,ITC,ITC2,2,Valle d'Aosta / Vallée d'Aoste,Valle d'Aosta,125666,58803,46.79,0.9
2811,2021-05-10,VDA,782,381,401,547,235,ITC,ITC2,2,Valle d'Aosta / Vallée d'Aoste,Valle d'Aosta,125666,59585,47.42,0.62
2812,2021-03-21,VDA,355,165,190,355,0,ITC,ITC2,2,Valle d'Aosta / Vallée d'Aoste,Valle d'Aosta,125666,59940,47.7,0.28
2813,2021-04-04,VDA,572,253,319,571,1,ITC,ITC2,2,Valle d'Aosta / Vallée d'Aoste,Valle d'Aosta,125666,60512,48.15,0.46
2814,2021-02-13,VDA,216,196,20,215,1,ITC,ITC2,2,Valle d'Aosta / Vallée d'Aoste,Valle d'Aosta,125666,60728,48.32,0.17
2815,2021-05-22,VDA,940,494,446,540,400,ITC,ITC2,2,Valle d'Aosta / Vallée d'Aoste,Valle d'Aosta,125666,61668,49.07,0.75
2816,2021-04-09,VDA,237,111,126,204,33,ITC,ITC2,2,Valle d'Aosta / Vallée d'Aoste,Valle d'Aosta,125666,61905,49.26,0.19
2817,2021-02-25,VDA,201,101,100,194,7,ITC,ITC2,2,Valle d'Aosta / Vallée d'Aoste,Valle d'Aosta,125666,62106,49.42,0.16
2818,2021-01-06,VDA,65,33,32,65,0,ITC,ITC2,2,Valle d'Aosta / Vallée d'Aoste,Valle d'Aosta,125666,62171,49.47,0.05
2819,2021-04-26,VDA,715,327,388,545,170,ITC,ITC2,2,Valle d'Aosta / Vallée d'Aoste,Valle d'Aosta,125666,62886,50.04,0.57
2820,2021-01-09,VDA,443,199,244,443,0,ITC,ITC2,2,Valle d'Aosta / Vallée d'Aoste,Valle d'Aosta,125666,63329,50.39,0.35
2821,2021-03-14,VDA,392,200,192,392,0,ITC,ITC2,2,Valle d'Aosta / Vallée d'Aoste,Valle d'Aosta,125666,63721,50.71,0.31
2822,2021-03-23,VDA,379,150,229,245,134,ITC,ITC2,2,Valle d'Aosta / Vallée d'Aoste,Valle d'Aosta,125666,64100,51.01,0.3
2823,2021-02-08,VDA,223,83,140,25,198,ITC,ITC2,2,Valle d'Aosta / Vallée d'Aoste,Valle d'Aosta,125666,64323,51.19,0.18
2824,2021-03-19,VDA,322,85,237,286,36,ITC,ITC2,2,Valle d'Aosta / Vallée d'Aoste,Valle d'Aosta,125666,64645,51.44,0.26
2825,2021-01-13,VDA,337,110,227,337,0,ITC,ITC2,2,Valle d'Aosta / Vallée d'Aoste,Valle d'Aosta,125666,64982,51.71,0.27
2826,2021-03-18,VDA,136,43,93,99,37,ITC,ITC2,2,Valle d'Aosta / Vallée d'Aoste,Valle d'Aosta,125666,65118,51.82,0.11
2827,2021-05-26,VDA,1208,586,622,575,633,ITC,ITC2,2,Valle d'Aosta / Vallée d'Aoste,Valle d'Aosta,125666,66326,52.78,0.96
2828,2021-02-28,VDA,260,86,174,77,183,ITC,ITC2,2,Valle d'Aosta / Vallée d'Aoste,Valle d'Aosta,125666,66586,52.99,0.21
2829,2021-05-03,VDA,839,400,439,488,351,ITC,ITC2,2,Valle d'Aosta / Vallée d'Aoste,Valle d'Aosta,125666,67425,53.65,0.67
2830,2021-03-07,VDA,64,30,34,11,53,ITC,ITC2,2,Valle d'Aosta / Vallée d'Aoste,Valle d'Aosta,125666,67489,53.71,0.05
2831,2021-01-30,VDA,439,202,237,14,425,ITC,ITC2,2,Valle d'Aosta / Vallée d'Aoste,Valle d'Aosta,125666,67928,54.05,0.35
2832,2021-04-21,VDA,868,410,458,620,248,ITC,ITC2,2,Valle d'Aosta / Vallée d'Aoste,Valle d'Aosta,125666,68796,54.75,0.69
2833,2021-03-02,VDA,339,166,173,336,3,ITC,ITC2,2,Valle d'Aosta / Vallée d'Aoste,Valle d'Aosta,125666,69135,55.01,0.27
2834,2021-01-11,VDA,325,112,213,325,0,ITC,ITC2,2,Valle d'Aosta / Vallée d'Aoste,Valle d'Aosta,125666,69460,55.27,0.26
2835,2021-05-14,VDA,960,442,518,291,669,ITC,ITC2,2,Valle d'Aosta / Vallée d'Aoste,Valle d'Aosta,125666,70420,56.04,0.76
2836,2021-02-01,VDA,404,127,277,87,317,ITC,ITC2,2,Valle d'Aosta / Vallée d'Aoste,Valle d'Aosta,125666,70824,56.36,0.32
2837,2021-03-30,VDA,402,223,179,382,20,ITC,ITC2,2,Valle d'Aosta / Vallée d'Aoste,Valle d'Aosta,125666,71226,56.68,0.32
2838,2021-02-27,VDA,231,85,146,124,107,ITC,ITC2,2,Valle d'Aosta / Vallée d'Aoste,Valle d'Aosta,125666,71457,56.86,0.18
2839,2021-03-02,PAT,1304,440,864,928,376,ITH,ITH2,4,Provincia Autonoma Trento,P.A. Trento,541380,1304,0.24,0.24
2840,2021-02-13,PAT,537,333,204,172,365,ITH,ITH2,4,Provincia Autonoma Trento,P.A. Trento,541380,1841,0.34,0.1
2841,2021-05-26,PAT,3598,1686,1912,1025,2573,ITH,ITH2,4,Provincia Autonoma Trento,P.A. Trento,541380,5439,1.0,0.66
2842,2021-01-27,PAT,802,277,525,91,711,ITH,ITH2,4,Provincia Autonoma Trento,P.A. Trento,541380,6241,1.15,0.15
2843,2021-05-09,PAT,2322,1210,1112,1978,344,ITH,ITH2,4,Provincia Autonoma Trento,P.A. Trento,541380,8563,1.58,0.43
2844,2021-01-28,PAT,530,147,383,48,482,ITH,ITH2,4,Provincia Autonoma Trento,P.A. Trento,541380,9093,1.68,0.1
2845,2021-04-23,PAT,3599,1749,1850,3545,54,ITH,ITH2,4,Provincia Autonoma Trento,P.A. Trento,541380,12692,2.34,0.66
2846,2021-01-13,PAT,421,123,298,421,0,ITH,ITH2,4,Provincia Autonoma Trento,P.A. Trento,541380,13113,2.42,0.08
2847,2021-03-18,PAT,2318,957,1361,1238,1080,ITH,ITH2,4,Provincia Autonoma Trento,P.A. Trento,541380,15431,2.85,0.43
2848,2021-03-20,PAT,872,402,470,670,202,ITH,ITH2,4,Provincia Autonoma Trento,P.A. Trento,541380,16303,3.01,0.16
2849,2021-03-21,PAT,129,69,60,129,0,ITH,ITH2,4,Provincia Autonoma Trento,P.A. Trento,541380,16432,3.04,0.02
2850,2021-05-24,PAT,4362,2004,2358,1332,3030,ITH,ITH2,4,Provincia Autonoma Trento,P.A. Trento,541380,20794,3.84,0.81
2851,2021-03-04,PAT,2358,793,1565,1580,778,ITH,ITH2,4,Provincia Autonoma Trento,P.A. Trento,541380,23152,4.28,0.44
2852,2021-05-07,PAT,5984,3077,2907,5147,837,ITH,ITH2,4,Provincia Autonoma Trento,P.A. Trento,541380,29136,5.38,1.11
2853,2021-04-20,PAT,2872,1372,1500,2836,36,ITH,ITH2,4,Provincia Autonoma Trento,P.A. Trento,541380,32008,5.91,0.53
2854,2021-02-15,PAT,533,187,346,419,114,ITH,ITH2,4,Provincia Autonoma Trento,P.A. Trento,541380,32541,6.01,0.1
2855,2021-01-23,PAT,577,334,243,388,189,ITH,ITH2,4,Provincia Autonoma Trento,P.A. Trento,541380,33118,6.12,0.11
2856,2021-05-05,PAT,4972,2575,2397,4689,283,ITH,ITH2,4,Provincia Autonoma Trento,P.A. Trento,541380,38090,7.04,0.92
2857,2021-03-23,PAT,2444,943,1501,1704,740,ITH,ITH2,4,Provincia Autonoma Trento,P.A. Trento,541380,40534,7.49,0.45
2858,2021-04-01,PAT,2893,1227,1666,1800,1093,ITH,ITH2,4,Provincia Autonoma Trento,P.A. Trento,541380,43427,8.02,0.53
2859,2021-04-18,PAT,1854,844,1010,1845,9,ITH,ITH2,4,Provincia Autonoma Trento,P.A. Trento,541380,45281,8.36,0.34
2860,2021-03-06,PAT,783,277,506,632,151,ITH,ITH2,4,Provincia Autonoma Trento,P.A. Trento,541380,46064,8.51,0.14
2861,2021-01-01,PAT,213,50,163,213,0,ITH,ITH2,4,Provincia Autonoma Trento,P.A. Trento,541380,46277,8.55,0.04
2862,2021-02-20,PAT,407,245,162,123,284,ITH,ITH2,4,Provincia Autonoma Trento,P.A. Trento,541380,46684,8.62,0.08
2863,2021-04-11,PAT,2340,1135,1205,2248,92,ITH,ITH2,4,Provincia Autonoma Trento,P.A. Trento,541380,49024,9.06,0.43
2864,2021-01-08,PAT,1449,313,1136,1449,0,ITH,ITH2,4,Provincia Autonoma Trento,P.A. Trento,541380,50473,9.32,0.27
2865,2021-02-27,PAT,1027,456,571,606,421,ITH,ITH2,4,Provincia Autonoma Trento,P.A. Trento,541380,51500,9.51,0.19
2866,2021-04-25,PAT,1970,939,1031,1963,7,ITH,ITH2,4,Provincia Autonoma Trento,P.A. Trento,541380,53470,9.88,0.36
2867,2021-04-21,PAT,2893,1349,1544,2843,50,ITH,ITH2,4,Provincia Autonoma Trento,P.A. Trento,541380,56363,10.41,0.53
2868,2021-02-16,PAT,663,244,419,658,5,ITH,ITH2,4,Provincia Autonoma Trento,P.A. Trento,541380,57026,10.53,0.12
2869,2021-05-10,PAT,3205,1644,1561,2701,504,ITH,ITH2,4,Provincia Autonoma Trento,P.A. Trento,541380,60231,11.13,0.59
2870,2021-01-11,PAT,730,221,509,730,0,ITH,ITH2,4,Provincia Autonoma Trento,P.A. Trento,541380,60961,11.26,0.13
2871,2021-01-30,PAT,386,132,254,152,234,ITH,ITH2,4,Provincia Autonoma Trento,P.A. Trento,541380,61347,11.33,0.07
2872,2021-04-06,PAT,2258,949,1309,1493,765,ITH,ITH2,4,Provincia Autonoma Trento,P.A. Trento,541380,63605,11.75,0.42
2873,2021-05-22,PAT,3236,1588,1648,919,2317,ITH,ITH2,4,Provincia Autonoma Trento,P.A. Trento,541380,66841,12.35,0.6
2874,2021-04-02,PAT,2801,1146,1655,2126,675,ITH,ITH2,4,Provincia Autonoma Trento,P.A. Trento,541380,69642,12.86,0.52
2875,2021-04-09,PAT,2706,1144,1562,1507,1199,ITH,ITH2,4,Provincia Autonoma Trento,P.A. Trento,541380,72348,13.36,0.5
2876,2021-02-11,PAT,1132,365,767,796,336,ITH,ITH2,4,Provincia Autonoma Trento,P.A. Trento,541380,73480,13.57,0.21
2877,2021-02-25,PAT,1641,643,998,1200,441,ITH,ITH2,4,Provincia Autonoma Trento,P.A. Trento,541380,75121,13.88,0.3
2878,2020-12-30,PAT,7,3,4,7,0,ITH,ITH2,4,Provincia Autonoma Trento,P.A. Trento,541380,75128,13.88,0.0
2879,2021-04-16,PAT,2836,1344,1492,2691,145,ITH,ITH2,4,Provincia Autonoma Trento,P.A. Trento,541380,77964,14.4,0.52
2880,2021-02-18,PAT,1205,426,779,1143,62,ITH,ITH2,4,Provincia Autonoma Trento,P.A. Trento,541380,79169,14.62,0.22
2881,2021-01-06,PAT,42,13,29,42,0,ITH,ITH2,4,Provincia Autonoma Trento,P.A. Trento,541380,79211,14.63,0.01
2882,2021-05-17,PAT,4292,2121,2171,3942,350,ITH,ITH2,4,Provincia Autonoma Trento,P.A. Trento,541380,83503,15.42,0.79
2883,2021-04-14,PAT,3115,1464,1651,2379,736,ITH,ITH2,4,Provincia Autonoma Trento,P.A. Trento,541380,86618,16.0,0.58
2884,2021-03-28,PAT,748,292,456,745,3,ITH,ITH2,4,Provincia Autonoma Trento,P.A. Trento,541380,87366,16.14,0.14
2885,2021-01-18,PAT,643,154,489,588,55,ITH,ITH2,4,Provincia Autonoma Trento,P.A. Trento,541380,88009,16.26,0.12
2886,2021-05-14,PAT,5293,2531,2762,3926,1367,ITH,ITH2,4,Provincia Autonoma Trento,P.A. Trento,541380,93302,17.23,0.98
2887,2021-05-21,PAT,5017,2407,2610,3325,1692,ITH,ITH2,4,Provincia Autonoma Trento,P.A. Trento,541380,98319,18.16,0.93
2888,2021-02-23,PAT,1108,395,713,897,211,ITH,ITH2,4,Provincia Autonoma Trento,P.A. Trento,541380,99427,18.37,0.2
2889,2021-02-06,PAT,574,298,276,433,141,ITH,ITH2,4,Provincia Autonoma Trento,P.A. Trento,541380,100001,18.47,0.11
2890,2021-01-04,PAT,870,227,643,870,0,ITH,ITH2,4,Provincia Autonoma Trento,P.A. Trento,541380,100871,18.63,0.16
2891,2021-05-02,PAT,3512,1955,1557,3475,37,ITH,ITH2,4,Provincia Autonoma Trento,P.A. Trento,541380,104383,19.28,0.65
2892,2021-03-13,PAT,830,380,450,782,48,ITH,ITH2,4,Provincia Autonoma Trento,P.A. Trento,541380,105213,19.43,0.15
2893,2021-05-03,PAT,4234,2178,2056,4081,153,ITH,ITH2,4,Provincia Autonoma Trento,P.A. Trento,541380,109447,20.22,0.78
2894,2021-01-16,PAT,319,148,171,319,0,ITH,ITH2,4,Provincia Autonoma Trento,P.A. Trento,541380,109766,20.28,0.06
2895,2021-04-28,PAT,4241,1972,2269,4103,138,ITH,ITH2,4,Provincia Autonoma Trento,P.A. Trento,541380,114007,21.06,0.78
2896,2021-01-25,PAT,817,215,602,23,794,ITH,ITH2,4,Provincia Autonoma Trento,P.A. Trento,541380,114824,21.21,0.15
2897,2021-03-30,PAT,2387,973,1414,1750,637,ITH,ITH2,4,Provincia Autonoma Trento,P.A. Trento,541380,117211,21.65,0.44
2898,2021-05-28,PAT,2913,1388,1525,1188,1725,ITH,ITH2,4,Provincia Autonoma Trento,P.A. Trento,541380,120124,22.19,0.54
2899,2021-03-25,PAT,2874,1103,1771,1824,1050,ITH,ITH2,4,Provincia Autonoma Trento,P.A. Trento,541380,122998,22.72,0.53
2900,2021-03-14,PAT,107,65,42,20,87,ITH,ITH2,4,Provincia Autonoma Trento,P.A. Trento,541380,123105,22.74,0.02
2901,2021-03-07,PAT,22,6,16,22,0,ITH,ITH2,4,Provincia Autonoma Trento,P.A. Trento,541380,123127,22.74,0.0
2902,2021-01-09,PAT,190,40,150,190,0,ITH,ITH2,4,Provincia Autonoma Trento,P.A. Trento,541380,123317,22.78,0.04
2903,2021-03-09,PAT,1581,589,992,938,643,ITH,ITH2,4,Provincia Autonoma Trento,P.A. Trento,541380,124898,23.07,0.29
2904,2021-05-12,PAT,3297,1491,1806,2114,1183,ITH,ITH2,4,Provincia Autonoma Trento,P.A. Trento,541380,128195,23.68,0.61
2905,2021-03-16,PAT,1391,506,885,608,783,ITH,ITH2,4,Provincia Autonoma Trento,P.A. Trento,541380,129586,23.94,0.26
2906,2021-02-01,PAT,1220,335,885,92,1128,ITH,ITH2,4,Provincia Autonoma Trento,P.A. Trento,541380,130806,24.16,0.23
2907,2021-02-08,PAT,1151,318,833,342,809,ITH,ITH2,4,Provincia Autonoma Trento,P.A. Trento,541380,131957,24.37,0.21
2908,2021-05-19,PAT,5088,2451,2637,3839,1249,ITH,ITH2,4,Provincia Autonoma Trento,P.A. Trento,541380,137045,25.31,0.94
2909,2021-04-13,PAT,2552,1057,1495,2045,507,ITH,ITH2,4,Provincia Autonoma Trento,P.A. Trento,541380,139597,25.79,0.47
2910,2021-02-17,PAT,1110,425,685,1020,90,ITH,ITH2,4,Provincia Autonoma Trento,P.A. Trento,541380,140707,25.99,0.21
2911,2021-02-26,PAT,1218,435,783,923,295,ITH,ITH2,4,Provincia Autonoma Trento,P.A. Trento,541380,141925,26.22,0.22
2912,2021-01-14,PAT,700,203,497,700,0,ITH,ITH2,4,Provincia Autonoma Trento,P.A. Trento,541380,142625,26.34,0.13
2913,2021-04-26,PAT,2646,1244,1402,2552,94,ITH,ITH2,4,Provincia Autonoma Trento,P.A. Trento,541380,145271,26.83,0.49
2914,2021-01-29,PAT,1353,331,1022,55,1298,ITH,ITH2,4,Provincia Autonoma Trento,P.A. Trento,541380,146624,27.08,0.25
2915,2021-01-12,PAT,505,158,347,505,0,ITH,ITH2,4,Provincia Autonoma Trento,P.A. Trento,541380,147129,27.18,0.09
2916,2021-04-07,PAT,2599,1012,1587,1658,941,ITH,ITH2,4,Provincia Autonoma Trento,P.A. Trento,541380,149728,27.66,0.48
2917,2021-01-10,PAT,84,19,65,84,0,ITH,ITH2,4,Provincia Autonoma Trento,P.A. Trento,541380,149812,27.67,0.02
2918,2021-04-22,PAT,3146,1468,1678,3102,44,ITH,ITH2,4,Provincia Autonoma Trento,P.A. Trento,541380,152958,28.25,0.58
2919,2021-04-05,PAT,35,17,18,33,2,ITH,ITH2,4,Provincia Autonoma Trento,P.A. Trento,541380,152993,28.26,0.01
2920,2021-03-19,PAT,2423,915,1508,1571,852,ITH,ITH2,4,Provincia Autonoma Trento,P.A. Trento,541380,155416,28.71,0.45
2921,2021-03-26,PAT,3154,1226,1928,2555,599,ITH,ITH2,4,Provincia Autonoma Trento,P.A. Trento,541380,158570,29.29,0.58
2922,2021-02-04,PAT,974,304,670,421,553,ITH,ITH2,4,Provincia Autonoma Trento,P.A. Trento,541380,159544,29.47,0.18
2923,2021-04-30,PAT,4910,2396,2514,4765,145,ITH,ITH2,4,Provincia Autonoma Trento,P.A. Trento,541380,164454,30.38,0.91
2924,2021-03-11,PAT,2295,851,1444,1473,822,ITH,ITH2,4,Provincia Autonoma Trento,P.A. Trento,541380,166749,30.8,0.42
2925,2021-01-20,PAT,291,73,218,279,12,ITH,ITH2,4,Provincia Autonoma Trento,P.A. Trento,541380,167040,30.85,0.05
2926,2021-01-15,PAT,595,132,463,595,0,ITH,ITH2,4,Provincia Autonoma Trento,P.A. Trento,541380,167635,30.96,0.11
2927,2021-03-24,PAT,2376,940,1436,1556,820,ITH,ITH2,4,Provincia Autonoma Trento,P.A. Trento,541380,170011,31.4,0.44
2928,2021-05-13,PAT,3405,1579,1826,2304,1101,ITH,ITH2,4,Provincia Autonoma Trento,P.A. Trento,541380,173416,32.03,0.63
2929,2021-01-26,PAT,542,154,388,27,515,ITH,ITH2,4,Provincia Autonoma Trento,P.A. Trento,541380,173958,32.13,0.1
2930,2021-02-09,PAT,915,287,628,442,473,ITH,ITH2,4,Provincia Autonoma Trento,P.A. Trento,541380,174873,32.3,0.17
2931,2021-03-31,PAT,2567,983,1584,1710,857,ITH,ITH2,4,Provincia Autonoma Trento,P.A. Trento,541380,177440,32.78,0.47
2932,2021-03-01,PAT,1237,454,783,942,295,ITH,ITH2,4,Provincia Autonoma Trento,P.A. Trento,541380,178677,33.0,0.23
2933,2020-12-27,PAT,103,40,63,103,0,ITH,ITH2,4,Provincia Autonoma Trento,P.A. Trento,541380,178780,33.02,0.02
2934,2021-05-25,PAT,4686,2232,2454,1851,2835,ITH,ITH2,4,Provincia Autonoma Trento,P.A. Trento,541380,183466,33.89,0.87
2935,2021-02-14,PAT,246,186,60,11,235,ITH,ITH2,4,Provincia Autonoma Trento,P.A. Trento,541380,183712,33.93,0.05
2936,2021-05-27,PAT,3790,1762,2028,1084,2706,ITH,ITH2,4,Provincia Autonoma Trento,P.A. Trento,541380,187502,34.63,0.7
2937,2021-01-22,PAT,1668,433,1235,329,1339,ITH,ITH2,4,Provincia Autonoma Trento,P.A. Trento,541380,189170,34.94,0.31
2938,2021-03-27,PAT,1615,709,906,1363,252,ITH,ITH2,4,Provincia Autonoma Trento,P.A. Trento,541380,190785,35.24,0.3
2939,2021-02-05,PAT,802,272,530,283,519,ITH,ITH2,4,Provincia Autonoma Trento,P.A. Trento,541380,191587,35.39,0.15
2940,2021-01-05,PAT,709,232,477,709,0,ITH,ITH2,4,Provincia Autonoma Trento,P.A. Trento,541380,192296,35.52,0.13
2941,2021-01-19,PAT,405,77,328,405,0,ITH,ITH2,4,Provincia Autonoma Trento,P.A. Trento,541380,192701,35.59,0.07
2942,2021-03-10,PAT,2411,928,1483,1490,921,ITH,ITH2,4,Provincia Autonoma Trento,P.A. Trento,541380,195112,36.04,0.45
2943,2021-02-03,PAT,846,314,532,414,432,ITH,ITH2,4,Provincia Autonoma Trento,P.A. Trento,541380,195958,36.2,0.16
2944,2021-05-23,PAT,1952,993,959,447,1505,ITH,ITH2,4,Provincia Autonoma Trento,P.A. Trento,541380,197910,36.56,0.36
2945,2021-02-10,PAT,851,291,560,509,342,ITH,ITH2,4,Provincia Autonoma Trento,P.A. Trento,541380,198761,36.71,0.16
2946,2021-04-08,PAT,3114,1294,1820,1996,1118,ITH,ITH2,4,Provincia Autonoma Trento,P.A. Trento,541380,201875,37.29,0.58
2947,2021-04-10,PAT,2796,1307,1489,2003,793,ITH,ITH2,4,Provincia Autonoma Trento,P.A. Trento,541380,204671,37.81,0.52
2948,2020-12-31,PAT,1624,449,1175,1624,0,ITH,ITH2,4,Provincia Autonoma Trento,P.A. Trento,541380,206295,38.11,0.3
2949,2021-03-05,PAT,2244,703,1541,1678,566,ITH,ITH2,4,Provincia Autonoma Trento,P.A. Trento,541380,208539,38.52,0.41
2950,2021-04-17,PAT,2203,1120,1083,2146,57,ITH,ITH2,4,Provincia Autonoma Trento,P.A. Trento,541380,210742,38.93,0.41
2951,2021-02-12,PAT,1010,340,670,589,421,ITH,ITH2,4,Provincia Autonoma Trento,P.A. Trento,541380,211752,39.11,0.19
2952,2021-03-03,PAT,1656,622,1034,1139,517,ITH,ITH2,4,Provincia Autonoma Trento,P.A. Trento,541380,213408,39.42,0.31
2953,2021-05-08,PAT,3151,1721,1430,2734,417,ITH,ITH2,4,Provincia Autonoma Trento,P.A. Trento,541380,216559,40.0,0.58
2954,2021-04-27,PAT,3879,1865,2014,3812,67,ITH,ITH2,4,Provincia Autonoma Trento,P.A. Trento,541380,220438,40.72,0.72
2955,2021-05-04,PAT,4474,2422,2052,4384,90,ITH,ITH2,4,Provincia Autonoma Trento,P.A. Trento,541380,224912,41.54,0.83
2956,2021-03-08,PAT,1398,433,965,1045,353,ITH,ITH2,4,Provincia Autonoma Trento,P.A. Trento,541380,226310,41.8,0.26
2957,2021-03-15,PAT,1410,545,865,946,464,ITH,ITH2,4,Provincia Autonoma Trento,P.A. Trento,541380,227720,42.06,0.26
2958,2021-01-17,PAT,251,195,56,251,0,ITH,ITH2,4,Provincia Autonoma Trento,P.A. Trento,541380,227971,42.11,0.05
2959,2021-05-11,PAT,3688,1744,1944,2845,843,ITH,ITH2,4,Provincia Autonoma Trento,P.A. Trento,541380,231659,42.79,0.68
2960,2021-03-22,PAT,2305,973,1332,1430,875,ITH,ITH2,4,Provincia Autonoma Trento,P.A. Trento,541380,233964,43.22,0.43
2961,2021-01-24,PAT,547,276,271,224,323,ITH,ITH2,4,Provincia Autonoma Trento,P.A. Trento,541380,234511,43.32,0.1
2962,2021-01-31,PAT,75,15,60,1,74,ITH,ITH2,4,Provincia Autonoma Trento,P.A. Trento,541380,234586,43.33,0.01
2963,2021-01-03,PAT,492,160,332,492,0,ITH,ITH2,4,Provincia Autonoma Trento,P.A. Trento,541380,235078,43.42,0.09
2964,2021-02-22,PAT,745,259,486,661,84,ITH,ITH2,4,Provincia Autonoma Trento,P.A. Trento,541380,235823,43.56,0.14
2965,2021-05-18,PAT,4245,2008,2237,3403,842,ITH,ITH2,4,Provincia Autonoma Trento,P.A. Trento,541380,240068,44.34,0.78
2966,2021-03-29,PAT,2461,958,1503,1726,735,ITH,ITH2,4,Provincia Autonoma Trento,P.A. Trento,541380,242529,44.8,0.45
2967,2021-04-12,PAT,3087,1408,1679,2591,496,ITH,ITH2,4,Provincia Autonoma Trento,P.A. Trento,541380,245616,45.37,0.57
2968,2021-01-02,PAT,502,143,359,502,0,ITH,ITH2,4,Provincia Autonoma Trento,P.A. Trento,541380,246118,45.46,0.09
2969,2021-05-20,PAT,4979,2353,2626,3373,1606,ITH,ITH2,4,Provincia Autonoma Trento,P.A. Trento,541380,251097,46.38,0.92
2970,2021-03-17,PAT,2067,790,1277,1199,868,ITH,ITH2,4,Provincia Autonoma Trento,P.A. Trento,541380,253164,46.76,0.38
2971,2021-05-06,PAT,5505,2726,2779,4726,779,ITH,ITH2,4,Provincia Autonoma Trento,P.A. Trento,541380,258669,47.78,1.02
2972,2021-02-02,PAT,907,240,667,190,717,ITH,ITH2,4,Provincia Autonoma Trento,P.A. Trento,541380,259576,47.95,0.17
2973,2021-04-03,PAT,1138,471,667,971,167,ITH,ITH2,4,Provincia Autonoma Trento,P.A. Trento,541380,260714,48.16,0.21
2974,2021-04-24,PAT,3507,1682,1825,3494,13,ITH,ITH2,4,Provincia Autonoma Trento,P.A. Trento,541380,264221,48.81,0.65
2975,2021-02-19,PAT,928,358,570,869,59,ITH,ITH2,4,Provincia Autonoma Trento,P.A. Trento,541380,265149,48.98,0.17
2976,2021-02-28,PAT,242,121,121,242,0,ITH,ITH2,4,Provincia Autonoma Trento,P.A. Trento,541380,265391,49.02,0.04
2977,2021-05-16,PAT,1321,729,592,1083,238,ITH,ITH2,4,Provincia Autonoma Trento,P.A. Trento,541380,266712,49.27,0.24
2978,2021-04-15,PAT,3182,1437,1745,3028,154,ITH,ITH2,4,Provincia Autonoma Trento,P.A. Trento,541380,269894,49.85,0.59
2979,2021-04-29,PAT,4621,2232,2389,4412,209,ITH,ITH2,4,Provincia Autonoma Trento,P.A. Trento,541380,274515,50.71,0.85
2980,2021-02-24,PAT,1318,523,795,922,396,ITH,ITH2,4,Provincia Autonoma Trento,P.A. Trento,541380,275833,50.95,0.24
2981,2021-04-19,PAT,2622,1235,1387,2599,23,ITH,ITH2,4,Provincia Autonoma Trento,P.A. Trento,541380,278455,51.43,0.48
2982,2021-05-01,PAT,4837,2463,2374,4802,35,ITH,ITH2,4,Provincia Autonoma Trento,P.A. Trento,541380,283292,52.33,0.89
2983,2021-03-12,PAT,2506,936,1570,1701,805,ITH,ITH2,4,Provincia Autonoma Trento,P.A. Trento,541380,285798,52.79,0.46
2984,2021-01-21,PAT,352,95,257,228,124,ITH,ITH2,4,Provincia Autonoma Trento,P.A. Trento,541380,286150,52.86,0.07
2985,2021-01-07,PAT,1270,310,960,1270,0,ITH,ITH2,4,Provincia Autonoma Trento,P.A. Trento,541380,287420,53.09,0.23
2986,2021-02-21,PAT,155,92,63,43,112,ITH,ITH2,4,Provincia Autonoma Trento,P.A. Trento,541380,287575,53.12,0.03
2987,2021-05-15,PAT,1567,815,752,679,888,ITH,ITH2,4,Provincia Autonoma Trento,P.A. Trento,541380,289142,53.41,0.29
2988,2021-05-12,SIC,36867,17353,19514,21924,14943,ITG,ITG1,19,Sicilia,Sicilia,4999891,36867,0.74,0.74
2989,2021-02-20,SIC,7242,3726,3516,7000,242,ITG,ITG1,19,Sicilia,Sicilia,4999891,44109,0.88,0.14
2990,2021-04-25,SIC,21349,10182,11167,16373,4976,ITG,ITG1,19,Sicilia,Sicilia,4999891,65458,1.31,0.43
2991,2021-04-08,SIC,16796,8287,8509,8313,8483,ITG,ITG1,19,Sicilia,Sicilia,4999891,82254,1.65,0.34
2992,2021-02-03,SIC,6096,2853,3243,753,5343,ITG,ITG1,19,Sicilia,Sicilia,4999891,88350,1.77,0.12
2993,2020-12-28,SIC,211,126,85,211,0,ITG,ITG1,19,Sicilia,Sicilia,4999891,88561,1.77,0.0
2994,2021-03-23,SIC,21065,10076,10989,15411,5654,ITG,ITG1,19,Sicilia,Sicilia,4999891,109626,2.19,0.42
2995,2021-03-25,SIC,20580,9549,11031,15041,5539,ITG,ITG1,19,Sicilia,Sicilia,4999891,130206,2.6,0.41
2996,2021-05-28,SIC,50324,22465,27859,24302,26022,ITG,ITG1,19,Sicilia,Sicilia,4999891,180530,3.61,1.01
2997,2021-03-08,SIC,13551,5833,7718,10743,2808,ITG,ITG1,19,Sicilia,Sicilia,4999891,194081,3.88,0.27
2998,2021-02-18,SIC,5472,3152,2320,5044,428,ITG,ITG1,19,Sicilia,Sicilia,4999891,199553,3.99,0.11
2999,2021-05-14,SIC,52244,24469,27775,36397,15847,ITG,ITG1,19,Sicilia,Sicilia,4999891,251797,5.04,1.04
3000,2021-02-01,SIC,6072,2681,3391,301,5771,ITG,ITG1,19,Sicilia,Sicilia,4999891,257869,5.16,0.12
3001,2021-04-27,SIC,26419,12721,13698,15590,10829,ITG,ITG1,19,Sicilia,Sicilia,4999891,284288,5.69,0.53
3002,2021-01-30,SIC,7838,3571,4267,174,7664,ITG,ITG1,19,Sicilia,Sicilia,4999891,292126,5.84,0.16
3003,2021-04-04,SIC,6831,3329,3502,5539,1292,ITG,ITG1,19,Sicilia,Sicilia,4999891,298957,5.98,0.14
3004,2020-12-27,SIC,91,55,36,91,0,ITG,ITG1,19,Sicilia,Sicilia,4999891,299048,5.98,0.0
3005,2021-03-01,SIC,12958,6118,6840,11303,1655,ITG,ITG1,19,Sicilia,Sicilia,4999891,312006,6.24,0.26
3006,2021-04-30,SIC,35219,16458,18761,24015,11204,ITG,ITG1,19,Sicilia,Sicilia,4999891,347225,6.94,0.7
3007,2021-03-04,SIC,15198,6554,8644,11000,4198,ITG,ITG1,19,Sicilia,Sicilia,4999891,362423,7.25,0.3
3008,2021-05-07,SIC,36656,17313,19343,25026,11630,ITG,ITG1,19,Sicilia,Sicilia,4999891,399079,7.98,0.73
3009,2021-01-13,SIC,5266,2492,2774,5266,0,ITG,ITG1,19,Sicilia,Sicilia,4999891,404345,8.09,0.11
3010,2021-03-18,SIC,15602,7783,7819,9864,5738,ITG,ITG1,19,Sicilia,Sicilia,4999891,419947,8.4,0.31
3011,2021-04-23,SIC,28881,13844,15037,22934,5947,ITG,ITG1,19,Sicilia,Sicilia,4999891,448828,8.98,0.58
3012,2021-03-11,SIC,15456,6521,8935,12891,2565,ITG,ITG1,19,Sicilia,Sicilia,4999891,464284,9.29,0.31
3013,2021-01-20,SIC,835,427,408,574,261,ITG,ITG1,19,Sicilia,Sicilia,4999891,465119,9.3,0.02
3014,2021-01-27,SIC,7530,3838,3692,187,7343,ITG,ITG1,19,Sicilia,Sicilia,4999891,472649,9.45,0.15
3015,2021-01-16,SIC,2781,1198,1583,2781,0,ITG,ITG1,19,Sicilia,Sicilia,4999891,475430,9.51,0.06
3016,2021-04-09,SIC,20538,10003,10535,11389,9149,ITG,ITG1,19,Sicilia,Sicilia,4999891,495968,9.92,0.41
3017,2021-04-11,SIC,15341,7577,7764,8312,7029,ITG,ITG1,19,Sicilia,Sicilia,4999891,511309,10.23,0.31
3018,2020-12-30,SIC,175,102,73,175,0,ITG,ITG1,19,Sicilia,Sicilia,4999891,511484,10.23,0.0
3019,2021-03-06,SIC,12918,5166,7752,10015,2903,ITG,ITG1,19,Sicilia,Sicilia,4999891,524402,10.49,0.26
3020,2021-03-02,SIC,14870,6361,8509,12061,2809,ITG,ITG1,19,Sicilia,Sicilia,4999891,539272,10.79,0.3
3021,2021-01-04,SIC,8401,4189,4212,8401,0,ITG,ITG1,19,Sicilia,Sicilia,4999891,547673,10.95,0.17
3022,2021-04-28,SIC,29348,13766,15582,20267,9081,ITG,ITG1,19,Sicilia,Sicilia,4999891,577021,11.54,0.59
3023,2021-02-23,SIC,8911,4672,4239,8448,463,ITG,ITG1,19,Sicilia,Sicilia,4999891,585932,11.72,0.18
3024,2021-03-09,SIC,13164,5591,7573,10791,2373,ITG,ITG1,19,Sicilia,Sicilia,4999891,599096,11.98,0.26
3025,2021-01-11,SIC,5915,2597,3318,5915,0,ITG,ITG1,19,Sicilia,Sicilia,4999891,605011,12.1,0.12
3026,2021-01-18,SIC,1650,670,980,1495,155,ITG,ITG1,19,Sicilia,Sicilia,4999891,606661,12.13,0.03
3027,2021-03-14,SIC,8776,3928,4848,4942,3834,ITG,ITG1,19,Sicilia,Sicilia,4999891,615437,12.31,0.18
3028,2021-02-11,SIC,5322,2098,3224,4859,463,ITG,ITG1,19,Sicilia,Sicilia,4999891,620759,12.42,0.11
3029,2021-04-16,SIC,28747,14425,14322,20371,8376,ITG,ITG1,19,Sicilia,Sicilia,4999891,649506,12.99,0.57
3030,2021-02-25,SIC,10122,5249,4873,8956,1166,ITG,ITG1,19,Sicilia,Sicilia,4999891,659628,13.19,0.2
3031,2021-05-21,SIC,45730,21531,24199,24321,21409,ITG,ITG1,19,Sicilia,Sicilia,4999891,705358,14.11,0.91
3032,2021-05-26,SIC,44329,20672,23657,23864,20465,ITG,ITG1,19,Sicilia,Sicilia,4999891,749687,14.99,0.89
3033,2021-04-13,SIC,19917,9689,10228,11082,8835,ITG,ITG1,19,Sicilia,Sicilia,4999891,769604,15.39,0.4
3034,2021-04-20,SIC,19275,9079,10196,13936,5339,ITG,ITG1,19,Sicilia,Sicilia,4999891,788879,15.78,0.39
3035,2021-01-23,SIC,4297,2216,2081,217,4080,ITG,ITG1,19,Sicilia,Sicilia,4999891,793176,15.86,0.09
3036,2021-04-02,SIC,14012,6596,7416,9225,4787,ITG,ITG1,19,Sicilia,Sicilia,4999891,807188,16.14,0.28
3037,2021-01-06,SIC,6483,3410,3073,6483,0,ITG,ITG1,19,Sicilia,Sicilia,4999891,813671,16.27,0.13
3038,2021-02-10,SIC,4420,1813,2607,3999,421,ITG,ITG1,19,Sicilia,Sicilia,4999891,818091,16.36,0.09
3039,2021-04-01,SIC,14400,6675,7725,9684,4716,ITG,ITG1,19,Sicilia,Sicilia,4999891,832491,16.65,0.29
3040,2021-03-28,SIC,10931,5136,5795,6920,4011,ITG,ITG1,19,Sicilia,Sicilia,4999891,843422,16.87,0.22
3041,2021-04-06,SIC,17869,8541,9328,13544,4325,ITG,ITG1,19,Sicilia,Sicilia,4999891,861291,17.23,0.36
3042,2021-02-22,SIC,8014,4147,3867,7523,491,ITG,ITG1,19,Sicilia,Sicilia,4999891,869305,17.39,0.16
3043,2021-05-24,SIC,35411,17053,18358,15692,19719,ITG,ITG1,19,Sicilia,Sicilia,4999891,904716,18.09,0.71
3044,2021-05-17,SIC,32144,15467,16677,19347,12797,ITG,ITG1,19,Sicilia,Sicilia,4999891,936860,18.74,0.64
3045,2021-03-21,SIC,15207,7330,7877,11236,3971,ITG,ITG1,19,Sicilia,Sicilia,4999891,952067,19.04,0.3
3046,2021-02-04,SIC,6932,3187,3745,1455,5477,ITG,ITG1,19,Sicilia,Sicilia,4999891,958999,19.18,0.14
3047,2021-02-13,SIC,3097,1164,1933,2841,256,ITG,ITG1,19,Sicilia,Sicilia,4999891,962096,19.24,0.06
3048,2021-02-06,SIC,5015,2189,2826,1462,3553,ITG,ITG1,19,Sicilia,Sicilia,4999891,967111,19.34,0.1
3049,2021-01-01,SIC,815,437,378,815,0,ITG,ITG1,19,Sicilia,Sicilia,4999891,967926,19.36,0.02
3050,2021-02-27,SIC,12430,5561,6869,11226,1204,ITG,ITG1,19,Sicilia,Sicilia,4999891,980356,19.61,0.25
3051,2021-04-18,SIC,19724,9863,9861,15358,4366,ITG,ITG1,19,Sicilia,Sicilia,4999891,1000080,20.0,0.39
3052,2021-01-22,SIC,1253,634,619,243,1010,ITG,ITG1,19,Sicilia,Sicilia,4999891,1001333,20.03,0.03
3053,2021-01-08,SIC,8334,3867,4467,8334,0,ITG,ITG1,19,Sicilia,Sicilia,4999891,1009667,20.19,0.17
3054,2021-05-02,SIC,24658,11447,13211,18057,6601,ITG,ITG1,19,Sicilia,Sicilia,4999891,1034325,20.69,0.49
3055,2021-05-16,SIC,33112,16125,16987,21785,11327,ITG,ITG1,19,Sicilia,Sicilia,4999891,1067437,21.35,0.66
3056,2021-03-20,SIC,18814,9031,9783,13489,5325,ITG,ITG1,19,Sicilia,Sicilia,4999891,1086251,21.73,0.38
3057,2021-05-09,SIC,28133,13159,14974,19862,8271,ITG,ITG1,19,Sicilia,Sicilia,4999891,1114384,22.29,0.56
3058,2021-02-24,SIC,9561,4850,4711,8971,590,ITG,ITG1,19,Sicilia,Sicilia,4999891,1123945,22.48,0.19
3059,2021-04-29,SIC,31677,14762,16915,22330,9347,ITG,ITG1,19,Sicilia,Sicilia,4999891,1155622,23.11,0.63
3060,2021-05-08,SIC,35748,17073,18675,25432,10316,ITG,ITG1,19,Sicilia,Sicilia,4999891,1191370,23.83,0.71
3061,2021-01-26,SIC,9482,4667,4815,261,9221,ITG,ITG1,19,Sicilia,Sicilia,4999891,1200852,24.02,0.19
3062,2021-01-21,SIC,1370,668,702,500,870,ITG,ITG1,19,Sicilia,Sicilia,4999891,1202222,24.04,0.03
3063,2021-03-26,SIC,18021,8372,9649,12490,5531,ITG,ITG1,19,Sicilia,Sicilia,4999891,1220243,24.41,0.36
3064,2021-01-15,SIC,5088,2236,2852,5088,0,ITG,ITG1,19,Sicilia,Sicilia,4999891,1225331,24.51,0.1
3065,2020-12-29,SIC,238,148,90,238,0,ITG,ITG1,19,Sicilia,Sicilia,4999891,1225569,24.51,0.0
3066,2021-04-10,SIC,20662,10083,10579,11620,9042,ITG,ITG1,19,Sicilia,Sicilia,4999891,1246231,24.93,0.41
3067,2021-03-24,SIC,21144,9907,11237,15307,5837,ITG,ITG1,19,Sicilia,Sicilia,4999891,1267375,25.35,0.42
3068,2021-01-17,SIC,1302,589,713,1245,57,ITG,ITG1,19,Sicilia,Sicilia,4999891,1268677,25.37,0.03
3069,2021-03-22,SIC,16817,7915,8902,11274,5543,ITG,ITG1,19,Sicilia,Sicilia,4999891,1285494,25.71,0.34
3070,2021-03-05,SIC,15883,6841,9042,11565,4318,ITG,ITG1,19,Sicilia,Sicilia,4999891,1301377,26.03,0.32
3071,2020-12-31,SIC,879,470,409,879,0,ITG,ITG1,19,Sicilia,Sicilia,4999891,1302256,26.05,0.02
3072,2021-02-16,SIC,4370,2282,2088,3905,465,ITG,ITG1,19,Sicilia,Sicilia,4999891,1306626,26.13,0.09
3073,2021-05-05,SIC,26304,12178,14126,16709,9595,ITG,ITG1,19,Sicilia,Sicilia,4999891,1332930,26.66,0.53
3074,2021-01-25,SIC,7517,3697,3820,313,7204,ITG,ITG1,19,Sicilia,Sicilia,4999891,1340447,26.81,0.15
3075,2021-05-19,SIC,42705,20585,22120,28407,14298,ITG,ITG1,19,Sicilia,Sicilia,4999891,1383152,27.66,0.85
3076,2021-03-16,SIC,9788,4365,5423,3670,6118,ITG,ITG1,19,Sicilia,Sicilia,4999891,1392940,27.86,0.2
3077,2021-02-08,SIC,4086,1760,2326,2129,1957,ITG,ITG1,19,Sicilia,Sicilia,4999891,1397026,27.94,0.08
3078,2021-03-30,SIC,14595,6759,7836,9770,4825,ITG,ITG1,19,Sicilia,Sicilia,4999891,1411621,28.23,0.29
3079,2021-02-07,SIC,2342,994,1348,674,1668,ITG,ITG1,19,Sicilia,Sicilia,4999891,1413963,28.28,0.05
3080,2021-05-25,SIC,33172,15022,18150,13966,19206,ITG,ITG1,19,Sicilia,Sicilia,4999891,1447135,28.94,0.66
3081,2021-04-12,SIC,18951,9204,9747,11611,7340,ITG,ITG1,19,Sicilia,Sicilia,4999891,1466086,29.32,0.38
3082,2021-02-21,SIC,5168,2501,2667,5062,106,ITG,ITG1,19,Sicilia,Sicilia,4999891,1471254,29.43,0.1
3083,2021-05-27,SIC,47287,21548,25739,24902,22385,ITG,ITG1,19,Sicilia,Sicilia,4999891,1518541,30.37,0.95
3084,2021-04-14,SIC,20291,9798,10493,11507,8784,ITG,ITG1,19,Sicilia,Sicilia,4999891,1538832,30.78,0.41
3085,2021-04-21,SIC,22678,10883,11795,16461,6217,ITG,ITG1,19,Sicilia,Sicilia,4999891,1561510,31.23,0.45
3086,2021-04-07,SIC,15559,7636,7923,8395,7164,ITG,ITG1,19,Sicilia,Sicilia,4999891,1577069,31.54,0.31
3087,2021-02-19,SIC,5129,2732,2397,4562,567,ITG,ITG1,19,Sicilia,Sicilia,4999891,1582198,31.64,0.1
3088,2021-04-24,SIC,31335,14797,16538,23595,7740,ITG,ITG1,19,Sicilia,Sicilia,4999891,1613533,32.27,0.63
3089,2021-01-14,SIC,5261,2521,2740,5261,0,ITG,ITG1,19,Sicilia,Sicilia,4999891,1618794,32.38,0.11
3090,2021-04-26,SIC,21922,10375,11547,13784,8138,ITG,ITG1,19,Sicilia,Sicilia,4999891,1640716,32.82,0.44
3091,2021-05-04,SIC,26820,12463,14357,17634,9186,ITG,ITG1,19,Sicilia,Sicilia,4999891,1667536,33.35,0.54
3092,2021-02-28,SIC,7167,3064,4103,6537,630,ITG,ITG1,19,Sicilia,Sicilia,4999891,1674703,33.49,0.14
3093,2021-02-15,SIC,3927,1818,2109,3362,565,ITG,ITG1,19,Sicilia,Sicilia,4999891,1678630,33.57,0.08
3094,2021-01-03,SIC,4703,2459,2244,4703,0,ITG,ITG1,19,Sicilia,Sicilia,4999891,1683333,33.67,0.09
3095,2021-01-10,SIC,3622,1616,2006,3622,0,ITG,ITG1,19,Sicilia,Sicilia,4999891,1686955,33.74,0.07
3096,2021-04-15,SIC,21357,10387,10970,11800,9557,ITG,ITG1,19,Sicilia,Sicilia,4999891,1708312,34.17,0.43
3097,2021-04-22,SIC,27112,12809,14303,20571,6541,ITG,ITG1,19,Sicilia,Sicilia,4999891,1735424,34.71,0.54
3098,2021-01-05,SIC,10537,5162,5375,10537,0,ITG,ITG1,19,Sicilia,Sicilia,4999891,1745961,34.92,0.21
3099,2021-03-10,SIC,13943,5954,7989,11558,2385,ITG,ITG1,19,Sicilia,Sicilia,4999891,1759904,35.2,0.28
3100,2021-01-12,SIC,4546,2235,2311,4546,0,ITG,ITG1,19,Sicilia,Sicilia,4999891,1764450,35.29,0.09
3101,2021-05-11,SIC,32440,15427,17013,19898,12542,ITG,ITG1,19,Sicilia,Sicilia,4999891,1796890,35.94,0.65
3102,2021-02-17,SIC,5414,3279,2135,4745,669,ITG,ITG1,19,Sicilia,Sicilia,4999891,1802304,36.05,0.11
3103,2021-05-13,SIC,47396,22238,25158,30798,16598,ITG,ITG1,19,Sicilia,Sicilia,4999891,1849700,36.99,0.95
3104,2021-01-31,SIC,4109,1959,2150,113,3996,ITG,ITG1,19,Sicilia,Sicilia,4999891,1853809,37.08,0.08
3105,2021-02-02,SIC,5535,2620,2915,629,4906,ITG,ITG1,19,Sicilia,Sicilia,4999891,1859344,37.19,0.11
3106,2021-03-07,SIC,9267,3456,5811,8184,1083,ITG,ITG1,19,Sicilia,Sicilia,4999891,1868611,37.37,0.19
3107,2021-02-05,SIC,7102,3158,3944,2128,4974,ITG,ITG1,19,Sicilia,Sicilia,4999891,1875713,37.52,0.14
3108,2021-04-03,SIC,16364,7782,8582,13528,2836,ITG,ITG1,19,Sicilia,Sicilia,4999891,1892077,37.84,0.33
3109,2021-03-27,SIC,15751,7437,8314,10838,4913,ITG,ITG1,19,Sicilia,Sicilia,4999891,1907828,38.16,0.32
3110,2021-01-29,SIC,9354,4316,5038,425,8929,ITG,ITG1,19,Sicilia,Sicilia,4999891,1917182,38.34,0.19
3111,2021-05-23,SIC,34139,16615,17524,20111,14028,ITG,ITG1,19,Sicilia,Sicilia,4999891,1951321,39.03,0.68
3112,2021-02-12,SIC,4676,1849,2827,4408,268,ITG,ITG1,19,Sicilia,Sicilia,4999891,1955997,39.12,0.09
3113,2021-03-13,SIC,12417,5475,6942,7834,4583,ITG,ITG1,19,Sicilia,Sicilia,4999891,1968414,39.37,0.25
3114,2021-04-17,SIC,26189,13226,12963,19037,7152,ITG,ITG1,19,Sicilia,Sicilia,4999891,1994603,39.89,0.52
3115,2021-02-26,SIC,12207,5966,6241,10523,1684,ITG,ITG1,19,Sicilia,Sicilia,4999891,2006810,40.14,0.24
3116,2021-01-07,SIC,9188,4249,4939,9188,0,ITG,ITG1,19,Sicilia,Sicilia,4999891,2015998,40.32,0.18
3117,2021-05-18,SIC,36143,17307,18836,23555,12588,ITG,ITG1,19,Sicilia,Sicilia,4999891,2052141,41.04,0.72
3118,2021-03-29,SIC,15004,7036,7968,10488,4516,ITG,ITG1,19,Sicilia,Sicilia,4999891,2067145,41.34,0.3
3119,2021-04-05,SIC,8024,3959,4065,6584,1440,ITG,ITG1,19,Sicilia,Sicilia,4999891,2075169,41.5,0.16
3120,2021-02-14,SIC,1058,403,655,918,140,ITG,ITG1,19,Sicilia,Sicilia,4999891,2076227,41.53,0.02
3121,2021-01-02,SIC,4882,2539,2343,4882,0,ITG,ITG1,19,Sicilia,Sicilia,4999891,2081109,41.62,0.1
3122,2021-01-19,SIC,1298,539,759,1096,202,ITG,ITG1,19,Sicilia,Sicilia,4999891,2082407,41.65,0.03
3123,2021-03-03,SIC,14668,6524,8144,11580,3088,ITG,ITG1,19,Sicilia,Sicilia,4999891,2097075,41.94,0.29
3124,2021-05-01,SIC,24474,11326,13148,19316,5158,ITG,ITG1,19,Sicilia,Sicilia,4999891,2121549,42.43,0.49
3125,2021-05-10,SIC,28305,13596,14709,16187,12118,ITG,ITG1,19,Sicilia,Sicilia,4999891,2149854,43.0,0.57
3126,2021-01-28,SIC,9317,4396,4921,405,8912,ITG,ITG1,19,Sicilia,Sicilia,4999891,2159171,43.18,0.19
3127,2021-03-15,SIC,10817,4715,6102,5752,5065,ITG,ITG1,19,Sicilia,Sicilia,4999891,2169988,43.4,0.22
3128,2021-01-24,SIC,4307,2251,2056,142,4165,ITG,ITG1,19,Sicilia,Sicilia,4999891,2174295,43.49,0.09
3129,2021-04-19,SIC,18473,8737,9736,12766,5707,ITG,ITG1,19,Sicilia,Sicilia,4999891,2192768,43.86,0.37
3130,2021-05-22,SIC,48204,22882,25322,28704,19500,ITG,ITG1,19,Sicilia,Sicilia,4999891,2240972,44.82,0.96
3131,2021-03-12,SIC,13110,5610,7500,10894,2216,ITG,ITG1,19,Sicilia,Sicilia,4999891,2254082,45.08,0.26
3132,2021-05-15,SIC,57101,26671,30430,41722,15379,ITG,ITG1,19,Sicilia,Sicilia,4999891,2311183,46.22,1.14
3133,2021-03-19,SIC,16517,8114,8403,10786,5731,ITG,ITG1,19,Sicilia,Sicilia,4999891,2327700,46.56,0.33
3134,2021-03-17,SIC,15161,7459,7702,9249,5912,ITG,ITG1,19,Sicilia,Sicilia,4999891,2342861,46.86,0.3
3135,2021-05-06,SIC,29006,13726,15280,18424,10582,ITG,ITG1,19,Sicilia,Sicilia,4999891,2371867,47.44,0.58
3136,2021-03-31,SIC,14606,6750,7856,9578,5028,ITG,ITG1,19,Sicilia,Sicilia,4999891,2386473,47.73,0.29
3137,2021-05-20,SIC,43476,20765,22711,27636,15840,ITG,ITG1,19,Sicilia,Sicilia,4999891,2429949,48.6,0.87
3138,2021-02-09,SIC,4412,1823,2589,3357,1055,ITG,ITG1,19,Sicilia,Sicilia,4999891,2434361,48.69,0.09
3139,2021-01-09,SIC,7327,3425,3902,7327,0,ITG,ITG1,19,Sicilia,Sicilia,4999891,2441688,48.83,0.15
3140,2021-05-03,SIC,23460,10821,12639,13576,9884,ITG,ITG1,19,Sicilia,Sicilia,4999891,2465148,49.3,0.47
