,data,area,Vaccinazioni giornaliere,sesso_maschile,sesso_femminile,Operatori sanitari - sociosanitari,Personale non sanitario,Ospiti RSA,categoria_over80,categoria_forze_armate,categoria_personale_scolastico,prima_dose,seconda_dose,codice_NUTS1,codice_NUTS2,codice_regione_ISTAT,nome_area,Regione,popolazione,Totale vaccinazioni,Totale vaccinazioni ogni cento ab,Vaccinazioni giornaliere ogni cento ab
0,2021-03-03,LAZ,17018,7197,9821,2097,1374,374,7987,1249,3937,12728,4290,ITI,ITI4,12,Lazio,Lazio,5879082,17018,0.29,0.29
1,2021-03-01,LAZ,16616,7102,9514,1551,1736,383,7961,1406,3579,12766,3850,ITI,ITI4,12,Lazio,Lazio,5879082,33634,0.57,0.28
2,2021-02-16,LAZ,8043,3862,4181,2058,578,261,4195,950,1,7786,257,ITI,ITI4,12,Lazio,Lazio,5879082,41677,0.71,0.14
3,2021-01-06,LAZ,5096,1951,3145,4619,155,320,0,1,1,5096,0,ITI,ITI4,12,Lazio,Lazio,5879082,46773,0.8,0.09
4,2021-03-14,LAZ,16986,6572,10414,1319,3382,81,8313,445,3446,11852,5134,ITI,ITI4,12,Lazio,Lazio,5879082,63759,1.08,0.29
5,2021-02-23,LAZ,10896,4678,6218,1896,602,309,5164,1015,1910,10272,624,ITI,ITI4,12,Lazio,Lazio,5879082,74655,1.27,0.19
6,2021-01-29,LAZ,7594,2866,4728,6373,427,704,90,0,0,477,7117,ITI,ITI4,12,Lazio,Lazio,5879082,82249,1.4,0.13
7,2021-02-28,LAZ,10223,3996,6227,1601,688,77,4576,682,2599,9709,514,ITI,ITI4,12,Lazio,Lazio,5879082,92472,1.57,0.17
8,2021-02-11,LAZ,6657,2788,3869,2196,334,500,3627,0,0,6459,198,ITI,ITI4,12,Lazio,Lazio,5879082,99129,1.69,0.11
9,2021-01-27,LAZ,5768,2170,3598,4797,385,457,129,0,0,651,5117,ITI,ITI4,12,Lazio,Lazio,5879082,104897,1.78,0.1
10,2021-02-10,LAZ,7774,3114,4660,2646,581,633,3914,0,0,4839,2935,ITI,ITI4,12,Lazio,Lazio,5879082,112671,1.92,0.13
11,2021-01-31,LAZ,4279,1783,2496,3572,339,244,124,0,0,296,3983,ITI,ITI4,12,Lazio,Lazio,5879082,116950,1.99,0.07
12,2021-01-20,LAZ,4390,1657,2733,3279,399,426,286,0,0,2849,1541,ITI,ITI4,12,Lazio,Lazio,5879082,121340,2.06,0.07
13,2021-03-02,LAZ,16528,7149,9379,1808,1421,229,8038,1278,3754,12599,3929,ITI,ITI4,12,Lazio,Lazio,5879082,137868,2.35,0.28
14,2021-01-10,LAZ,4039,1700,2339,3424,363,252,0,0,0,4039,0,ITI,ITI4,12,Lazio,Lazio,5879082,141907,2.41,0.07
15,2021-01-24,LAZ,5467,2109,3358,4945,262,134,126,0,0,385,5082,ITI,ITI4,12,Lazio,Lazio,5879082,147374,2.51,0.09
16,2021-01-28,LAZ,7954,2998,4956,6810,496,514,134,0,0,459,7495,ITI,ITI4,12,Lazio,Lazio,5879082,155328,2.64,0.14
17,2021-01-30,LAZ,6649,2730,3919,5298,574,651,126,0,0,448,6201,ITI,ITI4,12,Lazio,Lazio,5879082,161977,2.76,0.11
18,2021-01-11,LAZ,5525,2103,3422,4553,403,569,0,0,0,5525,0,ITI,ITI4,12,Lazio,Lazio,5879082,167502,2.85,0.09
19,2021-03-07,LAZ,14020,5404,8616,1200,1229,148,7214,696,3533,10431,3589,ITI,ITI4,12,Lazio,Lazio,5879082,181522,3.09,0.24
20,2021-01-13,LAZ,5559,2063,3496,4145,402,1009,3,0,0,5559,0,ITI,ITI4,12,Lazio,Lazio,5879082,187081,3.18,0.09
21,2021-02-12,LAZ,6494,2645,3849,1995,423,302,3774,0,0,6417,77,ITI,ITI4,12,Lazio,Lazio,5879082,193575,3.29,0.11
22,2021-01-25,LAZ,7761,3041,4720,7006,270,363,122,0,0,421,7340,ITI,ITI4,12,Lazio,Lazio,5879082,201336,3.42,0.13
23,2021-02-26,LAZ,12864,5600,7264,1909,1333,352,5146,1385,2739,11646,1218,ITI,ITI4,12,Lazio,Lazio,5879082,214200,3.64,0.22
24,2021-02-17,LAZ,8808,4371,4437,2282,432,499,4249,1345,1,8280,528,ITI,ITI4,12,Lazio,Lazio,5879082,223008,3.79,0.15
25,2021-01-01,LAZ,3553,1381,2172,3483,2,68,0,0,0,3553,0,ITI,ITI4,12,Lazio,Lazio,5879082,226561,3.85,0.06
26,2021-03-12,LAZ,22537,9964,12573,4614,3421,400,9380,774,3948,16226,6311,ITI,ITI4,12,Lazio,Lazio,5879082,249098,4.24,0.38
27,2021-01-12,LAZ,5391,1974,3417,4343,464,584,0,0,0,5391,0,ITI,ITI4,12,Lazio,Lazio,5879082,254489,4.33,0.09
28,2021-01-23,LAZ,6883,2682,4201,6063,278,417,125,0,0,255,6628,ITI,ITI4,12,Lazio,Lazio,5879082,261372,4.45,0.12
29,2021-01-16,LAZ,5345,2072,3273,3350,461,1064,470,0,0,5345,0,ITI,ITI4,12,Lazio,Lazio,5879082,266717,4.54,0.09
30,2021-02-14,LAZ,5536,2246,3290,1645,318,127,3446,0,0,5287,249,ITI,ITI4,12,Lazio,Lazio,5879082,272253,4.63,0.09
31,2021-01-15,LAZ,6223,2465,3758,4476,604,988,155,0,0,6223,0,ITI,ITI4,12,Lazio,Lazio,5879082,278476,4.74,0.11
32,2021-02-21,LAZ,6799,3101,3698,1245,362,51,4518,607,16,6517,282,ITI,ITI4,12,Lazio,Lazio,5879082,285275,4.85,0.12
33,2021-03-08,LAZ,19822,8196,11626,2421,2181,379,9031,1102,4708,14560,5262,ITI,ITI4,12,Lazio,Lazio,5879082,305097,5.19,0.34
34,2021-02-13,LAZ,6274,2436,3838,2123,213,280,3658,0,0,6186,88,ITI,ITI4,12,Lazio,Lazio,5879082,311371,5.3,0.11
35,2021-03-18,LAZ,13985,5998,7987,1734,2705,330,9201,9,6,7657,6328,ITI,ITI4,12,Lazio,Lazio,5879082,325356,5.53,0.24
36,2021-02-25,LAZ,12618,5509,7109,1754,1209,489,5132,1423,2611,11572,1046,ITI,ITI4,12,Lazio,Lazio,5879082,337974,5.75,0.21
37,2021-01-26,LAZ,7602,2907,4695,6590,256,631,125,0,0,372,7230,ITI,ITI4,12,Lazio,Lazio,5879082,345576,5.88,0.13
38,2021-03-15,LAZ,19130,8280,10850,2291,3663,408,9536,706,2526,12438,6692,ITI,ITI4,12,Lazio,Lazio,5879082,364706,6.2,0.33
39,2021-02-27,LAZ,11368,4246,7122,1358,885,515,4787,1120,2703,10415,953,ITI,ITI4,12,Lazio,Lazio,5879082,376074,6.4,0.19
40,2021-02-07,LAZ,4668,1865,2803,3251,385,218,813,0,1,382,4286,ITI,ITI4,12,Lazio,Lazio,5879082,380742,6.48,0.08
41,2021-02-08,LAZ,9334,3868,5466,3788,874,918,3754,0,0,4487,4847,ITI,ITI4,12,Lazio,Lazio,5879082,390076,6.63,0.16
42,2021-01-09,LAZ,6288,2556,3732,5110,558,620,0,0,0,6288,0,ITI,ITI4,12,Lazio,Lazio,5879082,396364,6.74,0.11
43,2021-02-22,LAZ,11413,4974,6439,1778,309,472,5242,1390,2222,10912,501,ITI,ITI4,12,Lazio,Lazio,5879082,407777,6.94,0.19
44,2021-02-24,LAZ,11974,5178,6796,1797,936,337,5177,1327,2400,10985,989,ITI,ITI4,12,Lazio,Lazio,5879082,419751,7.14,0.2
45,2021-03-20,LAZ,17502,6499,11003,1758,3767,360,8710,3,2904,11698,5804,ITI,ITI4,12,Lazio,Lazio,5879082,437253,7.44,0.3
46,2021-03-16,LAZ,13352,5668,7684,1470,2200,280,9390,7,5,6978,6374,ITI,ITI4,12,Lazio,Lazio,5879082,450605,7.66,0.23
47,2020-12-30,LAZ,1630,629,1001,1603,0,27,0,0,0,1630,0,ITI,ITI4,12,Lazio,Lazio,5879082,452235,7.69,0.03
48,2021-03-13,LAZ,21178,8311,12867,5057,2486,325,8851,720,3739,15292,5886,ITI,ITI4,12,Lazio,Lazio,5879082,473413,8.05,0.36
49,2021-01-03,LAZ,5250,1972,3278,5125,60,65,0,0,0,5250,0,ITI,ITI4,12,Lazio,Lazio,5879082,478663,8.14,0.09
50,2021-02-03,LAZ,6288,2348,3940,4620,555,1078,35,0,0,901,5387,ITI,ITI4,12,Lazio,Lazio,5879082,484951,8.25,0.11
51,2021-02-06,LAZ,5069,2015,3054,3270,630,660,509,0,0,769,4300,ITI,ITI4,12,Lazio,Lazio,5879082,490020,8.33,0.09
52,2021-01-19,LAZ,4361,1671,2690,2967,562,424,408,0,0,3908,453,ITI,ITI4,12,Lazio,Lazio,5879082,494381,8.41,0.07
53,2020-12-28,LAZ,959,412,547,957,2,0,0,0,0,959,0,ITI,ITI4,12,Lazio,Lazio,5879082,495340,8.43,0.02
54,2021-01-05,LAZ,7370,2802,4568,6690,102,577,0,1,0,7370,0,ITI,ITI4,12,Lazio,Lazio,5879082,502710,8.55,0.13
55,2021-03-19,LAZ,16340,6926,9414,2014,3767,385,9147,67,960,10135,6205,ITI,ITI4,12,Lazio,Lazio,5879082,519050,8.83,0.28
56,2021-03-10,LAZ,21733,9350,12383,3996,2627,451,8863,1179,4617,16108,5625,ITI,ITI4,12,Lazio,Lazio,5879082,540783,9.2,0.37
57,2021-01-17,LAZ,4555,1841,2714,3231,336,177,811,0,0,4343,212,ITI,ITI4,12,Lazio,Lazio,5879082,545338,9.28,0.08
58,2020-12-29,LAZ,440,155,285,440,0,0,0,0,0,440,0,ITI,ITI4,12,Lazio,Lazio,5879082,545778,9.28,0.01
59,2021-01-02,LAZ,6704,2629,4075,6268,78,358,0,0,0,6704,0,ITI,ITI4,12,Lazio,Lazio,5879082,552482,9.4,0.11
60,2021-03-09,LAZ,20740,8894,11846,3359,2290,338,8906,1230,4617,15549,5191,ITI,ITI4,12,Lazio,Lazio,5879082,573222,9.75,0.35
61,2021-01-14,LAZ,5232,1961,3271,3887,450,811,84,0,0,5232,0,ITI,ITI4,12,Lazio,Lazio,5879082,578454,9.84,0.09
62,2021-03-04,LAZ,18172,7736,10436,2771,1552,507,8122,1315,3905,13167,5005,ITI,ITI4,12,Lazio,Lazio,5879082,596626,10.15,0.31
63,2021-03-21,LAZ,8271,3120,5151,308,1730,55,4477,0,1701,5611,2660,ITI,ITI4,12,Lazio,Lazio,5879082,604897,10.29,0.14
64,2021-03-05,LAZ,18493,7800,10693,2724,1745,256,8476,1323,3969,13772,4721,ITI,ITI4,12,Lazio,Lazio,5879082,623390,10.6,0.31
65,2021-02-04,LAZ,6045,2281,3764,4460,621,892,72,0,0,942,5103,ITI,ITI4,12,Lazio,Lazio,5879082,629435,10.71,0.1
66,2021-01-22,LAZ,3662,1442,2220,3379,90,70,123,0,0,148,3514,ITI,ITI4,12,Lazio,Lazio,5879082,633097,10.77,0.06
67,2021-01-18,LAZ,5835,2268,3567,3901,756,725,453,0,0,4857,978,ITI,ITI4,12,Lazio,Lazio,5879082,638932,10.87,0.1
68,2021-02-18,LAZ,9676,4799,4877,2162,419,473,4956,1665,1,9178,498,ITI,ITI4,12,Lazio,Lazio,5879082,648608,11.03,0.16
69,2021-02-19,LAZ,9698,4893,4805,2170,390,408,5060,1636,34,9201,497,ITI,ITI4,12,Lazio,Lazio,5879082,658306,11.2,0.16
70,2021-01-04,LAZ,7478,2907,4571,7075,86,316,0,0,1,7478,0,ITI,ITI4,12,Lazio,Lazio,5879082,665784,11.32,0.13
71,2021-02-01,LAZ,5669,2173,3496,4784,319,559,7,0,0,353,5316,ITI,ITI4,12,Lazio,Lazio,5879082,671453,11.42,0.1
72,2021-01-07,LAZ,7724,2894,4830,6881,277,566,0,0,0,7724,0,ITI,ITI4,12,Lazio,Lazio,5879082,679177,11.55,0.13
73,2021-03-11,LAZ,23562,10488,13074,4811,3136,440,9213,1526,4436,17342,6220,ITI,ITI4,12,Lazio,Lazio,5879082,702739,11.95,0.4
74,2021-02-20,LAZ,8795,4082,4713,1942,461,298,4762,1310,22,8378,417,ITI,ITI4,12,Lazio,Lazio,5879082,711534,12.1,0.15
75,2021-02-05,LAZ,6910,2722,4188,5095,631,995,189,0,0,1131,5779,ITI,ITI4,12,Lazio,Lazio,5879082,718444,12.22,0.12
76,2021-02-15,LAZ,7726,3379,4347,2447,675,378,4218,8,0,7429,297,ITI,ITI4,12,Lazio,Lazio,5879082,726170,12.35,0.13
77,2021-01-21,LAZ,5247,2109,3138,4780,110,232,125,0,0,196,5051,ITI,ITI4,12,Lazio,Lazio,5879082,731417,12.44,0.09
78,2021-02-02,LAZ,5772,2133,3639,4712,486,571,3,0,0,501,5271,ITI,ITI4,12,Lazio,Lazio,5879082,737189,12.54,0.1
79,2020-12-27,LAZ,272,131,141,272,0,0,0,0,0,272,0,ITI,ITI4,12,Lazio,Lazio,5879082,737461,12.54,0.0
80,2021-01-08,LAZ,7707,2887,4820,6517,392,798,0,0,0,7707,0,ITI,ITI4,12,Lazio,Lazio,5879082,745168,12.67,0.13
81,2021-02-09,LAZ,8393,3484,4909,3258,582,548,4005,0,0,4571,3822,ITI,ITI4,12,Lazio,Lazio,5879082,753561,12.82,0.14
82,2020-12-31,LAZ,5218,2095,3123,4927,12,279,0,0,0,5218,0,ITI,ITI4,12,Lazio,Lazio,5879082,758779,12.91,0.09
83,2021-03-17,LAZ,13352,5713,7639,1480,2313,251,9287,7,14,7193,6159,ITI,ITI4,12,Lazio,Lazio,5879082,772131,13.13,0.23
84,2021-03-06,LAZ,17936,6887,11049,3652,1363,327,7890,932,3772,13682,4254,ITI,ITI4,12,Lazio,Lazio,5879082,790067,13.44,0.31
85,2021-03-21,LIG,134,56,78,1,6,0,127,0,0,32,102,ITC,ITC3,7,Liguria,Liguria,1550640,134,0.01,0.01
86,2021-02-27,LIG,1887,920,967,139,540,5,1203,0,0,1758,129,ITC,ITC3,7,Liguria,Liguria,1550640,2021,0.13,0.12
87,2021-02-25,LIG,3438,1346,2092,550,213,88,2584,2,1,3309,129,ITC,ITC3,7,Liguria,Liguria,1550640,5459,0.35,0.22
88,2020-12-28,LIG,80,30,50,77,3,0,0,0,0,80,0,ITC,ITC3,7,Liguria,Liguria,1550640,5539,0.36,0.01
89,2021-01-05,LIG,2878,896,1982,2307,303,261,0,0,7,2878,0,ITC,ITC3,7,Liguria,Liguria,1550640,8417,0.54,0.19
90,2021-01-15,LIG,2245,751,1494,1323,408,512,0,0,2,2245,0,ITC,ITC3,7,Liguria,Liguria,1550640,10662,0.69,0.14
91,2021-01-07,LIG,3166,1076,2090,2313,420,428,0,1,4,3166,0,ITC,ITC3,7,Liguria,Liguria,1550640,13828,0.89,0.2
92,2021-01-08,LIG,2926,999,1927,2084,406,431,0,1,4,2926,0,ITC,ITC3,7,Liguria,Liguria,1550640,16754,1.08,0.19
93,2020-12-29,LIG,125,33,92,93,11,21,0,0,0,125,0,ITC,ITC3,7,Liguria,Liguria,1550640,16879,1.09,0.01
94,2021-02-11,LIG,1952,757,1195,1233,258,455,0,0,6,1091,861,ITC,ITC3,7,Liguria,Liguria,1550640,18831,1.21,0.13
95,2021-01-20,LIG,1450,529,921,693,330,425,0,0,2,1438,12,ITC,ITC3,7,Liguria,Liguria,1550640,20281,1.31,0.09
96,2021-01-28,LIG,2840,968,1872,2237,288,309,0,1,5,40,2800,ITC,ITC3,7,Liguria,Liguria,1550640,23121,1.49,0.18
97,2021-01-12,LIG,2393,862,1531,1726,269,396,0,0,2,2393,0,ITC,ITC3,7,Liguria,Liguria,1550640,25514,1.65,0.15
98,2021-02-08,LIG,1858,716,1142,1224,385,242,0,0,7,306,1552,ITC,ITC3,7,Liguria,Liguria,1550640,27372,1.77,0.12
99,2020-12-27,LIG,135,56,79,88,2,45,0,0,0,135,0,ITC,ITC3,7,Liguria,Liguria,1550640,27507,1.77,0.01
100,2021-01-24,LIG,755,236,519,632,63,60,0,0,0,113,642,ITC,ITC3,7,Liguria,Liguria,1550640,28262,1.82,0.05
101,2021-03-10,LIG,5693,2752,2941,814,786,85,3602,405,1,3796,1897,ITC,ITC3,7,Liguria,Liguria,1550640,33955,2.19,0.37
102,2021-03-08,LIG,5579,2440,3139,1121,526,80,3539,306,7,3894,1685,ITC,ITC3,7,Liguria,Liguria,1550640,39534,2.55,0.36
103,2021-03-04,LIG,4719,2112,2607,919,317,277,2920,282,4,3889,830,ITC,ITC3,7,Liguria,Liguria,1550640,44253,2.85,0.3
104,2021-01-26,LIG,2480,802,1678,1963,261,251,0,0,5,104,2376,ITC,ITC3,7,Liguria,Liguria,1550640,46733,3.01,0.16
105,2021-03-09,LIG,5735,2663,3072,1027,621,131,3423,533,0,4312,1423,ITC,ITC3,7,Liguria,Liguria,1550640,52468,3.38,0.37
106,2021-01-27,LIG,1743,603,1140,1336,179,227,0,0,1,142,1601,ITC,ITC3,7,Liguria,Liguria,1550640,54211,3.5,0.11
107,2021-01-13,LIG,2753,1012,1741,1912,350,487,0,0,4,2753,0,ITC,ITC3,7,Liguria,Liguria,1550640,56964,3.67,0.18
108,2021-01-30,LIG,1661,567,1094,1261,141,257,0,0,2,25,1636,ITC,ITC3,7,Liguria,Liguria,1550640,58625,3.78,0.11
109,2021-02-06,LIG,1891,767,1124,1309,206,375,0,0,1,145,1746,ITC,ITC3,7,Liguria,Liguria,1550640,60516,3.9,0.12
110,2021-01-19,LIG,1356,429,927,709,316,328,0,0,3,1266,90,ITC,ITC3,7,Liguria,Liguria,1550640,61872,3.99,0.09
111,2021-01-01,LIG,144,55,89,139,5,0,0,0,0,144,0,ITC,ITC3,7,Liguria,Liguria,1550640,62016,4.0,0.01
112,2021-03-13,LIG,3521,1493,2028,328,710,72,1501,120,790,2668,853,ITC,ITC3,7,Liguria,Liguria,1550640,65537,4.23,0.23
113,2021-03-12,LIG,5987,2762,3225,1192,919,77,3358,437,4,3548,2439,ITC,ITC3,7,Liguria,Liguria,1550640,71524,4.61,0.39
114,2021-01-18,LIG,2125,740,1385,1247,430,438,0,0,10,1968,157,ITC,ITC3,7,Liguria,Liguria,1550640,73649,4.75,0.14
115,2021-01-02,LIG,691,245,446,595,96,0,0,0,0,691,0,ITC,ITC3,7,Liguria,Liguria,1550640,74340,4.79,0.04
116,2021-01-11,LIG,2651,990,1661,1989,345,316,0,0,1,2651,0,ITC,ITC3,7,Liguria,Liguria,1550640,76991,4.97,0.17
117,2021-02-07,LIG,407,153,254,191,29,187,0,0,0,2,405,ITC,ITC3,7,Liguria,Liguria,1550640,77398,4.99,0.03
118,2021-02-19,LIG,3092,1279,1813,987,592,97,1413,0,3,2916,176,ITC,ITC3,7,Liguria,Liguria,1550640,80490,5.19,0.2
119,2021-02-18,LIG,2756,1126,1630,953,422,349,1030,0,2,2428,328,ITC,ITC3,7,Liguria,Liguria,1550640,83246,5.37,0.18
120,2021-02-02,LIG,2598,979,1619,1947,228,421,0,0,2,198,2400,ITC,ITC3,7,Liguria,Liguria,1550640,85844,5.54,0.17
121,2021-01-06,LIG,1660,616,1044,1230,250,113,64,0,3,1660,0,ITC,ITC3,7,Liguria,Liguria,1550640,87504,5.64,0.11
122,2021-01-10,LIG,648,262,386,369,103,176,0,0,0,648,0,ITC,ITC3,7,Liguria,Liguria,1550640,88152,5.68,0.04
123,2021-01-16,LIG,1278,557,721,753,225,299,0,0,1,1278,0,ITC,ITC3,7,Liguria,Liguria,1550640,89430,5.77,0.08
124,2021-02-22,LIG,3307,1451,1856,701,211,226,2167,0,2,3169,138,ITC,ITC3,7,Liguria,Liguria,1550640,92737,5.98,0.21
125,2021-03-16,LIG,5935,2645,3290,898,507,277,4245,3,5,2301,3634,ITC,ITC3,7,Liguria,Liguria,1550640,98672,6.36,0.38
126,2021-01-14,LIG,2977,1053,1924,1868,555,553,0,0,1,2977,0,ITC,ITC3,7,Liguria,Liguria,1550640,101649,6.56,0.19
127,2020-12-31,LIG,988,354,634,750,55,155,28,0,0,988,0,ITC,ITC3,7,Liguria,Liguria,1550640,102637,6.62,0.06
128,2021-03-11,LIG,6164,2957,3207,1137,614,262,3653,496,2,4162,2002,ITC,ITC3,7,Liguria,Liguria,1550640,108801,7.02,0.4
129,2021-01-04,LIG,2516,826,1690,2157,235,121,0,0,3,2516,0,ITC,ITC3,7,Liguria,Liguria,1550640,111317,7.18,0.16
130,2021-03-15,LIG,6995,2978,4017,767,1346,10,3699,220,953,4448,2547,ITC,ITC3,7,Liguria,Liguria,1550640,118312,7.63,0.45
131,2021-02-10,LIG,2275,827,1448,1350,419,496,5,0,5,1014,1261,ITC,ITC3,7,Liguria,Liguria,1550640,120587,7.78,0.15
132,2021-01-31,LIG,624,270,354,418,71,135,0,0,0,9,615,ITC,ITC3,7,Liguria,Liguria,1550640,121211,7.82,0.04
133,2021-02-16,LIG,2391,948,1443,982,410,283,714,0,2,1998,393,ITC,ITC3,7,Liguria,Liguria,1550640,123602,7.97,0.15
134,2021-01-09,LIG,1335,481,854,998,147,188,0,0,2,1335,0,ITC,ITC3,7,Liguria,Liguria,1550640,124937,8.06,0.09
135,2021-03-03,LIG,4521,1811,2710,1029,242,288,2954,3,5,3528,993,ITC,ITC3,7,Liguria,Liguria,1550640,129458,8.35,0.29
136,2021-03-02,LIG,4037,1667,2370,724,176,76,3056,1,4,3727,310,ITC,ITC3,7,Liguria,Liguria,1550640,133495,8.61,0.26
137,2021-03-01,LIG,3490,1421,2069,528,119,105,2737,0,1,3368,122,ITC,ITC3,7,Liguria,Liguria,1550640,136985,8.83,0.23
138,2021-01-21,LIG,1102,385,717,584,185,332,1,0,0,672,430,ITC,ITC3,7,Liguria,Liguria,1550640,138087,8.91,0.07
139,2021-02-20,LIG,1334,636,698,159,464,122,589,0,0,1333,1,ITC,ITC3,7,Liguria,Liguria,1550640,139421,8.99,0.09
140,2021-02-03,LIG,2241,771,1470,1601,257,382,0,0,1,54,2187,ITC,ITC3,7,Liguria,Liguria,1550640,141662,9.14,0.14
141,2021-02-05,LIG,2628,975,1653,1728,432,464,0,0,4,301,2327,ITC,ITC3,7,Liguria,Liguria,1550640,144290,9.31,0.17
142,2021-01-03,LIG,734,230,504,658,75,0,0,0,1,734,0,ITC,ITC3,7,Liguria,Liguria,1550640,145024,9.35,0.05
143,2021-02-13,LIG,1079,508,571,543,135,147,254,0,0,800,279,ITC,ITC3,7,Liguria,Liguria,1550640,146103,9.42,0.07
144,2021-02-24,LIG,3734,1548,2186,796,264,150,2523,0,1,3476,258,ITC,ITC3,7,Liguria,Liguria,1550640,149837,9.66,0.24
145,2021-02-23,LIG,3795,1559,2236,682,270,113,2727,2,1,3686,109,ITC,ITC3,7,Liguria,Liguria,1550640,153632,9.91,0.24
146,2021-03-17,LIG,5406,2332,3074,751,363,40,4244,2,6,2421,2985,ITC,ITC3,7,Liguria,Liguria,1550640,159038,10.26,0.35
147,2021-02-09,LIG,1893,680,1213,1080,336,455,0,0,22,256,1637,ITC,ITC3,7,Liguria,Liguria,1550640,160931,10.38,0.12
148,2021-02-15,LIG,2254,837,1417,1083,265,241,662,1,2,1861,393,ITC,ITC3,7,Liguria,Liguria,1550640,163185,10.52,0.15
149,2021-02-04,LIG,2813,984,1829,1865,468,471,0,1,8,179,2634,ITC,ITC3,7,Liguria,Liguria,1550640,165998,10.71,0.18
150,2021-01-17,LIG,861,300,561,516,82,262,0,0,1,861,0,ITC,ITC3,7,Liguria,Liguria,1550640,166859,10.76,0.06
151,2021-02-28,LIG,1060,581,479,12,571,3,474,0,0,1059,1,ITC,ITC3,7,Liguria,Liguria,1550640,167919,10.83,0.07
152,2021-01-23,LIG,809,295,514,633,132,43,0,0,1,153,656,ITC,ITC3,7,Liguria,Liguria,1550640,168728,10.88,0.05
153,2020-12-30,LIG,12,5,7,12,0,0,0,0,0,12,0,ITC,ITC3,7,Liguria,Liguria,1550640,168740,10.88,0.0
154,2021-02-17,LIG,2622,1165,1457,882,362,262,1115,0,1,2259,363,ITC,ITC3,7,Liguria,Liguria,1550640,171362,11.05,0.17
155,2021-03-06,LIG,3243,1818,1425,373,788,120,1490,472,0,2538,705,ITC,ITC3,7,Liguria,Liguria,1550640,174605,11.26,0.21
156,2021-01-25,LIG,2717,888,1829,2208,190,317,0,0,2,471,2246,ITC,ITC3,7,Liguria,Liguria,1550640,177322,11.44,0.18
157,2021-02-12,LIG,1906,681,1225,863,221,391,430,0,1,987,919,ITC,ITC3,7,Liguria,Liguria,1550640,179228,11.56,0.12
158,2021-02-26,LIG,3756,1518,2238,779,223,168,2584,0,2,3428,328,ITC,ITC3,7,Liguria,Liguria,1550640,182984,11.8,0.24
159,2021-03-20,LIG,2278,981,1297,220,218,0,1831,9,0,1104,1174,ITC,ITC3,7,Liguria,Liguria,1550640,185262,11.95,0.15
160,2021-03-07,LIG,1858,1085,773,184,524,258,508,383,1,1557,301,ITC,ITC3,7,Liguria,Liguria,1550640,187120,12.07,0.12
161,2021-02-21,LIG,869,491,378,183,317,102,267,0,0,865,4,ITC,ITC3,7,Liguria,Liguria,1550640,187989,12.12,0.06
162,2021-02-14,LIG,233,122,111,31,30,112,60,0,0,233,0,ITC,ITC3,7,Liguria,Liguria,1550640,188222,12.14,0.02
163,2021-03-14,LIG,1648,747,901,64,383,176,567,27,431,1044,604,ITC,ITC3,7,Liguria,Liguria,1550640,189870,12.24,0.11
164,2021-01-29,LIG,3040,1057,1983,2298,311,429,0,0,2,66,2974,ITC,ITC3,7,Liguria,Liguria,1550640,192910,12.44,0.2
165,2021-01-22,LIG,1811,602,1209,1063,183,565,0,0,0,1326,485,ITC,ITC3,7,Liguria,Liguria,1550640,194721,12.56,0.12
166,2021-03-18,LIG,4938,2113,2825,622,541,84,3680,6,5,1995,2943,ITC,ITC3,7,Liguria,Liguria,1550640,199659,12.88,0.32
167,2021-03-05,LIG,4852,2142,2710,800,325,81,3329,312,5,3728,1124,ITC,ITC3,7,Liguria,Liguria,1550640,204511,13.19,0.31
168,2021-03-19,LIG,5038,2184,2854,667,554,57,3657,21,82,2045,2993,ITC,ITC3,7,Liguria,Liguria,1550640,209549,13.51,0.32
169,2021-02-01,LIG,2440,904,1536,1912,212,315,0,0,1,76,2364,ITC,ITC3,7,Liguria,Liguria,1550640,211989,13.67,0.16
170,2021-01-29,PAB,1488,508,980,874,313,295,2,0,4,23,1465,ITH,ITH1,4,Provincia Autonoma Bolzano / Bozen,P.A. Bolzano,533050,1488,0.28,0.28
171,2021-03-18,PAB,1288,524,764,49,169,48,1022,0,0,215,1073,ITH,ITH1,4,Provincia Autonoma Bolzano / Bozen,P.A. Bolzano,533050,2776,0.52,0.24
172,2021-02-11,PAB,1031,408,623,205,381,102,343,0,0,222,809,ITH,ITH1,4,Provincia Autonoma Bolzano / Bozen,P.A. Bolzano,533050,3807,0.71,0.19
173,2021-02-10,PAB,1630,602,1028,489,558,1,582,0,0,26,1604,ITH,ITH1,4,Provincia Autonoma Bolzano / Bozen,P.A. Bolzano,533050,5437,1.02,0.31
174,2021-03-12,PAB,868,400,468,65,358,41,298,57,49,718,150,ITH,ITH1,4,Provincia Autonoma Bolzano / Bozen,P.A. Bolzano,533050,6305,1.18,0.16
175,2021-02-07,PAB,2165,975,1190,99,398,1,1667,0,0,12,2153,ITH,ITH1,4,Provincia Autonoma Bolzano / Bozen,P.A. Bolzano,533050,8470,1.59,0.41
176,2021-01-05,PAB,821,283,538,728,93,0,0,0,0,821,0,ITH,ITH1,4,Provincia Autonoma Bolzano / Bozen,P.A. Bolzano,533050,9291,1.74,0.15
177,2021-02-16,PAB,529,205,324,10,7,0,512,0,0,529,0,ITH,ITH1,4,Provincia Autonoma Bolzano / Bozen,P.A. Bolzano,533050,9820,1.84,0.1
178,2021-01-04,PAB,469,191,278,397,72,0,0,0,0,469,0,ITH,ITH1,4,Provincia Autonoma Bolzano / Bozen,P.A. Bolzano,533050,10289,1.93,0.09
179,2021-02-20,PAB,1502,471,1031,196,83,24,469,1,729,1484,18,ITH,ITH1,4,Provincia Autonoma Bolzano / Bozen,P.A. Bolzano,533050,11791,2.21,0.28
180,2021-03-11,PAB,1644,806,838,89,552,68,365,237,333,1129,515,ITH,ITH1,4,Provincia Autonoma Bolzano / Bozen,P.A. Bolzano,533050,13435,2.52,0.31
181,2021-01-07,PAB,892,317,575,613,227,0,52,0,0,892,0,ITH,ITH1,4,Provincia Autonoma Bolzano / Bozen,P.A. Bolzano,533050,14327,2.69,0.17
182,2021-02-06,PAB,2300,1025,1275,447,375,6,1471,0,1,18,2282,ITH,ITH1,4,Provincia Autonoma Bolzano / Bozen,P.A. Bolzano,533050,16627,3.12,0.43
183,2021-02-03,PAB,1445,457,988,615,441,321,68,0,0,5,1440,ITH,ITH1,4,Provincia Autonoma Bolzano / Bozen,P.A. Bolzano,533050,18072,3.39,0.27
184,2021-03-06,PAB,3946,2069,1877,478,871,7,1953,256,381,3734,212,ITH,ITH1,4,Provincia Autonoma Bolzano / Bozen,P.A. Bolzano,533050,22018,4.13,0.74
185,2021-03-01,PAB,909,217,692,11,159,5,0,0,734,909,0,ITH,ITH1,4,Provincia Autonoma Bolzano / Bozen,P.A. Bolzano,533050,22927,4.3,0.17
186,2021-01-21,PAB,915,426,489,720,100,68,27,0,0,138,777,ITH,ITH1,4,Provincia Autonoma Bolzano / Bozen,P.A. Bolzano,533050,23842,4.47,0.17
187,2021-01-30,PAB,496,244,252,216,179,101,0,0,0,4,492,ITH,ITH1,4,Provincia Autonoma Bolzano / Bozen,P.A. Bolzano,533050,24338,4.57,0.09
188,2021-01-24,PAB,12,10,2,1,11,0,0,0,0,0,12,ITH,ITH1,4,Provincia Autonoma Bolzano / Bozen,P.A. Bolzano,533050,24350,4.57,0.0
189,2021-01-26,PAB,809,291,518,681,128,0,0,0,0,1,808,ITH,ITH1,4,Provincia Autonoma Bolzano / Bozen,P.A. Bolzano,533050,25159,4.72,0.15
190,2021-02-26,PAB,1385,492,893,62,143,2,846,0,332,1355,30,ITH,ITH1,4,Provincia Autonoma Bolzano / Bozen,P.A. Bolzano,533050,26544,4.98,0.26
191,2021-01-22,PAB,242,138,104,130,23,85,3,0,1,124,118,ITH,ITH1,4,Provincia Autonoma Bolzano / Bozen,P.A. Bolzano,533050,26786,5.03,0.05
192,2021-03-13,PAB,2859,1448,1411,165,1313,1,1272,89,19,2758,101,ITH,ITH1,4,Provincia Autonoma Bolzano / Bozen,P.A. Bolzano,533050,29645,5.56,0.54
193,2021-02-05,PAB,2789,1036,1753,641,677,394,1077,0,0,6,2783,ITH,ITH1,4,Provincia Autonoma Bolzano / Bozen,P.A. Bolzano,533050,32434,6.08,0.52
194,2021-01-11,PAB,1501,476,1025,537,640,174,150,0,0,1501,0,ITH,ITH1,4,Provincia Autonoma Bolzano / Bozen,P.A. Bolzano,533050,33935,6.37,0.28
195,2021-01-02,PAB,91,48,43,69,22,0,0,0,0,91,0,ITH,ITH1,4,Provincia Autonoma Bolzano / Bozen,P.A. Bolzano,533050,34026,6.38,0.02
196,2020-12-30,PAB,384,181,203,340,44,0,0,0,0,384,0,ITH,ITH1,4,Provincia Autonoma Bolzano / Bozen,P.A. Bolzano,533050,34410,6.46,0.07
197,2021-02-01,PAB,1385,404,981,709,379,296,0,0,1,11,1374,ITH,ITH1,4,Provincia Autonoma Bolzano / Bozen,P.A. Bolzano,533050,35795,6.72,0.26
198,2021-03-10,PAB,1172,446,726,653,188,0,134,80,117,1029,143,ITH,ITH1,4,Provincia Autonoma Bolzano / Bozen,P.A. Bolzano,533050,36967,6.93,0.22
199,2021-01-06,PAB,59,18,41,59,0,0,0,0,0,59,0,ITH,ITH1,4,Provincia Autonoma Bolzano / Bozen,P.A. Bolzano,533050,37026,6.95,0.01
200,2021-03-05,PAB,1756,590,1166,337,383,28,760,9,239,1314,442,ITH,ITH1,4,Provincia Autonoma Bolzano / Bozen,P.A. Bolzano,533050,38782,7.28,0.33
201,2021-01-19,PAB,811,349,462,170,66,0,575,0,0,681,130,ITH,ITH1,4,Provincia Autonoma Bolzano / Bozen,P.A. Bolzano,533050,39593,7.43,0.15
202,2021-01-13,PAB,1317,409,908,368,588,255,106,0,0,1317,0,ITH,ITH1,4,Provincia Autonoma Bolzano / Bozen,P.A. Bolzano,533050,40910,7.67,0.25
203,2021-01-14,PAB,1809,540,1269,477,761,285,286,0,0,1809,0,ITH,ITH1,4,Provincia Autonoma Bolzano / Bozen,P.A. Bolzano,533050,42719,8.01,0.34
204,2021-03-15,PAB,838,292,546,285,478,13,56,2,4,365,473,ITH,ITH1,4,Provincia Autonoma Bolzano / Bozen,P.A. Bolzano,533050,43557,8.17,0.16
205,2021-03-19,PAB,1896,768,1128,159,612,15,1096,0,14,793,1103,ITH,ITH1,4,Provincia Autonoma Bolzano / Bozen,P.A. Bolzano,533050,45453,8.53,0.36
206,2021-02-02,PAB,1731,500,1231,617,500,605,9,0,0,8,1723,ITH,ITH1,4,Provincia Autonoma Bolzano / Bozen,P.A. Bolzano,533050,47184,8.85,0.32
207,2021-02-08,PAB,1,1,0,0,1,0,0,0,0,1,0,ITH,ITH1,4,Provincia Autonoma Bolzano / Bozen,P.A. Bolzano,533050,47185,8.85,0.0
208,2021-02-25,PAB,1495,548,947,22,340,0,728,0,405,1494,1,ITH,ITH1,4,Provincia Autonoma Bolzano / Bozen,P.A. Bolzano,533050,48680,9.13,0.28
209,2021-03-03,PAB,1162,391,771,12,13,6,345,51,735,1149,13,ITH,ITH1,4,Provincia Autonoma Bolzano / Bozen,P.A. Bolzano,533050,49842,9.35,0.22
210,2021-03-21,PAB,409,148,261,99,16,0,294,0,0,2,407,ITH,ITH1,4,Provincia Autonoma Bolzano / Bozen,P.A. Bolzano,533050,50251,9.43,0.08
211,2021-03-04,PAB,1669,988,681,293,598,25,40,452,261,1457,212,ITH,ITH1,4,Provincia Autonoma Bolzano / Bozen,P.A. Bolzano,533050,51920,9.74,0.31
212,2021-01-15,PAB,3027,1119,1908,560,870,336,1261,0,0,3027,0,ITH,ITH1,4,Provincia Autonoma Bolzano / Bozen,P.A. Bolzano,533050,54947,10.31,0.57
213,2021-01-09,PAB,600,317,283,75,439,74,12,0,0,600,0,ITH,ITH1,4,Provincia Autonoma Bolzano / Bozen,P.A. Bolzano,533050,55547,10.42,0.11
214,2021-03-02,PAB,681,193,488,1,0,0,0,7,673,681,0,ITH,ITH1,4,Provincia Autonoma Bolzano / Bozen,P.A. Bolzano,533050,56228,10.55,0.13
215,2021-03-08,PAB,1187,517,670,23,285,164,712,0,3,1162,25,ITH,ITH1,4,Provincia Autonoma Bolzano / Bozen,P.A. Bolzano,533050,57415,10.77,0.22
216,2021-01-20,PAB,609,248,361,287,72,0,250,0,0,401,208,ITH,ITH1,4,Provincia Autonoma Bolzano / Bozen,P.A. Bolzano,533050,58024,10.89,0.11
217,2021-01-18,PAB,1655,638,1017,368,299,7,981,0,0,1651,4,ITH,ITH1,4,Provincia Autonoma Bolzano / Bozen,P.A. Bolzano,533050,59679,11.2,0.31
218,2021-03-16,PAB,620,245,375,22,63,38,497,0,0,103,517,ITH,ITH1,4,Provincia Autonoma Bolzano / Bozen,P.A. Bolzano,533050,60299,11.31,0.12
219,2021-01-03,PAB,41,16,25,33,7,0,1,0,0,41,0,ITH,ITH1,4,Provincia Autonoma Bolzano / Bozen,P.A. Bolzano,533050,60340,11.32,0.01
220,2021-01-16,PAB,2749,1229,1520,450,360,77,1861,0,1,2749,0,ITH,ITH1,4,Provincia Autonoma Bolzano / Bozen,P.A. Bolzano,533050,63089,11.84,0.52
221,2021-02-22,PAB,521,142,379,339,168,0,4,0,10,510,11,ITH,ITH1,4,Provincia Autonoma Bolzano / Bozen,P.A. Bolzano,533050,63610,11.93,0.1
222,2021-02-13,PAB,318,79,239,126,184,7,1,0,0,312,6,ITH,ITH1,4,Provincia Autonoma Bolzano / Bozen,P.A. Bolzano,533050,63928,11.99,0.06
223,2021-02-24,PAB,1361,403,958,10,3,0,0,8,1340,1349,12,ITH,ITH1,4,Provincia Autonoma Bolzano / Bozen,P.A. Bolzano,533050,65289,12.25,0.26
224,2021-01-23,PAB,195,115,80,183,12,0,0,0,0,0,195,ITH,ITH1,4,Provincia Autonoma Bolzano / Bozen,P.A. Bolzano,533050,65484,12.28,0.04
225,2021-02-27,PAB,2454,758,1696,202,128,8,881,3,1232,2446,8,ITH,ITH1,4,Provincia Autonoma Bolzano / Bozen,P.A. Bolzano,533050,67938,12.75,0.46
226,2021-01-17,PAB,2270,1025,1245,54,236,19,1961,0,0,2259,11,ITH,ITH1,4,Provincia Autonoma Bolzano / Bozen,P.A. Bolzano,533050,70208,13.17,0.43
227,2021-02-04,PAB,1877,568,1309,623,621,419,214,0,0,8,1869,ITH,ITH1,4,Provincia Autonoma Bolzano / Bozen,P.A. Bolzano,533050,72085,13.52,0.35
228,2021-01-25,PAB,462,177,285,380,80,0,1,0,1,3,459,ITH,ITH1,4,Provincia Autonoma Bolzano / Bozen,P.A. Bolzano,533050,72547,13.61,0.09
229,2021-01-28,PAB,867,307,560,584,214,69,0,0,0,10,857,ITH,ITH1,4,Provincia Autonoma Bolzano / Bozen,P.A. Bolzano,533050,73414,13.77,0.16
230,2021-02-09,PAB,317,126,191,64,22,2,227,0,2,1,316,ITH,ITH1,4,Provincia Autonoma Bolzano / Bozen,P.A. Bolzano,533050,73731,13.83,0.06
231,2021-03-17,PAB,570,212,358,7,40,42,481,0,0,569,1,ITH,ITH1,4,Provincia Autonoma Bolzano / Bozen,P.A. Bolzano,533050,74301,13.94,0.11
232,2021-03-07,PAB,114,13,101,59,51,0,3,0,1,9,105,ITH,ITH1,4,Provincia Autonoma Bolzano / Bozen,P.A. Bolzano,533050,74415,13.96,0.02
233,2021-03-20,PAB,1372,655,717,112,652,9,593,5,1,751,621,ITH,ITH1,4,Provincia Autonoma Bolzano / Bozen,P.A. Bolzano,533050,75787,14.22,0.26
234,2021-02-12,PAB,721,214,507,316,292,104,7,2,0,475,246,ITH,ITH1,4,Provincia Autonoma Bolzano / Bozen,P.A. Bolzano,533050,76508,14.35,0.14
235,2021-01-27,PAB,84,28,56,54,30,0,0,0,0,1,83,ITH,ITH1,4,Provincia Autonoma Bolzano / Bozen,P.A. Bolzano,533050,76592,14.37,0.02
236,2021-03-09,PAB,1185,540,645,29,101,21,915,72,47,1183,2,ITH,ITH1,4,Provincia Autonoma Bolzano / Bozen,P.A. Bolzano,533050,77777,14.59,0.22
237,2020-12-27,PAB,143,65,78,136,6,0,1,0,0,143,0,ITH,ITH1,4,Provincia Autonoma Bolzano / Bozen,P.A. Bolzano,533050,77920,14.62,0.03
238,2021-02-18,PAB,1641,401,1240,23,313,20,4,0,1281,1638,3,ITH,ITH1,4,Provincia Autonoma Bolzano / Bozen,P.A. Bolzano,533050,79561,14.93,0.31
239,2021-01-08,PAB,1488,469,1019,777,449,166,96,0,0,1488,0,ITH,ITH1,4,Provincia Autonoma Bolzano / Bozen,P.A. Bolzano,533050,81049,15.2,0.28
240,2020-12-31,PAB,847,485,362,424,423,0,0,0,0,847,0,ITH,ITH1,4,Provincia Autonoma Bolzano / Bozen,P.A. Bolzano,533050,81896,15.36,0.16
241,2021-02-19,PAB,1962,449,1513,121,250,79,7,0,1505,1951,11,ITH,ITH1,4,Provincia Autonoma Bolzano / Bozen,P.A. Bolzano,533050,83858,15.73,0.37
242,2021-01-10,PAB,2,2,0,1,1,0,0,0,0,2,0,ITH,ITH1,4,Provincia Autonoma Bolzano / Bozen,P.A. Bolzano,533050,83860,15.73,0.0
243,2021-03-14,PAB,754,336,418,130,37,33,553,1,0,25,729,ITH,ITH1,4,Provincia Autonoma Bolzano / Bozen,P.A. Bolzano,533050,84614,15.87,0.14
244,2021-02-17,PAB,4,1,3,1,2,0,1,0,0,2,2,ITH,ITH1,4,Provincia Autonoma Bolzano / Bozen,P.A. Bolzano,533050,84618,15.87,0.0
245,2021-02-23,PAB,763,320,443,0,58,0,621,0,84,758,5,ITH,ITH1,4,Provincia Autonoma Bolzano / Bozen,P.A. Bolzano,533050,85381,16.02,0.14
246,2021-02-15,PAB,72,42,30,17,10,40,5,0,0,26,46,ITH,ITH1,4,Provincia Autonoma Bolzano / Bozen,P.A. Bolzano,533050,85453,16.03,0.01
247,2021-01-01,PAB,1,1,0,1,0,0,0,0,0,1,0,ITH,ITH1,4,Provincia Autonoma Bolzano / Bozen,P.A. Bolzano,533050,85454,16.03,0.0
248,2021-01-12,PAB,1527,398,1129,299,680,475,73,0,0,1527,0,ITH,ITH1,4,Provincia Autonoma Bolzano / Bozen,P.A. Bolzano,533050,86981,16.32,0.29
249,2021-02-06,BAS,902,367,535,546,187,168,0,0,1,146,756,ITF,ITF5,17,Basilicata,Basilicata,559084,902,0.16,0.16
250,2021-02-13,BAS,799,313,486,279,204,115,199,2,0,738,61,ITF,ITF5,17,Basilicata,Basilicata,559084,1701,0.3,0.14
251,2021-01-24,BAS,834,299,535,706,127,1,0,0,0,58,776,ITF,ITF5,17,Basilicata,Basilicata,559084,2535,0.45,0.15
252,2021-02-21,BAS,284,113,171,16,2,11,254,0,1,284,0,ITF,ITF5,17,Basilicata,Basilicata,559084,2819,0.5,0.05
253,2021-02-28,BAS,802,342,460,32,30,0,740,0,0,774,28,ITF,ITF5,17,Basilicata,Basilicata,559084,3621,0.65,0.14
254,2021-02-25,BAS,1787,736,1051,67,14,0,1705,1,0,1741,46,ITF,ITF5,17,Basilicata,Basilicata,559084,5408,0.97,0.32
255,2021-03-18,BAS,1347,561,786,30,10,0,1307,0,0,22,1325,ITF,ITF5,17,Basilicata,Basilicata,559084,6755,1.21,0.24
256,2021-03-10,BAS,1650,814,836,101,110,33,877,256,273,811,839,ITF,ITF5,17,Basilicata,Basilicata,559084,8405,1.5,0.3
257,2021-01-26,BAS,793,350,443,622,136,35,0,0,0,101,692,ITF,ITF5,17,Basilicata,Basilicata,559084,9198,1.65,0.14
258,2021-01-29,BAS,612,228,384,397,145,70,0,0,0,63,549,ITF,ITF5,17,Basilicata,Basilicata,559084,9810,1.75,0.11
259,2021-03-20,BAS,1110,463,647,45,114,0,943,5,3,99,1011,ITF,ITF5,17,Basilicata,Basilicata,559084,10920,1.95,0.2
260,2021-02-24,BAS,1803,743,1060,85,29,2,1686,1,0,1734,69,ITF,ITF5,17,Basilicata,Basilicata,559084,12723,2.28,0.32
261,2021-01-21,BAS,30,10,20,0,30,0,0,0,0,30,0,ITF,ITF5,17,Basilicata,Basilicata,559084,12753,2.28,0.01
262,2021-03-05,BAS,1849,855,994,298,227,72,689,254,309,1104,745,ITF,ITF5,17,Basilicata,Basilicata,559084,14602,2.61,0.33
263,2021-01-25,BAS,1020,427,593,828,191,1,0,0,0,74,946,ITF,ITF5,17,Basilicata,Basilicata,559084,15622,2.79,0.18
264,2021-01-03,BAS,900,344,556,790,108,0,0,0,2,900,0,ITF,ITF5,17,Basilicata,Basilicata,559084,16522,2.96,0.16
265,2021-02-03,BAS,666,300,366,425,69,172,0,0,0,32,634,ITF,ITF5,17,Basilicata,Basilicata,559084,17188,3.07,0.12
266,2021-01-30,BAS,703,226,477,424,153,126,0,0,0,127,576,ITF,ITF5,17,Basilicata,Basilicata,559084,17891,3.2,0.13
267,2021-02-22,BAS,1789,772,1017,125,86,2,1576,0,0,1736,53,ITF,ITF5,17,Basilicata,Basilicata,559084,19680,3.52,0.32
268,2021-02-08,BAS,557,193,364,436,72,49,0,0,0,151,406,ITF,ITF5,17,Basilicata,Basilicata,559084,20237,3.62,0.1
269,2021-03-15,BAS,2345,981,1364,78,45,0,1933,23,266,519,1826,ITF,ITF5,17,Basilicata,Basilicata,559084,22582,4.04,0.42
270,2021-02-16,BAS,905,377,528,250,95,67,492,1,0,807,98,ITF,ITF5,17,Basilicata,Basilicata,559084,23487,4.2,0.16
271,2021-02-27,BAS,1983,854,1129,103,184,21,1675,0,0,1819,164,ITF,ITF5,17,Basilicata,Basilicata,559084,25470,4.56,0.35
272,2021-03-01,BAS,540,279,261,121,129,4,168,68,50,376,164,ITF,ITF5,17,Basilicata,Basilicata,559084,26010,4.65,0.1
273,2021-02-17,BAS,1135,493,642,123,69,57,884,1,1,1059,76,ITF,ITF5,17,Basilicata,Basilicata,559084,27145,4.86,0.2
274,2021-02-04,BAS,1092,440,652,636,175,281,0,0,0,63,1029,ITF,ITF5,17,Basilicata,Basilicata,559084,28237,5.05,0.2
275,2021-02-07,BAS,373,159,214,259,74,40,0,0,0,49,324,ITF,ITF5,17,Basilicata,Basilicata,559084,28610,5.12,0.07
276,2021-01-17,BAS,328,133,195,233,41,54,0,0,0,327,1,ITF,ITF5,17,Basilicata,Basilicata,559084,28938,5.18,0.06
277,2021-03-03,BAS,1739,813,926,191,413,99,589,203,244,1183,556,ITF,ITF5,17,Basilicata,Basilicata,559084,30677,5.49,0.31
278,2021-03-06,BAS,1350,534,816,296,170,57,383,185,259,756,594,ITF,ITF5,17,Basilicata,Basilicata,559084,32027,5.73,0.24
279,2021-01-22,BAS,67,24,43,6,60,0,1,0,0,67,0,ITF,ITF5,17,Basilicata,Basilicata,559084,32094,5.74,0.01
280,2021-03-08,BAS,1450,707,743,221,252,38,410,256,273,840,610,ITF,ITF5,17,Basilicata,Basilicata,559084,33544,6.0,0.26
281,2021-02-10,BAS,547,237,310,176,153,127,90,0,1,495,52,ITF,ITF5,17,Basilicata,Basilicata,559084,34091,6.1,0.1
282,2021-02-23,BAS,1901,771,1130,159,49,35,1658,0,0,1763,138,ITF,ITF5,17,Basilicata,Basilicata,559084,35992,6.44,0.34
283,2021-03-21,BAS,387,194,193,30,14,0,340,0,3,42,345,ITF,ITF5,17,Basilicata,Basilicata,559084,36379,6.51,0.07
284,2021-02-26,BAS,2148,904,1244,88,105,1,1954,0,0,2069,79,ITF,ITF5,17,Basilicata,Basilicata,559084,38527,6.89,0.38
285,2021-01-07,BAS,640,319,321,556,55,29,0,0,0,640,0,ITF,ITF5,17,Basilicata,Basilicata,559084,39167,7.01,0.11
286,2021-01-20,BAS,84,22,62,0,84,0,0,0,0,84,0,ITF,ITF5,17,Basilicata,Basilicata,559084,39251,7.02,0.02
287,2021-01-05,BAS,945,409,536,861,84,0,0,0,0,945,0,ITF,ITF5,17,Basilicata,Basilicata,559084,40196,7.19,0.17
288,2021-01-27,BAS,410,174,236,299,85,26,0,0,0,113,297,ITF,ITF5,17,Basilicata,Basilicata,559084,40606,7.26,0.07
289,2021-03-19,BAS,2189,956,1233,58,109,0,1858,22,142,241,1948,ITF,ITF5,17,Basilicata,Basilicata,559084,42795,7.65,0.39
290,2021-01-15,BAS,813,350,463,578,61,174,0,0,0,813,0,ITF,ITF5,17,Basilicata,Basilicata,559084,43608,7.8,0.15
291,2021-03-09,BAS,1391,706,685,222,95,33,545,258,238,787,604,ITF,ITF5,17,Basilicata,Basilicata,559084,44999,8.05,0.25
292,2021-01-02,BAS,949,380,569,855,91,0,0,0,3,949,0,ITF,ITF5,17,Basilicata,Basilicata,559084,45948,8.22,0.17
293,2021-01-31,BAS,77,24,53,75,2,0,0,0,0,0,77,ITF,ITF5,17,Basilicata,Basilicata,559084,46025,8.23,0.01
294,2021-02-15,BAS,621,232,389,191,137,46,246,1,0,580,41,ITF,ITF5,17,Basilicata,Basilicata,559084,46646,8.34,0.11
295,2021-03-13,BAS,1794,888,906,82,358,46,864,231,213,749,1045,ITF,ITF5,17,Basilicata,Basilicata,559084,48440,8.66,0.32
296,2021-03-14,BAS,1008,477,531,41,123,8,516,71,249,539,469,ITF,ITF5,17,Basilicata,Basilicata,559084,49448,8.84,0.18
297,2021-02-12,BAS,775,332,443,288,201,90,190,6,0,744,31,ITF,ITF5,17,Basilicata,Basilicata,559084,50223,8.98,0.14
298,2020-12-27,BAS,106,41,65,104,2,0,0,0,0,106,0,ITF,ITF5,17,Basilicata,Basilicata,559084,50329,9.0,0.02
299,2021-03-02,BAS,792,381,411,110,78,5,185,201,213,657,135,ITF,ITF5,17,Basilicata,Basilicata,559084,51121,9.14,0.14
300,2021-01-09,BAS,557,160,397,386,103,67,0,0,1,557,0,ITF,ITF5,17,Basilicata,Basilicata,559084,51678,9.24,0.1
301,2021-02-09,BAS,491,213,278,200,237,54,0,0,0,316,175,ITF,ITF5,17,Basilicata,Basilicata,559084,52169,9.33,0.09
302,2021-03-16,BAS,1899,799,1100,103,58,0,1671,5,62,228,1671,ITF,ITF5,17,Basilicata,Basilicata,559084,54068,9.67,0.34
303,2021-03-04,BAS,1872,889,983,217,243,66,842,263,241,1079,793,ITF,ITF5,17,Basilicata,Basilicata,559084,55940,10.01,0.33
304,2021-02-19,BAS,1622,737,885,219,375,66,962,0,0,1560,62,ITF,ITF5,17,Basilicata,Basilicata,559084,57562,10.3,0.29
305,2021-01-08,BAS,554,219,335,383,112,59,0,0,0,554,0,ITF,ITF5,17,Basilicata,Basilicata,559084,58116,10.39,0.1
306,2021-02-20,BAS,1158,530,628,75,201,80,802,0,0,1041,117,ITF,ITF5,17,Basilicata,Basilicata,559084,59274,10.6,0.21
307,2021-02-14,BAS,151,48,103,55,13,65,18,0,0,151,0,ITF,ITF5,17,Basilicata,Basilicata,559084,59425,10.63,0.03
308,2021-01-28,BAS,903,401,502,717,104,81,1,0,0,119,784,ITF,ITF5,17,Basilicata,Basilicata,559084,60328,10.79,0.16
309,2021-03-11,BAS,1783,919,864,163,162,77,905,253,223,824,959,ITF,ITF5,17,Basilicata,Basilicata,559084,62111,11.11,0.32
310,2021-01-06,BAS,294,129,165,229,29,36,0,0,0,294,0,ITF,ITF5,17,Basilicata,Basilicata,559084,62405,11.16,0.05
311,2021-02-18,BAS,1070,401,669,270,74,150,576,0,0,855,215,ITF,ITF5,17,Basilicata,Basilicata,559084,63475,11.35,0.19
312,2021-01-14,BAS,969,413,556,504,142,323,0,0,0,969,0,ITF,ITF5,17,Basilicata,Basilicata,559084,64444,11.53,0.17
313,2021-01-18,BAS,463,157,306,364,54,45,0,0,0,364,99,ITF,ITF5,17,Basilicata,Basilicata,559084,64907,11.61,0.08
314,2021-02-11,BAS,951,401,550,200,169,107,471,4,0,868,83,ITF,ITF5,17,Basilicata,Basilicata,559084,65858,11.78,0.17
315,2021-03-07,BAS,882,308,574,39,18,4,328,22,471,844,38,ITF,ITF5,17,Basilicata,Basilicata,559084,66740,11.94,0.16
316,2021-01-12,BAS,217,88,129,87,31,99,0,0,0,217,0,ITF,ITF5,17,Basilicata,Basilicata,559084,66957,11.98,0.04
317,2021-01-04,BAS,607,271,336,550,55,0,0,0,2,607,0,ITF,ITF5,17,Basilicata,Basilicata,559084,67564,12.08,0.11
318,2021-02-01,BAS,242,91,151,156,38,48,0,0,0,46,196,ITF,ITF5,17,Basilicata,Basilicata,559084,67806,12.13,0.04
319,2021-01-19,BAS,199,84,115,78,77,44,0,0,0,199,0,ITF,ITF5,17,Basilicata,Basilicata,559084,68005,12.16,0.04
320,2021-03-12,BAS,1896,975,921,266,109,37,985,241,258,798,1098,ITF,ITF5,17,Basilicata,Basilicata,559084,69901,12.5,0.34
321,2021-01-16,BAS,721,304,417,466,92,161,0,0,2,721,0,ITF,ITF5,17,Basilicata,Basilicata,559084,70622,12.63,0.13
322,2021-01-11,BAS,183,66,117,107,35,41,0,0,0,183,0,ITF,ITF5,17,Basilicata,Basilicata,559084,70805,12.66,0.03
323,2021-01-23,BAS,707,299,408,592,114,1,0,0,0,33,674,ITF,ITF5,17,Basilicata,Basilicata,559084,71512,12.79,0.13
324,2021-03-17,BAS,1448,606,842,22,29,0,1390,5,2,27,1421,ITF,ITF5,17,Basilicata,Basilicata,559084,72960,13.05,0.26
325,2021-02-02,BAS,365,141,224,212,51,102,0,0,0,175,190,ITF,ITF5,17,Basilicata,Basilicata,559084,73325,13.12,0.07
326,2021-02-05,BAS,983,443,540,611,181,191,0,0,0,64,919,ITF,ITF5,17,Basilicata,Basilicata,559084,74308,13.29,0.18
327,2021-01-13,BAS,916,387,529,699,68,148,0,0,1,916,0,ITF,ITF5,17,Basilicata,Basilicata,559084,75224,13.45,0.16
328,2021-01-10,BAS,77,24,53,9,68,0,0,0,0,77,0,ITF,ITF5,17,Basilicata,Basilicata,559084,75301,13.47,0.01
329,2021-01-28,FVG,2235,792,1443,1754,287,194,0,0,0,354,1881,ITH,ITH4,6,Friuli-Venezia Giulia,Friuli Venezia Giulia,1215220,2235,0.18,0.18
330,2021-03-11,FVG,3291,1384,1907,249,156,265,2013,104,504,1558,1733,ITH,ITH4,6,Friuli-Venezia Giulia,Friuli Venezia Giulia,1215220,5526,0.45,0.27
331,2021-02-24,FVG,2517,1082,1435,23,53,310,1834,0,297,2499,18,ITH,ITH4,6,Friuli-Venezia Giulia,Friuli Venezia Giulia,1215220,8043,0.66,0.21
332,2021-02-11,FVG,1930,663,1267,1134,568,224,3,1,0,1737,193,ITH,ITH4,6,Friuli-Venezia Giulia,Friuli Venezia Giulia,1215220,9973,0.82,0.16
333,2021-02-08,FVG,2354,693,1661,1399,521,434,0,0,0,91,2263,ITH,ITH4,6,Friuli-Venezia Giulia,Friuli Venezia Giulia,1215220,12327,1.01,0.19
334,2021-02-20,FVG,2068,933,1135,11,19,148,1584,0,306,1924,144,ITH,ITH4,6,Friuli-Venezia Giulia,Friuli Venezia Giulia,1215220,14395,1.18,0.17
335,2021-01-24,FVG,305,119,186,277,27,1,0,0,0,1,304,ITH,ITH4,6,Friuli-Venezia Giulia,Friuli Venezia Giulia,1215220,14700,1.21,0.03
336,2021-03-04,FVG,3397,1572,1825,357,250,88,1811,490,401,2764,633,ITH,ITH4,6,Friuli-Venezia Giulia,Friuli Venezia Giulia,1215220,18097,1.49,0.28
337,2021-01-07,FVG,2091,718,1373,1759,222,110,0,0,0,2091,0,ITH,ITH4,6,Friuli-Venezia Giulia,Friuli Venezia Giulia,1215220,20188,1.66,0.17
338,2021-01-08,FVG,2322,747,1575,1680,246,396,0,0,0,2322,0,ITH,ITH4,6,Friuli-Venezia Giulia,Friuli Venezia Giulia,1215220,22510,1.85,0.19
339,2021-03-12,FVG,3881,1527,2354,174,151,27,2840,100,589,2501,1380,ITH,ITH4,6,Friuli-Venezia Giulia,Friuli Venezia Giulia,1215220,26391,2.17,0.32
340,2021-01-27,FVG,1269,425,844,849,356,64,0,0,0,447,822,ITH,ITH4,6,Friuli-Venezia Giulia,Friuli Venezia Giulia,1215220,27660,2.28,0.1
341,2021-01-18,FVG,1961,607,1354,1359,492,110,0,0,0,1867,94,ITH,ITH4,6,Friuli-Venezia Giulia,Friuli Venezia Giulia,1215220,29621,2.44,0.16
342,2021-02-13,FVG,567,179,388,337,230,0,0,0,0,561,6,ITH,ITH4,6,Friuli-Venezia Giulia,Friuli Venezia Giulia,1215220,30188,2.48,0.05
343,2021-03-08,FVG,3873,1528,2345,684,538,7,2169,39,436,1816,2057,ITH,ITH4,6,Friuli-Venezia Giulia,Friuli Venezia Giulia,1215220,34061,2.8,0.32
344,2021-02-12,FVG,1200,428,772,674,395,128,2,0,1,1150,50,ITH,ITH4,6,Friuli-Venezia Giulia,Friuli Venezia Giulia,1215220,35261,2.9,0.1
345,2021-01-05,FVG,1680,551,1129,1350,133,197,0,0,0,1680,0,ITH,ITH4,6,Friuli-Venezia Giulia,Friuli Venezia Giulia,1215220,36941,3.04,0.14
346,2021-01-16,FVG,1231,360,871,771,212,248,0,0,0,1231,0,ITH,ITH4,6,Friuli-Venezia Giulia,Friuli Venezia Giulia,1215220,38172,3.14,0.1
347,2021-01-20,FVG,750,323,427,719,31,0,0,0,0,12,738,ITH,ITH4,6,Friuli-Venezia Giulia,Friuli Venezia Giulia,1215220,38922,3.2,0.06
348,2021-03-20,FVG,3328,1344,1984,412,295,6,2377,172,66,1236,2092,ITH,ITH4,6,Friuli-Venezia Giulia,Friuli Venezia Giulia,1215220,42250,3.48,0.27
349,2021-02-17,FVG,2350,997,1353,327,193,229,1555,46,0,1872,478,ITH,ITH4,6,Friuli-Venezia Giulia,Friuli Venezia Giulia,1215220,44600,3.67,0.19
350,2021-03-02,FVG,4215,1516,2699,1164,675,202,1535,5,634,2712,1503,ITH,ITH4,6,Friuli-Venezia Giulia,Friuli Venezia Giulia,1215220,48815,4.02,0.35
351,2021-01-23,FVG,816,324,492,768,48,0,0,0,0,4,812,ITH,ITH4,6,Friuli-Venezia Giulia,Friuli Venezia Giulia,1215220,49631,4.08,0.07
352,2021-03-07,FVG,2535,925,1610,1,158,0,143,452,1781,2534,1,ITH,ITH4,6,Friuli-Venezia Giulia,Friuli Venezia Giulia,1215220,52166,4.29,0.21
353,2021-02-16,FVG,2516,1135,1381,260,275,221,1760,0,0,2400,116,ITH,ITH4,6,Friuli-Venezia Giulia,Friuli Venezia Giulia,1215220,54682,4.5,0.21
354,2021-03-03,FVG,3623,1617,2006,748,559,100,1320,469,427,2346,1277,ITH,ITH4,6,Friuli-Venezia Giulia,Friuli Venezia Giulia,1215220,58305,4.8,0.3
355,2021-03-06,FVG,3487,1192,2295,182,259,1,1561,19,1465,3161,326,ITH,ITH4,6,Friuli-Venezia Giulia,Friuli Venezia Giulia,1215220,61792,5.08,0.29
356,2020-12-27,FVG,262,149,113,259,3,0,0,0,0,262,0,ITH,ITH4,6,Friuli-Venezia Giulia,Friuli Venezia Giulia,1215220,62054,5.11,0.02
357,2021-02-02,FVG,2466,806,1660,1657,393,416,0,0,0,217,2249,ITH,ITH4,6,Friuli-Venezia Giulia,Friuli Venezia Giulia,1215220,64520,5.31,0.2
358,2021-01-09,FVG,2518,841,1677,1519,406,593,0,0,0,2518,0,ITH,ITH4,6,Friuli-Venezia Giulia,Friuli Venezia Giulia,1215220,67038,5.52,0.21
359,2021-03-16,FVG,3062,1262,1800,325,339,196,2202,0,0,1024,2038,ITH,ITH4,6,Friuli-Venezia Giulia,Friuli Venezia Giulia,1215220,70100,5.77,0.25
360,2021-02-09,FVG,1848,556,1292,1053,509,286,0,0,0,1559,289,ITH,ITH4,6,Friuli-Venezia Giulia,Friuli Venezia Giulia,1215220,71948,5.92,0.15
361,2021-03-21,FVG,810,318,492,0,91,0,485,6,228,599,211,ITH,ITH4,6,Friuli-Venezia Giulia,Friuli Venezia Giulia,1215220,72758,5.99,0.07
362,2021-02-18,FVG,3210,1488,1722,229,138,331,1500,34,978,2804,406,ITH,ITH4,6,Friuli-Venezia Giulia,Friuli Venezia Giulia,1215220,75968,6.25,0.26
363,2021-02-19,FVG,3251,1289,1962,566,323,312,1589,35,426,2822,429,ITH,ITH4,6,Friuli-Venezia Giulia,Friuli Venezia Giulia,1215220,79219,6.52,0.27
364,2021-01-14,FVG,2588,789,1799,1608,550,430,0,0,0,2588,0,ITH,ITH4,6,Friuli-Venezia Giulia,Friuli Venezia Giulia,1215220,81807,6.73,0.21
365,2021-02-27,FVG,3418,1176,2242,202,171,0,1523,25,1497,3418,0,ITH,ITH4,6,Friuli-Venezia Giulia,Friuli Venezia Giulia,1215220,85225,7.01,0.28
366,2021-01-02,FVG,1217,471,746,1150,67,0,0,0,0,1217,0,ITH,ITH4,6,Friuli-Venezia Giulia,Friuli Venezia Giulia,1215220,86442,7.11,0.1
367,2021-02-01,FVG,2093,687,1406,1587,371,135,0,0,0,14,2079,ITH,ITH4,6,Friuli-Venezia Giulia,Friuli Venezia Giulia,1215220,88535,7.29,0.17
368,2021-02-22,FVG,2492,1196,1296,431,326,115,1369,246,5,2074,418,ITH,ITH4,6,Friuli-Venezia Giulia,Friuli Venezia Giulia,1215220,91027,7.49,0.21
369,2021-03-15,FVG,3694,1612,2082,326,328,152,2420,234,234,1398,2296,ITH,ITH4,6,Friuli-Venezia Giulia,Friuli Venezia Giulia,1215220,94721,7.79,0.3
370,2020-12-31,FVG,1053,384,669,1011,42,0,0,0,0,1053,0,ITH,ITH4,6,Friuli-Venezia Giulia,Friuli Venezia Giulia,1215220,95774,7.88,0.09
371,2021-02-28,FVG,2668,988,1680,234,163,0,405,378,1488,2273,395,ITH,ITH4,6,Friuli-Venezia Giulia,Friuli Venezia Giulia,1215220,98442,8.1,0.22
372,2021-02-25,FVG,3067,1603,1464,21,127,189,1556,433,741,3042,25,ITH,ITH4,6,Friuli-Venezia Giulia,Friuli Venezia Giulia,1215220,101509,8.35,0.25
373,2021-02-21,FVG,800,281,519,213,177,25,383,1,1,423,377,ITH,ITH4,6,Friuli-Venezia Giulia,Friuli Venezia Giulia,1215220,102309,8.42,0.07
374,2021-03-01,FVG,2840,998,1842,82,97,164,1544,4,949,2799,41,ITH,ITH4,6,Friuli-Venezia Giulia,Friuli Venezia Giulia,1215220,105149,8.65,0.23
375,2021-01-29,FVG,2413,813,1600,1855,321,237,0,0,0,264,2149,ITH,ITH4,6,Friuli-Venezia Giulia,Friuli Venezia Giulia,1215220,107562,8.85,0.2
376,2021-01-12,FVG,2259,712,1547,1528,370,361,0,0,0,2259,0,ITH,ITH4,6,Friuli-Venezia Giulia,Friuli Venezia Giulia,1215220,109821,9.04,0.19
377,2021-03-09,FVG,3861,1590,2271,656,522,196,2003,60,424,1108,2753,ITH,ITH4,6,Friuli-Venezia Giulia,Friuli Venezia Giulia,1215220,113682,9.35,0.32
378,2021-02-05,FVG,2613,784,1829,1612,511,490,0,0,0,90,2523,ITH,ITH4,6,Friuli-Venezia Giulia,Friuli Venezia Giulia,1215220,116295,9.57,0.22
379,2021-02-06,FVG,1154,338,816,755,208,191,0,0,0,22,1132,ITH,ITH4,6,Friuli-Venezia Giulia,Friuli Venezia Giulia,1215220,117449,9.66,0.09
380,2021-01-04,FVG,1510,559,951,1392,118,0,0,0,0,1510,0,ITH,ITH4,6,Friuli-Venezia Giulia,Friuli Venezia Giulia,1215220,118959,9.79,0.12
381,2021-02-07,FVG,1561,483,1078,866,693,2,0,0,0,386,1175,ITH,ITH4,6,Friuli-Venezia Giulia,Friuli Venezia Giulia,1215220,120520,9.92,0.13
382,2020-12-30,FVG,630,246,384,601,29,0,0,0,0,630,0,ITH,ITH4,6,Friuli-Venezia Giulia,Friuli Venezia Giulia,1215220,121150,9.97,0.05
383,2021-01-25,FVG,1582,567,1015,1369,141,72,0,0,0,194,1388,ITH,ITH4,6,Friuli-Venezia Giulia,Friuli Venezia Giulia,1215220,122732,10.1,0.13
384,2021-01-21,FVG,894,345,549,863,31,0,0,0,0,1,893,ITH,ITH4,6,Friuli-Venezia Giulia,Friuli Venezia Giulia,1215220,123626,10.17,0.07
385,2021-02-23,FVG,2615,1252,1363,104,107,206,1943,254,1,2437,178,ITH,ITH4,6,Friuli-Venezia Giulia,Friuli Venezia Giulia,1215220,126241,10.39,0.22
386,2021-02-26,FVG,3736,2092,1644,75,140,451,1739,1032,299,3590,146,ITH,ITH4,6,Friuli-Venezia Giulia,Friuli Venezia Giulia,1215220,129977,10.7,0.31
387,2021-03-18,FVG,3154,1345,1809,53,220,64,2816,0,1,1566,1588,ITH,ITH4,6,Friuli-Venezia Giulia,Friuli Venezia Giulia,1215220,133131,10.96,0.26
388,2021-03-05,FVG,3617,1426,2191,1043,686,33,1668,43,144,2583,1034,ITH,ITH4,6,Friuli-Venezia Giulia,Friuli Venezia Giulia,1215220,136748,11.25,0.3
389,2021-01-30,FVG,2271,744,1527,1475,354,442,0,0,0,270,2001,ITH,ITH4,6,Friuli-Venezia Giulia,Friuli Venezia Giulia,1215220,139019,11.44,0.19
390,2021-02-03,FVG,2646,790,1856,1701,558,386,1,0,0,23,2623,ITH,ITH4,6,Friuli-Venezia Giulia,Friuli Venezia Giulia,1215220,141665,11.66,0.22
391,2021-01-03,FVG,312,122,190,285,26,1,0,0,0,312,0,ITH,ITH4,6,Friuli-Venezia Giulia,Friuli Venezia Giulia,1215220,141977,11.68,0.03
392,2021-01-31,FVG,2713,836,1877,1692,1003,18,0,0,0,385,2328,ITH,ITH4,6,Friuli-Venezia Giulia,Friuli Venezia Giulia,1215220,144690,11.91,0.22
393,2021-03-17,FVG,3082,1227,1855,422,302,111,2242,3,2,595,2487,ITH,ITH4,6,Friuli-Venezia Giulia,Friuli Venezia Giulia,1215220,147772,12.16,0.25
394,2021-02-10,FVG,1352,496,856,745,487,119,0,0,1,1266,86,ITH,ITH4,6,Friuli-Venezia Giulia,Friuli Venezia Giulia,1215220,149124,12.27,0.11
395,2021-01-26,FVG,1972,647,1325,1439,152,381,0,0,0,214,1758,ITH,ITH4,6,Friuli-Venezia Giulia,Friuli Venezia Giulia,1215220,151096,12.43,0.16
396,2021-03-10,FVG,3322,1491,1831,297,364,185,1972,309,195,1532,1790,ITH,ITH4,6,Friuli-Venezia Giulia,Friuli Venezia Giulia,1215220,154418,12.71,0.27
397,2021-03-14,FVG,1373,540,833,0,8,0,244,333,788,1123,250,ITH,ITH4,6,Friuli-Venezia Giulia,Friuli Venezia Giulia,1215220,155791,12.82,0.11
398,2021-01-19,FVG,7,2,5,5,0,2,0,0,0,7,0,ITH,ITH4,6,Friuli-Venezia Giulia,Friuli Venezia Giulia,1215220,155798,12.82,0.0
399,2021-01-10,FVG,2941,919,2022,1745,951,245,0,0,0,2941,0,ITH,ITH4,6,Friuli-Venezia Giulia,Friuli Venezia Giulia,1215220,158739,13.06,0.24
400,2021-01-13,FVG,2651,834,1817,1822,599,230,0,0,0,2651,0,ITH,ITH4,6,Friuli-Venezia Giulia,Friuli Venezia Giulia,1215220,161390,13.28,0.22
401,2021-03-19,FVG,2911,1241,1670,93,65,190,2433,0,130,1123,1788,ITH,ITH4,6,Friuli-Venezia Giulia,Friuli Venezia Giulia,1215220,164301,13.52,0.24
402,2021-01-17,FVG,1720,524,1196,674,560,486,0,0,0,1720,0,ITH,ITH4,6,Friuli-Venezia Giulia,Friuli Venezia Giulia,1215220,166021,13.66,0.14
403,2021-01-22,FVG,90,30,60,89,1,0,0,0,0,0,90,ITH,ITH4,6,Friuli-Venezia Giulia,Friuli Venezia Giulia,1215220,166111,13.67,0.01
404,2021-03-13,FVG,2927,1117,1810,10,15,86,2056,37,723,1656,1271,ITH,ITH4,6,Friuli-Venezia Giulia,Friuli Venezia Giulia,1215220,169038,13.91,0.24
405,2021-02-15,FVG,2451,909,1542,698,405,314,1034,0,0,2201,250,ITH,ITH4,6,Friuli-Venezia Giulia,Friuli Venezia Giulia,1215220,171489,14.11,0.2
406,2021-01-11,FVG,1882,609,1273,1500,336,46,0,0,0,1882,0,ITH,ITH4,6,Friuli-Venezia Giulia,Friuli Venezia Giulia,1215220,173371,14.27,0.15
407,2021-01-15,FVG,2028,606,1422,1283,370,375,0,0,0,2028,0,ITH,ITH4,6,Friuli-Venezia Giulia,Friuli Venezia Giulia,1215220,175399,14.43,0.17
408,2021-02-04,FVG,2731,807,1924,1723,543,465,0,0,0,36,2695,ITH,ITH4,6,Friuli-Venezia Giulia,Friuli Venezia Giulia,1215220,178130,14.66,0.22
409,2021-01-06,FVG,709,264,445,514,195,0,0,0,0,709,0,ITH,ITH4,6,Friuli-Venezia Giulia,Friuli Venezia Giulia,1215220,178839,14.72,0.06
410,2021-01-20,CAL,1395,622,773,864,352,179,0,0,0,1394,1,ITF,ITF6,18,Calabria,Calabria,1947131,1395,0.07,0.07
411,2021-03-11,CAL,6875,3276,3599,934,2063,570,2379,329,600,5619,1256,ITF,ITF6,18,Calabria,Calabria,1947131,8270,0.42,0.35
412,2021-03-17,CAL,3634,1621,2013,277,980,165,2093,26,93,1937,1697,ITF,ITF6,18,Calabria,Calabria,1947131,11904,0.61,0.19
413,2021-01-18,CAL,1230,550,680,982,237,11,0,0,0,1040,190,ITF,ITF6,18,Calabria,Calabria,1947131,13134,0.67,0.06
414,2021-03-06,CAL,7945,4053,3892,701,1872,758,3795,813,6,7190,755,ITF,ITF6,18,Calabria,Calabria,1947131,21079,1.08,0.41
415,2021-01-28,CAL,2232,1107,1125,1920,312,0,0,0,0,84,2148,ITF,ITF6,18,Calabria,Calabria,1947131,23311,1.2,0.11
416,2020-12-27,CAL,275,150,125,274,1,0,0,0,0,275,0,ITF,ITF6,18,Calabria,Calabria,1947131,23586,1.21,0.01
417,2021-03-18,CAL,4240,1978,2262,359,1365,232,2195,44,45,2271,1969,ITF,ITF6,18,Calabria,Calabria,1947131,27826,1.43,0.22
418,2021-03-19,CAL,4182,1946,2236,486,1330,292,1964,8,102,1898,2284,ITF,ITF6,18,Calabria,Calabria,1947131,32008,1.64,0.21
419,2021-01-30,CAL,2173,1147,1026,1974,199,0,0,0,0,358,1815,ITF,ITF6,18,Calabria,Calabria,1947131,34181,1.76,0.11
420,2021-01-12,CAL,2058,1017,1041,1706,323,29,0,0,0,2058,0,ITF,ITF6,18,Calabria,Calabria,1947131,36239,1.86,0.11
421,2021-03-16,CAL,3767,1847,1920,459,1121,22,2077,58,30,2171,1596,ITF,ITF6,18,Calabria,Calabria,1947131,40006,2.05,0.19
422,2021-02-08,CAL,1847,733,1114,1214,512,121,0,0,0,661,1186,ITF,ITF6,18,Calabria,Calabria,1947131,41853,2.15,0.09
423,2021-03-08,CAL,5312,2815,2497,707,1813,453,1514,822,3,4254,1058,ITF,ITF6,18,Calabria,Calabria,1947131,47165,2.42,0.27
424,2021-02-24,CAL,1843,940,903,658,366,115,653,47,4,1368,475,ITF,ITF6,18,Calabria,Calabria,1947131,49008,2.52,0.09
425,2021-01-29,CAL,2048,984,1064,1752,247,49,0,0,0,234,1814,ITF,ITF6,18,Calabria,Calabria,1947131,51056,2.62,0.11
426,2021-01-22,CAL,656,274,382,298,248,110,0,0,0,654,2,ITF,ITF6,18,Calabria,Calabria,1947131,51712,2.66,0.03
427,2021-03-20,CAL,6455,2975,3480,432,1588,395,3561,34,445,4070,2385,ITF,ITF6,18,Calabria,Calabria,1947131,58167,2.99,0.33
428,2021-01-27,CAL,1457,734,723,1226,208,23,0,0,0,396,1061,ITF,ITF6,18,Calabria,Calabria,1947131,59624,3.06,0.07
429,2021-03-05,CAL,6145,3540,2605,695,1589,710,1854,1292,5,5570,575,ITF,ITF6,18,Calabria,Calabria,1947131,65769,3.38,0.32
430,2021-02-28,CAL,2167,983,1184,113,152,190,1706,6,0,2016,151,ITF,ITF6,18,Calabria,Calabria,1947131,67936,3.49,0.11
431,2021-01-21,CAL,958,444,514,735,108,115,0,0,0,929,29,ITF,ITF6,18,Calabria,Calabria,1947131,68894,3.54,0.05
432,2021-01-05,CAL,1350,618,732,1256,94,0,0,0,0,1350,0,ITF,ITF6,18,Calabria,Calabria,1947131,70244,3.61,0.07
433,2021-01-16,CAL,2394,1120,1274,1664,489,241,0,0,0,2394,0,ITF,ITF6,18,Calabria,Calabria,1947131,72638,3.73,0.12
434,2021-01-02,CAL,165,94,71,165,0,0,0,0,0,165,0,ITF,ITF6,18,Calabria,Calabria,1947131,72803,3.74,0.01
435,2021-01-24,CAL,44,18,26,15,3,26,0,0,0,39,5,ITF,ITF6,18,Calabria,Calabria,1947131,72847,3.74,0.0
436,2021-02-26,CAL,3077,1630,1447,538,688,406,1147,294,4,2610,467,ITF,ITF6,18,Calabria,Calabria,1947131,75924,3.9,0.16
437,2021-01-06,CAL,926,500,426,822,104,0,0,0,0,926,0,ITF,ITF6,18,Calabria,Calabria,1947131,76850,3.95,0.05
438,2021-03-01,CAL,2688,1533,1155,399,422,257,971,636,3,2238,450,ITF,ITF6,18,Calabria,Calabria,1947131,79538,4.08,0.14
439,2021-02-14,CAL,371,145,226,146,142,83,0,0,0,341,30,ITF,ITF6,18,Calabria,Calabria,1947131,79909,4.1,0.02
440,2021-01-08,CAL,2109,1014,1095,1898,211,0,0,0,0,2109,0,ITF,ITF6,18,Calabria,Calabria,1947131,82018,4.21,0.11
441,2021-01-26,CAL,1805,861,944,1571,164,70,0,0,0,285,1520,ITF,ITF6,18,Calabria,Calabria,1947131,83823,4.3,0.09
442,2021-03-21,CAL,2077,853,1224,67,302,101,1194,19,394,1070,1007,ITF,ITF6,18,Calabria,Calabria,1947131,85900,4.41,0.11
443,2021-02-25,CAL,2821,1519,1302,736,636,234,863,348,4,2242,579,ITF,ITF6,18,Calabria,Calabria,1947131,88721,4.56,0.14
444,2021-03-07,CAL,3131,1561,1570,105,655,348,1674,347,2,3042,89,ITF,ITF6,18,Calabria,Calabria,1947131,91852,4.72,0.16
445,2021-02-11,CAL,2341,1043,1298,1464,636,241,0,0,0,1081,1260,ITF,ITF6,18,Calabria,Calabria,1947131,94193,4.84,0.12
446,2021-03-14,CAL,2542,1018,1524,322,376,312,802,9,721,2142,400,ITF,ITF6,18,Calabria,Calabria,1947131,96735,4.97,0.13
447,2021-02-09,CAL,2147,904,1243,1422,494,231,0,0,0,948,1199,ITF,ITF6,18,Calabria,Calabria,1947131,98882,5.08,0.11
448,2021-01-09,CAL,1916,1036,880,1529,387,0,0,0,0,1916,0,ITF,ITF6,18,Calabria,Calabria,1947131,100798,5.18,0.1
449,2021-03-12,CAL,5092,2438,2654,468,1326,217,1963,333,785,4049,1043,ITF,ITF6,18,Calabria,Calabria,1947131,105890,5.44,0.26
450,2021-03-04,CAL,5381,3104,2277,646,1413,731,1540,1049,2,4585,796,ITF,ITF6,18,Calabria,Calabria,1947131,111271,5.71,0.28
451,2021-01-31,CAL,1107,554,553,764,285,58,0,0,0,155,952,ITF,ITF6,18,Calabria,Calabria,1947131,112378,5.77,0.06
452,2021-01-04,CAL,996,492,504,969,27,0,0,0,0,996,0,ITF,ITF6,18,Calabria,Calabria,1947131,113374,5.82,0.05
453,2021-02-02,CAL,2289,1112,1177,1863,351,75,0,0,0,177,2112,ITF,ITF6,18,Calabria,Calabria,1947131,115663,5.94,0.12
454,2021-03-02,CAL,4131,2390,1741,705,735,427,1390,872,2,3422,709,ITF,ITF6,18,Calabria,Calabria,1947131,119794,6.15,0.21
455,2021-02-12,CAL,1711,669,1042,815,760,136,0,0,0,943,768,ITF,ITF6,18,Calabria,Calabria,1947131,121505,6.24,0.09
456,2021-03-03,CAL,4865,2651,2214,631,1157,917,1367,789,4,3802,1063,ITF,ITF6,18,Calabria,Calabria,1947131,126370,6.49,0.25
457,2021-02-04,CAL,3391,1623,1768,2560,609,222,0,0,0,644,2747,ITF,ITF6,18,Calabria,Calabria,1947131,129761,6.66,0.17
458,2021-02-06,CAL,2909,1337,1572,2095,567,247,0,0,0,442,2467,ITF,ITF6,18,Calabria,Calabria,1947131,132670,6.81,0.15
459,2021-03-09,CAL,5820,3031,2789,803,1939,419,1768,873,18,4843,977,ITF,ITF6,18,Calabria,Calabria,1947131,138490,7.11,0.3
460,2021-02-18,CAL,1799,802,997,585,509,299,345,0,61,1576,223,ITF,ITF6,18,Calabria,Calabria,1947131,140289,7.2,0.09
461,2021-02-13,CAL,1331,583,748,731,488,111,1,0,0,968,363,ITF,ITF6,18,Calabria,Calabria,1947131,141620,7.27,0.07
462,2021-01-25,CAL,1064,512,552,1021,43,0,0,0,0,156,908,ITF,ITF6,18,Calabria,Calabria,1947131,142684,7.33,0.05
463,2021-02-19,CAL,1461,652,809,544,341,195,380,1,0,1200,261,ITF,ITF6,18,Calabria,Calabria,1947131,144145,7.4,0.08
464,2021-03-10,CAL,6441,3278,3163,742,2351,586,2021,677,64,5250,1191,ITF,ITF6,18,Calabria,Calabria,1947131,150586,7.73,0.33
465,2021-01-11,CAL,2154,1040,1114,1759,392,3,0,0,0,2154,0,ITF,ITF6,18,Calabria,Calabria,1947131,152740,7.84,0.11
466,2021-02-15,CAL,1137,538,599,499,412,159,66,0,1,989,148,ITF,ITF6,18,Calabria,Calabria,1947131,153877,7.9,0.06
467,2021-02-05,CAL,3795,1709,2086,2327,914,554,0,0,0,488,3307,ITF,ITF6,18,Calabria,Calabria,1947131,157672,8.1,0.19
468,2021-01-17,CAL,867,418,449,527,292,48,0,0,0,801,66,ITF,ITF6,18,Calabria,Calabria,1947131,158539,8.14,0.04
469,2021-02-27,CAL,3679,1913,1766,421,588,395,1971,302,2,3301,378,ITF,ITF6,18,Calabria,Calabria,1947131,162218,8.33,0.19
470,2021-02-17,CAL,1681,672,1009,673,343,285,299,0,81,1471,210,ITF,ITF6,18,Calabria,Calabria,1947131,163899,8.42,0.09
471,2021-03-15,CAL,3443,1650,1793,542,923,136,1093,163,586,2018,1425,ITF,ITF6,18,Calabria,Calabria,1947131,167342,8.59,0.18
472,2021-01-14,CAL,2557,1214,1343,1962,592,3,0,0,0,2557,0,ITF,ITF6,18,Calabria,Calabria,1947131,169899,8.73,0.13
473,2021-01-07,CAL,2180,1061,1119,1883,297,0,0,0,0,2180,0,ITF,ITF6,18,Calabria,Calabria,1947131,172079,8.84,0.11
474,2021-02-23,CAL,1549,728,821,437,381,206,522,2,1,1434,115,ITF,ITF6,18,Calabria,Calabria,1947131,173628,8.92,0.08
475,2021-02-03,CAL,2763,1428,1335,2170,490,103,0,0,0,583,2180,ITF,ITF6,18,Calabria,Calabria,1947131,176391,9.06,0.14
476,2021-01-13,CAL,2028,1022,1006,1800,194,34,0,0,0,2028,0,ITF,ITF6,18,Calabria,Calabria,1947131,178419,9.16,0.1
477,2021-03-13,CAL,6653,2933,3720,425,1376,338,3764,65,685,5679,974,ITF,ITF6,18,Calabria,Calabria,1947131,185072,9.5,0.34
478,2021-02-07,CAL,859,428,431,566,212,81,0,0,0,147,712,ITF,ITF6,18,Calabria,Calabria,1947131,185931,9.55,0.04
479,2021-02-21,CAL,608,286,322,36,164,47,331,30,0,531,77,ITF,ITF6,18,Calabria,Calabria,1947131,186539,9.58,0.03
480,2021-02-16,CAL,1534,643,891,659,517,240,118,0,0,1255,279,ITF,ITF6,18,Calabria,Calabria,1947131,188073,9.66,0.08
481,2021-01-19,CAL,1109,488,621,853,180,76,0,0,0,1098,11,ITF,ITF6,18,Calabria,Calabria,1947131,189182,9.72,0.06
482,2021-01-10,CAL,929,524,405,830,99,0,0,0,0,929,0,ITF,ITF6,18,Calabria,Calabria,1947131,190111,9.76,0.05
483,2021-02-10,CAL,2463,1074,1389,1469,637,357,0,0,0,839,1624,ITF,ITF6,18,Calabria,Calabria,1947131,192574,9.89,0.13
484,2021-01-23,CAL,400,186,214,325,52,23,0,0,0,358,42,ITF,ITF6,18,Calabria,Calabria,1947131,192974,9.91,0.02
485,2021-02-20,CAL,1358,735,623,438,411,55,433,19,2,1043,315,ITF,ITF6,18,Calabria,Calabria,1947131,194332,9.98,0.07
486,2021-02-01,CAL,2497,1192,1305,2044,410,43,0,0,0,248,2249,ITF,ITF6,18,Calabria,Calabria,1947131,196829,10.11,0.13
487,2021-01-03,CAL,6,3,3,4,2,0,0,0,0,6,0,ITF,ITF6,18,Calabria,Calabria,1947131,196835,10.11,0.0
488,2021-02-22,CAL,1996,1013,983,727,543,166,552,3,5,1441,555,ITF,ITF6,18,Calabria,Calabria,1947131,198831,10.21,0.1
489,2021-01-15,CAL,2793,1258,1535,1690,691,412,0,0,0,2793,0,ITF,ITF6,18,Calabria,Calabria,1947131,201624,10.35,0.14
490,2020-12-28,CAL,6,2,4,6,0,0,0,0,0,6,0,ITF,ITF6,18,Calabria,Calabria,1947131,201630,10.36,0.0
491,2021-02-11,LOM,16761,4937,11824,9642,3246,3831,32,4,6,9437,7324,ITC,ITC4,3,Lombardia,Lombardia,10060574,16761,0.17,0.17
492,2021-02-10,LOM,14117,4430,9687,8412,2357,3268,71,3,6,7413,6704,ITC,ITC4,3,Lombardia,Lombardia,10060574,30878,0.31,0.14
493,2021-02-23,LOM,11669,4761,6908,3935,1614,831,4296,990,3,11361,308,ITC,ITC4,3,Lombardia,Lombardia,10060574,42547,0.42,0.12
494,2021-01-13,LOM,25750,7917,17833,15546,5950,4062,189,2,1,25750,0,ITC,ITC4,3,Lombardia,Lombardia,10060574,68297,0.68,0.26
495,2021-03-08,LOM,28804,10774,18030,6487,4018,1011,11192,1575,4521,21898,6906,ITC,ITC4,3,Lombardia,Lombardia,10060574,97101,0.97,0.29
496,2021-01-22,LOM,2892,815,2077,1546,610,727,9,0,0,2839,53,ITC,ITC4,3,Lombardia,Lombardia,10060574,99993,0.99,0.03
497,2021-03-12,LOM,33553,12440,21113,5005,4050,1385,15303,1075,6735,23532,10021,ITC,ITC4,3,Lombardia,Lombardia,10060574,133546,1.33,0.33
498,2021-02-08,LOM,9800,2859,6941,5194,2239,2314,53,0,0,2089,7711,ITC,ITC4,3,Lombardia,Lombardia,10060574,143346,1.42,0.1
499,2020-12-31,LOM,713,300,413,657,56,0,0,0,0,713,0,ITC,ITC4,3,Lombardia,Lombardia,10060574,144059,1.43,0.01
500,2021-02-28,LOM,7823,3230,4593,1106,2280,76,4248,82,31,7607,216,ITC,ITC4,3,Lombardia,Lombardia,10060574,151882,1.51,0.08
501,2021-03-19,LOM,30463,12171,18292,2646,2802,1113,20891,149,2862,18235,12228,ITC,ITC4,3,Lombardia,Lombardia,10060574,182345,1.81,0.3
502,2021-02-15,LOM,8779,3073,5706,6010,1750,975,4,31,9,8359,420,ITC,ITC4,3,Lombardia,Lombardia,10060574,191124,1.9,0.09
503,2021-02-18,LOM,13937,4896,9041,6113,1945,1567,3427,857,28,12914,1023,ITC,ITC4,3,Lombardia,Lombardia,10060574,205061,2.04,0.14
504,2021-03-15,LOM,30826,11030,19796,4585,3934,814,12803,517,8173,22487,8339,ITC,ITC4,3,Lombardia,Lombardia,10060574,235887,2.34,0.31
505,2021-02-19,LOM,14013,5351,8662,5526,1884,1119,4540,928,16,13353,660,ITC,ITC4,3,Lombardia,Lombardia,10060574,249900,2.48,0.14
506,2021-01-12,LOM,19689,6561,13128,13370,4665,1562,91,1,0,19689,0,ITC,ITC4,3,Lombardia,Lombardia,10060574,269589,2.68,0.2
507,2021-03-10,LOM,31854,12136,19718,6756,4801,1860,11491,1524,5422,24318,7536,ITC,ITC4,3,Lombardia,Lombardia,10060574,301443,3.0,0.32
508,2021-03-17,LOM,25066,9962,15104,2478,2245,1852,18408,44,39,14596,10470,ITC,ITC4,3,Lombardia,Lombardia,10060574,326509,3.25,0.25
509,2021-02-17,LOM,11757,3705,8052,7564,2249,1857,39,38,10,10402,1355,ITC,ITC4,3,Lombardia,Lombardia,10060574,338266,3.36,0.12
510,2020-12-27,LOM,702,407,295,601,86,14,1,0,0,702,0,ITC,ITC4,3,Lombardia,Lombardia,10060574,338968,3.37,0.01
511,2021-03-11,LOM,34654,12995,21659,5647,4584,2051,14964,1216,6192,25136,9518,ITC,ITC4,3,Lombardia,Lombardia,10060574,373622,3.71,0.34
512,2021-02-02,LOM,19805,6567,13238,13480,4562,1679,76,7,1,489,19316,ITC,ITC4,3,Lombardia,Lombardia,10060574,393427,3.91,0.2
513,2021-01-20,LOM,5577,1363,4214,2742,1219,1557,59,0,0,5462,115,ITC,ITC4,3,Lombardia,Lombardia,10060574,399004,3.97,0.06
514,2021-01-02,LOM,199,72,127,178,21,0,0,0,0,199,0,ITC,ITC4,3,Lombardia,Lombardia,10060574,399203,3.97,0.0
515,2021-01-10,LOM,10512,3955,6557,8170,2243,85,11,2,1,10512,0,ITC,ITC4,3,Lombardia,Lombardia,10060574,409715,4.07,0.1
516,2021-03-14,LOM,13517,4733,8784,1493,1324,80,5258,396,4966,10248,3269,ITC,ITC4,3,Lombardia,Lombardia,10060574,423232,4.21,0.13
517,2021-03-03,LOM,26212,11172,15040,6271,6340,1585,9701,1845,470,19156,7056,ITC,ITC4,3,Lombardia,Lombardia,10060574,449444,4.47,0.26
518,2021-03-06,LOM,20783,8838,11945,4716,5887,438,7384,1011,1347,16278,4505,ITC,ITC4,3,Lombardia,Lombardia,10060574,470227,4.67,0.21
519,2021-01-18,LOM,9019,2929,6090,5154,2045,1764,54,2,0,8037,982,ITC,ITC4,3,Lombardia,Lombardia,10060574,479246,4.76,0.09
520,2021-01-05,LOM,7673,2513,5160,6160,1334,172,7,0,0,7673,0,ITC,ITC4,3,Lombardia,Lombardia,10060574,486919,4.84,0.08
521,2021-02-22,LOM,11655,4713,6942,4165,1536,932,4029,965,28,11346,309,ITC,ITC4,3,Lombardia,Lombardia,10060574,498574,4.96,0.12
522,2021-03-09,LOM,31927,12214,19713,6018,4873,2253,11948,1426,5409,24629,7298,ITC,ITC4,3,Lombardia,Lombardia,10060574,530501,5.27,0.32
523,2021-02-12,LOM,13367,4190,9177,7927,2631,2699,102,5,3,8709,4658,ITC,ITC4,3,Lombardia,Lombardia,10060574,543868,5.41,0.13
524,2021-01-25,LOM,7020,2370,4650,5629,1159,218,14,0,0,486,6534,ITC,ITC4,3,Lombardia,Lombardia,10060574,550888,5.48,0.07
525,2021-01-27,LOM,8028,2675,5353,6192,1399,434,1,0,2,820,7208,ITC,ITC4,3,Lombardia,Lombardia,10060574,558916,5.56,0.08
526,2021-02-06,LOM,15027,5462,9565,9697,3395,1860,71,1,3,977,14050,ITC,ITC4,3,Lombardia,Lombardia,10060574,573943,5.7,0.15
527,2021-03-21,LOM,7935,3006,4929,390,591,122,3665,544,2623,5486,2449,ITC,ITC4,3,Lombardia,Lombardia,10060574,581878,5.78,0.08
528,2021-03-16,LOM,25057,9933,15124,3274,2881,1379,17431,17,75,16141,8916,ITC,ITC4,3,Lombardia,Lombardia,10060574,606935,6.03,0.25
529,2021-01-21,LOM,5322,1566,3756,3008,1286,1024,4,0,0,4635,687,ITC,ITC4,3,Lombardia,Lombardia,10060574,612257,6.09,0.05
530,2021-02-04,LOM,27160,7963,19197,15583,5876,5500,194,7,0,1940,25220,ITC,ITC4,3,Lombardia,Lombardia,10060574,639417,6.36,0.27
531,2021-02-20,LOM,9385,3879,5506,4275,1110,216,2917,863,4,9092,293,ITC,ITC4,3,Lombardia,Lombardia,10060574,648802,6.45,0.09
532,2021-01-08,LOM,12593,3896,8697,9959,2316,313,5,0,0,12593,0,ITC,ITC4,3,Lombardia,Lombardia,10060574,661395,6.57,0.13
533,2020-12-30,LOM,113,42,71,105,8,0,0,0,0,113,0,ITC,ITC4,3,Lombardia,Lombardia,10060574,661508,6.58,0.0
534,2021-02-21,LOM,5004,1851,3153,1743,959,32,2227,40,3,4984,20,ITC,ITC4,3,Lombardia,Lombardia,10060574,666512,6.62,0.05
535,2021-02-09,LOM,12057,3292,8765,5703,2291,3982,75,2,4,4000,8057,ITC,ITC4,3,Lombardia,Lombardia,10060574,678569,6.74,0.12
536,2021-02-03,LOM,25300,7849,17451,15502,5690,3957,142,8,1,1119,24181,ITC,ITC4,3,Lombardia,Lombardia,10060574,703869,7.0,0.25
537,2021-01-03,LOM,852,316,536,744,103,4,1,0,0,852,0,ITC,ITC4,3,Lombardia,Lombardia,10060574,704721,7.0,0.01
538,2021-01-01,LOM,24,7,17,24,0,0,0,0,0,24,0,ITC,ITC4,3,Lombardia,Lombardia,10060574,704745,7.01,0.0
539,2021-02-07,LOM,7172,2793,4379,5540,1345,263,17,2,5,339,6833,ITC,ITC4,3,Lombardia,Lombardia,10060574,711917,7.08,0.07
540,2021-01-04,LOM,5977,2058,3919,4916,877,173,11,0,0,5977,0,ITC,ITC4,3,Lombardia,Lombardia,10060574,717894,7.14,0.06
541,2021-01-28,LOM,12154,3683,8471,9171,1982,971,28,1,1,775,11379,ITC,ITC4,3,Lombardia,Lombardia,10060574,730048,7.26,0.12
542,2021-02-16,LOM,9442,3072,6370,5821,2248,1338,8,8,19,8992,450,ITC,ITC4,3,Lombardia,Lombardia,10060574,739490,7.35,0.09
543,2021-01-09,LOM,12376,4558,7818,9498,2675,196,6,1,0,12376,0,ITC,ITC4,3,Lombardia,Lombardia,10060574,751866,7.47,0.12
544,2021-02-25,LOM,14915,6200,8715,2851,1563,1287,7988,1216,10,13508,1407,ITC,ITC4,3,Lombardia,Lombardia,10060574,766781,7.62,0.15
545,2021-01-19,LOM,8003,2322,5681,4013,1807,2117,65,1,0,7527,476,ITC,ITC4,3,Lombardia,Lombardia,10060574,774784,7.7,0.08
546,2021-02-14,LOM,3558,1539,2019,2749,772,24,3,0,10,2937,621,ITC,ITC4,3,Lombardia,Lombardia,10060574,778342,7.74,0.04
547,2021-02-27,LOM,13813,5817,7996,2001,1868,558,8247,1091,48,13269,544,ITC,ITC4,3,Lombardia,Lombardia,10060574,792155,7.87,0.14
548,2021-03-18,LOM,25549,10169,15380,2099,1992,1387,19930,44,97,15340,10209,ITC,ITC4,3,Lombardia,Lombardia,10060574,817704,8.13,0.25
549,2021-01-17,LOM,8224,3314,4910,5536,2436,211,36,5,0,8024,200,ITC,ITC4,3,Lombardia,Lombardia,10060574,825928,8.21,0.08
550,2021-01-31,LOM,9727,3754,5973,7568,2063,87,7,2,0,33,9694,ITC,ITC4,3,Lombardia,Lombardia,10060574,835655,8.31,0.1
551,2021-02-01,LOM,16027,5307,10720,11659,3421,902,43,1,1,324,15703,ITC,ITC4,3,Lombardia,Lombardia,10060574,851682,8.47,0.16
552,2021-01-16,LOM,15264,5688,9576,8555,5074,1480,152,3,0,15264,0,ITC,ITC4,3,Lombardia,Lombardia,10060574,866946,8.62,0.15
553,2021-03-01,LOM,18517,8118,10399,2624,2607,871,10779,1608,28,16829,1688,ITC,ITC4,3,Lombardia,Lombardia,10060574,885463,8.8,0.18
554,2021-01-06,LOM,7045,2486,4559,5838,1167,38,0,0,2,7045,0,ITC,ITC4,3,Lombardia,Lombardia,10060574,892508,8.87,0.07
555,2021-01-26,LOM,8325,2704,5621,6640,1440,223,22,0,0,334,7991,ITC,ITC4,3,Lombardia,Lombardia,10060574,900833,8.95,0.08
556,2021-03-07,LOM,10792,4751,6041,2998,1994,73,4520,552,655,8240,2552,ITC,ITC4,3,Lombardia,Lombardia,10060574,911625,9.06,0.11
557,2020-12-28,LOM,103,44,59,102,1,0,0,0,0,103,0,ITC,ITC4,3,Lombardia,Lombardia,10060574,911728,9.06,0.0
558,2021-02-26,LOM,17883,7396,10487,3083,1912,1155,10406,1303,24,16254,1629,ITC,ITC4,3,Lombardia,Lombardia,10060574,929611,9.24,0.18
559,2021-03-05,LOM,27847,11468,16379,6992,6550,1469,10531,1900,405,19710,8137,ITC,ITC4,3,Lombardia,Lombardia,10060574,957458,9.52,0.28
560,2020-12-29,LOM,100,43,57,100,0,0,0,0,0,100,0,ITC,ITC4,3,Lombardia,Lombardia,10060574,957558,9.52,0.0
561,2021-01-24,LOM,1185,453,732,829,331,24,1,0,0,523,662,ITC,ITC4,3,Lombardia,Lombardia,10060574,958743,9.53,0.01
562,2021-03-04,LOM,28793,11905,16888,6884,6799,2038,10777,1919,376,19941,8852,ITC,ITC4,3,Lombardia,Lombardia,10060574,987536,9.82,0.29
563,2021-03-20,LOM,30498,11260,19238,1862,2957,466,17176,284,7753,20963,9535,ITC,ITC4,3,Lombardia,Lombardia,10060574,1018034,10.12,0.3
564,2021-01-29,LOM,13436,4114,9322,10485,2369,573,9,0,0,654,12782,ITC,ITC4,3,Lombardia,Lombardia,10060574,1031470,10.25,0.13
565,2021-02-24,LOM,14561,5891,8670,3568,1747,1779,6262,1181,24,13639,922,ITC,ITC4,3,Lombardia,Lombardia,10060574,1046031,10.4,0.14
566,2021-01-30,LOM,12309,4565,7744,9902,2237,160,8,1,1,192,12117,ITC,ITC4,3,Lombardia,Lombardia,10060574,1058340,10.52,0.12
567,2021-02-05,LOM,24953,7248,17705,14100,6219,4375,258,1,0,2132,22821,ITC,ITC4,3,Lombardia,Lombardia,10060574,1083293,10.77,0.25
568,2021-01-07,LOM,11557,3594,7963,8956,1925,652,22,1,1,11557,0,ITC,ITC4,3,Lombardia,Lombardia,10060574,1094850,10.88,0.11
569,2021-02-13,LOM,6379,2430,3949,4172,1500,682,17,4,4,4930,1449,ITC,ITC4,3,Lombardia,Lombardia,10060574,1101229,10.95,0.06
570,2021-03-02,LOM,22398,9540,12858,3038,4189,2044,11219,1778,130,19468,2930,ITC,ITC4,3,Lombardia,Lombardia,10060574,1123627,11.17,0.22
571,2021-03-13,LOM,25393,9091,16302,3724,3022,250,10079,613,7705,19409,5984,ITC,ITC4,3,Lombardia,Lombardia,10060574,1149020,11.42,0.25
572,2021-01-14,LOM,26255,7670,18585,14942,5732,5352,228,1,0,26255,0,ITC,ITC4,3,Lombardia,Lombardia,10060574,1175275,11.68,0.26
573,2021-01-23,LOM,1114,357,757,644,332,138,0,0,0,916,198,ITC,ITC4,3,Lombardia,Lombardia,10060574,1176389,11.69,0.01
574,2021-01-11,LOM,15982,5311,10671,11781,3457,699,42,1,2,15982,0,ITC,ITC4,3,Lombardia,Lombardia,10060574,1192371,11.85,0.16
575,2021-01-15,LOM,24443,7194,17249,13560,6190,4389,302,2,0,24443,0,ITC,ITC4,3,Lombardia,Lombardia,10060574,1216814,12.09,0.24
576,2021-02-08,SAR,1470,533,937,998,345,126,1,0,0,856,614,ITG,ITG2,20,Sardegna,Sardegna,1639591,1470,0.09,0.09
577,2021-02-22,SAR,1623,944,679,597,404,180,2,440,0,1395,228,ITG,ITG2,20,Sardegna,Sardegna,1639591,3093,0.19,0.1
578,2021-03-04,SAR,3880,1888,1992,953,860,462,1091,475,39,2732,1148,ITG,ITG2,20,Sardegna,Sardegna,1639591,6973,0.43,0.24
579,2021-01-01,SAR,30,16,14,30,0,0,0,0,0,30,0,ITG,ITG2,20,Sardegna,Sardegna,1639591,7003,0.43,0.0
580,2021-03-12,SAR,5609,2350,3259,1035,1255,451,2438,271,159,4302,1307,ITG,ITG2,20,Sardegna,Sardegna,1639591,12612,0.77,0.34
581,2021-01-19,SAR,747,270,477,423,163,160,0,0,1,692,55,ITG,ITG2,20,Sardegna,Sardegna,1639591,13359,0.81,0.05
582,2021-02-17,SAR,1405,575,830,689,376,313,0,27,0,1330,75,ITG,ITG2,20,Sardegna,Sardegna,1639591,14764,0.9,0.09
583,2021-03-06,SAR,2535,1046,1489,1086,922,405,7,79,36,852,1683,ITG,ITG2,20,Sardegna,Sardegna,1639591,17299,1.06,0.15
584,2021-01-22,SAR,83,47,36,45,38,0,0,0,0,55,28,ITG,ITG2,20,Sardegna,Sardegna,1639591,17382,1.06,0.01
585,2021-03-03,SAR,3741,2035,1706,1058,716,525,701,740,1,2603,1138,ITG,ITG2,20,Sardegna,Sardegna,1639591,21123,1.29,0.23
586,2021-02-16,SAR,700,289,411,376,212,112,0,0,0,673,27,ITG,ITG2,20,Sardegna,Sardegna,1639591,21823,1.33,0.04
587,2021-01-09,SAR,4026,1417,2609,3181,845,0,0,0,0,4026,0,ITG,ITG2,20,Sardegna,Sardegna,1639591,25849,1.58,0.25
588,2021-01-29,SAR,2951,1067,1884,2580,368,3,0,0,0,48,2903,ITG,ITG2,20,Sardegna,Sardegna,1639591,28800,1.76,0.18
589,2021-02-26,SAR,2796,1106,1690,1224,1069,221,203,74,5,2490,306,ITG,ITG2,20,Sardegna,Sardegna,1639591,31596,1.93,0.17
590,2021-01-13,SAR,573,178,395,494,79,0,0,0,0,573,0,ITG,ITG2,20,Sardegna,Sardegna,1639591,32169,1.96,0.03
591,2021-03-21,SAR,1899,846,1053,7,137,0,1397,33,325,1051,848,ITG,ITG2,20,Sardegna,Sardegna,1639591,34068,2.08,0.12
592,2021-02-23,SAR,1519,1010,509,602,521,89,6,301,0,1285,234,ITG,ITG2,20,Sardegna,Sardegna,1639591,35587,2.17,0.09
593,2021-03-11,SAR,5743,2597,3146,1009,1061,416,2666,489,102,4526,1217,ITG,ITG2,20,Sardegna,Sardegna,1639591,41330,2.52,0.35
594,2021-03-01,SAR,2159,1054,1105,1135,444,141,104,334,1,1500,659,ITG,ITG2,20,Sardegna,Sardegna,1639591,43489,2.65,0.13
595,2021-02-09,SAR,2286,837,1449,1308,479,497,1,0,1,1290,996,ITG,ITG2,20,Sardegna,Sardegna,1639591,45775,2.79,0.14
596,2021-02-21,SAR,1584,709,875,66,32,59,1421,6,0,1554,30,ITG,ITG2,20,Sardegna,Sardegna,1639591,47359,2.89,0.1
597,2021-01-31,SAR,2121,750,1371,1544,576,0,1,0,0,48,2073,ITG,ITG2,20,Sardegna,Sardegna,1639591,49480,3.02,0.13
598,2021-02-01,SAR,1524,605,919,896,551,77,0,0,0,225,1299,ITG,ITG2,20,Sardegna,Sardegna,1639591,51004,3.11,0.09
599,2021-01-04,SAR,591,217,374,565,26,0,0,0,0,591,0,ITG,ITG2,20,Sardegna,Sardegna,1639591,51595,3.15,0.04
600,2021-02-02,SAR,1482,655,827,988,494,0,0,0,0,241,1241,ITG,ITG2,20,Sardegna,Sardegna,1639591,53077,3.24,0.09
601,2021-01-05,SAR,1327,446,881,1283,44,0,0,0,0,1327,0,ITG,ITG2,20,Sardegna,Sardegna,1639591,54404,3.32,0.08
602,2020-12-27,SAR,65,34,31,65,0,0,0,0,0,65,0,ITG,ITG2,20,Sardegna,Sardegna,1639591,54469,3.32,0.0
603,2021-01-20,SAR,210,77,133,154,56,0,0,0,0,208,2,ITG,ITG2,20,Sardegna,Sardegna,1639591,54679,3.33,0.01
604,2021-03-16,SAR,3906,1738,2168,644,837,311,2106,0,8,2975,931,ITG,ITG2,20,Sardegna,Sardegna,1639591,58585,3.57,0.24
605,2021-02-14,SAR,539,263,276,286,193,57,3,0,0,537,2,ITG,ITG2,20,Sardegna,Sardegna,1639591,59124,3.61,0.03
606,2021-01-07,SAR,3111,1077,2034,2720,380,0,0,11,0,3111,0,ITG,ITG2,20,Sardegna,Sardegna,1639591,62235,3.8,0.19
607,2020-12-28,SAR,65,25,40,65,0,0,0,0,0,65,0,ITG,ITG2,20,Sardegna,Sardegna,1639591,62300,3.8,0.0
608,2021-03-18,SAR,6273,2621,3652,1065,1370,354,3416,6,62,4672,1601,ITG,ITG2,20,Sardegna,Sardegna,1639591,68573,4.18,0.38
609,2021-02-05,SAR,1897,749,1148,1214,515,164,1,3,0,433,1464,ITG,ITG2,20,Sardegna,Sardegna,1639591,70470,4.3,0.12
610,2021-01-26,SAR,1336,453,883,1296,39,0,0,0,1,27,1309,ITG,ITG2,20,Sardegna,Sardegna,1639591,71806,4.38,0.08
611,2021-02-28,SAR,367,169,198,244,76,47,0,0,0,141,226,ITG,ITG2,20,Sardegna,Sardegna,1639591,72173,4.4,0.02
612,2021-02-18,SAR,1876,732,1144,1072,362,298,1,33,110,1812,64,ITG,ITG2,20,Sardegna,Sardegna,1639591,74049,4.52,0.11
613,2021-03-09,SAR,5140,2368,2772,1055,892,285,2266,332,310,4410,730,ITG,ITG2,20,Sardegna,Sardegna,1639591,79189,4.83,0.31
614,2021-03-15,SAR,2679,1215,1464,457,648,85,323,149,1017,2306,373,ITG,ITG2,20,Sardegna,Sardegna,1639591,81868,4.99,0.16
615,2021-01-02,SAR,60,21,39,60,0,0,0,0,0,60,0,ITG,ITG2,20,Sardegna,Sardegna,1639591,81928,5.0,0.0
616,2021-03-10,SAR,5697,2764,2933,719,872,413,2701,657,335,4844,853,ITG,ITG2,20,Sardegna,Sardegna,1639591,87625,5.34,0.35
617,2021-03-05,SAR,4955,2426,2529,1690,1361,669,566,659,10,2669,2286,ITG,ITG2,20,Sardegna,Sardegna,1639591,92580,5.65,0.3
618,2021-01-14,SAR,1105,426,679,885,220,0,0,0,0,1105,0,ITG,ITG2,20,Sardegna,Sardegna,1639591,93685,5.71,0.07
619,2021-01-12,SAR,865,408,457,504,361,0,0,0,0,865,0,ITG,ITG2,20,Sardegna,Sardegna,1639591,94550,5.77,0.05
620,2021-01-11,SAR,1183,505,678,656,526,0,1,0,0,1183,0,ITG,ITG2,20,Sardegna,Sardegna,1639591,95733,5.84,0.07
621,2021-01-25,SAR,588,212,376,553,35,0,0,0,0,22,566,ITG,ITG2,20,Sardegna,Sardegna,1639591,96321,5.87,0.04
622,2021-01-17,SAR,860,277,583,747,113,0,0,0,0,859,1,ITG,ITG2,20,Sardegna,Sardegna,1639591,97181,5.93,0.05
623,2021-03-19,SAR,6502,2677,3825,1284,1936,213,2870,189,10,4310,2192,ITG,ITG2,20,Sardegna,Sardegna,1639591,103683,6.32,0.4
624,2021-01-16,SAR,1492,525,967,1282,209,0,0,0,1,1492,0,ITG,ITG2,20,Sardegna,Sardegna,1639591,105175,6.41,0.09
625,2021-01-08,SAR,3257,1184,2073,2929,328,0,0,0,0,3257,0,ITG,ITG2,20,Sardegna,Sardegna,1639591,108432,6.61,0.2
626,2021-03-08,SAR,3965,1777,2188,732,1160,624,852,444,153,2776,1189,ITG,ITG2,20,Sardegna,Sardegna,1639591,112397,6.86,0.24
627,2021-02-12,SAR,2237,933,1304,986,749,501,1,0,0,2178,59,ITG,ITG2,20,Sardegna,Sardegna,1639591,114634,6.99,0.14
628,2021-01-15,SAR,1563,573,990,1170,390,0,0,3,0,1563,0,ITG,ITG2,20,Sardegna,Sardegna,1639591,116197,7.09,0.1
629,2021-03-20,SAR,4795,1914,2881,693,534,125,2483,105,855,2580,2215,ITG,ITG2,20,Sardegna,Sardegna,1639591,120992,7.38,0.29
630,2021-02-24,SAR,2410,1292,1118,1193,614,301,3,299,0,2221,189,ITG,ITG2,20,Sardegna,Sardegna,1639591,123402,7.53,0.15
631,2021-01-27,SAR,1408,494,914,1303,105,0,0,0,0,79,1329,ITG,ITG2,20,Sardegna,Sardegna,1639591,124810,7.61,0.09
632,2021-01-23,SAR,60,22,38,60,0,0,0,0,0,0,60,ITG,ITG2,20,Sardegna,Sardegna,1639591,124870,7.62,0.0
633,2021-03-07,SAR,1590,724,866,307,238,32,1011,0,2,1117,473,ITG,ITG2,20,Sardegna,Sardegna,1639591,126460,7.71,0.1
634,2021-03-02,SAR,2738,1415,1323,1044,730,260,319,383,2,1705,1033,ITG,ITG2,20,Sardegna,Sardegna,1639591,129198,7.88,0.17
635,2021-02-11,SAR,1314,490,824,588,356,369,1,0,0,1203,111,ITG,ITG2,20,Sardegna,Sardegna,1639591,130512,7.96,0.08
636,2021-02-19,SAR,1495,470,1025,677,437,379,1,1,0,1439,56,ITG,ITG2,20,Sardegna,Sardegna,1639591,132007,8.05,0.09
637,2021-02-25,SAR,2899,1255,1644,1474,738,466,161,51,9,2293,606,ITG,ITG2,20,Sardegna,Sardegna,1639591,134906,8.23,0.18
638,2021-01-06,SAR,1615,549,1066,1510,105,0,0,0,0,1615,0,ITG,ITG2,20,Sardegna,Sardegna,1639591,136521,8.33,0.1
639,2020-12-29,SAR,57,32,25,56,1,0,0,0,0,57,0,ITG,ITG2,20,Sardegna,Sardegna,1639591,136578,8.33,0.0
640,2021-02-10,SAR,1959,765,1194,1169,301,488,0,0,1,1441,518,ITG,ITG2,20,Sardegna,Sardegna,1639591,138537,8.45,0.12
641,2021-03-13,SAR,2677,1035,1642,274,394,147,1686,43,133,2396,281,ITG,ITG2,20,Sardegna,Sardegna,1639591,141214,8.61,0.16
642,2021-01-28,SAR,2968,1044,1924,2554,403,0,0,11,0,69,2899,ITG,ITG2,20,Sardegna,Sardegna,1639591,144182,8.79,0.18
643,2021-01-10,SAR,2183,750,1433,1632,551,0,0,0,0,2183,0,ITG,ITG2,20,Sardegna,Sardegna,1639591,146365,8.93,0.13
644,2021-03-17,SAR,5887,2524,3363,1066,1379,528,2783,3,128,4284,1603,ITG,ITG2,20,Sardegna,Sardegna,1639591,152252,9.29,0.36
645,2021-03-14,SAR,606,376,230,34,236,0,251,73,12,606,0,ITG,ITG2,20,Sardegna,Sardegna,1639591,152858,9.32,0.04
646,2021-02-15,SAR,958,349,609,440,239,279,0,0,0,927,31,ITG,ITG2,20,Sardegna,Sardegna,1639591,153816,9.38,0.06
647,2021-02-20,SAR,2037,854,1183,483,157,195,1201,0,1,1703,334,ITG,ITG2,20,Sardegna,Sardegna,1639591,155853,9.51,0.12
648,2021-01-18,SAR,904,326,578,714,190,0,0,0,0,780,124,ITG,ITG2,20,Sardegna,Sardegna,1639591,156757,9.56,0.06
649,2021-02-07,SAR,1116,394,722,975,141,0,0,0,0,228,888,ITG,ITG2,20,Sardegna,Sardegna,1639591,157873,9.63,0.07
650,2020-12-31,SAR,32,16,16,28,4,0,0,0,0,32,0,ITG,ITG2,20,Sardegna,Sardegna,1639591,157905,9.63,0.0
651,2021-02-27,SAR,1918,645,1273,1059,379,304,176,0,0,1363,555,ITG,ITG2,20,Sardegna,Sardegna,1639591,159823,9.75,0.12
652,2021-02-04,SAR,2271,816,1455,1737,363,170,1,0,0,916,1355,ITG,ITG2,20,Sardegna,Sardegna,1639591,162094,9.89,0.14
653,2021-01-21,SAR,126,60,66,60,66,0,0,0,0,94,32,ITG,ITG2,20,Sardegna,Sardegna,1639591,162220,9.89,0.01
654,2021-02-03,SAR,1118,418,700,919,180,19,0,0,0,426,692,ITG,ITG2,20,Sardegna,Sardegna,1639591,163338,9.96,0.07
655,2021-01-30,SAR,3862,1392,2470,2987,874,0,1,0,0,362,3500,ITG,ITG2,20,Sardegna,Sardegna,1639591,167200,10.2,0.24
656,2021-01-03,SAR,90,36,54,89,1,0,0,0,0,90,0,ITG,ITG2,20,Sardegna,Sardegna,1639591,167290,10.2,0.01
657,2021-02-13,SAR,1454,563,891,732,464,253,0,0,5,1452,2,ITG,ITG2,20,Sardegna,Sardegna,1639591,168744,10.29,0.09
658,2021-02-06,SAR,1970,697,1273,1544,286,139,0,0,1,569,1401,ITG,ITG2,20,Sardegna,Sardegna,1639591,170714,10.41,0.12
659,2021-01-24,SAR,90,34,56,89,1,0,0,0,0,5,85,ITG,ITG2,20,Sardegna,Sardegna,1639591,170804,10.42,0.01
660,2021-03-17,MAR,3435,1497,1938,301,183,117,2822,7,5,111,3324,ITI,ITI3,11,Marche,Marche,1525271,3435,0.23,0.23
661,2021-03-06,MAR,5725,2640,3085,973,831,125,2400,649,747,4457,1268,ITI,ITI3,11,Marche,Marche,1525271,9160,0.6,0.38
662,2021-01-08,MAR,1574,588,986,1226,348,0,0,0,0,1574,0,ITI,ITI3,11,Marche,Marche,1525271,10734,0.7,0.1
663,2021-01-26,MAR,2016,746,1270,1736,194,86,0,0,0,92,1924,ITI,ITI3,11,Marche,Marche,1525271,12750,0.84,0.13
664,2021-03-04,MAR,6611,2964,3647,1064,938,106,2798,936,769,5217,1394,ITI,ITI3,11,Marche,Marche,1525271,19361,1.27,0.43
665,2021-02-14,MAR,738,301,437,578,160,0,0,0,0,738,0,ITI,ITI3,11,Marche,Marche,1525271,20099,1.32,0.05
666,2020-12-31,MAR,383,178,205,370,13,0,0,0,0,383,0,ITI,ITI3,11,Marche,Marche,1525271,20482,1.34,0.03
667,2021-02-03,MAR,2125,742,1383,1344,615,166,0,0,0,119,2006,ITI,ITI3,11,Marche,Marche,1525271,22607,1.48,0.14
668,2021-01-15,MAR,1771,500,1271,985,420,366,0,0,0,1771,0,ITI,ITI3,11,Marche,Marche,1525271,24378,1.6,0.12
669,2021-01-03,MAR,896,348,548,759,137,0,0,0,0,896,0,ITI,ITI3,11,Marche,Marche,1525271,25274,1.66,0.06
670,2021-01-04,MAR,1500,563,937,1290,199,11,0,0,0,1500,0,ITI,ITI3,11,Marche,Marche,1525271,26774,1.76,0.1
671,2021-03-15,MAR,4489,2109,2380,300,473,8,3453,14,241,1422,3067,ITI,ITI3,11,Marche,Marche,1525271,31263,2.05,0.29
672,2021-02-28,MAR,2837,1250,1587,19,18,0,2796,2,2,2831,6,ITI,ITI3,11,Marche,Marche,1525271,34100,2.24,0.19
673,2021-02-15,MAR,973,413,560,544,428,1,0,0,0,960,13,ITI,ITI3,11,Marche,Marche,1525271,35073,2.3,0.06
674,2021-01-24,MAR,891,342,549,772,119,0,0,0,0,17,874,ITI,ITI3,11,Marche,Marche,1525271,35964,2.36,0.06
675,2021-03-13,MAR,5612,2506,3106,664,373,57,4248,133,137,1651,3961,ITI,ITI3,11,Marche,Marche,1525271,41576,2.73,0.37
676,2021-02-05,MAR,2156,653,1503,1317,420,419,0,0,0,440,1716,ITI,ITI3,11,Marche,Marche,1525271,43732,2.87,0.14
677,2021-01-21,MAR,896,253,643,460,100,336,0,0,0,585,311,ITI,ITI3,11,Marche,Marche,1525271,44628,2.93,0.06
678,2021-03-21,MAR,1763,754,1009,30,24,18,1642,3,46,603,1160,ITI,ITI3,11,Marche,Marche,1525271,46391,3.04,0.12
679,2021-02-13,MAR,1064,455,609,457,517,90,0,0,0,1012,52,ITI,ITI3,11,Marche,Marche,1525271,47455,3.11,0.07
680,2021-03-16,MAR,3577,1549,2028,317,196,54,2928,77,5,394,3183,ITI,ITI3,11,Marche,Marche,1525271,51032,3.35,0.23
681,2021-02-22,MAR,3413,1498,1915,325,408,77,2596,5,2,3339,74,ITI,ITI3,11,Marche,Marche,1525271,54445,3.57,0.22
682,2021-02-11,MAR,1988,658,1330,1155,621,212,0,0,0,1599,389,ITI,ITI3,11,Marche,Marche,1525271,56433,3.7,0.13
683,2021-01-16,MAR,2006,723,1283,1059,662,285,0,0,0,2006,0,ITI,ITI3,11,Marche,Marche,1525271,58439,3.83,0.13
684,2021-03-12,MAR,4710,2014,2696,820,727,0,1904,330,929,3465,1245,ITI,ITI3,11,Marche,Marche,1525271,63149,4.14,0.31
685,2021-01-28,MAR,1973,659,1314,1581,291,101,0,0,0,167,1806,ITI,ITI3,11,Marche,Marche,1525271,65122,4.27,0.13
686,2021-03-09,MAR,5519,2364,3155,754,468,36,2588,603,1070,4630,889,ITI,ITI3,11,Marche,Marche,1525271,70641,4.63,0.36
687,2021-01-02,MAR,453,139,314,444,9,0,0,0,0,453,0,ITI,ITI3,11,Marche,Marche,1525271,71094,4.66,0.03
688,2021-01-13,MAR,2105,746,1359,1408,621,76,0,0,0,2105,0,ITI,ITI3,11,Marche,Marche,1525271,73199,4.8,0.14
689,2021-02-06,MAR,2460,900,1560,1402,643,415,0,0,0,523,1937,ITI,ITI3,11,Marche,Marche,1525271,75659,4.96,0.16
690,2021-02-16,MAR,1292,475,817,737,463,92,0,0,0,1262,30,ITI,ITI3,11,Marche,Marche,1525271,76951,5.05,0.08
691,2021-01-23,MAR,557,190,367,440,54,63,0,0,0,123,434,ITI,ITI3,11,Marche,Marche,1525271,77508,5.08,0.04
692,2021-01-19,MAR,225,81,144,120,20,85,0,0,0,141,84,ITI,ITI3,11,Marche,Marche,1525271,77733,5.1,0.01
693,2021-03-11,MAR,6829,2929,3900,1094,921,38,3227,401,1148,5458,1371,ITI,ITI3,11,Marche,Marche,1525271,84562,5.54,0.45
694,2021-02-20,MAR,4127,1708,2419,118,411,261,3334,3,0,4016,111,ITI,ITI3,11,Marche,Marche,1525271,88689,5.81,0.27
695,2021-02-21,MAR,377,142,235,204,115,57,0,0,1,376,1,ITI,ITI3,11,Marche,Marche,1525271,89066,5.84,0.02
696,2021-01-09,MAR,1709,605,1104,1406,303,0,0,0,0,1709,0,ITI,ITI3,11,Marche,Marche,1525271,90775,5.95,0.11
697,2021-02-12,MAR,1583,618,965,815,680,88,0,0,0,1431,152,ITI,ITI3,11,Marche,Marche,1525271,92358,6.06,0.1
698,2021-03-20,MAR,4145,1745,2400,181,118,111,3640,6,89,1054,3091,ITI,ITI3,11,Marche,Marche,1525271,96503,6.33,0.27
699,2021-02-24,MAR,3440,1506,1934,226,235,165,2810,3,1,3361,79,ITI,ITI3,11,Marche,Marche,1525271,99943,6.55,0.23
700,2020-12-30,MAR,17,5,12,14,3,0,0,0,0,17,0,ITI,ITI3,11,Marche,Marche,1525271,99960,6.55,0.0
701,2021-01-17,MAR,1598,682,916,964,588,46,0,0,0,1549,49,ITI,ITI3,11,Marche,Marche,1525271,101558,6.66,0.1
702,2021-03-10,MAR,5768,2481,3287,721,818,101,2673,417,1038,4631,1137,ITI,ITI3,11,Marche,Marche,1525271,107326,7.04,0.38
703,2021-01-18,MAR,673,230,443,370,171,132,0,0,0,547,126,ITI,ITI3,11,Marche,Marche,1525271,107999,7.08,0.04
704,2021-02-19,MAR,1971,716,1255,1273,492,203,1,0,2,1836,135,ITI,ITI3,11,Marche,Marche,1525271,109970,7.21,0.13
705,2021-01-20,MAR,398,99,299,146,62,190,0,0,0,386,12,ITI,ITI3,11,Marche,Marche,1525271,110368,7.24,0.03
706,2021-01-10,MAR,1737,699,1038,1462,275,0,0,0,0,1737,0,ITI,ITI3,11,Marche,Marche,1525271,112105,7.35,0.11
707,2021-03-02,MAR,4963,1943,3020,589,275,242,3316,3,538,4397,566,ITI,ITI3,11,Marche,Marche,1525271,117068,7.68,0.33
708,2021-03-01,MAR,3725,1487,2238,387,177,82,2788,5,286,3478,247,ITI,ITI3,11,Marche,Marche,1525271,120793,7.92,0.24
709,2021-02-18,MAR,2103,746,1357,1150,549,402,1,0,1,1816,287,ITI,ITI3,11,Marche,Marche,1525271,122896,8.06,0.14
710,2021-02-10,MAR,1439,452,987,881,343,215,0,0,0,1080,359,ITI,ITI3,11,Marche,Marche,1525271,124335,8.15,0.09
711,2021-01-31,MAR,1927,772,1155,1532,395,0,0,0,0,105,1822,ITI,ITI3,11,Marche,Marche,1525271,126262,8.28,0.13
712,2021-01-14,MAR,2010,692,1318,1112,600,298,0,0,0,2010,0,ITI,ITI3,11,Marche,Marche,1525271,128272,8.41,0.13
713,2021-01-12,MAR,1226,413,813,912,264,50,0,0,0,1226,0,ITI,ITI3,11,Marche,Marche,1525271,129498,8.49,0.08
714,2021-03-07,MAR,5183,2108,3075,607,357,0,3007,316,896,4430,753,ITI,ITI3,11,Marche,Marche,1525271,134681,8.83,0.34
715,2021-01-25,MAR,1596,559,1037,1426,114,56,0,0,0,97,1499,ITI,ITI3,11,Marche,Marche,1525271,136277,8.93,0.1
716,2021-01-07,MAR,1802,633,1169,1480,322,0,0,0,0,1802,0,ITI,ITI3,11,Marche,Marche,1525271,138079,9.05,0.12
717,2021-03-19,MAR,3839,1598,2241,495,234,266,2834,4,6,342,3497,ITI,ITI3,11,Marche,Marche,1525271,141918,9.3,0.25
718,2021-01-11,MAR,1176,411,765,1021,155,0,0,0,0,1176,0,ITI,ITI3,11,Marche,Marche,1525271,143094,9.38,0.08
719,2021-01-30,MAR,1908,669,1239,1566,342,0,0,0,0,29,1879,ITI,ITI3,11,Marche,Marche,1525271,145002,9.51,0.13
720,2021-02-04,MAR,2342,810,1532,1406,661,275,0,0,0,112,2230,ITI,ITI3,11,Marche,Marche,1525271,147344,9.66,0.15
721,2021-02-09,MAR,125,42,83,78,21,26,0,0,0,47,78,ITI,ITI3,11,Marche,Marche,1525271,147469,9.67,0.01
722,2021-02-27,MAR,3374,1440,1934,186,172,161,2848,6,1,3165,209,ITI,ITI3,11,Marche,Marche,1525271,150843,9.89,0.22
723,2021-02-02,MAR,1193,397,796,804,296,93,0,0,0,73,1120,ITI,ITI3,11,Marche,Marche,1525271,152036,9.97,0.08
724,2021-02-08,MAR,833,258,575,408,163,262,0,0,0,371,462,ITI,ITI3,11,Marche,Marche,1525271,152869,10.02,0.05
725,2021-01-05,MAR,1562,586,976,1436,126,0,0,0,0,1562,0,ITI,ITI3,11,Marche,Marche,1525271,154431,10.12,0.1
726,2021-01-27,MAR,2120,780,1340,1754,226,140,0,0,0,122,1998,ITI,ITI3,11,Marche,Marche,1525271,156551,10.26,0.14
727,2021-03-18,MAR,3443,1513,1930,325,263,123,2653,76,3,216,3227,ITI,ITI3,11,Marche,Marche,1525271,159994,10.49,0.23
728,2021-02-25,MAR,3563,1447,2116,432,213,423,2491,3,1,3384,179,ITI,ITI3,11,Marche,Marche,1525271,163557,10.72,0.23
729,2020-12-27,MAR,200,97,103,184,12,4,0,0,0,200,0,ITI,ITI3,11,Marche,Marche,1525271,163757,10.74,0.01
730,2021-01-06,MAR,2181,792,1389,1738,296,147,0,0,0,2181,0,ITI,ITI3,11,Marche,Marche,1525271,165938,10.88,0.14
731,2021-02-23,MAR,3274,1400,1874,219,137,116,2794,8,0,3218,56,ITI,ITI3,11,Marche,Marche,1525271,169212,11.09,0.21
732,2021-03-05,MAR,6274,2943,3331,1128,875,143,2373,953,802,4807,1467,ITI,ITI3,11,Marche,Marche,1525271,175486,11.51,0.41
733,2021-01-22,MAR,487,167,320,315,85,87,0,0,0,194,293,ITI,ITI3,11,Marche,Marche,1525271,175973,11.54,0.03
734,2021-03-03,MAR,6750,3084,3666,818,819,254,3132,944,783,5869,881,ITI,ITI3,11,Marche,Marche,1525271,182723,11.98,0.44
735,2021-03-14,MAR,2515,1036,1479,442,80,0,1535,2,456,1917,598,ITI,ITI3,11,Marche,Marche,1525271,185238,12.14,0.16
736,2021-02-07,MAR,1871,735,1136,1156,669,46,0,0,0,344,1527,ITI,ITI3,11,Marche,Marche,1525271,187109,12.27,0.12
737,2021-03-08,MAR,6351,2794,3557,768,611,219,3101,638,1014,5349,1002,ITI,ITI3,11,Marche,Marche,1525271,193460,12.68,0.42
738,2021-02-01,MAR,1365,480,885,1057,227,81,0,0,0,98,1267,ITI,ITI3,11,Marche,Marche,1525271,194825,12.77,0.09
739,2021-01-29,MAR,1991,730,1261,1479,438,74,0,0,0,168,1823,ITI,ITI3,11,Marche,Marche,1525271,196816,12.9,0.13
740,2021-02-17,MAR,1791,664,1127,968,522,300,1,0,0,1672,119,ITI,ITI3,11,Marche,Marche,1525271,198607,13.02,0.12
741,2021-02-26,MAR,3569,1493,2076,446,231,330,2519,4,39,3093,476,ITI,ITI3,11,Marche,Marche,1525271,202176,13.26,0.23
742,2021-03-18,UMB,2765,1069,1696,957,144,191,1459,3,11,1552,1213,ITI,ITI2,10,Umbria,Umbria,882015,2765,0.31,0.31
743,2021-02-11,UMB,842,349,493,735,99,5,0,0,3,837,5,ITI,ITI2,10,Umbria,Umbria,882015,3607,0.41,0.1
744,2021-03-16,UMB,3502,1433,2069,1633,88,65,1706,0,10,1875,1627,ITI,ITI2,10,Umbria,Umbria,882015,7109,0.81,0.4
745,2021-02-07,UMB,54,17,37,46,8,0,0,0,0,1,53,ITI,ITI2,10,Umbria,Umbria,882015,7163,0.81,0.01
746,2021-01-29,UMB,1221,343,878,934,16,271,0,0,0,79,1142,ITI,ITI2,10,Umbria,Umbria,882015,8384,0.95,0.14
747,2021-01-06,UMB,843,323,520,840,3,0,0,0,0,843,0,ITI,ITI2,10,Umbria,Umbria,882015,9227,1.05,0.1
748,2021-03-10,UMB,3970,1900,2070,120,858,144,2564,209,75,2683,1287,ITI,ITI2,10,Umbria,Umbria,882015,13197,1.5,0.45
749,2021-02-01,UMB,1260,333,927,876,32,352,0,0,0,47,1213,ITI,ITI2,10,Umbria,Umbria,882015,14457,1.64,0.14
750,2021-01-11,UMB,1271,336,935,878,20,373,0,0,0,1271,0,ITI,ITI2,10,Umbria,Umbria,882015,15728,1.78,0.14
751,2021-03-09,UMB,4022,1945,2077,142,681,99,2912,165,23,2729,1293,ITI,ITI2,10,Umbria,Umbria,882015,19750,2.24,0.46
752,2021-02-05,UMB,780,234,546,645,51,84,0,0,0,18,762,ITI,ITI2,10,Umbria,Umbria,882015,20530,2.33,0.09
753,2021-03-14,UMB,66,48,18,0,61,1,0,0,4,66,0,ITI,ITI2,10,Umbria,Umbria,882015,20596,2.34,0.01
754,2021-03-06,UMB,4250,1109,3141,422,247,26,1113,120,2322,4107,143,ITI,ITI2,10,Umbria,Umbria,882015,24846,2.82,0.48
755,2021-03-19,UMB,1661,525,1136,439,252,29,191,26,724,1059,602,ITI,ITI2,10,Umbria,Umbria,882015,26507,3.01,0.19
756,2021-01-17,UMB,54,17,37,47,7,0,0,0,0,54,0,ITI,ITI2,10,Umbria,Umbria,882015,26561,3.01,0.01
757,2021-03-12,UMB,2632,1030,1602,110,596,41,463,229,1193,2134,498,ITI,ITI2,10,Umbria,Umbria,882015,29193,3.31,0.3
758,2021-01-26,UMB,814,390,424,813,1,0,0,0,0,18,796,ITI,ITI2,10,Umbria,Umbria,882015,30007,3.4,0.09
759,2021-01-31,UMB,1056,276,780,765,10,281,0,0,0,25,1031,ITI,ITI2,10,Umbria,Umbria,882015,31063,3.52,0.12
760,2021-01-22,UMB,276,105,171,273,1,2,0,0,0,32,244,ITI,ITI2,10,Umbria,Umbria,882015,31339,3.55,0.03
761,2021-02-12,UMB,671,224,447,459,208,1,1,0,2,665,6,ITI,ITI2,10,Umbria,Umbria,882015,32010,3.63,0.08
762,2021-01-03,UMB,267,111,156,267,0,0,0,0,0,267,0,ITI,ITI2,10,Umbria,Umbria,882015,32277,3.66,0.03
763,2021-01-24,UMB,254,104,150,254,0,0,0,0,0,1,253,ITI,ITI2,10,Umbria,Umbria,882015,32531,3.69,0.03
764,2021-01-30,UMB,1577,483,1094,841,18,717,1,0,0,44,1533,ITI,ITI2,10,Umbria,Umbria,882015,34108,3.87,0.18
765,2021-02-25,UMB,1334,495,839,826,101,97,305,0,5,1282,52,ITI,ITI2,10,Umbria,Umbria,882015,35442,4.02,0.15
766,2021-01-19,UMB,103,23,80,21,2,80,0,0,0,103,0,ITI,ITI2,10,Umbria,Umbria,882015,35545,4.03,0.01
767,2021-01-07,UMB,1291,383,908,883,4,404,0,0,0,1291,0,ITI,ITI2,10,Umbria,Umbria,882015,36836,4.18,0.15
768,2021-02-26,UMB,653,250,403,381,71,40,154,4,3,645,8,ITI,ITI2,10,Umbria,Umbria,882015,37489,4.25,0.07
769,2021-02-03,UMB,725,174,551,560,37,128,0,0,0,67,658,ITI,ITI2,10,Umbria,Umbria,882015,38214,4.33,0.08
770,2021-01-04,UMB,809,397,412,808,1,0,0,0,0,809,0,ITI,ITI2,10,Umbria,Umbria,882015,39023,4.42,0.09
771,2021-03-11,UMB,3537,1680,1857,143,784,238,2013,201,158,2531,1006,ITI,ITI2,10,Umbria,Umbria,882015,42560,4.83,0.4
772,2021-02-06,UMB,396,138,258,333,47,16,0,0,0,34,362,ITI,ITI2,10,Umbria,Umbria,882015,42956,4.87,0.04
773,2021-03-01,UMB,1510,777,733,114,28,0,1249,118,1,1396,114,ITI,ITI2,10,Umbria,Umbria,882015,44466,5.04,0.17
774,2021-01-05,UMB,850,428,422,845,5,0,0,0,0,850,0,ITI,ITI2,10,Umbria,Umbria,882015,45316,5.14,0.1
775,2021-01-25,UMB,647,322,325,645,2,0,0,0,0,5,642,ITI,ITI2,10,Umbria,Umbria,882015,45963,5.21,0.07
776,2021-01-02,UMB,301,110,191,301,0,0,0,0,0,301,0,ITI,ITI2,10,Umbria,Umbria,882015,46264,5.25,0.03
777,2021-02-20,UMB,282,100,182,83,8,39,152,0,0,258,24,ITI,ITI2,10,Umbria,Umbria,882015,46546,5.28,0.03
778,2021-02-17,UMB,1618,748,870,363,14,0,1240,0,1,1267,351,ITI,ITI2,10,Umbria,Umbria,882015,48164,5.46,0.18
779,2021-02-16,UMB,1307,655,652,33,12,0,1262,0,0,1298,9,ITI,ITI2,10,Umbria,Umbria,882015,49471,5.61,0.15
780,2021-01-15,UMB,692,212,480,588,44,60,0,0,0,692,0,ITI,ITI2,10,Umbria,Umbria,882015,50163,5.69,0.08
781,2021-03-07,UMB,844,180,664,16,83,25,44,0,676,837,7,ITI,ITI2,10,Umbria,Umbria,882015,51007,5.78,0.1
782,2021-02-10,UMB,715,349,366,606,106,3,0,0,0,700,15,ITI,ITI2,10,Umbria,Umbria,882015,51722,5.86,0.08
783,2021-03-13,UMB,1731,524,1207,120,182,49,152,77,1151,1486,245,ITI,ITI2,10,Umbria,Umbria,882015,53453,6.06,0.2
784,2021-01-09,UMB,1719,492,1227,888,10,821,0,0,0,1719,0,ITI,ITI2,10,Umbria,Umbria,882015,55172,6.26,0.19
785,2021-01-14,UMB,749,200,549,696,35,17,0,0,1,749,0,ITI,ITI2,10,Umbria,Umbria,882015,55921,6.34,0.08
786,2021-03-05,UMB,4586,1378,3208,604,389,7,685,347,2554,3930,656,ITI,ITI2,10,Umbria,Umbria,882015,60507,6.86,0.52
787,2021-03-20,UMB,2271,820,1451,314,685,0,0,72,1200,2246,25,ITI,ITI2,10,Umbria,Umbria,882015,62778,7.12,0.26
788,2021-02-24,UMB,1520,565,955,1082,46,91,292,9,0,1505,15,ITI,ITI2,10,Umbria,Umbria,882015,64298,7.29,0.17
789,2021-02-27,UMB,1658,354,1304,14,11,13,0,60,1560,1642,16,ITI,ITI2,10,Umbria,Umbria,882015,65956,7.48,0.19
790,2021-03-03,UMB,4435,1771,2664,720,290,86,1517,289,1533,3723,712,ITI,ITI2,10,Umbria,Umbria,882015,70391,7.98,0.5
791,2021-03-21,UMB,425,217,208,28,301,0,0,34,62,425,0,ITI,ITI2,10,Umbria,Umbria,882015,70816,8.03,0.05
792,2021-02-18,UMB,1495,582,913,324,16,170,985,0,0,1029,466,ITI,ITI2,10,Umbria,Umbria,882015,72311,8.2,0.17
793,2021-02-02,UMB,942,274,668,713,17,212,0,0,0,32,910,ITI,ITI2,10,Umbria,Umbria,882015,73253,8.31,0.11
794,2021-03-15,UMB,4592,1927,2665,1426,347,78,2337,141,263,2822,1770,ITI,ITI2,10,Umbria,Umbria,882015,77845,8.83,0.52
795,2021-02-08,UMB,637,203,434,368,112,153,0,4,0,88,549,ITI,ITI2,10,Umbria,Umbria,882015,78482,8.9,0.07
796,2021-01-16,UMB,221,73,148,146,32,43,0,0,0,221,0,ITI,ITI2,10,Umbria,Umbria,882015,78703,8.92,0.03
797,2021-03-08,UMB,3665,1797,1868,140,355,45,2853,230,42,2303,1362,ITI,ITI2,10,Umbria,Umbria,882015,82368,9.34,0.42
798,2021-01-20,UMB,613,222,391,583,15,14,0,0,1,613,0,ITI,ITI2,10,Umbria,Umbria,882015,82981,9.41,0.07
799,2021-01-18,UMB,588,215,373,315,149,124,0,0,0,504,84,ITI,ITI2,10,Umbria,Umbria,882015,83569,9.47,0.07
800,2021-01-13,UMB,450,139,311,379,29,42,0,0,0,450,0,ITI,ITI2,10,Umbria,Umbria,882015,84019,9.53,0.05
801,2021-02-15,UMB,1368,692,676,10,8,0,1350,0,0,1367,1,ITI,ITI2,10,Umbria,Umbria,882015,85387,9.68,0.16
802,2021-02-19,UMB,743,293,450,281,16,14,432,0,0,526,217,ITI,ITI2,10,Umbria,Umbria,882015,86130,9.77,0.08
803,2021-01-27,UMB,838,329,509,837,1,0,0,0,0,13,825,ITI,ITI2,10,Umbria,Umbria,882015,86968,9.86,0.1
804,2021-02-04,UMB,732,226,506,692,20,20,0,0,0,25,707,ITI,ITI2,10,Umbria,Umbria,882015,87700,9.94,0.08
805,2021-03-02,UMB,3626,1343,2283,318,276,55,1290,241,1446,3622,4,ITI,ITI2,10,Umbria,Umbria,882015,91326,10.35,0.41
806,2021-01-23,UMB,277,100,177,276,1,0,0,0,0,2,275,ITI,ITI2,10,Umbria,Umbria,882015,91603,10.39,0.03
807,2021-01-28,UMB,1240,392,848,891,4,345,0,0,0,19,1221,ITI,ITI2,10,Umbria,Umbria,882015,92843,10.53,0.14
808,2021-01-10,UMB,1056,275,781,740,9,307,0,0,0,1056,0,ITI,ITI2,10,Umbria,Umbria,882015,93899,10.65,0.12
809,2021-03-17,UMB,3264,1283,1981,1428,61,70,1681,8,16,1855,1409,ITI,ITI2,10,Umbria,Umbria,882015,97163,11.02,0.37
810,2021-03-04,UMB,4475,1849,2626,849,238,4,1552,366,1466,3647,828,ITI,ITI2,10,Umbria,Umbria,882015,101638,11.52,0.51
811,2021-02-13,UMB,115,28,87,68,46,0,1,0,0,112,3,ITI,ITI2,10,Umbria,Umbria,882015,101753,11.54,0.01
812,2021-01-08,UMB,1173,337,836,926,9,238,0,0,0,1173,0,ITI,ITI2,10,Umbria,Umbria,882015,102926,11.67,0.13
813,2021-02-23,UMB,1693,658,1035,1187,95,17,394,0,0,1651,42,ITI,ITI2,10,Umbria,Umbria,882015,104619,11.86,0.19
814,2020-12-31,UMB,322,127,195,310,12,0,0,0,0,322,0,ITI,ITI2,10,Umbria,Umbria,882015,104941,11.9,0.04
815,2021-01-21,UMB,610,202,408,428,13,169,0,0,0,341,269,ITI,ITI2,10,Umbria,Umbria,882015,105551,11.97,0.07
816,2020-12-27,UMB,85,45,40,67,2,16,0,0,0,85,0,ITI,ITI2,10,Umbria,Umbria,882015,105636,11.98,0.01
817,2021-01-12,UMB,784,247,537,665,14,105,0,0,0,784,0,ITI,ITI2,10,Umbria,Umbria,882015,106420,12.07,0.09
818,2021-01-01,UMB,269,102,167,268,1,0,0,0,0,269,0,ITI,ITI2,10,Umbria,Umbria,882015,106689,12.1,0.03
819,2021-02-22,UMB,1858,777,1081,732,120,1,1005,0,0,1772,86,ITI,ITI2,10,Umbria,Umbria,882015,108547,12.31,0.21
820,2021-02-26,MOL,563,260,303,42,57,3,406,0,55,490,73,ITF,ITF2,14,Molise,Molise,305617,563,0.18,0.18
821,2021-03-09,MOL,1329,579,750,199,467,0,52,218,393,1177,152,ITF,ITF2,14,Molise,Molise,305617,1892,0.62,0.43
822,2021-01-27,MOL,674,251,423,436,28,209,0,0,1,8,666,ITF,ITF2,14,Molise,Molise,305617,2566,0.84,0.22
823,2021-01-20,MOL,18,8,10,14,4,0,0,0,0,18,0,ITF,ITF2,14,Molise,Molise,305617,2584,0.85,0.01
824,2021-03-11,MOL,695,315,380,18,258,12,0,147,260,689,6,ITF,ITF2,14,Molise,Molise,305617,3279,1.07,0.23
825,2021-01-25,MOL,319,130,189,317,0,0,0,0,2,3,316,ITF,ITF2,14,Molise,Molise,305617,3598,1.18,0.1
826,2021-02-12,MOL,330,149,181,224,32,72,0,0,2,208,122,ITF,ITF2,14,Molise,Molise,305617,3928,1.29,0.11
827,2021-01-10,MOL,270,72,198,82,19,169,0,0,0,270,0,ITF,ITF2,14,Molise,Molise,305617,4198,1.37,0.09
828,2021-01-08,MOL,429,141,288,244,65,120,0,0,0,429,0,ITF,ITF2,14,Molise,Molise,305617,4627,1.51,0.14
829,2021-02-21,MOL,573,227,346,1,4,0,568,0,0,571,2,ITF,ITF2,14,Molise,Molise,305617,5200,1.7,0.19
830,2021-03-21,MOL,483,201,282,0,483,0,0,0,0,169,314,ITF,ITF2,14,Molise,Molise,305617,5683,1.86,0.16
831,2021-02-23,MOL,527,202,325,136,42,8,340,0,1,362,165,ITF,ITF2,14,Molise,Molise,305617,6210,2.03,0.17
832,2021-01-13,MOL,474,160,314,256,73,144,0,0,1,474,0,ITF,ITF2,14,Molise,Molise,305617,6684,2.19,0.16
833,2021-03-07,MOL,1114,499,615,2,1112,0,0,0,0,1112,2,ITF,ITF2,14,Molise,Molise,305617,7798,2.55,0.36
834,2021-02-09,MOL,359,170,189,161,88,110,0,0,0,197,162,ITF,ITF2,14,Molise,Molise,305617,8157,2.67,0.12
835,2021-03-14,MOL,594,239,355,2,592,0,0,0,0,16,578,ITF,ITF2,14,Molise,Molise,305617,8751,2.86,0.19
836,2021-01-31,MOL,268,70,198,85,18,164,0,0,1,6,262,ITF,ITF2,14,Molise,Molise,305617,9019,2.95,0.09
837,2021-02-28,MOL,828,331,497,38,763,27,0,0,0,786,42,ITF,ITF2,14,Molise,Molise,305617,9847,3.22,0.27
838,2021-01-18,MOL,114,48,66,97,17,0,0,0,0,114,0,ITF,ITF2,14,Molise,Molise,305617,9961,3.26,0.04
839,2021-02-10,MOL,150,78,72,91,6,53,0,0,0,130,20,ITF,ITF2,14,Molise,Molise,305617,10111,3.31,0.05
840,2021-02-16,MOL,156,70,86,148,8,0,0,0,0,150,6,ITF,ITF2,14,Molise,Molise,305617,10267,3.36,0.05
841,2021-03-20,MOL,2320,968,1352,28,2063,0,0,7,222,999,1321,ITF,ITF2,14,Molise,Molise,305617,12587,4.12,0.76
842,2021-02-17,MOL,72,32,40,47,19,6,0,0,0,57,15,ITF,ITF2,14,Molise,Molise,305617,12659,4.14,0.02
843,2021-02-07,MOL,66,32,34,49,1,16,0,0,0,19,47,ITF,ITF2,14,Molise,Molise,305617,12725,4.16,0.02
844,2021-02-11,MOL,293,133,160,225,19,45,0,3,1,257,36,ITF,ITF2,14,Molise,Molise,305617,13018,4.26,0.1
845,2021-03-01,MOL,641,268,373,200,184,108,0,2,147,427,214,ITF,ITF2,14,Molise,Molise,305617,13659,4.47,0.21
846,2021-02-04,MOL,758,295,463,502,114,141,0,0,1,77,681,ITF,ITF2,14,Molise,Molise,305617,14417,4.72,0.25
847,2021-01-04,MOL,314,131,183,301,13,0,0,0,0,314,0,ITF,ITF2,14,Molise,Molise,305617,14731,4.82,0.1
848,2021-01-05,MOL,449,180,269,441,8,0,0,0,0,449,0,ITF,ITF2,14,Molise,Molise,305617,15180,4.97,0.15
849,2021-02-06,MOL,429,179,250,276,22,130,0,0,1,29,400,ITF,ITF2,14,Molise,Molise,305617,15609,5.11,0.14
850,2021-02-03,MOL,731,249,482,391,159,180,0,0,1,338,393,ITF,ITF2,14,Molise,Molise,305617,16340,5.35,0.24
851,2020-12-27,MOL,50,20,30,29,4,17,0,0,0,50,0,ITF,ITF2,14,Molise,Molise,305617,16390,5.36,0.02
852,2021-03-15,MOL,832,338,494,137,271,66,0,61,297,587,245,ITF,ITF2,14,Molise,Molise,305617,17222,5.64,0.27
853,2021-02-19,MOL,169,93,76,95,70,1,0,0,3,167,2,ITF,ITF2,14,Molise,Molise,305617,17391,5.69,0.06
854,2021-01-28,MOL,613,217,396,430,28,154,0,0,1,17,596,ITF,ITF2,14,Molise,Molise,305617,18004,5.89,0.2
855,2021-02-02,MOL,486,155,331,295,63,128,0,0,0,163,323,ITF,ITF2,14,Molise,Molise,305617,18490,6.05,0.16
856,2021-03-12,MOL,1156,489,667,38,653,0,0,68,397,1120,36,ITF,ITF2,14,Molise,Molise,305617,19646,6.43,0.38
857,2021-01-26,MOL,450,184,266,444,5,0,0,0,1,8,442,ITF,ITF2,14,Molise,Molise,305617,20096,6.58,0.15
858,2021-02-18,MOL,319,74,245,296,23,0,0,0,0,306,13,ITF,ITF2,14,Molise,Molise,305617,20415,6.68,0.1
859,2021-02-08,MOL,334,141,193,206,43,85,0,0,0,216,118,ITF,ITF2,14,Molise,Molise,305617,20749,6.79,0.11
860,2021-02-01,MOL,562,201,361,301,149,111,0,0,1,14,548,ITF,ITF2,14,Molise,Molise,305617,21311,6.97,0.18
861,2021-03-16,MOL,594,225,369,13,566,11,0,4,0,247,347,ITF,ITF2,14,Molise,Molise,305617,21905,7.17,0.19
862,2021-02-05,MOL,593,269,324,460,70,63,0,0,0,55,538,ITF,ITF2,14,Molise,Molise,305617,22498,7.36,0.19
863,2021-02-27,MOL,1366,568,798,26,40,14,1285,0,1,1347,19,ITF,ITF2,14,Molise,Molise,305617,23864,7.81,0.45
864,2021-03-10,MOL,1717,716,1001,188,831,1,1,187,509,1667,50,ITF,ITF2,14,Molise,Molise,305617,25581,8.37,0.56
865,2021-03-06,MOL,1728,807,921,156,1415,0,5,152,0,1569,159,ITF,ITF2,14,Molise,Molise,305617,27309,8.94,0.57
866,2021-03-03,MOL,672,316,356,63,389,48,0,45,127,590,82,ITF,ITF2,14,Molise,Molise,305617,27981,9.16,0.22
867,2021-03-17,MOL,894,381,513,34,805,42,0,12,1,563,331,ITF,ITF2,14,Molise,Molise,305617,28875,9.45,0.29
868,2021-01-22,MOL,126,35,91,21,32,73,0,0,0,126,0,ITF,ITF2,14,Molise,Molise,305617,29001,9.49,0.04
869,2021-01-09,MOL,450,152,298,221,51,178,0,0,0,450,0,ITF,ITF2,14,Molise,Molise,305617,29451,9.64,0.15
870,2021-02-24,MOL,666,278,388,242,105,44,274,0,1,333,333,ITF,ITF2,14,Molise,Molise,305617,30117,9.85,0.22
871,2021-02-22,MOL,265,129,136,56,139,62,8,0,0,250,15,ITF,ITF2,14,Molise,Molise,305617,30382,9.94,0.09
872,2021-01-17,MOL,78,38,40,78,0,0,0,0,0,48,30,ITF,ITF2,14,Molise,Molise,305617,30460,9.97,0.03
873,2021-03-19,MOL,1158,473,685,33,866,9,0,2,248,731,427,ITF,ITF2,14,Molise,Molise,305617,31618,10.35,0.38
874,2021-01-15,MOL,538,242,296,398,59,81,0,0,0,538,0,ITF,ITF2,14,Molise,Molise,305617,32156,10.52,0.18
875,2021-02-25,MOL,541,239,302,68,12,28,433,0,0,473,68,ITF,ITF2,14,Molise,Molise,305617,32697,10.7,0.18
876,2021-01-29,MOL,421,136,285,227,82,109,0,0,3,6,415,ITF,ITF2,14,Molise,Molise,305617,33118,10.84,0.14
877,2021-03-18,MOL,1145,473,672,73,1027,45,0,0,0,681,464,ITF,ITF2,14,Molise,Molise,305617,34263,11.21,0.37
878,2021-01-30,MOL,461,158,303,189,92,180,0,0,0,12,449,ITF,ITF2,14,Molise,Molise,305617,34724,11.36,0.15
879,2021-03-04,MOL,850,417,433,252,493,69,0,36,0,526,324,ITF,ITF2,14,Molise,Molise,305617,35574,11.64,0.28
880,2021-01-14,MOL,646,239,407,418,113,115,0,0,0,646,0,ITF,ITF2,14,Molise,Molise,305617,36220,11.85,0.21
881,2021-01-12,MOL,336,114,222,132,75,129,0,0,0,336,0,ITF,ITF2,14,Molise,Molise,305617,36556,11.96,0.11
882,2021-03-05,MOL,1219,649,570,322,673,0,0,151,73,1015,204,ITF,ITF2,14,Molise,Molise,305617,37775,12.36,0.4
883,2021-03-08,MOL,1376,522,854,359,514,23,0,76,404,1236,140,ITF,ITF2,14,Molise,Molise,305617,39151,12.81,0.45
884,2021-01-07,MOL,598,209,389,414,39,145,0,0,0,598,0,ITF,ITF2,14,Molise,Molise,305617,39749,13.01,0.2
885,2021-01-11,MOL,557,194,363,196,250,111,0,0,0,557,0,ITF,ITF2,14,Molise,Molise,305617,40306,13.19,0.18
886,2021-01-16,MOL,420,166,254,270,23,127,0,0,0,420,0,ITF,ITF2,14,Molise,Molise,305617,40726,13.33,0.14
887,2021-01-06,MOL,689,260,429,456,62,171,0,0,0,689,0,ITF,ITF2,14,Molise,Molise,305617,41415,13.55,0.23
888,2021-03-13,MOL,1189,594,595,29,1004,5,0,151,0,200,989,ITF,ITF2,14,Molise,Molise,305617,42604,13.94,0.39
889,2021-03-02,MOL,666,383,283,98,253,51,0,113,151,508,158,ITF,ITF2,14,Molise,Molise,305617,43270,14.16,0.22
890,2021-01-21,MOL,6,2,4,0,6,0,0,0,0,6,0,ITF,ITF2,14,Molise,Molise,305617,43276,14.16,0.0
891,2021-02-13,MOL,132,80,52,129,3,0,0,0,0,132,0,ITF,ITF2,14,Molise,Molise,305617,43408,14.2,0.04
892,2021-02-15,MOL,144,70,74,117,12,15,0,0,0,141,3,ITF,ITF2,14,Molise,Molise,305617,43552,14.25,0.05
893,2021-02-20,MOL,1018,441,577,20,57,8,933,0,0,998,20,ITF,ITF2,14,Molise,Molise,305617,44570,14.58,0.33
894,2021-01-19,MOL,173,63,110,90,59,22,0,0,2,162,11,ITF,ITF2,14,Molise,Molise,305617,44743,14.64,0.06
895,2020-12-30,TOS,327,104,223,34,10,283,0,0,0,327,0,ITI,ITI1,9,Toscana,Toscana,3729641,327,0.01,0.01
896,2021-03-14,TOS,7160,2561,4599,3102,1249,121,2,211,2475,3229,3931,ITI,ITI1,9,Toscana,Toscana,3729641,7487,0.2,0.19
897,2021-02-14,TOS,8993,2567,6426,3033,5613,81,0,261,5,8883,110,ITI,ITI1,9,Toscana,Toscana,3729641,16480,0.44,0.24
898,2021-03-05,TOS,16238,6219,10019,3920,2408,170,5120,748,3872,11498,4740,ITI,ITI1,9,Toscana,Toscana,3729641,32718,0.88,0.44
899,2021-01-06,TOS,4519,1459,3060,3984,10,525,0,0,0,4519,0,ITI,ITI1,9,Toscana,Toscana,3729641,37237,1.0,0.12
900,2021-03-02,TOS,10522,3763,6759,3169,1026,125,1820,870,3512,7085,3437,ITI,ITI1,9,Toscana,Toscana,3729641,47759,1.28,0.28
901,2021-01-24,TOS,3348,1072,2276,2601,37,709,1,0,0,200,3148,ITI,ITI1,9,Toscana,Toscana,3729641,51107,1.37,0.09
902,2021-01-04,TOS,5063,1893,3170,4099,32,932,0,0,0,5063,0,ITI,ITI1,9,Toscana,Toscana,3729641,56170,1.51,0.14
903,2021-03-03,TOS,17956,6381,11575,3318,1154,135,9074,829,3446,14359,3597,ITI,ITI1,9,Toscana,Toscana,3729641,74126,1.99,0.48
904,2021-03-11,TOS,15036,5803,9233,2436,2240,229,9954,165,12,11727,3309,ITI,ITI1,9,Toscana,Toscana,3729641,89162,2.39,0.4
905,2021-02-20,TOS,4641,1790,2851,3350,1038,203,17,15,18,4128,513,ITI,ITI1,9,Toscana,Toscana,3729641,93803,2.52,0.12
906,2021-02-06,TOS,4527,1550,2977,3725,575,227,0,0,0,1294,3233,ITI,ITI1,9,Toscana,Toscana,3729641,98330,2.64,0.12
907,2021-01-03,TOS,3336,1052,2284,2565,9,762,0,0,0,3336,0,ITI,ITI1,9,Toscana,Toscana,3729641,101666,2.73,0.09
908,2021-02-26,TOS,10048,3817,6231,1557,1706,298,1787,1137,3563,8842,1206,ITI,ITI1,9,Toscana,Toscana,3729641,111714,3.0,0.27
909,2021-03-08,TOS,6248,2551,3697,4063,1732,177,64,204,8,1430,4818,ITI,ITI1,9,Toscana,Toscana,3729641,117962,3.16,0.17
910,2021-02-03,TOS,4221,1452,2769,3475,240,505,1,0,0,241,3980,ITI,ITI1,9,Toscana,Toscana,3729641,122183,3.28,0.11
911,2021-01-22,TOS,2861,1063,1798,2022,81,758,0,0,0,525,2336,ITI,ITI1,9,Toscana,Toscana,3729641,125044,3.35,0.08
912,2021-02-12,TOS,7606,2683,4923,3742,3272,188,2,402,0,7393,213,ITI,ITI1,9,Toscana,Toscana,3729641,132650,3.56,0.2
913,2021-01-14,TOS,3254,1179,2075,2459,475,320,0,0,0,3254,0,ITI,ITI1,9,Toscana,Toscana,3729641,135904,3.64,0.09
914,2021-02-15,TOS,8770,3374,5396,4536,2028,216,56,794,1140,7945,825,ITI,ITI1,9,Toscana,Toscana,3729641,144674,3.88,0.24
915,2021-03-19,TOS,9653,4262,5391,618,4413,241,4333,13,35,7008,2645,ITI,ITI1,9,Toscana,Toscana,3729641,154327,4.14,0.26
916,2021-03-04,TOS,17372,6605,10767,2816,1661,262,8124,814,3695,14296,3076,ITI,ITI1,9,Toscana,Toscana,3729641,171699,4.6,0.47
917,2021-01-17,TOS,2535,871,1664,2002,293,240,0,0,0,2022,513,ITI,ITI1,9,Toscana,Toscana,3729641,174234,4.67,0.07
918,2021-02-19,TOS,8297,2951,5346,2966,1234,243,154,580,3120,7790,507,ITI,ITI1,9,Toscana,Toscana,3729641,182531,4.89,0.22
919,2021-02-07,TOS,2806,953,1853,2349,300,157,0,0,0,885,1921,ITI,ITI1,9,Toscana,Toscana,3729641,185337,4.97,0.08
920,2021-01-05,TOS,5244,1755,3489,4354,11,879,0,0,0,5244,0,ITI,ITI1,9,Toscana,Toscana,3729641,190581,5.11,0.14
921,2021-01-08,TOS,5944,1641,4303,5360,39,545,0,0,0,5944,0,ITI,ITI1,9,Toscana,Toscana,3729641,196525,5.27,0.16
922,2021-02-08,TOS,4095,1358,2737,3373,345,377,0,0,0,3636,459,ITI,ITI1,9,Toscana,Toscana,3729641,200620,5.38,0.11
923,2021-01-30,TOS,4620,1622,2998,3763,219,638,0,0,0,197,4423,ITI,ITI1,9,Toscana,Toscana,3729641,205240,5.5,0.12
924,2021-01-10,TOS,3001,1104,1897,2432,138,431,0,0,0,3001,0,ITI,ITI1,9,Toscana,Toscana,3729641,208241,5.58,0.08
925,2021-01-29,TOS,6136,1698,4438,5375,139,622,0,0,0,302,5834,ITI,ITI1,9,Toscana,Toscana,3729641,214377,5.75,0.16
926,2021-03-13,TOS,9254,3282,5972,2833,2109,54,174,344,3740,5308,3946,ITI,ITI1,9,Toscana,Toscana,3729641,223631,6.0,0.25
927,2021-01-19,TOS,1104,531,573,392,221,491,0,0,0,1104,0,ITI,ITI1,9,Toscana,Toscana,3729641,224735,6.03,0.03
928,2021-03-18,TOS,9421,3760,5661,427,1410,238,7336,7,3,5615,3806,ITI,ITI1,9,Toscana,Toscana,3729641,234156,6.28,0.25
929,2021-02-13,TOS,7785,2360,5425,3667,3768,163,0,186,1,7558,227,ITI,ITI1,9,Toscana,Toscana,3729641,241941,6.49,0.21
930,2021-02-01,TOS,5465,1942,3523,4441,407,617,0,0,0,521,4944,ITI,ITI1,9,Toscana,Toscana,3729641,247406,6.63,0.15
931,2021-02-25,TOS,10580,4281,6299,1078,1702,259,3201,1141,3199,9586,994,ITI,ITI1,9,Toscana,Toscana,3729641,257986,6.92,0.28
932,2021-01-23,TOS,3949,1354,2595,2936,172,841,0,0,0,640,3309,ITI,ITI1,9,Toscana,Toscana,3729641,261935,7.02,0.11
933,2021-03-20,TOS,6283,2754,3529,867,5288,52,28,14,34,5218,1065,ITI,ITI1,9,Toscana,Toscana,3729641,268218,7.19,0.17
934,2021-02-16,TOS,9267,3338,5929,5083,982,178,10,691,2323,8556,711,ITI,ITI1,9,Toscana,Toscana,3729641,277485,7.44,0.25
935,2021-03-01,TOS,4295,1611,2684,3188,601,136,2,343,25,660,3635,ITI,ITI1,9,Toscana,Toscana,3729641,281780,7.56,0.12
936,2021-01-09,TOS,4484,1596,2888,3779,144,560,1,0,0,4484,0,ITI,ITI1,9,Toscana,Toscana,3729641,286264,7.68,0.12
937,2021-02-24,TOS,10345,4457,5888,81,1570,301,4114,1331,2948,10148,197,ITI,ITI1,9,Toscana,Toscana,3729641,296609,7.95,0.28
938,2021-02-17,TOS,8175,3168,5007,3465,1173,249,218,584,2486,7424,751,ITI,ITI1,9,Toscana,Toscana,3729641,304784,8.17,0.22
939,2021-02-23,TOS,7719,3323,4396,1490,1571,204,509,1114,2831,7558,161,ITI,ITI1,9,Toscana,Toscana,3729641,312503,8.38,0.21
940,2021-03-15,TOS,8298,3300,4998,3216,1957,401,23,420,2281,3862,4436,ITI,ITI1,9,Toscana,Toscana,3729641,320801,8.6,0.22
941,2021-02-18,TOS,8815,3284,5531,2924,1511,228,214,796,3142,7923,892,ITI,ITI1,9,Toscana,Toscana,3729641,329616,8.84,0.24
942,2021-02-05,TOS,5748,2244,3504,4121,1184,442,1,0,0,1924,3824,ITI,ITI1,9,Toscana,Toscana,3729641,335364,8.99,0.15
943,2021-03-07,TOS,5647,2356,3291,3102,1097,123,15,536,774,2106,3541,ITI,ITI1,9,Toscana,Toscana,3729641,341011,9.14,0.15
944,2021-01-13,TOS,4063,1398,2665,3308,350,405,0,0,0,4063,0,ITI,ITI1,9,Toscana,Toscana,3729641,345074,9.25,0.11
945,2021-01-21,TOS,1589,686,903,579,220,790,0,0,0,867,722,ITI,ITI1,9,Toscana,Toscana,3729641,346663,9.29,0.04
946,2021-01-15,TOS,3878,1347,2531,2758,676,444,0,0,0,3878,0,ITI,ITI1,9,Toscana,Toscana,3729641,350541,9.4,0.1
947,2021-01-20,TOS,1314,635,679,432,256,626,0,0,0,1077,237,ITI,ITI1,9,Toscana,Toscana,3729641,351855,9.43,0.04
948,2021-01-28,TOS,6275,1880,4395,5421,66,788,0,0,0,349,5926,ITI,ITI1,9,Toscana,Toscana,3729641,358130,9.6,0.17
949,2021-01-07,TOS,6018,1751,4267,5308,30,680,0,0,0,6018,0,ITI,ITI1,9,Toscana,Toscana,3729641,364148,9.76,0.16
950,2021-01-18,TOS,1119,636,483,430,314,375,0,0,0,1021,98,ITI,ITI1,9,Toscana,Toscana,3729641,365267,9.79,0.03
951,2021-02-22,TOS,9817,4253,5564,3484,2279,315,22,1014,2703,9539,278,ITI,ITI1,9,Toscana,Toscana,3729641,375084,10.06,0.26
952,2021-01-27,TOS,4835,1572,3263,4019,74,742,0,0,0,207,4628,ITI,ITI1,9,Toscana,Toscana,3729641,379919,10.19,0.13
953,2021-02-10,TOS,4262,1280,2982,3536,241,484,0,1,0,3739,523,ITI,ITI1,9,Toscana,Toscana,3729641,384181,10.3,0.11
954,2021-01-16,TOS,3271,1046,2225,2493,538,240,0,0,0,3271,0,ITI,ITI1,9,Toscana,Toscana,3729641,387452,10.39,0.09
955,2021-02-28,TOS,1648,667,981,1110,202,78,0,249,9,921,727,ITI,ITI1,9,Toscana,Toscana,3729641,389100,10.43,0.04
956,2021-01-11,TOS,5092,1689,3403,4360,210,522,0,0,0,5092,0,ITI,ITI1,9,Toscana,Toscana,3729641,394192,10.57,0.14
957,2021-03-09,TOS,10404,3985,6419,4805,2078,151,3217,142,11,4851,5553,ITI,ITI1,9,Toscana,Toscana,3729641,404596,10.85,0.28
958,2021-02-27,TOS,1945,723,1222,1354,314,132,1,125,19,1043,902,ITI,ITI1,9,Toscana,Toscana,3729641,406541,10.9,0.05
959,2021-01-25,TOS,5124,1896,3228,4159,56,909,0,0,0,248,4876,ITI,ITI1,9,Toscana,Toscana,3729641,411665,11.04,0.14
960,2021-01-02,TOS,3497,1097,2400,2682,15,800,0,0,0,3497,0,ITI,ITI1,9,Toscana,Toscana,3729641,415162,11.13,0.09
961,2021-02-04,TOS,4251,1594,2657,3166,624,456,5,0,0,961,3290,ITI,ITI1,9,Toscana,Toscana,3729641,419413,11.25,0.11
962,2021-01-31,TOS,3048,1129,1919,2465,135,448,0,0,0,105,2943,ITI,ITI1,9,Toscana,Toscana,3729641,422461,11.33,0.08
963,2021-02-21,TOS,5104,2089,3015,3666,1219,195,2,13,9,4935,169,ITI,ITI1,9,Toscana,Toscana,3729641,427565,11.46,0.14
964,2021-01-01,TOS,2368,786,1582,1716,2,650,0,0,0,2368,0,ITI,ITI1,9,Toscana,Toscana,3729641,429933,11.53,0.06
965,2021-01-12,TOS,3581,1398,2183,2944,283,354,0,0,0,3581,0,ITI,ITI1,9,Toscana,Toscana,3729641,433514,11.62,0.1
966,2021-02-11,TOS,5383,2021,3362,2809,2218,323,12,10,11,5141,242,ITI,ITI1,9,Toscana,Toscana,3729641,438897,11.77,0.14
967,2021-02-02,TOS,3741,1475,2266,3020,287,422,6,6,0,194,3547,ITI,ITI1,9,Toscana,Toscana,3729641,442638,11.87,0.1
968,2021-03-12,TOS,16055,5987,10068,2604,1950,176,6750,650,3925,12544,3511,ITI,ITI1,9,Toscana,Toscana,3729641,458693,12.3,0.43
969,2021-03-21,TOS,2213,1146,1067,368,1778,55,7,3,2,1177,1036,ITI,ITI1,9,Toscana,Toscana,3729641,460906,12.36,0.06
970,2021-02-09,TOS,4486,1468,3018,3583,388,513,2,0,0,3875,611,ITI,ITI1,9,Toscana,Toscana,3729641,465392,12.48,0.12
971,2021-03-16,TOS,4781,1834,2947,1543,1087,120,2003,12,16,2570,2211,ITI,ITI1,9,Toscana,Toscana,3729641,470173,12.61,0.13
972,2021-03-17,TOS,10816,4320,6496,345,1094,129,9244,2,2,6506,4310,ITI,ITI1,9,Toscana,Toscana,3729641,480989,12.9,0.29
973,2021-01-26,TOS,5392,1791,3601,4357,84,951,0,0,0,219,5173,ITI,ITI1,9,Toscana,Toscana,3729641,486381,13.04,0.14
974,2021-03-06,TOS,7096,2839,4257,3804,1614,145,30,357,1146,2905,4191,ITI,ITI1,9,Toscana,Toscana,3729641,493477,13.23,0.19
975,2020-12-31,TOS,805,202,603,97,10,698,0,0,0,805,0,ITI,ITI1,9,Toscana,Toscana,3729641,494282,13.25,0.02
976,2020-12-27,TOS,620,267,353,460,147,13,0,0,0,620,0,ITI,ITI1,9,Toscana,Toscana,3729641,494902,13.27,0.02
977,2021-03-10,TOS,17515,6847,10668,2993,2221,204,11906,178,13,13547,3968,ITI,ITI1,9,Toscana,Toscana,3729641,512417,13.74,0.47
978,2021-03-02,ABR,3963,1676,2287,934,439,53,1856,276,405,3279,684,ITF,ITF1,13,Abruzzo,Abruzzo,1304970,3963,0.3,0.3
979,2021-01-11,ABR,1551,557,994,1337,166,48,0,0,0,1551,0,ITF,ITF1,13,Abruzzo,Abruzzo,1304970,5514,0.42,0.12
980,2021-01-14,ABR,530,189,341,364,166,0,0,0,0,530,0,ITF,ITF1,13,Abruzzo,Abruzzo,1304970,6044,0.46,0.04
981,2021-03-05,ABR,5261,1937,3324,561,457,107,2582,202,1352,4564,697,ITF,ITF1,13,Abruzzo,Abruzzo,1304970,11305,0.87,0.4
982,2021-02-26,ABR,3919,1671,2248,1025,565,160,1650,257,262,2950,969,ITF,ITF1,13,Abruzzo,Abruzzo,1304970,15224,1.17,0.3
983,2021-01-12,ABR,1804,666,1138,1470,334,0,0,0,0,1804,0,ITF,ITF1,13,Abruzzo,Abruzzo,1304970,17028,1.3,0.14
984,2021-02-12,ABR,968,319,649,438,220,310,0,0,0,779,189,ITF,ITF1,13,Abruzzo,Abruzzo,1304970,17996,1.38,0.07
985,2021-01-17,ABR,187,59,128,136,51,0,0,0,0,180,7,ITF,ITF1,13,Abruzzo,Abruzzo,1304970,18183,1.39,0.01
986,2021-03-17,ABR,4542,1876,2666,285,213,144,3872,17,11,2799,1743,ITF,ITF1,13,Abruzzo,Abruzzo,1304970,22725,1.74,0.35
987,2021-02-28,ABR,1707,511,1196,23,34,0,79,149,1422,1705,2,ITF,ITF1,13,Abruzzo,Abruzzo,1304970,24432,1.87,0.13
988,2021-02-15,ABR,1796,831,965,625,487,221,217,246,0,1754,42,ITF,ITF1,13,Abruzzo,Abruzzo,1304970,26228,2.01,0.14
989,2021-03-19,ABR,5795,2584,3211,755,460,118,4398,51,13,2774,3021,ITF,ITF1,13,Abruzzo,Abruzzo,1304970,32023,2.45,0.44
990,2021-03-06,ABR,4174,1354,2820,432,368,52,1748,15,1559,3604,570,ITF,ITF1,13,Abruzzo,Abruzzo,1304970,36197,2.77,0.32
991,2021-01-22,ABR,118,57,61,2,4,112,0,0,0,118,0,ITF,ITF1,13,Abruzzo,Abruzzo,1304970,36315,2.78,0.01
992,2021-02-13,ABR,845,383,462,549,224,72,0,0,0,437,408,ITF,ITF1,13,Abruzzo,Abruzzo,1304970,37160,2.85,0.06
993,2021-03-01,ABR,3485,1390,2095,697,293,174,1911,128,282,2722,763,ITF,ITF1,13,Abruzzo,Abruzzo,1304970,40645,3.11,0.27
994,2021-03-08,ABR,5127,1669,3458,1190,507,112,1019,104,2195,4153,974,ITF,ITF1,13,Abruzzo,Abruzzo,1304970,45772,3.51,0.39
995,2020-12-27,ABR,37,19,18,34,1,2,0,0,0,37,0,ITF,ITF1,13,Abruzzo,Abruzzo,1304970,45809,3.51,0.0
996,2021-02-05,ABR,1535,520,1015,1188,241,106,0,0,0,788,747,ITF,ITF1,13,Abruzzo,Abruzzo,1304970,47344,3.63,0.12
997,2021-01-30,ABR,1509,566,943,1348,114,47,0,0,0,69,1440,ITF,ITF1,13,Abruzzo,Abruzzo,1304970,48853,3.74,0.12
998,2021-02-25,ABR,3086,1347,1739,615,557,18,1508,262,126,2558,528,ITF,ITF1,13,Abruzzo,Abruzzo,1304970,51939,3.98,0.24
999,2021-02-10,ABR,948,313,635,622,210,116,0,0,0,504,444,ITF,ITF1,13,Abruzzo,Abruzzo,1304970,52887,4.05,0.07
1000,2021-03-13,ABR,4166,1431,2735,537,1011,137,1401,23,1057,3102,1064,ITF,ITF1,13,Abruzzo,Abruzzo,1304970,57053,4.37,0.32
1001,2021-03-12,ABR,6021,1988,4033,1005,875,135,1700,117,2189,4438,1583,ITF,ITF1,13,Abruzzo,Abruzzo,1304970,63074,4.83,0.46
1002,2021-01-16,ABR,927,428,499,710,202,15,0,0,0,927,0,ITF,ITF1,13,Abruzzo,Abruzzo,1304970,64001,4.9,0.07
1003,2021-01-10,ABR,1139,409,730,1091,48,0,0,0,0,1139,0,ITF,ITF1,13,Abruzzo,Abruzzo,1304970,65140,4.99,0.09
1004,2021-02-20,ABR,4781,1842,2939,310,569,192,1417,406,1887,4705,76,ITF,ITF1,13,Abruzzo,Abruzzo,1304970,69921,5.36,0.37
1005,2021-02-18,ABR,2291,934,1357,670,380,416,610,215,0,2161,130,ITF,ITF1,13,Abruzzo,Abruzzo,1304970,72212,5.53,0.18
1006,2021-01-09,ABR,1483,565,918,1430,53,0,0,0,0,1483,0,ITF,ITF1,13,Abruzzo,Abruzzo,1304970,73695,5.65,0.11
1007,2021-02-19,ABR,3301,1552,1749,990,433,371,1111,388,8,3201,100,ITF,ITF1,13,Abruzzo,Abruzzo,1304970,76996,5.9,0.25
1008,2021-01-08,ABR,1525,507,1018,1487,38,0,0,0,0,1525,0,ITF,ITF1,13,Abruzzo,Abruzzo,1304970,78521,6.02,0.12
1009,2021-01-07,ABR,1603,552,1051,1566,37,0,0,0,0,1603,0,ITF,ITF1,13,Abruzzo,Abruzzo,1304970,80124,6.14,0.12
1010,2021-01-21,ABR,157,47,110,10,6,141,0,0,0,157,0,ITF,ITF1,13,Abruzzo,Abruzzo,1304970,80281,6.15,0.01
1011,2021-02-07,ABR,777,307,470,646,130,1,0,0,0,201,576,ITF,ITF1,13,Abruzzo,Abruzzo,1304970,81058,6.21,0.06
1012,2021-03-03,ABR,4627,1881,2746,1222,583,36,1585,346,855,3721,906,ITF,ITF1,13,Abruzzo,Abruzzo,1304970,85685,6.57,0.35
1013,2021-02-23,ABR,2784,1274,1510,324,423,215,1436,286,100,2773,11,ITF,ITF1,13,Abruzzo,Abruzzo,1304970,88469,6.78,0.21
1014,2021-03-10,ABR,4948,1640,3308,735,455,242,1518,127,1871,3992,956,ITF,ITF1,13,Abruzzo,Abruzzo,1304970,93417,7.16,0.38
1015,2021-02-24,ABR,3302,1439,1863,391,340,247,1967,226,131,3126,176,ITF,ITF1,13,Abruzzo,Abruzzo,1304970,96719,7.41,0.25
1016,2021-01-23,ABR,263,114,149,223,14,26,0,0,0,57,206,ITF,ITF1,13,Abruzzo,Abruzzo,1304970,96982,7.43,0.02
1017,2021-02-09,ABR,908,311,597,612,165,131,0,0,0,499,409,ITF,ITF1,13,Abruzzo,Abruzzo,1304970,97890,7.5,0.07
1018,2021-02-04,ABR,1681,616,1065,1168,456,57,0,0,0,609,1072,ITF,ITF1,13,Abruzzo,Abruzzo,1304970,99571,7.63,0.13
1019,2021-03-18,ABR,3896,1651,2245,281,286,3,3297,22,7,2065,1831,ITF,ITF1,13,Abruzzo,Abruzzo,1304970,103467,7.93,0.3
1020,2021-03-21,ABR,778,330,448,0,9,1,686,28,54,213,565,ITF,ITF1,13,Abruzzo,Abruzzo,1304970,104245,7.99,0.06
1021,2021-01-04,ABR,1401,575,826,1396,5,0,0,0,0,1401,0,ITF,ITF1,13,Abruzzo,Abruzzo,1304970,105646,8.1,0.11
1022,2021-03-11,ABR,5422,2186,3236,1322,558,241,1539,199,1563,4283,1139,ITF,ITF1,13,Abruzzo,Abruzzo,1304970,111068,8.51,0.42
1023,2021-02-21,ABR,1221,551,670,2,4,3,1210,2,0,1220,1,ITF,ITF1,13,Abruzzo,Abruzzo,1304970,112289,8.6,0.09
1024,2021-01-03,ABR,471,185,286,464,7,0,0,0,0,471,0,ITF,ITF1,13,Abruzzo,Abruzzo,1304970,112760,8.64,0.04
1025,2021-03-15,ABR,3516,1377,2139,656,569,78,1963,41,209,1701,1815,ITF,ITF1,13,Abruzzo,Abruzzo,1304970,116276,8.91,0.27
1026,2021-02-03,ABR,2061,717,1344,1541,402,118,0,0,0,419,1642,ITF,ITF1,13,Abruzzo,Abruzzo,1304970,118337,9.07,0.16
1027,2021-01-28,ABR,1433,495,938,1370,62,1,0,0,0,12,1421,ITF,ITF1,13,Abruzzo,Abruzzo,1304970,119770,9.18,0.11
1028,2021-03-04,ABR,5936,2358,3578,1170,535,93,2992,328,818,5015,921,ITF,ITF1,13,Abruzzo,Abruzzo,1304970,125706,9.63,0.45
1029,2021-01-24,ABR,50,22,28,49,1,0,0,0,0,6,44,ITF,ITF1,13,Abruzzo,Abruzzo,1304970,125756,9.64,0.0
1030,2021-01-29,ABR,1386,449,937,1290,96,0,0,0,0,74,1312,ITF,ITF1,13,Abruzzo,Abruzzo,1304970,127142,9.74,0.11
1031,2021-02-17,ABR,2076,951,1125,512,241,394,718,210,1,1793,283,ITF,ITF1,13,Abruzzo,Abruzzo,1304970,129218,9.9,0.16
1032,2021-02-01,ABR,1632,573,1059,1384,247,1,0,0,0,271,1361,ITF,ITF1,13,Abruzzo,Abruzzo,1304970,130850,10.03,0.13
1033,2021-01-20,ABR,447,156,291,147,96,204,0,0,0,445,2,ITF,ITF1,13,Abruzzo,Abruzzo,1304970,131297,10.06,0.03
1034,2021-01-31,ABR,1502,488,1014,1154,245,103,0,0,0,287,1215,ITF,ITF1,13,Abruzzo,Abruzzo,1304970,132799,10.18,0.12
1035,2021-01-27,ABR,1364,515,849,1301,63,0,0,0,0,39,1325,ITF,ITF1,13,Abruzzo,Abruzzo,1304970,134163,10.28,0.1
1036,2021-03-09,ABR,5169,1795,3374,987,528,84,1320,204,2046,4230,939,ITF,ITF1,13,Abruzzo,Abruzzo,1304970,139332,10.68,0.4
1037,2021-02-22,ABR,2644,1175,1469,477,357,46,1094,419,251,2614,30,ITF,ITF1,13,Abruzzo,Abruzzo,1304970,141976,10.88,0.2
1038,2021-02-11,ABR,816,262,554,473,189,154,0,0,0,773,43,ITF,ITF1,13,Abruzzo,Abruzzo,1304970,142792,10.94,0.06
1039,2021-03-16,ABR,3486,1453,2033,284,166,169,2849,6,12,1831,1655,ITF,ITF1,13,Abruzzo,Abruzzo,1304970,146278,11.21,0.27
1040,2021-02-16,ABR,1978,869,1109,841,513,139,410,75,0,1966,12,ITF,ITF1,13,Abruzzo,Abruzzo,1304970,148256,11.36,0.15
1041,2021-01-13,ABR,1253,440,813,1103,150,0,0,0,0,1253,0,ITF,ITF1,13,Abruzzo,Abruzzo,1304970,149509,11.46,0.1
1042,2021-01-06,ABR,1830,664,1166,1546,151,133,0,0,0,1830,0,ITF,ITF1,13,Abruzzo,Abruzzo,1304970,151339,11.6,0.14
1043,2021-01-05,ABR,1614,604,1010,1604,10,0,0,0,0,1614,0,ITF,ITF1,13,Abruzzo,Abruzzo,1304970,152953,11.72,0.12
1044,2021-01-18,ABR,122,48,74,106,14,2,0,0,0,46,76,ITF,ITF1,13,Abruzzo,Abruzzo,1304970,153075,11.73,0.01
1045,2021-01-15,ABR,379,149,230,223,121,35,0,0,0,379,0,ITF,ITF1,13,Abruzzo,Abruzzo,1304970,153454,11.76,0.03
1046,2021-02-08,ABR,1201,398,803,710,227,264,0,0,0,491,710,ITF,ITF1,13,Abruzzo,Abruzzo,1304970,154655,11.85,0.09
1047,2021-01-19,ABR,111,55,56,27,34,50,0,0,0,91,20,ITF,ITF1,13,Abruzzo,Abruzzo,1304970,154766,11.86,0.01
1048,2021-03-07,ABR,2523,630,1893,28,210,0,461,1,1823,2523,0,ITF,ITF1,13,Abruzzo,Abruzzo,1304970,157289,12.05,0.19
1049,2021-01-26,ABR,1542,567,975,1513,29,0,0,0,0,29,1513,ITF,ITF1,13,Abruzzo,Abruzzo,1304970,158831,12.17,0.12
1050,2021-03-20,ABR,4726,2155,2571,318,524,60,3643,84,97,2568,2158,ITF,ITF1,13,Abruzzo,Abruzzo,1304970,163557,12.53,0.36
1051,2021-01-25,ABR,1604,633,971,1584,20,0,0,0,0,20,1584,ITF,ITF1,13,Abruzzo,Abruzzo,1304970,165161,12.66,0.12
1052,2021-02-27,ABR,2809,1337,1472,253,185,123,732,642,874,2543,266,ITF,ITF1,13,Abruzzo,Abruzzo,1304970,167970,12.87,0.22
1053,2021-03-14,ABR,1883,731,1152,8,150,0,1476,0,249,1216,667,ITF,ITF1,13,Abruzzo,Abruzzo,1304970,169853,13.02,0.14
1054,2021-02-02,ABR,1798,677,1121,1243,413,142,0,0,0,241,1557,ITF,ITF1,13,Abruzzo,Abruzzo,1304970,171651,13.15,0.14
1055,2021-01-02,ABR,548,218,330,540,8,0,0,0,0,548,0,ITF,ITF1,13,Abruzzo,Abruzzo,1304970,172199,13.2,0.04
1056,2021-02-06,ABR,1611,742,869,1168,371,72,0,0,0,602,1009,ITF,ITF1,13,Abruzzo,Abruzzo,1304970,173810,13.32,0.12
1057,2021-02-20,EMR,5309,2100,3209,406,239,155,4509,0,0,5045,264,ITH,ITH5,8,Emilia-Romagna,Emilia-Romagna,4459477,5309,0.12,0.12
1058,2021-02-15,EMR,2890,845,2045,1981,463,157,289,0,0,2764,126,ITH,ITH5,8,Emilia-Romagna,Emilia-Romagna,4459477,8199,0.18,0.06
1059,2020-12-27,EMR,968,372,596,824,118,26,0,0,0,968,0,ITH,ITH5,8,Emilia-Romagna,Emilia-Romagna,4459477,9167,0.21,0.02
1060,2021-03-06,EMR,20312,5804,14508,2672,963,40,5859,517,10261,17620,2692,ITH,ITH5,8,Emilia-Romagna,Emilia-Romagna,4459477,29479,0.66,0.46
1061,2021-03-16,EMR,11957,4877,7080,408,682,86,10653,6,122,4735,7222,ITH,ITH5,8,Emilia-Romagna,Emilia-Romagna,4459477,41436,0.93,0.27
1062,2021-01-22,EMR,1827,477,1350,941,164,722,0,0,0,1088,739,ITH,ITH5,8,Emilia-Romagna,Emilia-Romagna,4459477,43263,0.97,0.04
1063,2021-01-17,EMR,2889,887,2002,1913,425,547,0,0,4,2643,246,ITH,ITH5,8,Emilia-Romagna,Emilia-Romagna,4459477,46152,1.03,0.06
1064,2020-12-31,EMR,2204,776,1428,1675,202,327,0,0,0,2204,0,ITH,ITH5,8,Emilia-Romagna,Emilia-Romagna,4459477,48356,1.08,0.05
1065,2021-03-19,EMR,12848,5423,7425,955,2128,48,9344,70,303,5817,7031,ITH,ITH5,8,Emilia-Romagna,Emilia-Romagna,4459477,61204,1.37,0.29
1066,2021-03-05,EMR,17477,5679,11798,3063,1476,244,6249,531,5914,14083,3394,ITH,ITH5,8,Emilia-Romagna,Emilia-Romagna,4459477,78681,1.76,0.39
1067,2021-01-30,EMR,10037,3508,6529,7562,1706,769,0,0,0,143,9894,ITH,ITH5,8,Emilia-Romagna,Emilia-Romagna,4459477,88718,1.99,0.23
1068,2021-01-11,EMR,9323,3266,6057,6574,1482,1267,0,0,0,9323,0,ITH,ITH5,8,Emilia-Romagna,Emilia-Romagna,4459477,98041,2.2,0.21
1069,2021-01-25,EMR,6413,2128,4285,5231,504,678,0,0,0,221,6192,ITH,ITH5,8,Emilia-Romagna,Emilia-Romagna,4459477,104454,2.34,0.14
1070,2021-03-10,EMR,18114,7309,10805,1314,1215,128,9894,1114,4449,12492,5622,ITH,ITH5,8,Emilia-Romagna,Emilia-Romagna,4459477,122568,2.75,0.41
1071,2021-01-06,EMR,8262,2941,5321,6850,761,650,0,1,0,8262,0,ITH,ITH5,8,Emilia-Romagna,Emilia-Romagna,4459477,130830,2.93,0.19
1072,2021-01-31,EMR,7692,2758,4934,6172,1259,261,0,0,0,242,7450,ITH,ITH5,8,Emilia-Romagna,Emilia-Romagna,4459477,138522,3.11,0.17
1073,2021-03-14,EMR,8466,3620,4846,698,942,69,5494,359,904,4690,3776,ITH,ITH5,8,Emilia-Romagna,Emilia-Romagna,4459477,146988,3.3,0.19
1074,2021-02-25,EMR,9151,3472,5679,793,514,140,7619,0,85,8200,951,ITH,ITH5,8,Emilia-Romagna,Emilia-Romagna,4459477,156139,3.5,0.21
1075,2021-03-17,EMR,13419,5566,7853,348,1344,49,11659,0,19,5697,7722,ITH,ITH5,8,Emilia-Romagna,Emilia-Romagna,4459477,169558,3.8,0.3
1076,2021-02-02,EMR,9430,3030,6400,6230,1490,1629,80,0,1,496,8934,ITH,ITH5,8,Emilia-Romagna,Emilia-Romagna,4459477,178988,4.01,0.21
1077,2021-01-23,EMR,2443,868,1575,1899,114,430,0,0,0,441,2002,ITH,ITH5,8,Emilia-Romagna,Emilia-Romagna,4459477,181431,4.07,0.05
1078,2021-03-07,EMR,6528,2433,4095,1452,737,22,2555,513,1249,5013,1515,ITH,ITH5,8,Emilia-Romagna,Emilia-Romagna,4459477,187959,4.21,0.15
1079,2021-03-02,EMR,11592,3807,7785,1921,785,221,5267,355,3043,9618,1974,ITH,ITH5,8,Emilia-Romagna,Emilia-Romagna,4459477,199551,4.47,0.26
1080,2021-03-13,EMR,15657,6075,9582,1245,1281,73,8217,886,3955,10371,5286,ITH,ITH5,8,Emilia-Romagna,Emilia-Romagna,4459477,215208,4.83,0.35
1081,2021-01-14,EMR,8085,2573,5512,5390,1088,1606,0,1,0,8085,0,ITH,ITH5,8,Emilia-Romagna,Emilia-Romagna,4459477,223293,5.01,0.18
1082,2021-01-05,EMR,9324,3163,6161,7924,635,765,0,0,0,9324,0,ITH,ITH5,8,Emilia-Romagna,Emilia-Romagna,4459477,232617,5.22,0.21
1083,2021-01-02,EMR,2347,903,1444,2071,79,197,0,0,0,2347,0,ITH,ITH5,8,Emilia-Romagna,Emilia-Romagna,4459477,234964,5.27,0.05
1084,2021-01-20,EMR,1321,269,1052,391,143,787,0,0,0,1320,1,ITH,ITH5,8,Emilia-Romagna,Emilia-Romagna,4459477,236285,5.3,0.03
1085,2021-01-19,EMR,2039,502,1537,745,135,1159,0,0,0,2022,17,ITH,ITH5,8,Emilia-Romagna,Emilia-Romagna,4459477,238324,5.34,0.05
1086,2021-01-18,EMR,3125,879,2246,1681,316,1128,0,0,0,2448,677,ITH,ITH5,8,Emilia-Romagna,Emilia-Romagna,4459477,241449,5.41,0.07
1087,2021-01-07,EMR,10208,3381,6827,8181,959,1068,0,0,0,10208,0,ITH,ITH5,8,Emilia-Romagna,Emilia-Romagna,4459477,251657,5.64,0.23
1088,2021-02-23,EMR,8188,3211,4977,407,316,111,7353,0,1,7804,384,ITH,ITH5,8,Emilia-Romagna,Emilia-Romagna,4459477,259845,5.83,0.18
1089,2021-03-18,EMR,13243,5602,7641,448,2092,19,10634,1,49,5481,7762,ITH,ITH5,8,Emilia-Romagna,Emilia-Romagna,4459477,273088,6.12,0.3
1090,2021-02-19,EMR,7283,2999,4284,818,368,257,5840,0,0,6780,503,ITH,ITH5,8,Emilia-Romagna,Emilia-Romagna,4459477,280371,6.29,0.16
1091,2021-01-21,EMR,2151,725,1426,1282,216,653,0,0,0,809,1342,ITH,ITH5,8,Emilia-Romagna,Emilia-Romagna,4459477,282522,6.34,0.05
1092,2021-01-26,EMR,8325,3000,5325,6599,694,1032,0,0,0,217,8108,ITH,ITH5,8,Emilia-Romagna,Emilia-Romagna,4459477,290847,6.52,0.19
1093,2021-02-04,EMR,9902,3191,6711,6426,1684,1674,118,0,0,1237,8665,ITH,ITH5,8,Emilia-Romagna,Emilia-Romagna,4459477,300749,6.74,0.22
1094,2021-02-17,EMR,6533,2761,3772,803,1278,404,4048,0,0,5760,773,ITH,ITH5,8,Emilia-Romagna,Emilia-Romagna,4459477,307282,6.89,0.15
1095,2021-03-20,EMR,15014,6216,8798,695,4341,69,9017,72,820,8289,6725,ITH,ITH5,8,Emilia-Romagna,Emilia-Romagna,4459477,322296,7.23,0.34
1096,2021-02-07,EMR,4786,1534,3252,3685,644,444,10,0,3,1727,3059,ITH,ITH5,8,Emilia-Romagna,Emilia-Romagna,4459477,327082,7.33,0.11
1097,2021-02-26,EMR,7613,2886,4727,1008,622,217,5463,0,303,6577,1036,ITH,ITH5,8,Emilia-Romagna,Emilia-Romagna,4459477,334695,7.51,0.17
1098,2021-03-21,EMR,4256,1776,2480,250,951,43,2789,2,221,2125,2131,ITH,ITH5,8,Emilia-Romagna,Emilia-Romagna,4459477,338951,7.6,0.1
1099,2021-01-24,EMR,2443,884,1559,2079,114,250,0,0,0,300,2143,ITH,ITH5,8,Emilia-Romagna,Emilia-Romagna,4459477,341394,7.66,0.05
1100,2021-03-04,EMR,16274,5297,10977,2594,1177,239,6346,511,5407,13283,2991,ITH,ITH5,8,Emilia-Romagna,Emilia-Romagna,4459477,357668,8.02,0.36
1101,2021-01-13,EMR,9062,2938,6124,6005,1312,1744,0,0,1,9062,0,ITH,ITH5,8,Emilia-Romagna,Emilia-Romagna,4459477,366730,8.22,0.2
1102,2021-02-06,EMR,7526,2379,5147,5358,946,1172,50,0,0,2120,5406,ITH,ITH5,8,Emilia-Romagna,Emilia-Romagna,4459477,374256,8.39,0.17
1103,2021-03-15,EMR,12571,5634,6937,789,1280,142,9058,777,525,6152,6419,ITH,ITH5,8,Emilia-Romagna,Emilia-Romagna,4459477,386827,8.67,0.28
1104,2021-02-16,EMR,5728,2427,3301,743,908,437,3640,0,0,5198,530,ITH,ITH5,8,Emilia-Romagna,Emilia-Romagna,4459477,392555,8.8,0.13
1105,2021-02-18,EMR,7043,2892,4151,891,531,236,5385,0,0,6461,582,ITH,ITH5,8,Emilia-Romagna,Emilia-Romagna,4459477,399598,8.96,0.16
1106,2021-02-05,EMR,9293,2959,6334,6211,1287,1607,187,0,1,1625,7668,ITH,ITH5,8,Emilia-Romagna,Emilia-Romagna,4459477,408891,9.17,0.21
1107,2021-02-08,EMR,5185,1519,3666,2827,693,1478,186,0,1,2290,2895,ITH,ITH5,8,Emilia-Romagna,Emilia-Romagna,4459477,414076,9.29,0.12
1108,2021-01-10,EMR,7125,2663,4462,5642,977,499,6,0,1,7125,0,ITH,ITH5,8,Emilia-Romagna,Emilia-Romagna,4459477,421201,9.45,0.16
1109,2021-01-12,EMR,9313,3084,6229,6350,1332,1631,0,0,0,9313,0,ITH,ITH5,8,Emilia-Romagna,Emilia-Romagna,4459477,430514,9.65,0.21
1110,2021-01-04,EMR,7258,2510,4748,6165,516,577,0,0,0,7258,0,ITH,ITH5,8,Emilia-Romagna,Emilia-Romagna,4459477,437772,9.82,0.16
1111,2021-03-12,EMR,17480,7154,10326,1575,1799,250,9742,1094,3020,10799,6681,ITH,ITH5,8,Emilia-Romagna,Emilia-Romagna,4459477,455252,10.21,0.39
1112,2021-02-03,EMR,9269,2972,6297,6227,1340,1617,85,0,0,953,8316,ITH,ITH5,8,Emilia-Romagna,Emilia-Romagna,4459477,464521,10.42,0.21
1113,2021-01-03,EMR,2729,934,1795,2479,80,170,0,0,0,2729,0,ITH,ITH5,8,Emilia-Romagna,Emilia-Romagna,4459477,467250,10.48,0.06
1114,2021-01-16,EMR,5592,1717,3875,3687,793,1108,0,3,1,5592,0,ITH,ITH5,8,Emilia-Romagna,Emilia-Romagna,4459477,472842,10.6,0.13
1115,2021-02-13,EMR,3603,1077,2526,2779,493,145,186,0,0,3005,598,ITH,ITH5,8,Emilia-Romagna,Emilia-Romagna,4459477,476445,10.68,0.08
1116,2021-02-09,EMR,4150,1246,2904,2217,467,1198,268,0,0,2305,1845,ITH,ITH5,8,Emilia-Romagna,Emilia-Romagna,4459477,480595,10.78,0.09
1117,2021-02-14,EMR,1398,377,1021,858,482,39,19,0,0,1278,120,ITH,ITH5,8,Emilia-Romagna,Emilia-Romagna,4459477,481993,10.81,0.03
1118,2021-02-21,EMR,4404,1693,2711,394,267,190,3553,0,0,3967,437,ITH,ITH5,8,Emilia-Romagna,Emilia-Romagna,4459477,486397,10.91,0.1
1119,2021-02-28,EMR,6809,2521,4288,1769,460,53,4219,4,304,4966,1843,ITH,ITH5,8,Emilia-Romagna,Emilia-Romagna,4459477,493206,11.06,0.15
1120,2021-02-22,EMR,7462,3080,4382,386,218,129,6729,0,0,7199,263,ITH,ITH5,8,Emilia-Romagna,Emilia-Romagna,4459477,500668,11.23,0.17
1121,2021-02-01,EMR,10289,3595,6694,7446,1584,1259,0,0,0,366,9923,ITH,ITH5,8,Emilia-Romagna,Emilia-Romagna,4459477,510957,11.46,0.23
1122,2021-03-08,EMR,11445,4506,6939,2297,1031,295,4272,1212,2338,8822,2623,ITH,ITH5,8,Emilia-Romagna,Emilia-Romagna,4459477,522402,11.71,0.26
1123,2021-01-15,EMR,7699,2393,5306,5297,1084,1317,0,0,1,7699,0,ITH,ITH5,8,Emilia-Romagna,Emilia-Romagna,4459477,530101,11.89,0.17
1124,2021-01-29,EMR,10326,3477,6849,8081,1228,1017,0,0,0,289,10037,ITH,ITH5,8,Emilia-Romagna,Emilia-Romagna,4459477,540427,12.12,0.23
1125,2021-02-12,EMR,5308,1676,3632,3391,908,704,305,0,0,3908,1400,ITH,ITH5,8,Emilia-Romagna,Emilia-Romagna,4459477,545735,12.24,0.12
1126,2021-03-01,EMR,9981,3539,6442,1818,597,433,5582,309,1242,7740,2241,ITH,ITH5,8,Emilia-Romagna,Emilia-Romagna,4459477,555716,12.46,0.22
1127,2021-03-11,EMR,16838,6893,9945,1119,1721,212,8800,1215,3771,11016,5822,ITH,ITH5,8,Emilia-Romagna,Emilia-Romagna,4459477,572554,12.84,0.38
1128,2021-02-27,EMR,10941,3987,6954,1719,499,114,7671,0,938,9210,1731,ITH,ITH5,8,Emilia-Romagna,Emilia-Romagna,4459477,583495,13.08,0.25
1129,2021-01-09,EMR,9874,3425,6449,7824,1169,881,0,0,0,9874,0,ITH,ITH5,8,Emilia-Romagna,Emilia-Romagna,4459477,593369,13.31,0.22
1130,2021-01-08,EMR,10808,3555,7253,8454,1274,1080,0,0,0,10808,0,ITH,ITH5,8,Emilia-Romagna,Emilia-Romagna,4459477,604177,13.55,0.24
1131,2021-02-24,EMR,9270,3542,5728,639,582,220,7766,0,63,8411,859,ITH,ITH5,8,Emilia-Romagna,Emilia-Romagna,4459477,613447,13.76,0.21
1132,2021-01-28,EMR,10220,3333,6887,8068,1030,1122,0,0,0,348,9872,ITH,ITH5,8,Emilia-Romagna,Emilia-Romagna,4459477,623667,13.99,0.23
1133,2021-03-03,EMR,15645,5177,10468,2525,1048,160,6797,340,4775,13203,2442,ITH,ITH5,8,Emilia-Romagna,Emilia-Romagna,4459477,639312,14.34,0.35
1134,2021-02-10,EMR,3935,1353,2582,2330,574,775,256,0,0,2735,1200,ITH,ITH5,8,Emilia-Romagna,Emilia-Romagna,4459477,643247,14.42,0.09
1135,2021-01-27,EMR,8316,2934,5382,6886,775,654,0,1,0,463,7853,ITH,ITH5,8,Emilia-Romagna,Emilia-Romagna,4459477,651563,14.61,0.19
1136,2021-03-09,EMR,14334,5763,8571,1024,938,180,7563,1072,3557,10400,3934,ITH,ITH5,8,Emilia-Romagna,Emilia-Romagna,4459477,665897,14.93,0.32
1137,2021-02-11,EMR,4244,1414,2830,2528,650,719,345,0,2,3406,838,ITH,ITH5,8,Emilia-Romagna,Emilia-Romagna,4459477,670141,15.03,0.1
1138,2021-01-10,PUG,2346,1060,1286,2035,109,202,0,0,0,2346,0,ITF,ITF4,16,Puglia,Puglia,4029053,2346,0.06,0.06
1139,2020-12-30,PUG,1,0,1,1,0,0,0,0,0,1,0,ITF,ITF4,16,Puglia,Puglia,4029053,2347,0.06,0.0
1140,2021-02-07,PUG,1503,648,855,1014,222,266,0,0,1,252,1251,ITF,ITF4,16,Puglia,Puglia,4029053,3850,0.1,0.04
1141,2021-01-05,PUG,5097,2245,2852,4741,249,98,5,0,4,5097,0,ITF,ITF4,16,Puglia,Puglia,4029053,8947,0.22,0.13
1142,2021-02-05,PUG,5622,2269,3353,4562,525,526,0,3,6,1325,4297,ITF,ITF4,16,Puglia,Puglia,4029053,14569,0.36,0.14
1143,2021-02-24,PUG,9755,4563,5192,1874,707,117,6136,365,556,9167,588,ITF,ITF4,16,Puglia,Puglia,4029053,24324,0.6,0.24
1144,2021-01-29,PUG,6188,2659,3529,5465,432,288,0,0,3,436,5752,ITF,ITF4,16,Puglia,Puglia,4029053,30512,0.76,0.15
1145,2021-02-12,PUG,4098,1629,2469,2937,451,690,5,10,5,3008,1090,ITF,ITF4,16,Puglia,Puglia,4029053,34610,0.86,0.1
1146,2021-03-20,PUG,7374,3347,4027,1233,285,14,5010,35,797,3137,4237,ITF,ITF4,16,Puglia,Puglia,4029053,41984,1.04,0.18
1147,2021-03-21,PUG,1614,763,851,162,22,11,1284,12,123,221,1393,ITF,ITF4,16,Puglia,Puglia,4029053,43598,1.08,0.04
1148,2021-01-24,PUG,1668,749,919,1286,231,150,1,0,0,152,1516,ITF,ITF4,16,Puglia,Puglia,4029053,45266,1.12,0.04
1149,2021-03-03,PUG,16325,6543,9782,2013,816,192,5814,810,6680,14504,1821,ITF,ITF4,16,Puglia,Puglia,4029053,61591,1.53,0.41
1150,2021-01-13,PUG,4533,1727,2806,3967,334,230,0,0,2,4533,0,ITF,ITF4,16,Puglia,Puglia,4029053,66124,1.64,0.11
1151,2021-02-23,PUG,9299,4398,4901,1763,487,156,5480,398,1015,8832,467,ITF,ITF4,16,Puglia,Puglia,4029053,75423,1.87,0.23
1152,2021-01-27,PUG,4574,1927,2647,3915,261,396,0,0,2,610,3964,ITF,ITF4,16,Puglia,Puglia,4029053,79997,1.99,0.11
1153,2021-01-21,PUG,2129,903,1226,1429,174,526,0,0,0,1270,859,ITF,ITF4,16,Puglia,Puglia,4029053,82126,2.04,0.05
1154,2021-01-22,PUG,1409,579,830,876,157,373,2,0,1,992,417,ITF,ITF4,16,Puglia,Puglia,4029053,83535,2.07,0.03
1155,2021-02-10,PUG,3603,1425,2178,2491,247,864,0,0,1,2122,1481,ITF,ITF4,16,Puglia,Puglia,4029053,87138,2.16,0.09
1156,2021-03-08,PUG,14417,5976,8441,2093,1135,202,6661,520,3806,12040,2377,ITF,ITF4,16,Puglia,Puglia,4029053,101555,2.52,0.36
1157,2021-01-09,PUG,4867,2245,2622,4313,303,246,4,0,1,4867,0,ITF,ITF4,16,Puglia,Puglia,4029053,106422,2.64,0.12
1158,2021-02-15,PUG,3248,1264,1984,2248,539,452,0,6,3,2629,619,ITF,ITF4,16,Puglia,Puglia,4029053,109670,2.72,0.08
1159,2021-02-19,PUG,4721,2008,2713,3036,1237,390,2,49,7,4331,390,ITF,ITF4,16,Puglia,Puglia,4029053,114391,2.84,0.12
1160,2021-02-06,PUG,4483,1911,2572,3480,487,513,0,0,3,1584,2899,ITF,ITF4,16,Puglia,Puglia,4029053,118874,2.95,0.11
1161,2021-01-17,PUG,1306,589,717,823,147,336,0,0,0,1237,69,ITF,ITF4,16,Puglia,Puglia,4029053,120180,2.98,0.03
1162,2021-02-27,PUG,13908,4703,9205,1575,777,190,5024,344,5998,12735,1173,ITF,ITF4,16,Puglia,Puglia,4029053,134088,3.33,0.35
1163,2021-02-04,PUG,5892,2356,3536,4422,812,652,0,0,6,1166,4726,ITF,ITF4,16,Puglia,Puglia,4029053,139980,3.47,0.15
1164,2020-12-27,PUG,506,249,257,401,42,63,0,0,0,506,0,ITF,ITF4,16,Puglia,Puglia,4029053,140486,3.49,0.01
1165,2021-02-18,PUG,4368,1843,2525,2710,966,683,5,2,2,3765,603,ITF,ITF4,16,Puglia,Puglia,4029053,144854,3.6,0.11
1166,2021-03-12,PUG,13714,6027,7687,3277,1311,430,4881,881,2934,9791,3923,ITF,ITF4,16,Puglia,Puglia,4029053,158568,3.94,0.34
1167,2021-02-20,PUG,2958,1076,1882,2112,244,167,7,4,424,2702,256,ITF,ITF4,16,Puglia,Puglia,4029053,161526,4.01,0.07
1168,2021-01-07,PUG,5707,2448,3259,5210,276,217,0,1,3,5707,0,ITF,ITF4,16,Puglia,Puglia,4029053,167233,4.15,0.14
1169,2021-02-01,PUG,3957,1656,2301,3439,300,209,0,4,5,375,3582,ITF,ITF4,16,Puglia,Puglia,4029053,171190,4.25,0.1
1170,2021-03-07,PUG,4859,1918,2941,930,236,2,1572,323,1796,4289,570,ITF,ITF4,16,Puglia,Puglia,4029053,176049,4.37,0.12
1171,2021-03-19,PUG,7143,3345,3798,1696,380,71,4675,64,257,2937,4206,ITF,ITF4,16,Puglia,Puglia,4029053,183192,4.55,0.18
1172,2021-03-05,PUG,16918,6737,10181,2307,1216,272,5191,1018,6914,14758,2160,ITF,ITF4,16,Puglia,Puglia,4029053,200110,4.97,0.42
1173,2021-01-30,PUG,5523,2510,3013,4747,348,419,3,0,6,413,5110,ITF,ITF4,16,Puglia,Puglia,4029053,205633,5.1,0.14
1174,2021-03-15,PUG,11554,5521,6033,2058,807,115,7560,353,661,5145,6409,ITF,ITF4,16,Puglia,Puglia,4029053,217187,5.39,0.29
1175,2021-01-14,PUG,4056,1582,2474,3161,394,499,0,0,2,4056,0,ITF,ITF4,16,Puglia,Puglia,4029053,221243,5.49,0.1
1176,2021-03-18,PUG,8675,3912,4763,1726,508,174,6147,30,90,2955,5720,ITF,ITF4,16,Puglia,Puglia,4029053,229918,5.71,0.22
1177,2021-02-13,PUG,3719,1451,2268,2880,519,291,4,18,7,3027,692,ITF,ITF4,16,Puglia,Puglia,4029053,233637,5.8,0.09
1178,2021-01-31,PUG,1805,825,980,1499,104,198,2,0,2,73,1732,ITF,ITF4,16,Puglia,Puglia,4029053,235442,5.84,0.04
1179,2020-12-31,PUG,1635,782,853,1549,39,44,0,0,3,1635,0,ITF,ITF4,16,Puglia,Puglia,4029053,237077,5.88,0.04
1180,2021-01-18,PUG,1844,770,1074,1182,216,446,0,0,0,1495,349,ITF,ITF4,16,Puglia,Puglia,4029053,238921,5.93,0.05
1181,2021-01-06,PUG,3943,1664,2279,3221,349,373,0,0,0,3943,0,ITF,ITF4,16,Puglia,Puglia,4029053,242864,6.03,0.1
1182,2021-03-13,PUG,9929,3907,6022,2150,421,128,3773,220,3237,8206,1723,ITF,ITF4,16,Puglia,Puglia,4029053,252793,6.27,0.25
1183,2021-01-19,PUG,1221,452,769,527,117,577,0,0,0,1211,10,ITF,ITF4,16,Puglia,Puglia,4029053,254014,6.3,0.03
1184,2021-03-17,PUG,9926,4563,5363,1745,582,61,7440,33,65,3996,5930,ITF,ITF4,16,Puglia,Puglia,4029053,263940,6.55,0.25
1185,2021-03-02,PUG,16195,6011,10184,1389,1055,111,4269,1246,8125,14892,1303,ITF,ITF4,16,Puglia,Puglia,4029053,280135,6.95,0.4
1186,2021-01-04,PUG,4503,2012,2491,4371,120,11,0,0,1,4503,0,ITF,ITF4,16,Puglia,Puglia,4029053,284638,7.06,0.11
1187,2021-01-12,PUG,4202,1765,2437,3628,350,218,1,0,5,4202,0,ITF,ITF4,16,Puglia,Puglia,4029053,288840,7.17,0.1
1188,2021-01-01,PUG,146,60,86,145,1,0,0,0,0,146,0,ITF,ITF4,16,Puglia,Puglia,4029053,288986,7.17,0.0
1189,2021-03-04,PUG,14816,5763,9053,1540,896,322,4558,1229,6271,13439,1377,ITF,ITF4,16,Puglia,Puglia,4029053,303802,7.54,0.37
1190,2021-03-06,PUG,15329,5718,9611,2112,775,70,5031,479,6862,13364,1965,ITF,ITF4,16,Puglia,Puglia,4029053,319131,7.92,0.38
1191,2021-01-08,PUG,5573,2337,3236,4844,401,325,0,0,3,5573,0,ITF,ITF4,16,Puglia,Puglia,4029053,324704,8.06,0.14
1192,2021-03-01,PUG,14809,5768,9041,1958,918,84,6005,819,5025,13442,1367,ITF,ITF4,16,Puglia,Puglia,4029053,339513,8.43,0.37
1193,2021-02-09,PUG,3834,1567,2267,2533,667,621,8,0,5,2162,1672,ITF,ITF4,16,Puglia,Puglia,4029053,343347,8.52,0.1
1194,2021-01-28,PUG,5464,2271,3193,4759,376,327,0,0,2,474,4990,ITF,ITF4,16,Puglia,Puglia,4029053,348811,8.66,0.14
1195,2021-02-03,PUG,5027,1999,3028,4362,478,184,0,0,3,728,4299,ITF,ITF4,16,Puglia,Puglia,4029053,353838,8.78,0.12
1196,2021-02-26,PUG,13428,4894,8534,2087,834,295,4998,600,4614,12410,1018,ITF,ITF4,16,Puglia,Puglia,4029053,367266,9.12,0.33
1197,2021-01-23,PUG,3036,1291,1745,2522,206,307,0,0,1,885,2151,ITF,ITF4,16,Puglia,Puglia,4029053,370302,9.19,0.08
1198,2021-02-17,PUG,4263,1742,2521,2453,1210,598,1,0,1,3666,597,ITF,ITF4,16,Puglia,Puglia,4029053,374565,9.3,0.11
1199,2021-02-28,PUG,5727,1757,3970,556,261,25,1484,194,3207,5541,186,ITF,ITF4,16,Puglia,Puglia,4029053,380292,9.44,0.14
1200,2021-02-08,PUG,3963,1595,2368,2933,614,389,1,25,1,1573,2390,ITF,ITF4,16,Puglia,Puglia,4029053,384255,9.54,0.1
1201,2021-02-22,PUG,9574,4513,5061,1413,728,139,6761,215,318,9244,330,ITF,ITF4,16,Puglia,Puglia,4029053,393829,9.77,0.24
1202,2021-01-20,PUG,1550,543,1007,783,165,602,0,0,0,1542,8,ITF,ITF4,16,Puglia,Puglia,4029053,395379,9.81,0.04
1203,2021-01-02,PUG,2945,1297,1648,2826,92,23,0,0,4,2945,0,ITF,ITF4,16,Puglia,Puglia,4029053,398324,9.89,0.07
1204,2021-02-21,PUG,2169,470,1699,535,85,49,32,12,1456,2108,61,ITF,ITF4,16,Puglia,Puglia,4029053,400493,9.94,0.05
1205,2021-01-11,PUG,3749,1587,2162,3212,357,175,0,3,2,3749,0,ITF,ITF4,16,Puglia,Puglia,4029053,404242,10.03,0.09
1206,2021-01-16,PUG,2502,1033,1469,1680,306,515,0,0,1,2502,0,ITF,ITF4,16,Puglia,Puglia,4029053,406744,10.1,0.06
1207,2021-02-02,PUG,4330,1837,2493,3621,389,317,0,0,3,591,3739,ITF,ITF4,16,Puglia,Puglia,4029053,411074,10.2,0.11
1208,2021-03-14,PUG,3241,1396,1845,952,203,73,973,42,998,2486,755,ITF,ITF4,16,Puglia,Puglia,4029053,414315,10.28,0.08
1209,2021-02-16,PUG,3378,1450,1928,2133,810,413,4,16,2,2733,645,ITF,ITF4,16,Puglia,Puglia,4029053,417693,10.37,0.08
1210,2021-01-15,PUG,4545,1860,2685,3592,388,558,0,3,4,4545,0,ITF,ITF4,16,Puglia,Puglia,4029053,422238,10.48,0.11
1211,2021-03-11,PUG,13989,6019,7970,2861,1177,478,5002,797,3674,10953,3036,ITF,ITF4,16,Puglia,Puglia,4029053,436227,10.83,0.35
1212,2021-02-11,PUG,3693,1401,2292,2568,400,723,0,0,2,2417,1276,ITF,ITF4,16,Puglia,Puglia,4029053,439920,10.92,0.09
1213,2021-01-25,PUG,3820,1676,2144,3470,179,168,2,0,1,423,3397,ITF,ITF4,16,Puglia,Puglia,4029053,443740,11.01,0.09
1214,2021-03-09,PUG,12550,5522,7028,1767,861,197,5337,1007,3381,10557,1993,ITF,ITF4,16,Puglia,Puglia,4029053,456290,11.32,0.31
1215,2021-03-10,PUG,14191,6151,8040,2554,1242,355,6363,601,3076,11081,3110,ITF,ITF4,16,Puglia,Puglia,4029053,470481,11.68,0.35
1216,2021-01-26,PUG,5361,2398,2963,4847,281,232,1,0,0,574,4787,ITF,ITF4,16,Puglia,Puglia,4029053,475842,11.81,0.13
1217,2021-01-03,PUG,2005,942,1063,1815,44,145,0,0,1,2005,0,ITF,ITF4,16,Puglia,Puglia,4029053,477847,11.86,0.05
1218,2021-02-14,PUG,784,348,436,681,32,70,0,0,1,662,122,ITF,ITF4,16,Puglia,Puglia,4029053,478631,11.88,0.02
1219,2021-02-25,PUG,11621,4955,6666,1719,873,419,5610,725,2275,10471,1150,ITF,ITF4,16,Puglia,Puglia,4029053,490252,12.17,0.29
1220,2021-03-16,PUG,9540,4547,4993,2161,820,76,6384,62,37,3216,6324,ITF,ITF4,16,Puglia,Puglia,4029053,499792,12.4,0.24
1221,2021-03-04,PIE,14421,5715,8706,2168,1961,582,7521,0,2189,11509,2912,ITC,ITC1,1,Piemonte,Piemonte,4356406,14421,0.33,0.33
1222,2021-01-24,PIE,3150,957,2193,2632,372,146,0,0,0,434,2716,ITC,ITC1,1,Piemonte,Piemonte,4356406,17571,0.4,0.07
1223,2021-02-08,PIE,6914,2355,4559,3782,1558,1574,0,0,0,666,6248,ITC,ITC1,1,Piemonte,Piemonte,4356406,24485,0.56,0.16
1224,2021-02-22,PIE,8460,3462,4998,1695,1439,518,3888,0,920,7871,589,ITC,ITC1,1,Piemonte,Piemonte,4356406,32945,0.76,0.19
1225,2021-02-27,PIE,12657,4840,7817,881,981,232,7529,0,3034,12309,348,ITC,ITC1,1,Piemonte,Piemonte,4356406,45602,1.05,0.29
1226,2021-03-20,PIE,11147,4576,6571,783,1033,34,7366,0,1931,5513,5634,ITC,ITC1,1,Piemonte,Piemonte,4356406,56749,1.3,0.26
1227,2021-03-09,PIE,13534,5266,8268,1679,1571,354,7615,0,2315,11187,2347,ITC,ITC1,1,Piemonte,Piemonte,4356406,70283,1.61,0.31
1228,2021-02-01,PIE,8641,3053,5588,6164,1403,1074,0,0,0,578,8063,ITC,ITC1,1,Piemonte,Piemonte,4356406,78924,1.81,0.2
1229,2021-02-19,PIE,5526,2171,3355,1987,1765,666,30,0,1078,5024,502,ITC,ITC1,1,Piemonte,Piemonte,4356406,84450,1.94,0.13
1230,2021-02-05,PIE,9449,3077,6372,5764,2041,1644,0,0,0,657,8792,ITC,ITC1,1,Piemonte,Piemonte,4356406,93899,2.16,0.22
1231,2021-01-19,PIE,6421,2099,4322,3574,1299,1548,0,0,0,6412,9,ITC,ITC1,1,Piemonte,Piemonte,4356406,100320,2.3,0.15
1232,2021-01-29,PIE,5939,1886,4053,4198,1069,672,0,0,0,455,5484,ITC,ITC1,1,Piemonte,Piemonte,4356406,106259,2.44,0.14
1233,2021-02-17,PIE,4730,2124,2606,2187,2044,497,1,0,1,3741,989,ITC,ITC1,1,Piemonte,Piemonte,4356406,110989,2.55,0.11
1234,2021-03-08,PIE,13716,5219,8497,2024,1415,366,7394,0,2517,11078,2638,ITC,ITC1,1,Piemonte,Piemonte,4356406,124705,2.86,0.31
1235,2021-03-01,PIE,11696,4678,7018,1141,1277,281,6594,0,2403,10884,812,ITC,ITC1,1,Piemonte,Piemonte,4356406,136401,3.13,0.27
1236,2021-02-16,PIE,3961,1752,2209,1819,1593,548,0,0,1,3203,758,ITC,ITC1,1,Piemonte,Piemonte,4356406,140362,3.22,0.09
1237,2021-02-14,PIE,1475,498,977,796,380,285,0,0,14,875,600,ITC,ITC1,1,Piemonte,Piemonte,4356406,141837,3.26,0.03
1238,2021-01-09,PIE,6183,2185,3998,4488,1127,568,0,0,0,6183,0,ITC,ITC1,1,Piemonte,Piemonte,4356406,148020,3.4,0.14
1239,2021-02-24,PIE,11382,4617,6765,1843,1314,407,5660,0,2158,10871,511,ITC,ITC1,1,Piemonte,Piemonte,4356406,159402,3.66,0.26
1240,2021-01-13,PIE,10078,3222,6856,6484,2265,1329,0,0,0,10078,0,ITC,ITC1,1,Piemonte,Piemonte,4356406,169480,3.89,0.23
1241,2020-12-28,PIE,1,1,0,1,0,0,0,0,0,1,0,ITC,ITC1,1,Piemonte,Piemonte,4356406,169481,3.89,0.0
1242,2021-02-21,PIE,5086,2080,3006,686,264,47,3352,0,737,4983,103,ITC,ITC1,1,Piemonte,Piemonte,4356406,174567,4.01,0.12
1243,2021-02-28,PIE,10801,4054,6747,641,511,53,6811,0,2785,10560,241,ITC,ITC1,1,Piemonte,Piemonte,4356406,185368,4.26,0.25
1244,2021-01-17,PIE,3517,1168,2349,2083,595,839,0,0,0,2870,647,ITC,ITC1,1,Piemonte,Piemonte,4356406,188885,4.34,0.08
1245,2021-01-26,PIE,6328,1878,4450,4725,875,728,0,0,0,735,5593,ITC,ITC1,1,Piemonte,Piemonte,4356406,195213,4.48,0.15
1246,2021-01-12,PIE,10040,3401,6639,6859,2009,1172,0,0,0,10040,0,ITC,ITC1,1,Piemonte,Piemonte,4356406,205253,4.71,0.23
1247,2021-01-10,PIE,5207,2273,2934,3904,784,519,0,0,0,5207,0,ITC,ITC1,1,Piemonte,Piemonte,4356406,210460,4.83,0.12
1248,2021-03-21,PIE,5114,2187,2927,292,512,0,3612,0,698,1529,3585,ITC,ITC1,1,Piemonte,Piemonte,4356406,215574,4.95,0.12
1249,2021-03-16,PIE,10264,4150,6114,2228,1094,320,6609,0,13,4208,6056,ITC,ITC1,1,Piemonte,Piemonte,4356406,225838,5.18,0.24
1250,2021-03-06,PIE,13954,5195,8759,2260,1120,456,7426,0,2692,11170,2784,ITC,ITC1,1,Piemonte,Piemonte,4356406,239792,5.5,0.32
1251,2020-12-27,PIE,912,368,544,760,76,76,0,0,0,912,0,ITC,ITC1,1,Piemonte,Piemonte,4356406,240704,5.53,0.02
1252,2021-01-22,PIE,3864,1248,2616,2279,650,935,0,0,0,2523,1341,ITC,ITC1,1,Piemonte,Piemonte,4356406,244568,5.61,0.09
1253,2021-01-16,PIE,7754,2630,5124,4794,1590,1370,0,0,0,7754,0,ITC,ITC1,1,Piemonte,Piemonte,4356406,252322,5.79,0.18
1254,2021-02-13,PIE,4150,1334,2816,2309,722,1113,1,0,5,2928,1222,ITC,ITC1,1,Piemonte,Piemonte,4356406,256472,5.89,0.1
1255,2021-01-18,PIE,6162,2047,4115,3233,1404,1525,0,0,0,5914,248,ITC,ITC1,1,Piemonte,Piemonte,4356406,262634,6.03,0.14
1256,2021-02-03,PIE,10185,3301,6884,6641,2309,1235,0,0,0,611,9574,ITC,ITC1,1,Piemonte,Piemonte,4356406,272819,6.26,0.23
1257,2021-02-12,PIE,6881,2212,4669,3524,1647,1708,0,0,2,3924,2957,ITC,ITC1,1,Piemonte,Piemonte,4356406,279700,6.42,0.16
1258,2021-01-04,PIE,5562,1678,3884,4590,737,235,0,0,0,5562,0,ITC,ITC1,1,Piemonte,Piemonte,4356406,285262,6.55,0.13
1259,2021-01-07,PIE,5385,1739,3646,4158,886,341,0,0,0,5385,0,ITC,ITC1,1,Piemonte,Piemonte,4356406,290647,6.67,0.12
1260,2021-02-20,PIE,3828,1251,2577,1100,1063,219,30,0,1416,3654,174,ITC,ITC1,1,Piemonte,Piemonte,4356406,294475,6.76,0.09
1261,2021-01-03,PIE,3061,966,2095,2714,295,52,0,0,0,3061,0,ITC,ITC1,1,Piemonte,Piemonte,4356406,297536,6.83,0.07
1262,2021-01-20,PIE,6538,2067,4471,3571,1153,1814,0,0,0,5813,725,ITC,ITC1,1,Piemonte,Piemonte,4356406,304074,6.98,0.15
1263,2021-03-11,PIE,13519,4967,8552,2308,1444,369,7307,0,2091,10437,3082,ITC,ITC1,1,Piemonte,Piemonte,4356406,317593,7.29,0.31
1264,2021-01-05,PIE,5377,1602,3775,4364,728,285,0,0,0,5377,0,ITC,ITC1,1,Piemonte,Piemonte,4356406,322970,7.41,0.12
1265,2021-02-09,PIE,7350,2309,5041,4153,1366,1831,0,0,0,722,6628,ITC,ITC1,1,Piemonte,Piemonte,4356406,330320,7.58,0.17
1266,2021-01-27,PIE,4196,1453,2743,2983,656,557,0,0,0,999,3197,ITC,ITC1,1,Piemonte,Piemonte,4356406,334516,7.68,0.1
1267,2021-01-06,PIE,3114,1110,2004,2368,433,313,0,0,0,3114,0,ITC,ITC1,1,Piemonte,Piemonte,4356406,337630,7.75,0.07
1268,2021-03-05,PIE,15246,5949,9297,2538,2018,654,7660,0,2376,11422,3824,ITC,ITC1,1,Piemonte,Piemonte,4356406,352876,8.1,0.35
1269,2021-03-18,PIE,11385,4674,6711,1435,958,331,8643,0,18,3737,7648,ITC,ITC1,1,Piemonte,Piemonte,4356406,364261,8.36,0.26
1270,2021-01-21,PIE,6876,2314,4562,4705,855,1316,0,0,0,3381,3495,ITC,ITC1,1,Piemonte,Piemonte,4356406,371137,8.52,0.16
1271,2021-02-23,PIE,9226,3708,5518,2294,1391,389,4100,0,1052,8645,581,ITC,ITC1,1,Piemonte,Piemonte,4356406,380363,8.73,0.21
1272,2021-02-26,PIE,12236,4910,7326,811,1449,487,6593,0,2896,11499,737,ITC,ITC1,1,Piemonte,Piemonte,4356406,392599,9.01,0.28
1273,2021-01-25,PIE,6209,1938,4271,4782,865,562,0,0,0,982,5227,ITC,ITC1,1,Piemonte,Piemonte,4356406,398808,9.15,0.14
1274,2021-03-07,PIE,11940,4643,7297,1321,1137,107,7326,0,2049,11061,879,ITC,ITC1,1,Piemonte,Piemonte,4356406,410748,9.43,0.27
1275,2021-01-14,PIE,9761,3150,6611,6175,2102,1484,0,0,0,9761,0,ITC,ITC1,1,Piemonte,Piemonte,4356406,420509,9.65,0.22
1276,2021-01-23,PIE,4219,1321,2898,3190,523,506,0,0,0,878,3341,ITC,ITC1,1,Piemonte,Piemonte,4356406,424728,9.75,0.1
1277,2021-02-15,PIE,4422,1592,2830,2318,1142,960,1,0,1,3217,1205,ITC,ITC1,1,Piemonte,Piemonte,4356406,429150,9.85,0.1
1278,2021-02-10,PIE,7445,2346,5099,3847,1498,2100,0,0,0,1316,6129,ITC,ITC1,1,Piemonte,Piemonte,4356406,436595,10.02,0.17
1279,2021-03-14,PIE,8180,3322,4858,794,617,2,5794,0,973,5286,2894,ITC,ITC1,1,Piemonte,Piemonte,4356406,444775,10.21,0.19
1280,2021-03-17,PIE,12195,4959,7236,2059,1048,202,8877,0,9,4969,7226,ITC,ITC1,1,Piemonte,Piemonte,4356406,456970,10.49,0.28
1281,2021-02-04,PIE,10196,3337,6859,6234,2199,1763,0,0,0,588,9608,ITC,ITC1,1,Piemonte,Piemonte,4356406,467166,10.72,0.23
1282,2021-01-31,PIE,4105,1748,2357,3076,654,375,0,0,0,112,3993,ITC,ITC1,1,Piemonte,Piemonte,4356406,471271,10.82,0.09
1283,2021-01-15,PIE,8961,2951,6010,5493,1924,1544,0,0,0,8961,0,ITC,ITC1,1,Piemonte,Piemonte,4356406,480232,11.02,0.21
1284,2021-02-25,PIE,12177,5226,6951,1436,2058,405,6320,0,1958,11629,548,ITC,ITC1,1,Piemonte,Piemonte,4356406,492409,11.3,0.28
1285,2021-01-28,PIE,5588,1809,3779,4118,879,590,1,0,0,384,5204,ITC,ITC1,1,Piemonte,Piemonte,4356406,497997,11.43,0.13
1286,2021-01-11,PIE,8740,2980,5760,6053,1561,1126,0,0,0,8740,0,ITC,ITC1,1,Piemonte,Piemonte,4356406,506737,11.63,0.2
1287,2021-02-02,PIE,10232,3504,6728,6866,2048,1318,0,0,0,814,9418,ITC,ITC1,1,Piemonte,Piemonte,4356406,516969,11.87,0.23
1288,2021-03-12,PIE,13719,5073,8646,2131,1330,454,7549,0,2255,10810,2909,ITC,ITC1,1,Piemonte,Piemonte,4356406,530688,12.18,0.31
1289,2021-03-10,PIE,13369,5059,8310,1660,1373,279,7916,0,2141,11076,2293,ITC,ITC1,1,Piemonte,Piemonte,4356406,544057,12.49,0.31
1290,2021-02-11,PIE,6761,2106,4655,3420,1327,2011,0,0,3,3004,3757,ITC,ITC1,1,Piemonte,Piemonte,4356406,550818,12.64,0.16
1291,2021-02-18,PIE,4780,2088,2692,2250,1904,624,0,0,2,4350,430,ITC,ITC1,1,Piemonte,Piemonte,4356406,555598,12.75,0.11
1292,2021-03-19,PIE,10466,4299,6167,1084,880,348,7884,0,270,4115,6351,ITC,ITC1,1,Piemonte,Piemonte,4356406,566064,12.99,0.24
1293,2020-12-30,PIE,730,322,408,685,45,0,0,0,0,730,0,ITC,ITC1,1,Piemonte,Piemonte,4356406,566794,13.01,0.02
1294,2021-01-08,PIE,5528,1761,3767,4078,1029,421,0,0,0,5528,0,ITC,ITC1,1,Piemonte,Piemonte,4356406,572322,13.14,0.13
1295,2020-12-31,PIE,3907,1332,2575,3413,360,134,0,0,0,3907,0,ITC,ITC1,1,Piemonte,Piemonte,4356406,576229,13.23,0.09
1296,2021-02-07,PIE,3087,974,2113,1649,662,776,0,0,0,445,2642,ITC,ITC1,1,Piemonte,Piemonte,4356406,579316,13.3,0.07
1297,2021-03-13,PIE,12763,4618,8145,1168,1013,157,8300,0,2125,11332,1431,ITC,ITC1,1,Piemonte,Piemonte,4356406,592079,13.59,0.29
1298,2021-03-02,PIE,11127,4471,6656,901,1130,214,6381,0,2501,10312,815,ITC,ITC1,1,Piemonte,Piemonte,4356406,603206,13.85,0.26
1299,2021-03-03,PIE,12053,4614,7439,1101,1025,258,7015,0,2654,11230,823,ITC,ITC1,1,Piemonte,Piemonte,4356406,615259,14.12,0.28
1300,2021-01-01,PIE,1038,395,643,922,116,0,0,0,0,1038,0,ITC,ITC1,1,Piemonte,Piemonte,4356406,616297,14.15,0.02
1301,2021-03-15,PIE,10489,4121,6368,1714,1502,225,5689,0,1359,4880,5609,ITC,ITC1,1,Piemonte,Piemonte,4356406,626786,14.39,0.24
1302,2021-01-02,PIE,3539,1134,2405,3072,414,53,0,0,0,3539,0,ITC,ITC1,1,Piemonte,Piemonte,4356406,630325,14.47,0.08
1303,2021-01-30,PIE,5978,2135,3843,4367,1116,495,0,0,0,218,5760,ITC,ITC1,1,Piemonte,Piemonte,4356406,636303,14.61,0.14
1304,2021-02-06,PIE,7982,2664,5318,5100,1627,1255,0,0,0,400,7582,ITC,ITC1,1,Piemonte,Piemonte,4356406,644285,14.79,0.18
1305,2021-02-10,VEN,4706,1568,3138,3104,857,744,0,0,1,3654,1052,ITH,ITH3,5,Veneto,Veneto,4905854,4706,0.1,0.1
1306,2021-01-16,VEN,4598,1539,3059,3193,756,649,0,0,0,4598,0,ITH,ITH3,5,Veneto,Veneto,4905854,9304,0.19,0.09
1307,2021-03-20,VEN,11367,4825,6542,564,4221,180,4707,49,1646,9276,2091,ITH,ITH3,5,Veneto,Veneto,4905854,20671,0.42,0.23
1308,2021-03-01,VEN,9358,3699,5659,2013,1138,923,2628,156,2500,7533,1825,ITH,ITH3,5,Veneto,Veneto,4905854,30029,0.61,0.19
1309,2021-03-15,VEN,16284,7017,9267,1346,2934,323,9301,433,1947,11092,5192,ITH,ITH3,5,Veneto,Veneto,4905854,46313,0.94,0.33
1310,2021-03-09,VEN,16171,7299,8872,1198,1910,668,8541,912,2942,10073,6098,ITH,ITH3,5,Veneto,Veneto,4905854,62484,1.27,0.33
1311,2021-01-02,VEN,5741,1765,3976,4797,396,544,2,0,2,5741,0,ITH,ITH3,5,Veneto,Veneto,4905854,68225,1.39,0.12
1312,2021-03-18,VEN,12254,4966,7288,1341,2113,343,7598,20,839,7106,5148,ITH,ITH3,5,Veneto,Veneto,4905854,80479,1.64,0.25
1313,2021-02-05,VEN,8362,2531,5831,4272,1912,2162,7,5,4,1425,6937,ITH,ITH3,5,Veneto,Veneto,4905854,88841,1.81,0.17
1314,2021-02-16,VEN,6629,2868,3761,718,387,478,5044,1,1,6452,177,ITH,ITH3,5,Veneto,Veneto,4905854,95470,1.95,0.14
1315,2021-01-22,VEN,1079,332,747,946,76,57,0,0,0,25,1054,ITH,ITH3,5,Veneto,Veneto,4905854,96549,1.97,0.02
1316,2021-02-17,VEN,6004,2764,3240,411,281,361,4946,5,0,5910,94,ITH,ITH3,5,Veneto,Veneto,4905854,102553,2.09,0.12
1317,2021-03-06,VEN,10501,4253,6248,2955,2715,1486,1973,46,1326,7307,3194,ITH,ITH3,5,Veneto,Veneto,4905854,113054,2.3,0.21
1318,2021-01-29,VEN,8996,2780,6216,6039,1517,1434,3,1,2,367,8629,ITH,ITH3,5,Veneto,Veneto,4905854,122050,2.49,0.18
1319,2021-01-26,VEN,6902,2081,4821,5338,595,963,0,1,5,155,6747,ITH,ITH3,5,Veneto,Veneto,4905854,128952,2.63,0.14
1320,2021-02-04,VEN,7313,2012,5301,3458,1459,2380,12,0,4,555,6758,ITH,ITH3,5,Veneto,Veneto,4905854,136265,2.78,0.15
1321,2021-03-10,VEN,18736,8503,10233,1407,2511,555,9051,1078,4134,13063,5673,ITH,ITH3,5,Veneto,Veneto,4905854,155001,3.16,0.38
1322,2021-02-28,VEN,4127,1382,2745,1702,1424,15,983,0,3,3290,837,ITH,ITH3,5,Veneto,Veneto,4905854,159128,3.24,0.08
1323,2021-02-11,VEN,4021,1244,2777,2613,596,800,9,1,2,3392,629,ITH,ITH3,5,Veneto,Veneto,4905854,163149,3.33,0.08
1324,2021-01-14,VEN,7060,1925,5135,3235,1333,2473,17,0,2,7060,0,ITH,ITH3,5,Veneto,Veneto,4905854,170209,3.47,0.14
1325,2021-02-24,VEN,8540,3655,4885,1522,640,506,5601,260,11,8058,482,ITH,ITH3,5,Veneto,Veneto,4905854,178749,3.64,0.17
1326,2021-03-19,VEN,13239,5448,7791,1588,2739,319,7859,42,692,7453,5786,ITH,ITH3,5,Veneto,Veneto,4905854,191988,3.91,0.27
1327,2021-01-05,VEN,7327,2183,5144,5410,789,1122,0,1,5,7327,0,ITH,ITH3,5,Veneto,Veneto,4905854,199315,4.06,0.15
1328,2021-01-20,VEN,1039,368,671,696,130,213,0,0,0,387,652,ITH,ITH3,5,Veneto,Veneto,4905854,200354,4.08,0.02
1329,2021-01-27,VEN,7140,2064,5076,5206,1047,879,0,0,8,246,6894,ITH,ITH3,5,Veneto,Veneto,4905854,207494,4.23,0.15
1330,2021-02-12,VEN,4325,1453,2872,2761,881,671,6,2,4,3753,572,ITH,ITH3,5,Veneto,Veneto,4905854,211819,4.32,0.09
1331,2021-01-25,VEN,6466,2074,4392,5060,499,904,1,0,2,170,6296,ITH,ITH3,5,Veneto,Veneto,4905854,218285,4.45,0.13
1332,2021-02-25,VEN,7852,3321,4531,1491,565,467,4946,109,274,7254,598,ITH,ITH3,5,Veneto,Veneto,4905854,226137,4.61,0.16
1333,2021-01-08,VEN,9397,2831,6566,5977,1603,1807,3,1,6,9397,0,ITH,ITH3,5,Veneto,Veneto,4905854,235534,4.8,0.19
1334,2021-03-16,VEN,12255,5254,7001,1216,2650,415,7854,17,103,6789,5466,ITH,ITH3,5,Veneto,Veneto,4905854,247789,5.05,0.25
1335,2021-01-13,VEN,5977,1600,4377,2792,1300,1880,3,0,2,5977,0,ITH,ITH3,5,Veneto,Veneto,4905854,253766,5.17,0.12
1336,2021-03-21,VEN,5586,2209,3377,670,1367,24,2560,1,964,3972,1614,ITH,ITH3,5,Veneto,Veneto,4905854,259352,5.29,0.11
1337,2021-03-11,VEN,19330,8579,10751,1547,3076,809,9310,964,3624,13846,5484,ITH,ITH3,5,Veneto,Veneto,4905854,278682,5.68,0.39
1338,2021-01-07,VEN,8359,2319,6040,5467,1087,1805,0,0,0,8359,0,ITH,ITH3,5,Veneto,Veneto,4905854,287041,5.85,0.17
1339,2021-02-26,VEN,8221,3243,4978,1676,1112,739,4381,31,282,6971,1250,ITH,ITH3,5,Veneto,Veneto,4905854,295262,6.02,0.17
1340,2021-02-09,VEN,5152,1871,3281,3095,870,1167,19,0,1,3422,1730,ITH,ITH3,5,Veneto,Veneto,4905854,300414,6.12,0.11
1341,2021-01-31,VEN,4740,1550,3190,3676,679,377,4,2,2,393,4347,ITH,ITH3,5,Veneto,Veneto,4905854,305154,6.22,0.1
1342,2021-01-09,VEN,7926,2537,5389,5174,1163,1573,3,11,2,7926,0,ITH,ITH3,5,Veneto,Veneto,4905854,313080,6.38,0.16
1343,2021-03-17,VEN,14393,5856,8537,1856,2687,218,8916,26,690,7715,6678,ITH,ITH3,5,Veneto,Veneto,4905854,327473,6.68,0.29
1344,2021-02-21,VEN,4624,1203,3421,495,9,18,417,2,3683,4619,5,ITH,ITH3,5,Veneto,Veneto,4905854,332097,6.77,0.09
1345,2021-03-14,VEN,14575,5631,8944,2173,4785,86,4135,129,3267,13762,813,ITH,ITH3,5,Veneto,Veneto,4905854,346672,7.07,0.3
1346,2021-03-03,VEN,11863,4496,7367,3310,1499,1110,3375,310,2259,8399,3464,ITH,ITH3,5,Veneto,Veneto,4905854,358535,7.31,0.24
1347,2021-01-21,VEN,2290,719,1571,1985,162,141,0,0,2,21,2269,ITH,ITH3,5,Veneto,Veneto,4905854,360825,7.35,0.05
1348,2021-02-23,VEN,7304,3214,4090,1007,493,213,5343,69,179,7046,258,ITH,ITH3,5,Veneto,Veneto,4905854,368129,7.5,0.15
1349,2021-02-13,VEN,3260,1472,1788,1558,665,1034,2,0,1,3246,14,ITH,ITH3,5,Veneto,Veneto,4905854,371389,7.57,0.07
1350,2021-01-24,VEN,4116,1219,2897,3752,138,222,1,0,3,28,4088,ITH,ITH3,5,Veneto,Veneto,4905854,375505,7.65,0.08
1351,2021-01-03,VEN,5158,1563,3595,4597,311,249,0,0,1,5158,0,ITH,ITH3,5,Veneto,Veneto,4905854,380663,7.76,0.11
1352,2021-02-03,VEN,5933,1659,4274,2851,1334,1743,1,0,4,482,5451,ITH,ITH3,5,Veneto,Veneto,4905854,386596,7.88,0.12
1353,2021-01-30,VEN,8730,2668,6062,6209,1285,1218,4,12,2,687,8043,ITH,ITH3,5,Veneto,Veneto,4905854,395326,8.06,0.18
1354,2021-02-07,VEN,2313,861,1452,1930,330,50,2,0,1,714,1599,ITH,ITH3,5,Veneto,Veneto,4905854,397639,8.11,0.05
1355,2020-12-30,VEN,699,245,454,598,62,39,0,0,0,699,0,ITH,ITH3,5,Veneto,Veneto,4905854,398338,8.12,0.01
1356,2021-01-04,VEN,6726,2029,4697,5238,569,913,1,0,5,6726,0,ITH,ITH3,5,Veneto,Veneto,4905854,405064,8.26,0.14
1357,2021-02-27,VEN,8959,2687,6272,2169,655,45,1960,12,4118,8127,832,ITH,ITH3,5,Veneto,Veneto,4905854,414023,8.44,0.18
1358,2021-03-04,VEN,12690,4694,7996,3100,1676,1349,3409,330,2826,9285,3405,ITH,ITH3,5,Veneto,Veneto,4905854,426713,8.7,0.26
1359,2021-01-18,VEN,2770,782,1988,1222,541,999,8,0,0,2571,199,ITH,ITH3,5,Veneto,Veneto,4905854,429483,8.75,0.06
1360,2020-12-31,VEN,3219,1043,2176,2700,265,252,0,0,2,3219,0,ITH,ITH3,5,Veneto,Veneto,4905854,432702,8.82,0.07
1361,2021-02-01,VEN,8517,2488,6029,4206,1953,2106,245,0,7,165,8352,ITH,ITH3,5,Veneto,Veneto,4905854,441219,8.99,0.17
1362,2021-01-19,VEN,1309,472,837,726,253,324,6,0,0,1160,149,ITH,ITH3,5,Veneto,Veneto,4905854,442528,9.02,0.03
1363,2021-03-12,VEN,18234,7933,10301,1914,3423,619,8051,755,3472,11562,6672,ITH,ITH3,5,Veneto,Veneto,4905854,460762,9.39,0.37
1364,2020-12-27,VEN,880,395,485,875,4,0,0,0,1,880,0,ITH,ITH3,5,Veneto,Veneto,4905854,461642,9.41,0.02
1365,2021-02-02,VEN,6402,1842,4560,2969,1285,1994,152,0,2,391,6011,ITH,ITH3,5,Veneto,Veneto,4905854,468044,9.54,0.13
1366,2021-02-06,VEN,4090,1351,2739,3023,697,367,3,0,0,709,3381,ITH,ITH3,5,Veneto,Veneto,4905854,472134,9.62,0.08
1367,2021-02-14,VEN,125,56,69,95,30,0,0,0,0,112,13,ITH,ITH3,5,Veneto,Veneto,4905854,472259,9.63,0.0
1368,2021-02-19,VEN,7292,3121,4171,1535,716,664,4368,3,6,7090,202,ITH,ITH3,5,Veneto,Veneto,4905854,479551,9.78,0.15
1369,2021-01-06,VEN,8129,2382,5747,6307,1003,807,1,2,9,8129,0,ITH,ITH3,5,Veneto,Veneto,4905854,487680,9.94,0.17
1370,2021-01-01,VEN,1525,470,1055,1494,30,1,0,0,0,1525,0,ITH,ITH3,5,Veneto,Veneto,4905854,489205,9.97,0.03
1371,2021-02-08,VEN,4964,1538,3426,2788,993,1169,12,0,2,1929,3035,ITH,ITH3,5,Veneto,Veneto,4905854,494169,10.07,0.1
1372,2021-01-28,VEN,9203,2661,6542,6458,1289,1448,5,0,3,175,9028,ITH,ITH3,5,Veneto,Veneto,4905854,503372,10.26,0.19
1373,2021-01-10,VEN,5020,1662,3358,3839,715,462,2,2,0,5020,0,ITH,ITH3,5,Veneto,Veneto,4905854,508392,10.36,0.1
1374,2021-02-22,VEN,6958,3016,3942,743,232,340,5402,1,240,6571,387,ITH,ITH3,5,Veneto,Veneto,4905854,515350,10.5,0.14
1375,2021-01-17,VEN,1932,780,1152,1587,220,120,3,0,2,1583,349,ITH,ITH3,5,Veneto,Veneto,4905854,517282,10.54,0.04
1376,2021-02-18,VEN,5700,2440,3260,934,353,607,3799,1,6,5637,63,ITH,ITH3,5,Veneto,Veneto,4905854,522982,10.66,0.12
1377,2021-03-05,VEN,13127,4889,8238,3430,1996,1384,3090,275,2952,9544,3583,ITH,ITH3,5,Veneto,Veneto,4905854,536109,10.93,0.27
1378,2021-03-08,VEN,13345,6046,7299,699,1188,383,7149,986,2940,9306,4039,ITH,ITH3,5,Veneto,Veneto,4905854,549454,11.2,0.27
1379,2021-01-11,VEN,7237,2100,5137,3499,1530,1956,247,0,5,7237,0,ITH,ITH3,5,Veneto,Veneto,4905854,556691,11.35,0.15
1380,2021-01-15,VEN,5863,1819,4044,2984,1299,1565,9,3,3,5863,0,ITH,ITH3,5,Veneto,Veneto,4905854,562554,11.47,0.12
1381,2021-02-15,VEN,4386,1820,2566,483,210,383,3294,14,2,4146,240,ITH,ITH3,5,Veneto,Veneto,4905854,566940,11.56,0.09
1382,2021-03-13,VEN,16805,6991,9814,2241,5366,75,4815,281,4027,13729,3076,ITH,ITH3,5,Veneto,Veneto,4905854,583745,11.9,0.34
1383,2021-02-20,VEN,6321,1985,4336,1798,204,100,971,6,3242,6317,4,ITH,ITH3,5,Veneto,Veneto,4905854,590066,12.03,0.13
1384,2021-01-12,VEN,5230,1516,3714,2251,1056,1752,168,0,3,5230,0,ITH,ITH3,5,Veneto,Veneto,4905854,595296,12.13,0.11
1385,2021-01-23,VEN,4063,1255,2808,3404,205,450,1,0,3,34,4029,ITH,ITH3,5,Veneto,Veneto,4905854,599359,12.22,0.08
1386,2021-03-07,VEN,4446,1739,2707,1692,927,17,983,0,827,3891,555,ITH,ITH3,5,Veneto,Veneto,4905854,603805,12.31,0.09
1387,2021-03-02,VEN,11318,4547,6771,2760,1847,1167,3285,411,1848,8043,3275,ITH,ITH3,5,Veneto,Veneto,4905854,615123,12.54,0.23
1388,2021-01-13,CAM,8019,3665,4354,4350,3082,587,0,0,0,8019,0,ITF,ITF3,15,Campania,Campania,5801692,8019,0.14,0.14
1389,2021-01-03,CAM,3837,2009,1828,3191,646,0,0,0,0,3837,0,ITF,ITF3,15,Campania,Campania,5801692,11856,0.2,0.07
1390,2021-03-04,CAM,14645,5345,9300,1788,5088,135,4198,1,3435,8752,5893,ITF,ITF3,15,Campania,Campania,5801692,26501,0.46,0.25
1391,2021-01-29,CAM,10052,4812,5240,6405,3388,259,0,0,0,47,10005,ITF,ITF3,15,Campania,Campania,5801692,36553,0.63,0.17
1392,2020-12-27,CAM,720,422,298,703,17,0,0,0,0,720,0,ITF,ITF3,15,Campania,Campania,5801692,37273,0.64,0.01
1393,2021-01-12,CAM,5214,2563,2651,3439,1435,340,0,0,0,5214,0,ITF,ITF3,15,Campania,Campania,5801692,42487,0.73,0.09
1394,2021-02-19,CAM,9556,3557,5999,1647,1128,161,4453,0,2167,8906,650,ITF,ITF3,15,Campania,Campania,5801692,52043,0.9,0.16
1395,2021-03-12,CAM,14234,7084,7150,979,4700,82,5285,1234,1954,8154,6080,ITF,ITF3,15,Campania,Campania,5801692,66277,1.14,0.25
1396,2021-01-18,CAM,957,399,558,576,194,187,0,0,0,713,244,ITF,ITF3,15,Campania,Campania,5801692,67234,1.16,0.02
1397,2021-03-13,CAM,14255,6792,7463,342,4234,193,5318,1195,2973,8970,5285,ITF,ITF3,15,Campania,Campania,5801692,81489,1.4,0.25
1398,2021-02-22,CAM,10613,3282,7331,512,2276,139,3867,0,3819,10351,262,ITF,ITF3,15,Campania,Campania,5801692,92102,1.59,0.18
1399,2021-01-16,CAM,3369,1675,1694,1355,1641,373,0,0,0,3369,0,ITF,ITF3,15,Campania,Campania,5801692,95471,1.65,0.06
1400,2021-01-06,CAM,7652,3749,3903,5781,1571,300,0,0,0,7652,0,ITF,ITF3,15,Campania,Campania,5801692,103123,1.78,0.13
1401,2021-03-16,CAM,8091,3522,4569,287,1817,60,5789,23,115,3777,4314,ITF,ITF3,15,Campania,Campania,5801692,111214,1.92,0.14
1402,2021-02-08,CAM,5113,2449,2664,1388,2121,226,1378,0,0,4311,802,ITF,ITF3,15,Campania,Campania,5801692,116327,2.01,0.09
1403,2021-02-16,CAM,5437,2410,3027,911,1183,169,3174,0,0,4666,771,ITF,ITF3,15,Campania,Campania,5801692,121764,2.1,0.09
1404,2021-01-25,CAM,5744,2926,2818,4743,945,56,0,0,0,164,5580,ITF,ITF3,15,Campania,Campania,5801692,127508,2.2,0.1
1405,2021-02-27,CAM,13941,4470,9471,597,3062,78,3146,0,7058,12299,1642,ITF,ITF3,15,Campania,Campania,5801692,141449,2.44,0.24
1406,2021-02-18,CAM,9078,3811,5267,1710,1342,70,5520,0,436,8370,708,ITF,ITF3,15,Campania,Campania,5801692,150527,2.59,0.16
1407,2021-02-17,CAM,7388,3210,4178,995,1085,38,4908,0,362,6328,1060,ITF,ITF3,15,Campania,Campania,5801692,157915,2.72,0.13
1408,2021-01-09,CAM,10566,5024,5542,6759,3538,269,0,0,0,10566,0,ITF,ITF3,15,Campania,Campania,5801692,168481,2.9,0.18
1409,2021-01-28,CAM,8832,4122,4710,6216,2269,347,0,0,0,135,8697,ITF,ITF3,15,Campania,Campania,5801692,177313,3.06,0.15
1410,2021-01-19,CAM,1095,474,621,534,390,171,0,0,0,1092,3,ITF,ITF3,15,Campania,Campania,5801692,178408,3.08,0.02
1411,2021-03-11,CAM,17523,8635,8888,1009,5223,105,7629,986,2571,10245,7278,ITF,ITF3,15,Campania,Campania,5801692,195931,3.38,0.3
1412,2021-02-02,CAM,5722,2804,2918,3640,1728,354,0,0,0,443,5279,ITF,ITF3,15,Campania,Campania,5801692,201653,3.48,0.1
1413,2021-02-13,CAM,5508,2549,2959,952,808,131,3615,0,2,5291,217,ITF,ITF3,15,Campania,Campania,5801692,207161,3.57,0.09
1414,2021-01-24,CAM,4128,2123,2005,3140,822,166,0,0,0,383,3745,ITF,ITF3,15,Campania,Campania,5801692,211289,3.64,0.07
1415,2021-03-02,CAM,12746,4550,8196,1266,4352,148,1938,2,5040,8402,4344,ITF,ITF3,15,Campania,Campania,5801692,224035,3.86,0.22
1416,2021-01-23,CAM,3839,2029,1810,3161,609,69,0,0,0,273,3566,ITF,ITF3,15,Campania,Campania,5801692,227874,3.93,0.07
1417,2021-03-17,CAM,11573,5092,6481,459,2063,49,8868,20,114,4997,6576,ITF,ITF3,15,Campania,Campania,5801692,239447,4.13,0.2
1418,2021-01-02,CAM,3674,1963,1711,3167,507,0,0,0,0,3674,0,ITF,ITF3,15,Campania,Campania,5801692,243121,4.19,0.06
1419,2021-01-20,CAM,1257,650,607,395,761,101,0,0,0,1257,0,ITF,ITF3,15,Campania,Campania,5801692,244378,4.21,0.02
1420,2021-01-27,CAM,7737,3820,3917,5837,1630,270,0,0,0,162,7575,ITF,ITF3,15,Campania,Campania,5801692,252115,4.35,0.13
1421,2021-03-09,CAM,13859,6628,7231,744,4620,217,3729,1118,3431,10078,3781,ITF,ITF3,15,Campania,Campania,5801692,265974,4.58,0.24
1422,2021-03-06,CAM,16296,6747,9549,957,4431,172,5827,1027,3882,10630,5666,ITF,ITF3,15,Campania,Campania,5801692,282270,4.87,0.28
1423,2021-03-21,CAM,3563,1645,1918,100,1189,11,1365,54,844,2138,1425,ITF,ITF3,15,Campania,Campania,5801692,285833,4.93,0.06
1424,2021-03-10,CAM,15226,7362,7864,638,3987,26,7285,1006,2284,8399,6827,ITF,ITF3,15,Campania,Campania,5801692,301059,5.19,0.26
1425,2021-03-08,CAM,14502,6703,7799,835,5195,36,4175,1334,2927,9727,4775,ITF,ITF3,15,Campania,Campania,5801692,315561,5.44,0.25
1426,2021-02-23,CAM,10988,3383,7605,514,2211,288,3688,0,4287,10462,526,ITF,ITF3,15,Campania,Campania,5801692,326549,5.63,0.19
1427,2021-01-08,CAM,10455,4969,5486,6714,3529,212,0,0,0,10455,0,ITF,ITF3,15,Campania,Campania,5801692,337004,5.81,0.18
1428,2021-01-01,CAM,919,506,413,831,88,0,0,0,0,919,0,ITF,ITF3,15,Campania,Campania,5801692,337923,5.82,0.02
1429,2021-02-11,CAM,6279,2705,3574,1861,1926,129,2363,0,0,6213,66,ITF,ITF3,15,Campania,Campania,5801692,344202,5.93,0.11
1430,2021-02-20,CAM,8565,3079,5486,1015,858,145,4582,0,1965,8262,303,ITF,ITF3,15,Campania,Campania,5801692,352767,6.08,0.15
1431,2021-02-06,CAM,5341,2665,2676,1990,2877,459,15,0,0,2103,3238,ITF,ITF3,15,Campania,Campania,5801692,358108,6.17,0.09
1432,2021-01-10,CAM,8165,3736,4429,5179,2889,97,0,0,0,8165,0,ITF,ITF3,15,Campania,Campania,5801692,366273,6.31,0.14
1433,2021-02-10,CAM,6904,3413,3491,1945,2703,98,2158,0,0,6728,176,ITF,ITF3,15,Campania,Campania,5801692,373177,6.43,0.12
1434,2021-03-14,CAM,8542,3734,4808,137,2215,36,3623,844,1687,4404,4138,ITF,ITF3,15,Campania,Campania,5801692,381719,6.58,0.15
1435,2021-02-14,CAM,3933,1926,2007,550,905,17,2461,0,0,3890,43,ITF,ITF3,15,Campania,Campania,5801692,385652,6.65,0.07
1436,2021-01-21,CAM,2093,1116,977,1379,639,75,0,0,0,677,1416,ITF,ITF3,15,Campania,Campania,5801692,387745,6.68,0.04
1437,2021-03-18,CAM,12156,5376,6780,444,2492,34,8658,74,454,5969,6187,ITF,ITF3,15,Campania,Campania,5801692,399901,6.89,0.21
1438,2021-01-26,CAM,7297,3701,3596,5742,1333,222,0,0,0,352,6945,ITF,ITF3,15,Campania,Campania,5801692,407198,7.02,0.13
1439,2021-01-11,CAM,4072,1871,2201,2386,1434,252,0,0,0,4072,0,ITF,ITF3,15,Campania,Campania,5801692,411270,7.09,0.07
1440,2021-01-14,CAM,7072,2976,4096,3706,3016,350,0,0,0,7072,0,ITF,ITF3,15,Campania,Campania,5801692,418342,7.21,0.12
1441,2021-02-25,CAM,12422,4479,7943,600,2672,124,4916,0,4110,11234,1188,ITF,ITF3,15,Campania,Campania,5801692,430764,7.42,0.21
1442,2021-03-01,CAM,12115,4241,7874,1095,3709,145,1720,0,5446,8004,4111,ITF,ITF3,15,Campania,Campania,5801692,442879,7.63,0.21
1443,2021-02-04,CAM,7943,3429,4514,3965,3685,292,1,0,0,1308,6635,ITF,ITF3,15,Campania,Campania,5801692,450822,7.77,0.14
1444,2021-02-05,CAM,7261,3463,3798,3447,3497,308,9,0,0,2133,5128,ITF,ITF3,15,Campania,Campania,5801692,458083,7.9,0.13
1445,2021-01-05,CAM,7237,3638,3599,5810,1321,106,0,0,0,7237,0,ITF,ITF3,15,Campania,Campania,5801692,465320,8.02,0.12
1446,2021-01-30,CAM,10721,5079,5642,6930,3564,227,0,0,0,39,10682,ITF,ITF3,15,Campania,Campania,5801692,476041,8.21,0.18
1447,2021-03-03,CAM,13921,5495,8426,2017,5280,158,3468,3,2995,7292,6629,ITF,ITF3,15,Campania,Campania,5801692,489962,8.45,0.24
1448,2021-01-22,CAM,1523,775,748,970,344,209,0,0,0,673,850,ITF,ITF3,15,Campania,Campania,5801692,491485,8.47,0.03
1449,2021-02-12,CAM,6555,2876,3679,1812,1467,214,3058,0,4,6343,212,ITF,ITF3,15,Campania,Campania,5801692,498040,8.58,0.11
1450,2021-03-20,CAM,13856,6413,7443,219,5173,35,6099,288,2042,10160,3696,ITF,ITF3,15,Campania,Campania,5801692,511896,8.82,0.24
1451,2021-02-15,CAM,5469,2515,2954,976,1002,94,3395,1,1,5296,173,ITF,ITF3,15,Campania,Campania,5801692,517365,8.92,0.09
1452,2021-02-09,CAM,4643,2202,2441,1148,2151,6,1338,0,0,4391,252,ITF,ITF3,15,Campania,Campania,5801692,522008,9.0,0.08
1453,2021-02-07,CAM,2936,1386,1550,712,1708,226,290,0,0,2158,778,ITF,ITF3,15,Campania,Campania,5801692,524944,9.05,0.05
1454,2020-12-31,CAM,1490,811,679,1273,216,1,0,0,0,1490,0,ITF,ITF3,15,Campania,Campania,5801692,526434,9.07,0.03
1455,2021-03-19,CAM,11014,4864,6150,263,3021,21,7226,28,455,7149,3865,ITF,ITF3,15,Campania,Campania,5801692,537448,9.26,0.19
1456,2021-02-24,CAM,11768,4143,7625,712,2311,145,5096,0,3504,11080,688,ITF,ITF3,15,Campania,Campania,5801692,549216,9.47,0.2
1457,2021-02-28,CAM,10400,3204,7196,485,3656,22,1943,0,4294,8501,1899,ITF,ITF3,15,Campania,Campania,5801692,559616,9.65,0.18
1458,2021-02-21,CAM,5834,2239,3595,780,653,22,3871,0,508,5609,225,ITF,ITF3,15,Campania,Campania,5801692,565450,9.75,0.1
1459,2021-01-17,CAM,1155,551,604,718,286,151,0,0,0,702,453,ITF,ITF3,15,Campania,Campania,5801692,566605,9.77,0.02
1460,2021-03-05,CAM,16471,6346,10125,1640,5427,64,5028,4,4308,9813,6658,ITF,ITF3,15,Campania,Campania,5801692,583076,10.05,0.28
1461,2021-02-26,CAM,13329,4230,9099,623,2381,223,3222,1,6879,11994,1335,ITF,ITF3,15,Campania,Campania,5801692,596405,10.28,0.23
1462,2021-01-07,CAM,8910,4166,4744,6313,2265,332,0,0,0,8910,0,ITF,ITF3,15,Campania,Campania,5801692,605315,10.43,0.15
1463,2021-01-31,CAM,8067,3711,4356,5107,2893,67,0,0,0,23,8044,ITF,ITF3,15,Campania,Campania,5801692,613382,10.57,0.14
1464,2021-02-01,CAM,3985,1813,2172,2504,1329,152,0,0,0,110,3875,ITF,ITF3,15,Campania,Campania,5801692,617367,10.64,0.07
1465,2021-03-07,CAM,11911,5344,6567,513,4258,85,3276,1512,2267,8070,3841,ITF,ITF3,15,Campania,Campania,5801692,629278,10.85,0.21
1466,2021-01-04,CAM,5826,2963,2863,4850,976,0,0,0,0,5826,0,ITF,ITF3,15,Campania,Campania,5801692,635104,10.95,0.1
1467,2021-01-15,CAM,4980,2381,2599,2740,2049,191,0,0,0,4980,0,ITF,ITF3,15,Campania,Campania,5801692,640084,11.03,0.09
1468,2021-03-15,CAM,13013,6124,6889,483,3821,85,5809,234,2581,8310,4703,ITF,ITF3,15,Campania,Campania,5801692,653097,11.26,0.22
1469,2021-02-03,CAM,8902,4002,4900,4735,3452,714,1,0,0,878,8024,ITF,ITF3,15,Campania,Campania,5801692,661999,11.41,0.15
1470,2021-02-18,VDA,349,153,196,61,41,45,180,14,8,261,88,ITC,ITC2,2,Valle d'Aosta / Vallée d'Aoste,Valle d'Aosta,125666,349,0.28,0.28
1471,2021-02-19,VDA,292,102,190,17,30,35,145,0,65,268,24,ITC,ITC2,2,Valle d'Aosta / Vallée d'Aoste,Valle d'Aosta,125666,641,0.51,0.23
1472,2021-01-28,VDA,290,123,167,197,85,6,2,0,0,56,234,ITC,ITC2,2,Valle d'Aosta / Vallée d'Aoste,Valle d'Aosta,125666,931,0.74,0.23
1473,2021-01-19,VDA,256,77,179,160,24,15,57,0,0,256,0,ITC,ITC2,2,Valle d'Aosta / Vallée d'Aoste,Valle d'Aosta,125666,1187,0.94,0.2
1474,2021-02-13,VDA,215,195,20,0,54,0,0,161,0,215,0,ITC,ITC2,2,Valle d'Aosta / Vallée d'Aoste,Valle d'Aosta,125666,1402,1.12,0.17
1475,2021-01-30,VDA,436,202,234,232,192,12,0,0,0,13,423,ITC,ITC2,2,Valle d'Aosta / Vallée d'Aoste,Valle d'Aosta,125666,1838,1.46,0.35
1476,2021-01-14,VDA,237,69,168,151,84,0,2,0,0,237,0,ITC,ITC2,2,Valle d'Aosta / Vallée d'Aoste,Valle d'Aosta,125666,2075,1.65,0.19
1477,2021-02-22,VDA,316,94,222,62,41,37,103,6,67,213,103,ITC,ITC2,2,Valle d'Aosta / Vallée d'Aoste,Valle d'Aosta,125666,2391,1.9,0.25
1478,2021-02-05,VDA,294,102,192,159,82,0,53,0,0,101,193,ITC,ITC2,2,Valle d'Aosta / Vallée d'Aoste,Valle d'Aosta,125666,2685,2.14,0.23
1479,2021-01-16,VDA,236,80,156,127,36,22,51,0,0,236,0,ITC,ITC2,2,Valle d'Aosta / Vallée d'Aoste,Valle d'Aosta,125666,2921,2.32,0.19
1480,2021-03-05,VDA,275,124,151,50,69,13,138,0,5,53,222,ITC,ITC2,2,Valle d'Aosta / Vallée d'Aoste,Valle d'Aosta,125666,3196,2.54,0.22
1481,2021-02-14,VDA,48,16,32,6,0,42,0,0,0,1,47,ITC,ITC2,2,Valle d'Aosta / Vallée d'Aoste,Valle d'Aosta,125666,3244,2.58,0.04
1482,2021-03-09,VDA,204,96,108,2,79,23,36,39,25,172,32,ITC,ITC2,2,Valle d'Aosta / Vallée d'Aoste,Valle d'Aosta,125666,3448,2.74,0.16
1483,2021-03-12,VDA,529,175,354,14,104,7,148,2,254,303,226,ITC,ITC2,2,Valle d'Aosta / Vallée d'Aoste,Valle d'Aosta,125666,3977,3.16,0.42
1484,2021-01-12,VDA,302,72,230,242,49,11,0,0,0,302,0,ITC,ITC2,2,Valle d'Aosta / Vallée d'Aoste,Valle d'Aosta,125666,4279,3.41,0.24
1485,2021-03-08,VDA,481,231,250,28,81,13,343,15,1,237,244,ITC,ITC2,2,Valle d'Aosta / Vallée d'Aoste,Valle d'Aosta,125666,4760,3.79,0.38
1486,2021-02-01,VDA,403,127,276,268,65,70,0,0,0,87,316,ITC,ITC2,2,Valle d'Aosta / Vallée d'Aoste,Valle d'Aosta,125666,5163,4.11,0.32
1487,2021-01-07,VDA,275,111,164,224,46,5,0,0,0,275,0,ITC,ITC2,2,Valle d'Aosta / Vallée d'Aoste,Valle d'Aosta,125666,5438,4.33,0.22
1488,2021-02-15,VDA,264,136,128,24,29,24,170,15,2,229,35,ITC,ITC2,2,Valle d'Aosta / Vallée d'Aoste,Valle d'Aosta,125666,5702,4.54,0.21
1489,2021-03-15,VDA,361,122,239,20,45,10,215,6,65,159,202,ITC,ITC2,2,Valle d'Aosta / Vallée d'Aoste,Valle d'Aosta,125666,6063,4.82,0.29
1490,2021-02-16,VDA,325,53,272,10,58,12,5,4,236,320,5,ITC,ITC2,2,Valle d'Aosta / Vallée d'Aoste,Valle d'Aosta,125666,6388,5.08,0.26
1491,2021-01-18,VDA,213,74,139,29,111,27,46,0,0,213,0,ITC,ITC2,2,Valle d'Aosta / Vallée d'Aoste,Valle d'Aosta,125666,6601,5.25,0.17
1492,2021-03-07,VDA,64,30,34,16,19,0,26,2,1,11,53,ITC,ITC2,2,Valle d'Aosta / Vallée d'Aoste,Valle d'Aosta,125666,6665,5.3,0.05
1493,2021-03-20,VDA,205,85,120,5,166,15,14,4,1,170,35,ITC,ITC2,2,Valle d'Aosta / Vallée d'Aoste,Valle d'Aosta,125666,6870,5.47,0.16
1494,2021-02-24,VDA,183,82,101,30,15,13,65,53,7,164,19,ITC,ITC2,2,Valle d'Aosta / Vallée d'Aoste,Valle d'Aosta,125666,7053,5.61,0.15
1495,2021-01-29,VDA,316,138,178,259,41,16,0,0,0,2,314,ITC,ITC2,2,Valle d'Aosta / Vallée d'Aoste,Valle d'Aosta,125666,7369,5.86,0.25
1496,2021-03-04,VDA,291,139,152,55,58,2,160,14,2,42,249,ITC,ITC2,2,Valle d'Aosta / Vallée d'Aoste,Valle d'Aosta,125666,7660,6.1,0.23
1497,2021-01-13,VDA,337,110,227,166,143,28,0,0,0,337,0,ITC,ITC2,2,Valle d'Aosta / Vallée d'Aoste,Valle d'Aosta,125666,7997,6.36,0.27
1498,2021-03-13,VDA,142,84,58,2,114,0,0,23,3,142,0,ITC,ITC2,2,Valle d'Aosta / Vallée d'Aoste,Valle d'Aosta,125666,8139,6.48,0.11
1499,2021-03-11,VDA,192,72,120,2,14,7,166,1,2,64,128,ITC,ITC2,2,Valle d'Aosta / Vallée d'Aoste,Valle d'Aosta,125666,8331,6.63,0.15
1500,2021-01-09,VDA,443,199,244,225,196,22,0,0,0,443,0,ITC,ITC2,2,Valle d'Aosta / Vallée d'Aoste,Valle d'Aosta,125666,8774,6.98,0.35
1501,2021-02-07,VDA,292,120,172,110,72,0,105,2,3,190,102,ITC,ITC2,2,Valle d'Aosta / Vallée d'Aoste,Valle d'Aosta,125666,9066,7.21,0.23
1502,2021-01-21,VDA,33,12,21,0,0,33,0,0,0,33,0,ITC,ITC2,2,Valle d'Aosta / Vallée d'Aoste,Valle d'Aosta,125666,9099,7.24,0.03
1503,2021-02-21,VDA,18,3,15,0,0,18,0,0,0,0,18,ITC,ITC2,2,Valle d'Aosta / Vallée d'Aoste,Valle d'Aosta,125666,9117,7.25,0.01
1504,2021-02-17,VDA,327,144,183,25,19,30,237,16,0,227,100,ITC,ITC2,2,Valle d'Aosta / Vallée d'Aoste,Valle d'Aosta,125666,9444,7.52,0.26
1505,2021-03-10,VDA,436,182,254,9,67,17,337,6,0,225,211,ITC,ITC2,2,Valle d'Aosta / Vallée d'Aoste,Valle d'Aosta,125666,9880,7.86,0.35
1506,2021-02-20,VDA,250,210,40,6,51,8,2,174,9,241,9,ITC,ITC2,2,Valle d'Aosta / Vallée d'Aoste,Valle d'Aosta,125666,10130,8.06,0.2
1507,2021-03-02,VDA,339,166,173,17,106,39,107,65,5,336,3,ITC,ITC2,2,Valle d'Aosta / Vallée d'Aoste,Valle d'Aosta,125666,10469,8.33,0.27
1508,2021-01-11,VDA,325,112,213,238,57,30,0,0,0,325,0,ITC,ITC2,2,Valle d'Aosta / Vallée d'Aoste,Valle d'Aosta,125666,10794,8.59,0.26
1509,2021-01-20,VDA,23,8,15,0,0,6,17,0,0,23,0,ITC,ITC2,2,Valle d'Aosta / Vallée d'Aoste,Valle d'Aosta,125666,10817,8.61,0.02
1510,2021-03-18,VDA,134,43,91,4,3,25,101,1,0,98,36,ITC,ITC2,2,Valle d'Aosta / Vallée d'Aoste,Valle d'Aosta,125666,10951,8.71,0.11
1511,2021-02-06,VDA,289,104,185,170,44,0,74,1,0,92,197,ITC,ITC2,2,Valle d'Aosta / Vallée d'Aoste,Valle d'Aosta,125666,11240,8.94,0.23
1512,2021-01-22,VDA,56,21,35,36,0,20,0,0,0,20,36,ITC,ITC2,2,Valle d'Aosta / Vallée d'Aoste,Valle d'Aosta,125666,11296,8.99,0.04
1513,2021-01-02,VDA,6,5,1,0,0,6,0,0,0,6,0,ITC,ITC2,2,Valle d'Aosta / Vallée d'Aoste,Valle d'Aosta,125666,11302,8.99,0.0
1514,2021-02-27,VDA,230,84,146,69,30,1,126,4,0,124,106,ITC,ITC2,2,Valle d'Aosta / Vallée d'Aoste,Valle d'Aosta,125666,11532,9.18,0.18
1515,2021-03-16,VDA,175,35,140,2,42,13,118,0,0,114,61,ITC,ITC2,2,Valle d'Aosta / Vallée d'Aoste,Valle d'Aosta,125666,11707,9.32,0.14
1516,2021-02-09,VDA,251,84,167,78,30,14,75,1,53,68,183,ITC,ITC2,2,Valle d'Aosta / Vallée d'Aoste,Valle d'Aosta,125666,11958,9.52,0.2
1517,2021-03-06,VDA,22,4,18,13,0,5,4,0,0,22,0,ITC,ITC2,2,Valle d'Aosta / Vallée d'Aoste,Valle d'Aosta,125666,11980,9.53,0.02
1518,2021-02-26,VDA,206,57,149,67,34,4,96,4,1,122,84,ITC,ITC2,2,Valle d'Aosta / Vallée d'Aoste,Valle d'Aosta,125666,12186,9.7,0.16
1519,2021-03-17,VDA,420,183,237,35,92,14,231,41,7,261,159,ITC,ITC2,2,Valle d'Aosta / Vallée d'Aoste,Valle d'Aosta,125666,12606,10.03,0.33
1520,2021-03-19,VDA,319,84,235,7,72,21,9,1,209,284,35,ITC,ITC2,2,Valle d'Aosta / Vallée d'Aoste,Valle d'Aosta,125666,12925,10.29,0.25
1521,2021-01-08,VDA,299,130,169,240,43,16,0,0,0,299,0,ITC,ITC2,2,Valle d'Aosta / Vallée d'Aoste,Valle d'Aosta,125666,13224,10.52,0.24
1522,2021-01-05,VDA,150,54,96,127,12,11,0,0,0,150,0,ITC,ITC2,2,Valle d'Aosta / Vallée d'Aoste,Valle d'Aosta,125666,13374,10.64,0.12
1523,2021-03-01,VDA,181,66,115,19,15,29,116,2,0,147,34,ITC,ITC2,2,Valle d'Aosta / Vallée d'Aoste,Valle d'Aosta,125666,13555,10.79,0.14
1524,2021-01-15,VDA,218,82,136,116,68,28,6,0,0,218,0,ITC,ITC2,2,Valle d'Aosta / Vallée d'Aoste,Valle d'Aosta,125666,13773,10.96,0.17
1525,2020-12-27,VDA,20,9,11,20,0,0,0,0,0,20,0,ITC,ITC2,2,Valle d'Aosta / Vallée d'Aoste,Valle d'Aosta,125666,13793,10.98,0.02
1526,2021-02-08,VDA,223,83,140,28,103,3,64,0,25,25,198,ITC,ITC2,2,Valle d'Aosta / Vallée d'Aoste,Valle d'Aosta,125666,14016,11.15,0.18
1527,2021-02-02,VDA,271,70,201,225,43,3,0,0,0,2,269,ITC,ITC2,2,Valle d'Aosta / Vallée d'Aoste,Valle d'Aosta,125666,14287,11.37,0.22
1528,2021-02-23,VDA,216,123,93,0,165,0,0,35,16,216,0,ITC,ITC2,2,Valle d'Aosta / Vallée d'Aoste,Valle d'Aosta,125666,14503,11.54,0.17
1529,2021-03-14,VDA,390,200,190,6,298,0,0,34,52,390,0,ITC,ITC2,2,Valle d'Aosta / Vallée d'Aoste,Valle d'Aosta,125666,14893,11.85,0.31
1530,2021-01-10,VDA,220,71,149,172,29,19,0,0,0,220,0,ITC,ITC2,2,Valle d'Aosta / Vallée d'Aoste,Valle d'Aosta,125666,15113,12.03,0.18
1531,2021-03-03,VDA,255,118,137,9,110,1,130,1,4,186,69,ITC,ITC2,2,Valle d'Aosta / Vallée d'Aoste,Valle d'Aosta,125666,15368,12.23,0.2
1532,2021-01-06,VDA,65,33,32,29,18,18,0,0,0,65,0,ITC,ITC2,2,Valle d'Aosta / Vallée d'Aoste,Valle d'Aosta,125666,15433,12.28,0.05
1533,2020-12-31,VDA,18,4,14,16,2,0,0,0,0,18,0,ITC,ITC2,2,Valle d'Aosta / Vallée d'Aoste,Valle d'Aosta,125666,15451,12.3,0.01
1534,2021-02-03,VDA,351,114,237,157,141,52,1,0,0,14,337,ITC,ITC2,2,Valle d'Aosta / Vallée d'Aoste,Valle d'Aosta,125666,15802,12.57,0.28
1535,2021-01-25,VDA,147,65,82,125,16,6,0,0,0,0,147,ITC,ITC2,2,Valle d'Aosta / Vallée d'Aoste,Valle d'Aosta,125666,15949,12.69,0.12
1536,2021-01-27,VDA,151,71,80,55,25,18,53,0,0,79,72,ITC,ITC2,2,Valle d'Aosta / Vallée d'Aoste,Valle d'Aosta,125666,16100,12.81,0.12
1537,2021-02-12,VDA,263,96,167,51,50,26,131,0,5,217,46,ITC,ITC2,2,Valle d'Aosta / Vallée d'Aoste,Valle d'Aosta,125666,16363,13.02,0.21
1538,2021-01-26,VDA,139,48,91,115,12,12,0,0,0,0,139,ITC,ITC2,2,Valle d'Aosta / Vallée d'Aoste,Valle d'Aosta,125666,16502,13.13,0.11
1539,2021-01-17,VDA,131,56,75,49,3,20,59,0,0,131,0,ITC,ITC2,2,Valle d'Aosta / Vallée d'Aoste,Valle d'Aosta,125666,16633,13.24,0.1
1540,2021-02-10,VDA,248,77,171,51,25,26,127,1,18,141,107,ITC,ITC2,2,Valle d'Aosta / Vallée d'Aoste,Valle d'Aosta,125666,16881,13.43,0.2
1541,2021-02-11,VDA,231,107,124,53,38,0,127,13,0,222,9,ITC,ITC2,2,Valle d'Aosta / Vallée d'Aoste,Valle d'Aosta,125666,17112,13.62,0.18
1542,2021-02-25,VDA,201,101,100,6,157,11,0,25,2,194,7,ITC,ITC2,2,Valle d'Aosta / Vallée d'Aoste,Valle d'Aosta,125666,17313,13.78,0.16
1543,2021-01-04,VDA,142,59,83,126,16,0,0,0,0,142,0,ITC,ITC2,2,Valle d'Aosta / Vallée d'Aoste,Valle d'Aosta,125666,17455,13.89,0.11
1544,2021-02-04,VDA,294,86,208,168,91,34,1,0,0,8,286,ITC,ITC2,2,Valle d'Aosta / Vallée d'Aoste,Valle d'Aosta,125666,17749,14.12,0.23
1545,2021-02-28,VDA,260,86,174,78,58,24,93,3,4,77,183,ITC,ITC2,2,Valle d'Aosta / Vallée d'Aoste,Valle d'Aosta,125666,18009,14.33,0.21
1546,2021-01-31,VDA,290,90,200,231,41,18,0,0,0,58,232,ITC,ITC2,2,Valle d'Aosta / Vallée d'Aoste,Valle d'Aosta,125666,18299,14.56,0.23
1547,2020-12-30,PAT,6,2,4,4,1,1,0,0,0,6,0,ITH,ITH2,4,Provincia Autonoma Trento,P.A. Trento,541380,6,0.0,0.0
1548,2021-02-05,PAT,802,271,531,467,22,66,247,0,0,283,519,ITH,ITH2,4,Provincia Autonoma Trento,P.A. Trento,541380,808,0.15,0.15
1549,2021-02-13,PAT,536,333,203,373,5,0,158,0,0,171,365,ITH,ITH2,4,Provincia Autonoma Trento,P.A. Trento,541380,1344,0.25,0.1
1550,2021-01-14,PAT,696,201,495,477,11,208,0,0,0,696,0,ITH,ITH2,4,Provincia Autonoma Trento,P.A. Trento,541380,2040,0.38,0.13
1551,2021-01-30,PAT,383,130,253,345,7,31,0,0,0,151,232,ITH,ITH2,4,Provincia Autonoma Trento,P.A. Trento,541380,2423,0.45,0.07
1552,2021-03-05,PAT,2180,686,1494,125,130,101,903,157,764,1582,598,ITH,ITH2,4,Provincia Autonoma Trento,P.A. Trento,541380,4603,0.85,0.4
1553,2021-03-15,PAT,1372,529,843,62,494,7,592,54,163,908,464,ITH,ITH2,4,Provincia Autonoma Trento,P.A. Trento,541380,5975,1.1,0.25
1554,2021-03-18,PAT,2217,916,1301,55,584,2,1573,2,1,1158,1059,ITH,ITH2,4,Provincia Autonoma Trento,P.A. Trento,541380,8192,1.51,0.41
1555,2021-02-12,PAT,1009,340,669,335,68,55,551,0,0,588,421,ITH,ITH2,4,Provincia Autonoma Trento,P.A. Trento,541380,9201,1.7,0.19
1556,2021-03-20,PAT,741,354,387,150,516,0,72,0,3,542,199,ITH,ITH2,4,Provincia Autonoma Trento,P.A. Trento,541380,9942,1.84,0.14
1557,2021-01-27,PAT,734,257,477,395,34,304,1,0,0,73,661,ITH,ITH2,4,Provincia Autonoma Trento,P.A. Trento,541380,10676,1.97,0.14
1558,2021-03-10,PAT,2334,903,1431,347,79,25,1375,221,287,1393,941,ITH,ITH2,4,Provincia Autonoma Trento,P.A. Trento,541380,13010,2.4,0.43
1559,2021-02-19,PAT,901,347,554,169,53,70,580,1,28,844,57,ITH,ITH2,4,Provincia Autonoma Trento,P.A. Trento,541380,13911,2.57,0.17
1560,2021-01-19,PAT,403,77,326,363,4,36,0,0,0,403,0,ITH,ITH2,4,Provincia Autonoma Trento,P.A. Trento,541380,14314,2.64,0.07
1561,2021-01-28,PAT,530,147,383,390,33,107,0,0,0,48,482,ITH,ITH2,4,Provincia Autonoma Trento,P.A. Trento,541380,14844,2.74,0.1
1562,2021-02-03,PAT,845,313,532,354,25,73,393,0,0,414,431,ITH,ITH2,4,Provincia Autonoma Trento,P.A. Trento,541380,15689,2.9,0.16
1563,2021-02-04,PAT,971,303,668,541,17,89,324,0,0,420,551,ITH,ITH2,4,Provincia Autonoma Trento,P.A. Trento,541380,16660,3.08,0.18
1564,2020-12-27,PAT,103,40,63,76,6,21,0,0,0,103,0,ITH,ITH2,4,Provincia Autonoma Trento,P.A. Trento,541380,16763,3.1,0.02
1565,2021-01-15,PAT,592,130,462,460,21,111,0,0,0,592,0,ITH,ITH2,4,Provincia Autonoma Trento,P.A. Trento,541380,17355,3.21,0.11
1566,2021-01-16,PAT,318,147,171,303,1,14,0,0,0,318,0,ITH,ITH2,4,Provincia Autonoma Trento,P.A. Trento,541380,17673,3.26,0.06
1567,2021-02-22,PAT,745,259,486,118,11,70,501,0,45,660,85,ITH,ITH2,4,Provincia Autonoma Trento,P.A. Trento,541380,18418,3.4,0.14
1568,2021-02-18,PAT,1196,422,774,300,30,35,773,3,55,1138,58,ITH,ITH2,4,Provincia Autonoma Trento,P.A. Trento,541380,19614,3.62,0.22
1569,2021-02-20,PAT,405,245,160,330,10,30,1,3,31,121,284,ITH,ITH2,4,Provincia Autonoma Trento,P.A. Trento,541380,20019,3.7,0.07
1570,2021-02-27,PAT,1021,454,567,444,28,0,434,4,111,598,423,ITH,ITH2,4,Provincia Autonoma Trento,P.A. Trento,541380,21040,3.89,0.19
1571,2021-02-01,PAT,1217,334,883,765,78,374,0,0,0,92,1125,ITH,ITH2,4,Provincia Autonoma Trento,P.A. Trento,541380,22257,4.11,0.22
1572,2021-03-12,PAT,2386,897,1489,205,345,85,1025,203,523,1606,780,ITH,ITH2,4,Provincia Autonoma Trento,P.A. Trento,541380,24643,4.55,0.44
1573,2021-01-07,PAT,1268,310,958,649,63,556,0,0,0,1268,0,ITH,ITH2,4,Provincia Autonoma Trento,P.A. Trento,541380,25911,4.79,0.23
1574,2021-03-03,PAT,1636,617,1019,71,32,58,1255,19,201,1078,558,ITH,ITH2,4,Provincia Autonoma Trento,P.A. Trento,541380,27547,5.09,0.3
1575,2021-01-13,PAT,420,123,297,391,6,23,0,0,0,420,0,ITH,ITH2,4,Provincia Autonoma Trento,P.A. Trento,541380,27967,5.17,0.08
1576,2021-02-24,PAT,1311,521,790,237,11,28,968,1,66,918,393,ITH,ITH2,4,Provincia Autonoma Trento,P.A. Trento,541380,29278,5.41,0.24
1577,2021-01-22,PAT,1628,422,1206,874,128,623,0,0,3,317,1311,ITH,ITH2,4,Provincia Autonoma Trento,P.A. Trento,541380,30906,5.71,0.3
1578,2021-03-08,PAT,1385,431,954,65,45,0,992,7,276,1025,360,ITH,ITH2,4,Provincia Autonoma Trento,P.A. Trento,541380,32291,5.96,0.26
1579,2021-02-16,PAT,663,244,419,73,14,3,563,0,10,658,5,ITH,ITH2,4,Provincia Autonoma Trento,P.A. Trento,541380,32954,6.09,0.12
1580,2021-01-09,PAT,184,40,144,139,14,31,0,0,0,184,0,ITH,ITH2,4,Provincia Autonoma Trento,P.A. Trento,541380,33138,6.12,0.03
1581,2021-01-21,PAT,349,93,256,318,15,16,0,0,0,227,122,ITH,ITH2,4,Provincia Autonoma Trento,P.A. Trento,541380,33487,6.19,0.06
1582,2021-03-04,PAT,2326,781,1545,160,81,23,1698,19,345,1478,848,ITH,ITH2,4,Provincia Autonoma Trento,P.A. Trento,541380,35813,6.62,0.43
1583,2021-01-24,PAT,545,274,271,533,12,0,0,0,0,223,322,ITH,ITH2,4,Provincia Autonoma Trento,P.A. Trento,541380,36358,6.72,0.1
1584,2021-03-21,PAT,61,41,20,5,56,0,0,0,0,60,1,ITH,ITH2,4,Provincia Autonoma Trento,P.A. Trento,541380,36419,6.73,0.01
1585,2021-01-29,PAT,1349,331,1018,722,86,541,0,0,0,54,1295,ITH,ITH2,4,Provincia Autonoma Trento,P.A. Trento,541380,37768,6.98,0.25
1586,2021-01-08,PAT,1442,312,1130,764,152,526,0,0,0,1442,0,ITH,ITH2,4,Provincia Autonoma Trento,P.A. Trento,541380,39210,7.24,0.27
1587,2021-03-01,PAT,1235,453,782,74,18,10,1035,3,95,937,298,ITH,ITH2,4,Provincia Autonoma Trento,P.A. Trento,541380,40445,7.47,0.23
1588,2021-02-23,PAT,1097,393,704,272,15,17,741,3,49,886,211,ITH,ITH2,4,Provincia Autonoma Trento,P.A. Trento,541380,41542,7.67,0.2
1589,2021-03-07,PAT,21,6,15,0,0,0,0,0,21,21,0,ITH,ITH2,4,Provincia Autonoma Trento,P.A. Trento,541380,41563,7.68,0.0
1590,2021-01-05,PAT,707,231,476,494,52,161,0,0,0,707,0,ITH,ITH2,4,Provincia Autonoma Trento,P.A. Trento,541380,42270,7.81,0.13
1591,2021-02-09,PAT,914,287,627,447,13,73,381,0,0,441,473,ITH,ITH2,4,Provincia Autonoma Trento,P.A. Trento,541380,43184,7.98,0.17
1592,2021-03-06,PAT,732,256,476,324,17,0,194,5,192,580,152,ITH,ITH2,4,Provincia Autonoma Trento,P.A. Trento,541380,43916,8.11,0.14
1593,2020-12-31,PAT,1598,440,1158,819,109,670,0,0,0,1598,0,ITH,ITH2,4,Provincia Autonoma Trento,P.A. Trento,541380,45514,8.41,0.3
1594,2021-01-18,PAT,640,154,486,527,40,73,0,0,0,586,54,ITH,ITH2,4,Provincia Autonoma Trento,P.A. Trento,541380,46154,8.53,0.12
1595,2021-01-23,PAT,570,330,240,480,2,88,0,0,0,384,186,ITH,ITH2,4,Provincia Autonoma Trento,P.A. Trento,541380,46724,8.63,0.11
1596,2021-02-26,PAT,1206,431,775,249,23,19,809,1,105,892,314,ITH,ITH2,4,Provincia Autonoma Trento,P.A. Trento,541380,47930,8.85,0.22
1597,2021-03-17,PAT,2032,781,1251,390,365,55,1216,1,5,1159,873,ITH,ITH2,4,Provincia Autonoma Trento,P.A. Trento,541380,49962,9.23,0.38
1598,2021-01-12,PAT,501,158,343,413,29,59,0,0,0,501,0,ITH,ITH2,4,Provincia Autonoma Trento,P.A. Trento,541380,50463,9.32,0.09
1599,2021-01-01,PAT,206,48,158,109,11,86,0,0,0,206,0,ITH,ITH2,4,Provincia Autonoma Trento,P.A. Trento,541380,50669,9.36,0.04
1600,2021-03-09,PAT,1526,571,955,95,66,28,1065,81,191,891,635,ITH,ITH2,4,Provincia Autonoma Trento,P.A. Trento,541380,52195,9.64,0.28
1601,2021-02-11,PAT,1130,364,766,331,16,48,735,0,0,796,334,ITH,ITH2,4,Provincia Autonoma Trento,P.A. Trento,541380,53325,9.85,0.21
1602,2021-01-06,PAT,42,13,29,42,0,0,0,0,0,42,0,ITH,ITH2,4,Provincia Autonoma Trento,P.A. Trento,541380,53367,9.86,0.01
1603,2021-02-15,PAT,531,186,345,145,28,27,320,0,11,417,114,ITH,ITH2,4,Provincia Autonoma Trento,P.A. Trento,541380,53898,9.96,0.1
1604,2021-03-02,PAT,1284,432,852,130,43,53,914,0,144,894,390,ITH,ITH2,4,Provincia Autonoma Trento,P.A. Trento,541380,55182,10.19,0.24
1605,2021-03-13,PAT,830,382,448,200,20,30,39,282,259,780,50,ITH,ITH2,4,Provincia Autonoma Trento,P.A. Trento,541380,56012,10.35,0.15
1606,2021-02-17,PAT,1108,424,684,324,27,35,707,3,12,1017,91,ITH,ITH2,4,Provincia Autonoma Trento,P.A. Trento,541380,57120,10.55,0.2
1607,2021-02-06,PAT,572,296,276,178,7,0,387,0,0,432,140,ITH,ITH2,4,Provincia Autonoma Trento,P.A. Trento,541380,57692,10.66,0.11
1608,2021-01-25,PAT,774,205,569,482,30,262,0,0,0,23,751,ITH,ITH2,4,Provincia Autonoma Trento,P.A. Trento,541380,58466,10.8,0.14
1609,2021-02-08,PAT,1149,318,831,550,59,237,302,0,1,341,808,ITH,ITH2,4,Provincia Autonoma Trento,P.A. Trento,541380,59615,11.01,0.21
1610,2021-03-11,PAT,2227,828,1399,98,164,41,1497,59,368,1369,858,ITH,ITH2,4,Provincia Autonoma Trento,P.A. Trento,541380,61842,11.42,0.41
1611,2021-01-31,PAT,74,15,59,55,13,6,0,0,0,0,74,ITH,ITH2,4,Provincia Autonoma Trento,P.A. Trento,541380,61916,11.44,0.01
1612,2021-02-10,PAT,849,289,560,310,9,51,479,0,0,509,340,ITH,ITH2,4,Provincia Autonoma Trento,P.A. Trento,541380,62765,11.59,0.16
1613,2021-01-10,PAT,84,19,65,53,19,12,0,0,0,84,0,ITH,ITH2,4,Provincia Autonoma Trento,P.A. Trento,541380,62849,11.61,0.02
1614,2021-03-14,PAT,107,65,42,102,0,0,0,0,5,20,87,ITH,ITH2,4,Provincia Autonoma Trento,P.A. Trento,541380,62956,11.63,0.02
1615,2021-02-02,PAT,889,237,652,507,47,171,164,0,0,190,699,ITH,ITH2,4,Provincia Autonoma Trento,P.A. Trento,541380,63845,11.79,0.16
1616,2021-01-20,PAT,288,71,217,229,11,48,0,0,0,276,12,ITH,ITH2,4,Provincia Autonoma Trento,P.A. Trento,541380,64133,11.85,0.05
1617,2021-01-02,PAT,498,142,356,334,25,139,0,0,0,498,0,ITH,ITH2,4,Provincia Autonoma Trento,P.A. Trento,541380,64631,11.94,0.09
1618,2021-01-11,PAT,724,220,504,516,58,150,0,0,0,724,0,ITH,ITH2,4,Provincia Autonoma Trento,P.A. Trento,541380,65355,12.07,0.13
1619,2021-02-21,PAT,155,92,63,154,0,0,0,0,1,43,112,ITH,ITH2,4,Provincia Autonoma Trento,P.A. Trento,541380,65510,12.1,0.03
1620,2021-01-17,PAT,251,195,56,251,0,0,0,0,0,251,0,ITH,ITH2,4,Provincia Autonoma Trento,P.A. Trento,541380,65761,12.15,0.05
1621,2021-03-19,PAT,2107,826,1281,231,968,0,892,2,14,1382,725,ITH,ITH2,4,Provincia Autonoma Trento,P.A. Trento,541380,67868,12.54,0.39
1622,2021-02-28,PAT,242,121,121,231,0,0,0,0,11,242,0,ITH,ITH2,4,Provincia Autonoma Trento,P.A. Trento,541380,68110,12.58,0.04
1623,2021-01-26,PAT,497,138,359,397,16,84,0,0,0,25,472,ITH,ITH2,4,Provincia Autonoma Trento,P.A. Trento,541380,68607,12.67,0.09
1624,2021-03-16,PAT,1350,496,854,221,81,36,1009,0,3,576,774,ITH,ITH2,4,Provincia Autonoma Trento,P.A. Trento,541380,69957,12.92,0.25
1625,2021-01-03,PAT,483,158,325,409,12,62,0,0,0,483,0,ITH,ITH2,4,Provincia Autonoma Trento,P.A. Trento,541380,70440,13.01,0.09
1626,2021-01-04,PAT,853,223,630,481,49,322,1,0,0,853,0,ITH,ITH2,4,Provincia Autonoma Trento,P.A. Trento,541380,71293,13.17,0.16
1627,2021-02-25,PAT,1584,620,964,120,16,32,1322,1,93,1159,425,ITH,ITH2,4,Provincia Autonoma Trento,P.A. Trento,541380,72877,13.46,0.29
1628,2021-02-14,PAT,246,186,60,246,0,0,0,0,0,11,235,ITH,ITH2,4,Provincia Autonoma Trento,P.A. Trento,541380,73123,13.51,0.05
1629,2021-01-21,SIC,1328,647,681,1001,190,137,0,0,0,499,829,ITG,ITG1,19,Sicilia,Sicilia,4999891,1328,0.03,0.03
1630,2021-02-26,SIC,12244,5976,6268,1836,1971,361,3890,1733,2453,10556,1688,ITG,ITG1,19,Sicilia,Sicilia,4999891,13572,0.27,0.24
1631,2021-01-17,SIC,1295,584,711,619,516,160,0,0,0,1245,50,ITG,ITG1,19,Sicilia,Sicilia,4999891,14867,0.3,0.03
1632,2020-12-29,SIC,235,146,89,235,0,0,0,0,0,235,0,ITG,ITG1,19,Sicilia,Sicilia,4999891,15102,0.3,0.0
1633,2020-12-30,SIC,173,101,72,156,17,0,0,0,0,173,0,ITG,ITG1,19,Sicilia,Sicilia,4999891,15275,0.31,0.0
1634,2021-03-15,SIC,10315,4515,5800,1237,2334,664,4830,213,1037,5244,5071,ITG,ITG1,19,Sicilia,Sicilia,4999891,25590,0.51,0.21
1635,2021-01-28,SIC,9328,4399,4929,7464,1569,295,0,0,0,414,8914,ITG,ITG1,19,Sicilia,Sicilia,4999891,34918,0.7,0.19
1636,2021-02-17,SIC,5428,3291,2137,1529,1126,880,8,1883,2,4755,673,ITG,ITG1,19,Sicilia,Sicilia,4999891,40346,0.81,0.11
1637,2021-03-16,SIC,10168,4462,5706,1662,1733,810,5677,68,218,4016,6152,ITG,ITG1,19,Sicilia,Sicilia,4999891,50514,1.01,0.2
1638,2021-03-11,SIC,14748,6224,8524,1604,4708,906,3931,473,3126,12176,2572,ITG,ITG1,19,Sicilia,Sicilia,4999891,65262,1.31,0.29
1639,2021-02-02,SIC,5537,2621,2916,3152,1956,429,0,0,0,633,4904,ITG,ITG1,19,Sicilia,Sicilia,4999891,70799,1.42,0.11
1640,2021-01-22,SIC,1235,625,610,1035,82,118,0,0,0,242,993,ITG,ITG1,19,Sicilia,Sicilia,4999891,72034,1.44,0.02
1641,2021-01-29,SIC,9360,4321,5039,7151,1904,305,0,0,0,432,8928,ITG,ITG1,19,Sicilia,Sicilia,4999891,81394,1.63,0.19
1642,2021-03-18,SIC,14120,7002,7118,1280,6806,597,5348,55,34,8411,5709,ITG,ITG1,19,Sicilia,Sicilia,4999891,95514,1.91,0.28
1643,2021-03-06,SIC,12845,5144,7701,2002,2000,758,3887,638,3560,9939,2906,ITG,ITG1,19,Sicilia,Sicilia,4999891,108359,2.17,0.26
1644,2021-02-09,SIC,4370,1831,2539,2240,1490,640,0,0,0,3364,1006,ITG,ITG1,19,Sicilia,Sicilia,4999891,112729,2.25,0.09
1645,2021-03-17,SIC,14024,6786,7238,1386,5923,664,5713,37,301,8082,5942,ITG,ITG1,19,Sicilia,Sicilia,4999891,126753,2.54,0.28
1646,2021-02-22,SIC,8035,4159,3876,1107,935,554,4065,1053,321,7544,491,ITG,ITG1,19,Sicilia,Sicilia,4999891,134788,2.7,0.16
1647,2021-02-05,SIC,7216,3232,3984,3618,2742,856,0,0,0,2132,5084,ITG,ITG1,19,Sicilia,Sicilia,4999891,142004,2.84,0.14
1648,2021-01-30,SIC,7837,3569,4268,5450,1912,475,0,0,0,175,7662,ITG,ITG1,19,Sicilia,Sicilia,4999891,149841,3.0,0.16
1649,2021-01-14,SIC,5250,2514,2736,3046,1945,259,0,0,0,5250,0,ITG,ITG1,19,Sicilia,Sicilia,4999891,155091,3.1,0.11
1650,2021-03-21,SIC,5664,2736,2928,174,2818,38,2464,18,152,3424,2240,ITG,ITG1,19,Sicilia,Sicilia,4999891,160755,3.22,0.11
1651,2021-01-24,SIC,4335,2262,2073,3990,342,3,0,0,0,148,4187,ITG,ITG1,19,Sicilia,Sicilia,4999891,165090,3.3,0.09
1652,2021-03-19,SIC,14975,7339,7636,1248,7356,561,5341,40,429,9253,5722,ITG,ITG1,19,Sicilia,Sicilia,4999891,180065,3.6,0.3
1653,2021-01-06,SIC,6471,3402,3069,5717,752,2,0,0,0,6471,0,ITG,ITG1,19,Sicilia,Sicilia,4999891,186536,3.73,0.13
1654,2021-03-01,SIC,12977,6129,6848,1557,1809,392,4302,1764,3153,11318,1659,ITG,ITG1,19,Sicilia,Sicilia,4999891,199513,3.99,0.26
1655,2021-02-07,SIC,2348,996,1352,1610,581,157,0,0,0,675,1673,ITG,ITG1,19,Sicilia,Sicilia,4999891,201861,4.04,0.05
1656,2021-03-02,SIC,14945,6384,8561,2380,1927,500,4467,1338,4333,12126,2819,ITG,ITG1,19,Sicilia,Sicilia,4999891,216806,4.34,0.3
1657,2021-01-10,SIC,3618,1615,2003,2126,1028,464,0,0,0,3618,0,ITG,ITG1,19,Sicilia,Sicilia,4999891,220424,4.41,0.07
1658,2021-01-11,SIC,5903,2590,3313,3923,1598,382,0,0,0,5903,0,ITG,ITG1,19,Sicilia,Sicilia,4999891,226327,4.53,0.12
1659,2020-12-28,SIC,207,124,83,205,2,0,0,0,0,207,0,ITG,ITG1,19,Sicilia,Sicilia,4999891,226534,4.53,0.0
1660,2021-01-15,SIC,5079,2233,2846,2824,1776,479,0,0,0,5079,0,ITG,ITG1,19,Sicilia,Sicilia,4999891,231613,4.63,0.1
1661,2021-03-07,SIC,9140,3417,5723,959,961,431,3350,216,3223,8060,1080,ITG,ITG1,19,Sicilia,Sicilia,4999891,240753,4.82,0.18
1662,2021-01-31,SIC,4111,1958,2153,2600,1216,295,0,0,0,113,3998,ITG,ITG1,19,Sicilia,Sicilia,4999891,244864,4.9,0.08
1663,2021-02-10,SIC,4433,1819,2614,1975,1717,741,0,0,0,4008,425,ITG,ITG1,19,Sicilia,Sicilia,4999891,249297,4.99,0.09
1664,2021-01-02,SIC,4872,2533,2339,4311,561,0,0,0,0,4872,0,ITG,ITG1,19,Sicilia,Sicilia,4999891,254169,5.08,0.1
1665,2021-02-14,SIC,1057,402,655,433,388,236,0,0,0,917,140,ITG,ITG1,19,Sicilia,Sicilia,4999891,255226,5.1,0.02
1666,2021-03-14,SIC,8242,3680,4562,565,2574,176,4263,34,630,4400,3842,ITG,ITG1,19,Sicilia,Sicilia,4999891,263468,5.27,0.16
1667,2021-02-12,SIC,4744,1852,2892,2299,1802,643,0,0,0,4413,331,ITG,ITG1,19,Sicilia,Sicilia,4999891,268212,5.36,0.09
1668,2021-01-27,SIC,7531,3835,3696,6329,1050,152,0,0,0,189,7342,ITG,ITG1,19,Sicilia,Sicilia,4999891,275743,5.51,0.15
1669,2021-02-15,SIC,3950,1861,2089,1699,1345,563,10,307,26,3381,569,ITG,ITG1,19,Sicilia,Sicilia,4999891,279693,5.59,0.08
1670,2021-02-19,SIC,5158,2757,2401,1485,1364,600,74,1396,239,4588,570,ITG,ITG1,19,Sicilia,Sicilia,4999891,284851,5.7,0.1
1671,2021-02-18,SIC,5494,3174,2320,1635,1244,813,9,1697,96,5063,431,ITG,ITG1,19,Sicilia,Sicilia,4999891,290345,5.81,0.11
1672,2021-02-28,SIC,7176,3071,4105,870,1311,93,3289,254,1359,6547,629,ITG,ITG1,19,Sicilia,Sicilia,4999891,297521,5.95,0.14
1673,2021-02-11,SIC,5332,2103,3229,2458,1984,890,0,0,0,4868,464,ITG,ITG1,19,Sicilia,Sicilia,4999891,302853,6.06,0.11
1674,2021-03-13,SIC,11739,5153,6586,1169,3658,493,4613,133,1673,7141,4598,ITG,ITG1,19,Sicilia,Sicilia,4999891,314592,6.29,0.23
1675,2021-01-03,SIC,4693,2454,2239,4361,332,0,0,0,0,4693,0,ITG,ITG1,19,Sicilia,Sicilia,4999891,319285,6.39,0.09
1676,2021-02-03,SIC,6100,2856,3244,3356,2120,624,0,0,0,756,5344,ITG,ITG1,19,Sicilia,Sicilia,4999891,325385,6.51,0.12
1677,2021-01-26,SIC,9515,4679,4836,8379,882,254,0,0,0,265,9250,ITG,ITG1,19,Sicilia,Sicilia,4999891,334900,6.7,0.19
1678,2021-02-06,SIC,5066,2225,2841,2535,1939,592,0,0,0,1488,3578,ITG,ITG1,19,Sicilia,Sicilia,4999891,339966,6.8,0.1
1679,2021-01-18,SIC,1548,646,902,721,619,208,0,0,0,1432,116,ITG,ITG1,19,Sicilia,Sicilia,4999891,341514,6.83,0.03
1680,2021-02-21,SIC,5174,2505,2669,377,650,174,3682,138,153,5068,106,ITG,ITG1,19,Sicilia,Sicilia,4999891,346688,6.93,0.1
1681,2021-02-04,SIC,6877,3159,3718,4417,1920,540,0,0,0,1460,5417,ITG,ITG1,19,Sicilia,Sicilia,4999891,353565,7.07,0.14
1682,2021-01-16,SIC,2776,1195,1581,1329,1149,298,0,0,0,2776,0,ITG,ITG1,19,Sicilia,Sicilia,4999891,356341,7.13,0.06
1683,2021-01-23,SIC,4149,2147,2002,3912,221,16,0,0,0,225,3924,ITG,ITG1,19,Sicilia,Sicilia,4999891,360490,7.21,0.08
1684,2021-01-13,SIC,5204,2462,2742,3033,1730,441,0,0,0,5204,0,ITG,ITG1,19,Sicilia,Sicilia,4999891,365694,7.31,0.1
1685,2021-03-04,SIC,15180,6545,8635,2811,2806,698,3927,1124,3814,10977,4203,ITG,ITG1,19,Sicilia,Sicilia,4999891,380874,7.62,0.3
1686,2021-03-05,SIC,15857,6832,9025,3190,2486,712,3998,1423,4048,11532,4325,ITG,ITG1,19,Sicilia,Sicilia,4999891,396731,7.93,0.32
1687,2021-02-23,SIC,8945,4687,4258,1265,1236,502,3996,1367,579,8456,489,ITG,ITG1,19,Sicilia,Sicilia,4999891,405676,8.11,0.18
1688,2021-02-24,SIC,9600,4869,4731,1423,1253,499,4028,1474,923,9004,596,ITG,ITG1,19,Sicilia,Sicilia,4999891,415276,8.31,0.19
1689,2021-02-13,SIC,3106,1167,1939,1295,1241,570,0,0,0,2849,257,ITG,ITG1,19,Sicilia,Sicilia,4999891,418382,8.37,0.06
1690,2021-03-09,SIC,13002,5466,7536,1593,2291,584,3943,937,3654,10629,2373,ITG,ITG1,19,Sicilia,Sicilia,4999891,431384,8.63,0.26
1691,2021-01-25,SIC,7511,3696,3815,6633,808,70,0,0,0,322,7189,ITG,ITG1,19,Sicilia,Sicilia,4999891,438895,8.78,0.15
1692,2021-03-20,SIC,17133,8220,8913,821,9284,413,5440,73,1102,11765,5368,ITG,ITG1,19,Sicilia,Sicilia,4999891,456028,9.12,0.34
1693,2021-01-20,SIC,808,410,398,422,194,192,0,0,0,573,235,ITG,ITG1,19,Sicilia,Sicilia,4999891,456836,9.14,0.02
1694,2021-02-08,SIC,4086,1759,2327,2346,1343,397,0,0,0,2128,1958,ITG,ITG1,19,Sicilia,Sicilia,4999891,460922,9.22,0.08
1695,2021-01-07,SIC,9173,4239,4934,7694,1269,210,0,0,0,9173,0,ITG,ITG1,19,Sicilia,Sicilia,4999891,470095,9.4,0.18
1696,2021-03-08,SIC,13414,5747,7667,2000,2104,626,3802,920,3962,10608,2806,ITG,ITG1,19,Sicilia,Sicilia,4999891,483509,9.67,0.27
1697,2021-02-16,SIC,4412,2298,2114,1463,1287,779,25,857,1,3945,467,ITG,ITG1,19,Sicilia,Sicilia,4999891,487921,9.76,0.09
1698,2021-02-25,SIC,10153,5275,4878,1770,1701,507,3980,1525,670,8974,1179,ITG,ITG1,19,Sicilia,Sicilia,4999891,498074,9.96,0.2
1699,2021-03-03,SIC,14652,6518,8134,2407,2325,507,4282,1325,3806,11569,3083,ITG,ITG1,19,Sicilia,Sicilia,4999891,512726,10.25,0.29
1700,2021-02-01,SIC,6077,2684,3393,4168,1591,318,0,0,0,304,5773,ITG,ITG1,19,Sicilia,Sicilia,4999891,518803,10.38,0.12
1701,2021-01-04,SIC,8373,4172,4201,7595,772,6,0,0,0,8373,0,ITG,ITG1,19,Sicilia,Sicilia,4999891,527176,10.54,0.17
1702,2021-01-09,SIC,7325,3424,3901,5034,1835,456,0,0,0,7325,0,ITG,ITG1,19,Sicilia,Sicilia,4999891,534501,10.69,0.15
1703,2021-01-19,SIC,1271,521,750,521,512,238,0,0,0,1093,178,ITG,ITG1,19,Sicilia,Sicilia,4999891,535772,10.72,0.03
1704,2021-01-12,SIC,4542,2234,2308,2863,1484,195,0,0,0,4542,0,ITG,ITG1,19,Sicilia,Sicilia,4999891,540314,10.81,0.09
1705,2021-01-05,SIC,10527,5159,5368,9074,1246,207,0,0,0,10527,0,ITG,ITG1,19,Sicilia,Sicilia,4999891,550841,11.02,0.21
1706,2020-12-31,SIC,877,469,408,827,50,0,0,0,0,877,0,ITG,ITG1,19,Sicilia,Sicilia,4999891,551718,11.03,0.02
1707,2021-01-08,SIC,8328,3864,4464,6591,1524,213,0,0,0,8328,0,ITG,ITG1,19,Sicilia,Sicilia,4999891,560046,11.2,0.17
1708,2021-02-20,SIC,7262,3732,3530,840,1332,546,3749,620,175,7011,251,ITG,ITG1,19,Sicilia,Sicilia,4999891,567308,11.35,0.15
1709,2021-03-10,SIC,13535,5773,7762,1477,2884,933,4060,646,3535,11145,2390,ITG,ITG1,19,Sicilia,Sicilia,4999891,580843,11.62,0.27
1710,2020-12-27,SIC,89,54,35,62,2,25,0,0,0,89,0,ITG,ITG1,19,Sicilia,Sicilia,4999891,580932,11.62,0.0
1711,2021-01-01,SIC,815,437,378,740,75,0,0,0,0,815,0,ITG,ITG1,19,Sicilia,Sicilia,4999891,581747,11.64,0.02
1712,2021-03-12,SIC,12614,5399,7215,1378,4173,695,3764,341,2263,10392,2222,ITG,ITG1,19,Sicilia,Sicilia,4999891,594361,11.89,0.25
1713,2021-02-27,SIC,12443,5568,6875,1515,2423,277,3838,1021,3369,11236,1207,ITG,ITG1,19,Sicilia,Sicilia,4999891,606804,12.14,0.25
