,data,area,Vaccinazioni giornaliere,sesso_maschile,sesso_femminile,prima_dose,seconda_dose,pregressa_infezione,codice_NUTS1,codice_NUTS2,codice_regione_ISTAT,nome_area,Regione,popolazione,Totale vaccinazioni,Totale vaccinazioni ogni cento ab,Vaccinazioni giornaliere ogni cento ab
0,2021-03-08,VDA,488,233,255,240,245,3,ITC,ITC2,2,Valle d'Aosta / Vallée d'Aoste,Valle d'Aosta,125666,488,0.39,0.39
1,2021-08-12,VDA,375,204,171,115,248,12,ITC,ITC2,2,Valle d'Aosta / Vallée d'Aoste,Valle d'Aosta,125666,863,0.69,0.3
2,2021-05-04,VDA,1136,511,625,435,674,27,ITC,ITC2,2,Valle d'Aosta / Vallée d'Aoste,Valle d'Aosta,125666,1999,1.59,0.9
3,2021-06-16,VDA,1064,565,499,666,394,4,ITC,ITC2,2,Valle d'Aosta / Vallée d'Aoste,Valle d'Aosta,125666,3063,2.44,0.85
4,2021-03-15,VDA,387,141,246,175,203,9,ITC,ITC2,2,Valle d'Aosta / Vallée d'Aoste,Valle d'Aosta,125666,3450,2.75,0.31
5,2021-08-19,VDA,265,158,107,70,180,15,ITC,ITC2,2,Valle d'Aosta / Vallée d'Aoste,Valle d'Aosta,125666,3715,2.96,0.21
6,2021-05-11,VDA,649,326,323,472,150,27,ITC,ITC2,2,Valle d'Aosta / Vallée d'Aoste,Valle d'Aosta,125666,4364,3.47,0.52
7,2021-04-27,VDA,979,424,555,653,292,34,ITC,ITC2,2,Valle d'Aosta / Vallée d'Aoste,Valle d'Aosta,125666,5343,4.25,0.78
8,2021-01-17,VDA,131,56,75,131,0,0,ITC,ITC2,2,Valle d'Aosta / Vallée d'Aoste,Valle d'Aosta,125666,5474,4.36,0.1
9,2021-07-12,VDA,979,483,496,238,733,8,ITC,ITC2,2,Valle d'Aosta / Vallée d'Aoste,Valle d'Aosta,125666,6453,5.14,0.78
10,2021-04-03,VDA,676,341,335,649,15,12,ITC,ITC2,2,Valle d'Aosta / Vallée d'Aoste,Valle d'Aosta,125666,7129,5.67,0.54
11,2021-03-20,VDA,209,87,122,168,36,5,ITC,ITC2,2,Valle d'Aosta / Vallée d'Aoste,Valle d'Aosta,125666,7338,5.84,0.17
12,2021-06-28,VDA,991,498,493,326,660,5,ITC,ITC2,2,Valle d'Aosta / Vallée d'Aoste,Valle d'Aosta,125666,8329,6.63,0.79
13,2021-06-11,VDA,1048,484,564,753,283,12,ITC,ITC2,2,Valle d'Aosta / Vallée d'Aoste,Valle d'Aosta,125666,9377,7.46,0.83
14,2021-01-27,VDA,156,75,81,80,76,0,ITC,ITC2,2,Valle d'Aosta / Vallée d'Aoste,Valle d'Aosta,125666,9533,7.59,0.12
15,2021-04-20,VDA,936,430,506,710,195,31,ITC,ITC2,2,Valle d'Aosta / Vallée d'Aoste,Valle d'Aosta,125666,10469,8.33,0.74
16,2021-01-10,VDA,220,71,149,212,0,8,ITC,ITC2,2,Valle d'Aosta / Vallée d'Aoste,Valle d'Aosta,125666,10689,8.51,0.18
17,2020-12-27,VDA,20,9,11,20,0,0,ITC,ITC2,2,Valle d'Aosta / Vallée d'Aoste,Valle d'Aosta,125666,10709,8.52,0.02
18,2021-09-02,VDA,520,271,249,89,416,15,ITC,ITC2,2,Valle d'Aosta / Vallée d'Aoste,Valle d'Aosta,125666,11229,8.94,0.41
19,2021-04-15,VDA,814,378,436,643,140,31,ITC,ITC2,2,Valle d'Aosta / Vallée d'Aoste,Valle d'Aosta,125666,12043,9.58,0.65
20,2021-07-07,VDA,794,441,353,414,363,17,ITC,ITC2,2,Valle d'Aosta / Vallée d'Aoste,Valle d'Aosta,125666,12837,10.22,0.63
21,2021-07-24,VDA,1019,536,483,329,682,8,ITC,ITC2,2,Valle d'Aosta / Vallée d'Aoste,Valle d'Aosta,125666,13856,11.03,0.81
22,2021-05-02,VDA,765,345,420,581,160,24,ITC,ITC2,2,Valle d'Aosta / Vallée d'Aoste,Valle d'Aosta,125666,14621,11.63,0.61
23,2021-01-22,VDA,58,22,36,22,36,0,ITC,ITC2,2,Valle d'Aosta / Vallée d'Aoste,Valle d'Aosta,125666,14679,11.68,0.05
24,2021-01-08,VDA,301,131,170,301,0,0,ITC,ITC2,2,Valle d'Aosta / Vallée d'Aoste,Valle d'Aosta,125666,14980,11.92,0.24
25,2021-03-06,VDA,22,4,18,18,0,4,ITC,ITC2,2,Valle d'Aosta / Vallée d'Aoste,Valle d'Aosta,125666,15002,11.94,0.02
26,2021-02-05,VDA,296,103,193,102,194,0,ITC,ITC2,2,Valle d'Aosta / Vallée d'Aoste,Valle d'Aosta,125666,15298,12.17,0.24
27,2021-02-22,VDA,317,94,223,211,104,2,ITC,ITC2,2,Valle d'Aosta / Vallée d'Aoste,Valle d'Aosta,125666,15615,12.43,0.25
28,2021-05-16,VDA,690,342,348,340,342,8,ITC,ITC2,2,Valle d'Aosta / Vallée d'Aoste,Valle d'Aosta,125666,16305,12.97,0.55
29,2021-08-07,VDA,739,433,306,304,421,14,ITC,ITC2,2,Valle d'Aosta / Vallée d'Aoste,Valle d'Aosta,125666,17044,13.56,0.59
30,2021-02-03,VDA,354,116,238,15,339,0,ITC,ITC2,2,Valle d'Aosta / Vallée d'Aoste,Valle d'Aosta,125666,17398,13.84,0.28
31,2021-04-01,VDA,778,394,384,747,12,19,ITC,ITC2,2,Valle d'Aosta / Vallée d'Aoste,Valle d'Aosta,125666,18176,14.46,0.62
32,2021-05-30,VDA,865,429,436,682,171,12,ITC,ITC2,2,Valle d'Aosta / Vallée d'Aoste,Valle d'Aosta,125666,19041,15.15,0.69
33,2021-07-26,VDA,1007,512,495,317,682,8,ITC,ITC2,2,Valle d'Aosta / Vallée d'Aoste,Valle d'Aosta,125666,20048,15.95,0.8
34,2021-09-07,VDA,407,211,196,61,343,3,ITC,ITC2,2,Valle d'Aosta / Vallée d'Aoste,Valle d'Aosta,125666,20455,16.28,0.32
35,2021-05-28,VDA,977,415,562,546,413,18,ITC,ITC2,2,Valle d'Aosta / Vallée d'Aoste,Valle d'Aosta,125666,21432,17.05,0.78
36,2021-02-17,VDA,329,146,183,225,101,3,ITC,ITC2,2,Valle d'Aosta / Vallée d'Aoste,Valle d'Aosta,125666,21761,17.32,0.26
37,2021-06-23,VDA,1044,551,493,422,617,5,ITC,ITC2,2,Valle d'Aosta / Vallée d'Aoste,Valle d'Aosta,125666,22805,18.15,0.83
38,2021-06-30,VDA,1120,543,577,416,695,9,ITC,ITC2,2,Valle d'Aosta / Vallée d'Aoste,Valle d'Aosta,125666,23925,19.04,0.89
39,2021-05-23,VDA,999,465,534,654,340,5,ITC,ITC2,2,Valle d'Aosta / Vallée d'Aoste,Valle d'Aosta,125666,24924,19.83,0.79
40,2021-01-29,VDA,321,139,182,2,319,0,ITC,ITC2,2,Valle d'Aosta / Vallée d'Aoste,Valle d'Aosta,125666,25245,20.09,0.26
41,2021-08-31,VDA,672,344,328,135,531,6,ITC,ITC2,2,Valle d'Aosta / Vallée d'Aoste,Valle d'Aosta,125666,25917,20.62,0.53
42,2021-04-22,VDA,1068,450,618,652,383,33,ITC,ITC2,2,Valle d'Aosta / Vallée d'Aoste,Valle d'Aosta,125666,26985,21.47,0.85
43,2021-05-09,VDA,574,287,287,425,130,19,ITC,ITC2,2,Valle d'Aosta / Vallée d'Aoste,Valle d'Aosta,125666,27559,21.93,0.46
44,2021-07-31,VDA,892,466,426,321,557,14,ITC,ITC2,2,Valle d'Aosta / Vallée d'Aoste,Valle d'Aosta,125666,28451,22.64,0.71
45,2021-06-09,VDA,1054,559,495,1011,35,8,ITC,ITC2,2,Valle d'Aosta / Vallée d'Aoste,Valle d'Aosta,125666,29505,23.48,0.84
46,2021-03-01,VDA,182,66,116,140,34,8,ITC,ITC2,2,Valle d'Aosta / Vallée d'Aoste,Valle d'Aosta,125666,29687,23.62,0.14
47,2021-02-15,VDA,264,136,128,226,35,3,ITC,ITC2,2,Valle d'Aosta / Vallée d'Aoste,Valle d'Aosta,125666,29951,23.83,0.21
48,2021-04-13,VDA,373,171,202,312,44,17,ITC,ITC2,2,Valle d'Aosta / Vallée d'Aoste,Valle d'Aosta,125666,30324,24.13,0.3
49,2021-07-05,VDA,836,357,479,313,510,13,ITC,ITC2,2,Valle d'Aosta / Vallée d'Aoste,Valle d'Aosta,125666,31160,24.8,0.67
50,2021-03-27,VDA,337,166,171,292,31,14,ITC,ITC2,2,Valle d'Aosta / Vallée d'Aoste,Valle d'Aosta,125666,31497,25.06,0.27
51,2021-06-18,VDA,1000,443,557,586,400,14,ITC,ITC2,2,Valle d'Aosta / Vallée d'Aoste,Valle d'Aosta,125666,32497,25.86,0.8
52,2021-06-04,VDA,910,385,525,468,435,7,ITC,ITC2,2,Valle d'Aosta / Vallée d'Aoste,Valle d'Aosta,125666,33407,26.58,0.72
53,2021-08-26,VDA,343,168,175,82,254,7,ITC,ITC2,2,Valle d'Aosta / Vallée d'Aoste,Valle d'Aosta,125666,33750,26.86,0.27
54,2021-07-23,VDA,974,485,489,358,608,8,ITC,ITC2,2,Valle d'Aosta / Vallée d'Aoste,Valle d'Aosta,125666,34724,27.63,0.78
55,2021-07-19,VDA,878,460,418,252,618,8,ITC,ITC2,2,Valle d'Aosta / Vallée d'Aoste,Valle d'Aosta,125666,35602,28.33,0.7
56,2021-02-24,VDA,185,84,101,163,21,1,ITC,ITC2,2,Valle d'Aosta / Vallée d'Aoste,Valle d'Aosta,125666,35787,28.48,0.15
57,2021-04-08,VDA,585,282,303,420,144,21,ITC,ITC2,2,Valle d'Aosta / Vallée d'Aoste,Valle d'Aosta,125666,36372,28.94,0.47
58,2021-02-10,VDA,248,77,171,141,107,0,ITC,ITC2,2,Valle d'Aosta / Vallée d'Aoste,Valle d'Aosta,125666,36620,29.14,0.2
59,2021-03-25,VDA,389,154,235,364,10,15,ITC,ITC2,2,Valle d'Aosta / Vallée d'Aoste,Valle d'Aosta,125666,37009,29.45,0.31
60,2021-05-21,VDA,933,443,490,523,401,9,ITC,ITC2,2,Valle d'Aosta / Vallée d'Aoste,Valle d'Aosta,125666,37942,30.19,0.74
61,2021-04-17,VDA,638,407,231,596,2,40,ITC,ITC2,2,Valle d'Aosta / Vallée d'Aoste,Valle d'Aosta,125666,38580,30.7,0.51
62,2021-01-07,VDA,280,113,167,280,0,0,ITC,ITC2,2,Valle d'Aosta / Vallée d'Aoste,Valle d'Aosta,125666,38860,30.92,0.22
63,2021-08-14,VDA,465,256,209,135,314,16,ITC,ITC2,2,Valle d'Aosta / Vallée d'Aoste,Valle d'Aosta,125666,39325,31.29,0.37
64,2021-03-13,VDA,147,88,59,141,0,6,ITC,ITC2,2,Valle d'Aosta / Vallée d'Aoste,Valle d'Aosta,125666,39472,31.41,0.12
65,2021-01-15,VDA,220,83,137,220,0,0,ITC,ITC2,2,Valle d'Aosta / Vallée d'Aoste,Valle d'Aosta,125666,39692,31.59,0.18
66,2021-08-30,VDA,546,275,271,115,393,38,ITC,ITC2,2,Valle d'Aosta / Vallée d'Aoste,Valle d'Aosta,125666,40238,32.02,0.43
67,2021-01-31,VDA,291,91,200,58,233,0,ITC,ITC2,2,Valle d'Aosta / Vallée d'Aoste,Valle d'Aosta,125666,40529,32.25,0.23
68,2021-09-04,VDA,513,271,242,131,368,14,ITC,ITC2,2,Valle d'Aosta / Vallée d'Aoste,Valle d'Aosta,125666,41042,32.66,0.41
69,2021-03-17,VDA,438,185,253,259,165,14,ITC,ITC2,2,Valle d'Aosta / Vallée d'Aoste,Valle d'Aosta,125666,41480,33.01,0.35
70,2021-03-03,VDA,258,119,139,182,71,5,ITC,ITC2,2,Valle d'Aosta / Vallée d'Aoste,Valle d'Aosta,125666,41738,33.21,0.21
71,2021-07-16,VDA,1078,555,523,343,731,4,ITC,ITC2,2,Valle d'Aosta / Vallée d'Aoste,Valle d'Aosta,125666,42816,34.07,0.86
72,2021-01-26,VDA,149,52,97,2,147,0,ITC,ITC2,2,Valle d'Aosta / Vallée d'Aoste,Valle d'Aosta,125666,42965,34.19,0.12
73,2021-02-12,VDA,263,96,167,216,46,1,ITC,ITC2,2,Valle d'Aosta / Vallée d'Aoste,Valle d'Aosta,125666,43228,34.4,0.21
74,2021-01-12,VDA,303,73,230,303,0,0,ITC,ITC2,2,Valle d'Aosta / Vallée d'Aoste,Valle d'Aosta,125666,43531,34.64,0.24
75,2021-09-01,VDA,800,428,372,188,586,26,ITC,ITC2,2,Valle d'Aosta / Vallée d'Aoste,Valle d'Aosta,125666,44331,35.28,0.64
76,2021-05-24,VDA,1139,518,621,677,447,15,ITC,ITC2,2,Valle d'Aosta / Vallée d'Aoste,Valle d'Aosta,125666,45470,36.18,0.91
77,2021-05-25,VDA,1117,532,585,530,575,12,ITC,ITC2,2,Valle d'Aosta / Vallée d'Aoste,Valle d'Aosta,125666,46587,37.07,0.89
78,2021-02-14,VDA,48,16,32,1,47,0,ITC,ITC2,2,Valle d'Aosta / Vallée d'Aoste,Valle d'Aosta,125666,46635,37.11,0.04
79,2021-05-08,VDA,908,543,365,500,382,26,ITC,ITC2,2,Valle d'Aosta / Vallée d'Aoste,Valle d'Aosta,125666,47543,37.83,0.72
80,2021-08-16,VDA,422,211,211,129,276,17,ITC,ITC2,2,Valle d'Aosta / Vallée d'Aoste,Valle d'Aosta,125666,47965,38.17,0.34
81,2021-04-05,VDA,465,223,242,445,6,14,ITC,ITC2,2,Valle d'Aosta / Vallée d'Aoste,Valle d'Aosta,125666,48430,38.54,0.37
82,2021-06-27,VDA,1254,609,645,311,931,12,ITC,ITC2,2,Valle d'Aosta / Vallée d'Aoste,Valle d'Aosta,125666,49684,39.54,1.0
83,2021-07-14,VDA,1021,534,487,291,728,2,ITC,ITC2,2,Valle d'Aosta / Vallée d'Aoste,Valle d'Aosta,125666,50705,40.35,0.81
84,2021-03-29,VDA,494,233,261,450,40,4,ITC,ITC2,2,Valle d'Aosta / Vallée d'Aoste,Valle d'Aosta,125666,51199,40.74,0.39
85,2021-06-20,VDA,1134,545,589,477,644,13,ITC,ITC2,2,Valle d'Aosta / Vallée d'Aoste,Valle d'Aosta,125666,52333,41.64,0.9
86,2021-03-12,VDA,535,177,358,301,226,8,ITC,ITC2,2,Valle d'Aosta / Vallée d'Aoste,Valle d'Aosta,125666,52868,42.07,0.43
87,2021-03-22,VDA,561,205,356,326,229,6,ITC,ITC2,2,Valle d'Aosta / Vallée d'Aoste,Valle d'Aosta,125666,53429,42.52,0.45
88,2021-02-19,VDA,292,102,190,267,24,1,ITC,ITC2,2,Valle d'Aosta / Vallée d'Aoste,Valle d'Aosta,125666,53721,42.75,0.23
89,2021-08-04,VDA,1046,571,475,370,658,18,ITC,ITC2,2,Valle d'Aosta / Vallée d'Aoste,Valle d'Aosta,125666,54767,43.58,0.83
90,2021-01-05,VDA,151,55,96,151,0,0,ITC,ITC2,2,Valle d'Aosta / Vallée d'Aoste,Valle d'Aosta,125666,54918,43.7,0.12
91,2021-01-14,VDA,237,69,168,237,0,0,ITC,ITC2,2,Valle d'Aosta / Vallée d'Aoste,Valle d'Aosta,125666,55155,43.89,0.19
92,2021-08-02,VDA,760,407,353,304,446,10,ITC,ITC2,2,Valle d'Aosta / Vallée d'Aoste,Valle d'Aosta,125666,55915,44.49,0.6
93,2021-04-24,VDA,723,401,322,534,167,22,ITC,ITC2,2,Valle d'Aosta / Vallée d'Aoste,Valle d'Aosta,125666,56638,45.07,0.58
94,2021-01-19,VDA,256,77,179,256,0,0,ITC,ITC2,2,Valle d'Aosta / Vallée d'Aoste,Valle d'Aosta,125666,56894,45.27,0.2
95,2021-04-12,VDA,487,187,300,305,164,18,ITC,ITC2,2,Valle d'Aosta / Vallée d'Aoste,Valle d'Aosta,125666,57381,45.66,0.39
96,2021-04-29,VDA,1293,636,657,742,532,19,ITC,ITC2,2,Valle d'Aosta / Vallée d'Aoste,Valle d'Aosta,125666,58674,46.69,1.03
97,2021-07-21,VDA,1168,638,530,310,849,9,ITC,ITC2,2,Valle d'Aosta / Vallée d'Aoste,Valle d'Aosta,125666,59842,47.62,0.93
98,2021-07-04,VDA,1192,530,662,349,829,14,ITC,ITC2,2,Valle d'Aosta / Vallée d'Aoste,Valle d'Aosta,125666,61034,48.57,0.95
99,2021-05-18,VDA,972,484,488,349,619,4,ITC,ITC2,2,Valle d'Aosta / Vallée d'Aoste,Valle d'Aosta,125666,62006,49.34,0.77
100,2021-02-07,VDA,292,120,172,190,102,0,ITC,ITC2,2,Valle d'Aosta / Vallée d'Aoste,Valle d'Aosta,125666,62298,49.57,0.23
101,2021-08-09,VDA,674,335,339,252,401,21,ITC,ITC2,2,Valle d'Aosta / Vallée d'Aoste,Valle d'Aosta,125666,62972,50.11,0.54
102,2021-05-01,VDA,941,564,377,440,484,17,ITC,ITC2,2,Valle d'Aosta / Vallée d'Aoste,Valle d'Aosta,125666,63913,50.86,0.75
103,2021-04-14,VDA,942,430,512,692,224,26,ITC,ITC2,2,Valle d'Aosta / Vallée d'Aoste,Valle d'Aosta,125666,64855,51.61,0.75
104,2021-05-10,VDA,785,384,401,533,235,17,ITC,ITC2,2,Valle d'Aosta / Vallée d'Aoste,Valle d'Aosta,125666,65640,52.23,0.62
105,2021-08-18,VDA,687,356,331,235,433,19,ITC,ITC2,2,Valle d'Aosta / Vallée d'Aoste,Valle d'Aosta,125666,66327,52.78,0.55
106,2021-07-30,VDA,965,501,464,419,525,21,ITC,ITC2,2,Valle d'Aosta / Vallée d'Aoste,Valle d'Aosta,125666,67292,53.55,0.77
107,2021-04-21,VDA,869,410,459,588,249,32,ITC,ITC2,2,Valle d'Aosta / Vallée d'Aoste,Valle d'Aosta,125666,68161,54.24,0.69
108,2021-07-13,VDA,1063,567,496,309,748,6,ITC,ITC2,2,Valle d'Aosta / Vallée d'Aoste,Valle d'Aosta,125666,69224,55.09,0.85
109,2021-03-21,VDA,360,169,191,351,0,9,ITC,ITC2,2,Valle d'Aosta / Vallée d'Aoste,Valle d'Aosta,125666,69584,55.37,0.29
110,2021-07-28,VDA,1424,765,659,362,1048,14,ITC,ITC2,2,Valle d'Aosta / Vallée d'Aoste,Valle d'Aosta,125666,71008,56.51,1.13
111,2021-04-19,VDA,753,326,427,521,209,23,ITC,ITC2,2,Valle d'Aosta / Vallée d'Aoste,Valle d'Aosta,125666,71761,57.1,0.6
112,2021-06-05,VDA,927,477,450,730,188,9,ITC,ITC2,2,Valle d'Aosta / Vallée d'Aoste,Valle d'Aosta,125666,72688,57.84,0.74
113,2021-02-11,VDA,232,107,125,222,9,1,ITC,ITC2,2,Valle d'Aosta / Vallée d'Aoste,Valle d'Aosta,125666,72920,58.03,0.18
114,2021-07-18,VDA,928,455,473,246,674,8,ITC,ITC2,2,Valle d'Aosta / Vallée d'Aoste,Valle d'Aosta,125666,73848,58.77,0.74
115,2021-04-09,VDA,238,111,127,201,33,4,ITC,ITC2,2,Valle d'Aosta / Vallée d'Aoste,Valle d'Aosta,125666,74086,58.95,0.19
116,2021-05-22,VDA,956,505,451,545,401,10,ITC,ITC2,2,Valle d'Aosta / Vallée d'Aoste,Valle d'Aosta,125666,75042,59.72,0.76
117,2021-03-31,VDA,555,302,253,511,26,18,ITC,ITC2,2,Valle d'Aosta / Vallée d'Aoste,Valle d'Aosta,125666,75597,60.16,0.44
118,2021-05-27,VDA,1093,498,595,575,506,12,ITC,ITC2,2,Valle d'Aosta / Vallée d'Aoste,Valle d'Aosta,125666,76690,61.03,0.87
119,2021-05-13,VDA,1146,561,585,523,602,21,ITC,ITC2,2,Valle d'Aosta / Vallée d'Aoste,Valle d'Aosta,125666,77836,61.94,0.91
120,2021-02-02,VDA,287,73,214,3,284,0,ITC,ITC2,2,Valle d'Aosta / Vallée d'Aoste,Valle d'Aosta,125666,78123,62.17,0.23
121,2021-07-09,VDA,945,446,499,279,656,10,ITC,ITC2,2,Valle d'Aosta / Vallée d'Aoste,Valle d'Aosta,125666,79068,62.92,0.75
122,2021-06-25,VDA,979,445,534,324,652,3,ITC,ITC2,2,Valle d'Aosta / Vallée d'Aoste,Valle d'Aosta,125666,80047,63.7,0.78
123,2021-08-21,VDA,441,221,220,93,331,17,ITC,ITC2,2,Valle d'Aosta / Vallée d'Aoste,Valle d'Aosta,125666,80488,64.05,0.35
124,2021-08-01,VDA,842,445,397,286,547,9,ITC,ITC2,2,Valle d'Aosta / Vallée d'Aoste,Valle d'Aosta,125666,81330,64.72,0.67
125,2021-01-28,VDA,294,124,170,55,239,0,ITC,ITC2,2,Valle d'Aosta / Vallée d'Aoste,Valle d'Aosta,125666,81624,64.95,0.23
126,2021-06-12,VDA,1234,600,634,1059,167,8,ITC,ITC2,2,Valle d'Aosta / Vallée d'Aoste,Valle d'Aosta,125666,82858,65.94,0.98
127,2021-01-16,VDA,238,80,158,238,0,0,ITC,ITC2,2,Valle d'Aosta / Vallée d'Aoste,Valle d'Aosta,125666,83096,66.12,0.19
128,2021-06-22,VDA,1192,666,526,531,649,12,ITC,ITC2,2,Valle d'Aosta / Vallée d'Aoste,Valle d'Aosta,125666,84288,67.07,0.95
129,2021-03-14,VDA,393,201,192,375,0,18,ITC,ITC2,2,Valle d'Aosta / Vallée d'Aoste,Valle d'Aosta,125666,84681,67.39,0.31
130,2021-04-26,VDA,718,330,388,516,170,32,ITC,ITC2,2,Valle d'Aosta / Vallée d'Aoste,Valle d'Aosta,125666,85399,67.96,0.57
131,2021-08-27,VDA,498,259,239,126,366,6,ITC,ITC2,2,Valle d'Aosta / Vallée d'Aoste,Valle d'Aosta,125666,85897,68.35,0.4
132,2021-07-01,VDA,962,473,489,328,621,13,ITC,ITC2,2,Valle d'Aosta / Vallée d'Aoste,Valle d'Aosta,125666,86859,69.12,0.77
133,2021-07-06,VDA,886,481,405,158,723,5,ITC,ITC2,2,Valle d'Aosta / Vallée d'Aoste,Valle d'Aosta,125666,87745,69.82,0.71
134,2021-01-02,VDA,6,5,1,6,0,0,ITC,ITC2,2,Valle d'Aosta / Vallée d'Aoste,Valle d'Aosta,125666,87751,69.83,0.0
135,2021-03-26,VDA,498,204,294,481,7,10,ITC,ITC2,2,Valle d'Aosta / Vallée d'Aoste,Valle d'Aosta,125666,88249,70.23,0.4
136,2021-06-17,VDA,991,530,461,635,342,14,ITC,ITC2,2,Valle d'Aosta / Vallée d'Aoste,Valle d'Aosta,125666,89240,71.01,0.79
137,2021-07-25,VDA,1021,494,527,262,749,10,ITC,ITC2,2,Valle d'Aosta / Vallée d'Aoste,Valle d'Aosta,125666,90261,71.83,0.81
138,2021-04-16,VDA,599,261,338,566,2,31,ITC,ITC2,2,Valle d'Aosta / Vallée d'Aoste,Valle d'Aosta,125666,90860,72.3,0.48
139,2021-04-02,VDA,875,345,530,626,226,23,ITC,ITC2,2,Valle d'Aosta / Vallée d'Aoste,Valle d'Aosta,125666,91735,73.0,0.7
140,2021-09-06,VDA,494,244,250,145,319,30,ITC,ITC2,2,Valle d'Aosta / Vallée d'Aoste,Valle d'Aosta,125666,92229,73.39,0.39
141,2021-05-29,VDA,800,436,364,554,239,7,ITC,ITC2,2,Valle d'Aosta / Vallée d'Aoste,Valle d'Aosta,125666,93029,74.03,0.64
142,2021-07-11,VDA,908,472,436,253,643,12,ITC,ITC2,2,Valle d'Aosta / Vallée d'Aoste,Valle d'Aosta,125666,93937,74.75,0.72
143,2021-02-25,VDA,202,101,101,190,8,4,ITC,ITC2,2,Valle d'Aosta / Vallée d'Aoste,Valle d'Aosta,125666,94139,74.91,0.16
144,2021-08-05,VDA,786,406,380,279,481,26,ITC,ITC2,2,Valle d'Aosta / Vallée d'Aoste,Valle d'Aosta,125666,94925,75.54,0.63
145,2021-03-10,VDA,439,184,255,220,214,5,ITC,ITC2,2,Valle d'Aosta / Vallée d'Aoste,Valle d'Aosta,125666,95364,75.89,0.35
146,2021-02-21,VDA,18,3,15,0,18,0,ITC,ITC2,2,Valle d'Aosta / Vallée d'Aoste,Valle d'Aosta,125666,95382,75.9,0.01
147,2021-06-01,VDA,873,470,403,510,354,9,ITC,ITC2,2,Valle d'Aosta / Vallée d'Aoste,Valle d'Aosta,125666,96255,76.6,0.69
148,2021-08-23,VDA,404,205,199,91,299,14,ITC,ITC2,2,Valle d'Aosta / Vallée d'Aoste,Valle d'Aosta,125666,96659,76.92,0.32
149,2021-05-20,VDA,1045,475,570,592,440,13,ITC,ITC2,2,Valle d'Aosta / Vallée d'Aoste,Valle d'Aosta,125666,97704,77.75,0.83
150,2021-07-02,VDA,871,386,485,303,562,6,ITC,ITC2,2,Valle d'Aosta / Vallée d'Aoste,Valle d'Aosta,125666,98575,78.44,0.69
151,2021-03-24,VDA,518,230,288,256,259,3,ITC,ITC2,2,Valle d'Aosta / Vallée d'Aoste,Valle d'Aosta,125666,99093,78.85,0.41
152,2021-08-28,VDA,535,285,250,91,423,21,ITC,ITC2,2,Valle d'Aosta / Vallée d'Aoste,Valle d'Aosta,125666,99628,79.28,0.43
153,2021-05-06,VDA,1083,516,567,664,385,34,ITC,ITC2,2,Valle d'Aosta / Vallée d'Aoste,Valle d'Aosta,125666,100711,80.14,0.86
154,2021-03-19,VDA,322,85,237,285,35,2,ITC,ITC2,2,Valle d'Aosta / Vallée d'Aoste,Valle d'Aosta,125666,101033,80.4,0.26
155,2021-05-07,VDA,566,247,319,514,30,22,ITC,ITC2,2,Valle d'Aosta / Vallée d'Aoste,Valle d'Aosta,125666,101599,80.85,0.45
156,2021-04-23,VDA,923,443,480,511,383,29,ITC,ITC2,2,Valle d'Aosta / Vallée d'Aoste,Valle d'Aosta,125666,102522,81.58,0.73
157,2021-01-13,VDA,338,110,228,338,0,0,ITC,ITC2,2,Valle d'Aosta / Vallée d'Aoste,Valle d'Aosta,125666,102860,81.85,0.27
158,2021-07-29,VDA,996,508,488,320,666,10,ITC,ITC2,2,Valle d'Aosta / Vallée d'Aoste,Valle d'Aosta,125666,103856,82.64,0.79
159,2021-07-15,VDA,1099,596,503,292,800,7,ITC,ITC2,2,Valle d'Aosta / Vallée d'Aoste,Valle d'Aosta,125666,104955,83.52,0.87
160,2021-04-06,VDA,743,382,361,598,112,33,ITC,ITC2,2,Valle d'Aosta / Vallée d'Aoste,Valle d'Aosta,125666,105698,84.11,0.59
161,2021-01-09,VDA,445,200,245,445,0,0,ITC,ITC2,2,Valle d'Aosta / Vallée d'Aoste,Valle d'Aosta,125666,106143,84.46,0.35
162,2021-06-24,VDA,1226,631,595,380,837,9,ITC,ITC2,2,Valle d'Aosta / Vallée d'Aoste,Valle d'Aosta,125666,107369,85.44,0.98
163,2021-07-03,VDA,936,485,451,390,537,9,ITC,ITC2,2,Valle d'Aosta / Vallée d'Aoste,Valle d'Aosta,125666,108305,86.18,0.74
164,2021-08-29,VDA,209,120,89,6,202,1,ITC,ITC2,2,Valle d'Aosta / Vallée d'Aoste,Valle d'Aosta,125666,108514,86.35,0.17
165,2021-02-08,VDA,224,83,141,25,199,0,ITC,ITC2,2,Valle d'Aosta / Vallée d'Aoste,Valle d'Aosta,125666,108738,86.53,0.18
166,2021-03-23,VDA,381,150,231,230,135,16,ITC,ITC2,2,Valle d'Aosta / Vallée d'Aoste,Valle d'Aosta,125666,109119,86.83,0.3
167,2021-05-19,VDA,993,498,495,410,575,8,ITC,ITC2,2,Valle d'Aosta / Vallée d'Aoste,Valle d'Aosta,125666,110112,87.62,0.79
168,2021-09-05,VDA,143,75,68,4,136,3,ITC,ITC2,2,Valle d'Aosta / Vallée d'Aoste,Valle d'Aosta,125666,110255,87.74,0.11
169,2021-03-16,VDA,185,37,148,109,67,9,ITC,ITC2,2,Valle d'Aosta / Vallée d'Aoste,Valle d'Aosta,125666,110440,87.88,0.15
170,2021-06-29,VDA,782,390,392,236,543,3,ITC,ITC2,2,Valle d'Aosta / Vallée d'Aoste,Valle d'Aosta,125666,111222,88.51,0.62
171,2021-06-10,VDA,1058,611,447,1007,41,10,ITC,ITC2,2,Valle d'Aosta / Vallée d'Aoste,Valle d'Aosta,125666,112280,89.35,0.84
172,2021-03-02,VDA,340,166,174,291,3,46,ITC,ITC2,2,Valle d'Aosta / Vallée d'Aoste,Valle d'Aosta,125666,112620,89.62,0.27
173,2021-01-11,VDA,328,113,215,328,0,0,ITC,ITC2,2,Valle d'Aosta / Vallée d'Aoste,Valle d'Aosta,125666,112948,89.88,0.26
174,2021-04-04,VDA,573,254,319,562,0,11,ITC,ITC2,2,Valle d'Aosta / Vallée d'Aoste,Valle d'Aosta,125666,113521,90.34,0.46
175,2021-01-06,VDA,66,34,32,66,0,0,ITC,ITC2,2,Valle d'Aosta / Vallée d'Aoste,Valle d'Aosta,125666,113587,90.39,0.05
176,2021-02-18,VDA,349,153,196,256,88,5,ITC,ITC2,2,Valle d'Aosta / Vallée d'Aoste,Valle d'Aosta,125666,113936,90.67,0.28
177,2021-01-21,VDA,33,12,21,33,0,0,ITC,ITC2,2,Valle d'Aosta / Vallée d'Aoste,Valle d'Aosta,125666,113969,90.69,0.03
178,2021-01-04,VDA,144,61,83,144,0,0,ITC,ITC2,2,Valle d'Aosta / Vallée d'Aoste,Valle d'Aosta,125666,114113,90.81,0.11
179,2021-03-28,VDA,524,213,311,497,0,27,ITC,ITC2,2,Valle d'Aosta / Vallée d'Aoste,Valle d'Aosta,125666,114637,91.22,0.42
180,2021-03-11,VDA,392,164,228,152,239,1,ITC,ITC2,2,Valle d'Aosta / Vallée d'Aoste,Valle d'Aosta,125666,115029,91.54,0.31
181,2021-06-02,VDA,1217,689,528,811,402,4,ITC,ITC2,2,Valle d'Aosta / Vallée d'Aoste,Valle d'Aosta,125666,116246,92.5,0.97
182,2021-06-19,VDA,1295,671,624,658,621,16,ITC,ITC2,2,Valle d'Aosta / Vallée d'Aoste,Valle d'Aosta,125666,117541,93.53,1.03
183,2021-08-24,VDA,672,370,302,144,518,10,ITC,ITC2,2,Valle d'Aosta / Vallée d'Aoste,Valle d'Aosta,125666,118213,94.07,0.53
184,2021-03-09,VDA,206,96,110,167,32,7,ITC,ITC2,2,Valle d'Aosta / Vallée d'Aoste,Valle d'Aosta,125666,118419,94.23,0.16
185,2021-02-20,VDA,256,214,42,243,10,3,ITC,ITC2,2,Valle d'Aosta / Vallée d'Aoste,Valle d'Aosta,125666,118675,94.44,0.2
186,2021-02-16,VDA,327,53,274,315,6,6,ITC,ITC2,2,Valle d'Aosta / Vallée d'Aoste,Valle d'Aosta,125666,119002,94.7,0.26
187,2021-03-18,VDA,136,43,93,96,37,3,ITC,ITC2,2,Valle d'Aosta / Vallée d'Aoste,Valle d'Aosta,125666,119138,94.81,0.11
188,2021-06-26,VDA,1066,512,554,352,707,7,ITC,ITC2,2,Valle d'Aosta / Vallée d'Aoste,Valle d'Aosta,125666,120204,95.65,0.85
189,2021-03-04,VDA,291,139,152,38,251,2,ITC,ITC2,2,Valle d'Aosta / Vallée d'Aoste,Valle d'Aosta,125666,120495,95.89,0.23
190,2021-05-26,VDA,1212,587,625,567,634,11,ITC,ITC2,2,Valle d'Aosta / Vallée d'Aoste,Valle d'Aosta,125666,121707,96.85,0.96
191,2021-09-03,VDA,534,283,251,141,369,24,ITC,ITC2,2,Valle d'Aosta / Vallée d'Aoste,Valle d'Aosta,125666,122241,97.27,0.42
192,2021-02-23,VDA,217,124,93,216,0,1,ITC,ITC2,2,Valle d'Aosta / Vallée d'Aoste,Valle d'Aosta,125666,122458,97.45,0.17
193,2021-06-03,VDA,1309,669,640,879,413,17,ITC,ITC2,2,Valle d'Aosta / Vallée d'Aoste,Valle d'Aosta,125666,123767,98.49,1.04
194,2021-08-25,VDA,681,348,333,128,527,26,ITC,ITC2,2,Valle d'Aosta / Vallée d'Aoste,Valle d'Aosta,125666,124448,99.03,0.54
195,2021-05-17,VDA,809,417,392,365,434,10,ITC,ITC2,2,Valle d'Aosta / Vallée d'Aoste,Valle d'Aosta,125666,125257,99.67,0.64
196,2021-08-08,VDA,579,297,282,175,394,10,ITC,ITC2,2,Valle d'Aosta / Vallée d'Aoste,Valle d'Aosta,125666,125836,100.14,0.46
197,2021-05-15,VDA,1067,614,453,368,686,13,ITC,ITC2,2,Valle d'Aosta / Vallée d'Aoste,Valle d'Aosta,125666,126903,100.98,0.85
198,2021-02-04,VDA,295,86,209,8,287,0,ITC,ITC2,2,Valle d'Aosta / Vallée d'Aoste,Valle d'Aosta,125666,127198,101.22,0.23
199,2021-04-28,VDA,1220,633,587,683,503,34,ITC,ITC2,2,Valle d'Aosta / Vallée d'Aoste,Valle d'Aosta,125666,128418,102.19,0.97
200,2021-08-06,VDA,820,400,420,405,397,18,ITC,ITC2,2,Valle d'Aosta / Vallée d'Aoste,Valle d'Aosta,125666,129238,102.84,0.65
201,2021-04-07,VDA,910,474,436,655,229,26,ITC,ITC2,2,Valle d'Aosta / Vallée d'Aoste,Valle d'Aosta,125666,130148,103.57,0.72
202,2021-09-08,VDA,603,307,296,207,342,54,ITC,ITC2,2,Valle d'Aosta / Vallée d'Aoste,Valle d'Aosta,125666,130751,104.05,0.48
203,2021-02-09,VDA,255,86,169,70,184,1,ITC,ITC2,2,Valle d'Aosta / Vallée d'Aoste,Valle d'Aosta,125666,131006,104.25,0.2
204,2021-07-20,VDA,1121,585,536,388,724,9,ITC,ITC2,2,Valle d'Aosta / Vallée d'Aoste,Valle d'Aosta,125666,132127,105.14,0.89
205,2021-04-18,VDA,523,255,268,495,2,26,ITC,ITC2,2,Valle d'Aosta / Vallée d'Aoste,Valle d'Aosta,125666,132650,105.56,0.42
206,2021-06-14,VDA,1017,523,494,575,428,14,ITC,ITC2,2,Valle d'Aosta / Vallée d'Aoste,Valle d'Aosta,125666,133667,106.37,0.81
207,2021-05-31,VDA,881,396,485,490,380,11,ITC,ITC2,2,Valle d'Aosta / Vallée d'Aoste,Valle d'Aosta,125666,134548,107.07,0.7
208,2021-08-17,VDA,560,306,254,210,342,8,ITC,ITC2,2,Valle d'Aosta / Vallée d'Aoste,Valle d'Aosta,125666,135108,107.51,0.45
209,2021-02-13,VDA,217,197,20,214,1,2,ITC,ITC2,2,Valle d'Aosta / Vallée d'Aoste,Valle d'Aosta,125666,135325,107.69,0.17
210,2021-08-10,VDA,853,437,416,580,263,10,ITC,ITC2,2,Valle d'Aosta / Vallée d'Aoste,Valle d'Aosta,125666,136178,108.37,0.68
211,2021-02-06,VDA,290,104,186,91,198,1,ITC,ITC2,2,Valle d'Aosta / Vallée d'Aoste,Valle d'Aosta,125666,136468,108.6,0.23
212,2021-04-30,VDA,833,357,476,469,347,17,ITC,ITC2,2,Valle d'Aosta / Vallée d'Aoste,Valle d'Aosta,125666,137301,109.26,0.66
213,2021-01-20,VDA,64,15,49,64,0,0,ITC,ITC2,2,Valle d'Aosta / Vallée d'Aoste,Valle d'Aosta,125666,137365,109.31,0.05
214,2021-07-22,VDA,981,519,462,270,704,7,ITC,ITC2,2,Valle d'Aosta / Vallée d'Aoste,Valle d'Aosta,125666,138346,110.09,0.78
215,2021-01-18,VDA,214,74,140,214,0,0,ITC,ITC2,2,Valle d'Aosta / Vallée d'Aoste,Valle d'Aosta,125666,138560,110.26,0.17
216,2021-04-11,VDA,479,208,271,462,0,17,ITC,ITC2,2,Valle d'Aosta / Vallée d'Aoste,Valle d'Aosta,125666,139039,110.64,0.38
217,2021-07-27,VDA,1122,597,525,561,552,9,ITC,ITC2,2,Valle d'Aosta / Vallée d'Aoste,Valle d'Aosta,125666,140161,111.53,0.89
218,2021-04-25,VDA,850,409,441,674,139,37,ITC,ITC2,2,Valle d'Aosta / Vallée d'Aoste,Valle d'Aosta,125666,141011,112.21,0.68
219,2021-06-21,VDA,1123,600,523,608,505,10,ITC,ITC2,2,Valle d'Aosta / Vallée d'Aoste,Valle d'Aosta,125666,142134,113.1,0.89
220,2021-06-07,VDA,711,347,364,637,61,13,ITC,ITC2,2,Valle d'Aosta / Vallée d'Aoste,Valle d'Aosta,125666,142845,113.67,0.57
221,2021-02-27,VDA,232,86,146,120,107,5,ITC,ITC2,2,Valle d'Aosta / Vallée d'Aoste,Valle d'Aosta,125666,143077,113.85,0.18
222,2021-08-03,VDA,936,485,451,564,358,14,ITC,ITC2,2,Valle d'Aosta / Vallée d'Aoste,Valle d'Aosta,125666,144013,114.6,0.74
223,2021-06-13,VDA,857,403,454,370,482,5,ITC,ITC2,2,Valle d'Aosta / Vallée d'Aoste,Valle d'Aosta,125666,144870,115.28,0.68
224,2021-06-08,VDA,772,408,364,731,33,8,ITC,ITC2,2,Valle d'Aosta / Vallée d'Aoste,Valle d'Aosta,125666,145642,115.9,0.61
225,2021-02-26,VDA,210,58,152,110,86,14,ITC,ITC2,2,Valle d'Aosta / Vallée d'Aoste,Valle d'Aosta,125666,145852,116.06,0.17
226,2021-04-10,VDA,405,191,214,389,5,11,ITC,ITC2,2,Valle d'Aosta / Vallée d'Aoste,Valle d'Aosta,125666,146257,116.39,0.32
227,2020-12-31,VDA,18,4,14,18,0,0,ITC,ITC2,2,Valle d'Aosta / Vallée d'Aoste,Valle d'Aosta,125666,146275,116.4,0.01
228,2021-06-06,VDA,1160,582,578,781,373,6,ITC,ITC2,2,Valle d'Aosta / Vallée d'Aoste,Valle d'Aosta,125666,147435,117.32,0.92
229,2021-06-15,VDA,924,508,416,654,257,13,ITC,ITC2,2,Valle d'Aosta / Vallée d'Aoste,Valle d'Aosta,125666,148359,118.06,0.74
230,2021-08-11,VDA,777,380,397,304,452,21,ITC,ITC2,2,Valle d'Aosta / Vallée d'Aoste,Valle d'Aosta,125666,149136,118.68,0.62
231,2021-03-05,VDA,277,125,152,53,223,1,ITC,ITC2,2,Valle d'Aosta / Vallée d'Aoste,Valle d'Aosta,125666,149413,118.9,0.22
232,2021-02-28,VDA,260,86,174,73,183,4,ITC,ITC2,2,Valle d'Aosta / Vallée d'Aoste,Valle d'Aosta,125666,149673,119.1,0.21
233,2021-05-05,VDA,1038,566,472,434,582,22,ITC,ITC2,2,Valle d'Aosta / Vallée d'Aoste,Valle d'Aosta,125666,150711,119.93,0.83
234,2021-08-13,VDA,495,273,222,203,283,9,ITC,ITC2,2,Valle d'Aosta / Vallée d'Aoste,Valle d'Aosta,125666,151206,120.32,0.39
235,2021-05-03,VDA,841,400,441,459,352,30,ITC,ITC2,2,Valle d'Aosta / Vallée d'Aoste,Valle d'Aosta,125666,152047,120.99,0.67
236,2021-03-07,VDA,64,30,34,11,53,0,ITC,ITC2,2,Valle d'Aosta / Vallée d'Aoste,Valle d'Aosta,125666,152111,121.04,0.05
237,2021-08-20,VDA,473,240,233,142,316,15,ITC,ITC2,2,Valle d'Aosta / Vallée d'Aoste,Valle d'Aosta,125666,152584,121.42,0.38
238,2021-01-30,VDA,440,203,237,12,426,2,ITC,ITC2,2,Valle d'Aosta / Vallée d'Aoste,Valle d'Aosta,125666,153024,121.77,0.35
239,2021-01-25,VDA,150,67,83,1,149,0,ITC,ITC2,2,Valle d'Aosta / Vallée d'Aoste,Valle d'Aosta,125666,153174,121.89,0.12
240,2021-07-10,VDA,1295,670,625,320,964,11,ITC,ITC2,2,Valle d'Aosta / Vallée d'Aoste,Valle d'Aosta,125666,154469,122.92,1.03
241,2021-08-22,VDA,177,88,89,8,169,0,ITC,ITC2,2,Valle d'Aosta / Vallée d'Aoste,Valle d'Aosta,125666,154646,123.06,0.14
242,2021-05-14,VDA,964,444,520,264,670,30,ITC,ITC2,2,Valle d'Aosta / Vallée d'Aoste,Valle d'Aosta,125666,155610,123.83,0.77
243,2021-02-01,VDA,409,128,281,86,320,3,ITC,ITC2,2,Valle d'Aosta / Vallée d'Aoste,Valle d'Aosta,125666,156019,124.15,0.33
244,2021-07-08,VDA,1276,709,567,340,925,11,ITC,ITC2,2,Valle d'Aosta / Vallée d'Aoste,Valle d'Aosta,125666,157295,125.17,1.02
245,2021-03-30,VDA,402,223,179,364,20,18,ITC,ITC2,2,Valle d'Aosta / Vallée d'Aoste,Valle d'Aosta,125666,157697,125.49,0.32
246,2021-05-12,VDA,1144,550,594,449,671,24,ITC,ITC2,2,Valle d'Aosta / Vallée d'Aoste,Valle d'Aosta,125666,158841,126.4,0.91
247,2021-07-17,VDA,987,521,466,251,731,5,ITC,ITC2,2,Valle d'Aosta / Vallée d'Aoste,Valle d'Aosta,125666,159828,127.18,0.79
248,2021-04-23,UMB,6659,2821,3838,3301,3159,199,ITI,ITI2,10,Umbria,Umbria,882015,6659,0.75,0.75
249,2021-02-25,UMB,1334,496,838,1274,52,8,ITI,ITI2,10,Umbria,Umbria,882015,7993,0.91,0.15
250,2021-03-11,UMB,3687,1799,1888,2668,1006,13,ITI,ITI2,10,Umbria,Umbria,882015,11680,1.32,0.42
251,2021-01-13,UMB,451,139,312,451,0,0,ITI,ITI2,10,Umbria,Umbria,882015,12131,1.38,0.05
252,2021-06-19,UMB,4589,2206,2383,2463,2033,93,ITI,ITI2,10,Umbria,Umbria,882015,16720,1.9,0.52
253,2021-01-06,UMB,847,326,521,847,0,0,ITI,ITI2,10,Umbria,Umbria,882015,17567,1.99,0.1
254,2021-06-12,UMB,7722,3688,4034,5962,1580,180,ITI,ITI2,10,Umbria,Umbria,882015,25289,2.87,0.88
255,2021-02-13,UMB,114,27,87,111,3,0,ITI,ITI2,10,Umbria,Umbria,882015,25403,2.88,0.01
256,2021-05-24,UMB,9077,4520,4557,8030,881,166,ITI,ITI2,10,Umbria,Umbria,882015,34480,3.91,1.03
257,2021-04-18,UMB,1532,681,851,578,931,23,ITI,ITI2,10,Umbria,Umbria,882015,36012,4.08,0.17
258,2021-01-11,UMB,1337,364,973,1337,0,0,ITI,ITI2,10,Umbria,Umbria,882015,37349,4.23,0.15
259,2021-07-27,UMB,8145,4091,4054,2694,5334,117,ITI,ITI2,10,Umbria,Umbria,882015,45494,5.16,0.92
260,2021-05-05,UMB,7224,3306,3918,3834,3306,84,ITI,ITI2,10,Umbria,Umbria,882015,52718,5.98,0.82
261,2021-01-25,UMB,649,322,327,5,644,0,ITI,ITI2,10,Umbria,Umbria,882015,53367,6.05,0.07
262,2021-08-15,UMB,4389,2384,2005,2862,1382,145,ITI,ITI2,10,Umbria,Umbria,882015,57756,6.55,0.5
263,2021-07-29,UMB,8203,4228,3975,2145,5940,118,ITI,ITI2,10,Umbria,Umbria,882015,65959,7.48,0.93
264,2021-05-07,UMB,10134,4716,5418,6656,3192,286,ITI,ITI2,10,Umbria,Umbria,882015,76093,8.63,1.15
265,2021-08-29,UMB,1947,1004,943,685,1253,9,ITI,ITI2,10,Umbria,Umbria,882015,78040,8.85,0.22
266,2021-06-02,UMB,3926,1886,2040,3805,42,79,ITI,ITI2,10,Umbria,Umbria,882015,81966,9.29,0.45
267,2021-02-20,UMB,283,101,182,259,24,0,ITI,ITI2,10,Umbria,Umbria,882015,82249,9.33,0.03
268,2021-03-09,UMB,4092,2002,2090,2795,1288,9,ITI,ITI2,10,Umbria,Umbria,882015,86341,9.79,0.46
269,2021-08-10,UMB,7402,3935,3467,4003,3256,143,ITI,ITI2,10,Umbria,Umbria,882015,93743,10.63,0.84
270,2021-06-14,UMB,5387,2750,2637,3253,2015,119,ITI,ITI2,10,Umbria,Umbria,882015,99130,11.24,0.61
271,2021-07-03,UMB,6481,3248,3233,2832,3497,152,ITI,ITI2,10,Umbria,Umbria,882015,105611,11.97,0.73
272,2021-07-20,UMB,8267,4107,4160,1096,7087,84,ITI,ITI2,10,Umbria,Umbria,882015,113878,12.91,0.94
273,2021-09-05,UMB,3390,1798,1592,259,3117,14,ITI,ITI2,10,Umbria,Umbria,882015,117268,13.3,0.38
274,2021-03-23,UMB,3828,1714,2114,2159,1632,37,ITI,ITI2,10,Umbria,Umbria,882015,121096,13.73,0.43
275,2021-08-27,UMB,4601,2419,2182,1500,3000,101,ITI,ITI2,10,Umbria,Umbria,882015,125697,14.25,0.52
276,2021-07-01,UMB,9747,4819,4928,3304,6289,154,ITI,ITI2,10,Umbria,Umbria,882015,135444,15.36,1.11
277,2021-02-08,UMB,637,203,434,88,549,0,ITI,ITI2,10,Umbria,Umbria,882015,136081,15.43,0.07
278,2021-05-19,UMB,9431,4219,5212,5600,3745,86,ITI,ITI2,10,Umbria,Umbria,882015,145512,16.5,1.07
279,2021-04-06,UMB,5294,2167,3127,2865,2392,37,ITI,ITI2,10,Umbria,Umbria,882015,150806,17.1,0.6
280,2021-03-28,UMB,1096,441,655,1041,24,31,ITI,ITI2,10,Umbria,Umbria,882015,151902,17.22,0.12
281,2021-01-30,UMB,1575,486,1089,43,1532,0,ITI,ITI2,10,Umbria,Umbria,882015,153477,17.4,0.18
282,2021-07-15,UMB,10573,5177,5396,565,9909,99,ITI,ITI2,10,Umbria,Umbria,882015,164050,18.6,1.2
283,2021-04-16,UMB,8101,3744,4357,6084,1838,179,ITI,ITI2,10,Umbria,Umbria,882015,172151,19.52,0.92
284,2021-04-30,UMB,6257,2971,3286,2735,3400,122,ITI,ITI2,10,Umbria,Umbria,882015,178408,20.23,0.71
285,2021-03-04,UMB,4486,1856,2630,3644,827,15,ITI,ITI2,10,Umbria,Umbria,882015,182894,20.74,0.51
286,2021-08-08,UMB,5066,2712,2354,3557,1414,95,ITI,ITI2,10,Umbria,Umbria,882015,187960,21.31,0.57
287,2021-01-20,UMB,603,221,382,603,0,0,ITI,ITI2,10,Umbria,Umbria,882015,188563,21.38,0.07
288,2021-04-04,UMB,57,20,37,22,35,0,ITI,ITI2,10,Umbria,Umbria,882015,188620,21.39,0.01
289,2021-06-07,UMB,6959,3436,3523,6086,696,177,ITI,ITI2,10,Umbria,Umbria,882015,195579,22.17,0.79
290,2021-03-16,UMB,3538,1454,2084,1909,1627,2,ITI,ITI2,10,Umbria,Umbria,882015,199117,22.58,0.4
291,2021-02-27,UMB,1658,354,1304,1642,16,0,ITI,ITI2,10,Umbria,Umbria,882015,200775,22.76,0.19
292,2021-04-03,UMB,2099,712,1387,1034,1054,11,ITI,ITI2,10,Umbria,Umbria,882015,202874,23.0,0.24
293,2021-07-12,UMB,4632,2242,2390,105,4515,12,ITI,ITI2,10,Umbria,Umbria,882015,207506,23.53,0.53
294,2021-03-18,UMB,2987,1179,1808,1713,1265,9,ITI,ITI2,10,Umbria,Umbria,882015,210493,23.87,0.34
295,2021-06-26,UMB,9380,4758,4622,5581,3638,161,ITI,ITI2,10,Umbria,Umbria,882015,219873,24.93,1.06
296,2021-07-10,UMB,7690,3810,3880,66,7610,14,ITI,ITI2,10,Umbria,Umbria,882015,227563,25.8,0.87
297,2021-08-22,UMB,1469,772,697,478,977,14,ITI,ITI2,10,Umbria,Umbria,882015,229032,25.97,0.17
298,2021-05-31,UMB,5824,2848,2976,4854,885,85,ITI,ITI2,10,Umbria,Umbria,882015,234856,26.63,0.66
299,2021-05-14,UMB,5347,2526,2821,3354,1819,174,ITI,ITI2,10,Umbria,Umbria,882015,240203,27.23,0.61
300,2021-02-01,UMB,1285,342,943,48,1237,0,ITI,ITI2,10,Umbria,Umbria,882015,241488,27.38,0.15
301,2021-02-18,UMB,1497,583,914,1029,467,1,ITI,ITI2,10,Umbria,Umbria,882015,242985,27.55,0.17
302,2021-07-22,UMB,10075,4924,5151,1653,8317,105,ITI,ITI2,10,Umbria,Umbria,882015,253060,28.69,1.14
303,2021-01-01,UMB,273,104,169,273,0,0,ITI,ITI2,10,Umbria,Umbria,882015,253333,28.72,0.03
304,2021-04-11,UMB,3101,1506,1595,3035,49,17,ITI,ITI2,10,Umbria,Umbria,882015,256434,29.07,0.35
305,2021-01-18,UMB,619,221,398,531,88,0,ITI,ITI2,10,Umbria,Umbria,882015,257053,29.14,0.07
306,2021-02-06,UMB,437,163,274,34,403,0,ITI,ITI2,10,Umbria,Umbria,882015,257490,29.19,0.05
307,2021-05-26,UMB,9665,4573,5092,8220,1253,192,ITI,ITI2,10,Umbria,Umbria,882015,267155,30.29,1.1
308,2021-09-03,UMB,4234,2193,2041,1320,2854,60,ITI,ITI2,10,Umbria,Umbria,882015,271389,30.77,0.48
309,2021-07-08,UMB,9576,4634,4942,180,9349,47,ITI,ITI2,10,Umbria,Umbria,882015,280965,31.85,1.09
310,2021-05-12,UMB,6528,3038,3490,4209,2149,170,ITI,ITI2,10,Umbria,Umbria,882015,287493,32.6,0.74
311,2021-03-30,UMB,3988,1735,2253,2406,1544,38,ITI,ITI2,10,Umbria,Umbria,882015,291481,33.05,0.45
312,2020-12-27,UMB,88,47,41,88,0,0,ITI,ITI2,10,Umbria,Umbria,882015,291569,33.06,0.01
313,2021-04-25,UMB,4362,1687,2675,3868,83,411,ITI,ITI2,10,Umbria,Umbria,882015,295931,33.55,0.49
314,2021-08-03,UMB,9207,4761,4446,3505,5519,183,ITI,ITI2,10,Umbria,Umbria,882015,305138,34.6,1.04
315,2021-08-12,UMB,7352,3900,3452,4586,2547,219,ITI,ITI2,10,Umbria,Umbria,882015,312490,35.43,0.83
316,2021-06-30,UMB,10551,5326,5225,3675,6725,151,ITI,ITI2,10,Umbria,Umbria,882015,323041,36.63,1.2
317,2021-09-02,UMB,4360,2268,2092,959,3360,41,ITI,ITI2,10,Umbria,Umbria,882015,327401,37.12,0.49
318,2021-07-07,UMB,9499,4502,4997,89,9380,30,ITI,ITI2,10,Umbria,Umbria,882015,336900,38.2,1.08
319,2021-01-08,UMB,1193,344,849,1193,0,0,ITI,ITI2,10,Umbria,Umbria,882015,338093,38.33,0.14
320,2021-05-23,UMB,5074,1857,3217,637,4421,16,ITI,ITI2,10,Umbria,Umbria,882015,343167,38.91,0.58
321,2021-08-31,UMB,4134,2136,1998,1223,2841,70,ITI,ITI2,10,Umbria,Umbria,882015,347301,39.38,0.47
322,2021-08-14,UMB,5850,3232,2618,2915,2785,150,ITI,ITI2,10,Umbria,Umbria,882015,353151,40.04,0.66
323,2021-03-17,UMB,3331,1313,2018,1855,1474,2,ITI,ITI2,10,Umbria,Umbria,882015,356482,40.42,0.38
324,2021-04-20,UMB,5451,2365,3086,3429,1947,75,ITI,ITI2,10,Umbria,Umbria,882015,361933,41.03,0.62
325,2021-01-27,UMB,841,330,511,13,828,0,ITI,ITI2,10,Umbria,Umbria,882015,362774,41.13,0.1
326,2021-01-10,UMB,1067,274,793,1067,0,0,ITI,ITI2,10,Umbria,Umbria,882015,363841,41.25,0.12
327,2021-05-21,UMB,8981,3672,5309,4066,4830,85,ITI,ITI2,10,Umbria,Umbria,882015,372822,42.27,1.02
328,2021-05-04,UMB,5544,2547,2997,2355,3127,62,ITI,ITI2,10,Umbria,Umbria,882015,378366,42.9,0.63
329,2021-04-01,UMB,4474,1911,2563,2326,2110,38,ITI,ITI2,10,Umbria,Umbria,882015,382840,43.41,0.51
330,2021-03-01,UMB,1505,775,730,1385,114,6,ITI,ITI2,10,Umbria,Umbria,882015,384345,43.58,0.17
331,2021-06-09,UMB,8162,3951,4211,7137,725,300,ITI,ITI2,10,Umbria,Umbria,882015,392507,44.5,0.93
332,2021-06-23,UMB,11360,5806,5554,7679,3412,269,ITI,ITI2,10,Umbria,Umbria,882015,403867,45.79,1.29
333,2021-03-15,UMB,4599,1941,2658,2827,1769,3,ITI,ITI2,10,Umbria,Umbria,882015,408466,46.31,0.52
334,2021-02-10,UMB,715,350,365,700,15,0,ITI,ITI2,10,Umbria,Umbria,882015,409181,46.39,0.08
335,2021-08-07,UMB,7231,3799,3432,2540,4619,72,ITI,ITI2,10,Umbria,Umbria,882015,416412,47.21,0.82
336,2021-05-16,UMB,5227,2493,2734,5088,50,89,ITI,ITI2,10,Umbria,Umbria,882015,421639,47.8,0.59
337,2021-08-24,UMB,4435,2247,2188,1872,2474,89,ITI,ITI2,10,Umbria,Umbria,882015,426074,48.31,0.5
338,2021-05-11,UMB,6259,2842,3417,3924,2193,142,ITI,ITI2,10,Umbria,Umbria,882015,432333,49.02,0.71
339,2021-08-19,UMB,5724,3036,2688,3936,1610,178,ITI,ITI2,10,Umbria,Umbria,882015,438057,49.67,0.65
340,2021-08-26,UMB,4059,2151,1908,1791,2158,110,ITI,ITI2,10,Umbria,Umbria,882015,442116,50.13,0.46
341,2021-02-22,UMB,1891,807,1084,1805,86,0,ITI,ITI2,10,Umbria,Umbria,882015,444007,50.34,0.21
342,2021-06-11,UMB,7009,3519,3490,6001,772,236,ITI,ITI2,10,Umbria,Umbria,882015,451016,51.13,0.79
343,2021-09-07,UMB,4804,2483,2321,1017,3711,76,ITI,ITI2,10,Umbria,Umbria,882015,455820,51.68,0.54
344,2021-05-30,UMB,5982,2999,2983,5662,202,118,ITI,ITI2,10,Umbria,Umbria,882015,461802,52.36,0.68
345,2021-03-08,UMB,3701,1825,1876,2327,1361,13,ITI,ITI2,10,Umbria,Umbria,882015,465503,52.78,0.42
346,2021-06-16,UMB,6324,3095,3229,3070,3100,154,ITI,ITI2,10,Umbria,Umbria,882015,471827,53.49,0.72
347,2021-03-25,UMB,3937,1728,2209,2826,1064,47,ITI,ITI2,10,Umbria,Umbria,882015,475764,53.94,0.45
348,2021-03-27,UMB,4253,1515,2738,3857,340,56,ITI,ITI2,10,Umbria,Umbria,882015,480017,54.42,0.48
349,2021-06-18,UMB,4814,2374,2440,1569,3166,79,ITI,ITI2,10,Umbria,Umbria,882015,484831,54.97,0.55
350,2021-07-05,UMB,8422,4083,4339,153,8255,14,ITI,ITI2,10,Umbria,Umbria,882015,493253,55.92,0.95
351,2021-05-13,UMB,5944,2671,3273,3730,2085,129,ITI,ITI2,10,Umbria,Umbria,882015,499197,56.6,0.67
352,2021-08-21,UMB,2789,1465,1324,1609,1115,65,ITI,ITI2,10,Umbria,Umbria,882015,501986,56.91,0.32
353,2021-02-19,UMB,743,293,450,525,217,1,ITI,ITI2,10,Umbria,Umbria,882015,502729,57.0,0.08
354,2021-01-07,UMB,1301,388,913,1301,0,0,ITI,ITI2,10,Umbria,Umbria,882015,504030,57.15,0.15
355,2021-06-25,UMB,10241,5318,4923,5252,4785,204,ITI,ITI2,10,Umbria,Umbria,882015,514271,58.31,1.16
356,2021-01-26,UMB,816,390,426,17,799,0,ITI,ITI2,10,Umbria,Umbria,882015,515087,58.4,0.09
357,2021-04-08,UMB,5904,2525,3379,4024,1807,73,ITI,ITI2,10,Umbria,Umbria,882015,520991,59.07,0.67
358,2021-07-17,UMB,7673,3856,3817,1287,6237,149,ITI,ITI2,10,Umbria,Umbria,882015,528664,59.94,0.87
359,2021-06-04,UMB,8928,4413,4515,7541,1205,182,ITI,ITI2,10,Umbria,Umbria,882015,537592,60.95,1.01
360,2021-03-29,UMB,3638,1604,2034,2153,1424,61,ITI,ITI2,10,Umbria,Umbria,882015,541230,61.36,0.41
361,2021-01-31,UMB,1061,276,785,25,1036,0,ITI,ITI2,10,Umbria,Umbria,882015,542291,61.48,0.12
362,2021-05-25,UMB,8826,4304,4522,7587,1066,173,ITI,ITI2,10,Umbria,Umbria,882015,551117,62.48,1.0
363,2021-08-17,UMB,3665,1909,1756,2489,1088,88,ITI,ITI2,10,Umbria,Umbria,882015,554782,62.9,0.42
364,2021-06-21,UMB,7552,3953,3599,5068,2338,146,ITI,ITI2,10,Umbria,Umbria,882015,562334,63.76,0.86
365,2021-01-24,UMB,258,106,152,1,257,0,ITI,ITI2,10,Umbria,Umbria,882015,562592,63.78,0.03
366,2021-08-16,UMB,3518,1742,1776,1978,1472,68,ITI,ITI2,10,Umbria,Umbria,882015,566110,64.18,0.4
367,2021-08-30,UMB,1951,951,1000,1497,372,82,ITI,ITI2,10,Umbria,Umbria,882015,568061,64.4,0.22
368,2021-06-08,UMB,7420,3659,3761,6654,557,209,ITI,ITI2,10,Umbria,Umbria,882015,575481,65.25,0.84
369,2021-06-27,UMB,7480,3738,3742,1732,5672,76,ITI,ITI2,10,Umbria,Umbria,882015,582961,66.09,0.85
370,2021-07-28,UMB,8239,4334,3905,2971,5155,113,ITI,ITI2,10,Umbria,Umbria,882015,591200,67.03,0.93
371,2021-06-13,UMB,6767,3558,3209,6393,230,144,ITI,ITI2,10,Umbria,Umbria,882015,597967,67.8,0.77
372,2021-05-01,UMB,5376,2641,2735,2099,3231,46,ITI,ITI2,10,Umbria,Umbria,882015,603343,68.41,0.61
373,2021-03-05,UMB,4623,1403,3220,3950,658,15,ITI,ITI2,10,Umbria,Umbria,882015,607966,68.93,0.52
374,2021-08-09,UMB,6694,3546,3148,3502,3032,160,ITI,ITI2,10,Umbria,Umbria,882015,614660,69.69,0.76
375,2021-03-03,UMB,4433,1772,2661,3719,711,3,ITI,ITI2,10,Umbria,Umbria,882015,619093,70.19,0.5
376,2021-08-11,UMB,7619,4085,3534,3718,3716,185,ITI,ITI2,10,Umbria,Umbria,882015,626712,71.05,0.86
377,2021-08-04,UMB,10670,5541,5129,3309,7195,166,ITI,ITI2,10,Umbria,Umbria,882015,637382,72.26,1.21
378,2021-05-18,UMB,7768,3364,4404,3837,3841,90,ITI,ITI2,10,Umbria,Umbria,882015,645150,73.15,0.88
379,2021-03-22,UMB,3562,1657,1905,2306,1246,10,ITI,ITI2,10,Umbria,Umbria,882015,648712,73.55,0.4
380,2021-04-05,UMB,4251,1729,2522,2182,2057,12,ITI,ITI2,10,Umbria,Umbria,882015,652963,74.03,0.48
381,2021-02-07,UMB,55,17,38,1,54,0,ITI,ITI2,10,Umbria,Umbria,882015,653018,74.04,0.01
382,2021-07-14,UMB,6206,3010,3196,1634,4264,308,ITI,ITI2,10,Umbria,Umbria,882015,659224,74.74,0.7
383,2021-08-01,UMB,3026,1533,1493,1330,1650,46,ITI,ITI2,10,Umbria,Umbria,882015,662250,75.08,0.34
384,2021-07-18,UMB,7853,4063,3790,273,7553,27,ITI,ITI2,10,Umbria,Umbria,882015,670103,75.97,0.89
385,2021-06-05,UMB,8232,3777,4455,5416,2655,161,ITI,ITI2,10,Umbria,Umbria,882015,678335,76.91,0.93
386,2021-08-05,UMB,9702,5076,4626,3841,5697,164,ITI,ITI2,10,Umbria,Umbria,882015,688037,78.01,1.1
387,2021-07-19,UMB,7669,3842,3827,1525,6043,101,ITI,ITI2,10,Umbria,Umbria,882015,695706,78.88,0.87
388,2021-04-27,UMB,5668,2401,3267,3054,2579,35,ITI,ITI2,10,Umbria,Umbria,882015,701374,79.52,0.64
389,2021-02-03,UMB,727,174,553,67,660,0,ITI,ITI2,10,Umbria,Umbria,882015,702101,79.6,0.08
390,2021-03-06,UMB,4308,1149,3159,4136,138,34,ITI,ITI2,10,Umbria,Umbria,882015,706409,80.09,0.49
391,2021-01-22,UMB,276,105,171,32,244,0,ITI,ITI2,10,Umbria,Umbria,882015,706685,80.12,0.03
392,2021-06-28,UMB,9830,4844,4986,3711,5990,129,ITI,ITI2,10,Umbria,Umbria,882015,716515,81.24,1.11
393,2021-05-02,UMB,3782,1867,1915,1298,2455,29,ITI,ITI2,10,Umbria,Umbria,882015,720297,81.66,0.43
394,2021-03-20,UMB,2320,845,1475,2290,25,5,ITI,ITI2,10,Umbria,Umbria,882015,722617,81.93,0.26
395,2021-03-13,UMB,1735,524,1211,1486,249,0,ITI,ITI2,10,Umbria,Umbria,882015,724352,82.12,0.2
396,2021-01-15,UMB,698,213,485,698,0,0,ITI,ITI2,10,Umbria,Umbria,882015,725050,82.2,0.08
397,2021-02-11,UMB,839,348,491,834,5,0,ITI,ITI2,10,Umbria,Umbria,882015,725889,82.3,0.1
398,2021-05-22,UMB,6984,2762,4222,2603,4332,49,ITI,ITI2,10,Umbria,Umbria,882015,732873,83.09,0.79
399,2021-06-06,UMB,7610,3906,3704,6790,694,126,ITI,ITI2,10,Umbria,Umbria,882015,740483,83.95,0.86
400,2021-02-24,UMB,1521,564,957,1506,15,0,ITI,ITI2,10,Umbria,Umbria,882015,742004,84.13,0.17
401,2021-08-18,UMB,4698,2457,2241,3434,1146,118,ITI,ITI2,10,Umbria,Umbria,882015,746702,84.66,0.53
402,2021-07-06,UMB,8600,4093,4507,149,8428,23,ITI,ITI2,10,Umbria,Umbria,882015,755302,85.63,0.98
403,2021-05-10,UMB,6012,2814,3198,3743,2152,117,ITI,ITI2,10,Umbria,Umbria,882015,761314,86.32,0.68
404,2021-05-08,UMB,8162,3749,4413,4806,3250,106,ITI,ITI2,10,Umbria,Umbria,882015,769476,87.24,0.93
405,2021-01-28,UMB,1248,394,854,18,1230,0,ITI,ITI2,10,Umbria,Umbria,882015,770724,87.38,0.14
406,2021-05-03,UMB,5091,2273,2818,2099,2888,104,ITI,ITI2,10,Umbria,Umbria,882015,775815,87.96,0.58
407,2021-01-23,UMB,280,100,180,2,278,0,ITI,ITI2,10,Umbria,Umbria,882015,776095,87.99,0.03
408,2021-01-21,UMB,609,203,406,339,269,1,ITI,ITI2,10,Umbria,Umbria,882015,776704,88.06,0.07
409,2021-08-20,UMB,4342,2312,2030,2920,1278,144,ITI,ITI2,10,Umbria,Umbria,882015,781046,88.55,0.49
410,2021-02-12,UMB,673,224,449,667,6,0,ITI,ITI2,10,Umbria,Umbria,882015,781719,88.63,0.08
411,2021-02-26,UMB,660,253,407,650,8,2,ITI,ITI2,10,Umbria,Umbria,882015,782379,88.7,0.07
412,2021-05-06,UMB,9474,4326,5148,6028,3316,130,ITI,ITI2,10,Umbria,Umbria,882015,791853,89.78,1.07
413,2021-09-01,UMB,4593,2367,2226,1135,3400,58,ITI,ITI2,10,Umbria,Umbria,882015,796446,90.3,0.52
414,2021-06-10,UMB,7567,3769,3798,6463,789,315,ITI,ITI2,10,Umbria,Umbria,882015,804013,91.16,0.86
415,2021-08-13,UMB,6967,3868,3099,4245,2524,198,ITI,ITI2,10,Umbria,Umbria,882015,810980,91.95,0.79
416,2021-09-06,UMB,4576,2385,2191,894,3645,37,ITI,ITI2,10,Umbria,Umbria,882015,815556,92.47,0.52
417,2021-07-25,UMB,7310,3852,3458,1167,6099,44,ITI,ITI2,10,Umbria,Umbria,882015,822866,93.29,0.83
418,2021-08-23,UMB,5290,2820,2470,1543,3662,85,ITI,ITI2,10,Umbria,Umbria,882015,828156,93.89,0.6
419,2021-06-01,UMB,4389,2090,2299,4161,156,72,ITI,ITI2,10,Umbria,Umbria,882015,832545,94.39,0.5
420,2021-03-10,UMB,4032,1943,2089,2760,1257,15,ITI,ITI2,10,Umbria,Umbria,882015,836577,94.85,0.46
421,2021-01-16,UMB,204,61,143,203,0,1,ITI,ITI2,10,Umbria,Umbria,882015,836781,94.87,0.02
422,2021-02-02,UMB,945,272,673,32,913,0,ITI,ITI2,10,Umbria,Umbria,882015,837726,94.98,0.11
423,2021-04-26,UMB,5402,2342,3060,3105,2255,42,ITI,ITI2,10,Umbria,Umbria,882015,843128,95.59,0.61
424,2021-04-09,UMB,6749,3130,3619,6411,216,122,ITI,ITI2,10,Umbria,Umbria,882015,849877,96.36,0.77
425,2021-01-29,UMB,1240,350,890,79,1161,0,ITI,ITI2,10,Umbria,Umbria,882015,851117,96.5,0.14
426,2021-05-09,UMB,5764,2756,3008,5253,391,120,ITI,ITI2,10,Umbria,Umbria,882015,856881,97.15,0.65
427,2021-09-04,UMB,3433,1775,1658,1099,2272,62,ITI,ITI2,10,Umbria,Umbria,882015,860314,97.54,0.39
428,2021-07-09,UMB,9569,4631,4938,128,9417,24,ITI,ITI2,10,Umbria,Umbria,882015,869883,98.62,1.08
429,2021-07-23,UMB,10664,5453,5211,1333,9225,106,ITI,ITI2,10,Umbria,Umbria,882015,880547,99.83,1.21
430,2021-07-11,UMB,5875,2967,2908,89,5785,1,ITI,ITI2,10,Umbria,Umbria,882015,886422,100.5,0.67
431,2021-04-02,UMB,4349,1782,2567,3548,756,45,ITI,ITI2,10,Umbria,Umbria,882015,890771,100.99,0.49
432,2021-01-09,UMB,1718,495,1223,1718,0,0,ITI,ITI2,10,Umbria,Umbria,882015,892489,101.19,0.19
433,2021-04-19,UMB,5038,2228,2810,2932,2048,58,ITI,ITI2,10,Umbria,Umbria,882015,897527,101.76,0.57
434,2021-02-05,UMB,783,234,549,18,765,0,ITI,ITI2,10,Umbria,Umbria,882015,898310,101.85,0.09
435,2021-07-21,UMB,9856,4914,4942,1233,8536,87,ITI,ITI2,10,Umbria,Umbria,882015,908166,102.96,1.12
436,2021-07-04,UMB,3411,1741,1670,2342,971,98,ITI,ITI2,10,Umbria,Umbria,882015,911577,103.35,0.39
437,2021-04-12,UMB,7093,3081,4012,5316,1717,60,ITI,ITI2,10,Umbria,Umbria,882015,918670,104.16,0.8
438,2021-01-19,UMB,102,23,79,102,0,0,ITI,ITI2,10,Umbria,Umbria,882015,918772,104.17,0.01
439,2021-04-29,UMB,5240,2261,2979,2806,2343,91,ITI,ITI2,10,Umbria,Umbria,882015,924012,104.76,0.59
440,2021-03-24,UMB,4108,1794,2314,2746,1323,39,ITI,ITI2,10,Umbria,Umbria,882015,928120,105.23,0.47
441,2021-07-02,UMB,8757,4331,4426,2968,5609,180,ITI,ITI2,10,Umbria,Umbria,882015,936877,106.22,0.99
442,2021-04-10,UMB,7404,3481,3923,7183,86,135,ITI,ITI2,10,Umbria,Umbria,882015,944281,107.06,0.84
443,2021-01-17,UMB,55,17,38,55,0,0,ITI,ITI2,10,Umbria,Umbria,882015,944336,107.07,0.01
444,2020-12-31,UMB,322,127,195,322,0,0,ITI,ITI2,10,Umbria,Umbria,882015,944658,107.1,0.04
445,2021-06-15,UMB,5991,3016,2975,3797,2075,119,ITI,ITI2,10,Umbria,Umbria,882015,950649,107.78,0.68
446,2021-08-28,UMB,2769,1428,1341,1356,1342,71,ITI,ITI2,10,Umbria,Umbria,882015,953418,108.1,0.31
447,2021-07-16,UMB,9630,4899,4731,667,8884,79,ITI,ITI2,10,Umbria,Umbria,882015,963048,109.19,1.09
448,2021-05-20,UMB,9872,4609,5263,6105,3657,110,ITI,ITI2,10,Umbria,Umbria,882015,972920,110.31,1.12
449,2021-03-31,UMB,3900,1730,2170,2183,1685,32,ITI,ITI2,10,Umbria,Umbria,882015,976820,110.75,0.44
450,2021-02-16,UMB,1308,655,653,1299,9,0,ITI,ITI2,10,Umbria,Umbria,882015,978128,110.9,0.15
451,2021-05-27,UMB,9982,4871,5111,8475,1325,182,ITI,ITI2,10,Umbria,Umbria,882015,988110,112.03,1.13
452,2021-01-04,UMB,810,397,413,810,0,0,ITI,ITI2,10,Umbria,Umbria,882015,988920,112.12,0.09
453,2021-04-14,UMB,8159,3682,4477,6100,1980,79,ITI,ITI2,10,Umbria,Umbria,882015,997079,113.05,0.93
454,2021-04-28,UMB,5394,2332,3062,2939,2398,57,ITI,ITI2,10,Umbria,Umbria,882015,1002473,113.66,0.61
455,2021-08-06,UMB,8239,4308,3931,3329,4822,88,ITI,ITI2,10,Umbria,Umbria,882015,1010712,114.59,0.93
456,2021-02-04,UMB,736,226,510,26,710,0,ITI,ITI2,10,Umbria,Umbria,882015,1011448,114.67,0.08
457,2021-05-15,UMB,4997,1886,3111,1765,3168,64,ITI,ITI2,10,Umbria,Umbria,882015,1016445,115.24,0.57
458,2021-02-21,UMB,1,0,1,1,0,0,ITI,ITI2,10,Umbria,Umbria,882015,1016446,115.24,0.0
459,2021-07-13,UMB,4235,2006,2229,78,4149,8,ITI,ITI2,10,Umbria,Umbria,882015,1020681,115.72,0.48
460,2021-04-21,UMB,5332,2320,3012,3061,2232,39,ITI,ITI2,10,Umbria,Umbria,882015,1026013,116.33,0.6
461,2021-07-30,UMB,6219,3243,2976,3186,2913,120,ITI,ITI2,10,Umbria,Umbria,882015,1032232,117.03,0.71
462,2021-03-02,UMB,3646,1346,2300,3637,6,3,ITI,ITI2,10,Umbria,Umbria,882015,1035878,117.44,0.41
463,2021-06-24,UMB,10268,5169,5099,6027,4012,229,ITI,ITI2,10,Umbria,Umbria,882015,1046146,118.61,1.16
464,2021-06-17,UMB,6979,3545,3434,4752,2081,146,ITI,ITI2,10,Umbria,Umbria,882015,1053125,119.4,0.79
465,2021-03-26,UMB,4602,1721,2881,4345,173,84,ITI,ITI2,10,Umbria,Umbria,882015,1057727,119.92,0.52
466,2021-01-02,UMB,304,111,193,304,0,0,ITI,ITI2,10,Umbria,Umbria,882015,1058031,119.96,0.03
467,2021-03-07,UMB,846,180,666,838,7,1,ITI,ITI2,10,Umbria,Umbria,882015,1058877,120.05,0.1
468,2021-09-08,UMB,4551,2434,2117,976,3504,71,ITI,ITI2,10,Umbria,Umbria,882015,1063428,120.57,0.52
469,2021-05-29,UMB,7862,3614,4248,6177,1571,114,ITI,ITI2,10,Umbria,Umbria,882015,1071290,121.46,0.89
470,2021-06-03,UMB,9050,4474,4576,8585,290,175,ITI,ITI2,10,Umbria,Umbria,882015,1080340,122.49,1.03
471,2021-04-07,UMB,5626,2305,3321,3534,2006,86,ITI,ITI2,10,Umbria,Umbria,882015,1085966,123.12,0.64
472,2021-02-23,UMB,1691,657,1034,1648,42,1,ITI,ITI2,10,Umbria,Umbria,882015,1087657,123.32,0.19
473,2021-07-26,UMB,9090,4803,4287,3875,5088,127,ITI,ITI2,10,Umbria,Umbria,882015,1096747,124.35,1.03
474,2021-05-28,UMB,9600,4440,5160,7116,2300,184,ITI,ITI2,10,Umbria,Umbria,882015,1106347,125.43,1.09
475,2021-04-15,UMB,7665,3505,4160,5703,1889,73,ITI,ITI2,10,Umbria,Umbria,882015,1114012,126.3,0.87
476,2021-02-17,UMB,1619,748,871,1266,352,1,ITI,ITI2,10,Umbria,Umbria,882015,1115631,126.49,0.18
477,2021-07-24,UMB,8698,4368,4330,1346,7284,68,ITI,ITI2,10,Umbria,Umbria,882015,1124329,127.47,0.99
478,2021-04-13,UMB,7683,3402,4281,5924,1669,90,ITI,ITI2,10,Umbria,Umbria,882015,1132012,128.34,0.87
479,2021-02-15,UMB,1367,692,675,1364,1,2,ITI,ITI2,10,Umbria,Umbria,882015,1133379,128.5,0.15
480,2021-01-03,UMB,270,112,158,270,0,0,ITI,ITI2,10,Umbria,Umbria,882015,1133649,128.53,0.03
481,2021-07-31,UMB,4334,2262,2072,1478,2809,47,ITI,ITI2,10,Umbria,Umbria,882015,1137983,129.02,0.49
482,2021-04-22,UMB,5458,2251,3207,2702,2674,82,ITI,ITI2,10,Umbria,Umbria,882015,1143441,129.64,0.62
483,2021-04-17,UMB,6696,3077,3619,5186,1343,167,ITI,ITI2,10,Umbria,Umbria,882015,1150137,130.4,0.76
484,2021-01-05,UMB,855,430,425,855,0,0,ITI,ITI2,10,Umbria,Umbria,882015,1150992,130.5,0.1
485,2021-08-02,UMB,5537,2897,2640,259,5256,22,ITI,ITI2,10,Umbria,Umbria,882015,1156529,131.12,0.63
486,2021-06-20,UMB,6225,3007,3218,1577,4605,43,ITI,ITI2,10,Umbria,Umbria,882015,1162754,131.83,0.71
487,2021-04-24,UMB,4566,1962,2604,3277,1183,106,ITI,ITI2,10,Umbria,Umbria,882015,1167320,132.35,0.52
488,2021-01-12,UMB,838,247,591,838,0,0,ITI,ITI2,10,Umbria,Umbria,882015,1168158,132.44,0.1
489,2021-03-14,UMB,66,48,18,66,0,0,ITI,ITI2,10,Umbria,Umbria,882015,1168224,132.45,0.01
490,2021-06-22,UMB,8091,4105,3986,5146,2800,145,ITI,ITI2,10,Umbria,Umbria,882015,1176315,133.37,0.92
491,2021-03-12,UMB,2695,1082,1613,2191,496,8,ITI,ITI2,10,Umbria,Umbria,882015,1179010,133.67,0.31
492,2021-03-21,UMB,676,338,338,673,0,3,ITI,ITI2,10,Umbria,Umbria,882015,1179686,133.75,0.08
493,2021-08-25,UMB,4286,2230,2056,1542,2664,80,ITI,ITI2,10,Umbria,Umbria,882015,1183972,134.23,0.49
494,2021-06-29,UMB,9974,5083,4891,4112,5702,160,ITI,ITI2,10,Umbria,Umbria,882015,1193946,135.37,1.13
495,2021-05-17,UMB,6379,3068,3311,4113,2180,86,ITI,ITI2,10,Umbria,Umbria,882015,1200325,136.09,0.72
496,2021-01-14,UMB,725,192,533,725,0,0,ITI,ITI2,10,Umbria,Umbria,882015,1201050,136.17,0.08
497,2021-03-19,UMB,1744,566,1178,1083,656,5,ITI,ITI2,10,Umbria,Umbria,882015,1202794,136.37,0.2
498,2021-08-27,TOS,16273,8698,7575,7744,8002,527,ITI,ITI1,9,Toscana,Toscana,3729641,16273,0.44,0.44
499,2021-01-28,TOS,6288,1884,4404,349,5932,7,ITI,ITI1,9,Toscana,Toscana,3729641,22561,0.6,0.17
500,2021-01-16,TOS,3298,1059,2239,3240,0,58,ITI,ITI1,9,Toscana,Toscana,3729641,25859,0.69,0.09
501,2021-04-26,TOS,10149,4936,5213,7456,2557,136,ITI,ITI1,9,Toscana,Toscana,3729641,36008,0.97,0.27
502,2021-01-02,TOS,3547,1126,2421,3503,0,44,ITI,ITI1,9,Toscana,Toscana,3729641,39555,1.06,0.1
503,2021-09-08,TOS,20853,10834,10019,7069,13057,727,ITI,ITI1,9,Toscana,Toscana,3729641,60408,1.62,0.56
504,2021-07-01,TOS,32084,15534,16550,10722,21080,282,ITI,ITI1,9,Toscana,Toscana,3729641,92492,2.48,0.86
505,2021-03-26,TOS,20752,9435,11317,14711,5830,211,ITI,ITI1,9,Toscana,Toscana,3729641,113244,3.04,0.56
506,2021-03-09,TOS,11176,4585,6591,5531,5565,80,ITI,ITI1,9,Toscana,Toscana,3729641,124420,3.34,0.3
507,2021-04-09,TOS,24611,10590,14021,20717,3444,450,ITI,ITI1,9,Toscana,Toscana,3729641,149031,4.0,0.66
508,2021-07-18,TOS,30389,15280,15109,8338,21841,210,ITI,ITI1,9,Toscana,Toscana,3729641,179420,4.81,0.81
509,2021-06-17,TOS,32619,16711,15908,26710,5564,345,ITI,ITI1,9,Toscana,Toscana,3729641,212039,5.69,0.87
510,2021-07-30,TOS,37914,20405,17509,10791,26766,357,ITI,ITI1,9,Toscana,Toscana,3729641,249953,6.7,1.02
511,2021-07-13,TOS,29346,14735,14611,7713,21457,176,ITI,ITI1,9,Toscana,Toscana,3729641,279299,7.49,0.79
512,2021-04-02,TOS,32015,13579,18436,23682,8078,255,ITI,ITI1,9,Toscana,Toscana,3729641,311314,8.35,0.86
513,2021-06-22,TOS,31062,15631,15431,22463,8219,380,ITI,ITI1,9,Toscana,Toscana,3729641,342376,9.18,0.83
514,2021-05-17,TOS,29782,14883,14899,20559,8945,278,ITI,ITI1,9,Toscana,Toscana,3729641,372158,9.98,0.8
515,2021-03-21,TOS,3296,1629,1667,1819,1434,43,ITI,ITI1,9,Toscana,Toscana,3729641,375454,10.07,0.09
516,2021-08-25,TOS,20292,10599,9693,10594,8972,726,ITI,ITI1,9,Toscana,Toscana,3729641,395746,10.61,0.54
517,2021-01-23,TOS,3982,1361,2621,641,3335,6,ITI,ITI1,9,Toscana,Toscana,3729641,399728,10.72,0.11
518,2021-06-29,TOS,37054,18042,19012,7976,28923,155,ITI,ITI1,9,Toscana,Toscana,3729641,436782,11.71,0.99
519,2021-05-03,TOS,11944,5518,6426,10363,1333,248,ITI,ITI1,9,Toscana,Toscana,3729641,448726,12.03,0.32
520,2021-05-22,TOS,26037,12667,13370,21490,4298,249,ITI,ITI1,9,Toscana,Toscana,3729641,474763,12.73,0.7
521,2021-05-05,TOS,30164,13465,16699,14854,14574,736,ITI,ITI1,9,Toscana,Toscana,3729641,504927,13.54,0.81
522,2021-08-13,TOS,23108,12519,10589,11334,11228,546,ITI,ITI1,9,Toscana,Toscana,3729641,528035,14.16,0.62
523,2021-02-28,TOS,1665,669,996,868,727,70,ITI,ITI1,9,Toscana,Toscana,3729641,529700,14.2,0.04
524,2021-02-11,TOS,5423,2037,3386,5099,242,82,ITI,ITI1,9,Toscana,Toscana,3729641,535123,14.35,0.15
525,2021-02-09,TOS,4534,1485,3049,3809,611,114,ITI,ITI1,9,Toscana,Toscana,3729641,539657,14.47,0.12
526,2021-04-07,TOS,35848,15483,20365,28159,7267,422,ITI,ITI1,9,Toscana,Toscana,3729641,575505,15.43,0.96
527,2021-08-01,TOS,29923,15319,14604,13787,15651,485,ITI,ITI1,9,Toscana,Toscana,3729641,605428,16.23,0.8
528,2021-06-05,TOS,28455,13608,14847,20559,7621,275,ITI,ITI1,9,Toscana,Toscana,3729641,633883,17.0,0.76
529,2021-08-08,TOS,25037,12920,12117,14610,9926,501,ITI,ITI1,9,Toscana,Toscana,3729641,658920,17.67,0.67
530,2021-01-11,TOS,5185,1719,3466,5084,0,101,ITI,ITI1,9,Toscana,Toscana,3729641,664105,17.81,0.14
531,2021-04-21,TOS,29658,12691,16967,16856,12163,639,ITI,ITI1,9,Toscana,Toscana,3729641,693763,18.6,0.8
532,2021-02-23,TOS,7754,3337,4417,7240,162,352,ITI,ITI1,9,Toscana,Toscana,3729641,701517,18.81,0.21
533,2021-06-03,TOS,32066,15457,16609,27152,4589,325,ITI,ITI1,9,Toscana,Toscana,3729641,733583,19.67,0.86
534,2021-08-20,TOS,20215,11087,9128,9959,9759,497,ITI,ITI1,9,Toscana,Toscana,3729641,753798,20.21,0.54
535,2021-03-19,TOS,10175,4475,5700,7131,2896,148,ITI,ITI1,9,Toscana,Toscana,3729641,763973,20.48,0.27
536,2021-01-21,TOS,1593,687,906,862,722,9,ITI,ITI1,9,Toscana,Toscana,3729641,765566,20.53,0.04
537,2021-03-07,TOS,5659,2362,3297,2001,3547,111,ITI,ITI1,9,Toscana,Toscana,3729641,771225,20.68,0.15
538,2021-07-20,TOS,37342,19108,18234,7967,29183,192,ITI,ITI1,9,Toscana,Toscana,3729641,808567,21.68,1.0
539,2021-09-06,TOS,22635,11688,10947,9295,12313,1027,ITI,ITI1,9,Toscana,Toscana,3729641,831202,22.29,0.61
540,2021-02-04,TOS,4264,1597,2667,942,3295,27,ITI,ITI1,9,Toscana,Toscana,3729641,835466,22.4,0.11
541,2021-05-15,TOS,29374,13864,15510,22871,5907,596,ITI,ITI1,9,Toscana,Toscana,3729641,864840,23.19,0.79
542,2021-04-28,TOS,19153,8193,10960,3446,15349,358,ITI,ITI1,9,Toscana,Toscana,3729641,883993,23.7,0.51
543,2021-02-18,TOS,8874,3301,5573,7793,897,184,ITI,ITI1,9,Toscana,Toscana,3729641,892867,23.94,0.24
544,2021-05-29,TOS,31582,15267,16315,23182,8173,227,ITI,ITI1,9,Toscana,Toscana,3729641,924449,24.79,0.85
545,2021-07-11,TOS,26193,12730,13463,9174,16845,174,ITI,ITI1,9,Toscana,Toscana,3729641,950642,25.49,0.7
546,2021-06-24,TOS,29469,14633,14836,19320,9753,396,ITI,ITI1,9,Toscana,Toscana,3729641,980111,26.28,0.79
547,2021-01-09,TOS,4542,1622,2920,4475,0,67,ITI,ITI1,9,Toscana,Toscana,3729641,984653,26.4,0.12
548,2021-09-01,TOS,23563,12397,11166,13362,9162,1039,ITI,ITI1,9,Toscana,Toscana,3729641,1008216,27.03,0.63
549,2021-06-10,TOS,26459,13572,12887,25550,560,349,ITI,ITI1,9,Toscana,Toscana,3729641,1034675,27.74,0.71
550,2021-05-24,TOS,33764,16728,17036,23898,9586,280,ITI,ITI1,9,Toscana,Toscana,3729641,1068439,28.65,0.91
551,2021-06-12,TOS,29406,15158,14248,24658,4393,355,ITI,ITI1,9,Toscana,Toscana,3729641,1097845,29.44,0.79
552,2021-04-16,TOS,29000,12897,16103,21439,6927,634,ITI,ITI1,9,Toscana,Toscana,3729641,1126845,30.21,0.78
553,2021-07-25,TOS,33928,16777,17151,7053,26694,181,ITI,ITI1,9,Toscana,Toscana,3729641,1160773,31.12,0.91
554,2021-03-02,TOS,10600,3795,6805,7039,3447,114,ITI,ITI1,9,Toscana,Toscana,3729641,1171373,31.41,0.28
555,2021-01-04,TOS,5240,1998,3242,5173,0,67,ITI,ITI1,9,Toscana,Toscana,3729641,1176613,31.55,0.14
556,2021-04-14,TOS,20207,8352,11855,14533,5125,549,ITI,ITI1,9,Toscana,Toscana,3729641,1196820,32.09,0.54
557,2021-02-16,TOS,9372,3367,6005,8420,721,231,ITI,ITI1,9,Toscana,Toscana,3729641,1206192,32.34,0.25
558,2021-05-02,TOS,11181,4936,6245,8979,1968,234,ITI,ITI1,9,Toscana,Toscana,3729641,1217373,32.64,0.3
559,2021-03-28,TOS,6211,2807,3404,5875,253,83,ITI,ITI1,9,Toscana,Toscana,3729641,1223584,32.81,0.17
560,2021-01-30,TOS,4625,1623,3002,173,4434,18,ITI,ITI1,9,Toscana,Toscana,3729641,1228209,32.93,0.12
561,2021-07-06,TOS,25797,13040,12757,11039,14530,228,ITI,ITI1,9,Toscana,Toscana,3729641,1254006,33.62,0.69
562,2021-05-10,TOS,26242,12417,13825,15247,10648,347,ITI,ITI1,9,Toscana,Toscana,3729641,1280248,34.33,0.7
563,2021-03-14,TOS,7190,2577,4613,3162,3935,93,ITI,ITI1,9,Toscana,Toscana,3729641,1287438,34.52,0.19
564,2021-08-18,TOS,25946,13819,12127,12841,12501,604,ITI,ITI1,9,Toscana,Toscana,3729641,1313384,35.21,0.7
565,2021-06-02,TOS,27613,13632,13981,21867,5512,234,ITI,ITI1,9,Toscana,Toscana,3729641,1340997,35.96,0.74
566,2021-04-06,TOS,22252,9843,12409,18091,3742,419,ITI,ITI1,9,Toscana,Toscana,3729641,1363249,36.55,0.6
567,2021-02-08,TOS,4132,1372,2760,3561,459,112,ITI,ITI1,9,Toscana,Toscana,3729641,1367381,36.66,0.11
568,2021-07-15,TOS,31260,15298,15962,8088,22924,248,ITI,ITI1,9,Toscana,Toscana,3729641,1398641,37.5,0.84
569,2021-05-19,TOS,27978,13589,14389,18644,9067,267,ITI,ITI1,9,Toscana,Toscana,3729641,1426619,38.25,0.75
570,2021-04-13,TOS,8504,3513,4991,5740,2481,283,ITI,ITI1,9,Toscana,Toscana,3729641,1435123,38.48,0.23
571,2021-08-22,TOS,18522,9965,8557,7303,10903,316,ITI,ITI1,9,Toscana,Toscana,3729641,1453645,38.98,0.5
572,2021-02-20,TOS,4724,1815,2909,4051,537,136,ITI,ITI1,9,Toscana,Toscana,3729641,1458369,39.1,0.13
573,2021-05-31,TOS,30358,14651,15707,19267,10849,242,ITI,ITI1,9,Toscana,Toscana,3729641,1488727,39.92,0.81
574,2021-05-14,TOS,33404,15461,17943,20022,12740,642,ITI,ITI1,9,Toscana,Toscana,3729641,1522131,40.81,0.9
575,2021-01-01,TOS,2410,814,1596,2364,0,46,ITI,ITI1,9,Toscana,Toscana,3729641,1524541,40.88,0.06
576,2021-04-11,TOS,3641,1680,1961,3331,155,155,ITI,ITI1,9,Toscana,Toscana,3729641,1528182,40.97,0.1
577,2021-07-03,TOS,29431,14827,14604,11872,17174,385,ITI,ITI1,9,Toscana,Toscana,3729641,1557613,41.76,0.79
578,2021-08-07,TOS,30473,16295,14178,14216,15770,487,ITI,ITI1,9,Toscana,Toscana,3729641,1588086,42.58,0.82
579,2021-03-06,TOS,7137,2859,4278,2849,4203,85,ITI,ITI1,9,Toscana,Toscana,3729641,1595223,42.77,0.19
580,2021-08-06,TOS,32963,17674,15289,15346,17140,477,ITI,ITI1,9,Toscana,Toscana,3729641,1628186,43.66,0.88
581,2021-03-23,TOS,9446,4411,5035,6959,2288,199,ITI,ITI1,9,Toscana,Toscana,3729641,1637632,43.91,0.25
582,2020-12-30,TOS,328,105,223,327,0,1,ITI,ITI1,9,Toscana,Toscana,3729641,1637960,43.92,0.01
583,2021-08-24,TOS,21881,11475,10406,12723,8294,864,ITI,ITI1,9,Toscana,Toscana,3729641,1659841,44.5,0.59
584,2021-08-05,TOS,34750,18022,16728,12126,22251,373,ITI,ITI1,9,Toscana,Toscana,3729641,1694591,45.44,0.93
585,2021-05-12,TOS,34232,15590,18642,13584,20062,586,ITI,ITI1,9,Toscana,Toscana,3729641,1728823,46.35,0.92
586,2021-01-18,TOS,1127,639,488,979,98,50,ITI,ITI1,9,Toscana,Toscana,3729641,1729950,46.38,0.03
587,2021-02-01,TOS,5524,1962,3562,520,4994,10,ITI,ITI1,9,Toscana,Toscana,3729641,1735474,46.53,0.15
588,2021-03-18,TOS,9993,3987,6006,5865,3989,139,ITI,ITI1,9,Toscana,Toscana,3729641,1745467,46.8,0.27
589,2021-06-26,TOS,34580,16774,17806,9991,24357,232,ITI,ITI1,9,Toscana,Toscana,3729641,1780047,47.73,0.93
590,2021-06-09,TOS,34853,17585,17268,33960,463,430,ITI,ITI1,9,Toscana,Toscana,3729641,1814900,48.66,0.93
591,2021-04-04,TOS,13928,6613,7315,13508,255,165,ITI,ITI1,9,Toscana,Toscana,3729641,1828828,49.03,0.37
592,2021-07-22,TOS,39403,19804,19599,4485,34750,168,ITI,ITI1,9,Toscana,Toscana,3729641,1868231,50.09,1.06
593,2021-05-26,TOS,35625,17118,18507,20149,15220,256,ITI,ITI1,9,Toscana,Toscana,3729641,1903856,51.05,0.96
594,2021-03-30,TOS,17039,7644,9395,13267,3574,198,ITI,ITI1,9,Toscana,Toscana,3729641,1920895,51.5,0.46
595,2021-09-03,TOS,14147,7391,6756,7537,5905,705,ITI,ITI1,9,Toscana,Toscana,3729641,1935042,51.88,0.38
596,2021-07-08,TOS,21096,10371,10725,9267,11588,241,ITI,ITI1,9,Toscana,Toscana,3729641,1956138,52.45,0.57
597,2021-08-10,TOS,25934,13491,12443,16354,8933,647,ITI,ITI1,9,Toscana,Toscana,3729641,1982072,53.14,0.7
598,2021-02-25,TOS,10648,4315,6333,9484,995,169,ITI,ITI1,9,Toscana,Toscana,3729641,1992720,53.43,0.29
599,2021-06-28,TOS,37707,18146,19561,8438,29100,169,ITI,ITI1,9,Toscana,Toscana,3729641,2030427,54.44,1.01
600,2021-01-20,TOS,1346,644,702,1034,249,63,ITI,ITI1,9,Toscana,Toscana,3729641,2031773,54.48,0.04
601,2021-04-30,TOS,40252,17813,22439,19652,19954,646,ITI,ITI1,9,Toscana,Toscana,3729641,2072025,55.56,1.08
602,2021-01-25,TOS,5136,1895,3241,243,4889,4,ITI,ITI1,9,Toscana,Toscana,3729641,2077161,55.69,0.14
603,2021-04-18,TOS,8372,4097,4275,7061,1035,276,ITI,ITI1,9,Toscana,Toscana,3729641,2085533,55.92,0.22
604,2021-07-27,TOS,38739,20142,18597,11272,27118,349,ITI,ITI1,9,Toscana,Toscana,3729641,2124272,56.96,1.04
605,2021-07-10,TOS,29317,14188,15129,7953,21174,190,ITI,ITI1,9,Toscana,Toscana,3729641,2153589,57.74,0.79
606,2021-05-07,TOS,32189,14720,17469,11350,20226,613,ITI,ITI1,9,Toscana,Toscana,3729641,2185778,58.61,0.86
607,2021-08-15,TOS,14689,7761,6928,5269,9236,184,ITI,ITI1,9,Toscana,Toscana,3729641,2200467,59.0,0.39
608,2021-07-29,TOS,39411,20529,18882,12609,26455,347,ITI,ITI1,9,Toscana,Toscana,3729641,2239878,60.06,1.06
609,2021-02-13,TOS,7869,2390,5479,7493,227,149,ITI,ITI1,9,Toscana,Toscana,3729641,2247747,60.27,0.21
610,2021-08-21,TOS,17982,9956,8026,8146,9458,378,ITI,ITI1,9,Toscana,Toscana,3729641,2265729,60.75,0.48
611,2021-02-03,TOS,4227,1452,2775,236,3987,4,ITI,ITI1,9,Toscana,Toscana,3729641,2269956,60.86,0.11
612,2021-01-15,TOS,3916,1362,2554,3856,0,60,ITI,ITI1,9,Toscana,Toscana,3729641,2273872,60.97,0.1
613,2021-04-25,TOS,11067,5252,5815,8760,2146,161,ITI,ITI1,9,Toscana,Toscana,3729641,2284939,61.26,0.3
614,2021-08-03,TOS,36350,18924,17426,12167,23805,378,ITI,ITI1,9,Toscana,Toscana,3729641,2321289,62.24,0.97
615,2021-01-13,TOS,4126,1423,2703,4061,0,65,ITI,ITI1,9,Toscana,Toscana,3729641,2325415,62.35,0.11
616,2021-04-23,TOS,25683,11433,14250,8799,16353,531,ITI,ITI1,9,Toscana,Toscana,3729641,2351098,63.04,0.69
617,2020-12-27,TOS,629,275,354,624,0,5,ITI,ITI1,9,Toscana,Toscana,3729641,2351727,63.06,0.02
618,2021-08-02,TOS,35306,18088,17218,13357,21556,393,ITI,ITI1,9,Toscana,Toscana,3729641,2387033,64.0,0.95
619,2021-01-03,TOS,3364,1070,2294,3317,0,47,ITI,ITI1,9,Toscana,Toscana,3729641,2390397,64.09,0.09
620,2021-02-15,TOS,8866,3407,5459,7866,828,172,ITI,ITI1,9,Toscana,Toscana,3729641,2399263,64.33,0.24
621,2021-04-27,TOS,10377,4927,5450,3667,6506,204,ITI,ITI1,9,Toscana,Toscana,3729641,2409640,64.61,0.28
622,2021-07-19,TOS,38039,18960,19079,8808,28941,290,ITI,ITI1,9,Toscana,Toscana,3729641,2447679,65.63,1.02
623,2021-01-17,TOS,2542,871,1671,1993,514,35,ITI,ITI1,9,Toscana,Toscana,3729641,2450221,65.7,0.07
624,2021-07-05,TOS,30532,15095,15437,10342,19959,231,ITI,ITI1,9,Toscana,Toscana,3729641,2480753,66.51,0.82
625,2021-03-08,TOS,6742,2960,3782,1865,4830,47,ITI,ITI1,9,Toscana,Toscana,3729641,2487495,66.7,0.18
626,2021-06-16,TOS,31800,16280,15520,26287,5189,324,ITI,ITI1,9,Toscana,Toscana,3729641,2519295,67.55,0.85
627,2021-05-30,TOS,28706,13958,14748,21510,6954,242,ITI,ITI1,9,Toscana,Toscana,3729641,2548001,68.32,0.77
628,2021-09-07,TOS,18896,9782,9114,6717,11547,632,ITI,ITI1,9,Toscana,Toscana,3729641,2566897,68.82,0.51
629,2021-09-02,TOS,18067,9423,8644,11046,6107,914,ITI,ITI1,9,Toscana,Toscana,3729641,2584964,69.31,0.48
630,2021-03-20,TOS,6593,2979,3614,5363,1139,91,ITI,ITI1,9,Toscana,Toscana,3729641,2591557,69.49,0.18
631,2021-01-22,TOS,2867,1064,1803,526,2338,3,ITI,ITI1,9,Toscana,Toscana,3729641,2594424,69.56,0.08
632,2021-07-07,TOS,25645,12608,13037,9333,16120,192,ITI,ITI1,9,Toscana,Toscana,3729641,2620069,70.25,0.69
633,2021-01-08,TOS,6063,1695,4368,5970,0,93,ITI,ITI1,9,Toscana,Toscana,3729641,2626132,70.41,0.16
634,2021-07-12,TOS,28288,14008,14280,9665,18319,304,ITI,ITI1,9,Toscana,Toscana,3729641,2654420,71.17,0.76
635,2021-04-01,TOS,27168,11271,15897,16192,10734,242,ITI,ITI1,9,Toscana,Toscana,3729641,2681588,71.9,0.73
636,2021-03-15,TOS,8703,3646,5057,4080,4449,174,ITI,ITI1,9,Toscana,Toscana,3729641,2690291,72.13,0.23
637,2021-06-23,TOS,31583,15316,16267,19822,11397,364,ITI,ITI1,9,Toscana,Toscana,3729641,2721874,72.98,0.85
638,2021-02-22,TOS,9891,4276,5615,9237,277,377,ITI,ITI1,9,Toscana,Toscana,3729641,2731765,73.24,0.27
639,2021-05-08,TOS,29191,13132,16059,13263,15527,401,ITI,ITI1,9,Toscana,Toscana,3729641,2760956,74.03,0.78
640,2021-03-12,TOS,17049,6645,10404,13322,3532,195,ITI,ITI1,9,Toscana,Toscana,3729641,2778005,74.48,0.46
641,2021-08-16,TOS,30000,15749,14251,16597,12700,703,ITI,ITI1,9,Toscana,Toscana,3729641,2808005,75.29,0.8
642,2021-01-14,TOS,3285,1186,2099,3249,0,36,ITI,ITI1,9,Toscana,Toscana,3729641,2811290,75.38,0.09
643,2021-06-20,TOS,25189,12490,12699,15423,9523,243,ITI,ITI1,9,Toscana,Toscana,3729641,2836479,76.05,0.68
644,2021-04-24,TOS,13449,6174,7275,5620,7460,369,ITI,ITI1,9,Toscana,Toscana,3729641,2849928,76.41,0.36
645,2021-03-16,TOS,4924,1889,3035,2584,2259,81,ITI,ITI1,9,Toscana,Toscana,3729641,2854852,76.54,0.13
646,2021-02-27,TOS,2000,763,1237,1019,903,78,ITI,ITI1,9,Toscana,Toscana,3729641,2856852,76.6,0.05
647,2021-06-07,TOS,34980,17164,17816,30977,3655,348,ITI,ITI1,9,Toscana,Toscana,3729641,2891832,77.54,0.94
648,2021-05-21,TOS,28960,13503,15457,17228,11475,257,ITI,ITI1,9,Toscana,Toscana,3729641,2920792,78.31,0.78
649,2021-08-29,TOS,16872,8911,7961,7469,8830,573,ITI,ITI1,9,Toscana,Toscana,3729641,2937664,78.77,0.45
650,2021-09-05,TOS,15147,8037,7110,6345,8278,524,ITI,ITI1,9,Toscana,Toscana,3729641,2952811,79.17,0.41
651,2021-02-06,TOS,4539,1555,2984,1270,3236,33,ITI,ITI1,9,Toscana,Toscana,3729641,2957350,79.29,0.12
652,2021-07-17,TOS,27760,14344,13416,8963,18556,241,ITI,ITI1,9,Toscana,Toscana,3729641,2985110,80.04,0.74
653,2021-07-04,TOS,31549,15321,16228,9361,21889,299,ITI,ITI1,9,Toscana,Toscana,3729641,3016659,80.88,0.85
654,2020-12-31,TOS,802,201,601,798,0,4,ITI,ITI1,9,Toscana,Toscana,3729641,3017461,80.9,0.02
655,2021-04-10,TOS,11714,5345,6369,10734,742,238,ITI,ITI1,9,Toscana,Toscana,3729641,3029175,81.22,0.31
656,2021-03-27,TOS,8866,4156,4710,8512,216,138,ITI,ITI1,9,Toscana,Toscana,3729641,3038041,81.46,0.24
657,2021-06-30,TOS,38286,18525,19761,8462,29604,220,ITI,ITI1,9,Toscana,Toscana,3729641,3076327,82.48,1.03
658,2021-02-14,TOS,9063,2587,6476,8800,110,153,ITI,ITI1,9,Toscana,Toscana,3729641,3085390,82.73,0.24
659,2021-05-25,TOS,34210,16517,17693,19293,14644,273,ITI,ITI1,9,Toscana,Toscana,3729641,3119600,83.64,0.92
660,2021-03-29,TOS,9686,4843,4843,9201,350,135,ITI,ITI1,9,Toscana,Toscana,3729641,3129286,83.9,0.26
661,2021-05-27,TOS,28382,13212,15170,13279,14882,221,ITI,ITI1,9,Toscana,Toscana,3729641,3157668,84.66,0.76
662,2021-03-31,TOS,32797,13291,19506,20202,12252,343,ITI,ITI1,9,Toscana,Toscana,3729641,3190465,85.54,0.88
663,2021-09-04,TOS,16660,8910,7750,7536,8361,763,ITI,ITI1,9,Toscana,Toscana,3729641,3207125,85.99,0.45
664,2021-07-09,TOS,29143,14117,15026,7693,21254,196,ITI,ITI1,9,Toscana,Toscana,3729641,3236268,86.77,0.78
665,2021-03-22,TOS,5261,2771,2490,4676,448,137,ITI,ITI1,9,Toscana,Toscana,3729641,3241529,86.91,0.14
666,2021-06-18,TOS,30829,16268,14561,25004,5411,414,ITI,ITI1,9,Toscana,Toscana,3729641,3272358,87.74,0.83
667,2021-03-25,TOS,23988,10409,13579,15319,8407,262,ITI,ITI1,9,Toscana,Toscana,3729641,3296346,88.38,0.64
668,2021-04-12,TOS,2631,1195,1436,1806,656,169,ITI,ITI1,9,Toscana,Toscana,3729641,3298977,88.45,0.07
669,2021-07-21,TOS,38514,19657,18857,7345,30934,235,ITI,ITI1,9,Toscana,Toscana,3729641,3337491,89.49,1.03
670,2021-05-13,TOS,35200,15548,19652,13204,21355,641,ITI,ITI1,9,Toscana,Toscana,3729641,3372691,90.43,0.94
671,2021-08-04,TOS,34853,18032,16821,11356,23078,419,ITI,ITI1,9,Toscana,Toscana,3729641,3407544,91.36,0.93
672,2021-04-29,TOS,39390,17744,21646,18562,20164,664,ITI,ITI1,9,Toscana,Toscana,3729641,3446934,92.42,1.06
673,2021-03-24,TOS,20045,8315,11730,10411,9490,144,ITI,ITI1,9,Toscana,Toscana,3729641,3466979,92.96,0.54
674,2021-02-21,TOS,5165,2104,3061,4790,170,205,ITI,ITI1,9,Toscana,Toscana,3729641,3472144,93.1,0.14
675,2021-06-01,TOS,26966,13400,13566,22874,3838,254,ITI,ITI1,9,Toscana,Toscana,3729641,3499110,93.82,0.72
676,2021-06-27,TOS,33309,16080,17229,5914,27261,134,ITI,ITI1,9,Toscana,Toscana,3729641,3532419,94.71,0.89
677,2021-05-01,TOS,23341,10071,13270,13728,9228,385,ITI,ITI1,9,Toscana,Toscana,3729641,3555760,95.34,0.63
678,2021-03-05,TOS,16904,6695,10209,11961,4761,182,ITI,ITI1,9,Toscana,Toscana,3729641,3572664,95.79,0.45
679,2021-08-09,TOS,28975,14718,14257,18503,9762,710,ITI,ITI1,9,Toscana,Toscana,3729641,3601639,96.57,0.78
680,2021-06-13,TOS,24622,12355,12267,22600,1659,363,ITI,ITI1,9,Toscana,Toscana,3729641,3626261,97.23,0.66
681,2021-01-10,TOS,3036,1123,1913,2982,0,54,ITI,ITI1,9,Toscana,Toscana,3729641,3629297,97.31,0.08
682,2021-04-20,TOS,18164,8111,10053,12209,5591,364,ITI,ITI1,9,Toscana,Toscana,3729641,3647461,97.8,0.49
683,2021-04-03,TOS,15018,6647,8371,13679,1123,216,ITI,ITI1,9,Toscana,Toscana,3729641,3662479,98.2,0.4
684,2021-01-27,TOS,4837,1575,3262,200,4632,5,ITI,ITI1,9,Toscana,Toscana,3729641,3667316,98.33,0.13
685,2021-08-30,TOS,24777,12533,12244,13119,10532,1126,ITI,ITI1,9,Toscana,Toscana,3729641,3692093,98.99,0.66
686,2021-03-17,TOS,11449,4600,6849,6818,4537,94,ITI,ITI1,9,Toscana,Toscana,3729641,3703542,99.3,0.31
687,2021-06-25,TOS,33653,16832,16821,12106,21264,283,ITI,ITI1,9,Toscana,Toscana,3729641,3737195,100.2,0.9
688,2021-06-08,TOS,32612,16730,15882,31736,491,385,ITI,ITI1,9,Toscana,Toscana,3729641,3769807,101.08,0.87
689,2021-02-26,TOS,10104,3847,6257,8674,1211,219,ITI,ITI1,9,Toscana,Toscana,3729641,3779911,101.35,0.27
690,2021-06-06,TOS,28330,13665,14665,22591,5373,366,ITI,ITI1,9,Toscana,Toscana,3729641,3808241,102.11,0.76
691,2021-06-11,TOS,29762,15500,14262,24735,4661,366,ITI,ITI1,9,Toscana,Toscana,3729641,3838003,102.91,0.8
692,2021-04-15,TOS,24507,10242,14265,15352,8624,531,ITI,ITI1,9,Toscana,Toscana,3729641,3862510,103.56,0.66
693,2021-02-17,TOS,8228,3193,5035,7349,754,125,ITI,ITI1,9,Toscana,Toscana,3729641,3870738,103.78,0.22
694,2021-07-24,TOS,38452,19374,19078,6847,31373,232,ITI,ITI1,9,Toscana,Toscana,3729641,3909190,104.81,1.03
695,2021-08-23,TOS,22740,11812,10928,11471,10540,729,ITI,ITI1,9,Toscana,Toscana,3729641,3931930,105.42,0.61
696,2021-02-19,TOS,8345,2968,5377,7652,513,180,ITI,ITI1,9,Toscana,Toscana,3729641,3940275,105.65,0.22
697,2021-03-01,TOS,4476,1732,2744,766,3643,67,ITI,ITI1,9,Toscana,Toscana,3729641,3944751,105.77,0.12
698,2021-05-23,TOS,28442,13677,14765,25610,2563,269,ITI,ITI1,9,Toscana,Toscana,3729641,3973193,106.53,0.76
699,2021-08-31,TOS,20885,10877,10008,11364,8772,749,ITI,ITI1,9,Toscana,Toscana,3729641,3994078,107.09,0.56
700,2021-08-14,TOS,22387,12220,10167,10457,11511,419,ITI,ITI1,9,Toscana,Toscana,3729641,4016465,107.69,0.6
701,2021-08-12,TOS,25845,13445,12400,14309,10892,644,ITI,ITI1,9,Toscana,Toscana,3729641,4042310,108.38,0.69
702,2021-07-26,TOS,38300,19867,18433,10083,27907,310,ITI,ITI1,9,Toscana,Toscana,3729641,4080610,109.41,1.03
703,2021-02-10,TOS,4315,1309,3006,3633,526,156,ITI,ITI1,9,Toscana,Toscana,3729641,4084925,109.53,0.12
704,2021-05-04,TOS,18329,8220,10109,12415,5469,445,ITI,ITI1,9,Toscana,Toscana,3729641,4103254,110.02,0.49
705,2021-05-28,TOS,30152,13958,16194,17428,12493,231,ITI,ITI1,9,Toscana,Toscana,3729641,4133406,110.83,0.81
706,2021-04-22,TOS,35789,15317,20472,17403,17558,828,ITI,ITI1,9,Toscana,Toscana,3729641,4169195,111.79,0.96
707,2021-02-24,TOS,10408,4489,5919,10070,198,140,ITI,ITI1,9,Toscana,Toscana,3729641,4179603,112.06,0.28
708,2021-07-31,TOS,35841,19214,16627,12372,23019,450,ITI,ITI1,9,Toscana,Toscana,3729641,4215444,113.03,0.96
709,2021-06-04,TOS,28343,13452,14891,20263,7811,269,ITI,ITI1,9,Toscana,Toscana,3729641,4243787,113.79,0.76
710,2021-04-08,TOS,29812,12612,17200,22996,6447,369,ITI,ITI1,9,Toscana,Toscana,3729641,4273599,114.58,0.8
711,2021-03-03,TOS,18233,6538,11695,14496,3609,128,ITI,ITI1,9,Toscana,Toscana,3729641,4291832,115.07,0.49
712,2021-01-05,TOS,5386,1835,3551,5326,0,60,ITI,ITI1,9,Toscana,Toscana,3729641,4297218,115.22,0.14
713,2021-01-19,TOS,1116,535,581,1074,0,42,ITI,ITI1,9,Toscana,Toscana,3729641,4298334,115.25,0.03
714,2021-07-02,TOS,28314,14210,14104,10815,17201,298,ITI,ITI1,9,Toscana,Toscana,3729641,4326648,116.01,0.76
715,2021-06-15,TOS,31236,16079,15157,26313,4574,349,ITI,ITI1,9,Toscana,Toscana,3729641,4357884,116.84,0.84
716,2021-03-10,TOS,18417,7420,10997,14314,3997,106,ITI,ITI1,9,Toscana,Toscana,3729641,4376301,117.34,0.49
717,2021-02-02,TOS,3745,1477,2268,187,3551,7,ITI,ITI1,9,Toscana,Toscana,3729641,4380046,117.44,0.1
718,2021-02-12,TOS,7682,2719,4963,7355,213,114,ITI,ITI1,9,Toscana,Toscana,3729641,4387728,117.64,0.21
719,2021-07-28,TOS,38577,20170,18407,12110,26128,339,ITI,ITI1,9,Toscana,Toscana,3729641,4426305,118.68,1.03
720,2021-01-26,TOS,5400,1795,3605,218,5178,4,ITI,ITI1,9,Toscana,Toscana,3729641,4431705,118.82,0.14
721,2021-05-06,TOS,31437,13674,17763,13452,17290,695,ITI,ITI1,9,Toscana,Toscana,3729641,4463142,119.67,0.84
722,2021-04-19,TOS,9105,4516,4589,7754,1034,317,ITI,ITI1,9,Toscana,Toscana,3729641,4472247,119.91,0.24
723,2021-04-17,TOS,20583,9231,11352,17947,2146,490,ITI,ITI1,9,Toscana,Toscana,3729641,4492830,120.46,0.55
724,2021-01-24,TOS,3349,1072,2277,196,3150,3,ITI,ITI1,9,Toscana,Toscana,3729641,4496179,120.55,0.09
725,2021-01-07,TOS,6179,1839,4340,6091,0,88,ITI,ITI1,9,Toscana,Toscana,3729641,4502358,120.72,0.17
726,2021-08-11,TOS,27064,14193,12871,16911,9416,737,ITI,ITI1,9,Toscana,Toscana,3729641,4529422,121.44,0.73
727,2021-01-12,TOS,3631,1417,2214,3558,0,73,ITI,ITI1,9,Toscana,Toscana,3729641,4533053,121.54,0.1
728,2021-06-14,TOS,31835,16353,15482,27430,4109,296,ITI,ITI1,9,Toscana,Toscana,3729641,4564888,122.39,0.85
729,2021-03-04,TOS,17902,6981,10921,14658,3085,159,ITI,ITI1,9,Toscana,Toscana,3729641,4582790,122.87,0.48
730,2021-08-17,TOS,25990,14021,11969,11458,14035,497,ITI,ITI1,9,Toscana,Toscana,3729641,4608780,123.57,0.7
731,2021-06-21,TOS,31209,15499,15710,18142,12801,266,ITI,ITI1,9,Toscana,Toscana,3729641,4639989,124.41,0.84
732,2021-01-06,TOS,4614,1503,3111,4562,0,52,ITI,ITI1,9,Toscana,Toscana,3729641,4644603,124.53,0.12
733,2021-03-11,TOS,16042,6416,9626,12485,3372,185,ITI,ITI1,9,Toscana,Toscana,3729641,4660645,124.96,0.43
734,2021-06-19,TOS,26524,13930,12594,21394,4791,339,ITI,ITI1,9,Toscana,Toscana,3729641,4687169,125.67,0.71
735,2021-02-05,TOS,5770,2250,3520,1905,3831,34,ITI,ITI1,9,Toscana,Toscana,3729641,4692939,125.83,0.15
736,2021-05-16,TOS,26692,12896,13796,23926,2470,296,ITI,ITI1,9,Toscana,Toscana,3729641,4719631,126.54,0.72
737,2021-05-11,TOS,27972,12997,14975,12102,15490,380,ITI,ITI1,9,Toscana,Toscana,3729641,4747603,127.29,0.75
738,2021-08-19,TOS,24195,12836,11359,11914,11651,630,ITI,ITI1,9,Toscana,Toscana,3729641,4771798,127.94,0.65
739,2021-03-13,TOS,9312,3317,5995,5190,3968,154,ITI,ITI1,9,Toscana,Toscana,3729641,4781110,128.19,0.25
740,2021-07-14,TOS,28964,14296,14668,8607,20099,258,ITI,ITI1,9,Toscana,Toscana,3729641,4810074,128.97,0.78
741,2021-01-29,TOS,6150,1702,4448,290,5848,12,ITI,ITI1,9,Toscana,Toscana,3729641,4816224,129.13,0.16
742,2021-05-09,TOS,22557,9785,12772,9414,12881,262,ITI,ITI1,9,Toscana,Toscana,3729641,4838781,129.74,0.6
743,2021-08-26,TOS,18580,9737,8843,9499,8359,722,ITI,ITI1,9,Toscana,Toscana,3729641,4857361,130.24,0.5
744,2021-07-16,TOS,27684,14049,13635,7703,19727,254,ITI,ITI1,9,Toscana,Toscana,3729641,4885045,130.98,0.74
745,2021-05-20,TOS,29783,13925,15858,18640,10858,285,ITI,ITI1,9,Toscana,Toscana,3729641,4914828,131.78,0.8
746,2021-08-28,TOS,15783,8503,7280,6374,8956,453,ITI,ITI1,9,Toscana,Toscana,3729641,4930611,132.2,0.42
747,2021-01-31,TOS,3052,1131,1921,100,2949,3,ITI,ITI1,9,Toscana,Toscana,3729641,4933663,132.28,0.08
748,2021-04-05,TOS,15288,6826,8462,14371,737,180,ITI,ITI1,9,Toscana,Toscana,3729641,4948951,132.69,0.41
749,2021-02-07,TOS,2818,958,1860,872,1926,20,ITI,ITI1,9,Toscana,Toscana,3729641,4951769,132.77,0.08
750,2021-07-23,TOS,38461,19307,19154,4389,33915,157,ITI,ITI1,9,Toscana,Toscana,3729641,4990230,133.8,1.03
751,2021-05-18,TOS,28852,14281,14571,19765,8834,253,ITI,ITI1,9,Toscana,Toscana,3729641,5019082,134.57,0.77
752,2021-05-12,EMR,38965,18311,20654,28474,9699,792,ITH,ITH5,8,Emilia-Romagna,Emilia-Romagna,4459477,38965,0.87,0.87
753,2021-02-01,EMR,10329,3618,6711,355,9972,2,ITH,ITH5,8,Emilia-Romagna,Emilia-Romagna,4459477,49294,1.11,0.23
754,2021-01-18,EMR,3131,881,2250,2448,680,3,ITH,ITH5,8,Emilia-Romagna,Emilia-Romagna,4459477,52425,1.18,0.07
755,2021-03-16,EMR,12254,5028,7226,4875,7314,65,ITH,ITH5,8,Emilia-Romagna,Emilia-Romagna,4459477,64679,1.45,0.27
756,2021-01-25,EMR,6465,2148,4317,205,6259,1,ITH,ITH5,8,Emilia-Romagna,Emilia-Romagna,4459477,71144,1.6,0.14
757,2021-07-01,EMR,34542,16882,17660,14812,18852,878,ITH,ITH5,8,Emilia-Romagna,Emilia-Romagna,4459477,105686,2.37,0.77
758,2021-03-23,EMR,18799,8146,10653,11946,6689,164,ITH,ITH5,8,Emilia-Romagna,Emilia-Romagna,4459477,124485,2.79,0.42
759,2021-04-16,EMR,29243,13766,15477,20015,8842,386,ITH,ITH5,8,Emilia-Romagna,Emilia-Romagna,4459477,153728,3.45,0.66
760,2021-01-06,EMR,8291,2955,5336,8290,0,1,ITH,ITH5,8,Emilia-Romagna,Emilia-Romagna,4459477,162019,3.63,0.19
761,2021-08-08,EMR,21614,11713,9901,10566,10496,552,ITH,ITH5,8,Emilia-Romagna,Emilia-Romagna,4459477,183633,4.12,0.48
762,2021-04-30,EMR,36657,16808,19849,21238,14809,610,ITH,ITH5,8,Emilia-Romagna,Emilia-Romagna,4459477,220290,4.94,0.82
763,2021-03-28,EMR,13547,6058,7489,9544,3885,118,ITH,ITH5,8,Emilia-Romagna,Emilia-Romagna,4459477,233837,5.24,0.3
764,2021-06-21,EMR,37598,19006,18592,16083,20894,621,ITH,ITH5,8,Emilia-Romagna,Emilia-Romagna,4459477,271435,6.09,0.84
765,2021-07-08,EMR,41353,20601,20752,4728,36207,418,ITH,ITH5,8,Emilia-Romagna,Emilia-Romagna,4459477,312788,7.01,0.93
766,2021-03-30,EMR,23344,10335,13009,17994,5042,308,ITH,ITH5,8,Emilia-Romagna,Emilia-Romagna,4459477,336132,7.54,0.52
767,2021-07-22,EMR,40384,21556,18828,15263,24201,920,ITH,ITH5,8,Emilia-Romagna,Emilia-Romagna,4459477,376516,8.44,0.91
768,2021-01-04,EMR,7313,2527,4786,7310,0,3,ITH,ITH5,8,Emilia-Romagna,Emilia-Romagna,4459477,383829,8.61,0.16
769,2021-08-17,EMR,22370,12293,10077,14488,6855,1027,ITH,ITH5,8,Emilia-Romagna,Emilia-Romagna,4459477,406199,9.11,0.5
770,2021-09-03,EMR,23718,12764,10954,6311,16804,603,ITH,ITH5,8,Emilia-Romagna,Emilia-Romagna,4459477,429917,9.64,0.53
771,2021-05-26,EMR,33349,14758,18591,9929,23034,386,ITH,ITH5,8,Emilia-Romagna,Emilia-Romagna,4459477,463266,10.39,0.75
772,2021-06-12,EMR,41391,21888,19503,35472,4920,999,ITH,ITH5,8,Emilia-Romagna,Emilia-Romagna,4459477,504657,11.32,0.93
773,2021-03-04,EMR,16457,5350,11107,13343,3024,90,ITH,ITH5,8,Emilia-Romagna,Emilia-Romagna,4459477,521114,11.69,0.37
774,2021-05-24,EMR,30012,13740,16272,17968,11530,514,ITH,ITH5,8,Emilia-Romagna,Emilia-Romagna,4459477,551126,12.36,0.67
775,2021-02-13,EMR,3631,1086,2545,3018,599,14,ITH,ITH5,8,Emilia-Romagna,Emilia-Romagna,4459477,554757,12.44,0.08
776,2021-01-23,EMR,2448,871,1577,439,2009,0,ITH,ITH5,8,Emilia-Romagna,Emilia-Romagna,4459477,557205,12.49,0.05
777,2021-05-07,EMR,35339,16986,18353,22671,11895,773,ITH,ITH5,8,Emilia-Romagna,Emilia-Romagna,4459477,592544,13.29,0.79
778,2021-07-03,EMR,32125,15936,16189,11410,20022,693,ITH,ITH5,8,Emilia-Romagna,Emilia-Romagna,4459477,624669,14.01,0.72
779,2021-08-29,EMR,20586,11388,9198,8476,11254,856,ITH,ITH5,8,Emilia-Romagna,Emilia-Romagna,4459477,645255,14.47,0.46
780,2021-01-30,EMR,10094,3528,6566,137,9956,1,ITH,ITH5,8,Emilia-Romagna,Emilia-Romagna,4459477,655349,14.7,0.23
781,2021-02-18,EMR,7044,2892,4152,6440,588,16,ITH,ITH5,8,Emilia-Romagna,Emilia-Romagna,4459477,662393,14.85,0.16
782,2021-06-07,EMR,40573,20826,19747,33450,6263,860,ITH,ITH5,8,Emilia-Romagna,Emilia-Romagna,4459477,702966,15.76,0.91
783,2021-08-03,EMR,38512,20271,18241,15569,22292,651,ITH,ITH5,8,Emilia-Romagna,Emilia-Romagna,4459477,741478,16.63,0.86
784,2021-07-20,EMR,43143,22551,20592,6679,35782,682,ITH,ITH5,8,Emilia-Romagna,Emilia-Romagna,4459477,784621,17.59,0.97
785,2021-04-11,EMR,15285,6940,8345,11981,3050,254,ITH,ITH5,8,Emilia-Romagna,Emilia-Romagna,4459477,799906,17.94,0.34
786,2021-03-09,EMR,14806,6037,8769,10756,3954,96,ITH,ITH5,8,Emilia-Romagna,Emilia-Romagna,4459477,814712,18.27,0.33
787,2021-05-05,EMR,30145,14004,16141,18306,11274,565,ITH,ITH5,8,Emilia-Romagna,Emilia-Romagna,4459477,844857,18.95,0.68
788,2021-02-25,EMR,9250,3498,5752,8272,955,23,ITH,ITH5,8,Emilia-Romagna,Emilia-Romagna,4459477,854107,19.15,0.21
789,2021-06-19,EMR,36693,18365,18328,16742,19405,546,ITH,ITH5,8,Emilia-Romagna,Emilia-Romagna,4459477,890800,19.98,0.82
790,2021-03-11,EMR,17498,7331,10167,11455,5856,187,ITH,ITH5,8,Emilia-Romagna,Emilia-Romagna,4459477,908298,20.37,0.39
791,2021-02-06,EMR,7603,2408,5195,2108,5491,4,ITH,ITH5,8,Emilia-Romagna,Emilia-Romagna,4459477,915901,20.54,0.17
792,2021-08-27,EMR,27862,14988,12874,6933,20195,734,ITH,ITH5,8,Emilia-Romagna,Emilia-Romagna,4459477,943763,21.16,0.62
793,2021-05-19,EMR,33845,14998,18847,18042,15270,533,ITH,ITH5,8,Emilia-Romagna,Emilia-Romagna,4459477,977608,21.92,0.76
794,2021-06-02,EMR,24123,12071,12052,18685,4979,459,ITH,ITH5,8,Emilia-Romagna,Emilia-Romagna,4459477,1001731,22.46,0.54
795,2021-09-05,EMR,17062,9171,7891,6358,9980,724,ITH,ITH5,8,Emilia-Romagna,Emilia-Romagna,4459477,1018793,22.85,0.38
796,2021-07-15,EMR,50398,26249,24149,7900,41791,707,ITH,ITH5,8,Emilia-Romagna,Emilia-Romagna,4459477,1069191,23.98,1.13
797,2021-04-23,EMR,29584,13818,15766,14309,14896,379,ITH,ITH5,8,Emilia-Romagna,Emilia-Romagna,4459477,1098775,24.64,0.66
798,2021-01-13,EMR,9080,2944,6136,9075,0,5,ITH,ITH5,8,Emilia-Romagna,Emilia-Romagna,4459477,1107855,24.84,0.2
799,2021-04-04,EMR,9883,4719,5164,7529,2271,83,ITH,ITH5,8,Emilia-Romagna,Emilia-Romagna,4459477,1117738,25.06,0.22
800,2021-01-11,EMR,9356,3278,6078,9347,0,9,ITH,ITH5,8,Emilia-Romagna,Emilia-Romagna,4459477,1127094,25.27,0.21
801,2021-05-31,EMR,29815,13777,16038,17731,11532,552,ITH,ITH5,8,Emilia-Romagna,Emilia-Romagna,4459477,1156909,25.94,0.67
802,2021-02-20,EMR,5318,2094,3224,5048,263,7,ITH,ITH5,8,Emilia-Romagna,Emilia-Romagna,4459477,1162227,26.06,0.12
803,2021-01-15,EMR,7754,2407,5347,7746,0,8,ITH,ITH5,8,Emilia-Romagna,Emilia-Romagna,4459477,1169981,26.24,0.17
804,2021-02-11,EMR,4258,1416,2842,3398,843,17,ITH,ITH5,8,Emilia-Romagna,Emilia-Romagna,4459477,1174239,26.33,0.1
805,2021-07-29,EMR,40788,21527,19261,14515,25549,724,ITH,ITH5,8,Emilia-Romagna,Emilia-Romagna,4459477,1215027,27.25,0.91
806,2021-07-27,EMR,41131,21852,19279,17022,23322,787,ITH,ITH5,8,Emilia-Romagna,Emilia-Romagna,4459477,1256158,28.17,0.92
807,2021-04-18,EMR,17528,8406,9122,12365,4934,229,ITH,ITH5,8,Emilia-Romagna,Emilia-Romagna,4459477,1273686,28.56,0.39
808,2021-06-14,EMR,41345,21374,19971,27459,13088,798,ITH,ITH5,8,Emilia-Romagna,Emilia-Romagna,4459477,1315031,29.49,0.93
809,2021-08-15,EMR,6649,3690,2959,3281,3199,169,ITH,ITH5,8,Emilia-Romagna,Emilia-Romagna,4459477,1321680,29.64,0.15
810,2021-06-26,EMR,37485,18996,18489,21009,15538,938,ITH,ITH5,8,Emilia-Romagna,Emilia-Romagna,4459477,1359165,30.48,0.84
811,2021-08-22,EMR,16461,9038,7423,6725,9101,635,ITH,ITH5,8,Emilia-Romagna,Emilia-Romagna,4459477,1375626,30.85,0.37
812,2021-07-10,EMR,42097,21437,20660,6802,34648,647,ITH,ITH5,8,Emilia-Romagna,Emilia-Romagna,4459477,1417723,31.79,0.94
813,2021-08-31,EMR,27946,14855,13091,8304,18582,1060,ITH,ITH5,8,Emilia-Romagna,Emilia-Romagna,4459477,1445669,32.42,0.63
814,2021-05-23,EMR,25506,11868,13638,13580,11609,317,ITH,ITH5,8,Emilia-Romagna,Emilia-Romagna,4459477,1471175,32.99,0.57
815,2021-07-19,EMR,42005,22125,19880,6636,34772,597,ITH,ITH5,8,Emilia-Romagna,Emilia-Romagna,4459477,1513180,33.93,0.94
816,2021-08-26,EMR,27589,14720,12869,9344,17292,953,ITH,ITH5,8,Emilia-Romagna,Emilia-Romagna,4459477,1540769,34.55,0.62
817,2021-06-04,EMR,45764,23028,22736,36812,8204,748,ITH,ITH5,8,Emilia-Romagna,Emilia-Romagna,4459477,1586533,35.58,1.03
818,2021-01-20,EMR,1331,269,1062,1329,1,1,ITH,ITH5,8,Emilia-Romagna,Emilia-Romagna,4459477,1587864,35.61,0.03
819,2021-07-24,EMR,38880,20966,17914,17260,20635,985,ITH,ITH5,8,Emilia-Romagna,Emilia-Romagna,4459477,1626744,36.48,0.87
820,2021-04-15,EMR,29368,13986,15382,19241,9682,445,ITH,ITH5,8,Emilia-Romagna,Emilia-Romagna,4459477,1656112,37.14,0.66
821,2021-06-18,EMR,42789,21456,21333,16290,25931,568,ITH,ITH5,8,Emilia-Romagna,Emilia-Romagna,4459477,1698901,38.1,0.96
822,2021-08-10,EMR,31322,16756,14566,15331,14913,1078,ITH,ITH5,8,Emilia-Romagna,Emilia-Romagna,4459477,1730223,38.8,0.7
823,2021-03-13,EMR,16143,6363,9780,10593,5314,236,ITH,ITH5,8,Emilia-Romagna,Emilia-Romagna,4459477,1746366,39.16,0.36
824,2021-07-05,EMR,33241,16209,17032,11203,21383,655,ITH,ITH5,8,Emilia-Romagna,Emilia-Romagna,4459477,1779607,39.91,0.75
825,2021-03-27,EMR,21680,9072,12608,14522,6911,247,ITH,ITH5,8,Emilia-Romagna,Emilia-Romagna,4459477,1801287,40.39,0.49
826,2021-04-13,EMR,23726,11132,12594,19033,4344,349,ITH,ITH5,8,Emilia-Romagna,Emilia-Romagna,4459477,1825013,40.92,0.53
827,2021-01-03,EMR,2763,945,1818,2763,0,0,ITH,ITH5,8,Emilia-Romagna,Emilia-Romagna,4459477,1827776,40.99,0.06
828,2021-05-02,EMR,25595,11656,13939,13190,12000,405,ITH,ITH5,8,Emilia-Romagna,Emilia-Romagna,4459477,1853371,41.56,0.57
829,2021-01-22,EMR,1831,477,1354,1086,743,2,ITH,ITH5,8,Emilia-Romagna,Emilia-Romagna,4459477,1855202,41.6,0.04
830,2021-08-24,EMR,23379,12700,10679,10500,11762,1117,ITH,ITH5,8,Emilia-Romagna,Emilia-Romagna,4459477,1878581,42.13,0.52
831,2021-02-08,EMR,5238,1537,3701,2317,2918,3,ITH,ITH5,8,Emilia-Romagna,Emilia-Romagna,4459477,1883819,42.24,0.12
832,2021-05-16,EMR,25890,12182,13708,18365,7146,379,ITH,ITH5,8,Emilia-Romagna,Emilia-Romagna,4459477,1909709,42.82,0.58
833,2021-02-22,EMR,7486,3093,4393,7200,273,13,ITH,ITH5,8,Emilia-Romagna,Emilia-Romagna,4459477,1917195,42.99,0.17
834,2021-05-09,EMR,25644,12269,13375,18279,6973,392,ITH,ITH5,8,Emilia-Romagna,Emilia-Romagna,4459477,1942839,43.57,0.58
835,2021-01-29,EMR,10427,3500,6927,290,10137,0,ITH,ITH5,8,Emilia-Romagna,Emilia-Romagna,4459477,1953266,43.8,0.23
836,2021-02-15,EMR,2903,850,2053,2710,125,68,ITH,ITH5,8,Emilia-Romagna,Emilia-Romagna,4459477,1956169,43.87,0.07
837,2021-01-27,EMR,8371,2951,5420,461,7910,0,ITH,ITH5,8,Emilia-Romagna,Emilia-Romagna,4459477,1964540,44.05,0.19
838,2021-07-31,EMR,36226,19238,16988,12141,23383,702,ITH,ITH5,8,Emilia-Romagna,Emilia-Romagna,4459477,2000766,44.87,0.81
839,2021-07-12,EMR,44070,22330,21740,5428,38132,510,ITH,ITH5,8,Emilia-Romagna,Emilia-Romagna,4459477,2044836,45.85,0.99
840,2021-09-07,EMR,24862,13433,11429,5690,18594,578,ITH,ITH5,8,Emilia-Romagna,Emilia-Romagna,4459477,2069698,46.41,0.56
841,2021-01-10,EMR,7173,2686,4487,7172,0,1,ITH,ITH5,8,Emilia-Romagna,Emilia-Romagna,4459477,2076871,46.57,0.16
842,2021-06-16,EMR,45963,23539,22424,25249,19965,749,ITH,ITH5,8,Emilia-Romagna,Emilia-Romagna,4459477,2122834,47.6,1.03
843,2021-03-08,EMR,12217,5098,7119,9469,2663,85,ITH,ITH5,8,Emilia-Romagna,Emilia-Romagna,4459477,2135051,47.88,0.27
844,2021-06-30,EMR,34262,17291,16971,17704,15666,892,ITH,ITH5,8,Emilia-Romagna,Emilia-Romagna,4459477,2169313,48.65,0.77
845,2021-07-17,EMR,43666,23055,20611,7175,35751,740,ITH,ITH5,8,Emilia-Romagna,Emilia-Romagna,4459477,2212979,49.62,0.98
846,2021-06-11,EMR,45988,23871,22117,38333,6557,1098,ITH,ITH5,8,Emilia-Romagna,Emilia-Romagna,4459477,2258967,50.66,1.03
847,2021-06-28,EMR,40080,19667,20413,19631,19579,870,ITH,ITH5,8,Emilia-Romagna,Emilia-Romagna,4459477,2299047,51.55,0.9
848,2021-03-20,EMR,16092,6831,9261,8958,6966,168,ITH,ITH5,8,Emilia-Romagna,Emilia-Romagna,4459477,2315139,51.92,0.36
849,2021-04-06,EMR,24768,11181,13587,19727,4751,290,ITH,ITH5,8,Emilia-Romagna,Emilia-Romagna,4459477,2339907,52.47,0.56
850,2020-12-27,EMR,972,374,598,972,0,0,ITH,ITH5,8,Emilia-Romagna,Emilia-Romagna,4459477,2340879,52.49,0.02
851,2021-03-10,EMR,18813,7744,11069,12984,5647,182,ITH,ITH5,8,Emilia-Romagna,Emilia-Romagna,4459477,2359692,52.91,0.42
852,2021-05-18,EMR,29237,13282,15955,18100,10647,490,ITH,ITH5,8,Emilia-Romagna,Emilia-Romagna,4459477,2388929,53.57,0.66
853,2021-02-07,EMR,4794,1537,3257,1724,3068,2,ITH,ITH5,8,Emilia-Romagna,Emilia-Romagna,4459477,2393723,53.68,0.11
854,2021-02-24,EMR,9359,3568,5791,8453,890,16,ITH,ITH5,8,Emilia-Romagna,Emilia-Romagna,4459477,2403082,53.89,0.21
855,2021-01-05,EMR,9372,3173,6199,9368,0,4,ITH,ITH5,8,Emilia-Romagna,Emilia-Romagna,4459477,2412454,54.1,0.21
856,2021-04-29,EMR,44992,21152,23840,26607,17565,820,ITH,ITH5,8,Emilia-Romagna,Emilia-Romagna,4459477,2457446,55.11,1.01
857,2021-01-19,EMR,2050,507,1543,2032,17,1,ITH,ITH5,8,Emilia-Romagna,Emilia-Romagna,4459477,2459496,55.15,0.05
858,2021-04-20,EMR,22653,10418,12235,13885,8367,401,ITH,ITH5,8,Emilia-Romagna,Emilia-Romagna,4459477,2482149,55.66,0.51
859,2021-06-23,EMR,38081,19097,18984,18475,18887,719,ITH,ITH5,8,Emilia-Romagna,Emilia-Romagna,4459477,2520230,56.51,0.85
860,2021-01-08,EMR,10876,3587,7289,10873,0,3,ITH,ITH5,8,Emilia-Romagna,Emilia-Romagna,4459477,2531106,56.76,0.24
861,2021-03-06,EMR,21035,5971,15064,18168,2743,124,ITH,ITH5,8,Emilia-Romagna,Emilia-Romagna,4459477,2552141,57.23,0.47
862,2021-02-12,EMR,5330,1679,3651,3900,1407,23,ITH,ITH5,8,Emilia-Romagna,Emilia-Romagna,4459477,2557471,57.35,0.12
863,2021-04-10,EMR,20939,9305,11634,16456,4148,335,ITH,ITH5,8,Emilia-Romagna,Emilia-Romagna,4459477,2578410,57.82,0.47
864,2021-04-17,EMR,27323,13086,14237,17578,9354,391,ITH,ITH5,8,Emilia-Romagna,Emilia-Romagna,4459477,2605733,58.43,0.61
865,2021-01-07,EMR,10292,3408,6884,10288,0,4,ITH,ITH5,8,Emilia-Romagna,Emilia-Romagna,4459477,2616025,58.66,0.23
866,2021-04-03,EMR,19967,8761,11206,15956,3800,211,ITH,ITH5,8,Emilia-Romagna,Emilia-Romagna,4459477,2635992,59.11,0.45
867,2021-08-09,EMR,30220,16121,14099,16610,12556,1054,ITH,ITH5,8,Emilia-Romagna,Emilia-Romagna,4459477,2666212,59.79,0.68
868,2021-05-01,EMR,28432,12782,15650,15278,12795,359,ITH,ITH5,8,Emilia-Romagna,Emilia-Romagna,4459477,2694644,60.43,0.64
869,2021-02-05,EMR,9310,2963,6347,1617,7689,4,ITH,ITH5,8,Emilia-Romagna,Emilia-Romagna,4459477,2703954,60.63,0.21
870,2021-06-20,EMR,30749,15599,15150,15593,14671,485,ITH,ITH5,8,Emilia-Romagna,Emilia-Romagna,4459477,2734703,61.32,0.69
871,2021-08-28,EMR,26279,14539,11740,8619,16839,821,ITH,ITH5,8,Emilia-Romagna,Emilia-Romagna,4459477,2760982,61.91,0.59
872,2021-05-20,EMR,40413,18345,22068,18393,21502,518,ITH,ITH5,8,Emilia-Romagna,Emilia-Romagna,4459477,2801395,62.82,0.91
873,2021-08-23,EMR,22586,11758,10828,11820,9469,1297,ITH,ITH5,8,Emilia-Romagna,Emilia-Romagna,4459477,2823981,63.33,0.51
874,2021-06-25,EMR,42865,21813,21052,19745,22319,801,ITH,ITH5,8,Emilia-Romagna,Emilia-Romagna,4459477,2866846,64.29,0.96
875,2021-06-13,EMR,28772,15010,13762,23813,4286,673,ITH,ITH5,8,Emilia-Romagna,Emilia-Romagna,4459477,2895618,64.93,0.65
876,2021-03-05,EMR,17921,5864,12057,14292,3504,125,ITH,ITH5,8,Emilia-Romagna,Emilia-Romagna,4459477,2913539,65.33,0.4
877,2021-03-22,EMR,17660,7821,9839,10616,6872,172,ITH,ITH5,8,Emilia-Romagna,Emilia-Romagna,4459477,2931199,65.73,0.4
878,2021-03-03,EMR,15896,5268,10628,13356,2487,53,ITH,ITH5,8,Emilia-Romagna,Emilia-Romagna,4459477,2947095,66.09,0.36
879,2021-05-30,EMR,27103,12808,14295,12984,13714,405,ITH,ITH5,8,Emilia-Romagna,Emilia-Romagna,4459477,2974198,66.69,0.61
880,2021-02-19,EMR,7330,3012,4318,6802,514,14,ITH,ITH5,8,Emilia-Romagna,Emilia-Romagna,4459477,2981528,66.86,0.16
881,2021-07-26,EMR,39568,21097,18471,15907,22881,780,ITH,ITH5,8,Emilia-Romagna,Emilia-Romagna,4459477,3021096,67.75,0.89
882,2020-12-31,EMR,2214,779,1435,2213,0,1,ITH,ITH5,8,Emilia-Romagna,Emilia-Romagna,4459477,3023310,67.8,0.05
883,2021-06-06,EMR,36603,19002,17601,31540,4415,648,ITH,ITH5,8,Emilia-Romagna,Emilia-Romagna,4459477,3059913,68.62,0.82
884,2021-02-26,EMR,9643,3677,5966,8563,1054,26,ITH,ITH5,8,Emilia-Romagna,Emilia-Romagna,4459477,3069556,68.83,0.22
885,2021-08-06,EMR,34652,18586,16066,18772,14987,893,ITH,ITH5,8,Emilia-Romagna,Emilia-Romagna,4459477,3104208,69.61,0.78
886,2021-04-28,EMR,33752,15604,18148,20263,12899,590,ITH,ITH5,8,Emilia-Romagna,Emilia-Romagna,4459477,3137960,70.37,0.76
887,2021-06-24,EMR,40651,20417,20234,20273,19569,809,ITH,ITH5,8,Emilia-Romagna,Emilia-Romagna,4459477,3178611,71.28,0.91
888,2021-08-20,EMR,19711,10734,8977,10225,8512,974,ITH,ITH5,8,Emilia-Romagna,Emilia-Romagna,4459477,3198322,71.72,0.44
889,2021-08-19,EMR,21532,11562,9970,11913,8727,892,ITH,ITH5,8,Emilia-Romagna,Emilia-Romagna,4459477,3219854,72.2,0.48
890,2021-05-28,EMR,41304,18966,22338,17273,23433,598,ITH,ITH5,8,Emilia-Romagna,Emilia-Romagna,4459477,3261158,73.13,0.93
891,2021-03-25,EMR,21484,9420,12064,14236,6993,255,ITH,ITH5,8,Emilia-Romagna,Emilia-Romagna,4459477,3282642,73.61,0.48
892,2021-05-21,EMR,39387,17562,21825,21637,17131,619,ITH,ITH5,8,Emilia-Romagna,Emilia-Romagna,4459477,3322029,74.49,0.88
893,2021-02-10,EMR,4024,1385,2639,2757,1261,6,ITH,ITH5,8,Emilia-Romagna,Emilia-Romagna,4459477,3326053,74.58,0.09
894,2021-04-08,EMR,31400,14419,16981,25327,5333,740,ITH,ITH5,8,Emilia-Romagna,Emilia-Romagna,4459477,3357453,75.29,0.7
895,2021-03-18,EMR,13771,5848,7923,5680,8005,86,ITH,ITH5,8,Emilia-Romagna,Emilia-Romagna,4459477,3371224,75.6,0.31
896,2021-05-14,EMR,37356,17203,20153,26802,9655,899,ITH,ITH5,8,Emilia-Romagna,Emilia-Romagna,4459477,3408580,76.43,0.84
897,2021-02-03,EMR,9348,2991,6357,961,8386,1,ITH,ITH5,8,Emilia-Romagna,Emilia-Romagna,4459477,3417928,76.64,0.21
898,2021-04-01,EMR,23944,10763,13181,19071,4557,316,ITH,ITH5,8,Emilia-Romagna,Emilia-Romagna,4459477,3441872,77.18,0.54
899,2021-02-17,EMR,6543,2766,3777,5757,773,13,ITH,ITH5,8,Emilia-Romagna,Emilia-Romagna,4459477,3448415,77.33,0.15
900,2021-07-23,EMR,40431,21905,18526,19809,19486,1136,ITH,ITH5,8,Emilia-Romagna,Emilia-Romagna,4459477,3488846,78.23,0.91
901,2021-04-14,EMR,27063,12851,14212,20522,6114,427,ITH,ITH5,8,Emilia-Romagna,Emilia-Romagna,4459477,3515909,78.84,0.61
902,2021-01-21,EMR,2167,730,1437,819,1348,0,ITH,ITH5,8,Emilia-Romagna,Emilia-Romagna,4459477,3518076,78.89,0.05
903,2021-03-17,EMR,13731,5699,8032,5818,7855,58,ITH,ITH5,8,Emilia-Romagna,Emilia-Romagna,4459477,3531807,79.2,0.31
904,2021-08-21,EMR,19087,10682,8405,10418,7767,902,ITH,ITH5,8,Emilia-Romagna,Emilia-Romagna,4459477,3550894,79.63,0.43
905,2021-05-13,EMR,35861,16518,19343,27292,7852,717,ITH,ITH5,8,Emilia-Romagna,Emilia-Romagna,4459477,3586755,80.43,0.8
906,2021-03-15,EMR,13461,6252,7209,6852,6507,102,ITH,ITH5,8,Emilia-Romagna,Emilia-Romagna,4459477,3600216,80.73,0.3
907,2021-02-09,EMR,4161,1253,2908,2307,1853,1,ITH,ITH5,8,Emilia-Romagna,Emilia-Romagna,4459477,3604377,80.83,0.09
908,2021-09-01,EMR,22593,12042,10551,7182,14667,744,ITH,ITH5,8,Emilia-Romagna,Emilia-Romagna,4459477,3626970,81.33,0.51
909,2021-05-15,EMR,33297,14998,18299,22216,10440,641,ITH,ITH5,8,Emilia-Romagna,Emilia-Romagna,4459477,3660267,82.08,0.75
910,2021-02-04,EMR,9935,3208,6727,1235,8699,1,ITH,ITH5,8,Emilia-Romagna,Emilia-Romagna,4459477,3670202,82.3,0.22
911,2021-05-22,EMR,33173,14159,19014,16473,16243,457,ITH,ITH5,8,Emilia-Romagna,Emilia-Romagna,4459477,3703375,83.05,0.74
912,2021-07-18,EMR,34584,17916,16668,8192,25824,568,ITH,ITH5,8,Emilia-Romagna,Emilia-Romagna,4459477,3737959,83.82,0.78
913,2021-04-09,EMR,25803,11695,14108,19527,5761,515,ITH,ITH5,8,Emilia-Romagna,Emilia-Romagna,4459477,3763762,84.4,0.58
914,2021-02-02,EMR,9492,3052,6440,527,8964,1,ITH,ITH5,8,Emilia-Romagna,Emilia-Romagna,4459477,3773254,84.61,0.21
915,2021-08-30,EMR,27006,14181,12825,7629,18351,1026,ITH,ITH5,8,Emilia-Romagna,Emilia-Romagna,4459477,3800260,85.22,0.61
916,2021-07-07,EMR,37920,19149,18771,13400,23720,800,ITH,ITH5,8,Emilia-Romagna,Emilia-Romagna,4459477,3838180,86.07,0.85
917,2021-03-29,EMR,21434,9619,11815,16539,4664,231,ITH,ITH5,8,Emilia-Romagna,Emilia-Romagna,4459477,3859614,86.55,0.48
918,2021-02-21,EMR,4449,1707,2742,3999,440,10,ITH,ITH5,8,Emilia-Romagna,Emilia-Romagna,4459477,3864063,86.65,0.1
919,2021-07-25,EMR,28477,15181,13296,10552,17441,484,ITH,ITH5,8,Emilia-Romagna,Emilia-Romagna,4459477,3892540,87.29,0.64
920,2021-08-11,EMR,27744,14871,12873,12058,14876,810,ITH,ITH5,8,Emilia-Romagna,Emilia-Romagna,4459477,3920284,87.91,0.62
921,2021-08-25,EMR,25125,13539,11586,9553,14606,966,ITH,ITH5,8,Emilia-Romagna,Emilia-Romagna,4459477,3945409,88.47,0.56
922,2021-01-02,EMR,2379,917,1462,2379,0,0,ITH,ITH5,8,Emilia-Romagna,Emilia-Romagna,4459477,3947788,88.53,0.05
923,2021-06-17,EMR,46706,23666,23040,21787,24227,692,ITH,ITH5,8,Emilia-Romagna,Emilia-Romagna,4459477,3994494,89.57,1.05
924,2021-08-13,EMR,21253,11799,9454,14262,6083,908,ITH,ITH5,8,Emilia-Romagna,Emilia-Romagna,4459477,4015747,90.05,0.48
925,2021-09-04,EMR,23696,12895,10801,8372,14431,893,ITH,ITH5,8,Emilia-Romagna,Emilia-Romagna,4459477,4039443,90.58,0.53
926,2021-08-16,EMR,20217,10867,9350,12624,6579,1014,ITH,ITH5,8,Emilia-Romagna,Emilia-Romagna,4459477,4059660,91.03,0.45
927,2021-09-02,EMR,24933,13240,11693,6469,17776,688,ITH,ITH5,8,Emilia-Romagna,Emilia-Romagna,4459477,4084593,91.59,0.56
928,2021-05-25,EMR,25242,11239,14003,11300,13512,430,ITH,ITH5,8,Emilia-Romagna,Emilia-Romagna,4459477,4109835,92.16,0.57
929,2021-02-14,EMR,1405,378,1027,1277,120,8,ITH,ITH5,8,Emilia-Romagna,Emilia-Romagna,4459477,4111240,92.19,0.03
930,2021-05-27,EMR,42351,18771,23580,13556,28288,507,ITH,ITH5,8,Emilia-Romagna,Emilia-Romagna,4459477,4153591,93.14,0.95
931,2021-02-16,EMR,5773,2447,3326,5228,531,14,ITH,ITH5,8,Emilia-Romagna,Emilia-Romagna,4459477,4159364,93.27,0.13
932,2021-06-01,EMR,27197,13114,14083,16835,9930,432,ITH,ITH5,8,Emilia-Romagna,Emilia-Romagna,4459477,4186561,93.88,0.61
933,2021-07-28,EMR,38700,20753,17947,13966,24047,687,ITH,ITH5,8,Emilia-Romagna,Emilia-Romagna,4459477,4225261,94.75,0.87
934,2021-06-03,EMR,37936,18443,19493,29686,7560,690,ITH,ITH5,8,Emilia-Romagna,Emilia-Romagna,4459477,4263197,95.6,0.85
935,2021-02-23,EMR,8217,3219,4998,7819,386,12,ITH,ITH5,8,Emilia-Romagna,Emilia-Romagna,4459477,4271414,95.78,0.18
936,2021-03-12,EMR,18325,7709,10616,11308,6721,296,ITH,ITH5,8,Emilia-Romagna,Emilia-Romagna,4459477,4289739,96.19,0.41
937,2021-04-22,EMR,29060,13455,15605,14616,14080,364,ITH,ITH5,8,Emilia-Romagna,Emilia-Romagna,4459477,4318799,96.85,0.65
938,2021-01-12,EMR,9483,3126,6357,9474,0,9,ITH,ITH5,8,Emilia-Romagna,Emilia-Romagna,4459477,4328282,97.06,0.21
939,2021-07-16,EMR,49790,26282,23508,7037,42084,669,ITH,ITH5,8,Emilia-Romagna,Emilia-Romagna,4459477,4378072,98.17,1.12
940,2021-06-27,EMR,29598,14894,14704,16192,12734,672,ITH,ITH5,8,Emilia-Romagna,Emilia-Romagna,4459477,4407670,98.84,0.66
941,2021-07-14,EMR,47977,24545,23432,5592,41852,533,ITH,ITH5,8,Emilia-Romagna,Emilia-Romagna,4459477,4455647,99.91,1.08
942,2021-04-05,EMR,14856,6810,8046,11786,2895,175,ITH,ITH5,8,Emilia-Romagna,Emilia-Romagna,4459477,4470503,100.25,0.33
943,2021-08-02,EMR,38529,20357,18172,14774,23090,665,ITH,ITH5,8,Emilia-Romagna,Emilia-Romagna,4459477,4509032,101.11,0.86
944,2021-04-24,EMR,28655,13251,15404,14063,14242,350,ITH,ITH5,8,Emilia-Romagna,Emilia-Romagna,4459477,4537687,101.75,0.64
945,2021-05-11,EMR,35819,16805,19014,27863,7262,694,ITH,ITH5,8,Emilia-Romagna,Emilia-Romagna,4459477,4573506,102.56,0.8
946,2021-01-31,EMR,7709,2771,4938,240,7469,0,ITH,ITH5,8,Emilia-Romagna,Emilia-Romagna,4459477,4581215,102.73,0.17
947,2021-04-12,EMR,19260,9016,10244,14449,4452,359,ITH,ITH5,8,Emilia-Romagna,Emilia-Romagna,4459477,4600475,103.16,0.43
948,2021-06-08,EMR,45145,23115,22030,36800,7545,800,ITH,ITH5,8,Emilia-Romagna,Emilia-Romagna,4459477,4645620,104.17,1.01
949,2021-08-04,EMR,35339,18841,16498,13025,21685,629,ITH,ITH5,8,Emilia-Romagna,Emilia-Romagna,4459477,4680959,104.97,0.79
950,2021-07-21,EMR,43692,23306,20386,10785,32281,626,ITH,ITH5,8,Emilia-Romagna,Emilia-Romagna,4459477,4724651,105.95,0.98
951,2021-04-19,EMR,20922,9806,11116,14337,6284,301,ITH,ITH5,8,Emilia-Romagna,Emilia-Romagna,4459477,4745573,106.42,0.47
952,2021-01-09,EMR,9999,3458,6541,9995,0,4,ITH,ITH5,8,Emilia-Romagna,Emilia-Romagna,4459477,4755572,106.64,0.22
953,2021-06-15,EMR,43877,22642,21235,27907,15075,895,ITH,ITH5,8,Emilia-Romagna,Emilia-Romagna,4459477,4799449,107.62,0.98
954,2021-03-07,EMR,7850,2962,4888,6288,1525,37,ITH,ITH5,8,Emilia-Romagna,Emilia-Romagna,4459477,4807299,107.8,0.18
955,2021-05-03,EMR,28739,13570,15169,17396,10887,456,ITH,ITH5,8,Emilia-Romagna,Emilia-Romagna,4459477,4836038,108.44,0.64
956,2021-08-01,EMR,30036,16158,13878,10268,19361,407,ITH,ITH5,8,Emilia-Romagna,Emilia-Romagna,4459477,4866074,109.12,0.67
957,2021-08-18,EMR,22269,12195,10074,14562,6648,1059,ITH,ITH5,8,Emilia-Romagna,Emilia-Romagna,4459477,4888343,109.62,0.5
958,2021-05-10,EMR,33895,16151,17744,26005,7263,627,ITH,ITH5,8,Emilia-Romagna,Emilia-Romagna,4459477,4922238,110.38,0.76
959,2021-07-30,EMR,39862,21412,18450,15670,23464,728,ITH,ITH5,8,Emilia-Romagna,Emilia-Romagna,4459477,4962100,111.27,0.89
960,2021-04-21,EMR,23976,10972,13004,13869,9745,362,ITH,ITH5,8,Emilia-Romagna,Emilia-Romagna,4459477,4986076,111.81,0.54
961,2021-05-08,EMR,32380,15113,17267,20398,11439,543,ITH,ITH5,8,Emilia-Romagna,Emilia-Romagna,4459477,5018456,112.53,0.73
962,2021-01-28,EMR,10263,3343,6920,348,9915,0,ITH,ITH5,8,Emilia-Romagna,Emilia-Romagna,4459477,5028719,112.76,0.23
963,2021-06-05,EMR,44325,22386,21939,36625,6923,777,ITH,ITH5,8,Emilia-Romagna,Emilia-Romagna,4459477,5073044,113.76,0.99
964,2021-06-22,EMR,36543,18200,18343,16264,19639,640,ITH,ITH5,8,Emilia-Romagna,Emilia-Romagna,4459477,5109587,114.58,0.82
965,2021-07-06,EMR,36815,18511,18304,12923,23198,694,ITH,ITH5,8,Emilia-Romagna,Emilia-Romagna,4459477,5146402,115.4,0.83
966,2021-05-17,EMR,32483,15416,17067,22337,9564,582,ITH,ITH5,8,Emilia-Romagna,Emilia-Romagna,4459477,5178885,116.13,0.73
967,2021-06-29,EMR,37733,18608,19125,18137,18797,799,ITH,ITH5,8,Emilia-Romagna,Emilia-Romagna,4459477,5216618,116.98,0.85
968,2021-03-21,EMR,11959,5296,6663,7260,4606,93,ITH,ITH5,8,Emilia-Romagna,Emilia-Romagna,4459477,5228577,117.25,0.27
969,2021-06-10,EMR,45104,23169,21935,38683,5387,1034,ITH,ITH5,8,Emilia-Romagna,Emilia-Romagna,4459477,5273681,118.26,1.01
970,2021-03-02,EMR,12665,4274,8391,10515,2092,58,ITH,ITH5,8,Emilia-Romagna,Emilia-Romagna,4459477,5286346,118.54,0.28
971,2021-03-19,EMR,15920,6970,8950,7791,7971,158,ITH,ITH5,8,Emilia-Romagna,Emilia-Romagna,4459477,5302266,118.9,0.36
972,2021-04-07,EMR,26888,12306,14582,20463,6079,346,ITH,ITH5,8,Emilia-Romagna,Emilia-Romagna,4459477,5329154,119.5,0.6
973,2021-01-14,EMR,8132,2595,5537,8123,0,9,ITH,ITH5,8,Emilia-Romagna,Emilia-Romagna,4459477,5337286,119.68,0.18
974,2021-02-28,EMR,6830,2528,4302,4959,1852,19,ITH,ITH5,8,Emilia-Romagna,Emilia-Romagna,4459477,5344116,119.84,0.15
975,2021-04-26,EMR,27915,12940,14975,18037,9324,554,ITH,ITH5,8,Emilia-Romagna,Emilia-Romagna,4459477,5372031,120.46,0.63
976,2021-01-16,EMR,5631,1718,3913,5630,0,1,ITH,ITH5,8,Emilia-Romagna,Emilia-Romagna,4459477,5377662,120.59,0.13
977,2021-03-14,EMR,8807,3840,4967,4944,3799,64,ITH,ITH5,8,Emilia-Romagna,Emilia-Romagna,4459477,5386469,120.79,0.2
978,2021-06-09,EMR,43161,21921,21240,35711,6432,1018,ITH,ITH5,8,Emilia-Romagna,Emilia-Romagna,4459477,5429630,121.75,0.97
979,2021-03-01,EMR,10103,3584,6519,7816,2262,25,ITH,ITH5,8,Emilia-Romagna,Emilia-Romagna,4459477,5439733,121.98,0.23
980,2021-08-05,EMR,36756,19451,17305,18356,17409,991,ITH,ITH5,8,Emilia-Romagna,Emilia-Romagna,4459477,5476489,122.81,0.82
981,2021-08-12,EMR,27694,15045,12649,19252,6878,1564,ITH,ITH5,8,Emilia-Romagna,Emilia-Romagna,4459477,5504183,123.43,0.62
982,2021-05-04,EMR,29313,13728,15585,15165,13672,476,ITH,ITH5,8,Emilia-Romagna,Emilia-Romagna,4459477,5533496,124.08,0.66
983,2021-02-27,EMR,10969,3998,6971,9194,1742,33,ITH,ITH5,8,Emilia-Romagna,Emilia-Romagna,4459477,5544465,124.33,0.25
984,2021-04-25,EMR,22360,10244,12116,14403,7515,442,ITH,ITH5,8,Emilia-Romagna,Emilia-Romagna,4459477,5566825,124.83,0.5
985,2021-08-07,EMR,30959,17027,13932,17678,12209,1072,ITH,ITH5,8,Emilia-Romagna,Emilia-Romagna,4459477,5597784,125.53,0.69
986,2021-04-27,EMR,32135,14874,17261,19234,12470,431,ITH,ITH5,8,Emilia-Romagna,Emilia-Romagna,4459477,5629919,126.25,0.72
987,2021-08-14,EMR,15795,8908,6887,8314,7025,456,ITH,ITH5,8,Emilia-Romagna,Emilia-Romagna,4459477,5645714,126.6,0.35
988,2021-05-06,EMR,35986,16628,19358,22155,13102,729,ITH,ITH5,8,Emilia-Romagna,Emilia-Romagna,4459477,5681700,127.41,0.81
989,2021-01-26,EMR,8339,3002,5337,209,8129,1,ITH,ITH5,8,Emilia-Romagna,Emilia-Romagna,4459477,5690039,127.59,0.19
990,2021-07-02,EMR,34760,17094,17666,12382,21724,654,ITH,ITH5,8,Emilia-Romagna,Emilia-Romagna,4459477,5724799,128.37,0.78
991,2021-03-24,EMR,21242,9414,11828,13632,7387,223,ITH,ITH5,8,Emilia-Romagna,Emilia-Romagna,4459477,5746041,128.85,0.48
992,2021-01-24,EMR,2446,887,1559,298,2148,0,ITH,ITH5,8,Emilia-Romagna,Emilia-Romagna,4459477,5748487,128.9,0.05
993,2021-07-09,EMR,44925,22954,21971,5415,39087,423,ITH,ITH5,8,Emilia-Romagna,Emilia-Romagna,4459477,5793412,129.91,1.01
994,2021-01-17,EMR,2898,890,2008,2648,249,1,ITH,ITH5,8,Emilia-Romagna,Emilia-Romagna,4459477,5796310,129.98,0.06
995,2021-04-02,EMR,23370,10534,12836,18553,4488,329,ITH,ITH5,8,Emilia-Romagna,Emilia-Romagna,4459477,5819680,130.5,0.52
996,2021-09-06,EMR,24926,13221,11705,6980,17193,753,ITH,ITH5,8,Emilia-Romagna,Emilia-Romagna,4459477,5844606,131.06,0.56
997,2021-05-29,EMR,37953,16523,21430,16662,20767,524,ITH,ITH5,8,Emilia-Romagna,Emilia-Romagna,4459477,5882559,131.91,0.85
998,2021-07-11,EMR,30400,15244,15156,2756,27375,269,ITH,ITH5,8,Emilia-Romagna,Emilia-Romagna,4459477,5912959,132.59,0.68
999,2021-03-31,EMR,25285,11053,14232,19505,5473,307,ITH,ITH5,8,Emilia-Romagna,Emilia-Romagna,4459477,5938244,133.16,0.57
1000,2021-07-13,EMR,48494,24839,23655,6468,41338,688,ITH,ITH5,8,Emilia-Romagna,Emilia-Romagna,4459477,5986738,134.25,1.09
1001,2021-09-08,EMR,21975,11845,10130,5422,15968,585,ITH,ITH5,8,Emilia-Romagna,Emilia-Romagna,4459477,6008713,134.74,0.49
1002,2021-07-04,EMR,24272,12070,12202,10173,13608,491,ITH,ITH5,8,Emilia-Romagna,Emilia-Romagna,4459477,6032985,135.28,0.54
1003,2021-03-26,EMR,23738,10125,13613,17022,6443,273,ITH,ITH5,8,Emilia-Romagna,Emilia-Romagna,4459477,6056723,135.82,0.53
1004,2021-08-11,MAR,7571,4099,3472,3170,4165,236,ITI,ITI3,11,Marche,Marche,1525271,7571,0.5,0.5
1005,2021-06-15,MAR,13196,6571,6625,9825,3052,319,ITI,ITI3,11,Marche,Marche,1525271,20767,1.36,0.87
1006,2021-01-12,MAR,1234,418,816,1221,0,13,ITI,ITI3,11,Marche,Marche,1525271,22001,1.44,0.08
1007,2021-06-22,MAR,13219,6482,6737,6475,6461,283,ITI,ITI3,11,Marche,Marche,1525271,35220,2.31,0.87
1008,2021-04-26,MAR,9174,4064,5110,6018,3026,130,ITI,ITI3,11,Marche,Marche,1525271,44394,2.91,0.6
1009,2021-08-06,MAR,11703,6353,5350,4143,7278,282,ITI,ITI3,11,Marche,Marche,1525271,56097,3.68,0.77
1010,2021-05-15,MAR,14118,6441,7677,7826,6044,248,ITI,ITI3,11,Marche,Marche,1525271,70215,4.6,0.93
1011,2021-08-23,MAR,6195,3340,2855,2277,3650,268,ITI,ITI3,11,Marche,Marche,1525271,76410,5.01,0.41
1012,2021-02-19,MAR,2002,739,1263,1826,135,41,ITI,ITI3,11,Marche,Marche,1525271,78412,5.14,0.13
1013,2021-03-24,MAR,7098,3019,4079,3309,3716,73,ITI,ITI3,11,Marche,Marche,1525271,85510,5.61,0.47
1014,2021-06-01,MAR,12055,6157,5898,9679,2090,286,ITI,ITI3,11,Marche,Marche,1525271,97565,6.4,0.79
1015,2021-03-10,MAR,5713,2442,3271,4479,1180,54,ITI,ITI3,11,Marche,Marche,1525271,103278,6.77,0.37
1016,2021-02-21,MAR,376,141,235,363,1,12,ITI,ITI3,11,Marche,Marche,1525271,103654,6.8,0.02
1017,2021-04-05,MAR,5703,2367,3336,4352,1269,82,ITI,ITI3,11,Marche,Marche,1525271,109357,7.17,0.37
1018,2021-06-27,MAR,9950,4820,5130,4486,5292,172,ITI,ITI3,11,Marche,Marche,1525271,119307,7.82,0.65
1019,2021-03-19,MAR,3881,1621,2260,325,3544,12,ITI,ITI3,11,Marche,Marche,1525271,123188,8.08,0.25
1020,2021-01-21,MAR,922,262,660,577,328,17,ITI,ITI3,11,Marche,Marche,1525271,124110,8.14,0.06
1021,2021-05-01,MAR,9328,3927,5401,3500,5751,77,ITI,ITI3,11,Marche,Marche,1525271,133438,8.75,0.61
1022,2021-01-26,MAR,2021,747,1274,70,1942,9,ITI,ITI3,11,Marche,Marche,1525271,135459,8.88,0.13
1023,2021-07-11,MAR,10399,5220,5179,1605,8657,137,ITI,ITI3,11,Marche,Marche,1525271,145858,9.56,0.68
1024,2021-04-19,MAR,9609,4503,5106,7898,1588,123,ITI,ITI3,11,Marche,Marche,1525271,155467,10.19,0.63
1025,2021-07-28,MAR,14200,7371,6829,3249,10719,232,ITI,ITI3,11,Marche,Marche,1525271,169667,11.12,0.93
1026,2021-09-06,MAR,6375,3389,2986,1771,4391,213,ITI,ITI3,11,Marche,Marche,1525271,176042,11.54,0.42
1027,2021-05-27,MAR,13733,6818,6915,9180,4301,252,ITI,ITI3,11,Marche,Marche,1525271,189775,12.44,0.9
1028,2021-03-31,MAR,7376,3088,4288,4264,3025,87,ITI,ITI3,11,Marche,Marche,1525271,197151,12.93,0.48
1029,2021-09-04,MAR,5449,2976,2473,1641,3624,184,ITI,ITI3,11,Marche,Marche,1525271,202600,13.28,0.36
1030,2021-05-20,MAR,12684,5961,6723,7537,4896,251,ITI,ITI3,11,Marche,Marche,1525271,215284,14.11,0.83
1031,2021-02-07,MAR,1872,735,1137,331,1529,12,ITI,ITI3,11,Marche,Marche,1525271,217156,14.24,0.12
1032,2021-07-23,MAR,15543,8280,7263,2530,12789,224,ITI,ITI3,11,Marche,Marche,1525271,232699,15.26,1.02
1033,2021-08-18,MAR,6421,3421,3000,3214,2872,335,ITI,ITI3,11,Marche,Marche,1525271,239120,15.68,0.42
1034,2021-08-04,MAR,12003,6381,5622,4060,7701,242,ITI,ITI3,11,Marche,Marche,1525271,251123,16.46,0.79
1035,2021-07-04,MAR,10896,5445,5451,3204,7531,161,ITI,ITI3,11,Marche,Marche,1525271,262019,17.18,0.71
1036,2020-12-31,MAR,392,184,208,390,0,2,ITI,ITI3,11,Marche,Marche,1525271,262411,17.2,0.03
1037,2021-01-19,MAR,233,87,146,140,90,3,ITI,ITI3,11,Marche,Marche,1525271,262644,17.22,0.02
1038,2021-02-02,MAR,1193,398,795,70,1123,0,ITI,ITI3,11,Marche,Marche,1525271,263837,17.3,0.08
1039,2021-05-13,MAR,12615,5698,6917,6826,5508,281,ITI,ITI3,11,Marche,Marche,1525271,276452,18.12,0.83
1040,2021-04-12,MAR,8573,3775,4798,7933,482,158,ITI,ITI3,11,Marche,Marche,1525271,285025,18.69,0.56
1041,2021-01-02,MAR,458,143,315,456,0,2,ITI,ITI3,11,Marche,Marche,1525271,285483,18.72,0.03
1042,2021-03-17,MAR,3477,1525,1952,105,3370,2,ITI,ITI3,11,Marche,Marche,1525271,288960,18.94,0.23
1043,2021-08-30,MAR,5676,2841,2835,2358,3048,270,ITI,ITI3,11,Marche,Marche,1525271,294636,19.32,0.37
1044,2021-02-28,MAR,2836,1251,1585,2822,6,8,ITI,ITI3,11,Marche,Marche,1525271,297472,19.5,0.19
1045,2021-06-08,MAR,14098,7094,7004,11195,2611,292,ITI,ITI3,11,Marche,Marche,1525271,311570,20.43,0.92
1046,2021-02-14,MAR,739,301,438,727,0,12,ITI,ITI3,11,Marche,Marche,1525271,312309,20.48,0.05
1047,2021-08-16,MAR,5165,2781,2384,2983,2022,160,ITI,ITI3,11,Marche,Marche,1525271,317474,20.81,0.34
1048,2021-05-08,MAR,12293,5486,6807,4850,7265,178,ITI,ITI3,11,Marche,Marche,1525271,329767,21.62,0.81
1049,2021-07-30,MAR,14714,7863,6851,4867,9559,288,ITI,ITI3,11,Marche,Marche,1525271,344481,22.58,0.96
1050,2021-07-09,MAR,14903,7502,7401,2557,12132,214,ITI,ITI3,11,Marche,Marche,1525271,359384,23.56,0.98
1051,2021-03-29,MAR,5898,2584,3314,3391,2458,49,ITI,ITI3,11,Marche,Marche,1525271,365282,23.95,0.39
1052,2021-06-03,MAR,14638,7483,7155,12081,2252,305,ITI,ITI3,11,Marche,Marche,1525271,379920,24.91,0.96
1053,2021-07-18,MAR,12124,6310,5814,1333,10673,118,ITI,ITI3,11,Marche,Marche,1525271,392044,25.7,0.79
1054,2021-01-31,MAR,1921,772,1149,93,1824,4,ITI,ITI3,11,Marche,Marche,1525271,393965,25.83,0.13
1055,2021-04-07,MAR,8874,3933,4941,8358,369,147,ITI,ITI3,11,Marche,Marche,1525271,402839,26.41,0.58
1056,2021-02-09,MAR,125,42,83,46,79,0,ITI,ITI3,11,Marche,Marche,1525271,402964,26.42,0.01
1057,2021-07-16,MAR,15838,8239,7599,1844,13736,258,ITI,ITI3,11,Marche,Marche,1525271,418802,27.46,1.04
1058,2021-06-12,MAR,13781,7315,6466,12104,1346,331,ITI,ITI3,11,Marche,Marche,1525271,432583,28.36,0.9
1059,2021-04-16,MAR,10086,4705,5381,9349,526,211,ITI,ITI3,11,Marche,Marche,1525271,442669,29.02,0.66
1060,2021-03-05,MAR,6224,2873,3351,4689,1469,66,ITI,ITI3,11,Marche,Marche,1525271,448893,29.43,0.41
1061,2021-01-07,MAR,1821,642,1179,1804,0,17,ITI,ITI3,11,Marche,Marche,1525271,450714,29.55,0.12
1062,2021-03-12,MAR,4681,1999,2682,3346,1280,55,ITI,ITI3,11,Marche,Marche,1525271,455395,29.86,0.31
1063,2021-01-14,MAR,2019,696,1323,1995,0,24,ITI,ITI3,11,Marche,Marche,1525271,457414,29.99,0.13
1064,2021-06-20,MAR,11160,5547,5613,5990,4988,182,ITI,ITI3,11,Marche,Marche,1525271,468574,30.72,0.73
1065,2021-01-23,MAR,557,190,367,118,436,3,ITI,ITI3,11,Marche,Marche,1525271,469131,30.76,0.04
1066,2021-06-29,MAR,13373,6600,6773,4928,8215,230,ITI,ITI3,11,Marche,Marche,1525271,482504,31.63,0.88
1067,2021-05-03,MAR,10410,4690,5720,4857,5414,139,ITI,ITI3,11,Marche,Marche,1525271,492914,32.32,0.68
1068,2021-03-28,MAR,4128,1741,2387,2397,1693,38,ITI,ITI3,11,Marche,Marche,1525271,497042,32.59,0.27
1069,2021-01-30,MAR,1905,668,1237,24,1881,0,ITI,ITI3,11,Marche,Marche,1525271,498947,32.71,0.12
1070,2021-02-04,MAR,2389,844,1545,107,2277,5,ITI,ITI3,11,Marche,Marche,1525271,501336,32.87,0.16
1071,2021-01-18,MAR,696,237,459,536,149,11,ITI,ITI3,11,Marche,Marche,1525271,502032,32.91,0.05
1072,2021-04-28,MAR,10938,4983,5955,6018,4745,175,ITI,ITI3,11,Marche,Marche,1525271,512970,33.63,0.72
1073,2021-03-26,MAR,6392,2626,3766,3475,2859,58,ITI,ITI3,11,Marche,Marche,1525271,519362,34.05,0.42
1074,2021-06-17,MAR,15206,7566,7640,8798,6111,297,ITI,ITI3,11,Marche,Marche,1525271,534568,35.05,1.0
1075,2021-03-09,MAR,5431,2294,3137,4458,881,92,ITI,ITI3,11,Marche,Marche,1525271,539999,35.4,0.36
1076,2021-07-22,MAR,15747,8049,7698,2019,13487,241,ITI,ITI3,11,Marche,Marche,1525271,555746,36.44,1.03
1077,2021-08-25,MAR,5586,2992,2594,2724,2541,321,ITI,ITI3,11,Marche,Marche,1525271,561332,36.8,0.37
1078,2021-03-07,MAR,5180,2107,3073,4378,754,48,ITI,ITI3,11,Marche,Marche,1525271,566512,37.14,0.34
1079,2021-08-08,MAR,5637,3020,2617,1681,3845,111,ITI,ITI3,11,Marche,Marche,1525271,572149,37.51,0.37
1080,2021-07-06,MAR,13963,6920,7043,3142,10598,223,ITI,ITI3,11,Marche,Marche,1525271,586112,38.43,0.92
1081,2021-07-20,MAR,14396,7435,6961,1767,12454,175,ITI,ITI3,11,Marche,Marche,1525271,600508,39.37,0.94
1082,2021-01-16,MAR,2040,735,1305,1989,0,51,ITI,ITI3,11,Marche,Marche,1525271,602548,39.5,0.13
1083,2021-06-19,MAR,14698,7406,7292,7749,6683,266,ITI,ITI3,11,Marche,Marche,1525271,617246,40.47,0.96
1084,2021-05-31,MAR,11783,5944,5839,8599,2931,253,ITI,ITI3,11,Marche,Marche,1525271,629029,41.24,0.77
1085,2021-05-17,MAR,12051,5651,6400,7468,4354,229,ITI,ITI3,11,Marche,Marche,1525271,641080,42.03,0.79
1086,2021-09-08,MAR,7230,3780,3450,2063,4911,256,ITI,ITI3,11,Marche,Marche,1525271,648310,42.5,0.47
1087,2021-03-02,MAR,5002,1967,3035,4370,566,66,ITI,ITI3,11,Marche,Marche,1525271,653312,42.83,0.33
1088,2021-06-10,MAR,14930,7695,7235,12575,2013,342,ITI,ITI3,11,Marche,Marche,1525271,668242,43.81,0.98
1089,2021-09-01,MAR,6204,3279,2925,2019,3952,233,ITI,ITI3,11,Marche,Marche,1525271,674446,44.22,0.41
1090,2021-08-15,MAR,225,112,113,205,13,7,ITI,ITI3,11,Marche,Marche,1525271,674671,44.23,0.01
1091,2021-05-24,MAR,10999,5193,5806,7957,2865,177,ITI,ITI3,11,Marche,Marche,1525271,685670,44.95,0.72
1092,2021-05-10,MAR,9461,4341,5120,4755,4564,142,ITI,ITI3,11,Marche,Marche,1525271,695131,45.57,0.62
1093,2021-03-14,MAR,2499,1032,1467,1896,592,11,ITI,ITI3,11,Marche,Marche,1525271,697630,45.74,0.16
1094,2021-03-21,MAR,4506,1873,2633,1612,2877,17,ITI,ITI3,11,Marche,Marche,1525271,702136,46.03,0.3
1095,2021-02-06,MAR,2463,902,1561,512,1942,9,ITI,ITI3,11,Marche,Marche,1525271,704599,46.2,0.16
1096,2021-07-25,MAR,9351,4933,4418,1004,8249,98,ITI,ITI3,11,Marche,Marche,1525271,713950,46.81,0.61
1097,2021-01-04,MAR,1528,574,954,1515,0,13,ITI,ITI3,11,Marche,Marche,1525271,715478,46.91,0.1
1098,2021-04-14,MAR,10221,4565,5656,9653,369,199,ITI,ITI3,11,Marche,Marche,1525271,725699,47.58,0.67
1099,2020-12-30,MAR,17,5,12,17,0,0,ITI,ITI3,11,Marche,Marche,1525271,725716,47.58,0.0
1100,2021-01-09,MAR,1718,606,1112,1698,0,20,ITI,ITI3,11,Marche,Marche,1525271,727434,47.69,0.11
1101,2021-04-02,MAR,6894,2988,3906,6042,739,113,ITI,ITI3,11,Marche,Marche,1525271,734328,48.14,0.45
1102,2021-03-16,MAR,3522,1523,1999,285,3231,6,ITI,ITI3,11,Marche,Marche,1525271,737850,48.38,0.23
1103,2021-06-24,MAR,13844,6679,7165,6187,7386,271,ITI,ITI3,11,Marche,Marche,1525271,751694,49.28,0.91
1104,2021-01-11,MAR,1182,413,769,1164,0,18,ITI,ITI3,11,Marche,Marche,1525271,752876,49.36,0.08
1105,2021-04-21,MAR,10787,4969,5818,9426,1196,165,ITI,ITI3,11,Marche,Marche,1525271,763663,50.07,0.71
1106,2021-01-28,MAR,2092,727,1365,159,1932,1,ITI,ITI3,11,Marche,Marche,1525271,765755,50.2,0.14
1107,2021-04-04,MAR,3835,1797,2038,2614,1169,52,ITI,ITI3,11,Marche,Marche,1525271,769590,50.46,0.25
1108,2021-07-13,MAR,14853,7278,7575,1456,13268,129,ITI,ITI3,11,Marche,Marche,1525271,784443,51.43,0.97
1109,2021-08-31,MAR,4830,2561,2269,2014,2587,229,ITI,ITI3,11,Marche,Marche,1525271,789273,51.75,0.32
1110,2021-04-13,MAR,9840,4262,5578,9396,234,210,ITI,ITI3,11,Marche,Marche,1525271,799113,52.39,0.65
1111,2021-07-05,MAR,13168,6510,6658,2918,10078,172,ITI,ITI3,11,Marche,Marche,1525271,812281,53.25,0.86
1112,2021-06-16,MAR,13755,6912,6843,9126,4365,264,ITI,ITI3,11,Marche,Marche,1525271,826036,54.16,0.9
1113,2021-06-02,MAR,11902,5939,5963,11028,678,196,ITI,ITI3,11,Marche,Marche,1525271,837938,54.94,0.78
1114,2021-02-22,MAR,3461,1532,1929,3351,75,35,ITI,ITI3,11,Marche,Marche,1525271,841399,55.16,0.23
1115,2021-04-09,MAR,9570,4191,5379,9149,200,221,ITI,ITI3,11,Marche,Marche,1525271,850969,55.79,0.63
1116,2021-07-27,MAR,14369,7536,6833,3032,11111,226,ITI,ITI3,11,Marche,Marche,1525271,865338,56.73,0.94
1117,2021-01-06,MAR,2215,804,1411,2196,0,19,ITI,ITI3,11,Marche,Marche,1525271,867553,56.88,0.15
1118,2021-03-04,MAR,6539,2894,3645,5081,1395,63,ITI,ITI3,11,Marche,Marche,1525271,874092,57.31,0.43
1119,2021-07-17,MAR,15139,7792,7347,1384,13544,211,ITI,ITI3,11,Marche,Marche,1525271,889231,58.3,0.99
1120,2021-05-21,MAR,13909,6594,7315,7225,6472,212,ITI,ITI3,11,Marche,Marche,1525271,903140,59.21,0.91
1121,2021-08-29,MAR,453,255,198,245,182,26,ITI,ITI3,11,Marche,Marche,1525271,903593,59.24,0.03
1122,2021-04-24,MAR,12172,5366,6806,7557,4467,148,ITI,ITI3,11,Marche,Marche,1525271,915765,60.04,0.8
1123,2021-02-26,MAR,3681,1523,2158,3096,480,105,ITI,ITI3,11,Marche,Marche,1525271,919446,60.28,0.24
1124,2021-05-12,MAR,10430,4691,5739,4732,5505,193,ITI,ITI3,11,Marche,Marche,1525271,929876,60.96,0.68
1125,2021-08-20,MAR,4963,2693,2270,2952,1687,324,ITI,ITI3,11,Marche,Marche,1525271,934839,61.29,0.33
1126,2021-09-03,MAR,6440,3387,3053,2193,3966,281,ITI,ITI3,11,Marche,Marche,1525271,941279,61.71,0.42
1127,2021-07-08,MAR,15040,7539,7501,2787,12027,226,ITI,ITI3,11,Marche,Marche,1525271,956319,62.7,0.99
1128,2021-04-30,MAR,14166,6204,7962,5395,8573,198,ITI,ITI3,11,Marche,Marche,1525271,970485,63.63,0.93
1129,2021-04-11,MAR,7119,3116,4003,6683,287,149,ITI,ITI3,11,Marche,Marche,1525271,977604,64.09,0.47
1130,2021-03-11,MAR,6635,2823,3812,5144,1412,79,ITI,ITI3,11,Marche,Marche,1525271,984239,64.53,0.44
1131,2021-03-25,MAR,6703,2794,3909,3186,3456,61,ITI,ITI3,11,Marche,Marche,1525271,990942,64.97,0.44
1132,2021-07-03,MAR,13843,6991,6852,4136,9395,312,ITI,ITI3,11,Marche,Marche,1525271,1004785,65.88,0.91
1133,2021-02-20,MAR,4163,1732,2431,4042,111,10,ITI,ITI3,11,Marche,Marche,1525271,1008948,66.15,0.27
1134,2021-08-22,MAR,109,60,49,75,26,8,ITI,ITI3,11,Marche,Marche,1525271,1009057,66.16,0.01
1135,2021-01-20,MAR,406,100,306,384,20,2,ITI,ITI3,11,Marche,Marche,1525271,1009463,66.18,0.03
1136,2021-03-13,MAR,5807,2681,3126,1765,4002,40,ITI,ITI3,11,Marche,Marche,1525271,1015270,66.56,0.38
1137,2021-08-17,MAR,7594,4040,3554,3085,4285,224,ITI,ITI3,11,Marche,Marche,1525271,1022864,67.06,0.5
1138,2021-06-21,MAR,12607,6184,6423,5479,6881,247,ITI,ITI3,11,Marche,Marche,1525271,1035471,67.89,0.83
1139,2021-05-09,MAR,8866,4022,4844,3559,5230,77,ITI,ITI3,11,Marche,Marche,1525271,1044337,68.47,0.58
1140,2021-06-09,MAR,14280,7417,6863,12109,1869,302,ITI,ITI3,11,Marche,Marche,1525271,1058617,69.41,0.94
1141,2021-06-07,MAR,13323,6590,6733,10570,2450,303,ITI,ITI3,11,Marche,Marche,1525271,1071940,70.28,0.87
1142,2021-02-27,MAR,3401,1457,1944,3158,209,34,ITI,ITI3,11,Marche,Marche,1525271,1075341,70.5,0.22
1143,2021-05-28,MAR,13963,6741,7222,8801,4864,298,ITI,ITI3,11,Marche,Marche,1525271,1089304,71.42,0.92
1144,2021-04-01,MAR,7578,3185,4393,4063,3418,97,ITI,ITI3,11,Marche,Marche,1525271,1096882,71.91,0.5
1145,2021-09-05,MAR,194,99,95,131,37,26,ITI,ITI3,11,Marche,Marche,1525271,1097076,71.93,0.01
1146,2021-07-24,MAR,13277,7118,6159,2943,10077,257,ITI,ITI3,11,Marche,Marche,1525271,1110353,72.8,0.87
1147,2021-07-10,MAR,14160,7233,6927,1656,12301,203,ITI,ITI3,11,Marche,Marche,1525271,1124513,73.73,0.93
1148,2021-04-22,MAR,10798,4931,5867,9078,1579,141,ITI,ITI3,11,Marche,Marche,1525271,1135311,74.43,0.71
1149,2021-02-24,MAR,3534,1547,1987,3424,78,32,ITI,ITI3,11,Marche,Marche,1525271,1138845,74.67,0.23
1150,2021-06-04,MAR,14339,7291,7048,11588,2440,311,ITI,ITI3,11,Marche,Marche,1525271,1153184,75.61,0.94
1151,2021-04-08,MAR,9490,4157,5333,8960,370,160,ITI,ITI3,11,Marche,Marche,1525271,1162674,76.23,0.62
1152,2021-05-22,MAR,11941,5720,6221,7321,4449,171,ITI,ITI3,11,Marche,Marche,1525271,1174615,77.01,0.78
1153,2021-02-11,MAR,1988,657,1331,1557,390,41,ITI,ITI3,11,Marche,Marche,1525271,1176603,77.14,0.13
1154,2021-05-05,MAR,11696,5321,6375,5101,6433,162,ITI,ITI3,11,Marche,Marche,1525271,1188299,77.91,0.77
1155,2021-08-13,MAR,6751,3759,2992,3388,3151,212,ITI,ITI3,11,Marche,Marche,1525271,1195050,78.35,0.44
1156,2021-08-27,MAR,5714,3049,2665,2800,2513,401,ITI,ITI3,11,Marche,Marche,1525271,1200764,78.72,0.37
1157,2021-07-01,MAR,14696,7367,7329,4659,9759,278,ITI,ITI3,11,Marche,Marche,1525271,1215460,79.69,0.96
1158,2021-02-03,MAR,2130,743,1387,97,2012,21,ITI,ITI3,11,Marche,Marche,1525271,1217590,79.83,0.14
1159,2021-05-14,MAR,13639,6294,7345,6506,6915,218,ITI,ITI3,11,Marche,Marche,1525271,1231229,80.72,0.89
1160,2021-07-02,MAR,14553,7178,7375,4674,9648,231,ITI,ITI3,11,Marche,Marche,1525271,1245782,81.68,0.95
1161,2021-06-18,MAR,15347,7647,7700,8293,6753,301,ITI,ITI3,11,Marche,Marche,1525271,1261129,82.68,1.01
1162,2021-03-06,MAR,5739,2642,3097,4419,1268,52,ITI,ITI3,11,Marche,Marche,1525271,1266868,83.06,0.38
1163,2021-06-14,MAR,12838,6486,6352,9256,3310,272,ITI,ITI3,11,Marche,Marche,1525271,1279706,83.9,0.84
1164,2021-08-28,MAR,3145,1696,1449,1201,1800,144,ITI,ITI3,11,Marche,Marche,1525271,1282851,84.11,0.21
1165,2021-01-29,MAR,1995,731,1264,155,1835,5,ITI,ITI3,11,Marche,Marche,1525271,1284846,84.24,0.13
1166,2021-05-18,MAR,11276,5349,5927,7490,3604,182,ITI,ITI3,11,Marche,Marche,1525271,1296122,84.98,0.74
1167,2021-08-26,MAR,5681,3028,2653,2775,2545,361,ITI,ITI3,11,Marche,Marche,1525271,1301803,85.35,0.37
1168,2021-08-21,MAR,2978,1664,1314,1492,1312,174,ITI,ITI3,11,Marche,Marche,1525271,1304781,85.54,0.2
1169,2021-05-11,MAR,10624,4831,5793,5489,4943,192,ITI,ITI3,11,Marche,Marche,1525271,1315405,86.24,0.7
1170,2021-03-15,MAR,4452,2061,2391,1291,3140,21,ITI,ITI3,11,Marche,Marche,1525271,1319857,86.53,0.29
1171,2021-08-19,MAR,6273,3347,2926,3490,2454,329,ITI,ITI3,11,Marche,Marche,1525271,1326130,86.94,0.41
1172,2021-06-23,MAR,13892,6818,7074,6626,7010,256,ITI,ITI3,11,Marche,Marche,1525271,1340022,87.85,0.91
1173,2021-08-24,MAR,6440,3402,3038,3299,2759,382,ITI,ITI3,11,Marche,Marche,1525271,1346462,88.28,0.42
1174,2021-08-05,MAR,11906,6393,5513,4079,7560,267,ITI,ITI3,11,Marche,Marche,1525271,1358368,89.06,0.78
1175,2021-03-27,MAR,7428,3098,4330,4957,2396,75,ITI,ITI3,11,Marche,Marche,1525271,1365796,89.54,0.49
1176,2021-04-10,MAR,10932,4626,6306,10371,314,247,ITI,ITI3,11,Marche,Marche,1525271,1376728,90.26,0.72
1177,2021-01-03,MAR,912,358,554,902,0,10,ITI,ITI3,11,Marche,Marche,1525271,1377640,90.32,0.06
1178,2021-07-19,MAR,14678,7531,7147,1925,12538,215,ITI,ITI3,11,Marche,Marche,1525271,1392318,91.28,0.96
1179,2021-03-08,MAR,6301,2762,3539,5188,1002,111,ITI,ITI3,11,Marche,Marche,1525271,1398619,91.7,0.41
1180,2021-02-05,MAR,2158,655,1503,438,1719,1,ITI,ITI3,11,Marche,Marche,1525271,1400777,91.84,0.14
1181,2021-05-16,MAR,10899,4958,5941,6546,4231,122,ITI,ITI3,11,Marche,Marche,1525271,1411676,92.55,0.71
1182,2021-03-03,MAR,6700,3076,3624,5716,885,99,ITI,ITI3,11,Marche,Marche,1525271,1418376,92.99,0.44
1183,2021-01-05,MAR,1589,594,995,1570,0,19,ITI,ITI3,11,Marche,Marche,1525271,1419965,93.1,0.1
1184,2021-04-15,MAR,10378,4675,5703,9571,564,243,ITI,ITI3,11,Marche,Marche,1525271,1430343,93.78,0.68
1185,2021-02-17,MAR,1828,701,1127,1642,118,68,ITI,ITI3,11,Marche,Marche,1525271,1432171,93.9,0.12
1186,2021-03-18,MAR,3440,1507,1933,149,3279,12,ITI,ITI3,11,Marche,Marche,1525271,1435611,94.12,0.23
1187,2021-06-26,MAR,13577,6906,6671,5688,7672,217,ITI,ITI3,11,Marche,Marche,1525271,1449188,95.01,0.89
1188,2021-05-23,MAR,9210,4284,4926,7414,1672,124,ITI,ITI3,11,Marche,Marche,1525271,1458398,95.62,0.6
1189,2021-05-06,MAR,12660,5825,6835,5356,7076,228,ITI,ITI3,11,Marche,Marche,1525271,1471058,96.45,0.83
1190,2021-02-12,MAR,1581,618,963,1404,151,26,ITI,ITI3,11,Marche,Marche,1525271,1472639,96.55,0.1
1191,2021-08-14,MAR,2400,1378,1022,1033,1318,49,ITI,ITI3,11,Marche,Marche,1525271,1475039,96.71,0.16
1192,2021-02-10,MAR,1441,452,989,1040,359,42,ITI,ITI3,11,Marche,Marche,1525271,1476480,96.8,0.09
1193,2021-02-15,MAR,967,412,555,939,13,15,ITI,ITI3,11,Marche,Marche,1525271,1477447,96.86,0.06
1194,2021-05-26,MAR,11889,5952,5937,8448,3227,214,ITI,ITI3,11,Marche,Marche,1525271,1489336,97.64,0.78
1195,2021-03-30,MAR,7486,3080,4406,4576,2834,76,ITI,ITI3,11,Marche,Marche,1525271,1496822,98.13,0.49
1196,2021-02-01,MAR,1362,479,883,93,1266,3,ITI,ITI3,11,Marche,Marche,1525271,1498184,98.22,0.09
1197,2021-08-07,MAR,9454,5194,4260,3473,5742,239,ITI,ITI3,11,Marche,Marche,1525271,1507638,98.84,0.62
1198,2021-07-21,MAR,14922,7618,7304,2065,12644,213,ITI,ITI3,11,Marche,Marche,1525271,1522560,99.82,0.98
1199,2021-04-29,MAR,13452,6159,7293,7161,6107,184,ITI,ITI3,11,Marche,Marche,1525271,1536012,100.7,0.88
1200,2021-05-07,MAR,12838,5803,7035,3550,9186,102,ITI,ITI3,11,Marche,Marche,1525271,1548850,101.55,0.84
1201,2021-02-13,MAR,1093,462,631,988,82,23,ITI,ITI3,11,Marche,Marche,1525271,1549943,101.62,0.07
1202,2021-01-27,MAR,2119,778,1341,113,2004,2,ITI,ITI3,11,Marche,Marche,1525271,1552062,101.76,0.14
1203,2021-04-20,MAR,10756,5030,5726,9147,1472,137,ITI,ITI3,11,Marche,Marche,1525271,1562818,102.46,0.71
1204,2021-07-29,MAR,14846,7880,6966,4580,9955,311,ITI,ITI3,11,Marche,Marche,1525271,1577664,103.43,0.97
1205,2021-01-25,MAR,1597,559,1038,90,1507,0,ITI,ITI3,11,Marche,Marche,1525271,1579261,103.54,0.1
1206,2021-01-08,MAR,1583,592,991,1568,0,15,ITI,ITI3,11,Marche,Marche,1525271,1580844,103.64,0.1
1207,2021-04-18,MAR,8824,4131,4693,7728,921,175,ITI,ITI3,11,Marche,Marche,1525271,1589668,104.22,0.58
1208,2021-04-06,MAR,8876,3693,5183,7928,810,138,ITI,ITI3,11,Marche,Marche,1525271,1598544,104.8,0.58
1209,2021-03-23,MAR,5839,2557,3282,2225,3576,38,ITI,ITI3,11,Marche,Marche,1525271,1604383,105.19,0.38
1210,2021-02-08,MAR,834,259,575,366,463,5,ITI,ITI3,11,Marche,Marche,1525271,1605217,105.24,0.05
1211,2021-07-15,MAR,16010,8287,7723,1750,14032,228,ITI,ITI3,11,Marche,Marche,1525271,1621227,106.29,1.05
1212,2021-05-19,MAR,11665,5364,6301,8367,3101,197,ITI,ITI3,11,Marche,Marche,1525271,1632892,107.06,0.76
1213,2021-04-17,MAR,11705,5317,6388,10393,1073,239,ITI,ITI3,11,Marche,Marche,1525271,1644597,107.82,0.77
1214,2021-07-26,MAR,11034,5740,5294,2111,8715,208,ITI,ITI3,11,Marche,Marche,1525271,1655631,108.55,0.72
1215,2021-08-09,MAR,9095,4829,4266,4051,4771,273,ITI,ITI3,11,Marche,Marche,1525271,1664726,109.14,0.6
1216,2021-06-11,MAR,14003,7156,6847,11374,2324,305,ITI,ITI3,11,Marche,Marche,1525271,1678729,110.06,0.92
1217,2021-05-25,MAR,11769,5798,5971,8497,3052,220,ITI,ITI3,11,Marche,Marche,1525271,1690498,110.83,0.77
1218,2021-09-02,MAR,6387,3402,2985,2129,4044,214,ITI,ITI3,11,Marche,Marche,1525271,1696885,111.25,0.42
1219,2021-03-01,MAR,3772,1520,2252,3503,248,21,ITI,ITI3,11,Marche,Marche,1525271,1700657,111.5,0.25
1220,2021-05-30,MAR,9736,4691,5045,6546,2993,197,ITI,ITI3,11,Marche,Marche,1525271,1710393,112.14,0.64
1221,2021-09-07,MAR,6140,3221,2919,1743,4194,203,ITI,ITI3,11,Marche,Marche,1525271,1716533,112.54,0.4
1222,2021-04-27,MAR,9594,4390,5204,5506,3990,98,ITI,ITI3,11,Marche,Marche,1525271,1726127,113.17,0.63
1223,2021-01-17,MAR,1625,695,930,1555,64,6,ITI,ITI3,11,Marche,Marche,1525271,1727752,113.28,0.11
1224,2021-07-31,MAR,13203,7250,5953,5142,7731,330,ITI,ITI3,11,Marche,Marche,1525271,1740955,114.14,0.87
1225,2021-07-14,MAR,13851,6818,7033,1784,11875,192,ITI,ITI3,11,Marche,Marche,1525271,1754806,115.05,0.91
1226,2021-01-10,MAR,1746,702,1044,1732,0,14,ITI,ITI3,11,Marche,Marche,1525271,1756552,115.16,0.11
1227,2021-07-12,MAR,13724,6805,6919,1228,12378,118,ITI,ITI3,11,Marche,Marche,1525271,1770276,116.06,0.9
1228,2021-04-03,MAR,7577,3204,4373,6736,667,174,ITI,ITI3,11,Marche,Marche,1525271,1777853,116.56,0.5
1229,2021-06-25,MAR,14345,7171,7174,6419,7637,289,ITI,ITI3,11,Marche,Marche,1525271,1792198,117.5,0.94
1230,2021-06-13,MAR,10752,5566,5186,9203,1299,250,ITI,ITI3,11,Marche,Marche,1525271,1802950,118.21,0.7
1231,2020-12-27,MAR,209,100,109,207,0,2,ITI,ITI3,11,Marche,Marche,1525271,1803159,118.22,0.01
1232,2021-08-02,MAR,11727,6209,5518,4601,6868,258,ITI,ITI3,11,Marche,Marche,1525271,1814886,118.99,0.77
1233,2021-06-06,MAR,12456,6140,6316,10642,1578,236,ITI,ITI3,11,Marche,Marche,1525271,1827342,119.8,0.82
1234,2021-02-18,MAR,2146,787,1359,1806,288,52,ITI,ITI3,11,Marche,Marche,1525271,1829488,119.95,0.14
1235,2021-05-29,MAR,12876,6240,6636,8118,4540,218,ITI,ITI3,11,Marche,Marche,1525271,1842364,120.79,0.84
1236,2021-02-16,MAR,1287,475,812,1225,30,32,ITI,ITI3,11,Marche,Marche,1525271,1843651,120.87,0.08
1237,2021-02-25,MAR,3561,1465,2096,3317,181,63,ITI,ITI3,11,Marche,Marche,1525271,1847212,121.11,0.23
1238,2021-08-01,MAR,7497,4049,3448,1835,5577,85,ITI,ITI3,11,Marche,Marche,1525271,1854709,121.6,0.49
1239,2021-06-05,MAR,13944,7011,6933,11520,2058,366,ITI,ITI3,11,Marche,Marche,1525271,1868653,122.51,0.91
1240,2021-04-23,MAR,11318,5222,6096,8098,3055,165,ITI,ITI3,11,Marche,Marche,1525271,1879971,123.25,0.74
1241,2021-02-23,MAR,3314,1432,1882,3243,56,15,ITI,ITI3,11,Marche,Marche,1525271,1883285,123.47,0.22
1242,2021-01-15,MAR,1772,500,1272,1755,0,17,ITI,ITI3,11,Marche,Marche,1525271,1885057,123.59,0.12
1243,2021-04-25,MAR,8605,3996,4609,6894,1578,133,ITI,ITI3,11,Marche,Marche,1525271,1893662,124.15,0.56
1244,2021-08-03,MAR,10883,5740,5143,4034,6582,267,ITI,ITI3,11,Marche,Marche,1525271,1904545,124.87,0.71
1245,2021-08-12,MAR,8017,4329,3688,3888,3768,361,ITI,ITI3,11,Marche,Marche,1525271,1912562,125.39,0.53
1246,2021-01-13,MAR,2114,747,1367,2073,0,41,ITI,ITI3,11,Marche,Marche,1525271,1914676,125.53,0.14
1247,2021-05-02,MAR,8905,3940,4965,3078,5742,85,ITI,ITI3,11,Marche,Marche,1525271,1923581,126.11,0.58
1248,2021-08-10,MAR,9200,4814,4386,3332,5593,275,ITI,ITI3,11,Marche,Marche,1525271,1932781,126.72,0.6
1249,2021-06-28,MAR,12362,6026,6336,4614,7511,237,ITI,ITI3,11,Marche,Marche,1525271,1945143,127.53,0.81
1250,2021-03-22,MAR,5703,2412,3291,2478,3178,47,ITI,ITI3,11,Marche,Marche,1525271,1950846,127.9,0.37
1251,2021-01-24,MAR,881,339,542,3,878,0,ITI,ITI3,11,Marche,Marche,1525271,1951727,127.96,0.06
1252,2021-06-30,MAR,13649,6663,6986,4452,8986,211,ITI,ITI3,11,Marche,Marche,1525271,1965376,128.85,0.89
1253,2021-05-04,MAR,10975,4841,6134,4926,5906,143,ITI,ITI3,11,Marche,Marche,1525271,1976351,129.57,0.72
1254,2021-03-20,MAR,4178,1759,2419,1034,3129,15,ITI,ITI3,11,Marche,Marche,1525271,1980529,129.85,0.27
1255,2021-01-22,MAR,489,168,321,193,294,2,ITI,ITI3,11,Marche,Marche,1525271,1981018,129.88,0.03
1256,2021-07-07,MAR,14259,7069,7190,2934,11082,243,ITI,ITI3,11,Marche,Marche,1525271,1995277,130.81,0.93
1257,2021-09-08,PAT,1360,698,662,431,902,27,ITH,ITH2,4,Provincia Autonoma Trento,P.A. Trento,541380,1360,0.25,0.25
1258,2021-07-27,PAT,4815,2546,2269,1752,2951,112,ITH,ITH2,4,Provincia Autonoma Trento,P.A. Trento,541380,6175,1.14,0.89
1259,2021-05-31,PAT,4806,2214,2592,1607,3088,111,ITH,ITH2,4,Provincia Autonoma Trento,P.A. Trento,541380,10981,2.03,0.89
1260,2021-08-08,PAT,635,338,297,241,386,8,ITH,ITH2,4,Provincia Autonoma Trento,P.A. Trento,541380,11616,2.15,0.12
1261,2021-08-27,PAT,3797,2064,1733,927,2790,80,ITH,ITH2,4,Provincia Autonoma Trento,P.A. Trento,541380,15413,2.85,0.7
1262,2021-03-26,PAT,3277,1282,1995,2519,612,146,ITH,ITH2,4,Provincia Autonoma Trento,P.A. Trento,541380,18690,3.45,0.61
1263,2021-02-06,PAT,582,302,280,439,143,0,ITH,ITH2,4,Provincia Autonoma Trento,P.A. Trento,541380,19272,3.56,0.11
1264,2021-02-23,PAT,1128,403,725,887,218,23,ITH,ITH2,4,Provincia Autonoma Trento,P.A. Trento,541380,20400,3.77,0.21
1265,2021-05-17,PAT,4357,2157,2200,3752,363,242,ITH,ITH2,4,Provincia Autonoma Trento,P.A. Trento,541380,24757,4.57,0.8
1266,2021-08-25,PAT,4391,2345,2046,1082,3236,73,ITH,ITH2,4,Provincia Autonoma Trento,P.A. Trento,541380,29148,5.38,0.81
1267,2021-06-29,PAT,6427,3241,3186,2773,3533,121,ITH,ITH2,4,Provincia Autonoma Trento,P.A. Trento,541380,35575,6.57,1.19
1268,2021-06-12,PAT,5428,2717,2711,436,4942,50,ITH,ITH2,4,Provincia Autonoma Trento,P.A. Trento,541380,41003,7.57,1.0
1269,2021-03-21,PAT,136,74,62,131,0,5,ITH,ITH2,4,Provincia Autonoma Trento,P.A. Trento,541380,41139,7.6,0.03
1270,2021-04-09,PAT,2806,1195,1611,1528,1209,69,ITH,ITH2,4,Provincia Autonoma Trento,P.A. Trento,541380,43945,8.12,0.52
1271,2021-02-11,PAT,1171,377,794,803,367,1,ITH,ITH2,4,Provincia Autonoma Trento,P.A. Trento,541380,45116,8.33,0.22
1272,2021-07-18,PAT,464,243,221,116,339,9,ITH,ITH2,4,Provincia Autonoma Trento,P.A. Trento,541380,45580,8.42,0.09
1273,2021-02-25,PAT,1656,649,1007,1200,446,10,ITH,ITH2,4,Provincia Autonoma Trento,P.A. Trento,541380,47236,8.73,0.31
1274,2020-12-30,PAT,7,3,4,7,0,0,ITH,ITH2,4,Provincia Autonoma Trento,P.A. Trento,541380,47243,8.73,0.0
1275,2021-06-05,PAT,4132,1939,2193,689,3364,79,ITH,ITH2,4,Provincia Autonoma Trento,P.A. Trento,541380,51375,9.49,0.76
1276,2021-07-13,PAT,3839,1952,1887,1777,1934,128,ITH,ITH2,4,Provincia Autonoma Trento,P.A. Trento,541380,55214,10.2,0.71
1277,2021-04-21,PAT,2945,1372,1573,2739,51,155,ITH,ITH2,4,Provincia Autonoma Trento,P.A. Trento,541380,58159,10.74,0.54
1278,2021-01-28,PAT,554,156,398,51,503,0,ITH,ITH2,4,Provincia Autonoma Trento,P.A. Trento,541380,58713,10.85,0.1
1279,2021-01-11,PAT,765,235,530,765,0,0,ITH,ITH2,4,Provincia Autonoma Trento,P.A. Trento,541380,59478,10.99,0.14
1280,2021-03-09,PAT,1670,620,1050,980,653,37,ITH,ITH2,4,Provincia Autonoma Trento,P.A. Trento,541380,61148,11.29,0.31
1281,2021-06-17,PAT,6752,3563,3189,2044,4538,170,ITH,ITH2,4,Provincia Autonoma Trento,P.A. Trento,541380,67900,12.54,1.25
1282,2021-01-23,PAT,584,338,246,389,194,1,ITH,ITH2,4,Provincia Autonoma Trento,P.A. Trento,541380,68484,12.65,0.11
1283,2021-05-03,PAT,4311,2223,2088,3844,157,310,ITH,ITH2,4,Provincia Autonoma Trento,P.A. Trento,541380,72795,13.45,0.8
1284,2021-08-13,PAT,5955,3374,2581,2581,3225,149,ITH,ITH2,4,Provincia Autonoma Trento,P.A. Trento,541380,78750,14.55,1.1
1285,2021-07-01,PAT,7150,3737,3413,3591,3364,195,ITH,ITH2,4,Provincia Autonoma Trento,P.A. Trento,541380,85900,15.87,1.32
1286,2021-05-05,PAT,5059,2611,2448,4434,305,320,ITH,ITH2,4,Provincia Autonoma Trento,P.A. Trento,541380,90959,16.8,0.93
1287,2021-07-20,PAT,4828,2610,2218,1745,2933,150,ITH,ITH2,4,Provincia Autonoma Trento,P.A. Trento,541380,95787,17.69,0.89
1288,2021-06-19,PAT,3146,1722,1424,236,2879,31,ITH,ITH2,4,Provincia Autonoma Trento,P.A. Trento,541380,98933,18.27,0.58
1289,2021-07-08,PAT,4164,2213,1951,2514,1482,168,ITH,ITH2,4,Provincia Autonoma Trento,P.A. Trento,541380,103097,19.04,0.77
1290,2021-02-04,PAT,1014,321,693,430,583,1,ITH,ITH2,4,Provincia Autonoma Trento,P.A. Trento,541380,104111,19.23,0.19
1291,2021-04-14,PAT,3146,1480,1666,2252,738,156,ITH,ITH2,4,Provincia Autonoma Trento,P.A. Trento,541380,107257,19.81,0.58
1292,2021-03-28,PAT,768,304,464,717,2,49,ITH,ITH2,4,Provincia Autonoma Trento,P.A. Trento,541380,108025,19.95,0.14
1293,2021-01-04,PAT,905,250,655,903,0,2,ITH,ITH2,4,Provincia Autonoma Trento,P.A. Trento,541380,108930,20.12,0.17
1294,2021-07-06,PAT,5238,2763,2475,3116,1931,191,ITH,ITH2,4,Provincia Autonoma Trento,P.A. Trento,541380,114168,21.09,0.97
1295,2021-01-18,PAT,690,168,522,631,59,0,ITH,ITH2,4,Provincia Autonoma Trento,P.A. Trento,541380,114858,21.22,0.13
1296,2021-05-24,PAT,4492,2077,2415,1269,3109,114,ITH,ITH2,4,Provincia Autonoma Trento,P.A. Trento,541380,119350,22.05,0.83
1297,2021-09-01,PAT,3916,2088,1828,829,3012,75,ITH,ITH2,4,Provincia Autonoma Trento,P.A. Trento,541380,123266,22.77,0.72
1298,2021-03-02,PAT,1323,446,877,910,382,31,ITH,ITH2,4,Provincia Autonoma Trento,P.A. Trento,541380,124589,23.01,0.24
1299,2021-06-10,PAT,6215,3027,3188,1813,4265,137,ITH,ITH2,4,Provincia Autonoma Trento,P.A. Trento,541380,130804,24.16,1.15
1300,2021-09-03,PAT,3470,1901,1569,784,2637,49,ITH,ITH2,4,Provincia Autonoma Trento,P.A. Trento,541380,134274,24.8,0.64
1301,2021-02-16,PAT,676,248,428,660,5,11,ITH,ITH2,4,Provincia Autonoma Trento,P.A. Trento,541380,134950,24.93,0.12
1302,2021-04-23,PAT,3668,1786,1882,3430,56,182,ITH,ITH2,4,Provincia Autonoma Trento,P.A. Trento,541380,138618,25.6,0.68
1303,2021-01-30,PAT,396,136,260,155,241,0,ITH,ITH2,4,Provincia Autonoma Trento,P.A. Trento,541380,139014,25.68,0.07
1304,2021-05-10,PAT,3270,1678,1592,2531,518,221,ITH,ITH2,4,Provincia Autonoma Trento,P.A. Trento,541380,142284,26.28,0.6
1305,2021-03-14,PAT,110,67,43,19,89,2,ITH,ITH2,4,Provincia Autonoma Trento,P.A. Trento,541380,142394,26.3,0.02
1306,2021-03-07,PAT,24,6,18,24,0,0,ITH,ITH2,4,Provincia Autonoma Trento,P.A. Trento,541380,142418,26.31,0.0
1307,2021-01-09,PAT,195,42,153,195,0,0,ITH,ITH2,4,Provincia Autonoma Trento,P.A. Trento,541380,142613,26.34,0.04
1308,2021-06-24,PAT,6056,3171,2885,3651,2208,197,ITH,ITH2,4,Provincia Autonoma Trento,P.A. Trento,541380,148669,27.46,1.12
1309,2021-05-12,PAT,3348,1511,1837,1962,1220,166,ITH,ITH2,4,Provincia Autonoma Trento,P.A. Trento,541380,152017,28.08,0.62
1310,2021-03-16,PAT,1407,514,893,581,792,34,ITH,ITH2,4,Provincia Autonoma Trento,P.A. Trento,541380,153424,28.34,0.26
1311,2021-08-20,PAT,5215,2878,2337,1485,3630,100,ITH,ITH2,4,Provincia Autonoma Trento,P.A. Trento,541380,158639,29.3,0.96
1312,2021-05-14,PAT,5443,2614,2829,3714,1428,301,ITH,ITH2,4,Provincia Autonoma Trento,P.A. Trento,541380,164082,30.31,1.01
1313,2021-08-22,PAT,406,243,163,220,171,15,ITH,ITH2,4,Provincia Autonoma Trento,P.A. Trento,541380,164488,30.38,0.07
1314,2021-08-06,PAT,6473,3565,2908,2667,3685,121,ITH,ITH2,4,Provincia Autonoma Trento,P.A. Trento,541380,170961,31.58,1.2
1315,2021-01-16,PAT,322,148,174,322,0,0,ITH,ITH2,4,Provincia Autonoma Trento,P.A. Trento,541380,171283,31.64,0.06
1316,2021-04-28,PAT,4289,1994,2295,3896,139,254,ITH,ITH2,4,Provincia Autonoma Trento,P.A. Trento,541380,175572,32.43,0.79
1317,2021-05-22,PAT,3374,1666,1708,849,2434,91,ITH,ITH2,4,Provincia Autonoma Trento,P.A. Trento,541380,178946,33.05,0.62
1318,2021-05-29,PAT,2445,1328,1117,783,1571,91,ITH,ITH2,4,Provincia Autonoma Trento,P.A. Trento,541380,181391,33.51,0.45
1319,2021-04-02,PAT,2892,1178,1714,2043,684,165,ITH,ITH2,4,Provincia Autonoma Trento,P.A. Trento,541380,184283,34.04,0.53
1320,2021-04-16,PAT,2906,1377,1529,2597,150,159,ITH,ITH2,4,Provincia Autonoma Trento,P.A. Trento,541380,187189,34.58,0.54
1321,2021-02-18,PAT,1436,504,932,1349,69,18,ITH,ITH2,4,Provincia Autonoma Trento,P.A. Trento,541380,188625,34.84,0.27
1322,2021-07-25,PAT,366,205,161,139,218,9,ITH,ITH2,4,Provincia Autonoma Trento,P.A. Trento,541380,188991,34.91,0.07
1323,2021-02-20,PAT,412,247,165,124,287,1,ITH,ITH2,4,Provincia Autonoma Trento,P.A. Trento,541380,189403,34.99,0.08
1324,2021-01-08,PAT,1537,341,1196,1536,0,1,ITH,ITH2,4,Provincia Autonoma Trento,P.A. Trento,541380,190940,35.27,0.28
1325,2021-06-14,PAT,5819,3010,2809,2043,3656,120,ITH,ITH2,4,Provincia Autonoma Trento,P.A. Trento,541380,196759,36.34,1.07
1326,2021-04-18,PAT,1865,850,1015,1796,9,60,ITH,ITH2,4,Provincia Autonoma Trento,P.A. Trento,541380,198624,36.69,0.34
1327,2021-03-06,PAT,809,285,524,615,152,42,ITH,ITH2,4,Provincia Autonoma Trento,P.A. Trento,541380,199433,36.84,0.15
1328,2021-04-13,PAT,2618,1090,1528,2026,509,83,ITH,ITH2,4,Provincia Autonoma Trento,P.A. Trento,541380,202051,37.32,0.48
1329,2021-01-20,PAT,308,77,231,296,12,0,ITH,ITH2,4,Provincia Autonoma Trento,P.A. Trento,541380,202359,37.38,0.06
1330,2021-04-30,PAT,4992,2434,2558,4443,163,386,ITH,ITH2,4,Provincia Autonoma Trento,P.A. Trento,541380,207351,38.3,0.92
1331,2021-05-19,PAT,5196,2514,2682,3671,1274,251,ITH,ITH2,4,Provincia Autonoma Trento,P.A. Trento,541380,212547,39.26,0.96
1332,2021-06-02,PAT,2884,1383,1501,895,1916,73,ITH,ITH2,4,Provincia Autonoma Trento,P.A. Trento,541380,215431,39.79,0.53
1333,2021-03-11,PAT,2622,984,1638,1507,1055,60,ITH,ITH2,4,Provincia Autonoma Trento,P.A. Trento,541380,218053,40.28,0.48
1334,2021-07-22,PAT,4778,2587,2191,1901,2738,139,ITH,ITH2,4,Provincia Autonoma Trento,P.A. Trento,541380,222831,41.16,0.88
1335,2021-08-24,PAT,4601,2467,2134,1287,3221,93,ITH,ITH2,4,Provincia Autonoma Trento,P.A. Trento,541380,227432,42.01,0.85
1336,2021-07-24,PAT,994,547,447,525,445,24,ITH,ITH2,4,Provincia Autonoma Trento,P.A. Trento,541380,228426,42.19,0.18
1337,2021-05-02,PAT,3564,1979,1585,3294,39,231,ITH,ITH2,4,Provincia Autonoma Trento,P.A. Trento,541380,231990,42.85,0.66
1338,2021-08-10,PAT,5994,3204,2790,2896,2912,186,ITH,ITH2,4,Provincia Autonoma Trento,P.A. Trento,541380,237984,43.96,1.11
1339,2021-03-13,PAT,965,496,469,841,48,76,ITH,ITH2,4,Provincia Autonoma Trento,P.A. Trento,541380,238949,44.14,0.18
1340,2021-07-05,PAT,5433,2850,2583,3793,1392,248,ITH,ITH2,4,Provincia Autonoma Trento,P.A. Trento,541380,244382,45.14,1.0
1341,2021-06-21,PAT,6260,3387,2873,3649,2425,186,ITH,ITH2,4,Provincia Autonoma Trento,P.A. Trento,541380,250642,46.3,1.16
1342,2021-03-04,PAT,2388,807,1581,1556,790,42,ITH,ITH2,4,Provincia Autonoma Trento,P.A. Trento,541380,253030,46.74,0.44
1343,2021-04-11,PAT,2392,1161,1231,2201,99,92,ITH,ITH2,4,Provincia Autonoma Trento,P.A. Trento,541380,255422,47.18,0.44
1344,2021-02-27,PAT,1054,468,586,606,428,20,ITH,ITH2,4,Provincia Autonoma Trento,P.A. Trento,541380,256476,47.37,0.19
1345,2021-08-03,PAT,6213,3357,2856,2488,3596,129,ITH,ITH2,4,Provincia Autonoma Trento,P.A. Trento,541380,262689,48.52,1.15
1346,2021-01-01,PAT,222,51,171,222,0,0,ITH,ITH2,4,Provincia Autonoma Trento,P.A. Trento,541380,262911,48.56,0.04
1347,2021-06-07,PAT,5885,2929,2956,2679,3025,181,ITH,ITH2,4,Provincia Autonoma Trento,P.A. Trento,541380,268796,49.65,1.09
1348,2021-04-25,PAT,2003,953,1050,1873,7,123,ITH,ITH2,4,Provincia Autonoma Trento,P.A. Trento,541380,270799,50.02,0.37
1349,2021-04-01,PAT,2945,1251,1694,1745,1106,94,ITH,ITH2,4,Provincia Autonoma Trento,P.A. Trento,541380,273744,50.56,0.54
1350,2021-07-10,PAT,1098,565,533,148,920,30,ITH,ITH2,4,Provincia Autonoma Trento,P.A. Trento,541380,274842,50.77,0.2
1351,2021-03-23,PAT,2483,962,1521,1628,755,100,ITH,ITH2,4,Provincia Autonoma Trento,P.A. Trento,541380,277325,51.23,0.46
1352,2021-05-28,PAT,3805,1768,2037,1399,2265,141,ITH,ITH2,4,Provincia Autonoma Trento,P.A. Trento,541380,281130,51.93,0.7
1353,2021-01-25,PAT,849,231,618,25,824,0,ITH,ITH2,4,Provincia Autonoma Trento,P.A. Trento,541380,281979,52.09,0.16
1354,2021-03-25,PAT,2916,1128,1788,1742,1060,114,ITH,ITH2,4,Provincia Autonoma Trento,P.A. Trento,541380,284895,52.62,0.54
1355,2021-07-03,PAT,1268,681,587,78,1185,5,ITH,ITH2,4,Provincia Autonoma Trento,P.A. Trento,541380,286163,52.86,0.23
1356,2021-03-18,PAT,2335,964,1371,1221,1089,25,ITH,ITH2,4,Provincia Autonoma Trento,P.A. Trento,541380,288498,53.29,0.43
1357,2021-06-09,PAT,6328,3123,3205,2114,4130,84,ITH,ITH2,4,Provincia Autonoma Trento,P.A. Trento,541380,294826,54.46,1.17
1358,2021-06-26,PAT,1436,753,683,678,727,31,ITH,ITH2,4,Provincia Autonoma Trento,P.A. Trento,541380,296262,54.72,0.27
1359,2021-06-28,PAT,6954,3597,3357,2960,3869,125,ITH,ITH2,4,Provincia Autonoma Trento,P.A. Trento,541380,303216,56.01,1.28
1360,2021-04-06,PAT,2288,969,1319,1459,770,59,ITH,ITH2,4,Provincia Autonoma Trento,P.A. Trento,541380,305504,56.43,0.42
1361,2021-07-15,PAT,4298,2300,1998,1790,2364,144,ITH,ITH2,4,Provincia Autonoma Trento,P.A. Trento,541380,309802,57.22,0.79
1362,2021-01-13,PAT,444,131,313,444,0,0,ITH,ITH2,4,Provincia Autonoma Trento,P.A. Trento,541380,310246,57.31,0.08
1363,2021-07-07,PAT,4529,2432,2097,2922,1406,201,ITH,ITH2,4,Provincia Autonoma Trento,P.A. Trento,541380,314775,58.14,0.84
1364,2021-01-03,PAT,503,166,337,503,0,0,ITH,ITH2,4,Provincia Autonoma Trento,P.A. Trento,541380,315278,58.24,0.09
1365,2021-07-21,PAT,4707,2521,2186,1527,3085,95,ITH,ITH2,4,Provincia Autonoma Trento,P.A. Trento,541380,319985,59.11,0.87
1366,2021-08-09,PAT,5349,2854,2495,2282,2925,142,ITH,ITH2,4,Provincia Autonoma Trento,P.A. Trento,541380,325334,60.09,0.99
1367,2021-08-26,PAT,4122,2163,1959,1068,2957,97,ITH,ITH2,4,Provincia Autonoma Trento,P.A. Trento,541380,329456,60.85,0.76
1368,2021-03-30,PAT,2467,999,1468,1672,693,102,ITH,ITH2,4,Provincia Autonoma Trento,P.A. Trento,541380,331923,61.31,0.46
1369,2021-08-28,PAT,1339,824,515,547,755,37,ITH,ITH2,4,Provincia Autonoma Trento,P.A. Trento,541380,333262,61.56,0.25
1370,2021-08-21,PAT,1318,782,536,601,678,39,ITH,ITH2,4,Provincia Autonoma Trento,P.A. Trento,541380,334580,61.8,0.24
1371,2021-06-25,PAT,7794,4157,3637,4179,3447,168,ITH,ITH2,4,Provincia Autonoma Trento,P.A. Trento,541380,342374,63.24,1.44
1372,2021-01-06,PAT,43,13,30,43,0,0,ITH,ITH2,4,Provincia Autonoma Trento,P.A. Trento,541380,342417,63.25,0.01
1373,2021-08-05,PAT,6390,3495,2895,2949,3317,124,ITH,ITH2,4,Provincia Autonoma Trento,P.A. Trento,541380,348807,64.43,1.18
1374,2021-04-29,PAT,4702,2266,2436,4173,214,315,ITH,ITH2,4,Provincia Autonoma Trento,P.A. Trento,541380,353509,65.3,0.87
1375,2021-08-07,PAT,1624,931,693,817,769,38,ITH,ITH2,4,Provincia Autonoma Trento,P.A. Trento,541380,355133,65.6,0.3
1376,2021-01-22,PAT,1748,459,1289,350,1396,2,ITH,ITH2,4,Provincia Autonoma Trento,P.A. Trento,541380,356881,65.92,0.32
1377,2021-02-05,PAT,835,288,547,285,550,0,ITH,ITH2,4,Provincia Autonoma Trento,P.A. Trento,541380,357716,66.07,0.15
1378,2021-05-16,PAT,1358,756,602,1042,248,68,ITH,ITH2,4,Provincia Autonoma Trento,P.A. Trento,541380,359074,66.33,0.25
1379,2021-01-05,PAT,759,262,497,759,0,0,ITH,ITH2,4,Provincia Autonoma Trento,P.A. Trento,541380,359833,66.47,0.14
1380,2021-04-15,PAT,3234,1459,1775,2830,156,248,ITH,ITH2,4,Provincia Autonoma Trento,P.A. Trento,541380,363067,67.06,0.6
1381,2021-06-18,PAT,7068,3761,3307,1785,5190,93,ITH,ITH2,4,Provincia Autonoma Trento,P.A. Trento,541380,370135,68.37,1.31
1382,2021-03-27,PAT,1673,747,926,1322,263,88,ITH,ITH2,4,Provincia Autonoma Trento,P.A. Trento,541380,371808,68.68,0.31
1383,2021-06-04,PAT,5928,2651,3277,1731,4062,135,ITH,ITH2,4,Provincia Autonoma Trento,P.A. Trento,541380,377736,69.77,1.09
1384,2021-06-06,PAT,2269,1080,1189,431,1817,21,ITH,ITH2,4,Provincia Autonoma Trento,P.A. Trento,541380,380005,70.19,0.42
1385,2021-07-12,PAT,4272,2152,2120,2038,2042,192,ITH,ITH2,4,Provincia Autonoma Trento,P.A. Trento,541380,384277,70.98,0.79
1386,2021-02-17,PAT,1175,450,725,1058,112,5,ITH,ITH2,4,Provincia Autonoma Trento,P.A. Trento,541380,385452,71.2,0.22
1387,2021-02-12,PAT,1033,346,687,592,439,2,ITH,ITH2,4,Provincia Autonoma Trento,P.A. Trento,541380,386485,71.39,0.19
1388,2021-03-01,PAT,1254,460,794,928,301,25,ITH,ITH2,4,Provincia Autonoma Trento,P.A. Trento,541380,387739,71.62,0.23
1389,2021-03-20,PAT,888,409,479,663,211,14,ITH,ITH2,4,Provincia Autonoma Trento,P.A. Trento,541380,388627,71.78,0.16
1390,2021-03-03,PAT,1672,628,1044,1115,520,37,ITH,ITH2,4,Provincia Autonoma Trento,P.A. Trento,541380,390299,72.09,0.31
1391,2021-09-02,PAT,3344,1751,1593,948,2348,48,ITH,ITH2,4,Provincia Autonoma Trento,P.A. Trento,541380,393643,72.71,0.62
1392,2021-06-11,PAT,7309,3477,3832,1492,5711,106,ITH,ITH2,4,Provincia Autonoma Trento,P.A. Trento,541380,400952,74.06,1.35
1393,2021-06-13,PAT,3734,2061,1673,279,3430,25,ITH,ITH2,4,Provincia Autonoma Trento,P.A. Trento,541380,404686,74.75,0.69
1394,2021-08-14,PAT,290,156,134,50,237,3,ITH,ITH2,4,Provincia Autonoma Trento,P.A. Trento,541380,404976,74.8,0.05
1395,2021-07-02,PAT,7424,4037,3387,3584,3596,244,ITH,ITH2,4,Provincia Autonoma Trento,P.A. Trento,541380,412400,76.18,1.37
1396,2021-01-15,PAT,628,149,479,627,0,1,ITH,ITH2,4,Provincia Autonoma Trento,P.A. Trento,541380,413028,76.29,0.12
1397,2021-05-20,PAT,5122,2408,2714,3149,1690,283,ITH,ITH2,4,Provincia Autonoma Trento,P.A. Trento,541380,418150,77.24,0.95
1398,2021-03-24,PAT,2415,963,1452,1468,827,120,ITH,ITH2,4,Provincia Autonoma Trento,P.A. Trento,541380,420565,77.68,0.45
1399,2021-02-09,PAT,952,303,649,448,503,1,ITH,ITH2,4,Provincia Autonoma Trento,P.A. Trento,541380,421517,77.86,0.18
1400,2021-03-17,PAT,2131,813,1318,1130,907,94,ITH,ITH2,4,Provincia Autonoma Trento,P.A. Trento,541380,423648,78.25,0.39
1401,2021-01-27,PAT,873,310,563,115,756,2,ITH,ITH2,4,Provincia Autonoma Trento,P.A. Trento,541380,424521,78.41,0.16
1402,2021-02-13,PAT,540,335,205,172,368,0,ITH,ITH2,4,Provincia Autonoma Trento,P.A. Trento,541380,425061,78.51,0.1
1403,2021-05-07,PAT,6092,3133,2959,4853,854,385,ITH,ITH2,4,Provincia Autonoma Trento,P.A. Trento,541380,431153,79.64,1.13
1404,2021-04-20,PAT,2908,1387,1521,2689,37,182,ITH,ITH2,4,Provincia Autonoma Trento,P.A. Trento,541380,434061,80.18,0.54
1405,2021-05-09,PAT,2354,1225,1129,1870,347,137,ITH,ITH2,4,Provincia Autonoma Trento,P.A. Trento,541380,436415,80.61,0.43
1406,2021-08-17,PAT,5447,2880,2567,1937,3379,131,ITH,ITH2,4,Provincia Autonoma Trento,P.A. Trento,541380,441862,81.62,1.01
1407,2021-02-15,PAT,547,193,354,419,126,2,ITH,ITH2,4,Provincia Autonoma Trento,P.A. Trento,541380,442409,81.72,0.1
1408,2021-05-26,PAT,3963,1870,2093,1116,2724,123,ITH,ITH2,4,Provincia Autonoma Trento,P.A. Trento,541380,446372,82.45,0.73
1409,2021-08-12,PAT,5696,3049,2647,2191,3330,175,ITH,ITH2,4,Provincia Autonoma Trento,P.A. Trento,541380,452068,83.5,1.05
1410,2021-07-29,PAT,5480,2912,2568,2648,2714,118,ITH,ITH2,4,Provincia Autonoma Trento,P.A. Trento,541380,457548,84.52,1.01
1411,2021-06-16,PAT,6326,3416,2910,1989,4213,124,ITH,ITH2,4,Provincia Autonoma Trento,P.A. Trento,541380,463874,85.68,1.17
1412,2021-02-24,PAT,1373,543,830,943,406,24,ITH,ITH2,4,Provincia Autonoma Trento,P.A. Trento,541380,465247,85.94,0.25
1413,2021-06-03,PAT,4845,2279,2566,1237,3515,93,ITH,ITH2,4,Provincia Autonoma Trento,P.A. Trento,541380,470092,86.83,0.89
1414,2021-01-19,PAT,434,89,345,434,0,0,ITH,ITH2,4,Provincia Autonoma Trento,P.A. Trento,541380,470526,86.91,0.08
1415,2021-05-30,PAT,1777,876,901,864,843,70,ITH,ITH2,4,Provincia Autonoma Trento,P.A. Trento,541380,472303,87.24,0.33
1416,2021-04-03,PAT,1180,485,695,934,178,68,ITH,ITH2,4,Provincia Autonoma Trento,P.A. Trento,541380,473483,87.46,0.22
1417,2021-09-07,PAT,1518,791,727,449,1026,43,ITH,ITH2,4,Provincia Autonoma Trento,P.A. Trento,541380,475001,87.74,0.28
1418,2021-04-24,PAT,3580,1714,1866,3352,16,212,ITH,ITH2,4,Provincia Autonoma Trento,P.A. Trento,541380,478581,88.4,0.66
1419,2021-02-26,PAT,1257,445,812,932,299,26,ITH,ITH2,4,Provincia Autonoma Trento,P.A. Trento,541380,479838,88.63,0.23
1420,2021-01-14,PAT,731,218,513,729,0,2,ITH,ITH2,4,Provincia Autonoma Trento,P.A. Trento,541380,480569,88.77,0.14
1421,2021-02-28,PAT,246,122,124,236,0,10,ITH,ITH2,4,Provincia Autonoma Trento,P.A. Trento,541380,480815,88.81,0.05
1422,2021-08-04,PAT,6209,3313,2896,2572,3499,138,ITH,ITH2,4,Provincia Autonoma Trento,P.A. Trento,541380,487024,89.96,1.15
1423,2021-06-08,PAT,6044,2919,3125,1786,4133,125,ITH,ITH2,4,Provincia Autonoma Trento,P.A. Trento,541380,493068,91.08,1.12
1424,2021-04-26,PAT,2676,1260,1416,2411,96,169,ITH,ITH2,4,Provincia Autonoma Trento,P.A. Trento,541380,495744,91.57,0.49
1425,2021-02-19,PAT,945,366,579,847,65,33,ITH,ITH2,4,Provincia Autonoma Trento,P.A. Trento,541380,496689,91.74,0.17
1426,2021-08-11,PAT,5847,3149,2698,3094,2591,162,ITH,ITH2,4,Provincia Autonoma Trento,P.A. Trento,541380,502536,92.83,1.08
1427,2021-02-22,PAT,755,262,493,663,86,6,ITH,ITH2,4,Provincia Autonoma Trento,P.A. Trento,541380,503291,92.96,0.14
1428,2021-05-18,PAT,4323,2047,2276,3169,869,285,ITH,ITH2,4,Provincia Autonoma Trento,P.A. Trento,541380,507614,93.76,0.8
1429,2021-03-12,PAT,2603,991,1612,1709,815,79,ITH,ITH2,4,Provincia Autonoma Trento,P.A. Trento,541380,510217,94.24,0.48
1430,2021-06-20,PAT,1900,1050,850,31,1864,5,ITH,ITH2,4,Provincia Autonoma Trento,P.A. Trento,541380,512117,94.59,0.35
1431,2021-01-02,PAT,522,149,373,522,0,0,ITH,ITH2,4,Provincia Autonoma Trento,P.A. Trento,541380,512639,94.69,0.1
1432,2021-03-29,PAT,2568,1011,1557,1696,742,130,ITH,ITH2,4,Provincia Autonoma Trento,P.A. Trento,541380,515207,95.17,0.47
1433,2021-04-12,PAT,3156,1455,1701,2527,504,125,ITH,ITH2,4,Provincia Autonoma Trento,P.A. Trento,541380,518363,95.75,0.58
1434,2021-02-02,PAT,942,254,688,192,750,0,ITH,ITH2,4,Provincia Autonoma Trento,P.A. Trento,541380,519305,95.92,0.17
1435,2021-07-09,PAT,5154,2733,2421,3046,1885,223,ITH,ITH2,4,Provincia Autonoma Trento,P.A. Trento,541380,524459,96.87,0.95
1436,2021-05-13,PAT,3458,1607,1851,2103,1127,228,ITH,ITH2,4,Provincia Autonoma Trento,P.A. Trento,541380,527917,97.51,0.64
1437,2021-03-31,PAT,2622,1001,1621,1654,868,100,ITH,ITH2,4,Provincia Autonoma Trento,P.A. Trento,541380,530539,98.0,0.48
1438,2021-01-26,PAT,577,173,404,28,549,0,ITH,ITH2,4,Provincia Autonoma Trento,P.A. Trento,541380,531116,98.1,0.11
1439,2021-05-06,PAT,5616,2795,2821,4447,794,375,ITH,ITH2,4,Provincia Autonoma Trento,P.A. Trento,541380,536732,99.14,1.04
1440,2020-12-27,PAT,107,43,64,107,0,0,ITH,ITH2,4,Provincia Autonoma Trento,P.A. Trento,541380,536839,99.16,0.02
1441,2021-07-30,PAT,5850,3097,2753,2291,3449,110,ITH,ITH2,4,Provincia Autonoma Trento,P.A. Trento,541380,542689,100.24,1.08
1442,2021-08-16,PAT,4849,2561,2288,1810,2930,109,ITH,ITH2,4,Provincia Autonoma Trento,P.A. Trento,541380,547538,101.14,0.9
1443,2021-05-25,PAT,4867,2315,2552,1743,2975,149,ITH,ITH2,4,Provincia Autonoma Trento,P.A. Trento,541380,552405,102.04,0.9
1444,2021-05-08,PAT,3195,1743,1452,2571,426,198,ITH,ITH2,4,Provincia Autonoma Trento,P.A. Trento,541380,555600,102.63,0.59
1445,2021-02-14,PAT,250,189,61,11,239,0,ITH,ITH2,4,Provincia Autonoma Trento,P.A. Trento,541380,555850,102.67,0.05
1446,2021-03-15,PAT,1453,573,880,929,469,55,ITH,ITH2,4,Provincia Autonoma Trento,P.A. Trento,541380,557303,102.94,0.27
1447,2021-08-19,PAT,4630,2484,2146,1107,3440,83,ITH,ITH2,4,Provincia Autonoma Trento,P.A. Trento,541380,561933,103.8,0.86
1448,2021-01-17,PAT,255,199,56,255,0,0,ITH,ITH2,4,Provincia Autonoma Trento,P.A. Trento,541380,562188,103.84,0.05
1449,2021-06-23,PAT,6694,3547,3147,4626,1871,197,ITH,ITH2,4,Provincia Autonoma Trento,P.A. Trento,541380,568882,105.08,1.24
1450,2021-05-11,PAT,3743,1768,1975,2642,863,238,ITH,ITH2,4,Provincia Autonoma Trento,P.A. Trento,541380,572625,105.77,0.69
1451,2021-04-27,PAT,3956,1902,2054,3597,70,289,ITH,ITH2,4,Provincia Autonoma Trento,P.A. Trento,541380,576581,106.5,0.73
1452,2021-07-23,PAT,4761,2441,2320,1671,2955,135,ITH,ITH2,4,Provincia Autonoma Trento,P.A. Trento,541380,581342,107.38,0.88
1453,2021-03-10,PAT,2486,973,1513,1473,948,65,ITH,ITH2,4,Provincia Autonoma Trento,P.A. Trento,541380,583828,107.84,0.46
1454,2021-08-02,PAT,5376,2852,2524,1607,3701,68,ITH,ITH2,4,Provincia Autonoma Trento,P.A. Trento,541380,589204,108.83,0.99
1455,2021-01-10,PAT,87,20,67,87,0,0,ITH,ITH2,4,Provincia Autonoma Trento,P.A. Trento,541380,589291,108.85,0.02
1456,2021-01-29,PAT,1425,363,1062,56,1369,0,ITH,ITH2,4,Provincia Autonoma Trento,P.A. Trento,541380,590716,109.11,0.26
1457,2021-07-14,PAT,4189,2177,2012,1704,2355,130,ITH,ITH2,4,Provincia Autonoma Trento,P.A. Trento,541380,594905,109.89,0.77
1458,2021-04-22,PAT,3175,1482,1693,2946,46,183,ITH,ITH2,4,Provincia Autonoma Trento,P.A. Trento,541380,598080,110.47,0.59
1459,2021-05-04,PAT,4571,2490,2081,4169,97,305,ITH,ITH2,4,Provincia Autonoma Trento,P.A. Trento,541380,602651,111.32,0.84
1460,2021-03-08,PAT,1426,439,987,1042,354,30,ITH,ITH2,4,Provincia Autonoma Trento,P.A. Trento,541380,604077,111.58,0.26
1461,2021-03-22,PAT,2349,995,1354,1406,885,58,ITH,ITH2,4,Provincia Autonoma Trento,P.A. Trento,541380,606426,112.01,0.43
1462,2021-01-24,PAT,562,285,277,226,336,0,ITH,ITH2,4,Provincia Autonoma Trento,P.A. Trento,541380,606988,112.12,0.1
1463,2021-06-30,PAT,6873,3530,3343,2694,4056,123,ITH,ITH2,4,Provincia Autonoma Trento,P.A. Trento,541380,613861,113.39,1.27
1464,2021-01-31,PAT,77,16,61,1,76,0,ITH,ITH2,4,Provincia Autonoma Trento,P.A. Trento,541380,613938,113.4,0.01
1465,2021-07-04,PAT,225,125,100,66,157,2,ITH,ITH2,4,Provincia Autonoma Trento,P.A. Trento,541380,614163,113.44,0.04
1466,2021-08-18,PAT,4634,2553,2081,1429,3118,87,ITH,ITH2,4,Provincia Autonoma Trento,P.A. Trento,541380,618797,114.3,0.86
1467,2021-05-27,PAT,4379,2034,2345,1164,3081,134,ITH,ITH2,4,Provincia Autonoma Trento,P.A. Trento,541380,623176,115.11,0.81
1468,2021-09-04,PAT,932,544,388,484,412,36,ITH,ITH2,4,Provincia Autonoma Trento,P.A. Trento,541380,624108,115.28,0.17
1469,2021-01-21,PAT,376,104,272,247,129,0,ITH,ITH2,4,Provincia Autonoma Trento,P.A. Trento,541380,624484,115.35,0.07
1470,2021-05-01,PAT,4889,2486,2403,4552,37,300,ITH,ITH2,4,Provincia Autonoma Trento,P.A. Trento,541380,629373,116.25,0.9
1471,2021-02-21,PAT,158,95,63,44,114,0,ITH,ITH2,4,Provincia Autonoma Trento,P.A. Trento,541380,629531,116.28,0.03
1472,2021-05-15,PAT,1605,833,772,649,915,41,ITH,ITH2,4,Provincia Autonoma Trento,P.A. Trento,541380,631136,116.58,0.3
1473,2021-06-01,PAT,4104,1925,2179,1081,2911,112,ITH,ITH2,4,Provincia Autonoma Trento,P.A. Trento,541380,635240,117.34,0.76
1474,2021-07-31,PAT,1497,856,641,1075,383,39,ITH,ITH2,4,Provincia Autonoma Trento,P.A. Trento,541380,636737,117.61,0.28
1475,2021-04-07,PAT,2655,1028,1627,1576,955,124,ITH,ITH2,4,Provincia Autonoma Trento,P.A. Trento,541380,639392,118.1,0.49
1476,2021-07-16,PAT,4598,2369,2229,1738,2706,154,ITH,ITH2,4,Provincia Autonoma Trento,P.A. Trento,541380,643990,118.95,0.85
1477,2021-06-27,PAT,1368,735,633,396,961,11,ITH,ITH2,4,Provincia Autonoma Trento,P.A. Trento,541380,645358,119.21,0.25
1478,2021-01-12,PAT,541,173,368,540,0,1,ITH,ITH2,4,Provincia Autonoma Trento,P.A. Trento,541380,645899,119.31,0.1
1479,2021-03-19,PAT,2467,925,1542,1503,881,83,ITH,ITH2,4,Provincia Autonoma Trento,P.A. Trento,541380,648366,119.76,0.46
1480,2021-04-05,PAT,35,17,18,30,2,3,ITH,ITH2,4,Provincia Autonoma Trento,P.A. Trento,541380,648401,119.77,0.01
1481,2021-08-30,PAT,3891,1985,1906,1182,2600,109,ITH,ITH2,4,Provincia Autonoma Trento,P.A. Trento,541380,652292,120.49,0.72
1482,2021-08-23,PAT,4339,2289,2050,1428,2746,165,ITH,ITH2,4,Provincia Autonoma Trento,P.A. Trento,541380,656631,121.29,0.8
1483,2021-09-06,PAT,3131,1644,1487,967,2064,100,ITH,ITH2,4,Provincia Autonoma Trento,P.A. Trento,541380,659762,121.87,0.58
1484,2021-07-11,PAT,1035,566,469,132,894,9,ITH,ITH2,4,Provincia Autonoma Trento,P.A. Trento,541380,660797,122.06,0.19
1485,2021-02-08,PAT,1194,333,861,347,847,0,ITH,ITH2,4,Provincia Autonoma Trento,P.A. Trento,541380,661991,122.28,0.22
1486,2021-08-29,PAT,615,346,269,310,281,24,ITH,ITH2,4,Provincia Autonoma Trento,P.A. Trento,541380,662606,122.39,0.11
1487,2021-07-17,PAT,1099,537,562,270,809,20,ITH,ITH2,4,Provincia Autonoma Trento,P.A. Trento,541380,663705,122.6,0.2
1488,2021-05-21,PAT,5216,2506,2710,3138,1806,272,ITH,ITH2,4,Provincia Autonoma Trento,P.A. Trento,541380,668921,123.56,0.96
1489,2021-02-01,PAT,1278,356,922,98,1180,0,ITH,ITH2,4,Provincia Autonoma Trento,P.A. Trento,541380,670199,123.79,0.24
1490,2021-08-31,PAT,4397,2289,2108,1238,3058,101,ITH,ITH2,4,Provincia Autonoma Trento,P.A. Trento,541380,674596,124.61,0.81
1491,2021-02-03,PAT,877,326,551,417,460,0,ITH,ITH2,4,Provincia Autonoma Trento,P.A. Trento,541380,675473,124.77,0.16
1492,2021-07-19,PAT,4810,2533,2277,1456,3224,130,ITH,ITH2,4,Provincia Autonoma Trento,P.A. Trento,541380,680283,125.66,0.89
1493,2021-05-23,PAT,1995,1015,980,431,1535,29,ITH,ITH2,4,Provincia Autonoma Trento,P.A. Trento,541380,682278,126.03,0.37
1494,2021-04-10,PAT,2877,1352,1525,1995,803,79,ITH,ITH2,4,Provincia Autonoma Trento,P.A. Trento,541380,685155,126.56,0.53
1495,2021-02-10,PAT,872,295,577,513,358,1,ITH,ITH2,4,Provincia Autonoma Trento,P.A. Trento,541380,686027,126.72,0.16
1496,2021-07-26,PAT,3900,2058,1842,836,2995,69,ITH,ITH2,4,Provincia Autonoma Trento,P.A. Trento,541380,689927,127.44,0.72
1497,2021-04-08,PAT,3181,1335,1846,1953,1133,95,ITH,ITH2,4,Provincia Autonoma Trento,P.A. Trento,541380,693108,128.03,0.59
1498,2020-12-31,PAT,1701,480,1221,1701,0,0,ITH,ITH2,4,Provincia Autonoma Trento,P.A. Trento,541380,694809,128.34,0.31
1499,2021-06-22,PAT,6383,3479,2904,3627,2568,188,ITH,ITH2,4,Provincia Autonoma Trento,P.A. Trento,541380,701192,129.52,1.18
1500,2021-03-05,PAT,2308,736,1572,1643,569,96,ITH,ITH2,4,Provincia Autonoma Trento,P.A. Trento,541380,703500,129.95,0.43
1501,2021-01-07,PAT,1301,328,973,1298,0,3,ITH,ITH2,4,Provincia Autonoma Trento,P.A. Trento,541380,704801,130.19,0.24
1502,2021-04-17,PAT,2253,1148,1105,2090,57,106,ITH,ITH2,4,Provincia Autonoma Trento,P.A. Trento,541380,707054,130.6,0.42
1503,2021-04-19,PAT,2646,1244,1402,2429,23,194,ITH,ITH2,4,Provincia Autonoma Trento,P.A. Trento,541380,709700,131.09,0.49
1504,2021-07-28,PAT,4868,2670,2198,2160,2572,136,ITH,ITH2,4,Provincia Autonoma Trento,P.A. Trento,541380,714568,131.99,0.9
1505,2021-06-15,PAT,6332,3342,2990,1632,4565,135,ITH,ITH2,4,Provincia Autonoma Trento,P.A. Trento,541380,720900,133.16,1.17
1506,2021-07-20,FVG,9409,4932,4477,2448,6665,296,ITH,ITH4,6,Friuli-Venezia Giulia,Friuli Venezia Giulia,1215220,9409,0.77,0.77
1507,2021-08-03,FVG,10181,5363,4818,5261,4557,363,ITH,ITH4,6,Friuli-Venezia Giulia,Friuli Venezia Giulia,1215220,19590,1.61,0.84
1508,2021-04-11,FVG,3435,1519,1916,2415,907,113,ITH,ITH4,6,Friuli-Venezia Giulia,Friuli Venezia Giulia,1215220,23025,1.89,0.28
1509,2021-06-07,FVG,9233,4789,4444,7847,1002,384,ITH,ITH4,6,Friuli-Venezia Giulia,Friuli Venezia Giulia,1215220,32258,2.65,0.76
1510,2020-12-28,FVG,1,0,1,1,0,0,ITH,ITH4,6,Friuli-Venezia Giulia,Friuli Venezia Giulia,1215220,32259,2.65,0.0
1511,2021-07-08,FVG,13117,7087,6030,1364,11572,181,ITH,ITH4,6,Friuli-Venezia Giulia,Friuli Venezia Giulia,1215220,45376,3.73,1.08
1512,2021-02-04,FVG,2728,808,1920,35,2693,0,ITH,ITH4,6,Friuli-Venezia Giulia,Friuli Venezia Giulia,1215220,48104,3.96,0.22
1513,2021-08-08,FVG,4334,2354,1980,1918,2325,91,ITH,ITH4,6,Friuli-Venezia Giulia,Friuli Venezia Giulia,1215220,52438,4.32,0.36
1514,2021-04-30,FVG,7417,3270,4147,3577,3666,174,ITH,ITH4,6,Friuli-Venezia Giulia,Friuli Venezia Giulia,1215220,59855,4.93,0.61
1515,2021-03-28,FVG,4947,2356,2591,4690,158,99,ITH,ITH4,6,Friuli-Venezia Giulia,Friuli Venezia Giulia,1215220,64802,5.33,0.41
1516,2021-01-18,FVG,1964,608,1356,1870,94,0,ITH,ITH4,6,Friuli-Venezia Giulia,Friuli Venezia Giulia,1215220,66766,5.49,0.16
1517,2021-01-04,FVG,1509,560,949,1509,0,0,ITH,ITH4,6,Friuli-Venezia Giulia,Friuli Venezia Giulia,1215220,68275,5.62,0.12
1518,2021-05-24,FVG,11481,5557,5924,7529,3649,303,ITH,ITH4,6,Friuli-Venezia Giulia,Friuli Venezia Giulia,1215220,79756,6.56,0.94
1519,2021-02-13,FVG,568,180,388,560,6,2,ITH,ITH4,6,Friuli-Venezia Giulia,Friuli Venezia Giulia,1215220,80324,6.61,0.05
1520,2021-08-15,FVG,1,1,0,0,1,0,ITH,ITH4,6,Friuli-Venezia Giulia,Friuli Venezia Giulia,1215220,80325,6.61,0.0
1521,2021-03-02,FVG,4224,1520,2704,2702,1500,22,ITH,ITH4,6,Friuli-Venezia Giulia,Friuli Venezia Giulia,1215220,84549,6.96,0.35
1522,2021-09-03,FVG,3990,2065,1925,2036,1688,266,ITH,ITH4,6,Friuli-Venezia Giulia,Friuli Venezia Giulia,1215220,88539,7.29,0.33
1523,2021-03-04,FVG,3461,1601,1860,2771,661,29,ITH,ITH4,6,Friuli-Venezia Giulia,Friuli Venezia Giulia,1215220,92000,7.57,0.28
1524,2021-06-12,FVG,8237,4721,3516,6798,1162,277,ITH,ITH4,6,Friuli-Venezia Giulia,Friuli Venezia Giulia,1215220,100237,8.25,0.68
1525,2021-02-18,FVG,3230,1503,1727,2804,408,18,ITH,ITH4,6,Friuli-Venezia Giulia,Friuli Venezia Giulia,1215220,103467,8.51,0.27
1526,2021-04-02,FVG,6610,2938,3672,4640,1841,129,ITH,ITH4,6,Friuli-Venezia Giulia,Friuli Venezia Giulia,1215220,110077,9.06,0.54
1527,2021-01-30,FVG,2284,745,1539,270,2014,0,ITH,ITH4,6,Friuli-Venezia Giulia,Friuli Venezia Giulia,1215220,112361,9.25,0.19
1528,2021-07-13,FVG,11086,5713,5373,1172,9763,151,ITH,ITH4,6,Friuli-Venezia Giulia,Friuli Venezia Giulia,1215220,123447,10.16,0.91
1529,2021-08-29,FVG,3148,1774,1374,1793,1255,100,ITH,ITH4,6,Friuli-Venezia Giulia,Friuli Venezia Giulia,1215220,126595,10.42,0.26
1530,2021-06-24,FVG,11124,5675,5449,1898,9116,110,ITH,ITH4,6,Friuli-Venezia Giulia,Friuli Venezia Giulia,1215220,137719,11.33,0.92
1531,2021-03-16,FVG,3193,1302,1891,1023,2085,85,ITH,ITH4,6,Friuli-Venezia Giulia,Friuli Venezia Giulia,1215220,140912,11.6,0.26
1532,2021-08-20,FVG,6251,3532,2719,2676,3302,273,ITH,ITH4,6,Friuli-Venezia Giulia,Friuli Venezia Giulia,1215220,147163,12.11,0.51
1533,2021-05-12,FVG,11197,5179,6018,9353,1432,412,ITH,ITH4,6,Friuli-Venezia Giulia,Friuli Venezia Giulia,1215220,158360,13.03,0.92
1534,2021-04-28,FVG,7343,3242,4101,3692,3515,136,ITH,ITH4,6,Friuli-Venezia Giulia,Friuli Venezia Giulia,1215220,165703,13.64,0.6
1535,2021-01-23,FVG,816,323,493,5,811,0,ITH,ITH4,6,Friuli-Venezia Giulia,Friuli Venezia Giulia,1215220,166519,13.7,0.07
1536,2021-09-08,FVG,2894,1615,1279,1280,1441,173,ITH,ITH4,6,Friuli-Venezia Giulia,Friuli Venezia Giulia,1215220,169413,13.94,0.24
1537,2021-05-31,FVG,8958,4447,4511,6477,2229,252,ITH,ITH4,6,Friuli-Venezia Giulia,Friuli Venezia Giulia,1215220,178371,14.68,0.74
1538,2021-07-27,FVG,9521,4787,4734,2651,6645,225,ITH,ITH4,6,Friuli-Venezia Giulia,Friuli Venezia Giulia,1215220,187892,15.46,0.78
1539,2021-08-27,FVG,6166,3323,2843,1394,4560,212,ITH,ITH4,6,Friuli-Venezia Giulia,Friuli Venezia Giulia,1215220,194058,15.97,0.51
1540,2021-06-19,FVG,8569,4467,4102,1353,7151,65,ITH,ITH4,6,Friuli-Venezia Giulia,Friuli Venezia Giulia,1215220,202627,16.67,0.71
1541,2021-02-06,FVG,1155,339,816,21,1133,1,ITH,ITH4,6,Friuli-Venezia Giulia,Friuli Venezia Giulia,1215220,203782,16.77,0.1
1542,2021-02-23,FVG,2650,1280,1370,2462,181,7,ITH,ITH4,6,Friuli-Venezia Giulia,Friuli Venezia Giulia,1215220,206432,16.99,0.22
1543,2021-05-17,FVG,8847,4111,4736,6080,2498,269,ITH,ITH4,6,Friuli-Venezia Giulia,Friuli Venezia Giulia,1215220,215279,17.72,0.73
1544,2021-03-09,FVG,4023,1729,2294,1243,2756,24,ITH,ITH4,6,Friuli-Venezia Giulia,Friuli Venezia Giulia,1215220,219302,18.05,0.33
1545,2021-03-21,FVG,2676,1003,1673,2214,410,52,ITH,ITH4,6,Friuli-Venezia Giulia,Friuli Venezia Giulia,1215220,221978,18.27,0.22
1546,2021-01-27,FVG,1273,427,846,450,821,2,ITH,ITH4,6,Friuli-Venezia Giulia,Friuli Venezia Giulia,1215220,223251,18.37,0.1
1547,2021-04-04,FVG,4,2,2,2,2,0,ITH,ITH4,6,Friuli-Venezia Giulia,Friuli Venezia Giulia,1215220,223255,18.37,0.0
1548,2021-06-26,FVG,10393,5303,5090,4147,6174,72,ITH,ITH4,6,Friuli-Venezia Giulia,Friuli Venezia Giulia,1215220,233648,19.23,0.86
1549,2021-04-21,FVG,7785,3471,4314,4020,3684,81,ITH,ITH4,6,Friuli-Venezia Giulia,Friuli Venezia Giulia,1215220,241433,19.87,0.64
1550,2021-01-11,FVG,1895,613,1282,1894,0,1,ITH,ITH4,6,Friuli-Venezia Giulia,Friuli Venezia Giulia,1215220,243328,20.02,0.16
1551,2021-07-15,FVG,10096,5142,4954,946,8906,244,ITH,ITH4,6,Friuli-Venezia Giulia,Friuli Venezia Giulia,1215220,253424,20.85,0.83
1552,2021-04-23,FVG,7563,3428,4135,3522,3902,139,ITH,ITH4,6,Friuli-Venezia Giulia,Friuli Venezia Giulia,1215220,260987,21.48,0.62
1553,2021-08-01,FVG,3599,1928,1671,1478,1873,248,ITH,ITH4,6,Friuli-Venezia Giulia,Friuli Venezia Giulia,1215220,264586,21.77,0.3
1554,2021-08-22,FVG,2056,1179,877,785,1234,37,ITH,ITH4,6,Friuli-Venezia Giulia,Friuli Venezia Giulia,1215220,266642,21.94,0.17
1555,2021-05-19,FVG,12135,5992,6143,9327,2374,434,ITH,ITH4,6,Friuli-Venezia Giulia,Friuli Venezia Giulia,1215220,278777,22.94,1.0
1556,2021-03-14,FVG,1403,554,849,1124,252,27,ITH,ITH4,6,Friuli-Venezia Giulia,Friuli Venezia Giulia,1215220,280180,23.06,0.12
1557,2021-05-05,FVG,9803,4279,5524,6081,3478,244,ITH,ITH4,6,Friuli-Venezia Giulia,Friuli Venezia Giulia,1215220,289983,23.86,0.81
1558,2021-01-25,FVG,1595,571,1024,200,1395,0,ITH,ITH4,6,Friuli-Venezia Giulia,Friuli Venezia Giulia,1215220,291578,23.99,0.13
1559,2021-07-01,FVG,12388,6446,5942,2641,9491,256,ITH,ITH4,6,Friuli-Venezia Giulia,Friuli Venezia Giulia,1215220,303966,25.01,1.02
1560,2021-03-23,FVG,3909,1697,2212,1743,2145,21,ITH,ITH4,6,Friuli-Venezia Giulia,Friuli Venezia Giulia,1215220,307875,25.33,0.32
1561,2021-01-16,FVG,1232,362,870,1232,0,0,ITH,ITH4,6,Friuli-Venezia Giulia,Friuli Venezia Giulia,1215220,309107,25.44,0.1
1562,2021-07-03,FVG,11431,6096,5335,1097,10186,148,ITH,ITH4,6,Friuli-Venezia Giulia,Friuli Venezia Giulia,1215220,320538,26.38,0.94
1563,2021-04-16,FVG,7015,3053,3962,4938,1942,135,ITH,ITH4,6,Friuli-Venezia Giulia,Friuli Venezia Giulia,1215220,327553,26.95,0.58
1564,2021-01-06,FVG,716,265,451,716,0,0,ITH,ITH4,6,Friuli-Venezia Giulia,Friuli Venezia Giulia,1215220,328269,27.01,0.06
1565,2021-02-11,FVG,1969,679,1290,1740,225,4,ITH,ITH4,6,Friuli-Venezia Giulia,Friuli Venezia Giulia,1215220,330238,27.18,0.16
1566,2021-04-09,FVG,8055,3736,4319,6576,1305,174,ITH,ITH4,6,Friuli-Venezia Giulia,Friuli Venezia Giulia,1215220,338293,27.84,0.66
1567,2021-02-27,FVG,3540,1205,2335,3522,1,17,ITH,ITH4,6,Friuli-Venezia Giulia,Friuli Venezia Giulia,1215220,341833,28.13,0.29
1568,2021-04-25,FVG,2382,992,1390,2188,13,181,ITH,ITH4,6,Friuli-Venezia Giulia,Friuli Venezia Giulia,1215220,344215,28.33,0.2
1569,2021-01-01,FVG,2,2,0,2,0,0,ITH,ITH4,6,Friuli-Venezia Giulia,Friuli Venezia Giulia,1215220,344217,28.33,0.0
1570,2021-01-15,FVG,2021,605,1416,2020,0,1,ITH,ITH4,6,Friuli-Venezia Giulia,Friuli Venezia Giulia,1215220,346238,28.49,0.17
1571,2021-03-11,FVG,3484,1520,1964,1715,1754,15,ITH,ITH4,6,Friuli-Venezia Giulia,Friuli Venezia Giulia,1215220,349722,28.78,0.29
1572,2021-04-13,FVG,7396,3299,4097,5657,1611,128,ITH,ITH4,6,Friuli-Venezia Giulia,Friuli Venezia Giulia,1215220,357118,29.39,0.61
1573,2021-01-03,FVG,313,123,190,313,0,0,ITH,ITH4,6,Friuli-Venezia Giulia,Friuli Venezia Giulia,1215220,357431,29.41,0.03
1574,2021-07-22,FVG,7720,4105,3615,3270,4147,303,ITH,ITH4,6,Friuli-Venezia Giulia,Friuli Venezia Giulia,1215220,365151,30.05,0.64
1575,2021-01-20,FVG,754,322,432,18,736,0,ITH,ITH4,6,Friuli-Venezia Giulia,Friuli Venezia Giulia,1215220,365905,30.11,0.06
1576,2021-02-22,FVG,2494,1199,1295,2070,419,5,ITH,ITH4,6,Friuli-Venezia Giulia,Friuli Venezia Giulia,1215220,368399,30.32,0.21
1577,2021-06-02,FVG,9429,4963,4466,8816,282,331,ITH,ITH4,6,Friuli-Venezia Giulia,Friuli Venezia Giulia,1215220,377828,31.09,0.78
1578,2021-06-04,FVG,12172,6238,5934,10278,1454,440,ITH,ITH4,6,Friuli-Venezia Giulia,Friuli Venezia Giulia,1215220,390000,32.09,1.0
1579,2021-07-05,FVG,9598,4882,4716,1320,8135,143,ITH,ITH4,6,Friuli-Venezia Giulia,Friuli Venezia Giulia,1215220,399598,32.88,0.79
1580,2021-06-21,FVG,9219,4509,4710,1828,7253,138,ITH,ITH4,6,Friuli-Venezia Giulia,Friuli Venezia Giulia,1215220,408817,33.64,0.76
1581,2021-03-13,FVG,2948,1125,1823,1660,1275,13,ITH,ITH4,6,Friuli-Venezia Giulia,Friuli Venezia Giulia,1215220,411765,33.88,0.24
1582,2021-07-24,FVG,6169,3335,2834,2917,3080,172,ITH,ITH4,6,Friuli-Venezia Giulia,Friuli Venezia Giulia,1215220,417934,34.39,0.51
1583,2021-08-24,FVG,6610,3571,3039,728,5747,135,ITH,ITH4,6,Friuli-Venezia Giulia,Friuli Venezia Giulia,1215220,424544,34.94,0.54
1584,2021-08-10,FVG,7297,4071,3226,5282,1656,359,ITH,ITH4,6,Friuli-Venezia Giulia,Friuli Venezia Giulia,1215220,431841,35.54,0.6
1585,2021-05-02,FVG,6916,3256,3660,3810,2964,142,ITH,ITH4,6,Friuli-Venezia Giulia,Friuli Venezia Giulia,1215220,438757,36.11,0.57
1586,2021-05-16,FVG,10026,4801,5225,8376,1406,244,ITH,ITH4,6,Friuli-Venezia Giulia,Friuli Venezia Giulia,1215220,448783,36.93,0.83
1587,2021-05-07,FVG,10944,5009,5935,7185,3561,198,ITH,ITH4,6,Friuli-Venezia Giulia,Friuli Venezia Giulia,1215220,459727,37.83,0.9
1588,2021-05-09,FVG,7387,3317,4070,3375,3877,135,ITH,ITH4,6,Friuli-Venezia Giulia,Friuli Venezia Giulia,1215220,467114,38.44,0.61
1589,2021-07-31,FVG,7364,3784,3580,1269,6005,90,ITH,ITH4,6,Friuli-Venezia Giulia,Friuli Venezia Giulia,1215220,474478,39.04,0.61
1590,2021-08-17,FVG,3520,1898,1622,2688,599,233,ITH,ITH4,6,Friuli-Venezia Giulia,Friuli Venezia Giulia,1215220,477998,39.33,0.29
1591,2021-05-26,FVG,13473,6729,6744,9651,3467,355,ITH,ITH4,6,Friuli-Venezia Giulia,Friuli Venezia Giulia,1215220,491471,40.44,1.11
1592,2021-02-15,FVG,2461,914,1547,2201,254,6,ITH,ITH4,6,Friuli-Venezia Giulia,Friuli Venezia Giulia,1215220,493932,40.65,0.2
1593,2021-04-18,FVG,6063,2814,3249,5420,410,233,ITH,ITH4,6,Friuli-Venezia Giulia,Friuli Venezia Giulia,1215220,499995,41.14,0.5
1594,2021-01-08,FVG,2344,751,1593,2344,0,0,ITH,ITH4,6,Friuli-Venezia Giulia,Friuli Venezia Giulia,1215220,502339,41.34,0.19
1595,2021-06-14,FVG,10321,5010,5311,5191,4838,292,ITH,ITH4,6,Friuli-Venezia Giulia,Friuli Venezia Giulia,1215220,512660,42.19,0.85
1596,2021-02-20,FVG,2080,942,1138,1933,144,3,ITH,ITH4,6,Friuli-Venezia Giulia,Friuli Venezia Giulia,1215220,514740,42.36,0.17
1597,2021-01-22,FVG,117,56,61,28,89,0,ITH,ITH4,6,Friuli-Venezia Giulia,Friuli Venezia Giulia,1215220,514857,42.37,0.01
1598,2021-03-06,FVG,3513,1201,2312,3154,327,32,ITH,ITH4,6,Friuli-Venezia Giulia,Friuli Venezia Giulia,1215220,518370,42.66,0.29
1599,2021-03-25,FVG,5545,2432,3113,3332,2140,73,ITH,ITH4,6,Friuli-Venezia Giulia,Friuli Venezia Giulia,1215220,523915,43.11,0.46
1600,2021-03-30,FVG,7622,3407,4215,6287,1200,135,ITH,ITH4,6,Friuli-Venezia Giulia,Friuli Venezia Giulia,1215220,531537,43.74,0.63
1601,2021-07-10,FVG,8807,4546,4261,143,8638,26,ITH,ITH4,6,Friuli-Venezia Giulia,Friuli Venezia Giulia,1215220,540344,44.46,0.72
1602,2021-06-09,FVG,11368,5984,5384,9492,1400,476,ITH,ITH4,6,Friuli-Venezia Giulia,Friuli Venezia Giulia,1215220,551712,45.4,0.94
1603,2021-03-01,FVG,2969,1044,1925,2892,53,24,ITH,ITH4,6,Friuli-Venezia Giulia,Friuli Venezia Giulia,1215220,554681,45.64,0.24
1604,2021-03-18,FVG,3378,1424,1954,1684,1686,8,ITH,ITH4,6,Friuli-Venezia Giulia,Friuli Venezia Giulia,1215220,558059,45.92,0.28
1605,2021-06-28,FVG,9925,5001,4924,2143,7712,70,ITH,ITH4,6,Friuli-Venezia Giulia,Friuli Venezia Giulia,1215220,567984,46.74,0.82
1606,2021-03-20,FVG,3410,1414,1996,1300,2096,14,ITH,ITH4,6,Friuli-Venezia Giulia,Friuli Venezia Giulia,1215220,571394,47.02,0.28
1607,2021-01-13,FVG,2657,837,1820,2656,0,1,ITH,ITH4,6,Friuli-Venezia Giulia,Friuli Venezia Giulia,1215220,574051,47.24,0.22
1608,2021-04-06,FVG,6691,3142,3549,5427,1157,107,ITH,ITH4,6,Friuli-Venezia Giulia,Friuli Venezia Giulia,1215220,580742,47.79,0.55
1609,2020-12-27,FVG,262,149,113,261,0,1,ITH,ITH4,6,Friuli-Venezia Giulia,Friuli Venezia Giulia,1215220,581004,47.81,0.02
1610,2021-08-09,FVG,7837,4194,3643,2371,5282,184,ITH,ITH4,6,Friuli-Venezia Giulia,Friuli Venezia Giulia,1215220,588841,48.46,0.64
1611,2021-02-07,FVG,1567,482,1085,384,1182,1,ITH,ITH4,6,Friuli-Venezia Giulia,Friuli Venezia Giulia,1215220,590408,48.58,0.13
1612,2021-08-26,FVG,7464,4040,3424,1402,5827,235,ITH,ITH4,6,Friuli-Venezia Giulia,Friuli Venezia Giulia,1215220,597872,49.2,0.61
1613,2021-05-18,FVG,10866,5434,5432,8402,2101,363,ITH,ITH4,6,Friuli-Venezia Giulia,Friuli Venezia Giulia,1215220,608738,50.09,0.89
1614,2021-06-01,FVG,10146,5132,5014,7700,2129,317,ITH,ITH4,6,Friuli-Venezia Giulia,Friuli Venezia Giulia,1215220,618884,50.93,0.83
1615,2021-06-20,FVG,6526,3239,3287,1490,4940,96,ITH,ITH4,6,Friuli-Venezia Giulia,Friuli Venezia Giulia,1215220,625410,51.46,0.54
1616,2021-04-01,FVG,6435,3074,3361,5327,1018,90,ITH,ITH4,6,Friuli-Venezia Giulia,Friuli Venezia Giulia,1215220,631845,51.99,0.53
1617,2021-09-05,FVG,2716,1474,1242,1309,1313,94,ITH,ITH4,6,Friuli-Venezia Giulia,Friuli Venezia Giulia,1215220,634561,52.22,0.22
1618,2021-05-28,FVG,10659,5108,5551,6233,4145,281,ITH,ITH4,6,Friuli-Venezia Giulia,Friuli Venezia Giulia,1215220,645220,53.09,0.88
1619,2021-09-07,FVG,3080,1659,1421,1211,1678,191,ITH,ITH4,6,Friuli-Venezia Giulia,Friuli Venezia Giulia,1215220,648300,53.35,0.25
1620,2021-07-12,FVG,10040,5157,4883,1111,8774,155,ITH,ITH4,6,Friuli-Venezia Giulia,Friuli Venezia Giulia,1215220,658340,54.17,0.83
1621,2021-02-19,FVG,3301,1320,1981,2842,442,17,ITH,ITH4,6,Friuli-Venezia Giulia,Friuli Venezia Giulia,1215220,661641,54.45,0.27
1622,2021-08-14,FVG,199,147,52,181,4,14,ITH,ITH4,6,Friuli-Venezia Giulia,Friuli Venezia Giulia,1215220,661840,54.46,0.02
1623,2021-08-28,FVG,2891,1571,1320,1776,957,158,ITH,ITH4,6,Friuli-Venezia Giulia,Friuli Venezia Giulia,1215220,664731,54.7,0.24
1624,2021-05-06,FVG,11979,5569,6410,7714,3985,280,ITH,ITH4,6,Friuli-Venezia Giulia,Friuli Venezia Giulia,1215220,676710,55.69,0.99
1625,2021-07-02,FVG,11116,5748,5368,2116,8808,192,ITH,ITH4,6,Friuli-Venezia Giulia,Friuli Venezia Giulia,1215220,687826,56.6,0.91
1626,2020-12-30,FVG,626,244,382,626,0,0,ITH,ITH4,6,Friuli-Venezia Giulia,Friuli Venezia Giulia,1215220,688452,56.65,0.05
1627,2021-06-05,FVG,10344,5347,4997,8398,1555,391,ITH,ITH4,6,Friuli-Venezia Giulia,Friuli Venezia Giulia,1215220,698796,57.5,0.85
1628,2021-02-25,FVG,3178,1660,1518,3115,30,33,ITH,ITH4,6,Friuli-Venezia Giulia,Friuli Venezia Giulia,1215220,701974,57.77,0.26
1629,2021-06-16,FVG,12203,5922,6281,3900,8039,264,ITH,ITH4,6,Friuli-Venezia Giulia,Friuli Venezia Giulia,1215220,714177,58.77,1.0
1630,2021-08-12,FVG,7954,4263,3691,5160,2499,295,ITH,ITH4,6,Friuli-Venezia Giulia,Friuli Venezia Giulia,1215220,722131,59.42,0.65
1631,2021-06-18,FVG,10980,5421,5559,3403,7312,265,ITH,ITH4,6,Friuli-Venezia Giulia,Friuli Venezia Giulia,1215220,733111,60.33,0.9
1632,2021-03-10,FVG,3602,1711,1891,1745,1796,61,ITH,ITH4,6,Friuli-Venezia Giulia,Friuli Venezia Giulia,1215220,736713,60.62,0.3
1633,2021-02-24,FVG,2532,1093,1439,2503,18,11,ITH,ITH4,6,Friuli-Venezia Giulia,Friuli Venezia Giulia,1215220,739245,60.83,0.21
1634,2021-03-27,FVG,5383,2922,2461,3923,1412,48,ITH,ITH4,6,Friuli-Venezia Giulia,Friuli Venezia Giulia,1215220,744628,61.28,0.44
1635,2021-04-15,FVG,6527,2886,3641,5093,1275,159,ITH,ITH4,6,Friuli-Venezia Giulia,Friuli Venezia Giulia,1215220,751155,61.81,0.54
1636,2021-04-29,FVG,6808,2998,3810,4014,2606,188,ITH,ITH4,6,Friuli-Venezia Giulia,Friuli Venezia Giulia,1215220,757963,62.37,0.56
1637,2021-01-05,FVG,1679,552,1127,1677,0,2,ITH,ITH4,6,Friuli-Venezia Giulia,Friuli Venezia Giulia,1215220,759642,62.51,0.14
1638,2021-08-07,FVG,4835,2611,2224,2772,1932,131,ITH,ITH4,6,Friuli-Venezia Giulia,Friuli Venezia Giulia,1215220,764477,62.91,0.4
1639,2021-04-24,FVG,6693,2952,3741,5207,1245,241,ITH,ITH4,6,Friuli-Venezia Giulia,Friuli Venezia Giulia,1215220,771170,63.46,0.55
1640,2021-06-06,FVG,9504,4636,4868,7643,1568,293,ITH,ITH4,6,Friuli-Venezia Giulia,Friuli Venezia Giulia,1215220,780674,64.24,0.78
1641,2021-02-26,FVG,3784,2130,1654,3581,171,32,ITH,ITH4,6,Friuli-Venezia Giulia,Friuli Venezia Giulia,1215220,784458,64.55,0.31
1642,2021-02-17,FVG,2365,1006,1359,1873,489,3,ITH,ITH4,6,Friuli-Venezia Giulia,Friuli Venezia Giulia,1215220,786823,64.75,0.19
1643,2021-02-12,FVG,1195,428,767,1142,49,4,ITH,ITH4,6,Friuli-Venezia Giulia,Friuli Venezia Giulia,1215220,788018,64.85,0.1
1644,2021-06-25,FVG,11008,5533,5475,2387,8562,59,ITH,ITH4,6,Friuli-Venezia Giulia,Friuli Venezia Giulia,1215220,799026,65.75,0.91
1645,2021-07-09,FVG,11959,6354,5605,2128,9544,287,ITH,ITH4,6,Friuli-Venezia Giulia,Friuli Venezia Giulia,1215220,810985,66.74,0.98
1646,2021-03-17,FVG,3242,1270,1972,736,2496,10,ITH,ITH4,6,Friuli-Venezia Giulia,Friuli Venezia Giulia,1215220,814227,67.0,0.27
1647,2021-08-21,FVG,2896,1558,1338,280,2574,42,ITH,ITH4,6,Friuli-Venezia Giulia,Friuli Venezia Giulia,1215220,817123,67.24,0.24
1648,2021-05-13,FVG,11226,5428,5798,8748,2081,397,ITH,ITH4,6,Friuli-Venezia Giulia,Friuli Venezia Giulia,1215220,828349,68.16,0.92
1649,2021-02-16,FVG,2518,1136,1382,2398,116,4,ITH,ITH4,6,Friuli-Venezia Giulia,Friuli Venezia Giulia,1215220,830867,68.37,0.21
1650,2021-03-24,FVG,3987,1727,2260,2465,1484,38,ITH,ITH4,6,Friuli-Venezia Giulia,Friuli Venezia Giulia,1215220,834854,68.7,0.33
1651,2021-05-20,FVG,12736,6335,6401,9798,2532,406,ITH,ITH4,6,Friuli-Venezia Giulia,Friuli Venezia Giulia,1215220,847590,69.75,1.05
1652,2021-01-26,FVG,1979,649,1330,217,1761,1,ITH,ITH4,6,Friuli-Venezia Giulia,Friuli Venezia Giulia,1215220,849569,69.91,0.16
1653,2021-07-29,FVG,9608,4899,4709,3226,6086,296,ITH,ITH4,6,Friuli-Venezia Giulia,Friuli Venezia Giulia,1215220,859177,70.7,0.79
1654,2021-04-20,FVG,7147,3079,4068,3099,3920,128,ITH,ITH4,6,Friuli-Venezia Giulia,Friuli Venezia Giulia,1215220,866324,71.29,0.59
1655,2021-06-23,FVG,12105,5859,6246,1998,9961,146,ITH,ITH4,6,Friuli-Venezia Giulia,Friuli Venezia Giulia,1215220,878429,72.29,1.0
1656,2021-08-19,FVG,4786,2561,2225,1627,3002,157,ITH,ITH4,6,Friuli-Venezia Giulia,Friuli Venezia Giulia,1215220,883215,72.68,0.39
1657,2021-08-05,FVG,7134,3669,3465,3238,3694,202,ITH,ITH4,6,Friuli-Venezia Giulia,Friuli Venezia Giulia,1215220,890349,73.27,0.59
1658,2021-04-27,FVG,8150,3742,4408,3551,4498,101,ITH,ITH4,6,Friuli-Venezia Giulia,Friuli Venezia Giulia,1215220,898499,73.94,0.67
1659,2021-02-05,FVG,2632,792,1840,89,2543,0,ITH,ITH4,6,Friuli-Venezia Giulia,Friuli Venezia Giulia,1215220,901131,74.15,0.22
1660,2021-04-14,FVG,7254,3135,4119,5411,1718,125,ITH,ITH4,6,Friuli-Venezia Giulia,Friuli Venezia Giulia,1215220,908385,74.75,0.6
1661,2021-07-06,FVG,11222,5858,5364,1353,9757,112,ITH,ITH4,6,Friuli-Venezia Giulia,Friuli Venezia Giulia,1215220,919607,75.67,0.92
1662,2021-07-23,FVG,9059,4644,4415,3041,5593,425,ITH,ITH4,6,Friuli-Venezia Giulia,Friuli Venezia Giulia,1215220,928666,76.42,0.75
1663,2021-08-25,FVG,7845,4199,3646,3021,4460,364,ITH,ITH4,6,Friuli-Venezia Giulia,Friuli Venezia Giulia,1215220,936511,77.07,0.65
1664,2021-05-30,FVG,11078,4997,6081,7237,3593,248,ITH,ITH4,6,Friuli-Venezia Giulia,Friuli Venezia Giulia,1215220,947589,77.98,0.91
1665,2021-08-06,FVG,6453,3395,3058,2349,3932,172,ITH,ITH4,6,Friuli-Venezia Giulia,Friuli Venezia Giulia,1215220,954042,78.51,0.53
1666,2021-08-11,FVG,7932,4188,3744,5224,2374,334,ITH,ITH4,6,Friuli-Venezia Giulia,Friuli Venezia Giulia,1215220,961974,79.16,0.65
1667,2021-05-03,FVG,7256,3304,3952,3346,3793,117,ITH,ITH4,6,Friuli-Venezia Giulia,Friuli Venezia Giulia,1215220,969230,79.76,0.6
1668,2021-01-14,FVG,2593,794,1799,2590,0,3,ITH,ITH4,6,Friuli-Venezia Giulia,Friuli Venezia Giulia,1215220,971823,79.97,0.21
1669,2021-08-13,FVG,3814,2139,1675,2645,968,201,ITH,ITH4,6,Friuli-Venezia Giulia,Friuli Venezia Giulia,1215220,975637,80.28,0.31
1670,2021-06-08,FVG,10559,5536,5023,9637,500,422,ITH,ITH4,6,Friuli-Venezia Giulia,Friuli Venezia Giulia,1215220,986196,81.15,0.87
1671,2021-02-28,FVG,2692,1005,1687,2269,394,29,ITH,ITH4,6,Friuli-Venezia Giulia,Friuli Venezia Giulia,1215220,988888,81.38,0.22
1672,2021-08-04,FVG,9348,4833,4515,4664,4381,303,ITH,ITH4,6,Friuli-Venezia Giulia,Friuli Venezia Giulia,1215220,998236,82.14,0.77
1673,2021-04-26,FVG,5492,2466,3026,3716,1656,120,ITH,ITH4,6,Friuli-Venezia Giulia,Friuli Venezia Giulia,1215220,1003728,82.6,0.45
1674,2021-03-29,FVG,7039,3134,3905,5375,1590,74,ITH,ITH4,6,Friuli-Venezia Giulia,Friuli Venezia Giulia,1215220,1010767,83.18,0.58
1675,2021-07-07,FVG,11326,5799,5527,1450,9749,127,ITH,ITH4,6,Friuli-Venezia Giulia,Friuli Venezia Giulia,1215220,1022093,84.11,0.93
1676,2021-07-21,FVG,8654,4384,4270,2044,6348,262,ITH,ITH4,6,Friuli-Venezia Giulia,Friuli Venezia Giulia,1215220,1030747,84.82,0.71
1677,2021-05-15,FVG,12694,6120,6574,7687,4705,302,ITH,ITH4,6,Friuli-Venezia Giulia,Friuli Venezia Giulia,1215220,1043441,85.86,1.04
1678,2021-05-01,FVG,7215,3252,3963,5911,1046,258,ITH,ITH4,6,Friuli-Venezia Giulia,Friuli Venezia Giulia,1215220,1050656,86.46,0.59
1679,2021-01-21,FVG,899,347,552,3,896,0,ITH,ITH4,6,Friuli-Venezia Giulia,Friuli Venezia Giulia,1215220,1051555,86.53,0.07
1680,2021-02-21,FVG,802,281,521,421,379,2,ITH,ITH4,6,Friuli-Venezia Giulia,Friuli Venezia Giulia,1215220,1052357,86.6,0.07
1681,2021-02-09,FVG,1845,555,1290,1556,288,1,ITH,ITH4,6,Friuli-Venezia Giulia,Friuli Venezia Giulia,1215220,1054202,86.75,0.15
1682,2021-02-02,FVG,2483,812,1671,218,2265,0,ITH,ITH4,6,Friuli-Venezia Giulia,Friuli Venezia Giulia,1215220,1056685,86.95,0.2
1683,2021-03-31,FVG,8149,3574,4575,7173,850,126,ITH,ITH4,6,Friuli-Venezia Giulia,Friuli Venezia Giulia,1215220,1064834,87.62,0.67
1684,2021-09-02,FVG,6914,3747,3167,1902,4778,234,ITH,ITH4,6,Friuli-Venezia Giulia,Friuli Venezia Giulia,1215220,1071748,88.19,0.57
1685,2021-05-25,FVG,12962,6408,6554,9288,3329,345,ITH,ITH4,6,Friuli-Venezia Giulia,Friuli Venezia Giulia,1215220,1084710,89.26,1.07
1686,2021-08-16,FVG,4801,2584,2217,2677,1876,248,ITH,ITH4,6,Friuli-Venezia Giulia,Friuli Venezia Giulia,1215220,1089511,89.66,0.4
1687,2021-06-11,FVG,10943,5968,4975,9640,839,464,ITH,ITH4,6,Friuli-Venezia Giulia,Friuli Venezia Giulia,1215220,1100454,90.56,0.9
1688,2021-03-03,FVG,3657,1642,2015,2350,1277,30,ITH,ITH4,6,Friuli-Venezia Giulia,Friuli Venezia Giulia,1215220,1104111,90.86,0.3
1689,2021-09-04,FVG,2786,1509,1277,1598,991,197,ITH,ITH4,6,Friuli-Venezia Giulia,Friuli Venezia Giulia,1215220,1106897,91.09,0.23
1690,2021-05-27,FVG,12866,6159,6707,7393,5248,225,ITH,ITH4,6,Friuli-Venezia Giulia,Friuli Venezia Giulia,1215220,1119763,92.14,1.06
1691,2021-07-30,FVG,9075,4729,4346,2771,6041,263,ITH,ITH4,6,Friuli-Venezia Giulia,Friuli Venezia Giulia,1215220,1128838,92.89,0.75
1692,2021-05-04,FVG,9617,4342,5275,6004,3387,226,ITH,ITH4,6,Friuli-Venezia Giulia,Friuli Venezia Giulia,1215220,1138455,93.68,0.79
1693,2021-01-24,FVG,307,121,186,2,305,0,ITH,ITH4,6,Friuli-Venezia Giulia,Friuli Venezia Giulia,1215220,1138762,93.71,0.03
1694,2021-06-30,FVG,13204,6722,6482,1386,11644,174,ITH,ITH4,6,Friuli-Venezia Giulia,Friuli Venezia Giulia,1215220,1151966,94.79,1.09
1695,2021-03-08,FVG,4135,1648,2487,2028,2092,15,ITH,ITH4,6,Friuli-Venezia Giulia,Friuli Venezia Giulia,1215220,1156101,95.14,0.34
1696,2021-03-22,FVG,3669,1454,2215,1671,1959,39,ITH,ITH4,6,Friuli-Venezia Giulia,Friuli Venezia Giulia,1215220,1159770,95.44,0.3
1697,2021-06-03,FVG,12476,6765,5711,9916,2131,429,ITH,ITH4,6,Friuli-Venezia Giulia,Friuli Venezia Giulia,1215220,1172246,96.46,1.03
1698,2021-01-19,FVG,6,2,4,6,0,0,ITH,ITH4,6,Friuli-Venezia Giulia,Friuli Venezia Giulia,1215220,1172252,96.46,0.0
1699,2021-01-10,FVG,2942,919,2023,2942,0,0,ITH,ITH4,6,Friuli-Venezia Giulia,Friuli Venezia Giulia,1215220,1175194,96.71,0.24
1700,2021-07-14,FVG,10911,5583,5328,1258,9461,192,ITH,ITH4,6,Friuli-Venezia Giulia,Friuli Venezia Giulia,1215220,1186105,97.6,0.9
1701,2021-04-05,FVG,2912,1449,1463,2834,16,62,ITH,ITH4,6,Friuli-Venezia Giulia,Friuli Venezia Giulia,1215220,1189017,97.84,0.24
1702,2021-01-12,FVG,2272,718,1554,2272,0,0,ITH,ITH4,6,Friuli-Venezia Giulia,Friuli Venezia Giulia,1215220,1191289,98.03,0.19
1703,2021-01-29,FVG,2419,815,1604,266,2153,0,ITH,ITH4,6,Friuli-Venezia Giulia,Friuli Venezia Giulia,1215220,1193708,98.23,0.2
1704,2021-04-22,FVG,6801,3093,3708,3034,3695,72,ITH,ITH4,6,Friuli-Venezia Giulia,Friuli Venezia Giulia,1215220,1200509,98.79,0.56
1705,2021-08-02,FVG,9032,4641,4391,2861,5915,256,ITH,ITH4,6,Friuli-Venezia Giulia,Friuli Venezia Giulia,1215220,1209541,99.53,0.74
1706,2021-04-03,FVG,4022,1994,2028,2622,1339,61,ITH,ITH4,6,Friuli-Venezia Giulia,Friuli Venezia Giulia,1215220,1213563,99.86,0.33
1707,2021-01-17,FVG,1715,522,1193,1713,0,2,ITH,ITH4,6,Friuli-Venezia Giulia,Friuli Venezia Giulia,1215220,1215278,100.0,0.14
1708,2021-03-15,FVG,3963,1813,2150,1614,2326,23,ITH,ITH4,6,Friuli-Venezia Giulia,Friuli Venezia Giulia,1215220,1219241,100.33,0.33
1709,2021-05-11,FVG,9188,4432,4756,7158,1812,218,ITH,ITH4,6,Friuli-Venezia Giulia,Friuli Venezia Giulia,1215220,1228429,101.09,0.76
1710,2021-01-31,FVG,2727,842,1885,385,2342,0,ITH,ITH4,6,Friuli-Venezia Giulia,Friuli Venezia Giulia,1215220,1231156,101.31,0.22
1711,2021-08-23,FVG,4702,2426,2276,2562,1782,358,ITH,ITH4,6,Friuli-Venezia Giulia,Friuli Venezia Giulia,1215220,1235858,101.7,0.39
1712,2021-05-29,FVG,12043,5857,6186,6783,4996,264,ITH,ITH4,6,Friuli-Venezia Giulia,Friuli Venezia Giulia,1215220,1247901,102.69,0.99
1713,2021-07-25,FVG,3896,2026,1870,1918,1872,106,ITH,ITH4,6,Friuli-Venezia Giulia,Friuli Venezia Giulia,1215220,1251797,103.01,0.32
1714,2021-07-11,FVG,6871,3589,3282,2387,4184,300,ITH,ITH4,6,Friuli-Venezia Giulia,Friuli Venezia Giulia,1215220,1258668,103.58,0.57
1715,2021-09-06,FVG,3878,2207,1671,685,3072,121,ITH,ITH4,6,Friuli-Venezia Giulia,Friuli Venezia Giulia,1215220,1262546,103.89,0.32
1716,2021-01-28,FVG,2249,797,1452,355,1894,0,ITH,ITH4,6,Friuli-Venezia Giulia,Friuli Venezia Giulia,1215220,1264795,104.08,0.19
1717,2021-05-08,FVG,10344,4674,5670,5361,4793,190,ITH,ITH4,6,Friuli-Venezia Giulia,Friuli Venezia Giulia,1215220,1275139,104.93,0.85
1718,2021-02-14,FVG,1,0,1,0,1,0,ITH,ITH4,6,Friuli-Venezia Giulia,Friuli Venezia Giulia,1215220,1275140,104.93,0.0
1719,2021-08-18,FVG,4712,2510,2202,3007,1472,233,ITH,ITH4,6,Friuli-Venezia Giulia,Friuli Venezia Giulia,1215220,1279852,105.32,0.39
1720,2021-05-10,FVG,8009,3557,4452,6222,1545,242,ITH,ITH4,6,Friuli-Venezia Giulia,Friuli Venezia Giulia,1215220,1287861,105.98,0.66
1721,2021-07-04,FVG,9359,4797,4562,2893,6211,255,ITH,ITH4,6,Friuli-Venezia Giulia,Friuli Venezia Giulia,1215220,1297220,106.75,0.77
1722,2021-03-26,FVG,6059,2632,3427,3855,2029,175,ITH,ITH4,6,Friuli-Venezia Giulia,Friuli Venezia Giulia,1215220,1303279,107.25,0.5
1723,2021-03-12,FVG,4164,1736,2428,2753,1385,26,ITH,ITH4,6,Friuli-Venezia Giulia,Friuli Venezia Giulia,1215220,1307443,107.59,0.34
1724,2021-01-02,FVG,1217,470,747,1217,0,0,ITH,ITH4,6,Friuli-Venezia Giulia,Friuli Venezia Giulia,1215220,1308660,107.69,0.1
1725,2021-04-12,FVG,7288,3196,4092,5997,1136,155,ITH,ITH4,6,Friuli-Venezia Giulia,Friuli Venezia Giulia,1215220,1315948,108.29,0.6
1726,2021-06-10,FVG,11593,6035,5558,9701,1485,407,ITH,ITH4,6,Friuli-Venezia Giulia,Friuli Venezia Giulia,1215220,1327541,109.24,0.95
1727,2021-09-01,FVG,8468,4596,3872,2051,6209,208,ITH,ITH4,6,Friuli-Venezia Giulia,Friuli Venezia Giulia,1215220,1336009,109.94,0.7
1728,2021-03-19,FVG,3278,1370,1908,1317,1946,15,ITH,ITH4,6,Friuli-Venezia Giulia,Friuli Venezia Giulia,1215220,1339287,110.21,0.27
1729,2021-06-27,FVG,7668,3829,3839,3735,3855,78,ITH,ITH4,6,Friuli-Venezia Giulia,Friuli Venezia Giulia,1215220,1346955,110.84,0.63
1730,2021-06-29,FVG,11385,5807,5578,1229,10049,107,ITH,ITH4,6,Friuli-Venezia Giulia,Friuli Venezia Giulia,1215220,1358340,111.78,0.94
1731,2021-07-16,FVG,9807,5239,4568,1702,7956,149,ITH,ITH4,6,Friuli-Venezia Giulia,Friuli Venezia Giulia,1215220,1368147,112.58,0.81
1732,2021-04-07,FVG,7860,3644,4216,6952,789,119,ITH,ITH4,6,Friuli-Venezia Giulia,Friuli Venezia Giulia,1215220,1376007,113.23,0.65
1733,2021-08-30,FVG,7305,3886,3419,2478,4593,234,ITH,ITH4,6,Friuli-Venezia Giulia,Friuli Venezia Giulia,1215220,1383312,113.83,0.6
1734,2021-05-22,FVG,11604,5209,6395,7087,4242,275,ITH,ITH4,6,Friuli-Venezia Giulia,Friuli Venezia Giulia,1215220,1394916,114.79,0.95
1735,2021-07-18,FVG,5469,2959,2510,438,5007,24,ITH,ITH4,6,Friuli-Venezia Giulia,Friuli Venezia Giulia,1215220,1400385,115.24,0.45
1736,2021-04-08,FVG,7471,3235,4236,5407,1930,134,ITH,ITH4,6,Friuli-Venezia Giulia,Friuli Venezia Giulia,1215220,1407856,115.85,0.61
1737,2021-05-21,FVG,11295,5045,6250,7915,3034,346,ITH,ITH4,6,Friuli-Venezia Giulia,Friuli Venezia Giulia,1215220,1419151,116.78,0.93
1738,2021-02-10,FVG,1353,499,854,1265,88,0,ITH,ITH4,6,Friuli-Venezia Giulia,Friuli Venezia Giulia,1215220,1420504,116.89,0.11
1739,2021-07-17,FVG,7389,3965,3424,620,6685,84,ITH,ITH4,6,Friuli-Venezia Giulia,Friuli Venezia Giulia,1215220,1427893,117.5,0.61
1740,2021-02-01,FVG,2106,690,1416,17,2089,0,ITH,ITH4,6,Friuli-Venezia Giulia,Friuli Venezia Giulia,1215220,1429999,117.67,0.17
1741,2021-08-31,FVG,7544,4039,3505,1349,6003,192,ITH,ITH4,6,Friuli-Venezia Giulia,Friuli Venezia Giulia,1215220,1437543,118.29,0.62
1742,2021-05-14,FVG,10864,5400,5464,7929,2638,297,ITH,ITH4,6,Friuli-Venezia Giulia,Friuli Venezia Giulia,1215220,1448407,119.19,0.89
1743,2021-02-03,FVG,2650,792,1858,22,2627,1,ITH,ITH4,6,Friuli-Venezia Giulia,Friuli Venezia Giulia,1215220,1451057,119.41,0.22
1744,2021-02-08,FVG,2361,697,1664,90,2270,1,ITH,ITH4,6,Friuli-Venezia Giulia,Friuli Venezia Giulia,1215220,1453418,119.6,0.19
1745,2021-06-13,FVG,8715,4538,4177,5174,3329,212,ITH,ITH4,6,Friuli-Venezia Giulia,Friuli Venezia Giulia,1215220,1462133,120.32,0.72
1746,2021-07-26,FVG,8559,4268,4291,1778,6571,210,ITH,ITH4,6,Friuli-Venezia Giulia,Friuli Venezia Giulia,1215220,1470692,121.02,0.7
1747,2021-04-17,FVG,7469,3240,4229,5820,1484,165,ITH,ITH4,6,Friuli-Venezia Giulia,Friuli Venezia Giulia,1215220,1478161,121.64,0.61
1748,2021-07-28,FVG,10501,5356,5145,4008,6041,452,ITH,ITH4,6,Friuli-Venezia Giulia,Friuli Venezia Giulia,1215220,1488662,122.5,0.86
1749,2021-07-19,FVG,9445,4938,4507,852,8439,154,ITH,ITH4,6,Friuli-Venezia Giulia,Friuli Venezia Giulia,1215220,1498107,123.28,0.78
1750,2021-04-10,FVG,5060,2217,2843,3753,1230,77,ITH,ITH4,6,Friuli-Venezia Giulia,Friuli Venezia Giulia,1215220,1503167,123.7,0.42
1751,2021-05-23,FVG,10296,4868,5428,5922,4158,216,ITH,ITH4,6,Friuli-Venezia Giulia,Friuli Venezia Giulia,1215220,1513463,124.54,0.85
1752,2021-01-07,FVG,2108,726,1382,2108,0,0,ITH,ITH4,6,Friuli-Venezia Giulia,Friuli Venezia Giulia,1215220,1515571,124.72,0.17
1753,2021-03-05,FVG,3833,1543,2290,2731,1079,23,ITH,ITH4,6,Friuli-Venezia Giulia,Friuli Venezia Giulia,1215220,1519404,125.03,0.32
1754,2021-04-19,FVG,6733,3142,3591,3214,3426,93,ITH,ITH4,6,Friuli-Venezia Giulia,Friuli Venezia Giulia,1215220,1526137,125.59,0.55
1755,2021-01-09,FVG,2534,846,1688,2533,0,1,ITH,ITH4,6,Friuli-Venezia Giulia,Friuli Venezia Giulia,1215220,1528671,125.79,0.21
1756,2021-06-15,FVG,12176,6196,5980,5354,6542,280,ITH,ITH4,6,Friuli-Venezia Giulia,Friuli Venezia Giulia,1215220,1540847,126.8,1.0
1757,2021-03-07,FVG,2557,939,1618,2496,1,60,ITH,ITH4,6,Friuli-Venezia Giulia,Friuli Venezia Giulia,1215220,1543404,127.01,0.21
1758,2020-12-31,FVG,1048,381,667,1047,0,1,ITH,ITH4,6,Friuli-Venezia Giulia,Friuli Venezia Giulia,1215220,1544452,127.09,0.09
1759,2021-06-17,FVG,11441,5788,5653,2281,9047,113,ITH,ITH4,6,Friuli-Venezia Giulia,Friuli Venezia Giulia,1215220,1555893,128.03,0.94
1760,2021-06-22,FVG,11612,5979,5633,2365,9112,135,ITH,ITH4,6,Friuli-Venezia Giulia,Friuli Venezia Giulia,1215220,1567505,128.99,0.96
1761,2021-09-06,PUG,21191,11096,10095,7076,13196,919,ITF,ITF4,16,Puglia,Puglia,4029053,21191,0.53,0.53
1762,2021-07-11,PUG,12194,5764,6430,2577,9519,98,ITF,ITF4,16,Puglia,Puglia,4029053,33385,0.83,0.3
1763,2021-08-23,PUG,30277,15656,14621,10621,18763,893,ITF,ITF4,16,Puglia,Puglia,4029053,63662,1.58,0.75
1764,2021-01-12,PUG,4223,1774,2449,4222,0,1,ITF,ITF4,16,Puglia,Puglia,4029053,67885,1.68,0.1
1765,2021-04-07,PUG,15748,7150,8598,8841,6709,198,ITF,ITF4,16,Puglia,Puglia,4029053,83633,2.08,0.39
1766,2021-07-16,PUG,46605,22618,23987,12948,32846,811,ITF,ITF4,16,Puglia,Puglia,4029053,130238,3.23,1.16
1767,2021-04-05,PUG,12779,6205,6574,12104,534,141,ITF,ITF4,16,Puglia,Puglia,4029053,143017,3.55,0.32
1768,2021-03-19,PUG,7998,3672,4326,3367,4595,36,ITF,ITF4,16,Puglia,Puglia,4029053,151015,3.75,0.2
1769,2021-06-27,PUG,18576,9226,9350,9956,8354,266,ITF,ITF4,16,Puglia,Puglia,4029053,169591,4.21,0.46
1770,2021-02-21,PUG,2179,475,1704,2065,63,51,ITF,ITF4,16,Puglia,Puglia,4029053,171770,4.26,0.05
1771,2021-06-01,PUG,35059,17561,17498,21647,13014,398,ITF,ITF4,16,Puglia,Puglia,4029053,206829,5.13,0.87
1772,2021-05-15,PUG,43731,19044,24687,22838,20180,713,ITF,ITF4,16,Puglia,Puglia,4029053,250560,6.22,1.09
1773,2021-06-03,PUG,50718,24600,26118,30551,19441,726,ITF,ITF4,16,Puglia,Puglia,4029053,301278,7.48,1.26
1774,2021-03-10,PUG,14862,6648,8214,11559,3140,163,ITF,ITF4,16,Puglia,Puglia,4029053,316140,7.85,0.37
1775,2021-02-09,PUG,3855,1575,2280,2159,1676,20,ITF,ITF4,16,Puglia,Puglia,4029053,319995,7.94,0.1
1776,2021-05-20,PUG,33736,15309,18427,20764,12456,516,ITF,ITF4,16,Puglia,Puglia,4029053,353731,8.78,0.84
1777,2021-03-24,PUG,13628,6542,7086,6049,7458,121,ITF,ITF4,16,Puglia,Puglia,4029053,367359,9.12,0.34
1778,2021-08-28,PUG,5721,3130,2591,2017,3516,188,ITF,ITF4,16,Puglia,Puglia,4029053,373080,9.26,0.14
1779,2021-01-26,PUG,5381,2408,2973,563,4817,1,ITF,ITF4,16,Puglia,Puglia,4029053,378461,9.39,0.13
1780,2021-07-02,PUG,47472,22569,24903,17364,29180,928,ITF,ITF4,16,Puglia,Puglia,4029053,425933,10.57,1.18
1781,2021-02-07,PUG,1585,669,916,253,1332,0,ITF,ITF4,16,Puglia,Puglia,4029053,427518,10.61,0.04
1782,2021-01-21,PUG,2132,905,1227,1268,862,2,ITF,ITF4,16,Puglia,Puglia,4029053,429650,10.66,0.05
1783,2021-05-01,PUG,27722,12693,15029,16729,10712,281,ITF,ITF4,16,Puglia,Puglia,4029053,457372,11.35,0.69
1784,2021-08-09,PUG,27951,14399,13552,11272,15814,865,ITF,ITF4,16,Puglia,Puglia,4029053,485323,12.05,0.69
1785,2021-01-02,PUG,2958,1306,1652,2958,0,0,ITF,ITF4,16,Puglia,Puglia,4029053,488281,12.12,0.07
1786,2021-04-12,PUG,29494,13872,15622,26152,3024,318,ITF,ITF4,16,Puglia,Puglia,4029053,517775,12.85,0.73
1787,2021-03-05,PUG,17749,7201,10548,15205,2320,224,ITF,ITF4,16,Puglia,Puglia,4029053,535524,13.29,0.44
1788,2021-02-26,PUG,13804,5070,8734,12525,1079,200,ITF,ITF4,16,Puglia,Puglia,4029053,549328,13.63,0.34
1789,2020-12-31,PUG,1638,785,853,1638,0,0,ITF,ITF4,16,Puglia,Puglia,4029053,550966,13.67,0.04
1790,2021-08-11,PUG,23892,12279,11613,12084,10789,1019,ITF,ITF4,16,Puglia,Puglia,4029053,574858,14.27,0.59
1791,2021-06-15,PUG,42751,20899,21852,22390,19767,594,ITF,ITF4,16,Puglia,Puglia,4029053,617609,15.33,1.06
1792,2021-06-08,PUG,39409,19191,20218,20960,17887,562,ITF,ITF4,16,Puglia,Puglia,4029053,657018,16.31,0.98
1793,2021-04-19,PUG,27768,12903,14865,24379,3051,338,ITF,ITF4,16,Puglia,Puglia,4029053,684786,17.0,0.69
1794,2021-07-28,PUG,45394,22955,22439,14728,29778,888,ITF,ITF4,16,Puglia,Puglia,4029053,730180,18.12,1.13
1795,2021-04-24,PUG,29465,13425,16040,25172,3956,337,ITF,ITF4,16,Puglia,Puglia,4029053,759645,18.85,0.73
1796,2021-08-30,PUG,28425,14786,13639,11483,15915,1027,ITF,ITF4,16,Puglia,Puglia,4029053,788070,19.56,0.71
1797,2021-01-31,PUG,1826,835,991,74,1752,0,ITF,ITF4,16,Puglia,Puglia,4029053,789896,19.61,0.05
1798,2021-05-29,PUG,30712,14479,16233,20610,9555,547,ITF,ITF4,16,Puglia,Puglia,4029053,820608,20.37,0.76
1799,2021-04-02,PUG,12867,6011,6856,8185,4531,151,ITF,ITF4,16,Puglia,Puglia,4029053,833475,20.69,0.32
1800,2021-07-30,PUG,36442,18726,17716,13169,22397,876,ITF,ITF4,16,Puglia,Puglia,4029053,869917,21.59,0.9
1801,2021-05-27,PUG,41031,19393,21638,22900,17455,676,ITF,ITF4,16,Puglia,Puglia,4029053,910948,22.61,1.02
1802,2021-09-04,PUG,5513,2987,2526,1639,3694,180,ITF,ITF4,16,Puglia,Puglia,4029053,916461,22.75,0.14
1803,2021-08-18,PUG,20152,10666,9486,10673,8553,926,ITF,ITF4,16,Puglia,Puglia,4029053,936613,23.25,0.5
1804,2021-02-14,PUG,789,348,441,657,127,5,ITF,ITF4,16,Puglia,Puglia,4029053,937402,23.27,0.02
1805,2021-05-25,PUG,34853,16270,18583,20584,13683,586,ITF,ITF4,16,Puglia,Puglia,4029053,972255,24.13,0.87
1806,2021-05-08,PUG,54487,23066,31421,23953,29948,586,ITF,ITF4,16,Puglia,Puglia,4029053,1026742,25.48,1.35
1807,2021-08-16,PUG,12064,6398,5666,7057,4368,639,ITF,ITF4,16,Puglia,Puglia,4029053,1038806,25.78,0.3
1808,2021-03-29,PUG,13586,6630,6956,6617,6769,200,ITF,ITF4,16,Puglia,Puglia,4029053,1052392,26.12,0.34
1809,2021-03-12,PUG,14326,6460,7866,10232,3949,145,ITF,ITF4,16,Puglia,Puglia,4029053,1066718,26.48,0.36
1810,2021-06-20,PUG,21627,10865,10762,14067,7234,326,ITF,ITF4,16,Puglia,Puglia,4029053,1088345,27.01,0.54
1811,2021-07-21,PUG,45071,22217,22854,11885,32341,845,ITF,ITF4,16,Puglia,Puglia,4029053,1133416,28.13,1.12
1812,2021-07-04,PUG,19951,9704,10247,7936,11729,286,ITF,ITF4,16,Puglia,Puglia,4029053,1153367,28.63,0.5
1813,2021-07-23,PUG,43357,21939,21418,13652,28729,976,ITF,ITF4,16,Puglia,Puglia,4029053,1196724,29.7,1.08
1814,2021-01-19,PUG,1221,452,769,1210,10,1,ITF,ITF4,16,Puglia,Puglia,4029053,1197945,29.73,0.03
1815,2021-06-13,PUG,21888,10964,10924,16377,5225,286,ITF,ITF4,16,Puglia,Puglia,4029053,1219833,30.28,0.54
1816,2021-02-28,PUG,6079,1811,4268,5811,191,77,ITF,ITF4,16,Puglia,Puglia,4029053,1225912,30.43,0.15
1817,2021-01-14,PUG,4081,1595,2486,4080,0,1,ITF,ITF4,16,Puglia,Puglia,4029053,1229993,30.53,0.1
1818,2021-01-07,PUG,5735,2469,3266,5735,0,0,ITF,ITF4,16,Puglia,Puglia,4029053,1235728,30.67,0.14
1819,2021-04-17,PUG,40104,19006,21098,36086,3592,426,ITF,ITF4,16,Puglia,Puglia,4029053,1275832,31.67,1.0
1820,2021-02-19,PUG,4756,2024,2732,4308,393,55,ITF,ITF4,16,Puglia,Puglia,4029053,1280588,31.78,0.12
1821,2021-06-22,PUG,42580,20657,21923,19062,22946,572,ITF,ITF4,16,Puglia,Puglia,4029053,1323168,32.84,1.06
1822,2021-04-26,PUG,26360,12080,14280,22726,3240,394,ITF,ITF4,16,Puglia,Puglia,4029053,1349528,33.49,0.65
1823,2021-08-04,PUG,35288,17979,17309,12438,21790,1060,ITF,ITF4,16,Puglia,Puglia,4029053,1384816,34.37,0.88
1824,2021-05-06,PUG,39790,17404,22386,19302,19927,561,ITF,ITF4,16,Puglia,Puglia,4029053,1424606,35.36,0.99
1825,2021-03-31,PUG,14588,6840,7748,8844,5591,153,ITF,ITF4,16,Puglia,Puglia,4029053,1439194,35.72,0.36
1826,2021-04-16,PUG,36156,16994,19162,32435,3290,431,ITF,ITF4,16,Puglia,Puglia,4029053,1475350,36.62,0.9
1827,2021-02-18,PUG,4390,1850,2540,3719,610,61,ITF,ITF4,16,Puglia,Puglia,4029053,1479740,36.73,0.11
1828,2021-07-25,PUG,14320,7405,6915,4281,9835,204,ITF,ITF4,16,Puglia,Puglia,4029053,1494060,37.08,0.36
1829,2021-03-02,PUG,16436,6110,10326,14877,1311,248,ITF,ITF4,16,Puglia,Puglia,4029053,1510496,37.49,0.41
1830,2021-06-10,PUG,47280,23247,24033,29417,17144,719,ITF,ITF4,16,Puglia,Puglia,4029053,1557776,38.66,1.17
1831,2021-04-04,PUG,6000,2978,3022,5912,7,81,ITF,ITF4,16,Puglia,Puglia,4029053,1563776,38.81,0.15
1832,2021-07-13,PUG,48859,23039,25820,7786,40488,585,ITF,ITF4,16,Puglia,Puglia,4029053,1612635,40.03,1.21
1833,2021-03-21,PUG,2697,1227,1470,578,2107,12,ITF,ITF4,16,Puglia,Puglia,4029053,1615332,40.09,0.07
1834,2021-06-29,PUG,46759,22426,24333,15364,30703,692,ITF,ITF4,16,Puglia,Puglia,4029053,1662091,41.25,1.16
1835,2021-01-11,PUG,3758,1592,2166,3757,0,1,ITF,ITF4,16,Puglia,Puglia,4029053,1665849,41.35,0.09
1836,2021-04-21,PUG,23174,10700,12474,19126,3746,302,ITF,ITF4,16,Puglia,Puglia,4029053,1689023,41.92,0.58
1837,2021-05-24,PUG,36238,17099,19139,24512,11114,612,ITF,ITF4,16,Puglia,Puglia,4029053,1725261,42.82,0.9
1838,2021-09-01,PUG,24782,12861,11921,9840,13884,1058,ITF,ITF4,16,Puglia,Puglia,4029053,1750043,43.44,0.62
1839,2021-02-16,PUG,3393,1456,1937,2713,649,31,ITF,ITF4,16,Puglia,Puglia,4029053,1753436,43.52,0.08
1840,2021-01-30,PUG,5543,2516,3027,380,5162,1,ITF,ITF4,16,Puglia,Puglia,4029053,1758979,43.66,0.14
1841,2021-05-10,PUG,37938,16767,21171,19317,18112,509,ITF,ITF4,16,Puglia,Puglia,4029053,1796917,44.6,0.94
1842,2021-08-17,PUG,19953,10354,9599,9272,9972,709,ITF,ITF4,16,Puglia,Puglia,4029053,1816870,45.09,0.5
1843,2021-09-03,PUG,21151,10900,10251,8320,11651,1180,ITF,ITF4,16,Puglia,Puglia,4029053,1838021,45.62,0.52
1844,2021-06-12,PUG,34669,17278,17391,25085,8989,595,ITF,ITF4,16,Puglia,Puglia,4029053,1872690,46.48,0.86
1845,2021-01-28,PUG,5490,2286,3204,441,5049,0,ITF,ITF4,16,Puglia,Puglia,4029053,1878180,46.62,0.14
1846,2021-08-15,PUG,57,34,23,56,1,0,ITF,ITF4,16,Puglia,Puglia,4029053,1878237,46.62,0.0
1847,2021-04-23,PUG,29632,13774,15858,23925,5291,416,ITF,ITF4,16,Puglia,Puglia,4029053,1907869,47.35,0.74
1848,2021-08-01,PUG,12435,6514,5921,4328,7987,120,ITF,ITF4,16,Puglia,Puglia,4029053,1920304,47.66,0.31
1849,2021-02-04,PUG,5939,2367,3572,1132,4803,4,ITF,ITF4,16,Puglia,Puglia,4029053,1926243,47.81,0.15
1850,2021-05-17,PUG,32988,15295,17693,20471,12016,501,ITF,ITF4,16,Puglia,Puglia,4029053,1959231,48.63,0.82
1851,2021-08-25,PUG,25633,13461,12172,10283,14406,944,ITF,ITF4,16,Puglia,Puglia,4029053,1984864,49.26,0.64
1852,2021-08-08,PUG,5121,2601,2520,1655,3416,50,ITF,ITF4,16,Puglia,Puglia,4029053,1989985,49.39,0.13
1853,2021-04-09,PUG,22183,9558,12625,17088,4707,388,ITF,ITF4,16,Puglia,Puglia,4029053,2012168,49.94,0.55
1854,2021-02-11,PUG,3699,1401,2298,2392,1279,28,ITF,ITF4,16,Puglia,Puglia,4029053,2015867,50.03,0.09
1855,2021-07-18,PUG,18847,9651,9196,6204,12306,337,ITF,ITF4,16,Puglia,Puglia,4029053,2034714,50.5,0.47
1856,2021-05-22,PUG,34790,15925,18865,23657,10588,545,ITF,ITF4,16,Puglia,Puglia,4029053,2069504,51.36,0.86
1857,2021-02-25,PUG,11999,5071,6928,10678,1184,137,ITF,ITF4,16,Puglia,Puglia,4029053,2081503,51.66,0.3
1858,2021-06-05,PUG,42693,20910,21783,29206,12767,720,ITF,ITF4,16,Puglia,Puglia,4029053,2124196,52.72,1.06
1859,2021-03-16,PUG,9893,4696,5197,3452,6382,59,ITF,ITF4,16,Puglia,Puglia,4029053,2134089,52.97,0.25
1860,2021-06-24,PUG,53065,25671,27394,23601,28676,788,ITF,ITF4,16,Puglia,Puglia,4029053,2187154,54.28,1.32
1861,2021-04-28,PUG,19892,8922,10970,14833,4795,264,ITF,ITF4,16,Puglia,Puglia,4029053,2207046,54.78,0.49
1862,2021-08-06,PUG,30362,15809,14553,9122,20481,759,ITF,ITF4,16,Puglia,Puglia,4029053,2237408,55.53,0.75
1863,2021-01-09,PUG,4899,2252,2647,4895,0,4,ITF,ITF4,16,Puglia,Puglia,4029053,2242307,55.65,0.12
1864,2021-07-08,PUG,41632,19311,22321,5429,35744,459,ITF,ITF4,16,Puglia,Puglia,4029053,2283939,56.69,1.03
1865,2021-01-04,PUG,4514,2017,2497,4512,0,2,ITF,ITF4,16,Puglia,Puglia,4029053,2288453,56.8,0.11
1866,2021-03-26,PUG,12045,5865,6180,7224,4680,141,ITF,ITF4,16,Puglia,Puglia,4029053,2300498,57.1,0.3
1867,2021-03-09,PUG,13700,6124,7576,11495,2021,184,ITF,ITF4,16,Puglia,Puglia,4029053,2314198,57.44,0.34
1868,2021-04-14,PUG,32078,15131,16947,28469,3304,305,ITF,ITF4,16,Puglia,Puglia,4029053,2346276,58.23,0.8
1869,2021-03-28,PUG,3550,1659,1891,1177,2337,36,ITF,ITF4,16,Puglia,Puglia,4029053,2349826,58.32,0.09
1870,2021-07-06,PUG,42447,19546,22901,6105,35925,417,ITF,ITF4,16,Puglia,Puglia,4029053,2392273,59.38,1.05
1871,2021-06-19,PUG,34836,17473,17363,22230,11952,654,ITF,ITF4,16,Puglia,Puglia,4029053,2427109,60.24,0.86
1872,2021-06-21,PUG,41974,20467,21507,21468,19869,637,ITF,ITF4,16,Puglia,Puglia,4029053,2469083,61.28,1.04
1873,2021-02-13,PUG,3733,1461,2272,3021,696,16,ITF,ITF4,16,Puglia,Puglia,4029053,2472816,61.37,0.09
1874,2021-06-28,PUG,48747,23642,25105,21664,26286,797,ITF,ITF4,16,Puglia,Puglia,4029053,2521563,62.58,1.21
1875,2021-07-01,PUG,48550,22729,25821,11451,36465,634,ITF,ITF4,16,Puglia,Puglia,4029053,2570113,63.79,1.2
1876,2021-03-14,PUG,3382,1465,1917,2473,868,41,ITF,ITF4,16,Puglia,Puglia,4029053,2573495,63.87,0.08
1877,2021-01-16,PUG,2508,1035,1473,2507,0,1,ITF,ITF4,16,Puglia,Puglia,4029053,2576003,63.94,0.06
1878,2021-08-05,PUG,34415,17324,17091,9466,24072,877,ITF,ITF4,16,Puglia,Puglia,4029053,2610418,64.79,0.85
1879,2021-01-06,PUG,3966,1680,2286,3965,0,1,ITF,ITF4,16,Puglia,Puglia,4029053,2614384,64.89,0.1
1880,2021-02-02,PUG,4365,1857,2508,574,3790,1,ITF,ITF4,16,Puglia,Puglia,4029053,2618749,65.0,0.11
1881,2021-07-09,PUG,37170,17906,19264,6401,30090,679,ITF,ITF4,16,Puglia,Puglia,4029053,2655919,65.92,0.92
1882,2021-05-13,PUG,38897,17342,21555,21011,17320,566,ITF,ITF4,16,Puglia,Puglia,4029053,2694816,66.88,0.97
1883,2021-03-17,PUG,10356,4706,5650,4102,6191,63,ITF,ITF4,16,Puglia,Puglia,4029053,2705172,67.14,0.26
1884,2021-07-20,PUG,47047,23084,23963,8205,38336,506,ITF,ITF4,16,Puglia,Puglia,4029053,2752219,68.31,1.17
1885,2021-09-08,PUG,17299,9067,8232,5365,11238,696,ITF,ITF4,16,Puglia,Puglia,4029053,2769518,68.74,0.43
1886,2021-03-18,PUG,9626,4376,5250,3345,6215,66,ITF,ITF4,16,Puglia,Puglia,4029053,2779144,68.98,0.24
1887,2021-06-26,PUG,32475,16358,16117,15901,16005,569,ITF,ITF4,16,Puglia,Puglia,4029053,2811619,69.78,0.81
1888,2021-03-04,PUG,15401,6118,9283,13726,1440,235,ITF,ITF4,16,Puglia,Puglia,4029053,2827020,70.17,0.38
1889,2021-06-09,PUG,42027,20811,21216,29985,11332,710,ITF,ITF4,16,Puglia,Puglia,4029053,2869047,71.21,1.04
1890,2021-02-15,PUG,3270,1273,1997,2602,623,45,ITF,ITF4,16,Puglia,Puglia,4029053,2872317,71.29,0.08
1891,2021-05-26,PUG,38751,18620,20131,26250,11844,657,ITF,ITF4,16,Puglia,Puglia,4029053,2911068,72.25,0.96
1892,2021-01-27,PUG,4607,1946,2661,618,3989,0,ITF,ITF4,16,Puglia,Puglia,4029053,2915675,72.37,0.11
1893,2021-05-07,PUG,50277,22434,27843,25967,23704,606,ITF,ITF4,16,Puglia,Puglia,4029053,2965952,73.61,1.25
1894,2021-07-29,PUG,43050,21769,21281,12293,29968,789,ITF,ITF4,16,Puglia,Puglia,4029053,3009002,74.68,1.07
1895,2021-01-13,PUG,4556,1734,2822,4555,0,1,ITF,ITF4,16,Puglia,Puglia,4029053,3013558,74.8,0.11
1896,2021-05-21,PUG,39267,18653,20614,28279,10195,793,ITF,ITF4,16,Puglia,Puglia,4029053,3052825,75.77,0.97
1897,2021-08-31,PUG,24823,12779,12044,8300,15673,850,ITF,ITF4,16,Puglia,Puglia,4029053,3077648,76.39,0.62
1898,2021-05-19,PUG,26505,12813,13692,19570,6500,435,ITF,ITF4,16,Puglia,Puglia,4029053,3104153,77.04,0.66
1899,2021-03-23,PUG,11161,5666,5495,4529,6536,96,ITF,ITF4,16,Puglia,Puglia,4029053,3115314,77.32,0.28
1900,2021-08-24,PUG,25061,12823,12238,9283,14953,825,ITF,ITF4,16,Puglia,Puglia,4029053,3140375,77.94,0.62
1901,2021-08-12,PUG,19427,10331,9096,10956,7562,909,ITF,ITF4,16,Puglia,Puglia,4029053,3159802,78.43,0.48
1902,2021-06-16,PUG,42184,20760,21424,26923,14530,731,ITF,ITF4,16,Puglia,Puglia,4029053,3201986,79.47,1.05
1903,2020-12-30,PUG,1,0,1,1,0,0,ITF,ITF4,16,Puglia,Puglia,4029053,3201987,79.47,0.0
1904,2021-03-22,PUG,9992,5144,4848,4250,5670,72,ITF,ITF4,16,Puglia,Puglia,4029053,3211979,79.72,0.25
1905,2021-01-24,PUG,1674,754,920,151,1523,0,ITF,ITF4,16,Puglia,Puglia,4029053,3213653,79.76,0.04
1906,2021-06-30,PUG,47953,23257,24696,18844,28251,858,ITF,ITF4,16,Puglia,Puglia,4029053,3261606,80.95,1.19
1907,2021-03-15,PUG,12362,6160,6202,5741,6517,104,ITF,ITF4,16,Puglia,Puglia,4029053,3273968,81.26,0.31
1908,2021-08-19,PUG,17832,9292,8540,8725,8382,725,ITF,ITF4,16,Puglia,Puglia,4029053,3291800,81.7,0.44
1909,2021-01-17,PUG,1311,592,719,1241,70,0,ITF,ITF4,16,Puglia,Puglia,4029053,3293111,81.73,0.03
1910,2021-06-23,PUG,29455,14393,15062,16949,11895,611,ITF,ITF4,16,Puglia,Puglia,4029053,3322566,82.47,0.73
1911,2021-04-27,PUG,26740,12102,14638,20784,5627,329,ITF,ITF4,16,Puglia,Puglia,4029053,3349306,83.13,0.66
1912,2021-08-27,PUG,23825,12473,11352,9924,12957,944,ITF,ITF4,16,Puglia,Puglia,4029053,3373131,83.72,0.59
1913,2021-02-23,PUG,9403,4435,4968,8814,497,92,ITF,ITF4,16,Puglia,Puglia,4029053,3382534,83.95,0.23
1914,2021-07-27,PUG,48670,24219,24451,13358,34504,808,ITF,ITF4,16,Puglia,Puglia,4029053,3431204,85.16,1.21
1915,2021-05-31,PUG,37991,18322,19669,23170,14265,556,ITF,ITF4,16,Puglia,Puglia,4029053,3469195,86.1,0.94
1916,2021-04-06,PUG,13870,6265,7605,6926,6773,171,ITF,ITF4,16,Puglia,Puglia,4029053,3483065,86.45,0.34
1917,2021-07-15,PUG,44943,21754,23189,8904,35362,677,ITF,ITF4,16,Puglia,Puglia,4029053,3528008,87.56,1.12
1918,2021-07-14,PUG,46292,22204,24088,13375,32082,835,ITF,ITF4,16,Puglia,Puglia,4029053,3574300,88.71,1.15
1919,2021-08-02,PUG,39778,20164,19614,14219,24337,1222,ITF,ITF4,16,Puglia,Puglia,4029053,3614078,89.7,0.99
1920,2021-03-01,PUG,15139,5884,9255,13598,1386,155,ITF,ITF4,16,Puglia,Puglia,4029053,3629217,90.08,0.38
1921,2021-09-05,PUG,3193,1746,1447,958,2113,122,ITF,ITF4,16,Puglia,Puglia,4029053,3632410,90.16,0.08
1922,2021-03-25,PUG,11782,6041,5741,5258,6422,102,ITF,ITF4,16,Puglia,Puglia,4029053,3644192,90.45,0.29
1923,2021-08-29,PUG,1286,664,622,422,836,28,ITF,ITF4,16,Puglia,Puglia,4029053,3645478,90.48,0.03
1924,2021-07-03,PUG,33324,16695,16629,13469,19350,505,ITF,ITF4,16,Puglia,Puglia,4029053,3678802,91.31,0.83
1925,2021-02-08,PUG,4011,1622,2389,1583,2413,15,ITF,ITF4,16,Puglia,Puglia,4029053,3682813,91.41,0.1
1926,2021-02-10,PUG,3660,1444,2216,2127,1513,20,ITF,ITF4,16,Puglia,Puglia,4029053,3686473,91.5,0.09
1927,2021-05-23,PUG,17983,8410,9573,13881,3841,261,ITF,ITF4,16,Puglia,Puglia,4029053,3704456,91.94,0.45
1928,2021-02-17,PUG,4297,1755,2542,3617,640,40,ITF,ITF4,16,Puglia,Puglia,4029053,3708753,92.05,0.11
1929,2021-05-28,PUG,44155,20903,23252,27439,15914,802,ITF,ITF4,16,Puglia,Puglia,4029053,3752908,93.15,1.1
1930,2021-07-26,PUG,48017,23966,24051,17131,29963,923,ITF,ITF4,16,Puglia,Puglia,4029053,3800925,94.34,1.19
1931,2021-05-30,PUG,21065,10080,10985,15731,5077,257,ITF,ITF4,16,Puglia,Puglia,4029053,3821990,94.86,0.52
1932,2021-09-07,PUG,21682,11363,10319,6636,14303,743,ITF,ITF4,16,Puglia,Puglia,4029053,3843672,95.4,0.54
1933,2021-05-09,PUG,30851,12662,18189,14797,15680,374,ITF,ITF4,16,Puglia,Puglia,4029053,3874523,96.16,0.77
1934,2021-04-22,PUG,23074,10558,12516,17740,4948,386,ITF,ITF4,16,Puglia,Puglia,4029053,3897597,96.74,0.57
1935,2021-07-31,PUG,20026,10640,9386,7902,11644,480,ITF,ITF4,16,Puglia,Puglia,4029053,3917623,97.23,0.5
1936,2021-02-12,PUG,4216,1673,2543,3099,1094,23,ITF,ITF4,16,Puglia,Puglia,4029053,3921839,97.34,0.1
1937,2021-01-29,PUG,6218,2673,3545,220,5998,0,ITF,ITF4,16,Puglia,Puglia,4029053,3928057,97.49,0.15
1938,2021-03-20,PUG,8447,3894,4553,3769,4630,48,ITF,ITF4,16,Puglia,Puglia,4029053,3936504,97.7,0.21
1939,2021-03-03,PUG,16833,6829,10004,14738,1940,155,ITF,ITF4,16,Puglia,Puglia,4029053,3953337,98.12,0.42
1940,2021-05-11,PUG,32754,14476,18278,13704,18559,491,ITF,ITF4,16,Puglia,Puglia,4029053,3986091,98.93,0.81
1941,2021-05-04,PUG,35239,14907,20332,18249,16569,421,ITF,ITF4,16,Puglia,Puglia,4029053,4021330,99.81,0.87
1942,2021-03-08,PUG,15021,6448,8573,12444,2416,161,ITF,ITF4,16,Puglia,Puglia,4029053,4036351,100.18,0.37
1943,2021-03-11,PUG,14868,6604,8264,11466,3194,208,ITF,ITF4,16,Puglia,Puglia,4029053,4051219,100.55,0.37
1944,2021-06-02,PUG,27113,13255,13858,21913,4843,357,ITF,ITF4,16,Puglia,Puglia,4029053,4078332,101.22,0.67
1945,2021-03-13,PUG,10488,4140,6348,8574,1816,98,ITF,ITF4,16,Puglia,Puglia,4029053,4088820,101.48,0.26
1946,2021-02-24,PUG,10071,4718,5353,9376,597,98,ITF,ITF4,16,Puglia,Puglia,4029053,4098891,101.73,0.25
1947,2021-06-04,PUG,52902,25604,27298,34217,17856,829,ITF,ITF4,16,Puglia,Puglia,4029053,4151793,103.05,1.31
1948,2021-05-18,PUG,28994,13487,15507,15791,12913,290,ITF,ITF4,16,Puglia,Puglia,4029053,4180787,103.77,0.72
1949,2021-08-26,PUG,20210,10425,9785,8629,10704,877,ITF,ITF4,16,Puglia,Puglia,4029053,4200997,104.27,0.5
1950,2021-04-29,PUG,26327,12173,14154,19193,6706,428,ITF,ITF4,16,Puglia,Puglia,4029053,4227324,104.92,0.65
1951,2021-08-07,PUG,10104,5336,4768,3551,6255,298,ITF,ITF4,16,Puglia,Puglia,4029053,4237428,105.17,0.25
1952,2021-04-25,PUG,11328,5244,6084,10051,1143,134,ITF,ITF4,16,Puglia,Puglia,4029053,4248756,105.45,0.28
1953,2021-02-27,PUG,14248,4827,9421,12826,1237,185,ITF,ITF4,16,Puglia,Puglia,4029053,4263004,105.81,0.35
1954,2021-08-03,PUG,36463,18500,17963,9205,26494,764,ITF,ITF4,16,Puglia,Puglia,4029053,4299467,106.71,0.91
1955,2021-01-01,PUG,150,61,89,150,0,0,ITF,ITF4,16,Puglia,Puglia,4029053,4299617,106.72,0.0
1956,2021-06-07,PUG,44476,21712,22764,30383,13326,767,ITF,ITF4,16,Puglia,Puglia,4029053,4344093,107.82,1.1
1957,2021-04-11,PUG,16492,7270,9222,14658,1648,186,ITF,ITF4,16,Puglia,Puglia,4029053,4360585,108.23,0.41
1958,2021-09-02,PUG,23143,12036,11107,7430,14840,873,ITF,ITF4,16,Puglia,Puglia,4029053,4383728,108.8,0.57
1959,2021-01-10,PUG,2351,1062,1289,2351,0,0,ITF,ITF4,16,Puglia,Puglia,4029053,4386079,108.86,0.06
1960,2021-04-20,PUG,21235,9862,11373,17476,3490,269,ITF,ITF4,16,Puglia,Puglia,4029053,4407314,109.39,0.53
1961,2020-12-27,PUG,510,252,258,510,0,0,ITF,ITF4,16,Puglia,Puglia,4029053,4407824,109.4,0.01
1962,2021-01-18,PUG,1848,772,1076,1496,351,1,ITF,ITF4,16,Puglia,Puglia,4029053,4409672,109.45,0.05
1963,2021-02-06,PUG,4557,1936,2621,1579,2963,15,ITF,ITF4,16,Puglia,Puglia,4029053,4414229,109.56,0.11
1964,2021-01-20,PUG,1547,541,1006,1537,8,2,ITF,ITF4,16,Puglia,Puglia,4029053,4415776,109.6,0.04
1965,2021-04-30,PUG,35058,15710,19348,22480,12011,567,ITF,ITF4,16,Puglia,Puglia,4029053,4450834,110.47,0.87
1966,2021-04-13,PUG,28797,13658,15139,24942,3539,316,ITF,ITF4,16,Puglia,Puglia,4029053,4479631,111.18,0.71
1967,2021-07-22,PUG,47662,23635,24027,8489,38487,686,ITF,ITF4,16,Puglia,Puglia,4029053,4527293,112.37,1.18
1968,2021-07-05,PUG,38988,18296,20692,7237,31198,553,ITF,ITF4,16,Puglia,Puglia,4029053,4566281,113.33,0.97
1969,2021-05-02,PUG,21364,9680,11684,13905,7279,180,ITF,ITF4,16,Puglia,Puglia,4029053,4587645,113.86,0.53
1970,2021-08-10,PUG,27227,14155,13072,14015,12051,1161,ITF,ITF4,16,Puglia,Puglia,4029053,4614872,114.54,0.68
1971,2021-07-24,PUG,26770,13892,12878,8008,18288,474,ITF,ITF4,16,Puglia,Puglia,4029053,4641642,115.2,0.66
1972,2021-03-06,PUG,16190,6141,10049,13889,2128,173,ITF,ITF4,16,Puglia,Puglia,4029053,4657832,115.61,0.4
1973,2021-01-08,PUG,5697,2398,3299,5695,0,2,ITF,ITF4,16,Puglia,Puglia,4029053,4663529,115.75,0.14
1974,2021-06-14,PUG,42145,20616,21529,28864,12489,792,ITF,ITF4,16,Puglia,Puglia,4029053,4705674,116.79,1.05
1975,2021-04-18,PUG,22691,10858,11833,21434,1058,199,ITF,ITF4,16,Puglia,Puglia,4029053,4728365,117.36,0.56
1976,2021-02-20,PUG,2978,1080,1898,2688,257,33,ITF,ITF4,16,Puglia,Puglia,4029053,4731343,117.43,0.07
1977,2021-08-14,PUG,1086,560,526,497,570,19,ITF,ITF4,16,Puglia,Puglia,4029053,4732429,117.46,0.03
1978,2021-01-15,PUG,4558,1866,2692,4553,0,5,ITF,ITF4,16,Puglia,Puglia,4029053,4736987,117.57,0.11
1979,2021-02-22,PUG,9658,4539,5119,9232,336,90,ITF,ITF4,16,Puglia,Puglia,4029053,4746645,117.81,0.24
1980,2021-02-05,PUG,5652,2278,3374,1311,4336,5,ITF,ITF4,16,Puglia,Puglia,4029053,4752297,117.95,0.14
1981,2021-05-16,PUG,24657,11123,13534,12470,11961,226,ITF,ITF4,16,Puglia,Puglia,4029053,4776954,118.56,0.61
1982,2021-06-11,PUG,48063,23512,24551,33028,14124,911,ITF,ITF4,16,Puglia,Puglia,4029053,4825017,119.76,1.19
1983,2021-04-03,PUG,10587,4661,5926,6817,3577,193,ITF,ITF4,16,Puglia,Puglia,4029053,4835604,120.02,0.26
1984,2021-06-18,PUG,47911,23580,24331,28884,18099,928,ITF,ITF4,16,Puglia,Puglia,4029053,4883515,121.21,1.19
1985,2021-01-03,PUG,2010,944,1066,2009,0,1,ITF,ITF4,16,Puglia,Puglia,4029053,4885525,121.26,0.05
1986,2021-03-27,PUG,12186,5725,6461,6883,5191,112,ITF,ITF4,16,Puglia,Puglia,4029053,4897711,121.56,0.3
1987,2021-01-05,PUG,5118,2256,2862,5115,0,3,ITF,ITF4,16,Puglia,Puglia,4029053,4902829,121.69,0.13
1988,2021-04-15,PUG,32796,15307,17489,28612,3783,401,ITF,ITF4,16,Puglia,Puglia,4029053,4935625,122.5,0.81
1989,2021-07-07,PUG,38783,18568,20215,6085,32189,509,ITF,ITF4,16,Puglia,Puglia,4029053,4974408,123.46,0.96
1990,2021-01-22,PUG,1414,579,835,992,421,1,ITF,ITF4,16,Puglia,Puglia,4029053,4975822,123.5,0.04
1991,2021-08-21,PUG,4302,2304,1998,1967,2101,234,ITF,ITF4,16,Puglia,Puglia,4029053,4980124,123.61,0.11
1992,2021-06-25,PUG,50949,25089,25860,23849,26200,900,ITF,ITF4,16,Puglia,Puglia,4029053,5031073,124.87,1.26
1993,2021-05-12,PUG,36670,16352,20318,23535,12550,585,ITF,ITF4,16,Puglia,Puglia,4029053,5067743,125.78,0.91
1994,2021-08-20,PUG,17899,9302,8597,8185,8965,749,ITF,ITF4,16,Puglia,Puglia,4029053,5085642,126.22,0.44
1995,2021-01-23,PUG,3043,1294,1749,880,2161,2,ITF,ITF4,16,Puglia,Puglia,4029053,5088685,126.3,0.08
1996,2021-05-03,PUG,33435,14944,18491,22171,10697,567,ITF,ITF4,16,Puglia,Puglia,4029053,5122120,127.13,0.83
1997,2021-03-07,PUG,4996,2007,2989,4370,578,48,ITF,ITF4,16,Puglia,Puglia,4029053,5127116,127.25,0.12
1998,2021-05-05,PUG,39369,17283,22086,24506,14268,595,ITF,ITF4,16,Puglia,Puglia,4029053,5166485,128.23,0.98
1999,2021-08-13,PUG,13779,7324,6455,7284,5905,590,ITF,ITF4,16,Puglia,Puglia,4029053,5180264,128.57,0.34
2000,2021-06-17,PUG,42967,20995,21972,21402,21003,562,ITF,ITF4,16,Puglia,Puglia,4029053,5223231,129.64,1.07
2001,2021-03-30,PUG,12456,5972,6484,6198,6102,156,ITF,ITF4,16,Puglia,Puglia,4029053,5235687,129.95,0.31
2002,2021-02-01,PUG,3979,1667,2312,353,3625,1,ITF,ITF4,16,Puglia,Puglia,4029053,5239666,130.05,0.1
2003,2021-07-17,PUG,30861,15495,15366,9535,20697,629,ITF,ITF4,16,Puglia,Puglia,4029053,5270527,130.81,0.77
2004,2021-05-14,PUG,45113,20617,24496,28012,16240,861,ITF,ITF4,16,Puglia,Puglia,4029053,5315640,131.93,1.12
2005,2021-08-22,PUG,1479,770,709,530,924,25,ITF,ITF4,16,Puglia,Puglia,4029053,5317119,131.97,0.04
2006,2021-01-25,PUG,3838,1685,2153,425,3412,1,ITF,ITF4,16,Puglia,Puglia,4029053,5320957,132.06,0.1
2007,2021-07-10,PUG,22418,11043,11375,4464,17658,296,ITF,ITF4,16,Puglia,Puglia,4029053,5343375,132.62,0.56
2008,2021-04-08,PUG,17533,7615,9918,11120,6199,214,ITF,ITF4,16,Puglia,Puglia,4029053,5360908,133.06,0.44
2009,2021-06-06,PUG,30776,15500,15276,25383,5072,321,ITF,ITF4,16,Puglia,Puglia,4029053,5391684,133.82,0.76
2010,2021-04-10,PUG,30961,13131,17830,26109,4465,387,ITF,ITF4,16,Puglia,Puglia,4029053,5422645,134.59,0.77
2011,2021-07-19,PUG,49569,24357,25212,10950,37856,763,ITF,ITF4,16,Puglia,Puglia,4029053,5472214,135.82,1.23
2012,2021-04-01,PUG,13987,6576,7411,7383,6383,221,ITF,ITF4,16,Puglia,Puglia,4029053,5486201,136.17,0.35
2013,2021-02-03,PUG,5056,2008,3048,705,4350,1,ITF,ITF4,16,Puglia,Puglia,4029053,5491257,136.29,0.13
2014,2021-07-12,PUG,45829,21640,24189,12738,32335,756,ITF,ITF4,16,Puglia,Puglia,4029053,5537086,137.43,1.14
2015,2021-08-08,LAZ,50314,26050,24264,18018,31462,834,ITI,ITI4,12,Lazio,Lazio,5879082,50314,0.86,0.86
2016,2021-06-26,LAZ,56240,26511,29729,24709,30935,596,ITI,ITI4,12,Lazio,Lazio,5879082,106554,1.81,0.96
2017,2021-04-30,LAZ,41736,18493,23243,26624,14391,721,ITI,ITI4,12,Lazio,Lazio,5879082,148290,2.52,0.71
2018,2021-08-22,LAZ,8764,5296,3468,2526,6148,90,ITI,ITI4,12,Lazio,Lazio,5879082,157054,2.67,0.15
2019,2021-03-30,LAZ,27150,13207,13943,19561,7224,365,ITI,ITI4,12,Lazio,Lazio,5879082,184204,3.13,0.46
2020,2021-07-08,LAZ,64363,31595,32768,28172,35508,683,ITI,ITI4,12,Lazio,Lazio,5879082,248567,4.23,1.09
2021,2021-07-27,LAZ,56432,27407,29025,8109,47992,331,ITI,ITI4,12,Lazio,Lazio,5879082,304999,5.19,0.96
2022,2021-04-18,LAZ,23870,10609,13261,15854,7700,316,ITI,ITI4,12,Lazio,Lazio,5879082,328869,5.59,0.41
2023,2021-04-16,LAZ,34574,15766,18808,21919,12221,434,ITI,ITI4,12,Lazio,Lazio,5879082,363443,6.18,0.59
2024,2021-01-23,LAZ,7218,2870,4348,588,6630,0,ITI,ITI4,12,Lazio,Lazio,5879082,370661,6.3,0.12
2025,2021-01-06,LAZ,5202,1991,3211,5082,0,120,ITI,ITI4,12,Lazio,Lazio,5879082,375863,6.39,0.09
2026,2021-02-18,LAZ,10093,5021,5072,9108,877,108,ITI,ITI4,12,Lazio,Lazio,5879082,385956,6.56,0.17
2027,2021-05-12,LAZ,47625,21622,26003,30241,16693,691,ITI,ITI4,12,Lazio,Lazio,5879082,433581,7.37,0.81
2028,2021-02-01,LAZ,5687,2186,3501,354,5332,1,ITI,ITI4,12,Lazio,Lazio,5879082,439268,7.47,0.1
2029,2021-03-16,LAZ,13643,5782,7861,7052,6507,84,ITI,ITI4,12,Lazio,Lazio,5879082,452911,7.7,0.23
2030,2021-03-09,LAZ,22051,9965,12086,16459,5228,364,ITI,ITI4,12,Lazio,Lazio,5879082,474962,8.08,0.38
2031,2021-01-11,LAZ,5704,2174,3530,5558,0,146,ITI,ITI4,12,Lazio,Lazio,5879082,480666,8.18,0.1
2032,2021-05-26,LAZ,47684,21931,25753,34883,12153,648,ITI,ITI4,12,Lazio,Lazio,5879082,528350,8.99,0.81
2033,2021-03-04,LAZ,19471,8750,10721,14182,5034,255,ITI,ITI4,12,Lazio,Lazio,5879082,547821,9.32,0.33
2034,2021-06-12,LAZ,69955,32126,37829,39884,29420,651,ITI,ITI4,12,Lazio,Lazio,5879082,617776,10.51,1.19
2035,2021-06-14,LAZ,63109,29571,33538,32322,30216,571,ITI,ITI4,12,Lazio,Lazio,5879082,680885,11.58,1.07
2036,2021-03-21,LAZ,18294,7204,11090,13027,5071,196,ITI,ITI4,12,Lazio,Lazio,5879082,699179,11.89,0.31
2037,2021-07-22,LAZ,61178,30571,30607,28488,31158,1532,ITI,ITI4,12,Lazio,Lazio,5879082,760357,12.93,1.04
2038,2021-09-03,LAZ,25922,13525,12397,7324,18121,477,ITI,ITI4,12,Lazio,Lazio,5879082,786279,13.37,0.44
2039,2021-05-17,LAZ,44651,20448,24203,35415,8622,614,ITI,ITI4,12,Lazio,Lazio,5879082,830930,14.13,0.76
2040,2021-02-06,LAZ,6241,2547,3694,904,5333,4,ITI,ITI4,12,Lazio,Lazio,5879082,837171,14.24,0.11
2041,2021-02-20,LAZ,9224,4278,4946,8366,784,74,ITI,ITI4,12,Lazio,Lazio,5879082,846395,14.4,0.16
2042,2021-05-31,LAZ,51816,23075,28741,30881,19913,1022,ITI,ITI4,12,Lazio,Lazio,5879082,898211,15.28,0.88
2043,2021-04-04,LAZ,17670,8202,9468,12262,5292,116,ITI,ITI4,12,Lazio,Lazio,5879082,915881,15.58,0.3
2044,2021-06-19,LAZ,66584,31413,35171,35283,30481,820,ITI,ITI4,12,Lazio,Lazio,5879082,982465,16.71,1.13
2045,2021-05-07,LAZ,48340,22662,25678,29788,17829,723,ITI,ITI4,12,Lazio,Lazio,5879082,1030805,17.53,0.82
2046,2021-03-11,LAZ,25521,12040,13481,18867,6288,366,ITI,ITI4,12,Lazio,Lazio,5879082,1056326,17.97,0.43
2047,2021-08-15,LAZ,1501,924,577,781,697,23,ITI,ITI4,12,Lazio,Lazio,5879082,1057827,17.99,0.03
2048,2021-07-03,LAZ,53253,25077,28176,4646,48460,147,ITI,ITI4,12,Lazio,Lazio,5879082,1111080,18.9,0.91
2049,2021-08-10,LAZ,51004,26380,24624,21573,28445,986,ITI,ITI4,12,Lazio,Lazio,5879082,1162084,19.77,0.87
2050,2021-05-19,LAZ,47332,21746,25586,36490,10162,680,ITI,ITI4,12,Lazio,Lazio,5879082,1209416,20.57,0.81
2051,2021-08-27,LAZ,30618,16067,14551,7648,22400,570,ITI,ITI4,12,Lazio,Lazio,5879082,1240034,21.09,0.52
2052,2021-01-04,LAZ,7586,2944,4642,7480,0,106,ITI,ITI4,12,Lazio,Lazio,5879082,1247620,21.22,0.13
2053,2021-06-24,LAZ,64076,30562,33514,28619,34797,660,ITI,ITI4,12,Lazio,Lazio,5879082,1311696,22.31,1.09
2054,2021-06-07,LAZ,62676,29340,33336,32715,29359,602,ITI,ITI4,12,Lazio,Lazio,5879082,1374372,23.38,1.07
2055,2021-02-25,LAZ,12819,5611,7208,11401,1215,203,ITI,ITI4,12,Lazio,Lazio,5879082,1387191,23.6,0.22
2056,2021-06-05,LAZ,66402,32714,33688,42942,22785,675,ITI,ITI4,12,Lazio,Lazio,5879082,1453593,24.72,1.13
2057,2021-07-15,LAZ,45042,22058,22984,6710,37898,434,ITI,ITI4,12,Lazio,Lazio,5879082,1498635,25.49,0.77
2058,2021-01-13,LAZ,5867,2245,3622,5705,0,162,ITI,ITI4,12,Lazio,Lazio,5879082,1504502,25.59,0.1
2059,2021-04-23,LAZ,37990,18295,19695,22043,15409,538,ITI,ITI4,12,Lazio,Lazio,5879082,1542492,26.24,0.65
2060,2021-08-03,LAZ,32328,16457,15871,5095,27032,201,ITI,ITI4,12,Lazio,Lazio,5879082,1574820,26.79,0.55
2061,2021-01-30,LAZ,7025,2898,4127,819,6205,1,ITI,ITI4,12,Lazio,Lazio,5879082,1581845,26.91,0.12
2062,2020-12-30,LAZ,1658,640,1018,1647,0,11,ITI,ITI4,12,Lazio,Lazio,5879082,1583503,26.93,0.03
2063,2021-07-01,LAZ,48573,23237,25336,7191,41161,221,ITI,ITI4,12,Lazio,Lazio,5879082,1632076,27.76,0.83
2064,2021-04-09,LAZ,27736,12630,15106,19124,8280,332,ITI,ITI4,12,Lazio,Lazio,5879082,1659812,28.23,0.47
2065,2021-03-23,LAZ,25488,11970,13518,18486,6645,357,ITI,ITI4,12,Lazio,Lazio,5879082,1685300,28.67,0.43
2066,2021-02-11,LAZ,7076,3067,4009,6447,604,25,ITI,ITI4,12,Lazio,Lazio,5879082,1692376,28.79,0.12
2067,2021-04-11,LAZ,19242,8534,10708,13120,5931,191,ITI,ITI4,12,Lazio,Lazio,5879082,1711618,29.11,0.33
2068,2021-02-13,LAZ,6615,2628,3987,6146,422,47,ITI,ITI4,12,Lazio,Lazio,5879082,1718233,29.23,0.11
2069,2021-07-20,LAZ,63450,31657,31793,28463,33744,1243,ITI,ITI4,12,Lazio,Lazio,5879082,1781683,30.31,1.08
2070,2021-05-24,LAZ,44047,20208,23839,33565,9829,653,ITI,ITI4,12,Lazio,Lazio,5879082,1825730,31.05,0.75
2071,2021-03-28,LAZ,19201,7838,11363,13543,5318,340,ITI,ITI4,12,Lazio,Lazio,5879082,1844931,31.38,0.33
2072,2021-01-25,LAZ,8173,3286,4887,828,7345,0,ITI,ITI4,12,Lazio,Lazio,5879082,1853104,31.52,0.14
2073,2021-05-05,LAZ,46865,21504,25361,30357,15878,630,ITI,ITI4,12,Lazio,Lazio,5879082,1899969,32.32,0.8
2074,2021-03-02,LAZ,17251,7638,9613,13111,3955,185,ITI,ITI4,12,Lazio,Lazio,5879082,1917220,32.61,0.29
2075,2021-01-18,LAZ,6389,2605,3784,5282,981,126,ITI,ITI4,12,Lazio,Lazio,5879082,1923609,32.72,0.11
2076,2021-04-28,LAZ,33041,15076,17965,20915,11668,458,ITI,ITI4,12,Lazio,Lazio,5879082,1956650,33.28,0.56
2077,2021-02-03,LAZ,6500,2495,4005,963,5530,7,ITI,ITI4,12,Lazio,Lazio,5879082,1963150,33.39,0.11
2078,2021-01-20,LAZ,4835,1959,2876,3285,1545,5,ITI,ITI4,12,Lazio,Lazio,5879082,1967985,33.47,0.08
2079,2021-05-14,LAZ,51652,23603,28049,32423,18412,817,ITI,ITI4,12,Lazio,Lazio,5879082,2019637,34.35,0.88
2080,2021-03-18,LAZ,14312,6114,8198,7779,6442,91,ITI,ITI4,12,Lazio,Lazio,5879082,2033949,34.6,0.24
2081,2021-06-21,LAZ,62041,28827,33214,28500,32925,616,ITI,ITI4,12,Lazio,Lazio,5879082,2095990,35.65,1.06
2082,2021-03-13,LAZ,21853,8758,13095,15699,5916,238,ITI,ITI4,12,Lazio,Lazio,5879082,2117843,36.02,0.37
2083,2021-02-08,LAZ,9758,4167,5591,4511,5245,2,ITI,ITI4,12,Lazio,Lazio,5879082,2127601,36.19,0.17
2084,2021-05-02,LAZ,32943,14465,18478,22941,9472,530,ITI,ITI4,12,Lazio,Lazio,5879082,2160544,36.75,0.56
2085,2021-01-22,LAZ,4036,1653,2383,520,3516,0,ITI,ITI4,12,Lazio,Lazio,5879082,2164580,36.82,0.07
2086,2021-02-27,LAZ,11543,4337,7206,10346,1052,145,ITI,ITI4,12,Lazio,Lazio,5879082,2176123,37.01,0.2
2087,2021-08-29,LAZ,27423,13954,13469,9015,17819,589,ITI,ITI4,12,Lazio,Lazio,5879082,2203546,37.48,0.47
2088,2021-04-01,LAZ,29803,14141,15662,22224,7179,400,ITI,ITI4,12,Lazio,Lazio,5879082,2233349,37.99,0.51
2089,2021-07-10,LAZ,71136,35705,35431,25051,45419,666,ITI,ITI4,12,Lazio,Lazio,5879082,2304485,39.2,1.21
2090,2021-07-24,LAZ,30771,15523,15248,3226,27388,157,ITI,ITI4,12,Lazio,Lazio,5879082,2335256,39.72,0.52
2091,2021-06-23,LAZ,62364,29383,32981,28436,33426,502,ITI,ITI4,12,Lazio,Lazio,5879082,2397620,40.78,1.06
2092,2021-04-15,LAZ,32055,14357,17698,20660,10888,507,ITI,ITI4,12,Lazio,Lazio,5879082,2429675,41.33,0.55
2093,2021-08-26,LAZ,32168,16685,15483,8265,23346,557,ITI,ITI4,12,Lazio,Lazio,5879082,2461843,41.87,0.55
2094,2021-02-10,LAZ,8259,3457,4802,4852,3402,5,ITI,ITI4,12,Lazio,Lazio,5879082,2470102,42.02,0.14
2095,2021-05-21,LAZ,52137,25082,27055,37317,14117,703,ITI,ITI4,12,Lazio,Lazio,5879082,2522239,42.9,0.89
2096,2021-06-04,LAZ,62089,30274,31815,43565,17867,657,ITI,ITI4,12,Lazio,Lazio,5879082,2584328,43.96,1.06
2097,2021-05-04,LAZ,40313,18543,21770,26073,13717,523,ITI,ITI4,12,Lazio,Lazio,5879082,2624641,44.64,0.69
2098,2021-08-12,LAZ,47978,24852,23126,20816,26187,975,ITI,ITI4,12,Lazio,Lazio,5879082,2672619,45.46,0.82
2099,2021-07-19,LAZ,63187,31070,32117,28311,33736,1140,ITI,ITI4,12,Lazio,Lazio,5879082,2735806,46.53,1.07
2100,2021-01-15,LAZ,6725,2772,3953,6554,0,171,ITI,ITI4,12,Lazio,Lazio,5879082,2742531,46.65,0.11
2101,2021-04-25,LAZ,24581,11280,13301,16374,7875,332,ITI,ITI4,12,Lazio,Lazio,5879082,2767112,47.07,0.42
2102,2021-04-06,LAZ,24669,11296,13373,17152,7188,329,ITI,ITI4,12,Lazio,Lazio,5879082,2791781,47.49,0.42
2103,2021-03-25,LAZ,29548,13731,15817,22387,6683,478,ITI,ITI4,12,Lazio,Lazio,5879082,2821329,47.99,0.5
2104,2021-01-27,LAZ,6190,2417,3773,1063,5127,0,ITI,ITI4,12,Lazio,Lazio,5879082,2827519,48.09,0.11
2105,2021-06-09,LAZ,70549,33415,37134,35993,33911,645,ITI,ITI4,12,Lazio,Lazio,5879082,2898068,49.29,1.2
2106,2021-04-27,LAZ,30848,13931,16917,19421,10973,454,ITI,ITI4,12,Lazio,Lazio,5879082,2928916,49.82,0.52
2107,2021-03-01,LAZ,17139,7373,9766,12984,3895,260,ITI,ITI4,12,Lazio,Lazio,5879082,2946055,50.11,0.29
2108,2021-08-05,LAZ,33584,17433,16151,21985,10568,1031,ITI,ITI4,12,Lazio,Lazio,5879082,2979639,50.68,0.57
2109,2021-02-15,LAZ,8047,3550,4497,7309,648,90,ITI,ITI4,12,Lazio,Lazio,5879082,2987686,50.82,0.14
2110,2021-01-29,LAZ,8416,3205,5211,930,7484,2,ITI,ITI4,12,Lazio,Lazio,5879082,2996102,50.96,0.14
2111,2021-09-05,LAZ,10085,5159,4926,6600,3045,440,ITI,ITI4,12,Lazio,Lazio,5879082,3006187,51.13,0.17
2112,2021-02-17,LAZ,9231,4624,4607,8262,897,72,ITI,ITI4,12,Lazio,Lazio,5879082,3015418,51.29,0.16
2113,2021-05-28,LAZ,57277,26643,30634,43151,13343,783,ITI,ITI4,12,Lazio,Lazio,5879082,3072695,52.26,0.97
2114,2021-08-19,LAZ,9204,5277,3927,2929,6170,105,ITI,ITI4,12,Lazio,Lazio,5879082,3081899,52.42,0.16
2115,2021-09-07,LAZ,12789,6501,6288,6758,5584,447,ITI,ITI4,12,Lazio,Lazio,5879082,3094688,52.64,0.22
2116,2021-03-06,LAZ,18403,7098,11305,13897,4277,229,ITI,ITI4,12,Lazio,Lazio,5879082,3113091,52.95,0.31
2117,2021-05-20,LAZ,51954,25074,26880,37233,13989,732,ITI,ITI4,12,Lazio,Lazio,5879082,3165045,53.84,0.88
2118,2021-08-28,LAZ,32581,17011,15570,11025,20811,745,ITI,ITI4,12,Lazio,Lazio,5879082,3197626,54.39,0.55
2119,2021-06-20,LAZ,55335,25451,29884,29605,24963,767,ITI,ITI4,12,Lazio,Lazio,5879082,3252961,55.33,0.94
2120,2021-06-06,LAZ,58288,28102,30186,35144,22542,602,ITI,ITI4,12,Lazio,Lazio,5879082,3311249,56.32,0.99
2121,2021-02-26,LAZ,13195,5760,7435,11545,1465,185,ITI,ITI4,12,Lazio,Lazio,5879082,3324444,56.55,0.22
2122,2021-07-09,LAZ,65085,31407,33678,27617,36708,760,ITI,ITI4,12,Lazio,Lazio,5879082,3389529,57.65,1.11
2123,2021-02-22,LAZ,11518,5028,6490,10810,554,154,ITI,ITI4,12,Lazio,Lazio,5879082,3401047,57.85,0.2
2124,2021-06-02,LAZ,43534,21605,21929,31440,11535,559,ITI,ITI4,12,Lazio,Lazio,5879082,3444581,58.59,0.74
2125,2021-06-11,LAZ,69837,32858,36979,36685,32492,660,ITI,ITI4,12,Lazio,Lazio,5879082,3514418,59.78,1.19
2126,2021-08-07,LAZ,34991,18945,16046,21967,11897,1127,ITI,ITI4,12,Lazio,Lazio,5879082,3549409,60.37,0.6
2127,2021-05-06,LAZ,48897,22787,26110,30545,17618,734,ITI,ITI4,12,Lazio,Lazio,5879082,3598306,61.21,0.83
2128,2021-06-01,LAZ,49177,23733,25444,30090,18601,486,ITI,ITI4,12,Lazio,Lazio,5879082,3647483,62.04,0.84
2129,2021-04-05,LAZ,19987,9153,10834,13617,6215,155,ITI,ITI4,12,Lazio,Lazio,5879082,3667470,62.38,0.34
2130,2021-07-28,LAZ,57779,29247,28532,8114,49311,354,ITI,ITI4,12,Lazio,Lazio,5879082,3725249,63.36,0.98
2131,2021-05-25,LAZ,47647,22369,25278,35318,11734,595,ITI,ITI4,12,Lazio,Lazio,5879082,3772896,64.17,0.81
2132,2021-09-02,LAZ,26189,13451,12738,7976,17772,441,ITI,ITI4,12,Lazio,Lazio,5879082,3799085,64.62,0.45
2133,2021-04-12,LAZ,23951,10801,13150,16654,6967,330,ITI,ITI4,12,Lazio,Lazio,5879082,3823036,65.03,0.41
2134,2021-07-21,LAZ,62852,31737,31115,28648,32829,1375,ITI,ITI4,12,Lazio,Lazio,5879082,3885888,66.1,1.07
2135,2021-03-27,LAZ,26568,10812,15756,19498,6520,550,ITI,ITI4,12,Lazio,Lazio,5879082,3912456,66.55,0.45
2136,2021-08-31,LAZ,31007,15350,15657,11661,18406,940,ITI,ITI4,12,Lazio,Lazio,5879082,3943463,67.08,0.53
2137,2021-07-05,LAZ,61736,29717,32019,25599,35064,1073,ITI,ITI4,12,Lazio,Lazio,5879082,4005199,68.13,1.05
2138,2021-05-23,LAZ,47186,22894,24292,39132,7408,646,ITI,ITI4,12,Lazio,Lazio,5879082,4052385,68.93,0.8
2139,2021-05-09,LAZ,37574,17272,20302,25783,11291,500,ITI,ITI4,12,Lazio,Lazio,5879082,4089959,69.57,0.64
2140,2021-08-17,LAZ,7991,4578,3413,3764,4134,93,ITI,ITI4,12,Lazio,Lazio,5879082,4097950,69.7,0.14
2141,2021-02-24,LAZ,12109,5237,6872,10936,1044,129,ITI,ITI4,12,Lazio,Lazio,5879082,4110059,69.91,0.21
2142,2021-07-07,LAZ,62708,31054,31654,28385,33720,603,ITI,ITI4,12,Lazio,Lazio,5879082,4172767,70.98,1.07
2143,2021-03-29,LAZ,25602,12161,13441,18203,7085,314,ITI,ITI4,12,Lazio,Lazio,5879082,4198369,71.41,0.44
2144,2021-03-15,LAZ,21039,9877,11162,14002,6772,265,ITI,ITI4,12,Lazio,Lazio,5879082,4219408,71.77,0.36
2145,2021-01-05,LAZ,7456,2832,4624,7353,0,103,ITI,ITI4,12,Lazio,Lazio,5879082,4226864,71.9,0.13
2146,2021-01-24,LAZ,5705,2232,3473,620,5085,0,ITI,ITI4,12,Lazio,Lazio,5879082,4232569,71.99,0.1
2147,2021-02-07,LAZ,4971,2049,2922,410,4560,1,ITI,ITI4,12,Lazio,Lazio,5879082,4237540,72.08,0.08
2148,2021-05-18,LAZ,45126,20647,24479,34899,9613,614,ITI,ITI4,12,Lazio,Lazio,5879082,4282666,72.85,0.77
2149,2021-08-14,LAZ,2536,1435,1101,992,1512,32,ITI,ITI4,12,Lazio,Lazio,5879082,4285202,72.89,0.04
2150,2021-08-16,LAZ,3699,2037,1662,2061,1577,61,ITI,ITI4,12,Lazio,Lazio,5879082,4288901,72.95,0.06
2151,2021-01-17,LAZ,4958,2051,2907,4680,213,65,ITI,ITI4,12,Lazio,Lazio,5879082,4293859,73.04,0.08
2152,2021-01-19,LAZ,4791,1969,2822,4334,454,3,ITI,ITI4,12,Lazio,Lazio,5879082,4298650,73.12,0.08
2153,2021-01-31,LAZ,4466,1858,2608,481,3985,0,ITI,ITI4,12,Lazio,Lazio,5879082,4303116,73.19,0.08
2154,2021-05-11,LAZ,48401,22231,26170,31127,16596,678,ITI,ITI4,12,Lazio,Lazio,5879082,4351517,74.02,0.82
2155,2021-07-16,LAZ,44041,21017,23024,2924,40936,181,ITI,ITI4,12,Lazio,Lazio,5879082,4395558,74.77,0.75
2156,2021-04-24,LAZ,33587,15157,18430,20138,12904,545,ITI,ITI4,12,Lazio,Lazio,5879082,4429145,75.34,0.57
2157,2021-08-02,LAZ,37443,19569,17874,6515,30695,233,ITI,ITI4,12,Lazio,Lazio,5879082,4466588,75.97,0.64
2158,2021-08-21,LAZ,10184,5856,4328,3209,6872,103,ITI,ITI4,12,Lazio,Lazio,5879082,4476772,76.15,0.17
2159,2021-05-30,LAZ,41285,17662,23623,33241,7379,665,ITI,ITI4,12,Lazio,Lazio,5879082,4518057,76.85,0.7
2160,2021-06-08,LAZ,66836,31906,34930,36156,30021,659,ITI,ITI4,12,Lazio,Lazio,5879082,4584893,77.99,1.14
2161,2021-07-14,LAZ,42214,20579,21635,6210,35639,365,ITI,ITI4,12,Lazio,Lazio,5879082,4627107,78.7,0.72
2162,2021-01-09,LAZ,6426,2617,3809,6313,0,113,ITI,ITI4,12,Lazio,Lazio,5879082,4633533,78.81,0.11
2163,2021-04-19,LAZ,30171,13720,16451,18960,10732,479,ITI,ITI4,12,Lazio,Lazio,5879082,4663704,79.33,0.51
2164,2021-02-21,LAZ,7000,3184,3816,6485,467,48,ITI,ITI4,12,Lazio,Lazio,5879082,4670704,79.45,0.12
2165,2020-12-27,LAZ,276,132,144,276,0,0,ITI,ITI4,12,Lazio,Lazio,5879082,4670980,79.45,0.0
2166,2021-03-20,LAZ,19280,7676,11604,13089,5923,268,ITI,ITI4,12,Lazio,Lazio,5879082,4690260,79.78,0.33
2167,2021-07-17,LAZ,43942,22165,21777,2186,41650,106,ITI,ITI4,12,Lazio,Lazio,5879082,4734202,80.53,0.75
2168,2021-06-30,LAZ,63042,29671,33371,29756,32735,551,ITI,ITI4,12,Lazio,Lazio,5879082,4797244,81.6,1.07
2169,2021-04-08,LAZ,26899,12330,14569,18762,7724,413,ITI,ITI4,12,Lazio,Lazio,5879082,4824143,82.06,0.46
2170,2021-07-12,LAZ,41453,20730,20723,5867,35353,233,ITI,ITI4,12,Lazio,Lazio,5879082,4865596,82.76,0.71
2171,2021-05-16,LAZ,51026,24575,26451,36910,13516,600,ITI,ITI4,12,Lazio,Lazio,5879082,4916622,83.63,0.87
2172,2021-08-24,LAZ,18720,9998,8722,11664,6344,712,ITI,ITI4,12,Lazio,Lazio,5879082,4935342,83.95,0.32
2173,2021-06-28,LAZ,58977,28202,30775,27488,31035,454,ITI,ITI4,12,Lazio,Lazio,5879082,4994319,84.95,1.0
2174,2021-08-11,LAZ,48927,25634,23293,20407,27642,878,ITI,ITI4,12,Lazio,Lazio,5879082,5043246,85.78,0.83
2175,2021-05-03,LAZ,39649,17904,21745,26182,12786,681,ITI,ITI4,12,Lazio,Lazio,5879082,5082895,86.46,0.67
2176,2021-07-25,LAZ,24663,12143,12520,2100,22513,50,ITI,ITI4,12,Lazio,Lazio,5879082,5107558,86.88,0.42
2177,2021-04-29,LAZ,38868,17357,21511,24812,13374,682,ITI,ITI4,12,Lazio,Lazio,5879082,5146426,87.54,0.66
2178,2021-03-03,LAZ,17916,7900,10016,13343,4315,258,ITI,ITI4,12,Lazio,Lazio,5879082,5164342,87.84,0.3
2179,2021-08-09,LAZ,52654,26744,25910,21910,29672,1072,ITI,ITI4,12,Lazio,Lazio,5879082,5216996,88.74,0.9
2180,2021-01-26,LAZ,7988,3134,4854,743,7245,0,ITI,ITI4,12,Lazio,Lazio,5879082,5224984,88.87,0.14
2181,2021-04-02,LAZ,29566,14181,15385,21761,7399,406,ITI,ITI4,12,Lazio,Lazio,5879082,5254550,89.38,0.5
2182,2021-07-11,LAZ,44163,22272,21891,3765,40244,154,ITI,ITI4,12,Lazio,Lazio,5879082,5298713,90.13,0.75
2183,2021-01-28,LAZ,8340,3188,5152,837,7502,1,ITI,ITI4,12,Lazio,Lazio,5879082,5307053,90.27,0.14
2184,2021-07-04,LAZ,46618,21705,24913,4125,42404,89,ITI,ITI4,12,Lazio,Lazio,5879082,5353671,91.06,0.79
2185,2021-05-08,LAZ,45517,20782,24735,29323,15459,735,ITI,ITI4,12,Lazio,Lazio,5879082,5399188,91.84,0.77
2186,2021-09-08,LAZ,12114,6243,5871,6766,4778,570,ITI,ITI4,12,Lazio,Lazio,5879082,5411302,92.04,0.21
2187,2021-07-13,LAZ,42758,20964,21794,5510,36905,343,ITI,ITI4,12,Lazio,Lazio,5879082,5454060,92.77,0.73
2188,2021-03-26,LAZ,30386,14081,16305,23016,6909,461,ITI,ITI4,12,Lazio,Lazio,5879082,5484446,93.29,0.52
2189,2021-07-06,LAZ,62621,30387,32234,28560,33562,499,ITI,ITI4,12,Lazio,Lazio,5879082,5547067,94.35,1.07
2190,2021-05-01,LAZ,38273,17211,21062,25708,12079,486,ITI,ITI4,12,Lazio,Lazio,5879082,5585340,95.0,0.65
2191,2021-04-17,LAZ,32494,14254,18240,19958,12071,465,ITI,ITI4,12,Lazio,Lazio,5879082,5617834,95.56,0.55
2192,2021-07-26,LAZ,50896,25072,25824,6667,43910,319,ITI,ITI4,12,Lazio,Lazio,5879082,5668730,96.42,0.87
2193,2021-03-12,LAZ,24155,11170,12985,17390,6402,363,ITI,ITI4,12,Lazio,Lazio,5879082,5692885,96.83,0.41
2194,2021-08-13,LAZ,43594,22671,20923,20107,22406,1081,ITI,ITI4,12,Lazio,Lazio,5879082,5736479,97.57,0.74
2195,2021-02-09,LAZ,8857,3808,5049,4581,4269,7,ITI,ITI4,12,Lazio,Lazio,5879082,5745336,97.73,0.15
2196,2021-02-23,LAZ,11119,4797,6322,10211,778,130,ITI,ITI4,12,Lazio,Lazio,5879082,5756455,97.91,0.19
2197,2021-02-14,LAZ,5808,2382,3426,5302,475,31,ITI,ITI4,12,Lazio,Lazio,5879082,5762263,98.01,0.1
2198,2021-02-28,LAZ,10289,4041,6248,9646,542,101,ITI,ITI4,12,Lazio,Lazio,5879082,5772552,98.19,0.18
2199,2021-01-02,LAZ,6843,2682,4161,6763,0,80,ITI,ITI4,12,Lazio,Lazio,5879082,5779395,98.3,0.12
2200,2021-05-13,LAZ,50294,22613,27681,31660,17884,750,ITI,ITI4,12,Lazio,Lazio,5879082,5829689,99.16,0.86
2201,2021-08-04,LAZ,47875,24127,23748,20675,26525,675,ITI,ITI4,12,Lazio,Lazio,5879082,5877564,99.97,0.81
2202,2021-06-29,LAZ,59526,28284,31242,27742,31188,596,ITI,ITI4,12,Lazio,Lazio,5879082,5937090,100.99,1.01
2203,2021-01-14,LAZ,5669,2236,3433,5495,0,174,ITI,ITI4,12,Lazio,Lazio,5879082,5942759,101.08,0.1
2204,2021-04-07,LAZ,26046,12192,13854,18347,7327,372,ITI,ITI4,12,Lazio,Lazio,5879082,5968805,101.53,0.44
2205,2020-12-28,LAZ,961,414,547,956,0,5,ITI,ITI4,12,Lazio,Lazio,5879082,5969766,101.54,0.02
2206,2021-01-16,LAZ,5780,2337,3443,5632,0,148,ITI,ITI4,12,Lazio,Lazio,5879082,5975546,101.64,0.1
2207,2021-04-26,LAZ,29358,13511,15847,19549,9301,508,ITI,ITI4,12,Lazio,Lazio,5879082,6004904,102.14,0.5
2208,2021-02-02,LAZ,5921,2220,3701,641,5277,3,ITI,ITI4,12,Lazio,Lazio,5879082,6010825,102.24,0.1
2209,2021-02-12,LAZ,6900,2882,4018,6380,438,82,ITI,ITI4,12,Lazio,Lazio,5879082,6017725,102.36,0.12
2210,2021-06-22,LAZ,62861,29082,33779,28596,33543,722,ITI,ITI4,12,Lazio,Lazio,5879082,6080586,103.43,1.07
2211,2021-03-14,LAZ,17304,6781,10523,11854,5182,268,ITI,ITI4,12,Lazio,Lazio,5879082,6097890,103.72,0.29
2212,2021-07-02,LAZ,48568,23275,25293,6617,41760,191,ITI,ITI4,12,Lazio,Lazio,5879082,6146458,104.55,0.83
2213,2021-03-22,LAZ,23436,10573,12863,16362,6738,336,ITI,ITI4,12,Lazio,Lazio,5879082,6169894,104.95,0.4
2214,2020-12-29,LAZ,498,182,316,494,0,4,ITI,ITI4,12,Lazio,Lazio,5879082,6170392,104.96,0.01
2215,2021-09-04,LAZ,14267,7260,7007,9673,3867,727,ITI,ITI4,12,Lazio,Lazio,5879082,6184659,105.2,0.24
2216,2021-06-13,LAZ,58462,26234,32228,33074,24874,514,ITI,ITI4,12,Lazio,Lazio,5879082,6243121,106.19,0.99
2217,2020-12-31,LAZ,5376,2152,3224,5316,0,60,ITI,ITI4,12,Lazio,Lazio,5879082,6248497,106.28,0.09
2218,2021-04-10,LAZ,23957,10425,13532,16473,7208,276,ITI,ITI4,12,Lazio,Lazio,5879082,6272454,106.69,0.41
2219,2021-02-05,LAZ,7343,3004,4339,1221,6118,4,ITI,ITI4,12,Lazio,Lazio,5879082,6279797,106.82,0.12
2220,2021-04-03,LAZ,24864,11229,13635,17895,6741,228,ITI,ITI4,12,Lazio,Lazio,5879082,6304661,107.24,0.42
2221,2021-02-19,LAZ,10099,5104,4995,9079,871,149,ITI,ITI4,12,Lazio,Lazio,5879082,6314760,107.41,0.17
2222,2021-06-17,LAZ,67076,32282,34794,31812,34531,733,ITI,ITI4,12,Lazio,Lazio,5879082,6381836,108.55,1.14
2223,2021-04-21,LAZ,33175,15079,18096,20238,12495,442,ITI,ITI4,12,Lazio,Lazio,5879082,6415011,109.12,0.56
2224,2021-07-30,LAZ,55994,29004,26990,7402,48235,357,ITI,ITI4,12,Lazio,Lazio,5879082,6471005,110.07,0.95
2225,2021-07-18,LAZ,58402,29736,28666,22795,34807,800,ITI,ITI4,12,Lazio,Lazio,5879082,6529407,111.06,0.99
2226,2021-01-21,LAZ,5743,2416,3327,631,5112,0,ITI,ITI4,12,Lazio,Lazio,5879082,6535150,111.16,0.1
2227,2021-03-31,LAZ,27905,13498,14407,20400,7156,349,ITI,ITI4,12,Lazio,Lazio,5879082,6563055,111.63,0.47
2228,2021-01-07,LAZ,7941,2981,4960,7784,0,157,ITI,ITI4,12,Lazio,Lazio,5879082,6570996,111.77,0.14
2229,2021-03-07,LAZ,14175,5485,8690,10352,3604,219,ITI,ITI4,12,Lazio,Lazio,5879082,6585171,112.01,0.24
2230,2021-06-15,LAZ,66238,32019,34219,33378,32281,579,ITI,ITI4,12,Lazio,Lazio,5879082,6651409,113.14,1.13
2231,2021-03-24,LAZ,27994,13152,14842,21312,6277,405,ITI,ITI4,12,Lazio,Lazio,5879082,6679403,113.61,0.48
2232,2021-09-06,LAZ,14392,7349,7043,7932,5859,601,ITI,ITI4,12,Lazio,Lazio,5879082,6693795,113.86,0.24
2233,2021-08-20,LAZ,8358,4709,3649,2088,6174,96,ITI,ITI4,12,Lazio,Lazio,5879082,6702153,114.0,0.14
2234,2021-05-29,LAZ,52114,23448,28666,40193,11053,868,ITI,ITI4,12,Lazio,Lazio,5879082,6754267,114.89,0.89
2235,2021-08-01,LAZ,39722,21173,18549,5716,33696,310,ITI,ITI4,12,Lazio,Lazio,5879082,6793989,115.56,0.68
2236,2021-05-10,LAZ,44524,20362,24162,30363,13449,712,ITI,ITI4,12,Lazio,Lazio,5879082,6838513,116.32,0.76
2237,2021-08-18,LAZ,9487,5485,4002,3254,6118,115,ITI,ITI4,12,Lazio,Lazio,5879082,6848000,116.48,0.16
2238,2021-05-27,LAZ,58567,27251,31316,43958,13816,793,ITI,ITI4,12,Lazio,Lazio,5879082,6906567,117.48,1.0
2239,2021-03-05,LAZ,19625,8695,10930,14621,4762,242,ITI,ITI4,12,Lazio,Lazio,5879082,6926192,117.81,0.33
2240,2021-02-16,LAZ,8375,4046,4329,7705,626,44,ITI,ITI4,12,Lazio,Lazio,5879082,6934567,117.95,0.14
2241,2021-06-03,LAZ,56895,28748,28147,38293,17868,734,ITI,ITI4,12,Lazio,Lazio,5879082,6991462,118.92,0.97
2242,2021-08-06,LAZ,33590,17657,15933,22365,10166,1059,ITI,ITI4,12,Lazio,Lazio,5879082,7025052,119.49,0.57
2243,2021-06-10,LAZ,72273,34152,38121,37316,34103,854,ITI,ITI4,12,Lazio,Lazio,5879082,7097325,120.72,1.23
2244,2021-04-14,LAZ,29405,13328,16077,18854,10198,353,ITI,ITI4,12,Lazio,Lazio,5879082,7126730,121.22,0.5
2245,2021-07-23,LAZ,58499,29345,29154,26809,29914,1776,ITI,ITI4,12,Lazio,Lazio,5879082,7185229,122.22,1.0
2246,2021-01-03,LAZ,5348,2017,3331,5289,0,59,ITI,ITI4,12,Lazio,Lazio,5879082,7190577,122.31,0.09
2247,2021-04-13,LAZ,25845,11983,13862,17639,7751,455,ITI,ITI4,12,Lazio,Lazio,5879082,7216422,122.75,0.44
2248,2021-07-31,LAZ,56249,29570,26679,5561,50383,305,ITI,ITI4,12,Lazio,Lazio,5879082,7272671,123.7,0.96
2249,2021-01-08,LAZ,7966,2987,4979,7769,0,197,ITI,ITI4,12,Lazio,Lazio,5879082,7280637,123.84,0.14
2250,2021-07-29,LAZ,56077,28569,27508,7676,48022,379,ITI,ITI4,12,Lazio,Lazio,5879082,7336714,124.79,0.95
2251,2021-01-01,LAZ,3603,1398,2205,3563,0,40,ITI,ITI4,12,Lazio,Lazio,5879082,7340317,124.85,0.06
2252,2021-01-10,LAZ,4136,1739,2397,4069,0,67,ITI,ITI4,12,Lazio,Lazio,5879082,7344453,124.93,0.07
2253,2021-06-16,LAZ,64758,31103,33655,32074,32040,644,ITI,ITI4,12,Lazio,Lazio,5879082,7409211,126.03,1.1
2254,2021-04-20,LAZ,31183,14311,16872,19372,11371,440,ITI,ITI4,12,Lazio,Lazio,5879082,7440394,126.56,0.53
2255,2021-03-08,LAZ,20962,9106,11856,15349,5309,304,ITI,ITI4,12,Lazio,Lazio,5879082,7461356,126.91,0.36
2256,2021-04-22,LAZ,39244,19522,19722,23818,14740,686,ITI,ITI4,12,Lazio,Lazio,5879082,7500600,127.58,0.67
2257,2021-03-10,LAZ,23382,10685,12697,17360,5666,356,ITI,ITI4,12,Lazio,Lazio,5879082,7523982,127.98,0.4
2258,2021-01-12,LAZ,5550,2048,3502,5407,0,143,ITI,ITI4,12,Lazio,Lazio,5879082,7529532,128.07,0.09
2259,2021-06-18,LAZ,64451,31051,33400,30309,33382,760,ITI,ITI4,12,Lazio,Lazio,5879082,7593983,129.17,1.1
2260,2021-03-17,LAZ,13888,5953,7935,7473,6297,118,ITI,ITI4,12,Lazio,Lazio,5879082,7607871,129.41,0.24
2261,2021-06-25,LAZ,63456,30650,32806,28136,34717,603,ITI,ITI4,12,Lazio,Lazio,5879082,7671327,130.49,1.08
2262,2021-06-27,LAZ,47265,21618,25647,20576,26192,497,ITI,ITI4,12,Lazio,Lazio,5879082,7718592,131.29,0.8
2263,2021-08-23,LAZ,22694,12367,10327,16315,5393,986,ITI,ITI4,12,Lazio,Lazio,5879082,7741286,131.68,0.39
2264,2021-02-04,LAZ,6476,2582,3894,1151,5324,1,ITI,ITI4,12,Lazio,Lazio,5879082,7747762,131.79,0.11
2265,2021-08-25,LAZ,31719,16651,15068,9913,21200,606,ITI,ITI4,12,Lazio,Lazio,5879082,7779481,132.32,0.54
2266,2021-05-22,LAZ,55231,27068,28163,43673,10713,845,ITI,ITI4,12,Lazio,Lazio,5879082,7834712,133.26,0.94
2267,2021-08-30,LAZ,30521,15413,15108,9979,19857,685,ITI,ITI4,12,Lazio,Lazio,5879082,7865233,133.78,0.52
2268,2021-05-15,LAZ,57521,27477,30044,40054,16589,878,ITI,ITI4,12,Lazio,Lazio,5879082,7922754,134.76,0.98
2269,2021-03-19,LAZ,17521,7603,9918,11006,6358,157,ITI,ITI4,12,Lazio,Lazio,5879082,7940275,135.06,0.3
2270,2021-09-01,LAZ,26435,13547,12888,8157,17759,519,ITI,ITI4,12,Lazio,Lazio,5879082,7966710,135.51,0.45
2271,2021-05-01,MOL,2673,1282,1391,407,2232,34,ITF,ITF2,14,Molise,Molise,305617,2673,0.87,0.87
2272,2021-03-05,MOL,1230,654,576,1007,209,14,ITF,ITF2,14,Molise,Molise,305617,3903,1.28,0.4
2273,2021-08-09,MOL,3440,1779,1661,1630,1759,51,ITF,ITF2,14,Molise,Molise,305617,7343,2.4,1.13
2274,2021-06-13,MOL,2938,1562,1376,2563,329,46,ITF,ITF2,14,Molise,Molise,305617,10281,3.36,0.96
2275,2021-04-17,MOL,3099,1526,1573,1553,1501,45,ITF,ITF2,14,Molise,Molise,305617,13380,4.38,1.01
2276,2021-01-26,MOL,450,184,266,8,442,0,ITF,ITF2,14,Molise,Molise,305617,13830,4.53,0.15
2277,2021-05-06,MOL,2747,1244,1503,2060,610,77,ITF,ITF2,14,Molise,Molise,305617,16577,5.42,0.9
2278,2021-07-28,MOL,2459,1306,1153,1151,1273,35,ITF,ITF2,14,Molise,Molise,305617,19036,6.23,0.8
2279,2021-06-27,MOL,2389,1129,1260,1141,1237,11,ITF,ITF2,14,Molise,Molise,305617,21425,7.01,0.78
2280,2021-01-07,MOL,600,209,391,600,0,0,ITF,ITF2,14,Molise,Molise,305617,22025,7.21,0.2
2281,2021-02-12,MOL,337,152,185,212,124,1,ITF,ITF2,14,Molise,Molise,305617,22362,7.32,0.11
2282,2021-08-23,MOL,1723,933,790,270,1440,13,ITF,ITF2,14,Molise,Molise,305617,24085,7.88,0.56
2283,2021-02-19,MOL,171,95,76,169,2,0,ITF,ITF2,14,Molise,Molise,305617,24256,7.94,0.06
2284,2021-03-10,MOL,1746,723,1023,1673,50,23,ITF,ITF2,14,Molise,Molise,305617,26002,8.51,0.57
2285,2021-06-01,MOL,2637,1341,1296,2481,110,46,ITF,ITF2,14,Molise,Molise,305617,28639,9.37,0.86
2286,2021-08-11,MOL,2023,1057,966,1144,815,64,ITF,ITF2,14,Molise,Molise,305617,30662,10.03,0.66
2287,2021-01-12,MOL,336,114,222,336,0,0,ITF,ITF2,14,Molise,Molise,305617,30998,10.14,0.11
2288,2021-03-24,MOL,1654,661,993,1218,402,34,ITF,ITF2,14,Molise,Molise,305617,32652,10.68,0.54
2289,2021-07-02,MOL,2708,1315,1393,137,2561,10,ITF,ITF2,14,Molise,Molise,305617,35360,11.57,0.89
2290,2021-07-04,MOL,2162,1091,1071,585,1554,23,ITF,ITF2,14,Molise,Molise,305617,37522,12.28,0.71
2291,2021-02-07,MOL,67,32,35,20,47,0,ITF,ITF2,14,Molise,Molise,305617,37589,12.3,0.02
2292,2021-05-18,MOL,1675,893,782,1004,658,13,ITF,ITF2,14,Molise,Molise,305617,39264,12.85,0.55
2293,2021-03-22,MOL,1171,450,721,896,245,30,ITF,ITF2,14,Molise,Molise,305617,40435,13.23,0.38
2294,2021-07-23,MOL,2933,1525,1408,874,2000,59,ITF,ITF2,14,Molise,Molise,305617,43368,14.19,0.96
2295,2021-09-04,MOL,1635,902,733,684,930,21,ITF,ITF2,14,Molise,Molise,305617,45003,14.73,0.53
2296,2021-08-28,MOL,1724,959,765,643,1065,16,ITF,ITF2,14,Molise,Molise,305617,46727,15.29,0.56
2297,2021-07-14,MOL,3438,1681,1757,209,3212,17,ITF,ITF2,14,Molise,Molise,305617,50165,16.41,1.12
2298,2021-04-05,MOL,392,190,202,293,99,0,ITF,ITF2,14,Molise,Molise,305617,50557,16.54,0.13
2299,2021-03-29,MOL,2068,845,1223,1522,489,57,ITF,ITF2,14,Molise,Molise,305617,52625,17.22,0.68
2300,2021-01-31,MOL,268,70,198,6,262,0,ITF,ITF2,14,Molise,Molise,305617,52893,17.31,0.09
2301,2021-06-20,MOL,424,174,250,48,372,4,ITF,ITF2,14,Molise,Molise,305617,53317,17.45,0.14
2302,2021-04-24,MOL,2578,1214,1364,700,1850,28,ITF,ITF2,14,Molise,Molise,305617,55895,18.29,0.84
2303,2021-02-26,MOL,566,261,305,492,73,1,ITF,ITF2,14,Molise,Molise,305617,56461,18.47,0.19
2304,2021-08-02,MOL,2720,1418,1302,1202,1470,48,ITF,ITF2,14,Molise,Molise,305617,59181,19.36,0.89
2305,2021-06-06,MOL,2111,1087,1024,1756,327,28,ITF,ITF2,14,Molise,Molise,305617,61292,20.06,0.69
2306,2021-03-19,MOL,1207,487,720,745,430,32,ITF,ITF2,14,Molise,Molise,305617,62499,20.45,0.39
2307,2021-01-21,MOL,6,2,4,6,0,0,ITF,ITF2,14,Molise,Molise,305617,62505,20.45,0.0
2308,2021-03-17,MOL,975,405,570,524,333,118,ITF,ITF2,14,Molise,Molise,305617,63480,20.77,0.32
2309,2021-06-25,MOL,3459,1703,1756,1478,1921,60,ITF,ITF2,14,Molise,Molise,305617,66939,21.9,1.13
2310,2021-06-08,MOL,2906,1603,1303,2202,701,3,ITF,ITF2,14,Molise,Molise,305617,69845,22.85,0.95
2311,2021-08-16,MOL,1786,926,860,829,941,16,ITF,ITF2,14,Molise,Molise,305617,71631,23.44,0.58
2312,2021-03-15,MOL,851,348,503,573,245,33,ITF,ITF2,14,Molise,Molise,305617,72482,23.72,0.28
2313,2021-05-13,MOL,3109,1444,1665,2554,461,94,ITF,ITF2,14,Molise,Molise,305617,75591,24.73,1.02
2314,2021-08-21,MOL,2146,1210,936,1079,1016,51,ITF,ITF2,14,Molise,Molise,305617,77737,25.44,0.7
2315,2021-08-04,MOL,2526,1308,1218,964,1543,19,ITF,ITF2,14,Molise,Molise,305617,80263,26.26,0.83
2316,2021-01-17,MOL,78,38,40,48,30,0,ITF,ITF2,14,Molise,Molise,305617,80341,26.29,0.03
2317,2021-04-10,MOL,2684,1277,1407,2465,154,65,ITF,ITF2,14,Molise,Molise,305617,83025,27.17,0.88
2318,2021-02-05,MOL,597,270,327,55,542,0,ITF,ITF2,14,Molise,Molise,305617,83622,27.36,0.2
2319,2021-01-19,MOL,174,63,111,163,11,0,ITF,ITF2,14,Molise,Molise,305617,83796,27.42,0.06
2320,2021-04-29,MOL,2264,1162,1102,883,1355,26,ITF,ITF2,14,Molise,Molise,305617,86060,28.16,0.74
2321,2021-04-12,MOL,1310,562,748,1040,252,18,ITF,ITF2,14,Molise,Molise,305617,87370,28.59,0.43
2322,2021-07-21,MOL,2116,1061,1055,793,1278,45,ITF,ITF2,14,Molise,Molise,305617,89486,29.28,0.69
2323,2021-05-20,MOL,2749,1416,1333,2423,189,137,ITF,ITF2,14,Molise,Molise,305617,92235,30.18,0.9
2324,2021-05-25,MOL,1981,893,1088,1308,633,40,ITF,ITF2,14,Molise,Molise,305617,94216,30.83,0.65
2325,2021-07-16,MOL,3101,1569,1532,398,2673,30,ITF,ITF2,14,Molise,Molise,305617,97317,31.84,1.01
2326,2021-07-09,MOL,3450,1659,1791,168,3264,18,ITF,ITF2,14,Molise,Molise,305617,100767,32.97,1.13
2327,2021-02-24,MOL,671,281,390,326,337,8,ITF,ITF2,14,Molise,Molise,305617,101438,33.19,0.22
2328,2021-08-20,MOL,2457,1293,1164,502,1935,20,ITF,ITF2,14,Molise,Molise,305617,103895,34.0,0.8
2329,2021-01-28,MOL,615,217,398,17,598,0,ITF,ITF2,14,Molise,Molise,305617,104510,34.2,0.2
2330,2021-09-01,MOL,1848,976,872,395,1433,20,ITF,ITF2,14,Molise,Molise,305617,106358,34.8,0.6
2331,2021-01-09,MOL,453,154,299,453,0,0,ITF,ITF2,14,Molise,Molise,305617,106811,34.95,0.15
2332,2021-04-19,MOL,1899,863,1036,992,784,123,ITF,ITF2,14,Molise,Molise,305617,108710,35.57,0.62
2333,2021-07-13,MOL,2829,1436,1393,323,2488,18,ITF,ITF2,14,Molise,Molise,305617,111539,36.5,0.93
2334,2021-02-28,MOL,838,337,501,793,43,2,ITF,ITF2,14,Molise,Molise,305617,112377,36.77,0.27
2335,2021-02-27,MOL,1372,571,801,1346,20,6,ITF,ITF2,14,Molise,Molise,305617,113749,37.22,0.45
2336,2021-06-07,MOL,1985,874,1111,1134,824,27,ITF,ITF2,14,Molise,Molise,305617,115734,37.87,0.65
2337,2021-08-30,MOL,1693,911,782,228,1446,19,ITF,ITF2,14,Molise,Molise,305617,117427,38.42,0.55
2338,2021-06-24,MOL,3361,1564,1797,442,2881,38,ITF,ITF2,14,Molise,Molise,305617,120788,39.52,1.1
2339,2021-03-02,MOL,674,387,287,508,159,7,ITF,ITF2,14,Molise,Molise,305617,121462,39.74,0.22
2340,2021-06-10,MOL,2621,1205,1416,1274,1301,46,ITF,ITF2,14,Molise,Molise,305617,124083,40.6,0.86
2341,2021-04-02,MOL,1486,727,759,668,784,34,ITF,ITF2,14,Molise,Molise,305617,125569,41.09,0.49
2342,2021-07-11,MOL,2464,1200,1264,181,2279,4,ITF,ITF2,14,Molise,Molise,305617,128033,41.89,0.81
2343,2021-08-13,MOL,1538,801,737,1123,384,31,ITF,ITF2,14,Molise,Molise,305617,129571,42.4,0.5
2344,2021-05-08,MOL,3037,1478,1559,1716,1258,63,ITF,ITF2,14,Molise,Molise,305617,132608,43.39,0.99
2345,2021-04-21,MOL,1888,798,1090,971,906,11,ITF,ITF2,14,Molise,Molise,305617,134496,44.01,0.62
2346,2021-07-30,MOL,2698,1398,1300,1442,1196,60,ITF,ITF2,14,Molise,Molise,305617,137194,44.89,0.88
2347,2021-02-11,MOL,295,133,162,258,37,0,ITF,ITF2,14,Molise,Molise,305617,137489,44.99,0.1
2348,2021-05-22,MOL,2310,1196,1114,2196,90,24,ITF,ITF2,14,Molise,Molise,305617,139799,45.74,0.76
2349,2021-04-28,MOL,1724,944,780,491,1221,12,ITF,ITF2,14,Molise,Molise,305617,141523,46.31,0.56
2350,2021-08-06,MOL,2333,1232,1101,1084,1206,43,ITF,ITF2,14,Molise,Molise,305617,143856,47.07,0.76
2351,2021-02-21,MOL,576,227,349,574,2,0,ITF,ITF2,14,Molise,Molise,305617,144432,47.26,0.19
2352,2021-02-04,MOL,762,296,466,78,684,0,ITF,ITF2,14,Molise,Molise,305617,145194,47.51,0.25
2353,2021-05-15,MOL,3034,1425,1609,2559,387,88,ITF,ITF2,14,Molise,Molise,305617,148228,48.5,0.99
2354,2021-03-12,MOL,1469,640,829,1409,36,24,ITF,ITF2,14,Molise,Molise,305617,149697,48.98,0.48
2355,2021-01-14,MOL,649,240,409,649,0,0,ITF,ITF2,14,Molise,Molise,305617,150346,49.19,0.21
2356,2021-03-31,MOL,2267,937,1330,1317,820,130,ITF,ITF2,14,Molise,Molise,305617,152613,49.94,0.74
2357,2021-03-07,MOL,1133,501,632,1128,2,3,ITF,ITF2,14,Molise,Molise,305617,153746,50.31,0.37
2358,2021-06-15,MOL,2252,1060,1192,775,1459,18,ITF,ITF2,14,Molise,Molise,305617,155998,51.04,0.74
2359,2021-06-17,MOL,2323,1025,1298,919,1373,31,ITF,ITF2,14,Molise,Molise,305617,158321,51.8,0.76
2360,2021-09-08,MOL,898,479,419,220,674,4,ITF,ITF2,14,Molise,Molise,305617,159219,52.1,0.29
2361,2021-03-26,MOL,2635,1061,1574,1905,645,85,ITF,ITF2,14,Molise,Molise,305617,161854,52.96,0.86
2362,2021-02-13,MOL,132,80,52,132,0,0,ITF,ITF2,14,Molise,Molise,305617,161986,53.0,0.04
2363,2021-08-29,MOL,1431,780,651,111,1311,9,ITF,ITF2,14,Molise,Molise,305617,163417,53.47,0.47
2364,2021-05-24,MOL,1986,864,1122,1279,675,32,ITF,ITF2,14,Molise,Molise,305617,165403,54.12,0.65
2365,2021-05-07,MOL,2695,1256,1439,2030,601,64,ITF,ITF2,14,Molise,Molise,305617,168098,55.0,0.88
2366,2021-04-18,MOL,1092,486,606,143,939,10,ITF,ITF2,14,Molise,Molise,305617,169190,55.36,0.36
2367,2021-07-27,MOL,1951,1075,876,1328,555,68,ITF,ITF2,14,Molise,Molise,305617,171141,56.0,0.64
2368,2021-02-23,MOL,586,223,363,362,221,3,ITF,ITF2,14,Molise,Molise,305617,171727,56.19,0.19
2369,2021-06-03,MOL,3327,1584,1743,2720,560,47,ITF,ITF2,14,Molise,Molise,305617,175054,57.28,1.09
2370,2021-04-07,MOL,1739,882,857,1375,276,88,ITF,ITF2,14,Molise,Molise,305617,176793,57.85,0.57
2371,2021-06-05,MOL,3037,1533,1504,2822,177,38,ITF,ITF2,14,Molise,Molise,305617,179830,58.84,0.99
2372,2021-07-18,MOL,1774,894,880,126,1638,10,ITF,ITF2,14,Molise,Molise,305617,181604,59.42,0.58
2373,2021-05-26,MOL,1637,747,890,825,769,43,ITF,ITF2,14,Molise,Molise,305617,183241,59.96,0.54
2374,2021-03-30,MOL,2027,872,1155,1481,513,33,ITF,ITF2,14,Molise,Molise,305617,185268,60.62,0.66
2375,2021-09-03,MOL,1678,874,804,357,1298,23,ITF,ITF2,14,Molise,Molise,305617,186946,61.17,0.55
2376,2021-02-01,MOL,563,201,362,14,549,0,ITF,ITF2,14,Molise,Molise,305617,187509,61.35,0.18
2377,2021-07-08,MOL,3447,1661,1786,108,3316,23,ITF,ITF2,14,Molise,Molise,305617,190956,62.48,1.13
2378,2021-05-12,MOL,2923,1327,1596,2714,100,109,ITF,ITF2,14,Molise,Molise,305617,193879,63.44,0.96
2379,2021-03-03,MOL,677,320,357,588,83,6,ITF,ITF2,14,Molise,Molise,305617,194556,63.66,0.22
2380,2021-01-05,MOL,449,180,269,449,0,0,ITF,ITF2,14,Molise,Molise,305617,195005,63.81,0.15
2381,2021-07-06,MOL,3072,1433,1639,38,3029,5,ITF,ITF2,14,Molise,Molise,305617,198077,64.81,1.01
2382,2021-05-10,MOL,2947,1304,1643,2508,376,63,ITF,ITF2,14,Molise,Molise,305617,201024,65.78,0.96
2383,2021-06-29,MOL,2509,1168,1341,385,2093,31,ITF,ITF2,14,Molise,Molise,305617,203533,66.6,0.82
2384,2021-05-03,MOL,2550,1209,1341,2316,164,70,ITF,ITF2,14,Molise,Molise,305617,206083,67.43,0.83
2385,2021-03-16,MOL,618,230,388,266,348,4,ITF,ITF2,14,Molise,Molise,305617,206701,67.63,0.2
2386,2021-01-11,MOL,558,194,364,558,0,0,ITF,ITF2,14,Molise,Molise,305617,207259,67.82,0.18
2387,2021-07-29,MOL,2473,1270,1203,1600,822,51,ITF,ITF2,14,Molise,Molise,305617,209732,68.63,0.81
2388,2021-03-04,MOL,856,420,436,515,325,16,ITF,ITF2,14,Molise,Molise,305617,210588,68.91,0.28
2389,2021-06-12,MOL,5958,3065,2893,5665,203,90,ITF,ITF2,14,Molise,Molise,305617,216546,70.86,1.95
2390,2021-08-17,MOL,1667,878,789,340,1310,17,ITF,ITF2,14,Molise,Molise,305617,218213,71.4,0.55
2391,2021-06-14,MOL,1652,821,831,549,1086,17,ITF,ITF2,14,Molise,Molise,305617,219865,71.94,0.54
2392,2021-02-18,MOL,321,74,247,304,13,4,ITF,ITF2,14,Molise,Molise,305617,220186,72.05,0.11
2393,2021-03-09,MOL,1338,583,755,1152,154,32,ITF,ITF2,14,Molise,Molise,305617,221524,72.48,0.44
2394,2021-02-20,MOL,1020,443,577,1000,20,0,ITF,ITF2,14,Molise,Molise,305617,222544,72.82,0.33
2395,2021-04-06,MOL,1526,714,812,1140,346,40,ITF,ITF2,14,Molise,Molise,305617,224070,73.32,0.5
2396,2021-02-08,MOL,335,141,194,216,119,0,ITF,ITF2,14,Molise,Molise,305617,224405,73.43,0.11
2397,2021-07-15,MOL,3226,1623,1603,212,2999,15,ITF,ITF2,14,Molise,Molise,305617,227631,74.48,1.06
2398,2021-05-19,MOL,2400,1226,1174,1903,431,66,ITF,ITF2,14,Molise,Molise,305617,230031,75.27,0.79
2399,2021-03-23,MOL,1683,711,972,1425,211,47,ITF,ITF2,14,Molise,Molise,305617,231714,75.82,0.55
2400,2021-08-27,MOL,2118,1090,1028,414,1682,22,ITF,ITF2,14,Molise,Molise,305617,233832,76.51,0.69
2401,2021-07-01,MOL,2681,1306,1375,275,2390,16,ITF,ITF2,14,Molise,Molise,305617,236513,77.39,0.88
2402,2021-07-26,MOL,2453,1262,1191,1263,1124,66,ITF,ITF2,14,Molise,Molise,305617,238966,78.19,0.8
2403,2021-02-15,MOL,144,70,74,141,3,0,ITF,ITF2,14,Molise,Molise,305617,239110,78.24,0.05
2404,2021-02-02,MOL,540,176,364,216,323,1,ITF,ITF2,14,Molise,Molise,305617,239650,78.42,0.18
2405,2021-01-16,MOL,422,166,256,422,0,0,ITF,ITF2,14,Molise,Molise,305617,240072,78.55,0.14
2406,2021-04-26,MOL,1173,528,645,815,332,26,ITF,ITF2,14,Molise,Molise,305617,241245,78.94,0.38
2407,2021-04-09,MOL,2362,1267,1095,2113,192,57,ITF,ITF2,14,Molise,Molise,305617,243607,79.71,0.77
2408,2021-05-17,MOL,2263,1108,1155,1716,497,50,ITF,ITF2,14,Molise,Molise,305617,245870,80.45,0.74
2409,2021-03-21,MOL,1254,546,708,481,770,3,ITF,ITF2,14,Molise,Molise,305617,247124,80.86,0.41
2410,2021-08-25,MOL,1503,809,694,342,1151,10,ITF,ITF2,14,Molise,Molise,305617,248627,81.35,0.49
2411,2021-03-14,MOL,600,241,359,18,582,0,ITF,ITF2,14,Molise,Molise,305617,249227,81.55,0.2
2412,2021-08-18,MOL,1346,706,640,343,981,22,ITF,ITF2,14,Molise,Molise,305617,250573,81.99,0.44
2413,2021-06-22,MOL,2981,1377,1604,674,2287,20,ITF,ITF2,14,Molise,Molise,305617,253554,82.96,0.98
2414,2021-01-25,MOL,319,130,189,3,316,0,ITF,ITF2,14,Molise,Molise,305617,253873,83.07,0.1
2415,2021-05-05,MOL,2493,1070,1423,2303,145,45,ITF,ITF2,14,Molise,Molise,305617,256366,83.88,0.82
2416,2021-05-04,MOL,2750,1197,1553,2561,131,58,ITF,ITF2,14,Molise,Molise,305617,259116,84.78,0.9
2417,2021-01-10,MOL,270,72,198,270,0,0,ITF,ITF2,14,Molise,Molise,305617,259386,84.87,0.09
2418,2021-04-20,MOL,2342,1038,1304,1215,1112,15,ITF,ITF2,14,Molise,Molise,305617,261728,85.64,0.77
2419,2021-06-09,MOL,1831,920,911,866,934,31,ITF,ITF2,14,Molise,Molise,305617,263559,86.24,0.6
2420,2021-05-23,MOL,1793,902,891,1750,9,34,ITF,ITF2,14,Molise,Molise,305617,265352,86.83,0.59
2421,2021-08-31,MOL,1744,954,790,312,1422,10,ITF,ITF2,14,Molise,Molise,305617,267096,87.4,0.57
2422,2021-01-20,MOL,18,8,10,18,0,0,ITF,ITF2,14,Molise,Molise,305617,267114,87.4,0.01
2423,2021-04-30,MOL,2967,1574,1393,823,2121,23,ITF,ITF2,14,Molise,Molise,305617,270081,88.37,0.97
2424,2021-02-25,MOL,543,239,304,471,69,3,ITF,ITF2,14,Molise,Molise,305617,270624,88.55,0.18
2425,2021-08-10,MOL,1927,1047,880,688,1207,32,ITF,ITF2,14,Molise,Molise,305617,272551,89.18,0.63
2426,2021-08-12,MOL,1465,761,704,1026,400,39,ITF,ITF2,14,Molise,Molise,305617,274016,89.66,0.48
2427,2021-01-29,MOL,424,137,287,6,418,0,ITF,ITF2,14,Molise,Molise,305617,274440,89.8,0.14
2428,2021-05-09,MOL,2082,950,1132,1937,98,47,ITF,ITF2,14,Molise,Molise,305617,276522,90.48,0.68
2429,2021-07-07,MOL,2969,1374,1595,58,2907,4,ITF,ITF2,14,Molise,Molise,305617,279491,91.45,0.97
2430,2021-05-11,MOL,3275,1446,1829,2925,254,96,ITF,ITF2,14,Molise,Molise,305617,282766,92.52,1.07
2431,2021-08-19,MOL,2282,1146,1136,607,1648,27,ITF,ITF2,14,Molise,Molise,305617,285048,93.27,0.75
2432,2021-01-22,MOL,128,36,92,128,0,0,ITF,ITF2,14,Molise,Molise,305617,285176,93.31,0.04
2433,2021-05-02,MOL,1920,948,972,582,1318,20,ITF,ITF2,14,Molise,Molise,305617,287096,93.94,0.63
2434,2021-03-06,MOL,1730,809,921,1559,160,11,ITF,ITF2,14,Molise,Molise,305617,288826,94.51,0.57
2435,2021-07-10,MOL,3743,1788,1955,326,3403,14,ITF,ITF2,14,Molise,Molise,305617,292569,95.73,1.22
2436,2021-04-04,MOL,258,142,116,231,15,12,ITF,ITF2,14,Molise,Molise,305617,292827,95.82,0.08
2437,2021-03-18,MOL,1220,495,725,637,465,118,ITF,ITF2,14,Molise,Molise,305617,294047,96.21,0.4
2438,2021-06-26,MOL,3141,1545,1596,530,2596,15,ITF,ITF2,14,Molise,Molise,305617,297188,97.24,1.03
2439,2021-02-10,MOL,152,80,72,132,20,0,ITF,ITF2,14,Molise,Molise,305617,297340,97.29,0.05
2440,2021-05-21,MOL,2289,1154,1135,1809,330,150,ITF,ITF2,14,Molise,Molise,305617,299629,98.04,0.75
2441,2021-01-27,MOL,675,251,424,8,667,0,ITF,ITF2,14,Molise,Molise,305617,300304,98.26,0.22
2442,2021-08-14,MOL,1622,875,747,705,896,21,ITF,ITF2,14,Molise,Molise,305617,301926,98.79,0.53
2443,2021-01-08,MOL,432,142,290,432,0,0,ITF,ITF2,14,Molise,Molise,305617,302358,98.93,0.14
2444,2021-09-02,MOL,1526,790,736,305,1195,26,ITF,ITF2,14,Molise,Molise,305617,303884,99.43,0.5
2445,2021-02-22,MOL,265,129,136,248,15,2,ITF,ITF2,14,Molise,Molise,305617,304149,99.52,0.09
2446,2020-12-27,MOL,50,20,30,50,0,0,ITF,ITF2,14,Molise,Molise,305617,304199,99.54,0.02
2447,2021-05-31,MOL,2391,1164,1227,1915,428,48,ITF,ITF2,14,Molise,Molise,305617,306590,100.32,0.78
2448,2021-05-14,MOL,2690,1241,1449,1901,724,65,ITF,ITF2,14,Molise,Molise,305617,309280,101.2,0.88
2449,2021-08-22,MOL,389,202,187,3,386,0,ITF,ITF2,14,Molise,Molise,305617,309669,101.33,0.13
2450,2021-06-02,MOL,2855,1375,1480,2722,100,33,ITF,ITF2,14,Molise,Molise,305617,312524,102.26,0.93
2451,2021-07-19,MOL,2815,1376,1439,518,2266,31,ITF,ITF2,14,Molise,Molise,305617,315339,103.18,0.92
2452,2021-02-03,MOL,745,254,491,344,401,0,ITF,ITF2,14,Molise,Molise,305617,316084,103.42,0.24
2453,2021-03-28,MOL,1639,757,882,522,1103,14,ITF,ITF2,14,Molise,Molise,305617,317723,103.96,0.54
2454,2021-01-30,MOL,465,161,304,12,453,0,ITF,ITF2,14,Molise,Molise,305617,318188,104.11,0.15
2455,2021-03-01,MOL,666,275,391,431,215,20,ITF,ITF2,14,Molise,Molise,305617,318854,104.33,0.22
2456,2021-04-03,MOL,1801,866,935,1726,36,39,ITF,ITF2,14,Molise,Molise,305617,320655,104.92,0.59
2457,2021-07-12,MOL,2694,1331,1363,361,2312,21,ITF,ITF2,14,Molise,Molise,305617,323349,105.8,0.88
2458,2021-01-18,MOL,115,48,67,115,0,0,ITF,ITF2,14,Molise,Molise,305617,323464,105.84,0.04
2459,2021-04-11,MOL,1219,603,616,1174,14,31,ITF,ITF2,14,Molise,Molise,305617,324683,106.24,0.4
2460,2021-07-20,MOL,2197,1110,1087,1027,1120,50,ITF,ITF2,14,Molise,Molise,305617,326880,106.96,0.72
2461,2021-07-03,MOL,2765,1391,1374,579,2164,22,ITF,ITF2,14,Molise,Molise,305617,329645,107.86,0.9
2462,2021-08-08,MOL,893,467,426,648,229,16,ITF,ITF2,14,Molise,Molise,305617,330538,108.15,0.29
2463,2021-07-22,MOL,2251,1116,1135,845,1348,58,ITF,ITF2,14,Molise,Molise,305617,332789,108.89,0.74
2464,2021-09-05,MOL,5,5,0,5,0,0,ITF,ITF2,14,Molise,Molise,305617,332794,108.89,0.0
2465,2021-02-06,MOL,431,179,252,30,401,0,ITF,ITF2,14,Molise,Molise,305617,333225,109.03,0.14
2466,2021-06-04,MOL,3107,1526,1581,2607,459,41,ITF,ITF2,14,Molise,Molise,305617,336332,110.05,1.02
2467,2021-04-08,MOL,1804,926,878,1553,203,48,ITF,ITF2,14,Molise,Molise,305617,338136,110.64,0.59
2468,2021-07-17,MOL,2878,1533,1345,303,2552,23,ITF,ITF2,14,Molise,Molise,305617,341014,111.58,0.94
2469,2021-04-22,MOL,1861,871,990,1062,781,18,ITF,ITF2,14,Molise,Molise,305617,342875,112.19,0.61
2470,2021-04-27,MOL,1628,782,846,447,1138,43,ITF,ITF2,14,Molise,Molise,305617,344503,112.72,0.53
2471,2021-08-05,MOL,2297,1159,1138,1621,625,51,ITF,ITF2,14,Molise,Molise,305617,346800,113.48,0.75
2472,2021-05-16,MOL,1284,585,699,1064,185,35,ITF,ITF2,14,Molise,Molise,305617,348084,113.9,0.42
2473,2021-08-24,MOL,1708,923,785,261,1422,25,ITF,ITF2,14,Molise,Molise,305617,349792,114.45,0.56
2474,2021-08-07,MOL,1935,1070,865,1056,851,28,ITF,ITF2,14,Molise,Molise,305617,351727,115.09,0.63
2475,2021-04-01,MOL,1495,677,818,738,730,27,ITF,ITF2,14,Molise,Molise,305617,353222,115.58,0.49
2476,2021-03-25,MOL,1834,740,1094,1288,498,48,ITF,ITF2,14,Molise,Molise,305617,355056,116.18,0.6
2477,2021-03-08,MOL,1397,528,869,1212,140,45,ITF,ITF2,14,Molise,Molise,305617,356453,116.63,0.46
2478,2021-06-16,MOL,2128,1052,1076,1167,943,18,ITF,ITF2,14,Molise,Molise,305617,358581,117.33,0.7
2479,2021-04-13,MOL,1643,722,921,1040,589,14,ITF,ITF2,14,Molise,Molise,305617,360224,117.87,0.54
2480,2021-03-27,MOL,2765,1284,1481,1302,1434,29,ITF,ITF2,14,Molise,Molise,305617,362989,118.77,0.9
2481,2021-07-05,MOL,2745,1286,1459,40,2703,2,ITF,ITF2,14,Molise,Molise,305617,365734,119.67,0.9
2482,2021-06-18,MOL,2790,1264,1526,1300,1462,28,ITF,ITF2,14,Molise,Molise,305617,368524,120.58,0.91
2483,2021-05-30,MOL,1888,945,943,1567,286,35,ITF,ITF2,14,Molise,Molise,305617,370412,121.2,0.62
2484,2021-09-07,MOL,920,498,422,345,563,12,ITF,ITF2,14,Molise,Molise,305617,371332,121.5,0.3
2485,2021-07-31,MOL,2010,1120,890,762,1202,46,ITF,ITF2,14,Molise,Molise,305617,373342,122.16,0.66
2486,2021-02-17,MOL,72,32,40,50,15,7,ITF,ITF2,14,Molise,Molise,305617,373414,122.18,0.02
2487,2021-07-24,MOL,3155,1697,1458,737,2388,30,ITF,ITF2,14,Molise,Molise,305617,376569,123.22,1.03
2488,2021-05-28,MOL,2677,1377,1300,2055,549,73,ITF,ITF2,14,Molise,Molise,305617,379246,124.09,0.88
2489,2021-06-11,MOL,3487,1678,1809,1995,1439,53,ITF,ITF2,14,Molise,Molise,305617,382733,125.23,1.14
2490,2021-04-15,MOL,1952,805,1147,1093,850,9,ITF,ITF2,14,Molise,Molise,305617,384685,125.87,0.64
2491,2021-01-04,MOL,314,131,183,314,0,0,ITF,ITF2,14,Molise,Molise,305617,384999,125.97,0.1
2492,2021-04-14,MOL,1826,775,1051,1139,668,19,ITF,ITF2,14,Molise,Molise,305617,386825,126.57,0.6
2493,2021-02-16,MOL,158,72,86,151,6,1,ITF,ITF2,14,Molise,Molise,305617,386983,126.62,0.05
2494,2021-05-27,MOL,2866,1365,1501,1981,843,42,ITF,ITF2,14,Molise,Molise,305617,389849,127.56,0.94
2495,2021-07-25,MOL,2023,1066,957,356,1651,16,ITF,ITF2,14,Molise,Molise,305617,391872,128.22,0.66
2496,2021-05-29,MOL,2383,1240,1143,1945,394,44,ITF,ITF2,14,Molise,Molise,305617,394255,129.0,0.78
2497,2021-09-06,MOL,1185,627,558,353,826,6,ITF,ITF2,14,Molise,Molise,305617,395440,129.39,0.39
2498,2021-02-09,MOL,361,171,190,198,163,0,ITF,ITF2,14,Molise,Molise,305617,395801,129.51,0.12
2499,2021-08-01,MOL,965,529,436,758,175,32,ITF,ITF2,14,Molise,Molise,305617,396766,129.82,0.32
2500,2021-08-03,MOL,2215,1152,1063,1224,955,36,ITF,ITF2,14,Molise,Molise,305617,398981,130.55,0.72
2501,2021-03-11,MOL,1475,641,834,1452,6,17,ITF,ITF2,14,Molise,Molise,305617,400456,131.03,0.48
2502,2021-01-06,MOL,691,260,431,691,0,0,ITF,ITF2,14,Molise,Molise,305617,401147,131.26,0.23
2503,2021-04-16,MOL,2461,1048,1413,1185,1237,39,ITF,ITF2,14,Molise,Molise,305617,403608,132.06,0.81
2504,2021-06-21,MOL,2936,1364,1572,1649,1239,48,ITF,ITF2,14,Molise,Molise,305617,406544,133.02,0.96
2505,2021-04-25,MOL,800,401,399,559,233,8,ITF,ITF2,14,Molise,Molise,305617,407344,133.29,0.26
2506,2021-01-13,MOL,480,163,317,480,0,0,ITF,ITF2,14,Molise,Molise,305617,407824,133.44,0.16
2507,2021-06-19,MOL,2374,1178,1196,1302,1026,46,ITF,ITF2,14,Molise,Molise,305617,410198,134.22,0.78
2508,2021-04-23,MOL,2084,903,1181,1382,671,31,ITF,ITF2,14,Molise,Molise,305617,412282,134.9,0.68
2509,2021-08-26,MOL,1724,935,789,307,1410,7,ITF,ITF2,14,Molise,Molise,305617,414006,135.47,0.56
2510,2021-06-30,MOL,2985,1418,1567,878,2023,84,ITF,ITF2,14,Molise,Molise,305617,416991,136.44,0.98
2511,2021-03-13,MOL,1193,598,595,184,990,19,ITF,ITF2,14,Molise,Molise,305617,418184,136.83,0.39
2512,2021-01-15,MOL,542,243,299,542,0,0,ITF,ITF2,14,Molise,Molise,305617,418726,137.01,0.18
2513,2021-06-23,MOL,2814,1297,1517,223,2581,10,ITF,ITF2,14,Molise,Molise,305617,421540,137.93,0.92
2514,2021-03-20,MOL,2348,983,1365,1007,1323,18,ITF,ITF2,14,Molise,Molise,305617,423888,138.7,0.77
2515,2021-06-28,MOL,2933,1367,1566,1013,1896,24,ITF,ITF2,14,Molise,Molise,305617,426821,139.66,0.96
2516,2021-01-30,CAM,10732,5083,5649,43,10687,2,ITF,ITF3,15,Campania,Campania,5801692,10732,0.18,0.18
2517,2021-07-03,CAM,67285,32498,34787,8135,58712,438,ITF,ITF3,15,Campania,Campania,5801692,78017,1.34,1.16
2518,2021-08-29,CAM,10260,5574,4686,3714,6277,269,ITF,ITF3,15,Campania,Campania,5801692,88277,1.52,0.18
2519,2021-01-16,CAM,3372,1677,1695,3261,0,111,ITF,ITF3,15,Campania,Campania,5801692,91649,1.58,0.06
2520,2021-03-02,CAM,12762,4560,8202,8184,4345,233,ITF,ITF3,15,Campania,Campania,5801692,104411,1.8,0.22
2521,2021-07-15,CAM,66735,32056,34679,8705,57080,950,ITF,ITF3,15,Campania,Campania,5801692,171146,2.95,1.15
2522,2021-05-24,CAM,31363,15157,16206,15853,15159,351,ITF,ITF3,15,Campania,Campania,5801692,202509,3.49,0.54
2523,2021-02-13,CAM,5508,2549,2959,5106,217,185,ITF,ITF3,15,Campania,Campania,5801692,208017,3.59,0.09
2524,2021-08-01,CAM,16086,8415,7671,6893,8834,359,ITF,ITF3,15,Campania,Campania,5801692,224103,3.86,0.28
2525,2021-04-23,CAM,32361,15537,16824,22432,9160,769,ITF,ITF3,15,Campania,Campania,5801692,256464,4.42,0.56
2526,2021-08-15,CAM,1121,638,483,216,898,7,ITF,ITF3,15,Campania,Campania,5801692,257585,4.44,0.02
2527,2021-04-11,CAM,17529,8610,8919,15033,2088,408,ITF,ITF3,15,Campania,Campania,5801692,275114,4.74,0.3
2528,2021-04-28,CAM,36424,17631,18793,25832,9761,831,ITF,ITF3,15,Campania,Campania,5801692,311538,5.37,0.63
2529,2021-01-18,CAM,960,399,561,684,244,32,ITF,ITF3,15,Campania,Campania,5801692,312498,5.39,0.02
2530,2021-07-20,CAM,40104,19783,20321,6144,33333,627,ITF,ITF3,15,Campania,Campania,5801692,352602,6.08,0.69
2531,2021-06-24,CAM,66120,31868,34252,13285,52310,525,ITF,ITF3,15,Campania,Campania,5801692,418722,7.22,1.14
2532,2021-03-16,CAM,8090,3519,4571,3695,4317,78,ITF,ITF3,15,Campania,Campania,5801692,426812,7.36,0.14
2533,2021-08-20,CAM,17414,9328,8086,7455,9421,538,ITF,ITF3,15,Campania,Campania,5801692,444226,7.66,0.3
2534,2021-01-25,CAM,5760,2929,2831,174,5586,0,ITF,ITF3,15,Campania,Campania,5801692,449986,7.76,0.1
2535,2021-07-01,CAM,61541,29869,31672,19725,41034,782,ITF,ITF3,15,Campania,Campania,5801692,511527,8.82,1.06
2536,2021-03-23,CAM,15745,7447,8298,12851,2515,379,ITF,ITF3,15,Campania,Campania,5801692,527272,9.09,0.27
2537,2021-08-27,CAM,24403,13015,11388,7836,15885,682,ITF,ITF3,15,Campania,Campania,5801692,551675,9.51,0.42
2538,2021-03-28,CAM,15565,7510,8055,13565,1625,375,ITF,ITF3,15,Campania,Campania,5801692,567240,9.78,0.27
2539,2021-01-04,CAM,5828,2962,2866,5728,0,100,ITF,ITF3,15,Campania,Campania,5801692,573068,9.88,0.1
2540,2021-06-19,CAM,62408,29712,32696,24084,37769,555,ITF,ITF3,15,Campania,Campania,5801692,635476,10.95,1.08
2541,2021-08-03,CAM,31996,16222,15774,14473,16655,868,ITF,ITF3,15,Campania,Campania,5801692,667472,11.5,0.55
2542,2021-02-11,CAM,6294,2716,3578,5917,77,300,ITF,ITF3,15,Campania,Campania,5801692,673766,11.61,0.11
2543,2021-06-07,CAM,57605,27731,29874,52553,4051,1001,ITF,ITF3,15,Campania,Campania,5801692,731371,12.61,0.99
2544,2021-02-25,CAM,12444,4487,7957,10940,1208,296,ITF,ITF3,15,Campania,Campania,5801692,743815,12.82,0.21
2545,2021-04-09,CAM,29952,14085,15867,23154,6139,659,ITF,ITF3,15,Campania,Campania,5801692,773767,13.34,0.52
2546,2021-06-05,CAM,77650,37594,40056,70586,6039,1025,ITF,ITF3,15,Campania,Campania,5801692,851417,14.68,1.34
2547,2021-08-22,CAM,6811,3877,2934,2537,4127,147,ITF,ITF3,15,Campania,Campania,5801692,858228,14.79,0.12
2548,2021-01-23,CAM,3843,2032,1811,267,3570,6,ITF,ITF3,15,Campania,Campania,5801692,862071,14.86,0.07
2549,2021-03-21,CAM,10075,4677,5398,7483,2391,201,ITF,ITF3,15,Campania,Campania,5801692,872146,15.03,0.17
2550,2021-02-10,CAM,6939,3439,3500,6483,206,250,ITF,ITF3,15,Campania,Campania,5801692,879085,15.15,0.12
2551,2021-07-17,CAM,55273,27563,27710,3357,51548,368,ITF,ITF3,15,Campania,Campania,5801692,934358,16.1,0.95
2552,2021-04-08,CAM,28501,13824,14677,22019,5848,634,ITF,ITF3,15,Campania,Campania,5801692,962859,16.6,0.49
2553,2021-01-11,CAM,4081,1879,2202,3971,0,110,ITF,ITF3,15,Campania,Campania,5801692,966940,16.67,0.07
2554,2021-09-03,CAM,26474,13635,12839,10803,14756,915,ITF,ITF3,15,Campania,Campania,5801692,993414,17.12,0.46
2555,2021-05-26,CAM,52746,25880,26866,21113,31159,474,ITF,ITF3,15,Campania,Campania,5801692,1046160,18.03,0.91
2556,2021-06-26,CAM,62952,30696,32256,14515,47863,574,ITF,ITF3,15,Campania,Campania,5801692,1109112,19.12,1.09
2557,2021-07-13,CAM,53695,25797,27898,4682,48504,509,ITF,ITF3,15,Campania,Campania,5801692,1162807,20.04,0.93
2558,2021-04-04,CAM,7965,4016,3949,6677,1046,242,ITF,ITF3,15,Campania,Campania,5801692,1170772,20.18,0.14
2559,2021-06-12,CAM,64001,31546,32455,55613,7216,1172,ITF,ITF3,15,Campania,Campania,5801692,1234773,21.28,1.1
2560,2021-03-04,CAM,14710,5396,9314,8523,5897,290,ITF,ITF3,15,Campania,Campania,5801692,1249483,21.54,0.25
2561,2021-05-17,CAM,49509,21757,27752,23648,25396,465,ITF,ITF3,15,Campania,Campania,5801692,1298992,22.39,0.85
2562,2021-02-06,CAM,5343,2666,2677,2002,3241,100,ITF,ITF3,15,Campania,Campania,5801692,1304335,22.48,0.09
2563,2021-07-22,CAM,61853,30552,31301,6497,54791,565,ITF,ITF3,15,Campania,Campania,5801692,1366188,23.55,1.07
2564,2021-08-08,CAM,7574,4041,3533,4649,2666,259,ITF,ITF3,15,Campania,Campania,5801692,1373762,23.68,0.13
2565,2021-04-30,CAM,42331,20199,22132,24961,16509,861,ITF,ITF3,15,Campania,Campania,5801692,1416093,24.41,0.73
2566,2021-02-04,CAM,7946,3430,4516,1249,6638,59,ITF,ITF3,15,Campania,Campania,5801692,1424039,24.55,0.14
2567,2021-01-01,CAM,919,506,413,899,0,20,ITF,ITF3,15,Campania,Campania,5801692,1424958,24.56,0.02
2568,2021-03-09,CAM,14143,6875,7268,9902,3799,442,ITF,ITF3,15,Campania,Campania,5801692,1439101,24.8,0.24
2569,2021-05-31,CAM,40823,20715,20108,29850,10400,573,ITF,ITF3,15,Campania,Campania,5801692,1479924,25.51,0.7
2570,2021-08-26,CAM,24535,12760,11775,8193,15527,815,ITF,ITF3,15,Campania,Campania,5801692,1504459,25.93,0.42
2571,2021-07-27,CAM,49161,24447,24714,12619,35719,823,ITF,ITF3,15,Campania,Campania,5801692,1553620,26.78,0.85
2572,2021-09-08,CAM,19067,9606,9461,8660,9599,808,ITF,ITF3,15,Campania,Campania,5801692,1572687,27.11,0.33
2573,2021-04-16,CAM,34450,16638,17812,23054,10668,728,ITF,ITF3,15,Campania,Campania,5801692,1607137,27.7,0.59
2574,2021-01-06,CAM,7652,3751,3901,7508,0,144,ITF,ITF3,15,Campania,Campania,5801692,1614789,27.83,0.13
2575,2021-02-18,CAM,9111,3833,5278,8149,727,235,ITF,ITF3,15,Campania,Campania,5801692,1623900,27.99,0.16
2576,2021-06-14,CAM,37132,17921,19211,18706,18023,403,ITF,ITF3,15,Campania,Campania,5801692,1661032,28.63,0.64
2577,2021-08-10,CAM,21640,11192,10448,13590,6949,1101,ITF,ITF3,15,Campania,Campania,5801692,1682672,29.0,0.37
2578,2021-05-19,CAM,51310,22660,28650,33803,16759,748,ITF,ITF3,15,Campania,Campania,5801692,1733982,29.89,0.88
2579,2021-05-05,CAM,51190,24869,26321,43167,6398,1625,ITF,ITF3,15,Campania,Campania,5801692,1785172,30.77,0.88
2580,2021-06-04,CAM,74587,35845,38742,64434,9135,1018,ITF,ITF3,15,Campania,Campania,5801692,1859759,32.06,1.29
2581,2021-05-21,CAM,63874,29653,34221,42142,20704,1028,ITF,ITF3,15,Campania,Campania,5801692,1923633,33.16,1.1
2582,2021-04-01,CAM,24695,12022,12673,20035,4137,523,ITF,ITF3,15,Campania,Campania,5801692,1948328,33.58,0.43
2583,2021-09-05,CAM,8214,4275,3939,5167,2587,460,ITF,ITF3,15,Campania,Campania,5801692,1956542,33.72,0.14
2584,2021-04-06,CAM,24525,11567,12958,19462,4525,538,ITF,ITF3,15,Campania,Campania,5801692,1981067,34.15,0.42
2585,2021-07-12,CAM,56703,27375,29328,3718,52605,380,ITF,ITF3,15,Campania,Campania,5801692,2037770,35.12,0.98
2586,2020-12-27,CAM,720,422,298,716,0,4,ITF,ITF3,15,Campania,Campania,5801692,2038490,35.14,0.01
2587,2021-07-29,CAM,48517,24353,24164,13504,34139,874,ITF,ITF3,15,Campania,Campania,5801692,2087007,35.97,0.84
2588,2021-04-20,CAM,32168,15551,16617,20234,11324,610,ITF,ITF3,15,Campania,Campania,5801692,2119175,36.53,0.55
2589,2021-06-28,CAM,46538,22744,23794,20397,25414,727,ITF,ITF3,15,Campania,Campania,5801692,2165713,37.33,0.8
2590,2021-03-20,CAM,13990,6531,7459,9974,3739,277,ITF,ITF3,15,Campania,Campania,5801692,2179703,37.57,0.24
2591,2021-08-31,CAM,27771,13965,13806,10827,15973,971,ITF,ITF3,15,Campania,Campania,5801692,2207474,38.05,0.48
2592,2021-02-15,CAM,5472,2516,2956,5150,175,147,ITF,ITF3,15,Campania,Campania,5801692,2212946,38.14,0.09
2593,2021-06-09,CAM,53065,26052,27013,41426,10917,722,ITF,ITF3,15,Campania,Campania,5801692,2266011,39.06,0.91
2594,2021-03-01,CAM,12134,4249,7885,7743,4113,278,ITF,ITF3,15,Campania,Campania,5801692,2278145,39.27,0.21
2595,2021-08-17,CAM,22281,12044,10237,7295,14442,544,ITF,ITF3,15,Campania,Campania,5801692,2300426,39.65,0.38
2596,2021-05-09,CAM,43215,20293,22922,30878,11106,1231,ITF,ITF3,15,Campania,Campania,5801692,2343641,40.4,0.74
2597,2021-07-31,CAM,30727,16215,14512,10560,19598,569,ITF,ITF3,15,Campania,Campania,5801692,2374368,40.93,0.53
2598,2021-05-07,CAM,59789,29215,30574,42330,15967,1492,ITF,ITF3,15,Campania,Campania,5801692,2434157,41.96,1.03
2599,2021-01-27,CAM,7755,3824,3931,168,7582,5,ITF,ITF3,15,Campania,Campania,5801692,2441912,42.09,0.13
2600,2021-03-18,CAM,12181,5384,6797,5789,6193,199,ITF,ITF3,15,Campania,Campania,5801692,2454093,42.3,0.21
2601,2021-03-25,CAM,20329,9658,10671,16328,3507,494,ITF,ITF3,15,Campania,Campania,5801692,2474422,42.65,0.35
2602,2021-05-28,CAM,73082,35333,37749,26269,46182,631,ITF,ITF3,15,Campania,Campania,5801692,2547504,43.91,1.26
2603,2021-05-14,CAM,61046,27584,33462,34772,24737,1537,ITF,ITF3,15,Campania,Campania,5801692,2608550,44.96,1.05
2604,2021-07-10,CAM,66913,32668,34245,2704,63963,246,ITF,ITF3,15,Campania,Campania,5801692,2675463,46.12,1.15
2605,2021-02-27,CAM,13956,4471,9485,11962,1653,341,ITF,ITF3,15,Campania,Campania,5801692,2689419,46.36,0.24
2606,2021-06-16,CAM,31653,15012,16641,20370,10775,508,ITF,ITF3,15,Campania,Campania,5801692,2721072,46.9,0.55
2607,2021-08-12,CAM,18925,9998,8927,12404,5716,805,ITF,ITF3,15,Campania,Campania,5801692,2739997,47.23,0.33
2608,2021-05-02,CAM,43496,21552,21944,31182,11377,937,ITF,ITF3,15,Campania,Campania,5801692,2783493,47.98,0.75
2609,2021-01-22,CAM,1534,783,751,666,854,14,ITF,ITF3,15,Campania,Campania,5801692,2785027,48.0,0.03
2610,2021-06-02,CAM,42942,20183,22759,37636,4730,576,ITF,ITF3,15,Campania,Campania,5801692,2827969,48.74,0.74
2611,2021-02-22,CAM,10698,3298,7400,10150,279,269,ITF,ITF3,15,Campania,Campania,5801692,2838667,48.93,0.18
2612,2021-03-11,CAM,18019,9069,8950,10274,7293,452,ITF,ITF3,15,Campania,Campania,5801692,2856686,49.24,0.31
2613,2021-08-24,CAM,22604,11702,10902,8676,13184,744,ITF,ITF3,15,Campania,Campania,5801692,2879290,49.63,0.39
2614,2021-05-16,CAM,51163,23230,27933,32843,17587,733,ITF,ITF3,15,Campania,Campania,5801692,2930453,50.51,0.88
2615,2021-02-20,CAM,8573,3080,5493,8090,303,180,ITF,ITF3,15,Campania,Campania,5801692,2939026,50.66,0.15
2616,2021-02-03,CAM,8908,4006,4902,843,8029,36,ITF,ITF3,15,Campania,Campania,5801692,2947934,50.81,0.15
2617,2021-05-18,CAM,52277,23283,28994,31860,19729,688,ITF,ITF3,15,Campania,Campania,5801692,3000211,51.71,0.9
2618,2021-01-10,CAM,8165,3736,4429,7963,0,202,ITF,ITF3,15,Campania,Campania,5801692,3008376,51.85,0.14
2619,2021-04-03,CAM,21120,10316,10804,18237,2383,500,ITF,ITF3,15,Campania,Campania,5801692,3029496,52.22,0.36
2620,2021-08-16,CAM,12465,6693,5772,6215,5723,527,ITF,ITF3,15,Campania,Campania,5801692,3041961,52.43,0.21
2621,2021-03-06,CAM,16377,6819,9558,10367,5672,338,ITF,ITF3,15,Campania,Campania,5801692,3058338,52.71,0.28
2622,2021-08-19,CAM,22018,11637,10381,9588,11774,656,ITF,ITF3,15,Campania,Campania,5801692,3080356,53.09,0.38
2623,2021-02-24,CAM,11810,4158,7652,10809,715,286,ITF,ITF3,15,Campania,Campania,5801692,3092166,53.3,0.2
2624,2021-01-05,CAM,7237,3637,3600,7074,0,163,ITF,ITF3,15,Campania,Campania,5801692,3099403,53.42,0.12
2625,2021-02-17,CAM,7418,3229,4189,6212,1073,133,ITF,ITF3,15,Campania,Campania,5801692,3106821,53.55,0.13
2626,2021-04-15,CAM,34352,16666,17686,23764,9906,682,ITF,ITF3,15,Campania,Campania,5801692,3141173,54.14,0.59
2627,2021-05-12,CAM,40938,19980,20958,30585,9171,1182,ITF,ITF3,15,Campania,Campania,5801692,3182111,54.85,0.71
2628,2021-07-08,CAM,61129,29426,31703,5619,55158,352,ITF,ITF3,15,Campania,Campania,5801692,3243240,55.9,1.05
2629,2021-07-14,CAM,51120,24586,26534,4270,46502,348,ITF,ITF3,15,Campania,Campania,5801692,3294360,56.78,0.88
2630,2021-04-05,CAM,11641,5541,6100,8897,2424,320,ITF,ITF3,15,Campania,Campania,5801692,3306001,56.98,0.2
2631,2021-03-17,CAM,11598,5102,6496,4846,6591,161,ITF,ITF3,15,Campania,Campania,5801692,3317599,57.18,0.2
2632,2021-06-11,CAM,70846,34426,36420,63487,6058,1301,ITF,ITF3,15,Campania,Campania,5801692,3388445,58.4,1.22
2633,2021-03-03,CAM,13924,5496,8428,7066,6632,226,ITF,ITF3,15,Campania,Campania,5801692,3402369,58.64,0.24
2634,2021-06-25,CAM,65519,31805,33714,13617,51347,555,ITF,ITF3,15,Campania,Campania,5801692,3467888,59.77,1.13
2635,2021-09-02,CAM,25517,13184,12333,10167,14452,898,ITF,ITF3,15,Campania,Campania,5801692,3493405,60.21,0.44
2636,2021-05-25,CAM,46574,22430,24144,22551,23458,565,ITF,ITF3,15,Campania,Campania,5801692,3539979,61.02,0.8
2637,2021-04-22,CAM,34121,16637,17484,20886,12546,689,ITF,ITF3,15,Campania,Campania,5801692,3574100,61.6,0.59
2638,2021-01-12,CAM,5221,2569,2652,5082,0,139,ITF,ITF3,15,Campania,Campania,5801692,3579321,61.69,0.09
2639,2021-03-08,CAM,14693,6851,7842,9440,4781,472,ITF,ITF3,15,Campania,Campania,5801692,3594014,61.95,0.25
2640,2021-05-04,CAM,48482,23344,25138,38221,8907,1354,ITF,ITF3,15,Campania,Campania,5801692,3642496,62.78,0.84
2641,2021-01-24,CAM,4123,2120,2003,361,3745,17,ITF,ITF3,15,Campania,Campania,5801692,3646619,62.85,0.07
2642,2021-08-21,CAM,9796,5396,4400,4082,5338,376,ITF,ITF3,15,Campania,Campania,5801692,3656415,63.02,0.17
2643,2021-05-13,CAM,55458,24834,30624,37811,16025,1622,ITF,ITF3,15,Campania,Campania,5801692,3711873,63.98,0.96
2644,2021-07-09,CAM,61508,29781,31727,4312,56842,354,ITF,ITF3,15,Campania,Campania,5801692,3773381,65.04,1.06
2645,2021-01-31,CAM,8070,3712,4358,22,8047,1,ITF,ITF3,15,Campania,Campania,5801692,3781451,65.18,0.14
2646,2021-08-09,CAM,25084,13084,12000,13683,10464,937,ITF,ITF3,15,Campania,Campania,5801692,3806535,65.61,0.43
2647,2021-02-05,CAM,7268,3464,3804,2023,5130,115,ITF,ITF3,15,Campania,Campania,5801692,3813803,65.74,0.13
2648,2021-08-07,CAM,17197,9179,8018,11204,5288,705,ITF,ITF3,15,Campania,Campania,5801692,3831000,66.03,0.3
2649,2021-04-29,CAM,41563,20183,21380,23993,16748,822,ITF,ITF3,15,Campania,Campania,5801692,3872563,66.75,0.72
2650,2021-01-19,CAM,1110,485,625,1055,5,50,ITF,ITF3,15,Campania,Campania,5801692,3873673,66.77,0.02
2651,2021-07-28,CAM,49456,24549,24907,13821,34778,857,ITF,ITF3,15,Campania,Campania,5801692,3923129,67.62,0.85
2652,2021-06-22,CAM,52454,25014,27440,13072,39004,378,ITF,ITF3,15,Campania,Campania,5801692,3975583,68.52,0.9
2653,2021-03-14,CAM,8617,3826,4791,4355,4142,120,ITF,ITF3,15,Campania,Campania,5801692,3984200,68.67,0.15
2654,2021-05-10,CAM,35480,16394,19086,24844,9932,704,ITF,ITF3,15,Campania,Campania,5801692,4019680,69.28,0.61
2655,2021-06-08,CAM,53116,25877,27239,45264,7077,775,ITF,ITF3,15,Campania,Campania,5801692,4072796,70.2,0.92
2656,2021-08-04,CAM,29839,15310,14529,15786,13099,954,ITF,ITF3,15,Campania,Campania,5801692,4102635,70.71,0.51
2657,2021-04-26,CAM,34059,16654,17405,27519,5630,910,ITF,ITF3,15,Campania,Campania,5801692,4136694,71.3,0.59
2658,2021-07-24,CAM,47995,24872,23123,6614,40889,492,ITF,ITF3,15,Campania,Campania,5801692,4184689,72.13,0.83
2659,2021-01-20,CAM,1264,654,610,1233,0,31,ITF,ITF3,15,Campania,Campania,5801692,4185953,72.15,0.02
2660,2021-04-13,CAM,26616,12690,13926,20534,5538,544,ITF,ITF3,15,Campania,Campania,5801692,4212569,72.61,0.46
2661,2021-01-03,CAM,3837,2010,1827,3788,0,49,ITF,ITF3,15,Campania,Campania,5801692,4216406,72.68,0.07
2662,2021-07-05,CAM,63322,30527,32795,12635,49896,791,ITF,ITF3,15,Campania,Campania,5801692,4279728,73.77,1.09
2663,2021-09-07,CAM,20481,10354,10127,9470,10164,847,ITF,ITF3,15,Campania,Campania,5801692,4300209,74.12,0.35
2664,2021-02-08,CAM,5128,2459,2669,4163,815,150,ITF,ITF3,15,Campania,Campania,5801692,4305337,74.21,0.09
2665,2021-02-01,CAM,3988,1814,2174,104,3876,8,ITF,ITF3,15,Campania,Campania,5801692,4309325,74.28,0.07
2666,2021-08-14,CAM,4918,2804,2114,2051,2706,161,ITF,ITF3,15,Campania,Campania,5801692,4314243,74.36,0.08
2667,2021-05-06,CAM,57621,28140,29481,41184,14777,1660,ITF,ITF3,15,Campania,Campania,5801692,4371864,75.35,0.99
2668,2021-09-01,CAM,27219,13717,13502,10236,16121,862,ITF,ITF3,15,Campania,Campania,5801692,4399083,75.82,0.47
2669,2021-08-18,CAM,19593,10344,9249,7740,11291,562,ITF,ITF3,15,Campania,Campania,5801692,4418676,76.16,0.34
2670,2021-05-11,CAM,39891,19252,20639,29521,9407,963,ITF,ITF3,15,Campania,Campania,5801692,4458567,76.85,0.69
2671,2021-07-11,CAM,40868,19670,21198,1002,39775,91,ITF,ITF3,15,Campania,Campania,5801692,4499435,77.55,0.7
2672,2021-02-02,CAM,5733,2811,2922,415,5287,31,ITF,ITF3,15,Campania,Campania,5801692,4505168,77.65,0.1
2673,2021-03-31,CAM,23203,11379,11824,19314,3442,447,ITF,ITF3,15,Campania,Campania,5801692,4528371,78.05,0.4
2674,2021-07-18,CAM,31387,15807,15580,3789,27168,430,ITF,ITF3,15,Campania,Campania,5801692,4559758,78.59,0.54
2675,2021-04-07,CAM,24977,11990,12987,19652,4726,599,ITF,ITF3,15,Campania,Campania,5801692,4584735,79.02,0.43
2676,2021-07-16,CAM,61061,29871,31190,6526,53914,621,ITF,ITF3,15,Campania,Campania,5801692,4645796,80.08,1.05
2677,2021-04-02,CAM,21868,10525,11343,19045,2324,499,ITF,ITF3,15,Campania,Campania,5801692,4667664,80.45,0.38
2678,2021-05-23,CAM,58765,28649,30116,37208,20906,651,ITF,ITF3,15,Campania,Campania,5801692,4726429,81.47,1.01
2679,2021-02-12,CAM,6563,2876,3687,6085,218,260,ITF,ITF3,15,Campania,Campania,5801692,4732992,81.58,0.11
2680,2021-01-29,CAM,10086,4822,5264,67,10015,4,ITF,ITF3,15,Campania,Campania,5801692,4743078,81.75,0.17
2681,2021-06-27,CAM,43560,21452,22108,13991,29073,496,ITF,ITF3,15,Campania,Campania,5801692,4786638,82.5,0.75
2682,2021-03-19,CAM,11153,4979,6174,7076,3877,200,ITF,ITF3,15,Campania,Campania,5801692,4797791,82.7,0.19
2683,2021-06-10,CAM,76017,36712,39305,67656,7108,1253,ITF,ITF3,15,Campania,Campania,5801692,4873808,84.01,1.31
2684,2021-05-08,CAM,56452,27149,29303,39019,15848,1585,ITF,ITF3,15,Campania,Campania,5801692,4930260,84.98,0.97
2685,2021-03-07,CAM,11974,5406,6568,7766,3844,364,ITF,ITF3,15,Campania,Campania,5801692,4942234,85.19,0.21
2686,2021-08-11,CAM,21052,11096,9956,12046,8143,863,ITF,ITF3,15,Campania,Campania,5801692,4963286,85.55,0.36
2687,2021-05-03,CAM,40761,19894,20867,27835,11872,1054,ITF,ITF3,15,Campania,Campania,5801692,5004047,86.25,0.7
2688,2021-06-29,CAM,49360,24017,25343,19694,29144,522,ITF,ITF3,15,Campania,Campania,5801692,5053407,87.1,0.85
2689,2021-06-15,CAM,18686,9095,9591,10985,7420,281,ITF,ITF3,15,Campania,Campania,5801692,5072093,87.42,0.32
2690,2021-07-21,CAM,50181,24428,25753,8369,40889,923,ITF,ITF3,15,Campania,Campania,5801692,5122274,88.29,0.86
2691,2021-01-21,CAM,2106,1125,981,678,1421,7,ITF,ITF3,15,Campania,Campania,5801692,5124380,88.33,0.04
2692,2021-07-23,CAM,61839,30810,31029,8360,52868,611,ITF,ITF3,15,Campania,Campania,5801692,5186219,89.39,1.07
2693,2021-04-14,CAM,27664,13338,14326,18625,8590,449,ITF,ITF3,15,Campania,Campania,5801692,5213883,89.87,0.48
2694,2021-05-01,CAM,46355,22667,23688,29252,16116,987,ITF,ITF3,15,Campania,Campania,5801692,5260238,90.67,0.8
2695,2021-07-06,CAM,56708,27077,29631,15825,40110,773,ITF,ITF3,15,Campania,Campania,5801692,5316946,91.64,0.98
2696,2021-04-12,CAM,23310,10921,12389,19733,3038,539,ITF,ITF3,15,Campania,Campania,5801692,5340256,92.05,0.4
2697,2021-01-02,CAM,3672,1963,1709,3614,0,58,ITF,ITF3,15,Campania,Campania,5801692,5343928,92.11,0.06
2698,2021-06-17,CAM,60216,28867,31349,32706,26800,710,ITF,ITF3,15,Campania,Campania,5801692,5404144,93.15,1.04
2699,2021-07-04,CAM,48824,23766,25058,6161,42321,342,ITF,ITF3,15,Campania,Campania,5801692,5452968,93.99,0.84
2700,2021-03-26,CAM,19870,9326,10544,15598,3818,454,ITF,ITF3,15,Campania,Campania,5801692,5472838,94.33,0.34
2701,2021-03-30,CAM,22059,10582,11477,18560,2959,540,ITF,ITF3,15,Campania,Campania,5801692,5494897,94.71,0.38
2702,2021-04-17,CAM,36203,17518,18685,23934,11518,751,ITF,ITF3,15,Campania,Campania,5801692,5531100,95.34,0.62
2703,2021-06-13,CAM,43429,21244,22185,37889,4731,809,ITF,ITF3,15,Campania,Campania,5801692,5574529,96.08,0.75
2704,2021-05-30,CAM,52171,25453,26718,37954,13329,888,ITF,ITF3,15,Campania,Campania,5801692,5626700,96.98,0.9
2705,2021-02-19,CAM,9588,3569,6019,8684,662,242,ITF,ITF3,15,Campania,Campania,5801692,5636288,97.15,0.17
2706,2021-07-26,CAM,48860,24317,24543,10243,37937,680,ITF,ITF3,15,Campania,Campania,5801692,5685148,97.99,0.84
2707,2021-02-28,CAM,10413,3207,7206,8277,1901,235,ITF,ITF3,15,Campania,Campania,5801692,5695561,98.17,0.18
2708,2021-02-14,CAM,3929,1923,2006,3842,34,53,ITF,ITF3,15,Campania,Campania,5801692,5699490,98.24,0.07
2709,2021-01-26,CAM,7350,3733,3617,335,6994,21,ITF,ITF3,15,Campania,Campania,5801692,5706840,98.37,0.13
2710,2021-04-19,CAM,30774,14828,15946,18644,11578,552,ITF,ITF3,15,Campania,Campania,5801692,5737614,98.9,0.53
2711,2021-01-09,CAM,10563,5022,5541,10300,0,263,ITF,ITF3,15,Campania,Campania,5801692,5748177,99.08,0.18
2712,2021-07-07,CAM,52314,24823,27491,7115,44644,555,ITF,ITF3,15,Campania,Campania,5801692,5800491,99.98,0.9
2713,2021-03-29,CAM,19413,9581,9832,17431,1551,431,ITF,ITF3,15,Campania,Campania,5801692,5819904,100.31,0.33
2714,2021-06-20,CAM,47615,22749,24866,14194,32996,425,ITF,ITF3,15,Campania,Campania,5801692,5867519,101.13,0.82
2715,2021-03-27,CAM,21516,10242,11274,17206,3869,441,ITF,ITF3,15,Campania,Campania,5801692,5889035,101.51,0.37
2716,2021-06-01,CAM,42304,20986,21318,31449,10550,305,ITF,ITF3,15,Campania,Campania,5801692,5931339,102.23,0.73
2717,2021-06-18,CAM,65901,31408,34493,34824,30311,766,ITF,ITF3,15,Campania,Campania,5801692,5997240,103.37,1.14
2718,2021-03-10,CAM,15634,7734,7900,8423,6852,359,ITF,ITF3,15,Campania,Campania,5801692,6012874,103.64,0.27
2719,2020-12-31,CAM,1490,811,679,1470,0,20,ITF,ITF3,15,Campania,Campania,5801692,6014364,103.67,0.03
2720,2021-06-06,CAM,63234,31450,31784,61584,651,999,ITF,ITF3,15,Campania,Campania,5801692,6077598,104.76,1.09
2721,2021-02-26,CAM,13367,4237,9130,11688,1368,311,ITF,ITF3,15,Campania,Campania,5801692,6090965,104.99,0.23
2722,2021-08-02,CAM,41767,21213,20554,13061,28013,693,ITF,ITF3,15,Campania,Campania,5801692,6132732,105.71,0.72
2723,2021-04-24,CAM,36386,17538,18848,24311,11250,825,ITF,ITF3,15,Campania,Campania,5801692,6169118,106.33,0.63
2724,2021-07-19,CAM,43997,21545,22452,5155,38374,468,ITF,ITF3,15,Campania,Campania,5801692,6213115,107.09,0.76
2725,2021-04-10,CAM,28365,13499,14866,22766,4917,682,ITF,ITF3,15,Campania,Campania,5801692,6241480,107.58,0.49
2726,2021-01-07,CAM,8909,4167,4742,8735,0,174,ITF,ITF3,15,Campania,Campania,5801692,6250389,107.73,0.15
2727,2021-03-05,CAM,16826,6670,10156,9830,6672,324,ITF,ITF3,15,Campania,Campania,5801692,6267215,108.02,0.29
2728,2021-01-28,CAM,8851,4130,4721,140,8703,8,ITF,ITF3,15,Campania,Campania,5801692,6276066,108.18,0.15
2729,2021-07-30,CAM,44830,22823,22007,14408,29502,920,ITF,ITF3,15,Campania,Campania,5801692,6320896,108.95,0.77
2730,2021-04-21,CAM,30348,14772,15576,17543,12232,573,ITF,ITF3,15,Campania,Campania,5801692,6351244,109.47,0.52
2731,2021-08-06,CAM,31222,16255,14967,17542,12638,1042,ITF,ITF3,15,Campania,Campania,5801692,6382466,110.01,0.54
2732,2021-08-23,CAM,23712,12356,11356,9521,13347,844,ITF,ITF3,15,Campania,Campania,5801692,6406178,110.42,0.41
2733,2021-05-15,CAM,62822,29087,33735,42071,18875,1876,ITF,ITF3,15,Campania,Campania,5801692,6469000,111.5,1.08
2734,2021-03-12,CAM,14581,7412,7169,8137,6088,356,ITF,ITF3,15,Campania,Campania,5801692,6483581,111.75,0.25
2735,2021-06-03,CAM,72659,35245,37414,60870,10682,1107,ITF,ITF3,15,Campania,Campania,5801692,6556240,113.01,1.25
2736,2021-02-23,CAM,11017,3396,7621,10156,542,319,ITF,ITF3,15,Campania,Campania,5801692,6567257,113.2,0.19
2737,2021-08-25,CAM,22834,12019,10815,8704,13422,708,ITF,ITF3,15,Campania,Campania,5801692,6590091,113.59,0.39
2738,2021-02-21,CAM,5840,2242,3598,5487,228,125,ITF,ITF3,15,Campania,Campania,5801692,6595931,113.69,0.1
2739,2021-08-13,CAM,16869,9152,7717,9721,6604,544,ITF,ITF3,15,Campania,Campania,5801692,6612800,113.98,0.29
2740,2021-01-14,CAM,7082,2983,4099,6816,0,266,ITF,ITF3,15,Campania,Campania,5801692,6619882,114.1,0.12
2741,2021-04-25,CAM,30745,15179,15566,24530,5408,807,ITF,ITF3,15,Campania,Campania,5801692,6650627,114.63,0.53
2742,2021-01-13,CAM,8032,3676,4356,7787,0,245,ITF,ITF3,15,Campania,Campania,5801692,6658659,114.77,0.14
2743,2021-04-18,CAM,27221,13286,13935,17771,8903,547,ITF,ITF3,15,Campania,Campania,5801692,6685880,115.24,0.47
2744,2021-01-08,CAM,10458,4970,5488,10197,0,261,ITF,ITF3,15,Campania,Campania,5801692,6696338,115.42,0.18
2745,2021-04-27,CAM,32170,15632,16538,23425,7930,815,ITF,ITF3,15,Campania,Campania,5801692,6728508,115.97,0.55
2746,2021-06-23,CAM,46773,22094,24679,10585,35800,388,ITF,ITF3,15,Campania,Campania,5801692,6775281,116.78,0.81
2747,2021-08-05,CAM,35173,18029,17144,17289,16832,1052,ITF,ITF3,15,Campania,Campania,5801692,6810454,117.39,0.61
2748,2021-01-15,CAM,5000,2394,2606,4842,0,158,ITF,ITF3,15,Campania,Campania,5801692,6815454,117.47,0.09
2749,2021-06-21,CAM,46922,22686,24236,11206,35293,423,ITF,ITF3,15,Campania,Campania,5801692,6862376,118.28,0.81
2750,2021-03-13,CAM,14525,7043,7482,8944,5283,298,ITF,ITF3,15,Campania,Campania,5801692,6876901,118.53,0.25
2751,2021-03-22,CAM,13188,6352,6836,10813,2046,329,ITF,ITF3,15,Campania,Campania,5801692,6890089,118.76,0.23
2752,2021-02-07,CAM,2929,1382,1547,2066,771,92,ITF,ITF3,15,Campania,Campania,5801692,6893018,118.81,0.05
2753,2021-06-30,CAM,47670,22778,24892,18321,28655,694,ITF,ITF3,15,Campania,Campania,5801692,6940688,119.63,0.82
2754,2021-09-04,CAM,18059,9827,8232,8651,8437,971,ITF,ITF3,15,Campania,Campania,5801692,6958747,119.94,0.31
2755,2021-01-17,CAM,1155,551,604,682,453,20,ITF,ITF3,15,Campania,Campania,5801692,6959902,119.96,0.02
2756,2021-03-15,CAM,13351,6495,6856,8306,4748,297,ITF,ITF3,15,Campania,Campania,5801692,6973253,120.19,0.23
2757,2021-07-02,CAM,55892,27011,28881,14359,40962,571,ITF,ITF3,15,Campania,Campania,5801692,7029145,121.16,0.96
2758,2021-08-28,CAM,17706,9615,8091,5364,11840,502,ITF,ITF3,15,Campania,Campania,5801692,7046851,121.46,0.31
2759,2021-05-27,CAM,73046,35398,37648,25815,46658,573,ITF,ITF3,15,Campania,Campania,5801692,7119897,122.72,1.26
2760,2021-02-16,CAM,5471,2431,3040,4499,787,185,ITF,ITF3,15,Campania,Campania,5801692,7125368,122.82,0.09
2761,2021-05-22,CAM,68133,32557,35576,45600,21659,874,ITF,ITF3,15,Campania,Campania,5801692,7193501,123.99,1.17
2762,2021-08-30,CAM,29100,15012,14088,9743,18545,812,ITF,ITF3,15,Campania,Campania,5801692,7222601,124.49,0.5
2763,2021-03-24,CAM,17922,8369,9553,14573,2958,391,ITF,ITF3,15,Campania,Campania,5801692,7240523,124.8,0.31
2764,2021-05-20,CAM,61040,28271,32769,42258,17797,985,ITF,ITF3,15,Campania,Campania,5801692,7301563,125.85,1.05
2765,2021-02-09,CAM,4654,2209,2445,4229,263,162,ITF,ITF3,15,Campania,Campania,5801692,7306217,125.93,0.08
2766,2021-09-06,CAM,22762,11626,11136,10669,11051,1042,ITF,ITF3,15,Campania,Campania,5801692,7328979,126.32,0.39
2767,2021-05-29,CAM,67880,32282,35598,43064,23963,853,ITF,ITF3,15,Campania,Campania,5801692,7396859,127.49,1.17
2768,2021-07-25,CAM,23224,11803,11421,4217,18739,268,ITF,ITF3,15,Campania,Campania,5801692,7420083,127.9,0.4
2769,2021-03-25,BAS,1885,605,1280,1513,347,25,ITF,ITF5,17,Basilicata,Basilicata,559084,1885,0.34,0.34
2770,2021-01-27,BAS,421,179,242,113,308,0,ITF,ITF5,17,Basilicata,Basilicata,559084,2306,0.41,0.08
2771,2021-02-10,BAS,552,241,311,497,53,2,ITF,ITF5,17,Basilicata,Basilicata,559084,2858,0.51,0.1
2772,2021-05-21,BAS,4578,2321,2257,1480,3086,12,ITF,ITF5,17,Basilicata,Basilicata,559084,7436,1.33,0.82
2773,2021-09-02,BAS,3031,1624,1407,881,2072,78,ITF,ITF5,17,Basilicata,Basilicata,559084,10467,1.87,0.54
2774,2021-01-15,BAS,819,353,466,819,0,0,ITF,ITF5,17,Basilicata,Basilicata,559084,11286,2.02,0.15
2775,2020-12-27,BAS,106,41,65,106,0,0,ITF,ITF5,17,Basilicata,Basilicata,559084,11392,2.04,0.02
2776,2021-03-20,BAS,1307,577,730,276,1024,7,ITF,ITF5,17,Basilicata,Basilicata,559084,12699,2.27,0.23
2777,2021-06-28,BAS,3642,1747,1895,2113,1510,19,ITF,ITF5,17,Basilicata,Basilicata,559084,16341,2.92,0.65
2778,2021-04-08,BAS,788,361,427,760,10,18,ITF,ITF5,17,Basilicata,Basilicata,559084,17129,3.06,0.14
2779,2021-04-22,BAS,5050,2352,2698,3382,1613,55,ITF,ITF5,17,Basilicata,Basilicata,559084,22179,3.97,0.9
2780,2021-07-31,BAS,5472,2880,2592,1826,3590,56,ITF,ITF5,17,Basilicata,Basilicata,559084,27651,4.95,0.98
2781,2021-07-17,BAS,5856,2916,2940,1709,4108,39,ITF,ITF5,17,Basilicata,Basilicata,559084,33507,5.99,1.05
2782,2021-06-30,BAS,3452,1668,1784,2315,1111,26,ITF,ITF5,17,Basilicata,Basilicata,559084,36959,6.61,0.62
2783,2021-06-04,BAS,4832,2289,2543,3749,1046,37,ITF,ITF5,17,Basilicata,Basilicata,559084,41791,7.47,0.86
2784,2021-02-24,BAS,1815,744,1071,1729,75,11,ITF,ITF5,17,Basilicata,Basilicata,559084,43606,7.8,0.32
2785,2021-08-26,BAS,2523,1278,1245,1120,1339,64,ITF,ITF5,17,Basilicata,Basilicata,559084,46129,8.25,0.45
2786,2021-02-22,BAS,1796,777,1019,1735,53,8,ITF,ITF5,17,Basilicata,Basilicata,559084,47925,8.57,0.32
2787,2021-05-30,BAS,2778,1421,1357,920,1853,5,ITF,ITF5,17,Basilicata,Basilicata,559084,50703,9.07,0.5
2788,2021-04-03,BAS,1816,755,1061,1465,338,13,ITF,ITF5,17,Basilicata,Basilicata,559084,52519,9.39,0.32
2789,2021-09-07,BAS,2659,1372,1287,679,1908,72,ITF,ITF5,17,Basilicata,Basilicata,559084,55178,9.87,0.48
2790,2021-08-24,BAS,3268,1767,1501,1478,1713,77,ITF,ITF5,17,Basilicata,Basilicata,559084,58446,10.45,0.58
2791,2021-08-12,BAS,3918,2000,1918,1677,2159,82,ITF,ITF5,17,Basilicata,Basilicata,559084,62364,11.15,0.7
2792,2021-07-26,BAS,5416,2720,2696,1991,3387,38,ITF,ITF5,17,Basilicata,Basilicata,559084,67780,12.12,0.97
2793,2021-01-22,BAS,67,24,43,67,0,0,ITF,ITF5,17,Basilicata,Basilicata,559084,67847,12.14,0.01
2794,2021-07-24,BAS,5750,2946,2804,1776,3924,50,ITF,ITF5,17,Basilicata,Basilicata,559084,73597,13.16,1.03
2795,2021-05-04,BAS,4142,1994,2148,3568,524,50,ITF,ITF5,17,Basilicata,Basilicata,559084,77739,13.9,0.74
2796,2021-03-08,BAS,1474,723,751,821,621,32,ITF,ITF5,17,Basilicata,Basilicata,559084,79213,14.17,0.26
2797,2021-06-16,BAS,4606,2086,2520,2126,2460,20,ITF,ITF5,17,Basilicata,Basilicata,559084,83819,14.99,0.82
2798,2021-01-10,BAS,77,24,53,77,0,0,ITF,ITF5,17,Basilicata,Basilicata,559084,83896,15.01,0.01
2799,2021-04-20,BAS,4148,1982,2166,2179,1941,28,ITF,ITF5,17,Basilicata,Basilicata,559084,88044,15.75,0.74
2800,2021-08-07,BAS,4516,2376,2140,1361,3096,59,ITF,ITF5,17,Basilicata,Basilicata,559084,92560,16.56,0.81
2801,2021-01-08,BAS,556,220,336,556,0,0,ITF,ITF5,17,Basilicata,Basilicata,559084,93116,16.66,0.1
2802,2021-04-01,BAS,2735,1119,1616,1967,737,31,ITF,ITF5,17,Basilicata,Basilicata,559084,95851,17.14,0.49
2803,2021-02-03,BAS,675,305,370,32,643,0,ITF,ITF5,17,Basilicata,Basilicata,559084,96526,17.27,0.12
2804,2021-03-06,BAS,1376,544,832,752,611,13,ITF,ITF5,17,Basilicata,Basilicata,559084,97902,17.51,0.25
2805,2021-05-09,BAS,4685,2339,2346,2942,1694,49,ITF,ITF5,17,Basilicata,Basilicata,559084,102587,18.35,0.84
2806,2021-02-15,BAS,635,240,395,575,44,16,ITF,ITF5,17,Basilicata,Basilicata,559084,103222,18.46,0.11
2807,2021-01-29,BAS,619,233,386,63,556,0,ITF,ITF5,17,Basilicata,Basilicata,559084,103841,18.57,0.11
2808,2021-02-17,BAS,1137,493,644,1058,77,2,ITF,ITF5,17,Basilicata,Basilicata,559084,104978,18.78,0.2
2809,2021-05-28,BAS,3617,1811,1806,918,2666,33,ITF,ITF5,17,Basilicata,Basilicata,559084,108595,19.42,0.65
2810,2021-06-11,BAS,4236,1982,2254,3166,1028,42,ITF,ITF5,17,Basilicata,Basilicata,559084,112831,20.18,0.76
2811,2021-08-19,BAS,3596,1871,1725,1672,1836,88,ITF,ITF5,17,Basilicata,Basilicata,559084,116427,20.82,0.64
2812,2021-05-11,BAS,2654,1353,1301,1597,1033,24,ITF,ITF5,17,Basilicata,Basilicata,559084,119081,21.3,0.47
2813,2021-06-23,BAS,3241,1522,1719,2332,876,33,ITF,ITF5,17,Basilicata,Basilicata,559084,122322,21.88,0.58
2814,2021-03-13,BAS,1809,895,914,740,1049,20,ITF,ITF5,17,Basilicata,Basilicata,559084,124131,22.2,0.32
2815,2021-02-07,BAS,382,161,221,49,333,0,ITF,ITF5,17,Basilicata,Basilicata,559084,124513,22.27,0.07
2816,2021-05-02,BAS,4182,2001,2181,3489,629,64,ITF,ITF5,17,Basilicata,Basilicata,559084,128695,23.02,0.75
2817,2021-04-15,BAS,3431,1679,1752,2586,799,46,ITF,ITF5,17,Basilicata,Basilicata,559084,132126,23.63,0.61
2818,2021-07-07,BAS,5203,2470,2733,2019,3169,15,ITF,ITF5,17,Basilicata,Basilicata,559084,137329,24.56,0.93
2819,2021-01-03,BAS,910,347,563,910,0,0,ITF,ITF5,17,Basilicata,Basilicata,559084,138239,24.73,0.16
2820,2021-06-09,BAS,4423,2072,2351,3967,423,33,ITF,ITF5,17,Basilicata,Basilicata,559084,142662,25.52,0.79
2821,2021-04-13,BAS,2120,1054,1066,1279,823,18,ITF,ITF5,17,Basilicata,Basilicata,559084,144782,25.9,0.38
2822,2021-03-01,BAS,553,286,267,384,169,0,ITF,ITF5,17,Basilicata,Basilicata,559084,145335,26.0,0.1
2823,2021-08-14,BAS,3478,1906,1572,1421,1997,60,ITF,ITF5,17,Basilicata,Basilicata,559084,148813,26.62,0.62
2824,2021-06-18,BAS,4465,2066,2399,2179,2259,27,ITF,ITF5,17,Basilicata,Basilicata,559084,153278,27.42,0.8
2825,2021-08-23,BAS,3315,1736,1579,1369,1864,82,ITF,ITF5,17,Basilicata,Basilicata,559084,156593,28.01,0.59
2826,2021-03-15,BAS,2377,994,1383,509,1850,18,ITF,ITF5,17,Basilicata,Basilicata,559084,158970,28.43,0.43
2827,2021-01-17,BAS,331,133,198,330,1,0,ITF,ITF5,17,Basilicata,Basilicata,559084,159301,28.49,0.06
2828,2021-04-27,BAS,4729,2243,2486,4348,327,54,ITF,ITF5,17,Basilicata,Basilicata,559084,164030,29.34,0.85
2829,2021-08-05,BAS,4556,2319,2237,1283,3232,41,ITF,ITF5,17,Basilicata,Basilicata,559084,168586,30.15,0.81
2830,2021-02-05,BAS,998,449,549,64,932,2,ITF,ITF5,17,Basilicata,Basilicata,559084,169584,30.33,0.18
2831,2021-07-12,BAS,5441,2592,2849,1606,3809,26,ITF,ITF5,17,Basilicata,Basilicata,559084,175025,31.31,0.97
2832,2021-05-16,BAS,4973,2468,2505,2811,2113,49,ITF,ITF5,17,Basilicata,Basilicata,559084,179998,32.2,0.89
2833,2021-07-19,BAS,5926,2890,3036,1998,3886,42,ITF,ITF5,17,Basilicata,Basilicata,559084,185924,33.26,1.06
2834,2021-05-23,BAS,4518,2302,2216,1527,2984,7,ITF,ITF5,17,Basilicata,Basilicata,559084,190442,34.06,0.81
2835,2021-06-01,BAS,6137,2927,3210,3034,3076,27,ITF,ITF5,17,Basilicata,Basilicata,559084,196579,35.16,1.1
2836,2021-08-04,BAS,4500,2232,2268,1424,3035,41,ITF,ITF5,17,Basilicata,Basilicata,559084,201079,35.97,0.8
2837,2021-06-08,BAS,4587,2195,2392,4191,358,38,ITF,ITF5,17,Basilicata,Basilicata,559084,205666,36.79,0.82
2838,2021-03-05,BAS,1876,865,1011,1102,759,15,ITF,ITF5,17,Basilicata,Basilicata,559084,207542,37.12,0.34
2839,2021-06-13,BAS,3014,1440,1574,2678,308,28,ITF,ITF5,17,Basilicata,Basilicata,559084,210556,37.66,0.54
2840,2021-05-27,BAS,3623,1863,1760,1073,2536,14,ITF,ITF5,17,Basilicata,Basilicata,559084,214179,38.31,0.65
2841,2021-09-04,BAS,2605,1397,1208,773,1764,68,ITF,ITF5,17,Basilicata,Basilicata,559084,216784,38.77,0.47
2842,2021-04-24,BAS,4583,2221,2362,3476,1051,56,ITF,ITF5,17,Basilicata,Basilicata,559084,221367,39.59,0.82
2843,2021-08-02,BAS,4609,2334,2275,1779,2790,40,ITF,ITF5,17,Basilicata,Basilicata,559084,225976,40.42,0.82
2844,2021-07-16,BAS,5932,2899,3033,1802,4096,34,ITF,ITF5,17,Basilicata,Basilicata,559084,231908,41.48,1.06
2845,2021-03-19,BAS,2313,1003,1310,260,2046,7,ITF,ITF5,17,Basilicata,Basilicata,559084,234221,41.89,0.41
2846,2021-07-14,BAS,5641,2721,2920,1627,3989,25,ITF,ITF5,17,Basilicata,Basilicata,559084,239862,42.9,1.01
2847,2021-04-05,BAS,728,235,493,413,305,10,ITF,ITF5,17,Basilicata,Basilicata,559084,240590,43.03,0.13
2848,2021-03-22,BAS,1222,549,673,641,573,8,ITF,ITF5,17,Basilicata,Basilicata,559084,241812,43.25,0.22
2849,2021-03-03,BAS,1799,840,959,1214,563,22,ITF,ITF5,17,Basilicata,Basilicata,559084,243611,43.57,0.32
2850,2021-05-25,BAS,4200,2114,2086,868,3322,10,ITF,ITF5,17,Basilicata,Basilicata,559084,247811,44.32,0.75
2851,2021-02-14,BAS,151,48,103,105,0,46,ITF,ITF5,17,Basilicata,Basilicata,559084,247962,44.35,0.03
2852,2021-01-31,BAS,78,24,54,0,78,0,ITF,ITF5,17,Basilicata,Basilicata,559084,248040,44.37,0.01
2853,2021-01-12,BAS,217,88,129,217,0,0,ITF,ITF5,17,Basilicata,Basilicata,559084,248257,44.4,0.04
2854,2021-05-18,BAS,5895,2855,3040,3379,2492,24,ITF,ITF5,17,Basilicata,Basilicata,559084,254152,45.46,1.05
2855,2021-08-09,BAS,4012,2067,1945,1569,2396,47,ITF,ITF5,17,Basilicata,Basilicata,559084,258164,46.18,0.72
2856,2021-07-23,BAS,5551,2781,2770,1889,3616,46,ITF,ITF5,17,Basilicata,Basilicata,559084,263715,47.17,0.99
2857,2021-05-01,BAS,4708,2139,2569,3883,755,70,ITF,ITF5,17,Basilicata,Basilicata,559084,268423,48.01,0.84
2858,2021-04-12,BAS,2176,1054,1122,1652,494,30,ITF,ITF5,17,Basilicata,Basilicata,559084,270599,48.4,0.39
2859,2021-07-21,BAS,5845,2942,2903,1611,4201,33,ITF,ITF5,17,Basilicata,Basilicata,559084,276444,49.45,1.05
2860,2021-04-19,BAS,4182,1920,2262,2395,1653,134,ITF,ITF5,17,Basilicata,Basilicata,559084,280626,50.19,0.75
2861,2021-07-28,BAS,5044,2580,2464,1936,3048,60,ITF,ITF5,17,Basilicata,Basilicata,559084,285670,51.1,0.9
2862,2021-06-15,BAS,3222,1417,1805,2225,976,21,ITF,ITF5,17,Basilicata,Basilicata,559084,288892,51.67,0.58
2863,2021-06-27,BAS,3007,1477,1530,2377,616,14,ITF,ITF5,17,Basilicata,Basilicata,559084,291899,52.21,0.54
2864,2021-04-29,BAS,4859,2399,2460,4342,441,76,ITF,ITF5,17,Basilicata,Basilicata,559084,296758,53.08,0.87
2865,2021-03-17,BAS,1471,615,856,24,1443,4,ITF,ITF5,17,Basilicata,Basilicata,559084,298229,53.34,0.26
2866,2021-01-19,BAS,199,84,115,199,0,0,ITF,ITF5,17,Basilicata,Basilicata,559084,298428,53.38,0.04
2867,2021-06-25,BAS,3317,1571,1746,2444,839,34,ITF,ITF5,17,Basilicata,Basilicata,559084,301745,53.97,0.59
2868,2021-07-04,BAS,3112,1563,1549,2164,922,26,ITF,ITF5,17,Basilicata,Basilicata,559084,304857,54.53,0.56
2869,2021-07-09,BAS,5338,2608,2730,1696,3633,9,ITF,ITF5,17,Basilicata,Basilicata,559084,310195,55.48,0.95
2870,2021-04-17,BAS,3461,1655,1806,2170,1262,29,ITF,ITF5,17,Basilicata,Basilicata,559084,313656,56.1,0.62
2871,2021-03-29,BAS,2482,898,1584,2141,288,53,ITF,ITF5,17,Basilicata,Basilicata,559084,316138,56.55,0.44
2872,2021-01-05,BAS,952,410,542,952,0,0,ITF,ITF5,17,Basilicata,Basilicata,559084,317090,56.72,0.17
2873,2021-06-20,BAS,4010,1883,2127,1939,2036,35,ITF,ITF5,17,Basilicata,Basilicata,559084,321100,57.43,0.72
2874,2021-08-20,BAS,3123,1679,1444,1452,1593,78,ITF,ITF5,17,Basilicata,Basilicata,559084,324223,57.99,0.56
2875,2021-02-16,BAS,908,377,531,791,98,19,ITF,ITF5,17,Basilicata,Basilicata,559084,325131,58.15,0.16
2876,2021-01-28,BAS,919,407,512,119,800,0,ITF,ITF5,17,Basilicata,Basilicata,559084,326050,58.32,0.16
2877,2021-08-30,BAS,3200,1712,1488,1550,1546,104,ITF,ITF5,17,Basilicata,Basilicata,559084,329250,58.89,0.57
2878,2021-03-24,BAS,2002,771,1231,1482,494,26,ITF,ITF5,17,Basilicata,Basilicata,559084,331252,59.25,0.36
2879,2021-07-02,BAS,3689,1839,1850,2484,1176,29,ITF,ITF5,17,Basilicata,Basilicata,559084,334941,59.91,0.66
2880,2021-02-28,BAS,813,347,466,772,37,4,ITF,ITF5,17,Basilicata,Basilicata,559084,335754,60.05,0.15
2881,2021-01-02,BAS,957,383,574,956,0,1,ITF,ITF5,17,Basilicata,Basilicata,559084,336711,60.23,0.17
2882,2021-01-16,BAS,725,305,420,725,0,0,ITF,ITF5,17,Basilicata,Basilicata,559084,337436,60.36,0.13
2883,2021-04-26,BAS,4466,2164,2302,4197,221,48,ITF,ITF5,17,Basilicata,Basilicata,559084,341902,61.15,0.8
2884,2021-03-27,BAS,2257,866,1391,1809,434,14,ITF,ITF5,17,Basilicata,Basilicata,559084,344159,61.56,0.4
2885,2021-08-31,BAS,3097,1592,1505,1677,1275,145,ITF,ITF5,17,Basilicata,Basilicata,559084,347256,62.11,0.55
2886,2021-07-05,BAS,3272,1616,1656,2214,1023,35,ITF,ITF5,17,Basilicata,Basilicata,559084,350528,62.7,0.59
2887,2021-01-07,BAS,644,321,323,644,0,0,ITF,ITF5,17,Basilicata,Basilicata,559084,351172,62.81,0.12
2888,2021-09-06,BAS,3017,1569,1448,748,2191,78,ITF,ITF5,17,Basilicata,Basilicata,559084,354189,63.35,0.54
2889,2021-05-10,BAS,4803,2382,2421,2708,2042,53,ITF,ITF5,17,Basilicata,Basilicata,559084,358992,64.21,0.86
2890,2021-08-18,BAS,3571,1975,1596,1499,1976,96,ITF,ITF5,17,Basilicata,Basilicata,559084,362563,64.85,0.64
2891,2021-07-18,BAS,4389,2163,2226,1577,2785,27,ITF,ITF5,17,Basilicata,Basilicata,559084,366952,65.63,0.79
2892,2021-08-01,BAS,4210,2114,2096,1633,2537,40,ITF,ITF5,17,Basilicata,Basilicata,559084,371162,66.39,0.75
2893,2021-06-29,BAS,3856,1880,1976,2785,1043,28,ITF,ITF5,17,Basilicata,Basilicata,559084,375018,67.08,0.69
2894,2021-03-21,BAS,1177,547,630,474,700,3,ITF,ITF5,17,Basilicata,Basilicata,559084,376195,67.29,0.21
2895,2021-05-29,BAS,3060,1534,1526,824,2225,11,ITF,ITF5,17,Basilicata,Basilicata,559084,379255,67.84,0.55
2896,2021-09-01,BAS,3250,1685,1565,1047,2104,99,ITF,ITF5,17,Basilicata,Basilicata,559084,382505,68.42,0.58
2897,2021-02-11,BAS,958,406,552,873,83,2,ITF,ITF5,17,Basilicata,Basilicata,559084,383463,68.59,0.17
2898,2021-05-22,BAS,5493,2725,2768,1929,3553,11,ITF,ITF5,17,Basilicata,Basilicata,559084,388956,69.57,0.98
2899,2021-03-26,BAS,1957,703,1254,1668,261,28,ITF,ITF5,17,Basilicata,Basilicata,559084,390913,69.92,0.35
2900,2021-03-14,BAS,1013,479,534,530,471,12,ITF,ITF5,17,Basilicata,Basilicata,559084,391926,70.1,0.18
2901,2021-03-31,BAS,3122,1273,1849,2301,791,30,ITF,ITF5,17,Basilicata,Basilicata,559084,395048,70.66,0.56
2902,2021-06-22,BAS,4355,2061,2294,2223,2100,32,ITF,ITF5,17,Basilicata,Basilicata,559084,399403,71.44,0.78
2903,2021-06-05,BAS,4800,2210,2590,3823,941,36,ITF,ITF5,17,Basilicata,Basilicata,559084,404203,72.3,0.86
2904,2021-08-27,BAS,2479,1313,1166,999,1410,70,ITF,ITF5,17,Basilicata,Basilicata,559084,406682,72.74,0.44
2905,2021-08-08,BAS,3664,1873,1791,1115,2520,29,ITF,ITF5,17,Basilicata,Basilicata,559084,410346,73.4,0.66
2906,2021-02-21,BAS,284,113,171,284,0,0,ITF,ITF5,17,Basilicata,Basilicata,559084,410630,73.45,0.05
2907,2021-03-07,BAS,897,313,584,847,40,10,ITF,ITF5,17,Basilicata,Basilicata,559084,411527,73.61,0.16
2908,2021-01-09,BAS,560,161,399,560,0,0,ITF,ITF5,17,Basilicata,Basilicata,559084,412087,73.71,0.1
2909,2021-08-29,BAS,2331,1249,1082,1255,979,97,ITF,ITF5,17,Basilicata,Basilicata,559084,414418,74.12,0.42
2910,2021-07-03,BAS,3946,2104,1842,2756,1144,46,ITF,ITF5,17,Basilicata,Basilicata,559084,418364,74.83,0.71
2911,2021-05-07,BAS,4639,2281,2358,3267,1340,32,ITF,ITF5,17,Basilicata,Basilicata,559084,423003,75.66,0.83
2912,2021-08-15,BAS,2705,1431,1274,1137,1528,40,ITF,ITF5,17,Basilicata,Basilicata,559084,425708,76.14,0.48
2913,2021-02-26,BAS,2160,907,1253,2072,82,6,ITF,ITF5,17,Basilicata,Basilicata,559084,427868,76.53,0.39
2914,2021-05-20,BAS,5886,2982,2904,2887,2971,28,ITF,ITF5,17,Basilicata,Basilicata,559084,433754,77.58,1.05
2915,2021-08-28,BAS,2275,1287,988,1110,1105,60,ITF,ITF5,17,Basilicata,Basilicata,559084,436029,77.99,0.41
2916,2021-06-06,BAS,4512,2074,2438,3695,779,38,ITF,ITF5,17,Basilicata,Basilicata,559084,440541,78.8,0.81
2917,2021-08-11,BAS,3709,1922,1787,1428,2223,58,ITF,ITF5,17,Basilicata,Basilicata,559084,444250,79.46,0.66
2918,2021-02-19,BAS,1627,739,888,1559,63,5,ITF,ITF5,17,Basilicata,Basilicata,559084,445877,79.75,0.29
2919,2021-02-12,BAS,781,334,447,748,32,1,ITF,ITF5,17,Basilicata,Basilicata,559084,446658,79.89,0.14
2920,2021-04-10,BAS,1035,379,656,923,84,28,ITF,ITF5,17,Basilicata,Basilicata,559084,447693,80.08,0.19
2921,2021-01-13,BAS,917,387,530,917,0,0,ITF,ITF5,17,Basilicata,Basilicata,559084,448610,80.24,0.16
2922,2021-04-23,BAS,4551,2191,2360,3477,1013,61,ITF,ITF5,17,Basilicata,Basilicata,559084,453161,81.05,0.81
2923,2021-01-30,BAS,713,230,483,129,584,0,ITF,ITF5,17,Basilicata,Basilicata,559084,453874,81.18,0.13
2924,2021-09-08,BAS,2822,1493,1329,768,2005,49,ITF,ITF5,17,Basilicata,Basilicata,559084,456696,81.69,0.5
2925,2021-02-13,BAS,802,314,488,703,61,38,ITF,ITF5,17,Basilicata,Basilicata,559084,457498,81.83,0.14
2926,2021-05-24,BAS,4833,2344,2489,1087,3733,13,ITF,ITF5,17,Basilicata,Basilicata,559084,462331,82.69,0.86
2927,2021-07-29,BAS,4858,2525,2333,1909,2902,47,ITF,ITF5,17,Basilicata,Basilicata,559084,467189,83.56,0.87
2928,2021-06-02,BAS,5962,2806,3156,4375,1544,43,ITF,ITF5,17,Basilicata,Basilicata,559084,473151,84.63,1.07
2929,2021-04-18,BAS,3720,1843,1877,2327,1370,23,ITF,ITF5,17,Basilicata,Basilicata,559084,476871,85.3,0.67
2930,2021-02-20,BAS,1169,536,633,1050,119,0,ITF,ITF5,17,Basilicata,Basilicata,559084,478040,85.5,0.21
2931,2021-07-27,BAS,4720,2371,2349,1815,2855,50,ITF,ITF5,17,Basilicata,Basilicata,559084,482760,86.35,0.84
2932,2021-05-31,BAS,4230,2010,2220,1713,2509,8,ITF,ITF5,17,Basilicata,Basilicata,559084,486990,87.1,0.76
2933,2021-02-18,BAS,1075,404,671,855,217,3,ITF,ITF5,17,Basilicata,Basilicata,559084,488065,87.3,0.19
2934,2021-01-14,BAS,973,413,560,973,0,0,ITF,ITF5,17,Basilicata,Basilicata,559084,489038,87.47,0.17
2935,2021-04-07,BAS,1212,552,660,1156,36,20,ITF,ITF5,17,Basilicata,Basilicata,559084,490250,87.69,0.22
2936,2021-04-25,BAS,2990,1459,1531,2906,52,32,ITF,ITF5,17,Basilicata,Basilicata,559084,493240,88.22,0.53
2937,2021-08-03,BAS,5059,2573,2486,1827,3183,49,ITF,ITF5,17,Basilicata,Basilicata,559084,498299,89.13,0.9
2938,2021-08-17,BAS,3508,1763,1745,1398,2044,66,ITF,ITF5,17,Basilicata,Basilicata,559084,501807,89.76,0.63
2939,2021-05-12,BAS,4730,2330,2400,2800,1881,49,ITF,ITF5,17,Basilicata,Basilicata,559084,506537,90.6,0.85
2940,2021-07-15,BAS,6479,3211,3268,1668,4785,26,ITF,ITF5,17,Basilicata,Basilicata,559084,513016,91.76,1.16
2941,2021-04-06,BAS,1275,465,810,1073,184,18,ITF,ITF5,17,Basilicata,Basilicata,559084,514291,91.99,0.23
2942,2021-06-14,BAS,4825,2156,2669,2090,2711,24,ITF,ITF5,17,Basilicata,Basilicata,559084,519116,92.85,0.86
2943,2021-07-10,BAS,5529,2668,2861,1595,3925,9,ITF,ITF5,17,Basilicata,Basilicata,559084,524645,93.84,0.99
2944,2021-05-14,BAS,5909,2798,3111,3274,2530,105,ITF,ITF5,17,Basilicata,Basilicata,559084,530554,94.9,1.06
2945,2021-03-18,BAS,1362,569,793,17,1336,9,ITF,ITF5,17,Basilicata,Basilicata,559084,531916,95.14,0.24
2946,2021-08-22,BAS,2443,1282,1161,1023,1371,49,ITF,ITF5,17,Basilicata,Basilicata,559084,534359,95.58,0.44
2947,2021-06-26,BAS,3338,1615,1723,2751,558,29,ITF,ITF5,17,Basilicata,Basilicata,559084,537697,96.17,0.6
2948,2021-02-23,BAS,1910,772,1138,1751,141,18,ITF,ITF5,17,Basilicata,Basilicata,559084,539607,96.52,0.34
2949,2021-06-03,BAS,4922,2258,2664,3703,1181,38,ITF,ITF5,17,Basilicata,Basilicata,559084,544529,97.4,0.88
2950,2021-03-12,BAS,1921,986,935,786,1107,28,ITF,ITF5,17,Basilicata,Basilicata,559084,546450,97.74,0.34
2951,2021-05-17,BAS,5548,2735,2813,3362,2136,50,ITF,ITF5,17,Basilicata,Basilicata,559084,551998,98.73,0.99
2952,2021-08-25,BAS,2682,1407,1275,1259,1339,84,ITF,ITF5,17,Basilicata,Basilicata,559084,554680,99.21,0.48
2953,2021-02-08,BAS,565,194,371,154,411,0,ITF,ITF5,17,Basilicata,Basilicata,559084,555245,99.31,0.1
2954,2021-05-19,BAS,2872,1499,1373,1183,1676,13,ITF,ITF5,17,Basilicata,Basilicata,559084,558117,99.83,0.51
2955,2021-02-25,BAS,1795,740,1055,1737,47,11,ITF,ITF5,17,Basilicata,Basilicata,559084,559912,100.15,0.32
2956,2021-08-10,BAS,4415,2325,2090,1513,2831,71,ITF,ITF5,17,Basilicata,Basilicata,559084,564327,100.94,0.79
2957,2021-06-24,BAS,4091,1940,2151,2152,1902,37,ITF,ITF5,17,Basilicata,Basilicata,559084,568418,101.67,0.73
2958,2021-04-28,BAS,4709,2159,2550,4207,441,61,ITF,ITF5,17,Basilicata,Basilicata,559084,573127,102.51,0.84
2959,2021-03-02,BAS,803,387,416,660,138,5,ITF,ITF5,17,Basilicata,Basilicata,559084,573930,102.66,0.14
2960,2021-08-06,BAS,4215,2158,2057,1316,2846,53,ITF,ITF5,17,Basilicata,Basilicata,559084,578145,103.41,0.75
2961,2021-06-10,BAS,4346,2101,2245,3867,442,37,ITF,ITF5,17,Basilicata,Basilicata,559084,582491,104.19,0.78
2962,2021-09-05,BAS,2282,1205,1077,466,1783,33,ITF,ITF5,17,Basilicata,Basilicata,559084,584773,104.59,0.41
2963,2021-03-04,BAS,1903,903,1000,1070,809,24,ITF,ITF5,17,Basilicata,Basilicata,559084,586676,104.94,0.34
2964,2021-06-12,BAS,3686,1694,1992,2959,689,38,ITF,ITF5,17,Basilicata,Basilicata,559084,590362,105.59,0.66
2965,2021-04-14,BAS,2047,1002,1045,1354,677,16,ITF,ITF5,17,Basilicata,Basilicata,559084,592409,105.96,0.37
2966,2021-01-21,BAS,31,10,21,30,1,0,ITF,ITF5,17,Basilicata,Basilicata,559084,592440,105.97,0.01
2967,2021-01-04,BAS,614,275,339,614,0,0,ITF,ITF5,17,Basilicata,Basilicata,559084,593054,106.08,0.11
2968,2021-07-06,BAS,4211,2009,2202,2115,2060,36,ITF,ITF5,17,Basilicata,Basilicata,559084,597265,106.83,0.75
2969,2021-01-23,BAS,756,319,437,33,723,0,ITF,ITF5,17,Basilicata,Basilicata,559084,598021,106.96,0.14
2970,2021-05-03,BAS,4511,2043,2468,3620,827,64,ITF,ITF5,17,Basilicata,Basilicata,559084,602532,107.77,0.81
2971,2021-02-09,BAS,495,216,279,317,178,0,ITF,ITF5,17,Basilicata,Basilicata,559084,603027,107.86,0.09
2972,2021-07-25,BAS,4479,2254,2225,1607,2848,24,ITF,ITF5,17,Basilicata,Basilicata,559084,607506,108.66,0.8
2973,2021-08-13,BAS,3661,1904,1757,1423,2147,91,ITF,ITF5,17,Basilicata,Basilicata,559084,611167,109.32,0.65
2974,2021-07-30,BAS,4768,2436,2332,1917,2802,49,ITF,ITF5,17,Basilicata,Basilicata,559084,615935,110.17,0.85
2975,2021-06-17,BAS,4443,2045,2398,2088,2330,25,ITF,ITF5,17,Basilicata,Basilicata,559084,620378,110.96,0.79
2976,2021-04-21,BAS,3951,1845,2106,2242,1679,30,ITF,ITF5,17,Basilicata,Basilicata,559084,624329,111.67,0.71
2977,2021-01-18,BAS,465,158,307,366,99,0,ITF,ITF5,17,Basilicata,Basilicata,559084,624794,111.75,0.08
2978,2021-03-16,BAS,1924,808,1116,226,1695,3,ITF,ITF5,17,Basilicata,Basilicata,559084,626718,112.1,0.34
2979,2021-02-06,BAS,927,381,546,146,781,0,ITF,ITF5,17,Basilicata,Basilicata,559084,627645,112.26,0.17
2980,2021-04-30,BAS,5288,2377,2911,4064,1163,61,ITF,ITF5,17,Basilicata,Basilicata,559084,632933,113.21,0.95
2981,2021-01-20,BAS,85,22,63,84,1,0,ITF,ITF5,17,Basilicata,Basilicata,559084,633018,113.22,0.02
2982,2021-03-23,BAS,1644,634,1010,1454,170,20,ITF,ITF5,17,Basilicata,Basilicata,559084,634662,113.52,0.29
2983,2021-07-01,BAS,3711,1856,1855,2564,1113,34,ITF,ITF5,17,Basilicata,Basilicata,559084,638373,114.18,0.66
2984,2021-09-03,BAS,2878,1528,1350,762,2052,64,ITF,ITF5,17,Basilicata,Basilicata,559084,641251,114.7,0.51
2985,2021-02-01,BAS,248,94,154,46,202,0,ITF,ITF5,17,Basilicata,Basilicata,559084,641499,114.74,0.04
2986,2021-05-26,BAS,4489,2260,2229,1676,2784,29,ITF,ITF5,17,Basilicata,Basilicata,559084,645988,115.54,0.8
2987,2021-06-21,BAS,4258,2045,2213,2142,2095,21,ITF,ITF5,17,Basilicata,Basilicata,559084,650246,116.31,0.76
2988,2021-06-19,BAS,4469,2179,2290,2373,2074,22,ITF,ITF5,17,Basilicata,Basilicata,559084,654715,117.1,0.8
2989,2021-03-28,BAS,2147,746,1401,2111,19,17,ITF,ITF5,17,Basilicata,Basilicata,559084,656862,117.49,0.38
2990,2021-03-11,BAS,1800,931,869,819,963,18,ITF,ITF5,17,Basilicata,Basilicata,559084,658662,117.81,0.32
2991,2021-03-30,BAS,2868,1219,1649,2494,358,16,ITF,ITF5,17,Basilicata,Basilicata,559084,661530,118.32,0.51
2992,2021-07-08,BAS,5137,2429,2708,1852,3260,25,ITF,ITF5,17,Basilicata,Basilicata,559084,666667,119.24,0.92
2993,2021-01-06,BAS,296,130,166,296,0,0,ITF,ITF5,17,Basilicata,Basilicata,559084,666963,119.3,0.05
2994,2021-04-16,BAS,3324,1635,1689,2398,901,25,ITF,ITF5,17,Basilicata,Basilicata,559084,670287,119.89,0.59
2995,2021-05-05,BAS,4338,2050,2288,3376,891,71,ITF,ITF5,17,Basilicata,Basilicata,559084,674625,120.67,0.78
2996,2021-03-09,BAS,1413,723,690,780,612,21,ITF,ITF5,17,Basilicata,Basilicata,559084,676038,120.92,0.25
2997,2021-01-25,BAS,1045,439,606,74,970,1,ITF,ITF5,17,Basilicata,Basilicata,559084,677083,121.11,0.19
2998,2021-01-11,BAS,186,67,119,186,0,0,ITF,ITF5,17,Basilicata,Basilicata,559084,677269,121.14,0.03
2999,2021-01-24,BAS,867,316,551,58,808,1,ITF,ITF5,17,Basilicata,Basilicata,559084,678136,121.29,0.16
3000,2021-05-13,BAS,5986,2969,3017,3298,2597,91,ITF,ITF5,17,Basilicata,Basilicata,559084,684122,122.36,1.07
3001,2021-08-21,BAS,3268,1778,1490,1711,1461,96,ITF,ITF5,17,Basilicata,Basilicata,559084,687390,122.95,0.58
3002,2021-05-08,BAS,4846,2407,2439,3382,1412,52,ITF,ITF5,17,Basilicata,Basilicata,559084,692236,123.82,0.87
3003,2021-08-16,BAS,3566,1866,1700,1484,1998,84,ITF,ITF5,17,Basilicata,Basilicata,559084,695802,124.45,0.64
3004,2021-03-10,BAS,1687,846,841,837,839,11,ITF,ITF5,17,Basilicata,Basilicata,559084,697489,124.76,0.3
3005,2021-01-26,BAS,813,358,455,101,712,0,ITF,ITF5,17,Basilicata,Basilicata,559084,698302,124.9,0.15
3006,2021-05-06,BAS,5068,2440,2628,3431,1586,51,ITF,ITF5,17,Basilicata,Basilicata,559084,703370,125.81,0.91
3007,2021-05-15,BAS,6533,3344,3189,3875,2575,83,ITF,ITF5,17,Basilicata,Basilicata,559084,709903,126.98,1.17
3008,2021-04-02,BAS,2344,1057,1287,1714,605,25,ITF,ITF5,17,Basilicata,Basilicata,559084,712247,127.4,0.42
3009,2021-02-04,BAS,1108,446,662,64,1044,0,ITF,ITF5,17,Basilicata,Basilicata,559084,713355,127.59,0.2
3010,2021-07-11,BAS,5031,2405,2626,1508,3498,25,ITF,ITF5,17,Basilicata,Basilicata,559084,718386,128.49,0.9
3011,2021-02-02,BAS,370,145,225,175,194,1,ITF,ITF5,17,Basilicata,Basilicata,559084,718756,128.56,0.07
3012,2021-04-09,BAS,1153,350,803,1062,63,28,ITF,ITF5,17,Basilicata,Basilicata,559084,719909,128.77,0.21
3013,2021-07-13,BAS,5853,2825,3028,1772,4033,48,ITF,ITF5,17,Basilicata,Basilicata,559084,725762,129.81,1.05
3014,2021-02-27,BAS,2003,863,1140,1821,165,17,ITF,ITF5,17,Basilicata,Basilicata,559084,727765,130.17,0.36
3015,2021-07-20,BAS,5693,2792,2901,1688,3965,40,ITF,ITF5,17,Basilicata,Basilicata,559084,733458,131.19,1.02
3016,2021-06-07,BAS,4239,1921,2318,3885,316,38,ITF,ITF5,17,Basilicata,Basilicata,559084,737697,131.95,0.76
3017,2021-04-11,BAS,966,393,573,760,176,30,ITF,ITF5,17,Basilicata,Basilicata,559084,738663,132.12,0.17
3018,2021-04-04,BAS,612,227,385,188,418,6,ITF,ITF5,17,Basilicata,Basilicata,559084,739275,132.23,0.11
3019,2021-07-22,BAS,5796,2888,2908,1786,3948,62,ITF,ITF5,17,Basilicata,Basilicata,559084,745071,133.27,1.04
3020,2021-02-06,CAL,2938,1353,1585,440,2497,1,ITF,ITF6,18,Calabria,Calabria,1947131,2938,0.15,0.15
3021,2021-09-05,CAL,1496,812,684,697,782,17,ITF,ITF6,18,Calabria,Calabria,1947131,4434,0.23,0.08
3022,2021-07-10,CAL,15945,7539,8406,3244,12657,44,ITF,ITF6,18,Calabria,Calabria,1947131,20379,1.05,0.82
3023,2021-01-23,CAL,403,188,215,360,43,0,ITF,ITF6,18,Calabria,Calabria,1947131,20782,1.07,0.02
3024,2021-01-11,CAL,2191,1061,1130,2189,0,2,ITF,ITF6,18,Calabria,Calabria,1947131,22973,1.18,0.11
3025,2021-01-25,CAL,1090,522,568,150,940,0,ITF,ITF6,18,Calabria,Calabria,1947131,24063,1.24,0.06
3026,2021-05-05,CAL,13619,6518,7101,8408,5133,78,ITF,ITF6,18,Calabria,Calabria,1947131,37682,1.94,0.7
3027,2021-08-17,CAL,7682,3914,3768,2759,4828,95,ITF,ITF6,18,Calabria,Calabria,1947131,45364,2.33,0.39
3028,2021-04-18,CAL,5882,2810,3072,4940,917,25,ITF,ITF6,18,Calabria,Calabria,1947131,51246,2.63,0.3
3029,2021-04-04,CAL,1574,789,785,1141,422,11,ITF,ITF6,18,Calabria,Calabria,1947131,52820,2.71,0.08
3030,2021-06-26,CAL,15586,7203,8383,7577,7938,71,ITF,ITF6,18,Calabria,Calabria,1947131,68406,3.51,0.8
3031,2021-08-08,CAL,4219,2146,2073,1493,2698,28,ITF,ITF6,18,Calabria,Calabria,1947131,72625,3.73,0.22
3032,2021-07-22,CAL,18329,9026,9303,3489,14749,91,ITF,ITF6,18,Calabria,Calabria,1947131,90954,4.67,0.94
3033,2021-04-30,CAL,15113,7410,7703,10530,4502,81,ITF,ITF6,18,Calabria,Calabria,1947131,106067,5.45,0.78
3034,2021-07-01,CAL,12399,5838,6561,5476,6839,84,ITF,ITF6,18,Calabria,Calabria,1947131,118466,6.08,0.64
3035,2021-02-01,CAL,2558,1212,1346,237,2318,3,ITF,ITF6,18,Calabria,Calabria,1947131,121024,6.22,0.13
3036,2021-07-08,CAL,12049,5615,6434,2692,9312,45,ITF,ITF6,18,Calabria,Calabria,1947131,133073,6.83,0.62
3037,2021-03-09,CAL,6585,3438,3147,5525,989,71,ITF,ITF6,18,Calabria,Calabria,1947131,139658,7.17,0.34
3038,2021-02-20,CAL,1507,789,718,1165,328,14,ITF,ITF6,18,Calabria,Calabria,1947131,141165,7.25,0.08
3039,2021-08-22,CAL,1524,770,754,484,1021,19,ITF,ITF6,18,Calabria,Calabria,1947131,142689,7.33,0.08
3040,2021-05-31,CAL,15300,7348,7952,7311,7908,81,ITF,ITF6,18,Calabria,Calabria,1947131,157989,8.11,0.79
3041,2021-07-27,CAL,17588,8996,8592,5022,12479,87,ITF,ITF6,18,Calabria,Calabria,1947131,175577,9.02,0.9
3042,2021-01-06,CAL,956,520,436,956,0,0,ITF,ITF6,18,Calabria,Calabria,1947131,176533,9.07,0.05
3043,2021-04-16,CAL,10345,5050,5295,8642,1643,60,ITF,ITF6,18,Calabria,Calabria,1947131,186878,9.6,0.53
3044,2021-02-18,CAL,1889,876,1013,1637,233,19,ITF,ITF6,18,Calabria,Calabria,1947131,188767,9.69,0.1
3045,2021-08-03,CAL,14103,7129,6974,3913,10116,74,ITF,ITF6,18,Calabria,Calabria,1947131,202870,10.42,0.72
3046,2021-08-10,CAL,9781,4914,4867,3596,6084,101,ITF,ITF6,18,Calabria,Calabria,1947131,212651,10.92,0.5
3047,2021-06-14,CAL,14358,6511,7847,9627,4654,77,ITF,ITF6,18,Calabria,Calabria,1947131,227009,11.66,0.74
3048,2021-03-04,CAL,5497,3198,2299,4676,800,21,ITF,ITF6,18,Calabria,Calabria,1947131,232506,11.94,0.28
3049,2021-06-12,CAL,13248,6298,6950,10782,2398,68,ITF,ITF6,18,Calabria,Calabria,1947131,245754,12.62,0.68
3050,2021-03-28,CAL,2698,1237,1461,1566,1127,5,ITF,ITF6,18,Calabria,Calabria,1947131,248452,12.76,0.14
3051,2021-08-29,CAL,1684,887,797,722,932,30,ITF,ITF6,18,Calabria,Calabria,1947131,250136,12.85,0.09
3052,2021-01-30,CAL,2213,1173,1040,296,1914,3,ITF,ITF6,18,Calabria,Calabria,1947131,252349,12.96,0.11
3053,2021-02-17,CAL,1879,833,1046,1649,213,17,ITF,ITF6,18,Calabria,Calabria,1947131,254228,13.06,0.1
3054,2021-07-24,CAL,18181,9344,8837,4684,13397,100,ITF,ITF6,18,Calabria,Calabria,1947131,272409,13.99,0.93
3055,2021-05-28,CAL,21019,10216,10803,11424,9482,113,ITF,ITF6,18,Calabria,Calabria,1947131,293428,15.07,1.08
3056,2021-03-02,CAL,4424,2501,1923,3619,796,9,ITF,ITF6,18,Calabria,Calabria,1947131,297852,15.3,0.23
3057,2021-03-16,CAL,3874,1901,1973,2183,1678,13,ITF,ITF6,18,Calabria,Calabria,1947131,301726,15.5,0.2
3058,2021-07-29,CAL,17590,8769,8821,4717,12772,101,ITF,ITF6,18,Calabria,Calabria,1947131,319316,16.4,0.9
3059,2021-02-11,CAL,2353,1053,1300,1064,1267,22,ITF,ITF6,18,Calabria,Calabria,1947131,321669,16.52,0.12
3060,2021-06-07,CAL,18006,8423,9583,14711,3214,81,ITF,ITF6,18,Calabria,Calabria,1947131,339675,17.44,0.92
3061,2021-05-24,CAL,17787,8913,8874,9936,7769,82,ITF,ITF6,18,Calabria,Calabria,1947131,357462,18.36,0.91
3062,2021-05-07,CAL,16288,7669,8619,9655,6538,95,ITF,ITF6,18,Calabria,Calabria,1947131,373750,19.19,0.84
3063,2021-02-13,CAL,1418,612,806,1045,370,3,ITF,ITF6,18,Calabria,Calabria,1947131,375168,19.27,0.07
3064,2021-08-15,CAL,51,24,27,17,33,1,ITF,ITF6,18,Calabria,Calabria,1947131,375219,19.27,0.0
3065,2021-01-18,CAL,1309,594,715,1056,249,4,ITF,ITF6,18,Calabria,Calabria,1947131,376528,19.34,0.07
3066,2021-07-03,CAL,15185,7148,8037,5283,9823,79,ITF,ITF6,18,Calabria,Calabria,1947131,391713,20.12,0.78
3067,2021-04-11,CAL,4212,1914,2298,2243,1952,17,ITF,ITF6,18,Calabria,Calabria,1947131,395925,20.33,0.22
3068,2021-07-20,CAL,17495,8484,9011,3197,14224,74,ITF,ITF6,18,Calabria,Calabria,1947131,413420,21.23,0.9
3069,2021-03-11,CAL,7320,3484,3836,5953,1315,52,ITF,ITF6,18,Calabria,Calabria,1947131,420740,21.61,0.38
3070,2021-06-19,CAL,15854,7420,8434,8498,7288,68,ITF,ITF6,18,Calabria,Calabria,1947131,436594,22.42,0.81
3071,2021-06-21,CAL,15419,7104,8315,7997,7383,39,ITF,ITF6,18,Calabria,Calabria,1947131,452013,23.21,0.79
3072,2021-01-04,CAL,1076,533,543,1073,0,3,ITF,ITF6,18,Calabria,Calabria,1947131,453089,23.27,0.06
3073,2021-04-23,CAL,13152,6458,6694,9438,3614,100,ITF,ITF6,18,Calabria,Calabria,1947131,466241,23.95,0.68
3074,2021-01-13,CAL,2110,1067,1043,2098,0,12,ITF,ITF6,18,Calabria,Calabria,1947131,468351,24.05,0.11
3075,2021-02-25,CAL,2928,1576,1352,2285,603,40,ITF,ITF6,18,Calabria,Calabria,1947131,471279,24.2,0.15
3076,2021-05-12,CAL,16492,8046,8446,10828,5567,97,ITF,ITF6,18,Calabria,Calabria,1947131,487771,25.05,0.85
3077,2021-05-26,CAL,18754,9344,9410,10338,8324,92,ITF,ITF6,18,Calabria,Calabria,1947131,506525,26.01,0.96
3078,2021-03-30,CAL,6519,2849,3670,3653,2842,24,ITF,ITF6,18,Calabria,Calabria,1947131,513044,26.35,0.33
3079,2021-09-03,CAL,9061,4629,4432,3570,5303,188,ITF,ITF6,18,Calabria,Calabria,1947131,522105,26.81,0.47
3080,2021-05-19,CAL,18330,9083,9247,11260,6993,77,ITF,ITF6,18,Calabria,Calabria,1947131,540435,27.76,0.94
3081,2021-04-15,CAL,7792,3817,3975,5990,1755,47,ITF,ITF6,18,Calabria,Calabria,1947131,548227,28.16,0.4
3082,2021-04-01,CAL,8696,3959,4737,4152,4506,38,ITF,ITF6,18,Calabria,Calabria,1947131,556923,28.6,0.45
3083,2021-04-08,CAL,9369,4437,4932,5831,3487,51,ITF,ITF6,18,Calabria,Calabria,1947131,566292,29.08,0.48
3084,2021-05-23,CAL,11393,5555,5838,6994,4355,44,ITF,ITF6,18,Calabria,Calabria,1947131,577685,29.67,0.59
3085,2021-03-01,CAL,2758,1564,1194,2293,461,4,ITF,ITF6,18,Calabria,Calabria,1947131,580443,29.81,0.14
3086,2021-06-09,CAL,18264,8625,9639,15898,2281,85,ITF,ITF6,18,Calabria,Calabria,1947131,598707,30.75,0.94
3087,2021-08-31,CAL,6829,3377,3452,2672,4030,127,ITF,ITF6,18,Calabria,Calabria,1947131,605536,31.1,0.35
3088,2021-07-12,CAL,17980,8539,9441,2686,15245,49,ITF,ITF6,18,Calabria,Calabria,1947131,623516,32.02,0.92
3089,2021-01-10,CAL,957,539,418,957,0,0,ITF,ITF6,18,Calabria,Calabria,1947131,624473,32.07,0.05
3090,2021-04-20,CAL,7901,3990,3911,6075,1748,78,ITF,ITF6,18,Calabria,Calabria,1947131,632374,32.48,0.41
3091,2021-06-11,CAL,17833,8762,9071,15128,2580,125,ITF,ITF6,18,Calabria,Calabria,1947131,650207,33.39,0.92
3092,2021-01-08,CAL,2201,1049,1152,2194,0,7,ITF,ITF6,18,Calabria,Calabria,1947131,652408,33.51,0.11
3093,2021-03-18,CAL,4507,2108,2399,2345,2136,26,ITF,ITF6,18,Calabria,Calabria,1947131,656915,33.74,0.23
3094,2021-02-27,CAL,4064,2094,1970,3670,387,7,ITF,ITF6,18,Calabria,Calabria,1947131,660979,33.95,0.21
3095,2021-07-31,CAL,13811,7062,6749,3641,10096,74,ITF,ITF6,18,Calabria,Calabria,1947131,674790,34.66,0.71
3096,2021-01-27,CAL,1491,757,734,384,1106,1,ITF,ITF6,18,Calabria,Calabria,1947131,676281,34.73,0.08
3097,2021-04-13,CAL,6974,3426,3548,5611,1336,27,ITF,ITF6,18,Calabria,Calabria,1947131,683255,35.09,0.36
3098,2021-01-20,CAL,1410,630,780,1406,1,3,ITF,ITF6,18,Calabria,Calabria,1947131,684665,35.16,0.07
3099,2021-01-03,CAL,6,3,3,6,0,0,ITF,ITF6,18,Calabria,Calabria,1947131,684671,35.16,0.0
3100,2021-03-27,CAL,8850,4030,4820,4665,4140,45,ITF,ITF6,18,Calabria,Calabria,1947131,693521,35.62,0.45
3101,2021-07-05,CAL,13389,6254,7135,4264,9060,65,ITF,ITF6,18,Calabria,Calabria,1947131,706910,36.31,0.69
3102,2021-02-10,CAL,2526,1086,1440,876,1635,15,ITF,ITF6,18,Calabria,Calabria,1947131,709436,36.43,0.13
3103,2021-07-17,CAL,18337,9046,9291,2709,15560,68,ITF,ITF6,18,Calabria,Calabria,1947131,727773,37.38,0.94
3104,2021-06-04,CAL,17547,8158,9389,12955,4523,69,ITF,ITF6,18,Calabria,Calabria,1947131,745320,38.28,0.9
3105,2021-05-21,CAL,21370,10884,10486,13857,7403,110,ITF,ITF6,18,Calabria,Calabria,1947131,766690,39.38,1.1
3106,2021-03-06,CAL,8546,4403,4143,7705,816,25,ITF,ITF6,18,Calabria,Calabria,1947131,775236,39.81,0.44
3107,2021-08-19,CAL,5872,2945,2927,2348,3467,57,ITF,ITF6,18,Calabria,Calabria,1947131,781108,40.12,0.3
3108,2021-05-09,CAL,9695,4530,5165,6041,3605,49,ITF,ITF6,18,Calabria,Calabria,1947131,790803,40.61,0.5
3109,2021-01-29,CAL,2080,1005,1075,226,1853,1,ITF,ITF6,18,Calabria,Calabria,1947131,792883,40.72,0.11
3110,2021-05-14,CAL,19949,9581,10368,12944,6887,118,ITF,ITF6,18,Calabria,Calabria,1947131,812832,41.75,1.02
3111,2021-04-27,CAL,9983,4909,5074,7962,1971,50,ITF,ITF6,18,Calabria,Calabria,1947131,822815,42.26,0.51
3112,2021-02-03,CAL,2871,1480,1391,516,2350,5,ITF,ITF6,18,Calabria,Calabria,1947131,825686,42.41,0.15
3113,2021-07-19,CAL,19019,9109,9910,3033,15936,50,ITF,ITF6,18,Calabria,Calabria,1947131,844705,43.38,0.98
3114,2021-08-05,CAL,12471,6289,6182,3880,8494,97,ITF,ITF6,18,Calabria,Calabria,1947131,857176,44.02,0.64
3115,2021-02-22,CAL,2102,1073,1029,1532,561,9,ITF,ITF6,18,Calabria,Calabria,1947131,859278,44.13,0.11
3116,2021-06-02,CAL,12102,5800,6302,8788,3267,47,ITF,ITF6,18,Calabria,Calabria,1947131,871380,44.75,0.62
3117,2021-08-07,CAL,9529,4874,4655,3019,6446,64,ITF,ITF6,18,Calabria,Calabria,1947131,880909,45.24,0.49
3118,2021-05-16,CAL,13817,6741,7076,9919,3843,55,ITF,ITF6,18,Calabria,Calabria,1947131,894726,45.95,0.71
3119,2021-08-24,CAL,6504,3228,3276,2319,4100,85,ITF,ITF6,18,Calabria,Calabria,1947131,901230,46.29,0.33
3120,2021-08-16,CAL,6974,3566,3408,2376,4536,62,ITF,ITF6,18,Calabria,Calabria,1947131,908204,46.64,0.36
3121,2021-02-12,CAL,1717,673,1044,943,768,6,ITF,ITF6,18,Calabria,Calabria,1947131,909921,46.73,0.09
3122,2021-06-27,CAL,8424,3946,4478,4987,3397,40,ITF,ITF6,18,Calabria,Calabria,1947131,918345,47.16,0.43
3123,2021-05-04,CAL,16534,7624,8910,11625,4803,106,ITF,ITF6,18,Calabria,Calabria,1947131,934879,48.01,0.85
3124,2021-08-12,CAL,7642,3877,3765,2801,4665,176,ITF,ITF6,18,Calabria,Calabria,1947131,942521,48.41,0.39
3125,2021-01-22,CAL,661,276,385,659,2,0,ITF,ITF6,18,Calabria,Calabria,1947131,943182,48.44,0.03
3126,2021-05-02,CAL,12562,5864,6698,10586,1910,66,ITF,ITF6,18,Calabria,Calabria,1947131,955744,49.08,0.65
3127,2021-03-29,CAL,5787,2503,3284,3979,1776,32,ITF,ITF6,18,Calabria,Calabria,1947131,961531,49.38,0.3
3128,2021-01-31,CAL,1130,562,568,148,982,0,ITF,ITF6,18,Calabria,Calabria,1947131,962661,49.44,0.06
3129,2021-07-07,CAL,13970,6583,7387,3899,9995,76,ITF,ITF6,18,Calabria,Calabria,1947131,976631,50.16,0.72
3130,2021-01-05,CAL,1552,732,820,1550,0,2,ITF,ITF6,18,Calabria,Calabria,1947131,978183,50.24,0.08
3131,2021-01-12,CAL,2094,1035,1059,2085,0,9,ITF,ITF6,18,Calabria,Calabria,1947131,980277,50.34,0.11
3132,2021-02-24,CAL,1948,995,953,1463,479,6,ITF,ITF6,18,Calabria,Calabria,1947131,982225,50.44,0.1
3133,2021-03-23,CAL,5271,2472,2799,3423,1824,24,ITF,ITF6,18,Calabria,Calabria,1947131,987496,50.72,0.27
3134,2021-08-27,CAL,9163,4771,4392,3615,5388,160,ITF,ITF6,18,Calabria,Calabria,1947131,996659,51.19,0.47
3135,2021-07-15,CAL,18280,8808,9472,2520,15708,52,ITF,ITF6,18,Calabria,Calabria,1947131,1014939,52.12,0.94
3136,2021-02-15,CAL,1182,567,615,1012,165,5,ITF,ITF6,18,Calabria,Calabria,1947131,1016121,52.19,0.06
3137,2021-09-02,CAL,7539,3916,3623,3160,4257,122,ITF,ITF6,18,Calabria,Calabria,1947131,1023660,52.57,0.39
3138,2021-02-14,CAL,491,229,262,453,37,1,ITF,ITF6,18,Calabria,Calabria,1947131,1024151,52.6,0.03
3139,2021-05-25,CAL,16425,8045,8380,10215,6123,87,ITF,ITF6,18,Calabria,Calabria,1947131,1040576,53.44,0.84
3140,2021-01-26,CAL,1894,910,984,269,1624,1,ITF,ITF6,18,Calabria,Calabria,1947131,1042470,53.54,0.1
3141,2021-07-28,CAL,21383,10734,10649,5897,15372,114,ITF,ITF6,18,Calabria,Calabria,1947131,1063853,54.64,1.1
3142,2021-04-22,CAL,9838,4921,4917,6848,2936,54,ITF,ITF6,18,Calabria,Calabria,1947131,1073691,55.14,0.51
3143,2021-05-06,CAL,13354,6321,7033,8925,4356,73,ITF,ITF6,18,Calabria,Calabria,1947131,1087045,55.83,0.69
3144,2021-08-14,CAL,2231,1195,1036,725,1489,17,ITF,ITF6,18,Calabria,Calabria,1947131,1089276,55.94,0.11
3145,2021-07-14,CAL,22648,10681,11967,4160,18411,77,ITF,ITF6,18,Calabria,Calabria,1947131,1111924,57.11,1.16
3146,2021-04-05,CAL,3644,1729,1915,2672,959,13,ITF,ITF6,18,Calabria,Calabria,1947131,1115568,57.29,0.19
3147,2021-06-08,CAL,16683,7901,8782,14514,2047,122,ITF,ITF6,18,Calabria,Calabria,1947131,1132251,58.15,0.86
3148,2021-05-11,CAL,15143,7332,7811,10244,4827,72,ITF,ITF6,18,Calabria,Calabria,1947131,1147394,58.93,0.78
3149,2021-07-16,CAL,21056,10034,11022,3375,17605,76,ITF,ITF6,18,Calabria,Calabria,1947131,1168450,60.01,1.08
3150,2021-07-21,CAL,22118,10622,11496,4517,17487,114,ITF,ITF6,18,Calabria,Calabria,1947131,1190568,61.14,1.14
3151,2021-01-17,CAL,913,441,472,807,100,6,ITF,ITF6,18,Calabria,Calabria,1947131,1191481,61.19,0.05
3152,2021-03-24,CAL,7980,3648,4332,4550,3405,25,ITF,ITF6,18,Calabria,Calabria,1947131,1199461,61.6,0.41
3153,2021-04-10,CAL,11734,5311,6423,6823,4865,46,ITF,ITF6,18,Calabria,Calabria,1947131,1211195,62.2,0.6
3154,2021-03-03,CAL,5116,2791,2325,4012,1090,14,ITF,ITF6,18,Calabria,Calabria,1947131,1216311,62.47,0.26
3155,2021-08-04,CAL,16022,8118,7904,4254,11667,101,ITF,ITF6,18,Calabria,Calabria,1947131,1232333,63.29,0.82
3156,2021-06-29,CAL,13078,6041,7037,5353,7673,52,ITF,ITF6,18,Calabria,Calabria,1947131,1245411,63.96,0.67
3157,2021-05-03,CAL,14855,6806,8049,10463,4299,93,ITF,ITF6,18,Calabria,Calabria,1947131,1260266,64.72,0.76
3158,2021-03-21,CAL,4467,1929,2538,2729,1726,12,ITF,ITF6,18,Calabria,Calabria,1947131,1264733,64.95,0.23
3159,2021-03-07,CAL,3413,1743,1670,3306,93,14,ITF,ITF6,18,Calabria,Calabria,1947131,1268146,65.13,0.18
3160,2021-08-11,CAL,11056,5673,5383,3520,7421,115,ITF,ITF6,18,Calabria,Calabria,1947131,1279202,65.7,0.57
3161,2021-06-15,CAL,15161,7052,8109,10237,4832,92,ITF,ITF6,18,Calabria,Calabria,1947131,1294363,66.48,0.78
3162,2021-03-08,CAL,5524,2992,2532,4406,1085,33,ITF,ITF6,18,Calabria,Calabria,1947131,1299887,66.76,0.28
3163,2021-03-25,CAL,7552,3568,3984,4584,2932,36,ITF,ITF6,18,Calabria,Calabria,1947131,1307439,67.15,0.39
3164,2021-09-07,CAL,5881,2973,2908,2774,2968,139,ITF,ITF6,18,Calabria,Calabria,1947131,1313320,67.45,0.3
3165,2021-06-16,CAL,18340,8475,9865,12124,6125,91,ITF,ITF6,18,Calabria,Calabria,1947131,1331660,68.39,0.94
3166,2020-12-27,CAL,317,169,148,317,0,0,ITF,ITF6,18,Calabria,Calabria,1947131,1331977,68.41,0.02
3167,2021-04-06,CAL,8179,3727,4452,4460,3683,36,ITF,ITF6,18,Calabria,Calabria,1947131,1340156,68.83,0.42
3168,2021-03-17,CAL,4194,1879,2315,2189,1995,10,ITF,ITF6,18,Calabria,Calabria,1947131,1344350,69.04,0.22
3169,2021-06-25,CAL,18836,8748,10088,8068,10682,86,ITF,ITF6,18,Calabria,Calabria,1947131,1363186,70.01,0.97
3170,2021-07-13,CAL,17440,8159,9281,2307,15063,70,ITF,ITF6,18,Calabria,Calabria,1947131,1380626,70.91,0.9
3171,2021-04-19,CAL,7904,3818,4086,6171,1685,48,ITF,ITF6,18,Calabria,Calabria,1947131,1388530,71.31,0.41
3172,2021-01-24,CAL,47,20,27,41,6,0,ITF,ITF6,18,Calabria,Calabria,1947131,1388577,71.31,0.0
3173,2021-07-09,CAL,15678,7307,8371,3635,11972,71,ITF,ITF6,18,Calabria,Calabria,1947131,1404255,72.12,0.81
3174,2021-08-21,CAL,3645,1859,1786,1439,2159,47,ITF,ITF6,18,Calabria,Calabria,1947131,1407900,72.31,0.19
3175,2020-12-28,CAL,6,2,4,6,0,0,ITF,ITF6,18,Calabria,Calabria,1947131,1407906,72.31,0.0
3176,2021-06-03,CAL,14256,6654,7602,9587,4615,54,ITF,ITF6,18,Calabria,Calabria,1947131,1422162,73.04,0.73
3177,2021-04-07,CAL,9183,4174,5009,5054,4072,57,ITF,ITF6,18,Calabria,Calabria,1947131,1431345,73.51,0.47
3178,2021-02-23,CAL,1617,765,852,1493,119,5,ITF,ITF6,18,Calabria,Calabria,1947131,1432962,73.59,0.08
3179,2021-03-31,CAL,9160,4180,4980,5064,4060,36,ITF,ITF6,18,Calabria,Calabria,1947131,1442122,74.06,0.47
3180,2021-04-09,CAL,8038,3768,4270,5052,2896,90,ITF,ITF6,18,Calabria,Calabria,1947131,1450160,74.48,0.41
3181,2021-07-18,CAL,8790,4205,4585,1280,7478,32,ITF,ITF6,18,Calabria,Calabria,1947131,1458950,74.93,0.45
3182,2021-06-05,CAL,20794,9713,11081,17633,3081,80,ITF,ITF6,18,Calabria,Calabria,1947131,1479744,76.0,1.07
3183,2021-04-03,CAL,9455,4090,5365,4529,4863,63,ITF,ITF6,18,Calabria,Calabria,1947131,1489199,76.48,0.49
3184,2021-01-28,CAL,2300,1144,1156,79,2221,0,ITF,ITF6,18,Calabria,Calabria,1947131,1491499,76.6,0.12
3185,2021-08-13,CAL,7595,3919,3676,2444,5083,68,ITF,ITF6,18,Calabria,Calabria,1947131,1499094,76.99,0.39
3186,2021-05-08,CAL,18574,8432,10142,10511,7987,76,ITF,ITF6,18,Calabria,Calabria,1947131,1517668,77.94,0.95
3187,2021-05-22,CAL,22205,10566,11639,14212,7902,91,ITF,ITF6,18,Calabria,Calabria,1947131,1539873,79.08,1.14
3188,2021-08-30,CAL,9384,4715,4669,3154,6106,124,ITF,ITF6,18,Calabria,Calabria,1947131,1549257,79.57,0.48
3189,2021-04-21,CAL,11627,5842,5785,8633,2934,60,ITF,ITF6,18,Calabria,Calabria,1947131,1560884,80.16,0.6
3190,2021-07-30,CAL,19741,10064,9677,5519,14095,127,ITF,ITF6,18,Calabria,Calabria,1947131,1580625,81.18,1.01
3191,2021-04-02,CAL,8555,3920,4635,4581,3940,34,ITF,ITF6,18,Calabria,Calabria,1947131,1589180,81.62,0.44
3192,2021-06-24,CAL,15419,7025,8394,6982,8357,80,ITF,ITF6,18,Calabria,Calabria,1947131,1604599,82.41,0.79
3193,2021-03-19,CAL,4260,1993,2267,1884,2369,7,ITF,ITF6,18,Calabria,Calabria,1947131,1608859,82.63,0.22
3194,2021-03-14,CAL,2773,1072,1701,2284,482,7,ITF,ITF6,18,Calabria,Calabria,1947131,1611632,82.77,0.14
3195,2021-08-18,CAL,9455,4850,4605,3390,5965,100,ITF,ITF6,18,Calabria,Calabria,1947131,1621087,83.26,0.49
3196,2021-06-22,CAL,14626,6918,7708,7381,7149,96,ITF,ITF6,18,Calabria,Calabria,1947131,1635713,84.01,0.75
3197,2021-05-10,CAL,13174,6126,7048,7691,5419,64,ITF,ITF6,18,Calabria,Calabria,1947131,1648887,84.68,0.68
3198,2021-04-26,CAL,10193,5061,5132,7711,2433,49,ITF,ITF6,18,Calabria,Calabria,1947131,1659080,85.21,0.52
3199,2021-02-05,CAL,3866,1747,2119,473,3378,15,ITF,ITF6,18,Calabria,Calabria,1947131,1662946,85.4,0.2
3200,2021-04-29,CAL,12523,6091,6432,8656,3808,59,ITF,ITF6,18,Calabria,Calabria,1947131,1675469,86.05,0.64
3201,2021-04-12,CAL,7043,3429,3614,5350,1663,30,ITF,ITF6,18,Calabria,Calabria,1947131,1682512,86.41,0.36
3202,2021-01-19,CAL,1132,499,633,1117,13,2,ITF,ITF6,18,Calabria,Calabria,1947131,1683644,86.47,0.06
3203,2021-07-04,CAL,5956,2822,3134,1993,3927,36,ITF,ITF6,18,Calabria,Calabria,1947131,1689600,86.77,0.31
3204,2021-06-17,CAL,15819,7228,8591,9595,6170,54,ITF,ITF6,18,Calabria,Calabria,1947131,1705419,87.59,0.81
3205,2021-03-26,CAL,8120,3854,4266,4947,3139,34,ITF,ITF6,18,Calabria,Calabria,1947131,1713539,88.0,0.42
3206,2021-09-08,CAL,7754,4000,3754,3308,4291,155,ITF,ITF6,18,Calabria,Calabria,1947131,1721293,88.4,0.4
3207,2021-02-08,CAL,1880,748,1132,667,1210,3,ITF,ITF6,18,Calabria,Calabria,1947131,1723173,88.5,0.1
3208,2021-04-24,CAL,19303,9608,9695,15758,3455,90,ITF,ITF6,18,Calabria,Calabria,1947131,1742476,89.49,0.99
3209,2021-02-26,CAL,3166,1683,1483,2688,463,15,ITF,ITF6,18,Calabria,Calabria,1947131,1745642,89.65,0.16
3210,2021-08-02,CAL,15086,7541,7545,3730,11298,58,ITF,ITF6,18,Calabria,Calabria,1947131,1760728,90.43,0.77
3211,2021-06-20,CAL,6652,3151,3501,3816,2808,28,ITF,ITF6,18,Calabria,Calabria,1947131,1767380,90.77,0.34
3212,2021-06-06,CAL,13811,6640,7171,12016,1724,71,ITF,ITF6,18,Calabria,Calabria,1947131,1781191,91.48,0.71
3213,2021-01-09,CAL,2103,1129,974,2095,0,8,ITF,ITF6,18,Calabria,Calabria,1947131,1783294,91.59,0.11
3214,2021-09-01,CAL,9145,4696,4449,3502,5498,145,ITF,ITF6,18,Calabria,Calabria,1947131,1792439,92.06,0.47
3215,2021-02-28,CAL,2373,1082,1291,2214,156,3,ITF,ITF6,18,Calabria,Calabria,1947131,1794812,92.18,0.12
3216,2021-06-18,CAL,18919,8809,10110,11286,7517,116,ITF,ITF6,18,Calabria,Calabria,1947131,1813731,93.15,0.97
3217,2021-03-10,CAL,6890,3510,3380,5473,1378,39,ITF,ITF6,18,Calabria,Calabria,1947131,1820621,93.5,0.35
3218,2021-08-23,CAL,7680,3814,3866,2793,4781,106,ITF,ITF6,18,Calabria,Calabria,1947131,1828301,93.9,0.39
3219,2021-06-01,CAL,12886,5977,6909,7885,4941,60,ITF,ITF6,18,Calabria,Calabria,1947131,1841187,94.56,0.66
3220,2021-05-13,CAL,15984,7693,8291,11174,4730,80,ITF,ITF6,18,Calabria,Calabria,1947131,1857171,95.38,0.82
3221,2021-02-19,CAL,1521,689,832,1248,264,9,ITF,ITF6,18,Calabria,Calabria,1947131,1858692,95.46,0.08
3222,2021-05-30,CAL,11010,5307,5703,6821,4154,35,ITF,ITF6,18,Calabria,Calabria,1947131,1869702,96.02,0.57
3223,2021-01-07,CAL,2223,1091,1132,2219,0,4,ITF,ITF6,18,Calabria,Calabria,1947131,1871925,96.14,0.11
3224,2021-06-13,CAL,6859,3366,3493,5730,1073,56,ITF,ITF6,18,Calabria,Calabria,1947131,1878784,96.49,0.35
3225,2021-04-17,CAL,10860,5078,5782,9023,1786,51,ITF,ITF6,18,Calabria,Calabria,1947131,1889644,97.05,0.56
3226,2021-05-01,CAL,16750,7983,8767,12402,4256,92,ITF,ITF6,18,Calabria,Calabria,1947131,1906394,97.91,0.86
3227,2021-03-05,CAL,6244,3624,2620,5649,579,16,ITF,ITF6,18,Calabria,Calabria,1947131,1912638,98.23,0.32
3228,2021-08-09,CAL,13172,6712,6460,4641,8369,162,ITF,ITF6,18,Calabria,Calabria,1947131,1925810,98.91,0.68
3229,2021-07-26,CAL,18800,9339,9461,5220,13487,93,ITF,ITF6,18,Calabria,Calabria,1947131,1944610,99.87,0.97
3230,2021-03-12,CAL,5162,2473,2689,4074,1065,23,ITF,ITF6,18,Calabria,Calabria,1947131,1949772,100.14,0.27
3231,2021-01-14,CAL,2677,1272,1405,2671,0,6,ITF,ITF6,18,Calabria,Calabria,1947131,1952449,100.27,0.14
3232,2021-07-06,CAL,12492,5751,6741,3826,8600,66,ITF,ITF6,18,Calabria,Calabria,1947131,1964941,100.91,0.64
3233,2021-01-02,CAL,166,94,72,166,0,0,ITF,ITF6,18,Calabria,Calabria,1947131,1965107,100.92,0.01
3234,2021-07-11,CAL,6434,2985,3449,846,5577,11,ITF,ITF6,18,Calabria,Calabria,1947131,1971541,101.25,0.33
3235,2021-06-10,CAL,15896,7333,8563,12986,2809,101,ITF,ITF6,18,Calabria,Calabria,1947131,1987437,102.07,0.82
3236,2021-05-17,CAL,14913,7464,7449,10138,4721,54,ITF,ITF6,18,Calabria,Calabria,1947131,2002350,102.84,0.77
3237,2021-08-25,CAL,8845,4329,4516,3325,5386,134,ITF,ITF6,18,Calabria,Calabria,1947131,2011195,103.29,0.45
3238,2021-02-21,CAL,667,306,361,587,79,1,ITF,ITF6,18,Calabria,Calabria,1947131,2011862,103.32,0.03
3239,2021-04-28,CAL,12580,6100,6480,9624,2884,72,ITF,ITF6,18,Calabria,Calabria,1947131,2024442,103.97,0.65
3240,2021-02-04,CAL,3677,1748,1929,646,3025,6,ITF,ITF6,18,Calabria,Calabria,1947131,2028119,104.16,0.19
3241,2021-05-15,CAL,27280,13055,14225,20267,6877,136,ITF,ITF6,18,Calabria,Calabria,1947131,2055399,105.56,1.4
3242,2021-08-06,CAL,15621,7933,7688,5086,10403,132,ITF,ITF6,18,Calabria,Calabria,1947131,2071020,106.36,0.8
3243,2021-02-02,CAL,2376,1170,1206,176,2200,0,ITF,ITF6,18,Calabria,Calabria,1947131,2073396,106.48,0.12
3244,2021-01-16,CAL,2429,1140,1289,2426,0,3,ITF,ITF6,18,Calabria,Calabria,1947131,2075825,106.61,0.12
3245,2021-01-21,CAL,983,460,523,946,34,3,ITF,ITF6,18,Calabria,Calabria,1947131,2076808,106.66,0.05
3246,2021-08-20,CAL,7569,3822,3747,3020,4458,91,ITF,ITF6,18,Calabria,Calabria,1947131,2084377,107.05,0.39
3247,2021-06-23,CAL,17242,7874,9368,8149,9010,83,ITF,ITF6,18,Calabria,Calabria,1947131,2101619,107.93,0.89
3248,2021-03-13,CAL,7027,3046,3981,5945,1045,37,ITF,ITF6,18,Calabria,Calabria,1947131,2108646,108.3,0.36
3249,2021-01-15,CAL,2819,1267,1552,2813,0,6,ITF,ITF6,18,Calabria,Calabria,1947131,2111465,108.44,0.14
3250,2021-04-25,CAL,15901,8070,7831,14800,1033,68,ITF,ITF6,18,Calabria,Calabria,1947131,2127366,109.26,0.82
3251,2021-08-26,CAL,7207,3602,3605,3179,3907,121,ITF,ITF6,18,Calabria,Calabria,1947131,2134573,109.63,0.37
3252,2021-06-30,CAL,16392,7509,8883,7019,9271,102,ITF,ITF6,18,Calabria,Calabria,1947131,2150965,110.47,0.84
3253,2021-06-28,CAL,13308,6127,7181,5376,7864,68,ITF,ITF6,18,Calabria,Calabria,1947131,2164273,111.15,0.68
3254,2021-03-20,CAL,6784,3108,3676,4182,2585,17,ITF,ITF6,18,Calabria,Calabria,1947131,2171057,111.5,0.35
3255,2021-03-15,CAL,3661,1769,1892,2164,1484,13,ITF,ITF6,18,Calabria,Calabria,1947131,2174718,111.69,0.19
3256,2021-08-28,CAL,5303,2778,2525,1895,3315,93,ITF,ITF6,18,Calabria,Calabria,1947131,2180021,111.96,0.27
3257,2021-07-02,CAL,16275,7535,8740,6241,9949,85,ITF,ITF6,18,Calabria,Calabria,1947131,2196296,112.8,0.84
3258,2021-05-20,CAL,16996,8507,8489,11271,5656,69,ITF,ITF6,18,Calabria,Calabria,1947131,2213292,113.67,0.87
3259,2021-02-07,CAL,871,435,436,143,726,2,ITF,ITF6,18,Calabria,Calabria,1947131,2214163,113.71,0.04
3260,2021-05-18,CAL,15344,7677,7667,11846,3428,70,ITF,ITF6,18,Calabria,Calabria,1947131,2229507,114.5,0.79
3261,2021-03-22,CAL,5000,2351,2649,3181,1794,25,ITF,ITF6,18,Calabria,Calabria,1947131,2234507,114.76,0.26
3262,2021-09-04,CAL,5550,2958,2592,2321,3124,105,ITF,ITF6,18,Calabria,Calabria,1947131,2240057,115.04,0.29
3263,2021-02-09,CAL,2178,922,1256,953,1215,10,ITF,ITF6,18,Calabria,Calabria,1947131,2242235,115.16,0.11
3264,2021-05-29,CAL,19301,8963,10338,9351,9874,76,ITF,ITF6,18,Calabria,Calabria,1947131,2261536,116.15,0.99
3265,2021-09-06,CAL,8004,4119,3885,3444,4420,140,ITF,ITF6,18,Calabria,Calabria,1947131,2269540,116.56,0.41
3266,2021-07-25,CAL,6951,3572,3379,1469,5450,32,ITF,ITF6,18,Calabria,Calabria,1947131,2276491,116.92,0.36
3267,2021-04-14,CAL,8096,3912,4184,6588,1458,50,ITF,ITF6,18,Calabria,Calabria,1947131,2284587,117.33,0.42
3268,2021-02-16,CAL,1753,745,1008,1467,281,5,ITF,ITF6,18,Calabria,Calabria,1947131,2286340,117.42,0.09
3269,2021-07-23,CAL,22745,11352,11393,5559,17084,102,ITF,ITF6,18,Calabria,Calabria,1947131,2309085,118.59,1.17
3270,2021-05-27,CAL,17676,8742,8934,9773,7819,84,ITF,ITF6,18,Calabria,Calabria,1947131,2326761,119.5,0.91
3271,2021-08-01,CAL,4895,2562,2333,1172,3699,24,ITF,ITF6,18,Calabria,Calabria,1947131,2331656,119.75,0.25
3272,2021-08-15,SIC,2513,1428,1085,1509,954,50,ITG,ITG1,19,Sicilia,Sicilia,4999891,2513,0.05,0.05
3273,2021-08-01,SIC,19971,10434,9537,7859,11966,146,ITG,ITG1,19,Sicilia,Sicilia,4999891,22484,0.45,0.4
3274,2021-06-19,SIC,44303,21064,23239,18764,25219,320,ITG,ITG1,19,Sicilia,Sicilia,4999891,66787,1.34,0.89
3275,2021-04-23,SIC,28634,13725,14909,22410,5841,383,ITG,ITG1,19,Sicilia,Sicilia,4999891,95421,1.91,0.57
3276,2021-06-24,SIC,42368,19670,22698,17636,24372,360,ITG,ITG1,19,Sicilia,Sicilia,4999891,137789,2.76,0.85
3277,2021-06-07,SIC,49692,23418,26274,41116,8041,535,ITG,ITG1,19,Sicilia,Sicilia,4999891,187481,3.75,0.99
3278,2021-01-25,SIC,7455,3692,3763,267,7181,7,ITG,ITG1,19,Sicilia,Sicilia,4999891,194936,3.9,0.15
3279,2021-05-05,SIC,26413,12236,14177,16284,9684,445,ITG,ITG1,19,Sicilia,Sicilia,4999891,221349,4.43,0.53
3280,2021-05-19,SIC,42907,20772,22135,28190,14336,381,ITG,ITG1,19,Sicilia,Sicilia,4999891,264256,5.29,0.86
3281,2021-07-27,SIC,43337,21479,21858,19274,23600,463,ITG,ITG1,19,Sicilia,Sicilia,4999891,307593,6.15,0.87
3282,2021-08-29,SIC,14525,7929,6596,4754,9625,146,ITG,ITG1,19,Sicilia,Sicilia,4999891,322118,6.44,0.29
3283,2021-02-25,SIC,9942,5208,4734,8686,1164,92,ITG,ITG1,19,Sicilia,Sicilia,4999891,332060,6.64,0.2
3284,2021-06-05,SIC,59963,28524,31439,48735,10599,629,ITG,ITG1,19,Sicilia,Sicilia,4999891,392023,7.84,1.2
3285,2021-03-14,SIC,8783,3930,4853,4894,3837,52,ITG,ITG1,19,Sicilia,Sicilia,4999891,400806,8.02,0.18
3286,2021-08-03,SIC,32102,15741,16361,13914,17768,420,ITG,ITG1,19,Sicilia,Sicilia,4999891,432908,8.66,0.64
3287,2021-03-02,SIC,14784,6379,8405,11887,2781,116,ITG,ITG1,19,Sicilia,Sicilia,4999891,447692,8.95,0.3
3288,2021-01-04,SIC,8684,4330,4354,8634,0,50,ITG,ITG1,19,Sicilia,Sicilia,4999891,456376,9.13,0.17
3289,2021-01-18,SIC,1627,676,951,1456,160,11,ITG,ITG1,19,Sicilia,Sicilia,4999891,458003,9.16,0.03
3290,2021-04-28,SIC,29291,13724,15567,19719,9163,409,ITG,ITG1,19,Sicilia,Sicilia,4999891,487294,9.75,0.59
3291,2021-08-10,SIC,21839,10878,10961,10662,10916,261,ITG,ITG1,19,Sicilia,Sicilia,4999891,509133,10.18,0.44
3292,2021-04-11,SIC,15382,7595,7787,8228,7041,113,ITG,ITG1,19,Sicilia,Sicilia,4999891,524515,10.49,0.31
3293,2021-07-20,SIC,48516,23632,24884,12797,35358,361,ITG,ITG1,19,Sicilia,Sicilia,4999891,573031,11.46,0.97
3294,2020-12-30,SIC,186,110,76,185,0,1,ITG,ITG1,19,Sicilia,Sicilia,4999891,573217,11.46,0.0
3295,2021-01-16,SIC,2737,1221,1516,2716,0,21,ITG,ITG1,19,Sicilia,Sicilia,4999891,575954,11.52,0.05
3296,2021-07-01,SIC,31002,14084,16918,10755,19990,257,ITG,ITG1,19,Sicilia,Sicilia,4999891,606956,12.14,0.62
3297,2021-04-09,SIC,20231,9843,10388,10922,9046,263,ITG,ITG1,19,Sicilia,Sicilia,4999891,627187,12.54,0.4
3298,2021-03-23,SIC,20974,10090,10884,15232,5567,175,ITG,ITG1,19,Sicilia,Sicilia,4999891,648161,12.96,0.42
3299,2021-02-13,SIC,2979,1124,1855,2686,256,37,ITG,ITG1,19,Sicilia,Sicilia,4999891,651140,13.02,0.06
3300,2021-05-24,SIC,35894,17455,18439,15596,20065,233,ITG,ITG1,19,Sicilia,Sicilia,4999891,687034,13.74,0.72
3301,2021-08-27,SIC,23360,11879,11481,9851,13182,327,ITG,ITG1,19,Sicilia,Sicilia,4999891,710394,14.21,0.47
3302,2021-01-30,SIC,7734,3556,4178,142,7589,3,ITG,ITG1,19,Sicilia,Sicilia,4999891,718128,14.36,0.15
3303,2021-03-28,SIC,10992,5153,5839,6912,4013,67,ITG,ITG1,19,Sicilia,Sicilia,4999891,729120,14.58,0.22
3304,2021-07-15,SIC,48408,22466,25942,8005,40140,263,ITG,ITG1,19,Sicilia,Sicilia,4999891,777528,15.55,0.97
3305,2021-06-26,SIC,37270,17784,19486,16352,20610,308,ITG,ITG1,19,Sicilia,Sicilia,4999891,814798,16.3,0.75
3306,2021-04-30,SIC,35059,16357,18702,23523,11055,481,ITG,ITG1,19,Sicilia,Sicilia,4999891,849857,17.0,0.7
3307,2021-03-04,SIC,15259,6708,8551,11010,4122,127,ITG,ITG1,19,Sicilia,Sicilia,4999891,865116,17.3,0.31
3308,2021-08-08,SIC,15318,8130,7188,7413,7715,190,ITG,ITG1,19,Sicilia,Sicilia,4999891,880434,17.61,0.31
3309,2021-06-12,SIC,45801,22398,23403,39371,5896,534,ITG,ITG1,19,Sicilia,Sicilia,4999891,926235,18.53,0.92
3310,2021-03-16,SIC,9643,4334,5309,3569,6003,71,ITG,ITG1,19,Sicilia,Sicilia,4999891,935878,18.72,0.19
3311,2021-07-08,SIC,38399,17498,20901,6535,31641,223,ITG,ITG1,19,Sicilia,Sicilia,4999891,974277,19.49,0.77
3312,2021-02-11,SIC,5238,2060,3178,4652,467,119,ITG,ITG1,19,Sicilia,Sicilia,4999891,979515,19.59,0.1
3313,2021-04-16,SIC,28867,14501,14366,20246,8300,321,ITG,ITG1,19,Sicilia,Sicilia,4999891,1008382,20.17,0.58
3314,2021-01-23,SIC,4489,2310,2179,208,4271,10,ITG,ITG1,19,Sicilia,Sicilia,4999891,1012871,20.26,0.09
3315,2021-01-06,SIC,6270,3302,2968,6205,0,65,ITG,ITG1,19,Sicilia,Sicilia,4999891,1019141,20.38,0.13
3316,2021-05-31,SIC,38128,17168,20960,21278,16554,296,ITG,ITG1,19,Sicilia,Sicilia,4999891,1057269,21.15,0.76
3317,2021-09-08,SIC,20259,10099,10160,9190,10673,396,ITG,ITG1,19,Sicilia,Sicilia,4999891,1077528,21.55,0.41
3318,2021-08-22,SIC,10335,5506,4829,3916,6301,118,ITG,ITG1,19,Sicilia,Sicilia,4999891,1087863,21.76,0.21
3319,2021-02-18,SIC,5342,3148,2194,4842,431,69,ITG,ITG1,19,Sicilia,Sicilia,4999891,1093205,21.86,0.11
3320,2021-05-12,SIC,36870,17397,19473,21414,14928,528,ITG,ITG1,19,Sicilia,Sicilia,4999891,1130075,22.6,0.74
3321,2021-08-20,SIC,18798,9361,9437,9854,8679,265,ITG,ITG1,19,Sicilia,Sicilia,4999891,1148873,22.98,0.38
3322,2021-07-17,SIC,49326,24294,25032,9317,39709,300,ITG,ITG1,19,Sicilia,Sicilia,4999891,1198199,23.96,0.99
3323,2020-12-28,SIC,225,138,87,224,0,1,ITG,ITG1,19,Sicilia,Sicilia,4999891,1198424,23.97,0.0
3324,2021-05-17,SIC,31940,15411,16529,19000,12646,294,ITG,ITG1,19,Sicilia,Sicilia,4999891,1230364,24.61,0.64
3325,2021-03-21,SIC,15227,7347,7880,11185,3970,72,ITG,ITG1,19,Sicilia,Sicilia,4999891,1245591,24.91,0.3
3326,2021-02-06,SIC,4738,2120,2618,1450,3268,20,ITG,ITG1,19,Sicilia,Sicilia,4999891,1250329,25.01,0.09
3327,2021-02-04,SIC,6762,3084,3678,1421,5311,30,ITG,ITG1,19,Sicilia,Sicilia,4999891,1257091,25.14,0.14
3328,2021-09-03,SIC,21896,11059,10837,9920,11603,373,ITG,ITG1,19,Sicilia,Sicilia,4999891,1278987,25.58,0.44
3329,2021-04-04,SIC,6801,3324,3477,5435,1295,71,ITG,ITG1,19,Sicilia,Sicilia,4999891,1285788,25.72,0.14
3330,2021-07-13,SIC,46134,21174,24960,6920,38996,218,ITG,ITG1,19,Sicilia,Sicilia,4999891,1331922,26.64,0.92
3331,2021-02-23,SIC,8785,4667,4118,8229,468,88,ITG,ITG1,19,Sicilia,Sicilia,4999891,1340707,26.81,0.18
3332,2021-03-09,SIC,13179,5774,7405,10845,2203,131,ITG,ITG1,19,Sicilia,Sicilia,4999891,1353886,27.08,0.26
3333,2021-01-11,SIC,5930,2618,3312,5870,0,60,ITG,ITG1,19,Sicilia,Sicilia,4999891,1359816,27.2,0.12
3334,2021-05-07,SIC,36604,17280,19324,24587,11627,390,ITG,ITG1,19,Sicilia,Sicilia,4999891,1396420,27.93,0.73
3335,2021-03-11,SIC,15461,6713,8748,12889,2418,154,ITG,ITG1,19,Sicilia,Sicilia,4999891,1411881,28.24,0.31
3336,2021-01-27,SIC,7296,3714,3582,166,7129,1,ITG,ITG1,19,Sicilia,Sicilia,4999891,1419177,28.38,0.15
3337,2021-01-13,SIC,5190,2447,2743,5156,0,34,ITG,ITG1,19,Sicilia,Sicilia,4999891,1424367,28.49,0.1
3338,2021-02-27,SIC,12241,5505,6736,10936,1204,101,ITG,ITG1,19,Sicilia,Sicilia,4999891,1436608,28.73,0.24
3339,2021-07-12,SIC,49005,22614,26391,6441,42363,201,ITG,ITG1,19,Sicilia,Sicilia,4999891,1485613,29.71,0.98
3340,2021-02-08,SIC,3888,1680,2208,2081,1759,48,ITG,ITG1,19,Sicilia,Sicilia,4999891,1489501,29.79,0.08
3341,2021-01-22,SIC,1294,641,653,261,1031,2,ITG,ITG1,19,Sicilia,Sicilia,4999891,1490795,29.82,0.03
3342,2021-01-08,SIC,8156,3797,4359,8063,0,93,ITG,ITG1,19,Sicilia,Sicilia,4999891,1498951,29.98,0.16
3343,2021-04-18,SIC,19838,9918,9920,15286,4364,188,ITG,ITG1,19,Sicilia,Sicilia,4999891,1518789,30.38,0.4
3344,2021-08-31,SIC,27965,14173,13792,10306,17360,299,ITG,ITG1,19,Sicilia,Sicilia,4999891,1546754,30.94,0.56
3345,2021-03-30,SIC,14588,6774,7814,9714,4771,103,ITG,ITG1,19,Sicilia,Sicilia,4999891,1561342,31.23,0.29
3346,2021-03-13,SIC,12227,5395,6832,7635,4499,93,ITG,ITG1,19,Sicilia,Sicilia,4999891,1573569,31.47,0.24
3347,2021-04-02,SIC,13908,6563,7345,9049,4738,121,ITG,ITG1,19,Sicilia,Sicilia,4999891,1587477,31.75,0.28
3348,2021-02-10,SIC,4354,1776,2578,3888,383,83,ITG,ITG1,19,Sicilia,Sicilia,4999891,1591831,31.84,0.09
3349,2021-05-21,SIC,48719,23080,25639,26666,21627,426,ITG,ITG1,19,Sicilia,Sicilia,4999891,1640550,32.81,0.97
3350,2021-08-12,SIC,15125,7583,7542,7979,6904,242,ITG,ITG1,19,Sicilia,Sicilia,4999891,1655675,33.11,0.3
3351,2021-04-01,SIC,14332,6629,7703,9519,4669,144,ITG,ITG1,19,Sicilia,Sicilia,4999891,1670007,33.4,0.29
3352,2021-07-10,SIC,46919,22355,24564,6057,40654,208,ITG,ITG1,19,Sicilia,Sicilia,4999891,1716926,34.34,0.94
3353,2021-06-23,SIC,44513,20710,23803,17927,26250,336,ITG,ITG1,19,Sicilia,Sicilia,4999891,1761439,35.23,0.89
3354,2021-04-08,SIC,19012,9344,9668,9272,9542,198,ITG,ITG1,19,Sicilia,Sicilia,4999891,1780451,35.61,0.38
3355,2021-02-20,SIC,7172,3708,3464,6804,272,96,ITG,ITG1,19,Sicilia,Sicilia,4999891,1787623,35.75,0.14
3356,2021-01-20,SIC,969,513,456,691,275,3,ITG,ITG1,19,Sicilia,Sicilia,4999891,1788592,35.77,0.02
3357,2021-03-18,SIC,15418,7758,7660,9739,5624,55,ITG,ITG1,19,Sicilia,Sicilia,4999891,1804010,36.08,0.31
3358,2021-08-26,SIC,20017,10109,9908,9101,10608,308,ITG,ITG1,19,Sicilia,Sicilia,4999891,1824027,36.48,0.4
3359,2021-06-04,SIC,57873,26771,31102,45403,11962,508,ITG,ITG1,19,Sicilia,Sicilia,4999891,1881900,37.64,1.16
3360,2021-04-06,SIC,17766,8486,9280,13256,4297,213,ITG,ITG1,19,Sicilia,Sicilia,4999891,1899666,37.99,0.36
3361,2021-02-22,SIC,7946,4131,3815,7370,493,83,ITG,ITG1,19,Sicilia,Sicilia,4999891,1907612,38.15,0.16
3362,2020-12-27,SIC,93,55,38,92,0,1,ITG,ITG1,19,Sicilia,Sicilia,4999891,1907705,38.15,0.0
3363,2021-06-02,SIC,35283,16298,18985,27103,7782,398,ITG,ITG1,19,Sicilia,Sicilia,4999891,1942988,38.86,0.71
3364,2021-06-16,SIC,40442,18806,21636,21270,18813,359,ITG,ITG1,19,Sicilia,Sicilia,4999891,1983430,39.67,0.81
3365,2021-03-25,SIC,20478,9535,10943,14752,5549,177,ITG,ITG1,19,Sicilia,Sicilia,4999891,2003908,40.08,0.41
3366,2021-07-03,SIC,33887,16290,17597,9032,24609,246,ITG,ITG1,19,Sicilia,Sicilia,4999891,2037795,40.76,0.68
3367,2021-09-07,SIC,22809,11335,11474,9500,12890,419,ITG,ITG1,19,Sicilia,Sicilia,4999891,2060604,41.21,0.46
3368,2021-03-06,SIC,12650,5063,7587,9764,2783,103,ITG,ITG1,19,Sicilia,Sicilia,4999891,2073254,41.47,0.25
3369,2021-09-05,SIC,12740,6906,5834,5502,7046,192,ITG,ITG1,19,Sicilia,Sicilia,4999891,2085994,41.72,0.25
3370,2021-06-14,SIC,43496,20663,22833,28169,14898,429,ITG,ITG1,19,Sicilia,Sicilia,4999891,2129490,42.59,0.87
3371,2021-05-28,SIC,51285,22992,28293,24321,26551,413,ITG,ITG1,19,Sicilia,Sicilia,4999891,2180775,43.62,1.03
3372,2021-08-19,SIC,19593,9781,9812,10506,8777,310,ITG,ITG1,19,Sicilia,Sicilia,4999891,2200368,44.01,0.39
3373,2021-04-17,SIC,26011,13153,12858,18667,7068,276,ITG,ITG1,19,Sicilia,Sicilia,4999891,2226379,44.53,0.52
3374,2021-07-26,SIC,44548,22204,22344,16703,27473,372,ITG,ITG1,19,Sicilia,Sicilia,4999891,2270927,45.42,0.89
3375,2021-03-17,SIC,15056,7444,7612,9077,5852,127,ITG,ITG1,19,Sicilia,Sicilia,4999891,2285983,45.72,0.3
3376,2021-06-25,SIC,39809,18683,21126,17385,22085,339,ITG,ITG1,19,Sicilia,Sicilia,4999891,2325792,46.52,0.8
3377,2021-07-09,SIC,44827,20687,24140,6404,38239,184,ITG,ITG1,19,Sicilia,Sicilia,4999891,2370619,47.41,0.9
3378,2021-03-01,SIC,12776,6079,6697,10992,1658,126,ITG,ITG1,19,Sicilia,Sicilia,4999891,2383395,47.67,0.26
3379,2021-06-09,SIC,49787,23682,26105,41910,7266,611,ITG,ITG1,19,Sicilia,Sicilia,4999891,2433182,48.66,1.0
3380,2021-02-07,SIC,2323,983,1340,664,1649,10,ITG,ITG1,19,Sicilia,Sicilia,4999891,2435505,48.71,0.05
3381,2021-07-14,SIC,47552,22027,25525,7934,39357,261,ITG,ITG1,19,Sicilia,Sicilia,4999891,2483057,49.66,0.95
3382,2021-05-18,SIC,36141,17400,18741,23249,12490,402,ITG,ITG1,19,Sicilia,Sicilia,4999891,2519198,50.39,0.72
3383,2021-07-21,SIC,42972,20968,22004,10642,32018,312,ITG,ITG1,19,Sicilia,Sicilia,4999891,2562170,51.24,0.86
3384,2021-07-07,SIC,35429,16208,19221,6039,29149,241,ITG,ITG1,19,Sicilia,Sicilia,4999891,2597599,51.95,0.71
3385,2021-05-25,SIC,33576,15440,18136,13948,19372,256,ITG,ITG1,19,Sicilia,Sicilia,4999891,2631175,52.62,0.67
3386,2021-03-29,SIC,15049,7085,7964,10399,4500,150,ITG,ITG1,19,Sicilia,Sicilia,4999891,2646224,52.93,0.3
3387,2021-09-02,SIC,23149,11854,11295,10011,12750,388,ITG,ITG1,19,Sicilia,Sicilia,4999891,2669373,53.39,0.46
3388,2021-05-16,SIC,33717,16444,17273,21893,11526,298,ITG,ITG1,19,Sicilia,Sicilia,4999891,2703090,54.06,0.67
3389,2021-01-24,SIC,4345,2270,2075,123,4220,2,ITG,ITG1,19,Sicilia,Sicilia,4999891,2707435,54.15,0.09
3390,2021-05-04,SIC,26864,12477,14387,17148,9299,417,ITG,ITG1,19,Sicilia,Sicilia,4999891,2734299,54.69,0.54
3391,2021-03-15,SIC,10691,4736,5955,5657,4954,80,ITG,ITG1,19,Sicilia,Sicilia,4999891,2744990,54.9,0.21
3392,2021-08-09,SIC,25177,12859,12318,12484,12317,376,ITG,ITG1,19,Sicilia,Sicilia,4999891,2770167,55.4,0.5
3393,2021-01-19,SIC,1526,677,849,1270,241,15,ITG,ITG1,19,Sicilia,Sicilia,4999891,2771693,55.44,0.03
3394,2021-06-11,SIC,49981,23849,26132,41600,7712,669,ITG,ITG1,19,Sicilia,Sicilia,4999891,2821674,56.43,1.0
3395,2021-04-29,SIC,31823,14849,16974,21805,9562,456,ITG,ITG1,19,Sicilia,Sicilia,4999891,2853497,57.07,0.64
3396,2021-03-03,SIC,14591,6551,8040,11384,3076,131,ITG,ITG1,19,Sicilia,Sicilia,4999891,2868088,57.36,0.29
3397,2021-08-07,SIC,20060,10407,9653,10820,8903,337,ITG,ITG1,19,Sicilia,Sicilia,4999891,2888148,57.76,0.4
3398,2021-08-16,SIC,20372,10452,9920,10937,9120,315,ITG,ITG1,19,Sicilia,Sicilia,4999891,2908520,58.17,0.41
3399,2021-02-19,SIC,4979,2695,2284,4328,564,87,ITG,ITG1,19,Sicilia,Sicilia,4999891,2913499,58.27,0.1
3400,2021-03-08,SIC,13528,5976,7552,10783,2617,128,ITG,ITG1,19,Sicilia,Sicilia,4999891,2927027,58.54,0.27
3401,2021-08-21,SIC,13739,7166,6573,6200,7352,187,ITG,ITG1,19,Sicilia,Sicilia,4999891,2940766,58.82,0.27
3402,2021-05-30,SIC,35781,16178,19603,17425,18060,296,ITG,ITG1,19,Sicilia,Sicilia,4999891,2976547,59.53,0.72
3403,2021-05-13,SIC,47495,22274,25221,30297,16552,646,ITG,ITG1,19,Sicilia,Sicilia,4999891,3024042,60.48,0.95
3404,2021-01-31,SIC,4063,1945,2118,107,3954,2,ITG,ITG1,19,Sicilia,Sicilia,4999891,3028105,60.56,0.08
3405,2021-05-11,SIC,32694,15507,17187,19686,12501,507,ITG,ITG1,19,Sicilia,Sicilia,4999891,3060799,61.22,0.65
3406,2021-02-17,SIC,5222,3204,2018,4499,671,52,ITG,ITG1,19,Sicilia,Sicilia,4999891,3066021,61.32,0.1
3407,2021-06-01,SIC,38991,17728,21263,24596,14044,351,ITG,ITG1,19,Sicilia,Sicilia,4999891,3105012,62.1,0.78
3408,2021-04-05,SIC,8024,3957,4067,6510,1442,72,ITG,ITG1,19,Sicilia,Sicilia,4999891,3113036,62.26,0.16
3409,2021-04-12,SIC,19022,9221,9801,11486,7276,260,ITG,ITG1,19,Sicilia,Sicilia,4999891,3132058,62.64,0.38
3410,2021-02-14,SIC,1055,402,653,905,140,10,ITG,ITG1,19,Sicilia,Sicilia,4999891,3133113,62.66,0.02
3411,2021-01-02,SIC,4887,2545,2342,4851,0,36,ITG,ITG1,19,Sicilia,Sicilia,4999891,3138000,62.76,0.1
3412,2021-02-03,SIC,5945,2793,3152,707,5230,8,ITG,ITG1,19,Sicilia,Sicilia,4999891,3143945,62.88,0.12
3413,2021-04-27,SIC,26461,12690,13771,15150,10960,351,ITG,ITG1,19,Sicilia,Sicilia,4999891,3170406,63.41,0.53
3414,2021-08-05,SIC,23860,11847,12013,11522,12031,307,ITG,ITG1,19,Sicilia,Sicilia,4999891,3194266,63.89,0.48
3415,2021-05-14,SIC,52250,24500,27750,35790,15682,778,ITG,ITG1,19,Sicilia,Sicilia,4999891,3246516,64.93,1.05
3416,2021-01-15,SIC,5325,2335,2990,5258,0,67,ITG,ITG1,19,Sicilia,Sicilia,4999891,3251841,65.04,0.11
3417,2021-04-25,SIC,21405,10210,11195,16142,5019,244,ITG,ITG1,19,Sicilia,Sicilia,4999891,3273246,65.47,0.43
3418,2021-02-01,SIC,5954,2641,3313,295,5645,14,ITG,ITG1,19,Sicilia,Sicilia,4999891,3279200,65.59,0.12
3419,2021-05-02,SIC,24619,11435,13184,17700,6605,314,ITG,ITG1,19,Sicilia,Sicilia,4999891,3303819,66.08,0.49
3420,2021-03-20,SIC,18605,8987,9618,13366,5144,95,ITG,ITG1,19,Sicilia,Sicilia,4999891,3322424,66.45,0.37
3421,2021-08-24,SIC,23727,11757,11970,10962,12397,368,ITG,ITG1,19,Sicilia,Sicilia,4999891,3346151,66.92,0.47
3422,2021-06-28,SIC,31945,14878,17067,14908,16743,294,ITG,ITG1,19,Sicilia,Sicilia,4999891,3378096,67.56,0.64
3423,2021-07-05,SIC,37530,17616,19914,8909,28380,241,ITG,ITG1,19,Sicilia,Sicilia,4999891,3415626,68.31,0.75
3424,2021-06-21,SIC,40251,18633,21618,18419,21503,329,ITG,ITG1,19,Sicilia,Sicilia,4999891,3455877,69.12,0.81
3425,2021-07-28,SIC,37672,18873,18799,14689,22660,323,ITG,ITG1,19,Sicilia,Sicilia,4999891,3493549,69.87,0.75
3426,2021-06-22,SIC,40055,18408,21647,18342,21335,378,ITG,ITG1,19,Sicilia,Sicilia,4999891,3533604,70.67,0.8
3427,2021-05-22,SIC,48036,22815,25221,28314,19325,397,ITG,ITG1,19,Sicilia,Sicilia,4999891,3581640,71.63,0.96
3428,2021-08-30,SIC,28199,14367,13832,10212,17641,346,ITG,ITG1,19,Sicilia,Sicilia,4999891,3609839,72.2,0.56
3429,2021-02-28,SIC,7132,3032,4100,6457,630,45,ITG,ITG1,19,Sicilia,Sicilia,4999891,3616971,72.34,0.14
3430,2021-02-24,SIC,9381,4804,4577,8704,567,110,ITG,ITG1,19,Sicilia,Sicilia,4999891,3626352,72.53,0.19
3431,2021-01-21,SIC,1457,715,742,490,956,11,ITG,ITG1,19,Sicilia,Sicilia,4999891,3627809,72.56,0.03
3432,2021-05-01,SIC,24456,11320,13136,19001,5170,285,ITG,ITG1,19,Sicilia,Sicilia,4999891,3652265,73.05,0.49
3433,2021-07-06,SIC,37119,17162,19957,10283,26527,309,ITG,ITG1,19,Sicilia,Sicilia,4999891,3689384,73.79,0.74
3434,2021-05-10,SIC,28741,13797,14944,16179,12220,342,ITG,ITG1,19,Sicilia,Sicilia,4999891,3718125,74.36,0.57
3435,2021-08-18,SIC,21976,11343,10633,11683,9924,369,ITG,ITG1,19,Sicilia,Sicilia,4999891,3740101,74.8,0.44
3436,2021-03-26,SIC,17999,8362,9637,12340,5503,156,ITG,ITG1,19,Sicilia,Sicilia,4999891,3758100,75.16,0.36
3437,2021-01-28,SIC,9038,4277,4761,361,8676,1,ITG,ITG1,19,Sicilia,Sicilia,4999891,3767138,75.34,0.18
3438,2021-07-04,SIC,26518,12804,13714,7609,18734,175,ITG,ITG1,19,Sicilia,Sicilia,4999891,3793656,75.87,0.53
3439,2021-05-08,SIC,35675,17049,18626,24899,10323,453,ITG,ITG1,19,Sicilia,Sicilia,4999891,3829331,76.59,0.71
3440,2021-01-26,SIC,9581,4746,4835,214,9366,1,ITG,ITG1,19,Sicilia,Sicilia,4999891,3838912,76.78,0.19
3441,2021-06-06,SIC,49540,23927,25613,41152,7829,559,ITG,ITG1,19,Sicilia,Sicilia,4999891,3888452,77.77,0.99
3442,2021-02-26,SIC,11989,5883,6106,10192,1681,116,ITG,ITG1,19,Sicilia,Sicilia,4999891,3900441,78.01,0.24
3443,2021-05-06,SIC,29487,14017,15470,18153,10842,492,ITG,ITG1,19,Sicilia,Sicilia,4999891,3929928,78.6,0.59
3444,2021-08-28,SIC,20872,11177,9695,7262,13390,220,ITG,ITG1,19,Sicilia,Sicilia,4999891,3950800,79.02,0.42
3445,2021-08-14,SIC,6148,3341,2807,3309,2718,121,ITG,ITG1,19,Sicilia,Sicilia,4999891,3956948,79.14,0.12
3446,2021-03-31,SIC,14525,6708,7817,9442,4935,148,ITG,ITG1,19,Sicilia,Sicilia,4999891,3971473,79.43,0.29
3447,2021-01-07,SIC,9076,4213,4863,8992,0,84,ITG,ITG1,19,Sicilia,Sicilia,4999891,3980549,79.61,0.18
3448,2021-02-21,SIC,5169,2501,2668,5044,107,18,ITG,ITG1,19,Sicilia,Sicilia,4999891,3985718,79.72,0.1
3449,2021-04-24,SIC,31219,14719,16500,23143,7641,435,ITG,ITG1,19,Sicilia,Sicilia,4999891,4016937,80.34,0.62
3450,2021-08-02,SIC,32989,16397,16592,12857,19782,350,ITG,ITG1,19,Sicilia,Sicilia,4999891,4049926,81.0,0.66
3451,2021-08-06,SIC,24790,12580,12210,13505,10876,409,ITG,ITG1,19,Sicilia,Sicilia,4999891,4074716,81.5,0.5
3452,2021-04-26,SIC,21706,10276,11430,13301,8087,318,ITG,ITG1,19,Sicilia,Sicilia,4999891,4096422,81.93,0.43
3453,2021-02-02,SIC,5322,2497,2825,611,4701,10,ITG,ITG1,19,Sicilia,Sicilia,4999891,4101744,82.04,0.11
3454,2021-08-04,SIC,24375,12019,12356,10990,13061,324,ITG,ITG1,19,Sicilia,Sicilia,4999891,4126119,82.52,0.49
3455,2021-07-18,SIC,39285,19786,19499,8101,30951,233,ITG,ITG1,19,Sicilia,Sicilia,4999891,4165404,83.31,0.79
3456,2021-01-14,SIC,5267,2494,2773,5205,0,62,ITG,ITG1,19,Sicilia,Sicilia,4999891,4170671,83.42,0.11
3457,2021-05-09,SIC,28448,13325,15123,19769,8301,378,ITG,ITG1,19,Sicilia,Sicilia,4999891,4199119,83.98,0.57
3458,2021-08-17,SIC,18613,9520,9093,10141,8145,327,ITG,ITG1,19,Sicilia,Sicilia,4999891,4217732,84.36,0.37
3459,2021-09-04,SIC,18295,9849,8446,8344,9607,344,ITG,ITG1,19,Sicilia,Sicilia,4999891,4236027,84.72,0.37
3460,2021-02-05,SIC,6790,3007,3783,2086,4666,38,ITG,ITG1,19,Sicilia,Sicilia,4999891,4242817,84.86,0.14
3461,2021-04-03,SIC,16422,7819,8603,13421,2837,164,ITG,ITG1,19,Sicilia,Sicilia,4999891,4259239,85.19,0.33
3462,2021-06-08,SIC,47712,22406,25306,40460,6713,539,ITG,ITG1,19,Sicilia,Sicilia,4999891,4306951,86.14,0.95
3463,2021-08-11,SIC,16203,8337,7866,8726,7188,289,ITG,ITG1,19,Sicilia,Sicilia,4999891,4323154,86.46,0.32
3464,2021-01-09,SIC,7256,3425,3831,7195,0,61,ITG,ITG1,19,Sicilia,Sicilia,4999891,4330410,86.61,0.15
3465,2021-05-03,SIC,23328,10803,12525,13265,9798,265,ITG,ITG1,19,Sicilia,Sicilia,4999891,4353738,87.08,0.47
3466,2021-07-11,SIC,36043,16870,19173,3664,32284,95,ITG,ITG1,19,Sicilia,Sicilia,4999891,4389781,87.8,0.72
3467,2021-07-25,SIC,31813,16767,15046,11847,19707,259,ITG,ITG1,19,Sicilia,Sicilia,4999891,4421594,88.43,0.64
3468,2021-04-19,SIC,18292,8672,9620,12464,5590,238,ITG,ITG1,19,Sicilia,Sicilia,4999891,4439886,88.8,0.37
3469,2021-03-22,SIC,16692,7920,8772,11167,5429,96,ITG,ITG1,19,Sicilia,Sicilia,4999891,4456578,89.13,0.33
3470,2021-06-30,SIC,32618,15041,17577,11447,20849,322,ITG,ITG1,19,Sicilia,Sicilia,4999891,4489196,89.79,0.65
3471,2020-12-29,SIC,245,152,93,244,0,1,ITG,ITG1,19,Sicilia,Sicilia,4999891,4489441,89.79,0.0
3472,2021-06-13,SIC,34549,17167,17382,30605,3511,433,ITG,ITG1,19,Sicilia,Sicilia,4999891,4523990,90.48,0.69
3473,2021-04-10,SIC,20448,9978,10470,11302,8972,174,ITG,ITG1,19,Sicilia,Sicilia,4999891,4544438,90.89,0.41
3474,2021-01-17,SIC,1314,598,716,1240,65,9,ITG,ITG1,19,Sicilia,Sicilia,4999891,4545752,90.92,0.03
3475,2021-07-02,SIC,30580,14242,16338,9943,20351,286,ITG,ITG1,19,Sicilia,Sicilia,4999891,4576332,91.53,0.61
3476,2021-07-19,SIC,48981,23599,25382,11655,36967,359,ITG,ITG1,19,Sicilia,Sicilia,4999891,4625313,92.51,0.98
3477,2021-03-27,SIC,15699,7406,8293,10685,4888,126,ITG,ITG1,19,Sicilia,Sicilia,4999891,4641012,92.82,0.31
3478,2021-01-29,SIC,9186,4257,4929,404,8770,12,ITG,ITG1,19,Sicilia,Sicilia,4999891,4650198,93.01,0.18
3479,2021-02-12,SIC,4606,1829,2777,4241,286,79,ITG,ITG1,19,Sicilia,Sicilia,4999891,4654804,93.1,0.09
3480,2021-05-23,SIC,34111,16607,17504,19855,14027,229,ITG,ITG1,19,Sicilia,Sicilia,4999891,4688915,93.78,0.68
3481,2021-06-10,SIC,53055,24909,28146,45149,7253,653,ITG,ITG1,19,Sicilia,Sicilia,4999891,4741970,94.84,1.06
3482,2021-05-27,SIC,47627,21937,25690,24467,22738,422,ITG,ITG1,19,Sicilia,Sicilia,4999891,4789597,95.79,0.95
3483,2021-04-14,SIC,20590,9941,10649,11619,8773,198,ITG,ITG1,19,Sicilia,Sicilia,4999891,4810187,96.21,0.41
3484,2021-07-23,SIC,41502,20851,20651,14365,26813,324,ITG,ITG1,19,Sicilia,Sicilia,4999891,4851689,97.04,0.83
3485,2021-08-13,SIC,11519,5969,5550,5979,5301,239,ITG,ITG1,19,Sicilia,Sicilia,4999891,4863208,97.27,0.23
3486,2021-02-09,SIC,4351,1800,2551,3249,1037,65,ITG,ITG1,19,Sicilia,Sicilia,4999891,4867559,97.35,0.09
3487,2021-05-20,SIC,44108,21134,22974,27755,15936,417,ITG,ITG1,19,Sicilia,Sicilia,4999891,4911667,98.24,0.88
3488,2021-03-05,SIC,15789,6852,8937,11395,4244,150,ITG,ITG1,19,Sicilia,Sicilia,4999891,4927456,98.55,0.32
3489,2021-02-16,SIC,4201,2208,1993,3664,467,70,ITG,ITG1,19,Sicilia,Sicilia,4999891,4931657,98.64,0.08
3490,2021-06-17,SIC,41884,19503,22381,20358,21152,374,ITG,ITG1,19,Sicilia,Sicilia,4999891,4973541,99.47,0.84
3491,2020-12-31,SIC,897,477,420,889,0,8,ITG,ITG1,19,Sicilia,Sicilia,4999891,4974438,99.49,0.02
3492,2021-03-07,SIC,9272,3458,5814,8130,1083,59,ITG,ITG1,19,Sicilia,Sicilia,4999891,4983710,99.68,0.19
3493,2021-06-15,SIC,46165,21762,24403,28194,17535,436,ITG,ITG1,19,Sicilia,Sicilia,4999891,5029875,100.6,0.92
3494,2021-03-24,SIC,20986,9879,11107,15039,5743,204,ITG,ITG1,19,Sicilia,Sicilia,4999891,5050861,101.02,0.42
3495,2021-09-06,SIC,23326,11864,11462,9986,12926,414,ITG,ITG1,19,Sicilia,Sicilia,4999891,5074187,101.49,0.47
3496,2021-05-29,SIC,47195,21470,25725,23530,23215,450,ITG,ITG1,19,Sicilia,Sicilia,4999891,5121382,102.43,0.94
3497,2021-04-21,SIC,22399,10753,11646,15991,6127,281,ITG,ITG1,19,Sicilia,Sicilia,4999891,5143781,102.88,0.45
3498,2021-04-07,SIC,18454,9068,9386,9738,8517,199,ITG,ITG1,19,Sicilia,Sicilia,4999891,5162235,103.25,0.37
3499,2021-07-16,SIC,49376,23384,25992,8724,40363,289,ITG,ITG1,19,Sicilia,Sicilia,4999891,5211611,104.23,0.99
3500,2021-07-30,SIC,32515,16117,16398,12081,20147,287,ITG,ITG1,19,Sicilia,Sicilia,4999891,5244126,104.88,0.65
3501,2021-06-03,SIC,46007,21100,24907,33764,11719,524,ITG,ITG1,19,Sicilia,Sicilia,4999891,5290133,105.8,0.92
3502,2021-01-01,SIC,825,441,384,821,0,4,ITG,ITG1,19,Sicilia,Sicilia,4999891,5290958,105.82,0.02
3503,2021-04-20,SIC,18997,9006,9991,13439,5249,309,ITG,ITG1,19,Sicilia,Sicilia,4999891,5309955,106.2,0.38
3504,2021-07-29,SIC,36205,17892,18313,14330,21532,343,ITG,ITG1,19,Sicilia,Sicilia,4999891,5346160,106.93,0.72
3505,2021-07-24,SIC,40736,21213,19523,16796,23629,311,ITG,ITG1,19,Sicilia,Sicilia,4999891,5386896,107.74,0.81
3506,2021-02-15,SIC,3777,1769,2008,3137,564,76,ITG,ITG1,19,Sicilia,Sicilia,4999891,5390673,107.82,0.08
3507,2021-07-22,SIC,40676,19970,20706,11229,29150,297,ITG,ITG1,19,Sicilia,Sicilia,4999891,5431349,108.63,0.81
3508,2021-05-26,SIC,44748,21043,23705,23915,20488,345,ITG,ITG1,19,Sicilia,Sicilia,4999891,5476097,109.52,0.89
3509,2021-01-03,SIC,4813,2516,2297,4779,0,34,ITG,ITG1,19,Sicilia,Sicilia,4999891,5480910,109.62,0.1
3510,2021-04-13,SIC,20272,9876,10396,11228,8843,201,ITG,ITG1,19,Sicilia,Sicilia,4999891,5501182,110.03,0.41
3511,2021-07-31,SIC,28760,14938,13822,10447,18046,267,ITG,ITG1,19,Sicilia,Sicilia,4999891,5529942,110.6,0.58
3512,2021-01-10,SIC,3566,1598,1968,3544,0,22,ITG,ITG1,19,Sicilia,Sicilia,4999891,5533508,110.67,0.07
3513,2021-01-05,SIC,10485,5155,5330,10402,0,83,ITG,ITG1,19,Sicilia,Sicilia,4999891,5543993,110.88,0.21
3514,2021-04-15,SIC,21595,10498,11097,12003,9356,236,ITG,ITG1,19,Sicilia,Sicilia,4999891,5565588,111.31,0.43
3515,2021-06-20,SIC,33454,15830,17624,15114,18079,261,ITG,ITG1,19,Sicilia,Sicilia,4999891,5599042,111.98,0.67
3516,2021-04-22,SIC,26776,12644,14132,19892,6463,421,ITG,ITG1,19,Sicilia,Sicilia,4999891,5625818,112.52,0.54
3517,2021-03-10,SIC,13960,6134,7826,11626,2187,147,ITG,ITG1,19,Sicilia,Sicilia,4999891,5639778,112.8,0.28
3518,2021-01-12,SIC,4375,2142,2233,4329,0,46,ITG,ITG1,19,Sicilia,Sicilia,4999891,5644153,112.89,0.09
3519,2021-06-18,SIC,43609,20151,23458,18860,24377,372,ITG,ITG1,19,Sicilia,Sicilia,4999891,5687762,113.76,0.87
3520,2021-06-27,SIC,25314,12203,13111,12099,12983,232,ITG,ITG1,19,Sicilia,Sicilia,4999891,5713076,114.26,0.51
3521,2021-05-15,SIC,56537,26405,30132,40370,15249,918,ITG,ITG1,19,Sicilia,Sicilia,4999891,5769613,115.39,1.13
3522,2021-03-19,SIC,16325,8061,8264,10652,5579,94,ITG,ITG1,19,Sicilia,Sicilia,4999891,5785938,115.72,0.33
3523,2021-08-23,SIC,24086,11902,12184,10794,12939,353,ITG,ITG1,19,Sicilia,Sicilia,4999891,5810024,116.2,0.48
3524,2021-09-01,SIC,24936,12714,12222,10575,14006,355,ITG,ITG1,19,Sicilia,Sicilia,4999891,5834960,116.7,0.5
3525,2021-03-12,SIC,12895,5575,7320,10666,2071,158,ITG,ITG1,19,Sicilia,Sicilia,4999891,5847855,116.96,0.26
3526,2021-08-25,SIC,21846,10843,11003,9969,11516,361,ITG,ITG1,19,Sicilia,Sicilia,4999891,5869701,117.4,0.44
3527,2021-06-29,SIC,31458,14737,16721,15727,15325,406,ITG,ITG1,19,Sicilia,Sicilia,4999891,5901159,118.03,0.63
3528,2021-08-13,VEN,24449,13825,10624,18306,5367,776,ITH,ITH3,5,Veneto,Veneto,4905854,24449,0.5,0.5
3529,2021-08-27,VEN,26739,14304,12435,8254,17906,579,ITH,ITH3,5,Veneto,Veneto,4905854,51188,1.04,0.55
3530,2021-05-05,VEN,44415,21281,23134,36223,6563,1629,ITH,ITH3,5,Veneto,Veneto,4905854,95603,1.95,0.91
3531,2021-07-01,VEN,51012,26057,24955,20699,29307,1006,ITH,ITH3,5,Veneto,Veneto,4905854,146615,2.99,1.04
3532,2021-07-13,VEN,43577,22615,20962,5423,37846,308,ITH,ITH3,5,Veneto,Veneto,4905854,190192,3.88,0.89
3533,2021-04-04,VEN,7789,3534,4255,6514,1148,127,ITH,ITH3,5,Veneto,Veneto,4905854,197981,4.04,0.16
3534,2021-01-11,VEN,7244,2102,5142,7243,0,1,ITH,ITH3,5,Veneto,Veneto,4905854,205225,4.18,0.15
3535,2021-04-21,VEN,32409,13205,19204,15567,16065,777,ITH,ITH3,5,Veneto,Veneto,4905854,237634,4.84,0.66
3536,2021-05-22,VEN,34844,16711,18133,12719,21453,672,ITH,ITH3,5,Veneto,Veneto,4905854,272478,5.55,0.71
3537,2021-02-11,VEN,4015,1238,2777,3349,628,38,ITH,ITH3,5,Veneto,Veneto,4905854,276493,5.64,0.08
3538,2021-01-28,VEN,9216,2666,6550,169,9045,2,ITH,ITH3,5,Veneto,Veneto,4905854,285709,5.82,0.19
3539,2021-06-17,VEN,51765,25935,25830,25553,25064,1148,ITH,ITH3,5,Veneto,Veneto,4905854,337474,6.88,1.06
3540,2021-03-09,VEN,16566,7459,9107,9828,6338,400,ITH,ITH3,5,Veneto,Veneto,4905854,354040,7.22,0.34
3541,2021-09-08,VEN,27665,14604,13061,5189,21680,796,ITH,ITH3,5,Veneto,Veneto,4905854,381705,7.78,0.56
3542,2021-05-31,VEN,31656,16247,15409,20889,9936,831,ITH,ITH3,5,Veneto,Veneto,4905854,413361,8.43,0.65
3543,2021-03-26,VEN,29618,13164,16454,23281,5468,869,ITH,ITH3,5,Veneto,Veneto,4905854,442979,9.03,0.6
3544,2021-01-23,VEN,4057,1250,2807,31,4026,0,ITH,ITH3,5,Veneto,Veneto,4905854,447036,9.11,0.08
3545,2021-06-29,VEN,45583,22737,22846,19052,25844,687,ITH,ITH3,5,Veneto,Veneto,4905854,492619,10.04,0.93
3546,2021-03-21,VEN,11992,4756,7236,8286,3466,240,ITH,ITH3,5,Veneto,Veneto,4905854,504611,10.29,0.24
3547,2021-01-16,VEN,4612,1542,3070,4612,0,0,ITH,ITH3,5,Veneto,Veneto,4905854,509223,10.38,0.09
3548,2021-05-17,VEN,26553,13001,13552,15651,10080,822,ITH,ITH3,5,Veneto,Veneto,4905854,535776,10.92,0.54
3549,2021-02-06,VEN,4099,1354,2745,708,3391,0,ITH,ITH3,5,Veneto,Veneto,4905854,539875,11.0,0.08
3550,2021-08-25,VEN,20049,10875,9174,8023,11445,581,ITH,ITH3,5,Veneto,Veneto,4905854,559924,11.41,0.41
3551,2021-02-23,VEN,7384,3253,4131,7029,270,85,ITH,ITH3,5,Veneto,Veneto,4905854,567308,11.56,0.15
3552,2021-07-18,VEN,37722,19763,17959,3847,33625,250,ITH,ITH3,5,Veneto,Veneto,4905854,605030,12.33,0.77
3553,2021-02-25,VEN,7904,3345,4559,7158,607,139,ITH,ITH3,5,Veneto,Veneto,4905854,612934,12.49,0.16
3554,2021-04-09,VEN,31205,13767,17438,21911,8350,944,ITH,ITH3,5,Veneto,Veneto,4905854,644139,13.13,0.64
3555,2021-06-05,VEN,46877,24146,22731,37317,8104,1456,ITH,ITH3,5,Veneto,Veneto,4905854,691016,14.09,0.96
3556,2021-07-27,VEN,42265,22181,20084,11790,30043,432,ITH,ITH3,5,Veneto,Veneto,4905854,733281,14.95,0.86
3557,2021-08-01,VEN,27915,14943,12972,11050,16355,510,ITH,ITH3,5,Veneto,Veneto,4905854,761196,15.52,0.57
3558,2021-04-23,VEN,31320,13862,17458,21444,8711,1165,ITH,ITH3,5,Veneto,Veneto,4905854,792516,16.15,0.64
3559,2021-02-16,VEN,6644,2870,3774,6439,176,29,ITH,ITH3,5,Veneto,Veneto,4905854,799160,16.29,0.14
3560,2021-05-12,VEN,37002,17912,19090,30249,5128,1625,ITH,ITH3,5,Veneto,Veneto,4905854,836162,17.04,0.75
3561,2021-07-08,VEN,46730,24315,22415,4504,41925,301,ITH,ITH3,5,Veneto,Veneto,4905854,882892,18.0,0.95
3562,2021-06-24,VEN,56223,28475,27748,17636,37901,686,ITH,ITH3,5,Veneto,Veneto,4905854,939115,19.14,1.15
3563,2021-03-16,VEN,12538,5358,7180,6633,5626,279,ITH,ITH3,5,Veneto,Veneto,4905854,951653,19.4,0.26
3564,2021-08-20,VEN,19458,10541,8917,11288,7579,591,ITH,ITH3,5,Veneto,Veneto,4905854,971111,19.79,0.4
3565,2021-09-01,VEN,21007,10749,10258,7625,12629,753,ITH,ITH3,5,Veneto,Veneto,4905854,992118,20.22,0.43
3566,2021-05-24,VEN,33093,16436,16657,7630,25054,409,ITH,ITH3,5,Veneto,Veneto,4905854,1025211,20.9,0.67
3567,2021-08-15,VEN,3106,1763,1343,2617,426,63,ITH,ITH3,5,Veneto,Veneto,4905854,1028317,20.96,0.06
3568,2021-01-09,VEN,7937,2539,5398,7932,0,5,ITH,ITH3,5,Veneto,Veneto,4905854,1036254,21.12,0.16
3569,2021-03-18,VEN,12626,5145,7481,7037,5236,353,ITH,ITH3,5,Veneto,Veneto,4905854,1048880,21.38,0.26
3570,2021-03-02,VEN,11498,4628,6870,7935,3312,251,ITH,ITH3,5,Veneto,Veneto,4905854,1060378,21.61,0.23
3571,2021-06-10,VEN,52409,27043,25366,41326,9381,1702,ITH,ITH3,5,Veneto,Veneto,4905854,1112787,22.68,1.07
3572,2021-04-02,VEN,24121,10635,13486,17146,6332,643,ITH,ITH3,5,Veneto,Veneto,4905854,1136908,23.17,0.49
3573,2021-03-28,VEN,31315,13610,17705,26883,3615,817,ITH,ITH3,5,Veneto,Veneto,4905854,1168223,23.81,0.64
3574,2021-06-19,VEN,49305,25084,24221,25678,22596,1031,ITH,ITH3,5,Veneto,Veneto,4905854,1217528,24.82,1.01
3575,2021-07-06,VEN,36153,18628,17525,13207,22313,633,ITH,ITH3,5,Veneto,Veneto,4905854,1253681,25.55,0.74
3576,2021-04-14,VEN,15944,6916,9028,8764,6634,546,ITH,ITH3,5,Veneto,Veneto,4905854,1269625,25.88,0.32
3577,2021-01-04,VEN,6740,2037,4703,6738,0,2,ITH,ITH3,5,Veneto,Veneto,4905854,1276365,26.02,0.14
3578,2021-08-22,VEN,9246,5043,4203,5861,3107,278,ITH,ITH3,5,Veneto,Veneto,4905854,1285611,26.21,0.19
3579,2021-08-06,VEN,38334,20921,17413,19867,17593,874,ITH,ITH3,5,Veneto,Veneto,4905854,1323945,26.99,0.78
3580,2021-04-28,VEN,32466,15198,17268,22250,9024,1192,ITH,ITH3,5,Veneto,Veneto,4905854,1356411,27.65,0.66
3581,2021-07-20,VEN,44377,23690,20687,6880,36989,508,ITH,ITH3,5,Veneto,Veneto,4905854,1400788,28.55,0.9
3582,2021-01-18,VEN,2766,778,1988,2560,201,5,ITH,ITH3,5,Veneto,Veneto,4905854,1403554,28.61,0.06
3583,2021-02-04,VEN,7397,2029,5368,550,6846,1,ITH,ITH3,5,Veneto,Veneto,4905854,1410951,28.76,0.15
3584,2021-08-08,VEN,20529,11402,9127,10675,9544,310,ITH,ITH3,5,Veneto,Veneto,4905854,1431480,29.18,0.42
3585,2021-06-12,VEN,48703,24502,24201,36402,10833,1468,ITH,ITH3,5,Veneto,Veneto,4905854,1480183,30.17,0.99
3586,2021-05-29,VEN,33067,16703,16364,24247,7700,1120,ITH,ITH3,5,Veneto,Veneto,4905854,1513250,30.85,0.67
3587,2021-02-18,VEN,5833,2456,3377,5730,64,39,ITH,ITH3,5,Veneto,Veneto,4905854,1519083,30.96,0.12
3588,2021-07-25,VEN,33202,17544,15658,10847,21890,465,ITH,ITH3,5,Veneto,Veneto,4905854,1552285,31.64,0.68
3589,2021-04-16,VEN,24471,10503,13968,11894,11893,684,ITH,ITH3,5,Veneto,Veneto,4905854,1576756,32.14,0.5
3590,2021-03-14,VEN,15186,5945,9241,13844,894,448,ITH,ITH3,5,Veneto,Veneto,4905854,1591942,32.45,0.31
3591,2021-05-10,VEN,36517,17086,19431,25415,9856,1246,ITH,ITH3,5,Veneto,Veneto,4905854,1628459,33.19,0.74
3592,2021-01-30,VEN,8764,2680,6084,690,8074,0,ITH,ITH3,5,Veneto,Veneto,4905854,1637223,33.37,0.18
3593,2021-03-07,VEN,4494,1768,2726,3861,560,73,ITH,ITH3,5,Veneto,Veneto,4905854,1641717,33.46,0.09
3594,2021-03-23,VEN,22228,10249,11979,16869,4717,642,ITH,ITH3,5,Veneto,Veneto,4905854,1663945,33.92,0.45
3595,2021-05-19,VEN,33161,15186,17975,16229,15995,937,ITH,ITH3,5,Veneto,Veneto,4905854,1697106,34.59,0.68
3596,2021-02-08,VEN,5007,1559,3448,1923,3078,6,ITH,ITH3,5,Veneto,Veneto,4905854,1702113,34.7,0.1
3597,2021-04-06,VEN,29032,13367,15665,23256,5046,730,ITH,ITH3,5,Veneto,Veneto,4905854,1731145,35.29,0.59
3598,2021-06-26,VEN,48090,24517,23573,13595,34005,490,ITH,ITH3,5,Veneto,Veneto,4905854,1779235,36.27,0.98
3599,2021-05-07,VEN,48652,23311,25341,37605,8682,2365,ITH,ITH3,5,Veneto,Veneto,4905854,1827887,37.26,0.99
3600,2021-01-27,VEN,7148,2069,5079,239,6908,1,ITH,ITH3,5,Veneto,Veneto,4905854,1835035,37.41,0.15
3601,2021-02-13,VEN,3267,1473,1794,3231,20,16,ITH,ITH3,5,Veneto,Veneto,4905854,1838302,37.47,0.07
3602,2021-09-03,VEN,32046,17155,14891,7541,23711,794,ITH,ITH3,5,Veneto,Veneto,4905854,1870348,38.12,0.65
3603,2021-06-09,VEN,42836,21970,20866,33778,7505,1553,ITH,ITH3,5,Veneto,Veneto,4905854,1913184,39.0,0.87
3604,2021-06-28,VEN,47673,24126,23547,18422,28547,704,ITH,ITH3,5,Veneto,Veneto,4905854,1960857,39.97,0.97
3605,2021-01-25,VEN,6472,2077,4395,157,6315,0,ITH,ITH3,5,Veneto,Veneto,4905854,1967329,40.1,0.13
3606,2021-07-29,VEN,47543,25134,22409,20151,26545,847,ITH,ITH3,5,Veneto,Veneto,4905854,2014872,41.07,0.97
3607,2021-07-15,VEN,51446,26922,24524,6033,45035,378,ITH,ITH3,5,Veneto,Veneto,4905854,2066318,42.12,1.05
3608,2021-04-20,VEN,22468,9508,12960,7880,14011,577,ITH,ITH3,5,Veneto,Veneto,4905854,2088786,42.58,0.46
3609,2021-08-17,VEN,19252,10461,8791,11203,7586,463,ITH,ITH3,5,Veneto,Veneto,4905854,2108038,42.97,0.39
3610,2021-05-09,VEN,35090,16144,18946,23789,10055,1246,ITH,ITH3,5,Veneto,Veneto,4905854,2143128,43.69,0.72
3611,2021-05-26,VEN,31164,15234,15930,13987,16496,681,ITH,ITH3,5,Veneto,Veneto,4905854,2174292,44.32,0.64
3612,2021-05-14,VEN,46829,22275,24554,24285,20960,1584,ITH,ITH3,5,Veneto,Veneto,4905854,2221121,45.27,0.95
3613,2021-02-20,VEN,6432,2019,4413,6276,75,81,ITH,ITH3,5,Veneto,Veneto,4905854,2227553,45.41,0.13
3614,2021-06-02,VEN,20318,10239,10079,15347,4347,624,ITH,ITH3,5,Veneto,Veneto,4905854,2247871,45.82,0.41
3615,2021-08-24,VEN,19885,10599,9286,8896,10454,535,ITH,ITH3,5,Veneto,Veneto,4905854,2267756,46.23,0.41
3616,2021-02-01,VEN,8563,2502,6061,157,8406,0,ITH,ITH3,5,Veneto,Veneto,4905854,2276319,46.4,0.17
3617,2021-02-15,VEN,4392,1827,2565,4143,240,9,ITH,ITH3,5,Veneto,Veneto,4905854,2280711,46.49,0.09
3618,2021-03-30,VEN,36006,15317,20689,29733,5252,1021,ITH,ITH3,5,Veneto,Veneto,4905854,2316717,47.22,0.73
3619,2021-08-02,VEN,40101,21035,19066,16304,23169,628,ITH,ITH3,5,Veneto,Veneto,4905854,2356818,48.04,0.82
3620,2021-08-05,VEN,39232,21437,17795,15696,22928,608,ITH,ITH3,5,Veneto,Veneto,4905854,2396050,48.84,0.8
3621,2021-04-18,VEN,17531,7262,10269,9506,7567,458,ITH,ITH3,5,Veneto,Veneto,4905854,2413581,49.2,0.36
3622,2021-01-08,VEN,9416,2837,6579,9402,0,14,ITH,ITH3,5,Veneto,Veneto,4905854,2422997,49.39,0.19
3623,2021-04-30,VEN,50268,23622,26646,33166,15673,1429,ITH,ITH3,5,Veneto,Veneto,4905854,2473265,50.41,1.02
3624,2021-01-20,VEN,1039,368,671,387,652,0,ITH,ITH3,5,Veneto,Veneto,4905854,2474304,50.44,0.02
3625,2021-07-03,VEN,38705,20120,18585,11028,27102,575,ITH,ITH3,5,Veneto,Veneto,4905854,2513009,51.22,0.79
3626,2021-06-16,VEN,47797,23579,24218,25260,21440,1097,ITH,ITH3,5,Veneto,Veneto,4905854,2560806,52.2,0.97
3627,2021-01-01,VEN,1525,470,1055,1524,0,1,ITH,ITH3,5,Veneto,Veneto,4905854,2562331,52.23,0.03
3628,2021-03-25,VEN,25975,11063,14912,18970,6104,901,ITH,ITH3,5,Veneto,Veneto,4905854,2588306,52.76,0.53
3629,2021-04-11,VEN,21014,8878,12136,14228,6298,488,ITH,ITH3,5,Veneto,Veneto,4905854,2609320,53.19,0.43
3630,2021-07-22,VEN,48399,25128,23271,13313,34434,652,ITH,ITH3,5,Veneto,Veneto,4905854,2657719,54.17,0.99
3631,2021-04-13,VEN,14040,6328,7712,8055,5479,506,ITH,ITH3,5,Veneto,Veneto,4905854,2671759,54.46,0.29
3632,2021-07-05,VEN,39141,20284,18857,14146,24196,799,ITH,ITH3,5,Veneto,Veneto,4905854,2710900,55.26,0.8
3633,2021-01-03,VEN,5158,1562,3596,5158,0,0,ITH,ITH3,5,Veneto,Veneto,4905854,2716058,55.36,0.11
3634,2021-09-02,VEN,22647,12082,10565,6073,15778,796,ITH,ITH3,5,Veneto,Veneto,4905854,2738705,55.83,0.46
3635,2021-03-03,VEN,12102,4648,7454,8389,3502,211,ITH,ITH3,5,Veneto,Veneto,4905854,2750807,56.07,0.25
3636,2021-06-11,VEN,47321,24620,22701,34710,11184,1427,ITH,ITH3,5,Veneto,Veneto,4905854,2798128,57.04,0.96
3637,2021-06-25,VEN,51720,26166,25554,15075,36005,640,ITH,ITH3,5,Veneto,Veneto,4905854,2849848,58.09,1.05
3638,2021-01-13,VEN,5989,1606,4383,5986,0,3,ITH,ITH3,5,Veneto,Veneto,4905854,2855837,58.21,0.12
3639,2021-08-03,VEN,40735,21562,19173,17592,22426,717,ITH,ITH3,5,Veneto,Veneto,4905854,2896572,59.04,0.83
3640,2021-04-25,VEN,18335,8155,10180,12902,4835,598,ITH,ITH3,5,Veneto,Veneto,4905854,2914907,59.42,0.37
3641,2021-06-21,VEN,44339,22192,22147,20464,22967,908,ITH,ITH3,5,Veneto,Veneto,4905854,2959246,60.32,0.9
3642,2021-01-06,VEN,8142,2391,5751,8139,0,3,ITH,ITH3,5,Veneto,Veneto,4905854,2967388,60.49,0.17
3643,2021-06-23,VEN,49370,24459,24911,14555,34016,799,ITH,ITH3,5,Veneto,Veneto,4905854,3016758,61.49,1.01
3644,2021-04-10,VEN,27483,11987,15496,18376,8474,633,ITH,ITH3,5,Veneto,Veneto,4905854,3044241,62.05,0.56
3645,2021-06-06,VEN,37450,19173,18277,31495,4731,1224,ITH,ITH3,5,Veneto,Veneto,4905854,3081691,62.82,0.76
3646,2020-12-27,VEN,880,395,485,880,0,0,ITH,ITH3,5,Veneto,Veneto,4905854,3082571,62.83,0.02
3647,2021-09-07,VEN,26423,14069,12354,5476,20223,724,ITH,ITH3,5,Veneto,Veneto,4905854,3108994,63.37,0.54
3648,2021-05-30,VEN,22550,11273,11277,15205,6691,654,ITH,ITH3,5,Veneto,Veneto,4905854,3131544,63.83,0.46
3649,2021-07-26,VEN,43647,22946,20701,16999,26016,632,ITH,ITH3,5,Veneto,Veneto,4905854,3175191,64.72,0.89
3650,2021-05-03,VEN,40711,19812,20899,32800,6439,1472,ITH,ITH3,5,Veneto,Veneto,4905854,3215902,65.55,0.83
3651,2021-05-28,VEN,46965,22979,23986,23675,22081,1209,ITH,ITH3,5,Veneto,Veneto,4905854,3262867,66.51,0.96
3652,2021-07-24,VEN,41706,22362,19344,13298,27773,635,ITH,ITH3,5,Veneto,Veneto,4905854,3304573,67.36,0.85
3653,2021-07-10,VEN,43197,23216,19981,6303,36541,353,ITH,ITH3,5,Veneto,Veneto,4905854,3347770,68.24,0.88
3654,2021-09-05,VEN,15189,8391,6798,3469,11428,292,ITH,ITH3,5,Veneto,Veneto,4905854,3362959,68.55,0.31
3655,2021-08-31,VEN,19758,10442,9316,6976,12184,598,ITH,ITH3,5,Veneto,Veneto,4905854,3382717,68.95,0.4
3656,2021-03-01,VEN,9395,3717,5678,7410,1822,163,ITH,ITH3,5,Veneto,Veneto,4905854,3392112,69.14,0.19
3657,2021-07-12,VEN,43247,22782,20465,4013,38912,322,ITH,ITH3,5,Veneto,Veneto,4905854,3435359,70.03,0.88
3658,2021-04-03,VEN,21992,9645,12347,13863,7722,407,ITH,ITH3,5,Veneto,Veneto,4905854,3457351,70.47,0.45
3659,2021-03-20,VEN,13035,5393,7642,10657,2082,296,ITH,ITH3,5,Veneto,Veneto,4905854,3470386,70.74,0.27
3660,2021-01-10,VEN,5036,1673,3363,5035,0,1,ITH,ITH3,5,Veneto,Veneto,4905854,3475422,70.84,0.1
3661,2021-05-23,VEN,34492,16470,18022,10620,23400,472,ITH,ITH3,5,Veneto,Veneto,4905854,3509914,71.55,0.7
3662,2021-02-12,VEN,4314,1446,2868,3671,572,71,ITH,ITH3,5,Veneto,Veneto,4905854,3514228,71.63,0.09
3663,2021-03-15,VEN,16673,7331,9342,10956,5212,505,ITH,ITH3,5,Veneto,Veneto,4905854,3530901,71.97,0.34
3664,2021-03-08,VEN,13644,6282,7362,9304,4077,263,ITH,ITH3,5,Veneto,Veneto,4905854,3544545,72.25,0.28
3665,2021-07-19,VEN,44748,23570,21178,7965,36388,395,ITH,ITH3,5,Veneto,Veneto,4905854,3589293,73.16,0.91
3666,2021-02-26,VEN,8298,3273,5025,6943,1260,95,ITH,ITH3,5,Veneto,Veneto,4905854,3597591,73.33,0.17
3667,2021-04-24,VEN,24770,10832,13938,14966,9080,724,ITH,ITH3,5,Veneto,Veneto,4905854,3622361,73.84,0.5
3668,2021-01-14,VEN,7066,1927,5139,7046,0,20,ITH,ITH3,5,Veneto,Veneto,4905854,3629427,73.98,0.14
3669,2021-03-12,VEN,18665,8196,10469,11330,6752,583,ITH,ITH3,5,Veneto,Veneto,4905854,3648092,74.36,0.38
3670,2021-04-17,VEN,22451,9099,13352,14374,7278,799,ITH,ITH3,5,Veneto,Veneto,4905854,3670543,74.82,0.46
3671,2021-01-07,VEN,8361,2317,6044,8360,0,1,ITH,ITH3,5,Veneto,Veneto,4905854,3678904,74.99,0.17
3672,2021-06-13,VEN,37345,19259,18086,29318,6957,1070,ITH,ITH3,5,Veneto,Veneto,4905854,3716249,75.75,0.76
3673,2021-03-11,VEN,19838,8893,10945,13796,5576,466,ITH,ITH3,5,Veneto,Veneto,4905854,3736087,76.16,0.4
3674,2021-07-17,VEN,40612,21484,19128,4293,35974,345,ITH,ITH3,5,Veneto,Veneto,4905854,3776699,76.98,0.83
3675,2021-08-29,VEN,13389,7347,6042,4492,8573,324,ITH,ITH3,5,Veneto,Veneto,4905854,3790088,77.26,0.27
3676,2021-05-21,VEN,44864,22065,22799,19800,23957,1107,ITH,ITH3,5,Veneto,Veneto,4905854,3834952,78.17,0.91
3677,2021-01-29,VEN,9029,2789,6240,365,8664,0,ITH,ITH3,5,Veneto,Veneto,4905854,3843981,78.35,0.18
3678,2021-05-08,VEN,41529,18786,22743,28258,11836,1435,ITH,ITH3,5,Veneto,Veneto,4905854,3885510,79.2,0.85
3679,2021-07-30,VEN,45582,24244,21338,22626,22082,874,ITH,ITH3,5,Veneto,Veneto,4905854,3931092,80.13,0.93
3680,2021-08-16,VEN,19705,10668,9037,12957,6165,583,ITH,ITH3,5,Veneto,Veneto,4905854,3950797,80.53,0.4
3681,2021-05-18,VEN,27036,12552,14484,12634,13639,763,ITH,ITH3,5,Veneto,Veneto,4905854,3977833,81.08,0.55
3682,2021-06-30,VEN,45818,23103,22715,17871,27197,750,ITH,ITH3,5,Veneto,Veneto,4905854,4023651,82.02,0.93
3683,2021-03-22,VEN,18156,8184,9972,12585,5050,521,ITH,ITH3,5,Veneto,Veneto,4905854,4041807,82.39,0.37
3684,2021-03-13,VEN,17241,7312,9929,13735,3132,374,ITH,ITH3,5,Veneto,Veneto,4905854,4059048,82.74,0.35
3685,2021-01-15,VEN,5879,1819,4060,5873,0,6,ITH,ITH3,5,Veneto,Veneto,4905854,4064927,82.86,0.12
3686,2021-08-28,VEN,20854,11585,9269,8637,11479,738,ITH,ITH3,5,Veneto,Veneto,4905854,4085781,83.28,0.43
3687,2021-05-20,VEN,44850,21262,23588,19363,24378,1109,ITH,ITH3,5,Veneto,Veneto,4905854,4130631,84.2,0.91
3688,2021-02-09,VEN,5250,1892,3358,3431,1806,13,ITH,ITH3,5,Veneto,Veneto,4905854,4135881,84.31,0.11
3689,2021-08-30,VEN,26899,14257,12642,7972,18309,618,ITH,ITH3,5,Veneto,Veneto,4905854,4162780,84.85,0.55
3690,2021-09-04,VEN,23571,12881,10690,6047,16872,652,ITH,ITH3,5,Veneto,Veneto,4905854,4186351,85.33,0.48
3691,2021-05-27,VEN,46667,22923,23744,22363,23258,1046,ITH,ITH3,5,Veneto,Veneto,4905854,4233018,86.29,0.95
3692,2021-02-07,VEN,2316,863,1453,714,1601,1,ITH,ITH3,5,Veneto,Veneto,4905854,4235334,86.33,0.05
3693,2021-09-06,VEN,28251,15181,13070,5812,21758,681,ITH,ITH3,5,Veneto,Veneto,4905854,4263585,86.91,0.58
3694,2021-07-02,VEN,49567,25142,24425,16290,32494,783,ITH,ITH3,5,Veneto,Veneto,4905854,4313152,87.92,1.01
3695,2021-03-24,VEN,22126,9581,12545,14664,6806,656,ITH,ITH3,5,Veneto,Veneto,4905854,4335278,88.37,0.45
3696,2021-07-14,VEN,43630,22430,21200,5282,37953,395,ITH,ITH3,5,Veneto,Veneto,4905854,4378908,89.26,0.89
3697,2021-04-22,VEN,32077,13946,18131,15471,15780,826,ITH,ITH3,5,Veneto,Veneto,4905854,4410985,89.91,0.65
3698,2021-07-31,VEN,35175,18902,16273,17032,17502,641,ITH,ITH3,5,Veneto,Veneto,4905854,4446160,90.63,0.72
3699,2021-08-14,VEN,9918,5809,4109,7267,2401,250,ITH,ITH3,5,Veneto,Veneto,4905854,4456078,90.83,0.2
3700,2021-06-08,VEN,43858,22676,21182,36187,6152,1519,ITH,ITH3,5,Veneto,Veneto,4905854,4499936,91.73,0.89
3701,2021-05-25,VEN,27870,13453,14417,11274,16096,500,ITH,ITH3,5,Veneto,Veneto,4905854,4527806,92.29,0.57
3702,2021-02-14,VEN,125,55,70,112,13,0,ITH,ITH3,5,Veneto,Veneto,4905854,4527931,92.3,0.0
3703,2021-02-28,VEN,4136,1389,2747,3224,837,75,ITH,ITH3,5,Veneto,Veneto,4905854,4532067,92.38,0.08
3704,2021-03-17,VEN,14646,5991,8655,7526,6797,323,ITH,ITH3,5,Veneto,Veneto,4905854,4546713,92.68,0.3
3705,2021-01-21,VEN,2294,719,1575,19,2275,0,ITH,ITH3,5,Veneto,Veneto,4905854,4549007,92.73,0.05
3706,2021-03-05,VEN,13341,5023,8318,9222,3674,445,ITH,ITH3,5,Veneto,Veneto,4905854,4562348,93.0,0.27
3707,2021-06-18,VEN,53661,26781,26880,23982,28637,1042,ITH,ITH3,5,Veneto,Veneto,4905854,4616009,94.09,1.09
3708,2021-03-27,VEN,32093,14018,18075,25377,5807,909,ITH,ITH3,5,Veneto,Veneto,4905854,4648102,94.75,0.65
3709,2021-06-03,VEN,54534,28044,26490,40875,12005,1654,ITH,ITH3,5,Veneto,Veneto,4905854,4702636,95.86,1.11
3710,2021-06-20,VEN,41211,20067,21144,18927,21543,741,ITH,ITH3,5,Veneto,Veneto,4905854,4743847,96.7,0.84
3711,2021-02-19,VEN,7323,3141,4182,6995,204,124,ITH,ITH3,5,Veneto,Veneto,4905854,4751170,96.85,0.15
3712,2021-02-17,VEN,6022,2772,3250,5900,94,28,ITH,ITH3,5,Veneto,Veneto,4905854,4757192,96.97,0.12
3713,2021-04-01,VEN,25405,11197,14208,18213,6414,778,ITH,ITH3,5,Veneto,Veneto,4905854,4782597,97.49,0.52
3714,2021-04-15,VEN,20942,8654,12288,9362,10833,747,ITH,ITH3,5,Veneto,Veneto,4905854,4803539,97.91,0.43
3715,2021-01-05,VEN,7335,2186,5149,7333,0,2,ITH,ITH3,5,Veneto,Veneto,4905854,4810874,98.06,0.15
3716,2021-06-27,VEN,40240,20557,19683,15348,24311,581,ITH,ITH3,5,Veneto,Veneto,4905854,4851114,98.88,0.82
3717,2021-03-19,VEN,13804,5672,8132,7403,6106,295,ITH,ITH3,5,Veneto,Veneto,4905854,4864918,99.17,0.28
3718,2021-04-27,VEN,28213,12798,15415,20132,6916,1165,ITH,ITH3,5,Veneto,Veneto,4905854,4893131,99.74,0.58
3719,2021-01-17,VEN,1933,781,1152,1584,349,0,ITH,ITH3,5,Veneto,Veneto,4905854,4895064,99.78,0.04
3720,2021-02-03,VEN,5955,1672,4283,474,5477,4,ITH,ITH3,5,Veneto,Veneto,4905854,4901019,99.9,0.12
3721,2021-08-07,VEN,28951,16294,12657,16330,12072,549,ITH,ITH3,5,Veneto,Veneto,4905854,4929970,100.49,0.59
3722,2021-04-29,VEN,50331,23413,26918,35406,13184,1741,ITH,ITH3,5,Veneto,Veneto,4905854,4980301,101.52,1.03
3723,2021-07-21,VEN,43279,22339,20940,8698,34083,498,ITH,ITH3,5,Veneto,Veneto,4905854,5023580,102.4,0.88
3724,2021-02-05,VEN,8390,2541,5849,1407,6974,9,ITH,ITH3,5,Veneto,Veneto,4905854,5031970,102.57,0.17
3725,2021-02-22,VEN,7019,3044,3975,6581,391,47,ITH,ITH3,5,Veneto,Veneto,4905854,5038989,102.71,0.14
3726,2021-05-16,VEN,28422,14015,14407,20317,7081,1024,ITH,ITH3,5,Veneto,Veneto,4905854,5067411,103.29,0.58
3727,2021-08-09,VEN,34767,18642,16125,17131,16863,773,ITH,ITH3,5,Veneto,Veneto,4905854,5102178,104.0,0.71
3728,2021-08-26,VEN,22307,11883,10424,8315,13385,607,ITH,ITH3,5,Veneto,Veneto,4905854,5124485,104.46,0.45
3729,2021-02-10,VEN,4762,1593,3169,3692,1061,9,ITH,ITH3,5,Veneto,Veneto,4905854,5129247,104.55,0.1
3730,2021-04-08,VEN,32410,14388,18022,23347,7887,1176,ITH,ITH3,5,Veneto,Veneto,4905854,5161657,105.21,0.66
3731,2021-06-04,VEN,49652,25840,23812,39833,8143,1676,ITH,ITH3,5,Veneto,Veneto,4905854,5211309,106.23,1.01
3732,2021-02-24,VEN,8622,3680,4942,7998,489,135,ITH,ITH3,5,Veneto,Veneto,4905854,5219931,106.4,0.18
3733,2021-06-22,VEN,43746,21630,22116,18502,24389,855,ITH,ITH3,5,Veneto,Veneto,4905854,5263677,107.29,0.89
3734,2021-08-18,VEN,23320,12569,10751,14192,8444,684,ITH,ITH3,5,Veneto,Veneto,4905854,5286997,107.77,0.48
3735,2021-08-04,VEN,42448,22671,19777,22591,18763,1094,ITH,ITH3,5,Veneto,Veneto,4905854,5329445,108.63,0.87
3736,2021-08-23,VEN,24513,13027,11486,10567,13233,713,ITH,ITH3,5,Veneto,Veneto,4905854,5353958,109.13,0.5
3737,2021-02-21,VEN,4640,1212,3428,4516,5,119,ITH,ITH3,5,Veneto,Veneto,4905854,5358598,109.23,0.09
3738,2021-05-15,VEN,36275,17520,18755,24820,10023,1432,ITH,ITH3,5,Veneto,Veneto,4905854,5394873,109.97,0.74
3739,2021-06-01,VEN,26996,13569,13427,15788,10560,648,ITH,ITH3,5,Veneto,Veneto,4905854,5421869,110.52,0.55
3740,2021-03-10,VEN,19044,8728,10316,12959,5686,399,ITH,ITH3,5,Veneto,Veneto,4905854,5440913,110.91,0.39
3741,2021-07-28,VEN,40299,20922,19377,12055,27795,449,ITH,ITH3,5,Veneto,Veneto,4905854,5481212,111.73,0.82
3742,2021-01-12,VEN,5231,1517,3714,5223,0,8,ITH,ITH3,5,Veneto,Veneto,4905854,5486443,111.83,0.11
3743,2021-04-19,VEN,21558,8929,12629,4708,16420,430,ITH,ITH3,5,Veneto,Veneto,4905854,5508001,112.27,0.44
3744,2021-04-05,VEN,19165,8376,10789,13422,5439,304,ITH,ITH3,5,Veneto,Veneto,4905854,5527166,112.66,0.39
3745,2021-01-26,VEN,6925,2092,4833,149,6776,0,ITH,ITH3,5,Veneto,Veneto,4905854,5534091,112.81,0.14
3746,2021-05-06,VEN,47056,22067,24989,36577,8499,1980,ITH,ITH3,5,Veneto,Veneto,4905854,5581147,113.77,0.96
3747,2020-12-31,VEN,3221,1042,2179,3221,0,0,ITH,ITH3,5,Veneto,Veneto,4905854,5584368,113.83,0.07
3748,2021-07-04,VEN,33886,17580,16306,14992,18289,605,ITH,ITH3,5,Veneto,Veneto,4905854,5618254,114.52,0.69
3749,2021-04-12,VEN,14919,6345,8574,6397,8218,304,ITH,ITH3,5,Veneto,Veneto,4905854,5633173,114.83,0.3
3750,2021-01-02,VEN,5742,1766,3976,5741,0,1,ITH,ITH3,5,Veneto,Veneto,4905854,5638915,114.94,0.12
3751,2021-01-19,VEN,1313,475,838,1163,149,1,ITH,ITH3,5,Veneto,Veneto,4905854,5640228,114.97,0.03
3752,2021-07-23,VEN,44498,23460,21038,15138,28786,574,ITH,ITH3,5,Veneto,Veneto,4905854,5684726,115.88,0.91
3753,2021-05-01,VEN,38878,18253,20625,28712,8929,1237,ITH,ITH3,5,Veneto,Veneto,4905854,5723604,116.67,0.79
3754,2021-04-26,VEN,20733,9461,11272,14911,5140,682,ITH,ITH3,5,Veneto,Veneto,4905854,5744337,117.09,0.42
3755,2021-06-15,VEN,47843,24302,23541,29144,17545,1154,ITH,ITH3,5,Veneto,Veneto,4905854,5792180,118.07,0.98
3756,2021-08-11,VEN,26784,14793,11991,15639,10569,576,ITH,ITH3,5,Veneto,Veneto,4905854,5818964,118.61,0.55
3757,2021-05-02,VEN,37247,17266,19981,25608,10331,1308,ITH,ITH3,5,Veneto,Veneto,4905854,5856211,119.37,0.76
3758,2021-06-14,VEN,42629,21561,21068,26294,15320,1015,ITH,ITH3,5,Veneto,Veneto,4905854,5898840,120.24,0.87
3759,2021-03-06,VEN,10687,4357,6330,7215,3280,192,ITH,ITH3,5,Veneto,Veneto,4905854,5909527,120.46,0.22
3760,2021-08-10,VEN,28492,15631,12861,16404,11478,610,ITH,ITH3,5,Veneto,Veneto,4905854,5938019,121.04,0.58
3761,2020-12-30,VEN,699,245,454,699,0,0,ITH,ITH3,5,Veneto,Veneto,4905854,5938718,121.05,0.01
3762,2021-08-12,VEN,24160,13081,11079,17288,6163,709,ITH,ITH3,5,Veneto,Veneto,4905854,5962878,121.55,0.49
3763,2021-06-07,VEN,44701,23319,21382,36173,7043,1485,ITH,ITH3,5,Veneto,Veneto,4905854,6007579,122.46,0.91
3764,2021-02-27,VEN,8994,2693,6301,7964,849,181,ITH,ITH3,5,Veneto,Veneto,4905854,6016573,122.64,0.18
3765,2021-03-04,VEN,12990,4890,8100,9119,3479,392,ITH,ITH3,5,Veneto,Veneto,4905854,6029563,122.91,0.26
3766,2021-07-07,VEN,40980,21322,19658,15643,24540,797,ITH,ITH3,5,Veneto,Veneto,4905854,6070543,123.74,0.84
3767,2021-08-19,VEN,19546,10653,8893,12200,6811,535,ITH,ITH3,5,Veneto,Veneto,4905854,6090089,124.14,0.4
3768,2021-05-11,VEN,33198,16515,16683,27144,4729,1325,ITH,ITH3,5,Veneto,Veneto,4905854,6123287,124.82,0.68
3769,2021-01-22,VEN,1080,332,748,25,1055,0,ITH,ITH3,5,Veneto,Veneto,4905854,6124367,124.84,0.02
3770,2021-08-21,VEN,12168,6867,5301,8270,3380,518,ITH,ITH3,5,Veneto,Veneto,4905854,6136535,125.09,0.25
3771,2021-05-04,VEN,43032,20383,22649,33354,8033,1645,ITH,ITH3,5,Veneto,Veneto,4905854,6179567,125.96,0.88
3772,2021-01-24,VEN,4117,1219,2898,28,4089,0,ITH,ITH3,5,Veneto,Veneto,4905854,6183684,126.05,0.08
3773,2021-04-07,VEN,36064,16206,19858,27609,7341,1114,ITH,ITH3,5,Veneto,Veneto,4905854,6219748,126.78,0.74
3774,2021-07-16,VEN,44738,24066,20672,6957,37320,461,ITH,ITH3,5,Veneto,Veneto,4905854,6264486,127.69,0.91
3775,2021-01-31,VEN,4789,1566,3223,408,4381,0,ITH,ITH3,5,Veneto,Veneto,4905854,6269275,127.79,0.1
3776,2021-03-29,VEN,31475,13706,17769,26647,3828,1000,ITH,ITH3,5,Veneto,Veneto,4905854,6300750,128.43,0.64
3777,2021-05-13,VEN,44343,21882,22461,32580,9919,1844,ITH,ITH3,5,Veneto,Veneto,4905854,6345093,129.34,0.9
3778,2021-02-02,VEN,6515,1881,4634,396,6119,0,ITH,ITH3,5,Veneto,Veneto,4905854,6351608,129.47,0.13
3779,2021-07-09,VEN,45091,23782,21309,4126,40680,285,ITH,ITH3,5,Veneto,Veneto,4905854,6396699,130.39,0.92
3780,2021-03-31,VEN,38979,16460,22519,30422,7508,1049,ITH,ITH3,5,Veneto,Veneto,4905854,6435678,131.18,0.79
3781,2021-07-11,VEN,34239,17925,16314,3700,30284,255,ITH,ITH3,5,Veneto,Veneto,4905854,6469917,131.88,0.7
3782,2021-03-14,LIG,1659,752,907,1043,604,12,ITC,ITC3,7,Liguria,Liguria,1550640,1659,0.11,0.11
3783,2021-08-18,LIG,12214,6591,5623,4247,7846,121,ITC,ITC3,7,Liguria,Liguria,1550640,13873,0.89,0.79
3784,2021-06-22,LIG,15817,7468,8349,7617,8135,65,ITC,ITC3,7,Liguria,Liguria,1550640,29690,1.91,1.02
3785,2021-07-06,LIG,12372,6073,6299,5637,6651,84,ITC,ITC3,7,Liguria,Liguria,1550640,42062,2.71,0.8
3786,2021-05-10,LIG,12663,5649,7014,6201,6382,80,ITC,ITC3,7,Liguria,Liguria,1550640,54725,3.53,0.82
3787,2021-08-30,LIG,9783,5225,4558,2468,7239,76,ITC,ITC3,7,Liguria,Liguria,1550640,64508,4.16,0.63
3788,2021-02-11,LIG,1990,772,1218,1093,888,9,ITC,ITC3,7,Liguria,Liguria,1550640,66498,4.29,0.13
3789,2021-05-22,LIG,6657,3222,3435,4879,1687,91,ITC,ITC3,7,Liguria,Liguria,1550640,73155,4.72,0.43
3790,2021-06-10,LIG,18893,9741,9152,13127,5674,92,ITC,ITC3,7,Liguria,Liguria,1550640,92048,5.94,1.22
3791,2021-03-19,LIG,5303,2237,3066,2100,3152,51,ITC,ITC3,7,Liguria,Liguria,1550640,97351,6.28,0.34
3792,2021-03-02,LIG,4082,1694,2388,3764,310,8,ITC,ITC3,7,Liguria,Liguria,1550640,101433,6.54,0.26
3793,2021-07-11,LIG,2151,1194,957,1230,903,18,ITC,ITC3,7,Liguria,Liguria,1550640,103584,6.68,0.14
3794,2021-02-28,LIG,1060,580,480,1048,11,1,ITC,ITC3,7,Liguria,Liguria,1550640,104644,6.75,0.07
3795,2021-09-01,LIG,8496,4473,4023,2716,5713,67,ITC,ITC3,7,Liguria,Liguria,1550640,113140,7.3,0.55
3796,2021-04-26,LIG,10592,4998,5594,7863,2642,87,ITC,ITC3,7,Liguria,Liguria,1550640,123732,7.98,0.68
3797,2021-01-16,LIG,1279,558,721,1274,0,5,ITC,ITC3,7,Liguria,Liguria,1550640,125011,8.06,0.08
3798,2021-02-02,LIG,2675,1007,1668,127,2546,2,ITC,ITC3,7,Liguria,Liguria,1550640,127686,8.23,0.17
3799,2021-04-28,LIG,14469,6527,7942,6381,8000,88,ITC,ITC3,7,Liguria,Liguria,1550640,142155,9.17,0.93
3800,2021-08-06,LIG,12210,6204,6006,3970,8123,117,ITC,ITC3,7,Liguria,Liguria,1550640,154365,9.95,0.79
3801,2021-02-04,LIG,2820,990,1830,177,2643,0,ITC,ITC3,7,Liguria,Liguria,1550640,157185,10.14,0.18
3802,2021-01-28,LIG,2851,972,1879,37,2814,0,ITC,ITC3,7,Liguria,Liguria,1550640,160036,10.32,0.18
3803,2021-03-26,LIG,9358,4041,5317,6093,3158,107,ITC,ITC3,7,Liguria,Liguria,1550640,169394,10.92,0.6
3804,2021-07-04,LIG,4862,2583,2279,3806,1001,55,ITC,ITC3,7,Liguria,Liguria,1550640,174256,11.24,0.31
3805,2021-01-02,LIG,693,247,446,693,0,0,ITC,ITC3,7,Liguria,Liguria,1550640,174949,11.28,0.04
3806,2021-08-01,LIG,1490,856,634,152,1338,0,ITC,ITC3,7,Liguria,Liguria,1550640,176439,11.38,0.1
3807,2021-02-16,LIG,2430,958,1472,1995,430,5,ITC,ITC3,7,Liguria,Liguria,1550640,178869,11.54,0.16
3808,2021-07-23,LIG,20013,10311,9702,5136,14767,110,ITC,ITC3,7,Liguria,Liguria,1550640,198882,12.83,1.29
3809,2021-05-27,LIG,17011,8720,8291,12677,4175,159,ITC,ITC3,7,Liguria,Liguria,1550640,215893,13.92,1.1
3810,2021-04-14,LIG,13084,5675,7409,10751,2211,122,ITC,ITC3,7,Liguria,Liguria,1550640,228977,14.77,0.84
3811,2021-07-18,LIG,2384,1223,1161,385,1984,15,ITC,ITC3,7,Liguria,Liguria,1550640,231361,14.92,0.15
3812,2021-06-05,LIG,8109,4131,3978,4926,3156,27,ITC,ITC3,7,Liguria,Liguria,1550640,239470,15.44,0.52
3813,2021-04-09,LIG,12483,5569,6914,10560,1787,136,ITC,ITC3,7,Liguria,Liguria,1550640,251953,16.25,0.81
3814,2021-03-31,LIG,11955,5292,6663,9071,2780,104,ITC,ITC3,7,Liguria,Liguria,1550640,263908,17.02,0.77
3815,2021-05-03,LIG,13267,5922,7345,6358,6822,87,ITC,ITC3,7,Liguria,Liguria,1550640,277175,17.87,0.86
3816,2021-08-11,LIG,13126,6731,6395,4786,8229,111,ITC,ITC3,7,Liguria,Liguria,1550640,290301,18.72,0.85
3817,2021-03-21,LIG,551,220,331,69,482,0,ITC,ITC3,7,Liguria,Liguria,1550640,290852,18.76,0.04
3818,2021-08-25,LIG,9350,5035,4315,3221,6022,107,ITC,ITC3,7,Liguria,Liguria,1550640,300202,19.36,0.6
3819,2021-01-23,LIG,813,297,516,156,657,0,ITC,ITC3,7,Liguria,Liguria,1550640,301015,19.41,0.05
3820,2021-06-29,LIG,15191,7238,7953,8641,6463,87,ITC,ITC3,7,Liguria,Liguria,1550640,316206,20.39,0.98
3821,2021-05-17,LIG,12049,5530,6519,8610,3371,68,ITC,ITC3,7,Liguria,Liguria,1550640,328255,21.17,0.78
3822,2021-06-24,LIG,11164,5449,5715,6228,4864,72,ITC,ITC3,7,Liguria,Liguria,1550640,339419,21.89,0.72
3823,2021-04-02,LIG,11796,5223,6573,9221,2489,86,ITC,ITC3,7,Liguria,Liguria,1550640,351215,22.65,0.76
3824,2021-04-21,LIG,14295,6461,7834,8861,5345,89,ITC,ITC3,7,Liguria,Liguria,1550640,365510,23.57,0.92
3825,2021-07-30,LIG,16085,8334,7751,4667,11336,82,ITC,ITC3,7,Liguria,Liguria,1550640,381595,24.61,1.04
3826,2021-08-13,LIG,10896,5628,5268,3928,6876,92,ITC,ITC3,7,Liguria,Liguria,1550640,392491,25.31,0.7
3827,2021-05-08,LIG,7540,3337,4203,2274,5228,38,ITC,ITC3,7,Liguria,Liguria,1550640,400031,25.8,0.49
3828,2021-01-25,LIG,2734,893,1841,475,2258,1,ITC,ITC3,7,Liguria,Liguria,1550640,402765,25.97,0.18
3829,2021-05-05,LIG,13725,6143,7582,5178,8463,84,ITC,ITC3,7,Liguria,Liguria,1550640,416490,26.86,0.89
3830,2021-01-09,LIG,1338,484,854,1337,0,1,ITC,ITC3,7,Liguria,Liguria,1550640,417828,26.95,0.09
3831,2021-04-19,LIG,12840,5622,7218,8917,3834,89,ITC,ITC3,7,Liguria,Liguria,1550640,430668,27.77,0.83
3832,2021-07-13,LIG,13108,6449,6659,3477,9582,49,ITC,ITC3,7,Liguria,Liguria,1550640,443776,28.62,0.85
3833,2021-05-15,LIG,7323,3276,4047,4296,2961,66,ITC,ITC3,7,Liguria,Liguria,1550640,451099,29.09,0.47
3834,2021-02-21,LIG,868,490,378,862,4,2,ITC,ITC3,7,Liguria,Liguria,1550640,451967,29.15,0.06
3835,2021-06-15,LIG,17434,8472,8962,9276,8092,66,ITC,ITC3,7,Liguria,Liguria,1550640,469401,30.27,1.12
3836,2021-03-07,LIG,1915,1139,776,1602,301,12,ITC,ITC3,7,Liguria,Liguria,1550640,471316,30.39,0.12
3837,2021-09-08,LIG,7456,3896,3560,2123,5239,94,ITC,ITC3,7,Liguria,Liguria,1550640,478772,30.88,0.48
3838,2021-06-17,LIG,16712,7943,8769,9086,7545,81,ITC,ITC3,7,Liguria,Liguria,1550640,495484,31.95,1.08
3839,2021-05-29,LIG,6880,3261,3619,3981,2873,26,ITC,ITC3,7,Liguria,Liguria,1550640,502364,32.4,0.44
3840,2021-09-06,LIG,8031,4151,3880,2730,5204,97,ITC,ITC3,7,Liguria,Liguria,1550640,510395,32.92,0.52
3841,2021-07-25,LIG,6405,3273,3132,651,5743,11,ITC,ITC3,7,Liguria,Liguria,1550640,516800,33.33,0.41
3842,2021-02-09,LIG,1956,696,1260,263,1691,2,ITC,ITC3,7,Liguria,Liguria,1550640,518756,33.45,0.13
3843,2020-12-28,LIG,80,30,50,80,0,0,ITC,ITC3,7,Liguria,Liguria,1550640,518836,33.46,0.01
3844,2021-06-03,LIG,15553,7710,7843,9111,6390,52,ITC,ITC3,7,Liguria,Liguria,1550640,534389,34.46,1.0
3845,2021-04-07,LIG,13694,6115,7579,11310,2292,92,ITC,ITC3,7,Liguria,Liguria,1550640,548083,35.35,0.88
3846,2021-02-23,LIG,3809,1559,2250,3663,109,37,ITC,ITC3,7,Liguria,Liguria,1550640,551892,35.59,0.25
3847,2021-08-10,LIG,13130,6556,6574,4279,8711,140,ITC,ITC3,7,Liguria,Liguria,1550640,565022,36.44,0.85
3848,2021-01-21,LIG,1109,385,724,677,431,1,ITC,ITC3,7,Liguria,Liguria,1550640,566131,36.51,0.07
3849,2021-08-20,LIG,9428,5025,4403,3141,6197,90,ITC,ITC3,7,Liguria,Liguria,1550640,575559,37.12,0.61
3850,2021-01-30,LIG,1666,572,1094,22,1643,1,ITC,ITC3,7,Liguria,Liguria,1550640,577225,37.22,0.11
3851,2021-03-28,LIG,1141,510,631,381,752,8,ITC,ITC3,7,Liguria,Liguria,1550640,578366,37.3,0.07
3852,2021-08-29,LIG,738,420,318,173,562,3,ITC,ITC3,7,Liguria,Liguria,1550640,579104,37.35,0.05
3853,2021-07-29,LIG,17992,9204,8788,4403,13512,77,ITC,ITC3,7,Liguria,Liguria,1550640,597096,38.51,1.16
3854,2021-03-16,LIG,6091,2733,3358,2317,3735,39,ITC,ITC3,7,Liguria,Liguria,1550640,603187,38.9,0.39
3855,2021-01-11,LIG,2658,994,1664,2656,0,2,ITC,ITC3,7,Liguria,Liguria,1550640,605845,39.07,0.17
3856,2021-08-15,LIG,1410,785,625,849,528,33,ITC,ITC3,7,Liguria,Liguria,1550640,607255,39.16,0.09
3857,2021-05-24,LIG,11894,5596,6298,9283,2511,100,ITC,ITC3,7,Liguria,Liguria,1550640,619149,39.93,0.77
3858,2021-05-07,LIG,13618,6049,7569,5714,7812,92,ITC,ITC3,7,Liguria,Liguria,1550640,632767,40.81,0.88
3859,2021-02-13,LIG,1080,508,572,797,280,3,ITC,ITC3,7,Liguria,Liguria,1550640,633847,40.88,0.07
3860,2021-06-07,LIG,15720,7672,8048,8627,7037,56,ITC,ITC3,7,Liguria,Liguria,1550640,649567,41.89,1.01
3861,2021-06-26,LIG,7229,3365,3864,4434,2724,71,ITC,ITC3,7,Liguria,Liguria,1550640,656796,42.36,0.47
3862,2021-07-10,LIG,6910,3486,3424,2726,4135,49,ITC,ITC3,7,Liguria,Liguria,1550640,663706,42.8,0.45
3863,2021-04-04,LIG,764,369,395,508,251,5,ITC,ITC3,7,Liguria,Liguria,1550640,664470,42.85,0.05
3864,2021-04-18,LIG,2619,1165,1454,2094,470,55,ITC,ITC3,7,Liguria,Liguria,1550640,667089,43.02,0.17
3865,2020-12-30,LIG,12,5,7,12,0,0,ITC,ITC3,7,Liguria,Liguria,1550640,667101,43.02,0.0
3866,2021-07-03,LIG,8826,4378,4448,5442,3331,53,ITC,ITC3,7,Liguria,Liguria,1550640,675927,43.59,0.57
3867,2021-04-11,LIG,4251,1930,2321,3958,249,44,ITC,ITC3,7,Liguria,Liguria,1550640,680178,43.86,0.27
3868,2021-07-20,LIG,13980,6883,7097,2718,11200,62,ITC,ITC3,7,Liguria,Liguria,1550640,694158,44.77,0.9
3869,2021-02-06,LIG,1892,768,1124,145,1747,0,ITC,ITC3,7,Liguria,Liguria,1550640,696050,44.89,0.12
3870,2021-09-05,LIG,1014,569,445,272,738,4,ITC,ITC3,7,Liguria,Liguria,1550640,697064,44.95,0.07
3871,2021-06-11,LIG,17877,9103,8774,11729,6082,66,ITC,ITC3,7,Liguria,Liguria,1550640,714941,46.11,1.15
3872,2021-06-14,LIG,15168,7323,7845,8214,6879,75,ITC,ITC3,7,Liguria,Liguria,1550640,730109,47.08,0.98
3873,2021-02-25,LIG,3459,1349,2110,3307,130,22,ITC,ITC3,7,Liguria,Liguria,1550640,733568,47.31,0.22
3874,2021-06-02,LIG,8544,4347,4197,5336,3177,31,ITC,ITC3,7,Liguria,Liguria,1550640,742112,47.86,0.55
3875,2021-06-19,LIG,7416,3776,3640,5692,1672,52,ITC,ITC3,7,Liguria,Liguria,1550640,749528,48.34,0.48
3876,2021-02-18,LIG,2772,1128,1644,2425,339,8,ITC,ITC3,7,Liguria,Liguria,1550640,752300,48.52,0.18
3877,2021-05-14,LIG,13165,5871,7294,8640,4351,174,ITC,ITC3,7,Liguria,Liguria,1550640,765465,49.36,0.85
3878,2021-08-22,LIG,760,441,319,175,579,6,ITC,ITC3,7,Liguria,Liguria,1550640,766225,49.41,0.05
3879,2021-05-31,LIG,14732,7389,7343,9122,5527,83,ITC,ITC3,7,Liguria,Liguria,1550640,780957,50.36,0.95
3880,2021-03-09,LIG,5941,2757,3184,4450,1433,58,ITC,ITC3,7,Liguria,Liguria,1550640,786898,50.75,0.38
3881,2021-02-20,LIG,1337,639,698,1334,1,2,ITC,ITC3,7,Liguria,Liguria,1550640,788235,50.83,0.09
3882,2021-07-12,LIG,13459,6464,6995,4156,9241,62,ITC,ITC3,7,Liguria,Liguria,1550640,801694,51.7,0.87
3883,2021-01-10,LIG,651,264,387,647,0,4,ITC,ITC3,7,Liguria,Liguria,1550640,802345,51.74,0.04
3884,2021-04-20,LIG,14255,6525,7730,9744,4360,151,ITC,ITC3,7,Liguria,Liguria,1550640,816600,52.66,0.92
3885,2021-08-17,LIG,9851,5170,4681,3643,6112,96,ITC,ITC3,7,Liguria,Liguria,1550640,826451,53.3,0.64
3886,2021-03-04,LIG,4743,2118,2625,3840,848,55,ITC,ITC3,7,Liguria,Liguria,1550640,831194,53.6,0.31
3887,2021-06-12,LIG,10263,4992,5271,7448,2760,55,ITC,ITC3,7,Liguria,Liguria,1550640,841457,54.27,0.66
3888,2021-04-30,LIG,14440,6452,7988,5773,8580,87,ITC,ITC3,7,Liguria,Liguria,1550640,855897,55.2,0.93
3889,2021-03-06,LIG,3305,1842,1463,2581,705,19,ITC,ITC3,7,Liguria,Liguria,1550640,859202,55.41,0.21
3890,2021-01-22,LIG,1828,606,1222,1337,489,2,ITC,ITC3,7,Liguria,Liguria,1550640,861030,55.53,0.12
3891,2021-05-02,LIG,3981,1837,2144,503,3472,6,ITC,ITC3,7,Liguria,Liguria,1550640,865011,55.78,0.26
3892,2021-04-15,LIG,11855,5242,6613,9893,1858,104,ITC,ITC3,7,Liguria,Liguria,1550640,876866,56.55,0.76
3893,2021-04-08,LIG,13798,6184,7614,11614,2049,135,ITC,ITC3,7,Liguria,Liguria,1550640,890664,57.44,0.89
3894,2021-07-17,LIG,6514,3360,3154,1800,4696,18,ITC,ITC3,7,Liguria,Liguria,1550640,897178,57.86,0.42
3895,2021-07-31,LIG,8263,4413,3850,1310,6926,27,ITC,ITC3,7,Liguria,Liguria,1550640,905441,58.39,0.53
3896,2021-06-04,LIG,14801,7267,7534,9230,5501,70,ITC,ITC3,7,Liguria,Liguria,1550640,920242,59.35,0.95
3897,2021-01-14,LIG,2983,1056,1927,2982,0,1,ITC,ITC3,7,Liguria,Liguria,1550640,923225,59.54,0.19
3898,2021-03-12,LIG,6223,2874,3349,3690,2475,58,ITC,ITC3,7,Liguria,Liguria,1550640,929448,59.94,0.4
3899,2021-07-01,LIG,13575,6547,7028,7300,6176,99,ITC,ITC3,7,Liguria,Liguria,1550640,943023,60.82,0.88
3900,2021-05-19,LIG,13585,5966,7619,10326,3127,132,ITC,ITC3,7,Liguria,Liguria,1550640,956608,61.69,0.88
3901,2021-03-23,LIG,9297,4235,5062,5993,3218,86,ITC,ITC3,7,Liguria,Liguria,1550640,965905,62.29,0.6
3902,2021-08-27,LIG,9208,4915,4293,2834,6300,74,ITC,ITC3,7,Liguria,Liguria,1550640,975113,62.88,0.59
3903,2021-07-15,LIG,14790,7482,7308,5147,9514,129,ITC,ITC3,7,Liguria,Liguria,1550640,989903,63.84,0.95
3904,2021-07-27,LIG,17440,8884,8556,4361,13002,77,ITC,ITC3,7,Liguria,Liguria,1550640,1007343,64.96,1.12
3905,2021-01-08,LIG,2941,1002,1939,2939,0,2,ITC,ITC3,7,Liguria,Liguria,1550640,1010284,65.15,0.19
3906,2021-01-27,LIG,1749,604,1145,139,1609,1,ITC,ITC3,7,Liguria,Liguria,1550640,1012033,65.27,0.11
3907,2021-05-21,LIG,12872,5967,6905,9604,3135,133,ITC,ITC3,7,Liguria,Liguria,1550640,1024905,66.1,0.83
3908,2021-02-27,LIG,1888,921,967,1755,129,4,ITC,ITC3,7,Liguria,Liguria,1550640,1026793,66.22,0.12
3909,2021-02-10,LIG,2325,840,1485,1017,1305,3,ITC,ITC3,7,Liguria,Liguria,1550640,1029118,66.37,0.15
3910,2021-08-14,LIG,3209,1717,1492,895,2297,17,ITC,ITC3,7,Liguria,Liguria,1550640,1032327,66.57,0.21
3911,2021-03-18,LIG,4991,2125,2866,1978,2983,30,ITC,ITC3,7,Liguria,Liguria,1550640,1037318,66.9,0.32
3912,2021-04-01,LIG,12441,5518,6923,9587,2776,78,ITC,ITC3,7,Liguria,Liguria,1550640,1049759,67.7,0.8
3913,2021-05-04,LIG,13662,6095,7567,5361,8235,66,ITC,ITC3,7,Liguria,Liguria,1550640,1063421,68.58,0.88
3914,2021-08-12,LIG,12535,6447,6088,4603,7845,87,ITC,ITC3,7,Liguria,Liguria,1550640,1075956,69.39,0.81
3915,2021-05-09,LIG,2827,1245,1582,1085,1712,30,ITC,ITC3,7,Liguria,Liguria,1550640,1078783,69.57,0.18
3916,2021-08-07,LIG,5197,2656,2541,1120,4055,22,ITC,ITC3,7,Liguria,Liguria,1550640,1083980,69.91,0.34
3917,2021-05-16,LIG,3712,1863,1849,2119,1567,26,ITC,ITC3,7,Liguria,Liguria,1550640,1087692,70.14,0.24
3918,2021-08-24,LIG,8732,4528,4204,2910,5734,88,ITC,ITC3,7,Liguria,Liguria,1550640,1096424,70.71,0.56
3919,2021-02-22,LIG,3349,1479,1870,3197,143,9,ITC,ITC3,7,Liguria,Liguria,1550640,1099773,70.92,0.22
3920,2021-02-17,LIG,2701,1185,1516,2254,435,12,ITC,ITC3,7,Liguria,Liguria,1550640,1102474,71.1,0.17
3921,2021-07-24,LIG,11609,6039,5570,2311,9246,52,ITC,ITC3,7,Liguria,Liguria,1550640,1114083,71.85,0.75
3922,2021-05-28,LIG,16325,8157,8168,11619,4561,145,ITC,ITC3,7,Liguria,Liguria,1550640,1130408,72.9,1.05
3923,2021-01-05,LIG,2880,896,1984,2880,0,0,ITC,ITC3,7,Liguria,Liguria,1550640,1133288,73.09,0.19
3924,2021-03-03,LIG,4586,1850,2736,3446,1030,110,ITC,ITC3,7,Liguria,Liguria,1550640,1137874,73.38,0.3
3925,2021-08-04,LIG,13854,6973,6881,3254,10494,106,ITC,ITC3,7,Liguria,Liguria,1550640,1151728,74.27,0.89
3926,2021-02-24,LIG,3769,1562,2207,3458,259,52,ITC,ITC3,7,Liguria,Liguria,1550640,1155497,74.52,0.24
3927,2020-12-29,LIG,125,33,92,125,0,0,ITC,ITC3,7,Liguria,Liguria,1550640,1155622,74.53,0.01
3928,2021-01-12,LIG,2476,890,1586,2475,0,1,ITC,ITC3,7,Liguria,Liguria,1550640,1158098,74.69,0.16
3929,2021-01-18,LIG,2146,749,1397,1987,157,2,ITC,ITC3,7,Liguria,Liguria,1550640,1160244,74.82,0.14
3930,2021-08-08,LIG,1208,650,558,543,659,6,ITC,ITC3,7,Liguria,Liguria,1550640,1161452,74.9,0.08
3931,2021-07-22,LIG,21453,10902,10551,4564,16781,108,ITC,ITC3,7,Liguria,Liguria,1550640,1182905,76.28,1.38
3932,2021-02-01,LIG,2574,929,1645,101,2473,0,ITC,ITC3,7,Liguria,Liguria,1550640,1185479,76.45,0.17
3933,2021-07-08,LIG,13671,6719,6952,6149,7419,103,ITC,ITC3,7,Liguria,Liguria,1550640,1199150,77.33,0.88
3934,2021-05-12,LIG,12121,5491,6630,6610,5409,102,ITC,ITC3,7,Liguria,Liguria,1550640,1211271,78.11,0.78
3935,2021-05-26,LIG,16700,8433,8267,12171,4383,146,ITC,ITC3,7,Liguria,Liguria,1550640,1227971,79.19,1.08
3936,2021-03-30,LIG,12230,5433,6797,8754,3395,81,ITC,ITC3,7,Liguria,Liguria,1550640,1240201,79.98,0.79
3937,2021-09-03,LIG,7358,4056,3302,2205,5083,70,ITC,ITC3,7,Liguria,Liguria,1550640,1247559,80.45,0.47
3938,2021-09-02,LIG,8451,4504,3947,2855,5517,79,ITC,ITC3,7,Liguria,Liguria,1550640,1256010,81.0,0.55
3939,2021-06-08,LIG,18128,9045,9083,11399,6653,76,ITC,ITC3,7,Liguria,Liguria,1550640,1274138,82.17,1.17
3940,2021-03-17,LIG,5559,2371,3188,2455,3085,19,ITC,ITC3,7,Liguria,Liguria,1550640,1279697,82.53,0.36
3941,2021-06-25,LIG,13851,6622,7229,6863,6922,66,ITC,ITC3,7,Liguria,Liguria,1550640,1293548,83.42,0.89
3942,2021-07-14,LIG,11523,5673,5850,3414,8037,72,ITC,ITC3,7,Liguria,Liguria,1550640,1305071,84.16,0.74
3943,2021-01-29,LIG,3101,1070,2031,63,3038,0,ITC,ITC3,7,Liguria,Liguria,1550640,1308172,84.36,0.2
3944,2021-01-20,LIG,1560,557,1003,1547,12,1,ITC,ITC3,7,Liguria,Liguria,1550640,1309732,84.46,0.1
3945,2021-08-19,LIG,9825,5170,4655,2716,7014,95,ITC,ITC3,7,Liguria,Liguria,1550640,1319557,85.1,0.63
3946,2021-07-09,LIG,12846,6333,6513,4182,8591,73,ITC,ITC3,7,Liguria,Liguria,1550640,1332403,85.93,0.83
3947,2021-04-05,LIG,3985,1757,2228,2313,1651,21,ITC,ITC3,7,Liguria,Liguria,1550640,1336388,86.18,0.26
3948,2021-07-16,LIG,12633,6227,6406,3141,9437,55,ITC,ITC3,7,Liguria,Liguria,1550640,1349021,87.0,0.81
3949,2021-05-11,LIG,13943,6400,7543,7199,6632,112,ITC,ITC3,7,Liguria,Liguria,1550640,1362964,87.9,0.9
3950,2021-03-29,LIG,10594,4629,5965,7364,3135,95,ITC,ITC3,7,Liguria,Liguria,1550640,1373558,88.58,0.68
3951,2021-01-31,LIG,625,271,354,4,621,0,ITC,ITC3,7,Liguria,Liguria,1550640,1374183,88.62,0.04
3952,2021-07-07,LIG,11800,5652,6148,4925,6801,74,ITC,ITC3,7,Liguria,Liguria,1550640,1385983,89.38,0.76
3953,2021-08-31,LIG,9550,5049,4501,2657,6837,56,ITC,ITC3,7,Liguria,Liguria,1550640,1395533,90.0,0.62
3954,2021-05-23,LIG,2310,1121,1189,1172,1124,14,ITC,ITC3,7,Liguria,Liguria,1550640,1397843,90.15,0.15
3955,2021-03-01,LIG,3541,1447,2094,3386,136,19,ITC,ITC3,7,Liguria,Liguria,1550640,1401384,90.37,0.23
3956,2021-06-09,LIG,19106,9590,9516,12446,6589,71,ITC,ITC3,7,Liguria,Liguria,1550640,1420490,91.61,1.23
3957,2021-04-03,LIG,5410,2500,2910,4435,944,31,ITC,ITC3,7,Liguria,Liguria,1550640,1425900,91.96,0.35
3958,2021-01-24,LIG,762,242,520,116,646,0,ITC,ITC3,7,Liguria,Liguria,1550640,1426662,92.0,0.05
3959,2021-06-27,LIG,1950,895,1055,681,1253,16,ITC,ITC3,7,Liguria,Liguria,1550640,1428612,92.13,0.13
3960,2021-04-22,LIG,13882,6216,7666,8658,5090,134,ITC,ITC3,7,Liguria,Liguria,1550640,1442494,93.03,0.9
3961,2021-07-19,LIG,12111,6037,6074,3334,8699,78,ITC,ITC3,7,Liguria,Liguria,1550640,1454605,93.81,0.78
3962,2021-08-05,LIG,14247,7360,6887,4113,10048,86,ITC,ITC3,7,Liguria,Liguria,1550640,1468852,94.73,0.92
3963,2021-04-27,LIG,14823,6700,8123,7145,7611,67,ITC,ITC3,7,Liguria,Liguria,1550640,1483675,95.68,0.96
3964,2021-02-03,LIG,2320,792,1528,51,2269,0,ITC,ITC3,7,Liguria,Liguria,1550640,1485995,95.83,0.15
3965,2021-07-21,LIG,19211,9523,9688,3815,15319,77,ITC,ITC3,7,Liguria,Liguria,1550640,1505206,97.07,1.24
3966,2021-04-29,LIG,15593,6983,8610,6644,8855,94,ITC,ITC3,7,Liguria,Liguria,1550640,1520799,98.08,1.01
3967,2021-04-12,LIG,12394,5478,6916,10276,2022,96,ITC,ITC3,7,Liguria,Liguria,1550640,1533193,98.87,0.8
3968,2021-01-19,LIG,1375,440,935,1281,90,4,ITC,ITC3,7,Liguria,Liguria,1550640,1534568,98.96,0.09
3969,2021-02-05,LIG,2740,994,1746,299,2440,1,ITC,ITC3,7,Liguria,Liguria,1550640,1537308,99.14,0.18
3970,2021-04-06,LIG,13265,5905,7360,10893,2265,107,ITC,ITC3,7,Liguria,Liguria,1550640,1550573,100.0,0.86
3971,2021-02-08,LIG,1983,744,1239,299,1684,0,ITC,ITC3,7,Liguria,Liguria,1550640,1552556,100.12,0.13
3972,2020-12-27,LIG,135,56,79,134,0,1,ITC,ITC3,7,Liguria,Liguria,1550640,1552691,100.13,0.01
3973,2021-07-28,LIG,18482,9521,8961,5803,12552,127,ITC,ITC3,7,Liguria,Liguria,1550640,1571173,101.32,1.19
3974,2021-05-06,LIG,14543,6446,8097,6072,8342,129,ITC,ITC3,7,Liguria,Liguria,1550640,1585716,102.26,0.94
3975,2021-01-26,LIG,2490,809,1681,16,2474,0,ITC,ITC3,7,Liguria,Liguria,1550640,1588206,102.42,0.16
3976,2021-09-07,LIG,7782,4114,3668,2645,5054,83,ITC,ITC3,7,Liguria,Liguria,1550640,1595988,102.92,0.5
3977,2021-06-16,LIG,16411,7930,8481,9201,7133,77,ITC,ITC3,7,Liguria,Liguria,1550640,1612399,103.98,1.06
3978,2021-03-08,LIG,5631,2462,3169,3907,1692,32,ITC,ITC3,7,Liguria,Liguria,1550640,1618030,104.35,0.36
3979,2021-03-25,LIG,9783,4236,5547,6243,3397,143,ITC,ITC3,7,Liguria,Liguria,1550640,1627813,104.98,0.63
3980,2021-01-01,LIG,146,56,90,146,0,0,ITC,ITC3,7,Liguria,Liguria,1550640,1627959,104.99,0.01
3981,2021-03-27,LIG,3935,1549,2386,2515,1397,23,ITC,ITC3,7,Liguria,Liguria,1550640,1631894,105.24,0.25
3982,2021-07-05,LIG,11932,5778,6154,5304,6547,81,ITC,ITC3,7,Liguria,Liguria,1550640,1643826,106.01,0.77
3983,2021-04-13,LIG,13089,5875,7214,10948,2029,112,ITC,ITC3,7,Liguria,Liguria,1550640,1656915,106.85,0.84
3984,2021-02-15,LIG,2264,839,1425,1853,399,12,ITC,ITC3,7,Liguria,Liguria,1550640,1659179,107.0,0.15
3985,2021-01-03,LIG,738,233,505,736,0,2,ITC,ITC3,7,Liguria,Liguria,1550640,1659917,107.05,0.05
3986,2021-07-26,LIG,17673,9019,8654,4718,12849,106,ITC,ITC3,7,Liguria,Liguria,1550640,1677590,108.19,1.14
3987,2021-01-07,LIG,3227,1096,2131,3224,0,3,ITC,ITC3,7,Liguria,Liguria,1550640,1680817,108.4,0.21
3988,2021-06-13,LIG,5642,2706,2936,5136,456,50,ITC,ITC3,7,Liguria,Liguria,1550640,1686459,108.76,0.36
3989,2021-04-17,LIG,7393,3219,4174,6582,755,56,ITC,ITC3,7,Liguria,Liguria,1550640,1693852,109.24,0.48
3990,2021-05-01,LIG,7153,3260,3893,1314,5809,30,ITC,ITC3,7,Liguria,Liguria,1550640,1701005,109.7,0.46
3991,2021-03-05,LIG,4874,2154,2720,3690,1137,47,ITC,ITC3,7,Liguria,Liguria,1550640,1705879,110.01,0.31
3992,2021-08-09,LIG,11994,6099,5895,4345,7527,122,ITC,ITC3,7,Liguria,Liguria,1550640,1717873,110.78,0.77
3993,2021-03-24,LIG,9195,4039,5156,5821,3292,82,ITC,ITC3,7,Liguria,Liguria,1550640,1727068,111.38,0.59
3994,2021-07-02,LIG,12994,6375,6619,6374,6521,99,ITC,ITC3,7,Liguria,Liguria,1550640,1740062,112.22,0.84
3995,2020-12-31,LIG,990,352,638,990,0,0,ITC,ITC3,7,Liguria,Liguria,1550640,1741052,112.28,0.06
3996,2021-04-10,LIG,7894,3564,4330,6905,914,75,ITC,ITC3,7,Liguria,Liguria,1550640,1748946,112.79,0.51
3997,2021-01-17,LIG,866,301,565,865,0,1,ITC,ITC3,7,Liguria,Liguria,1550640,1749812,112.84,0.06
3998,2021-02-12,LIG,1941,691,1250,896,1044,1,ITC,ITC3,7,Liguria,Liguria,1550640,1751753,112.97,0.13
3999,2021-08-16,LIG,9916,5129,4787,3768,6049,99,ITC,ITC3,7,Liguria,Liguria,1550640,1761669,113.61,0.64
4000,2021-03-15,LIG,7371,3123,4248,4502,2822,47,ITC,ITC3,7,Liguria,Liguria,1550640,1769040,114.08,0.48
4001,2021-08-21,LIG,3060,1663,1397,896,2118,46,ITC,ITC3,7,Liguria,Liguria,1550640,1772100,114.28,0.2
4002,2021-05-13,LIG,13329,6093,7236,8897,4273,159,ITC,ITC3,7,Liguria,Liguria,1550640,1785429,115.14,0.86
4003,2021-02-19,LIG,3223,1307,1916,3033,176,14,ITC,ITC3,7,Liguria,Liguria,1550640,1788652,115.35,0.21
4004,2021-05-30,LIG,3308,1615,1693,1338,1947,23,ITC,ITC3,7,Liguria,Liguria,1550640,1791960,115.56,0.21
4005,2021-08-23,LIG,10564,5511,5053,3536,6923,105,ITC,ITC3,7,Liguria,Liguria,1550640,1802524,116.24,0.68
4006,2021-06-01,LIG,16355,8237,8118,10921,5376,58,ITC,ITC3,7,Liguria,Liguria,1550640,1818879,117.3,1.05
4007,2021-06-18,LIG,15427,7509,7918,8118,7225,84,ITC,ITC3,7,Liguria,Liguria,1550640,1834306,118.29,0.99
4008,2021-03-10,LIG,5924,2868,3056,3952,1917,55,ITC,ITC3,7,Liguria,Liguria,1550640,1840230,118.68,0.38
4009,2021-06-06,LIG,3814,2032,1782,2938,862,14,ITC,ITC3,7,Liguria,Liguria,1550640,1844044,118.92,0.25
4010,2021-04-24,LIG,8220,3798,4422,4983,3155,82,ITC,ITC3,7,Liguria,Liguria,1550640,1852264,119.45,0.53
4011,2021-02-26,LIG,3771,1526,2245,3417,329,25,ITC,ITC3,7,Liguria,Liguria,1550640,1856035,119.69,0.24
4012,2021-08-02,LIG,13105,6514,6591,2975,10053,77,ITC,ITC3,7,Liguria,Liguria,1550640,1869140,120.54,0.85
4013,2021-06-20,LIG,1336,658,678,1045,275,16,ITC,ITC3,7,Liguria,Liguria,1550640,1870476,120.63,0.09
4014,2021-04-23,LIG,14698,6653,8045,8458,6130,110,ITC,ITC3,7,Liguria,Liguria,1550640,1885174,121.57,0.95
4015,2021-03-11,LIG,6424,3103,3321,4359,2014,51,ITC,ITC3,7,Liguria,Liguria,1550640,1891598,121.99,0.41
4016,2021-01-13,LIG,2761,1016,1745,2760,0,1,ITC,ITC3,7,Liguria,Liguria,1550640,1894359,122.17,0.18
4017,2021-01-04,LIG,2624,857,1767,2623,0,1,ITC,ITC3,7,Liguria,Liguria,1550640,1896983,122.34,0.17
4018,2021-08-03,LIG,14137,7221,6916,3977,10068,92,ITC,ITC3,7,Liguria,Liguria,1550640,1911120,123.25,0.91
4019,2021-06-21,LIG,14853,7043,7810,8517,6259,77,ITC,ITC3,7,Liguria,Liguria,1550640,1925973,124.21,0.96
4020,2021-04-16,LIG,12012,5295,6717,10023,1832,157,ITC,ITC3,7,Liguria,Liguria,1550640,1937985,124.98,0.77
4021,2021-01-06,LIG,1666,618,1048,1663,0,3,ITC,ITC3,7,Liguria,Liguria,1550640,1939651,125.09,0.11
4022,2021-06-28,LIG,11627,5627,6000,7221,4313,93,ITC,ITC3,7,Liguria,Liguria,1550640,1951278,125.84,0.75
4023,2021-03-20,LIG,2316,995,1321,1129,1174,13,ITC,ITC3,7,Liguria,Liguria,1550640,1953594,125.99,0.15
4024,2021-08-26,LIG,9042,4728,4314,2627,6348,67,ITC,ITC3,7,Liguria,Liguria,1550640,1962636,126.57,0.58
4025,2021-06-30,LIG,15099,7205,7894,8194,6820,85,ITC,ITC3,7,Liguria,Liguria,1550640,1977735,127.54,0.97
4026,2021-01-15,LIG,2264,756,1508,2259,0,5,ITC,ITC3,7,Liguria,Liguria,1550640,1979999,127.69,0.15
4027,2021-04-25,LIG,1936,921,1015,1509,415,12,ITC,ITC3,7,Liguria,Liguria,1550640,1981935,127.81,0.12
4028,2021-03-13,LIG,3852,1638,2214,2964,858,30,ITC,ITC3,7,Liguria,Liguria,1550640,1985787,128.06,0.25
4029,2021-06-23,LIG,14354,6867,7487,9061,5208,85,ITC,ITC3,7,Liguria,Liguria,1550640,2000141,128.99,0.93
4030,2021-02-14,LIG,233,122,111,233,0,0,ITC,ITC3,7,Liguria,Liguria,1550640,2000374,129.0,0.02
4031,2021-05-25,LIG,14279,6959,7320,10958,3195,126,ITC,ITC3,7,Liguria,Liguria,1550640,2014653,129.92,0.92
4032,2021-09-04,LIG,3017,1684,1333,880,2112,25,ITC,ITC3,7,Liguria,Liguria,1550640,2017670,130.12,0.19
4033,2021-03-22,LIG,7759,3476,4283,4743,2943,73,ITC,ITC3,7,Liguria,Liguria,1550640,2025429,130.62,0.5
4034,2021-02-07,LIG,407,153,254,2,405,0,ITC,ITC3,7,Liguria,Liguria,1550640,2025836,130.65,0.03
4035,2021-05-18,LIG,13503,6136,7367,10061,3316,126,ITC,ITC3,7,Liguria,Liguria,1550640,2039339,131.52,0.87
4036,2021-08-28,LIG,4129,2337,1792,1006,3098,25,ITC,ITC3,7,Liguria,Liguria,1550640,2043468,131.78,0.27
4037,2021-05-20,LIG,12951,6009,6942,8790,4040,121,ITC,ITC3,7,Liguria,Liguria,1550640,2056419,132.62,0.84
4038,2021-01-16,SAR,1498,530,968,1498,0,0,ITG,ITG2,20,Sardegna,Sardegna,1639591,1498,0.09,0.09
4039,2021-08-15,SAR,19,10,9,9,10,0,ITG,ITG2,20,Sardegna,Sardegna,1639591,1517,0.09,0.0
4040,2021-07-01,SAR,19833,9763,10070,7257,12483,93,ITG,ITG2,20,Sardegna,Sardegna,1639591,21350,1.3,1.21
4041,2021-03-23,SAR,6499,2905,3594,5229,1089,181,ITG,ITG2,20,Sardegna,Sardegna,1639591,27849,1.7,0.4
4042,2021-07-15,SAR,18778,9236,9542,4646,14031,101,ITG,ITG2,20,Sardegna,Sardegna,1639591,46627,2.84,1.15
4043,2021-08-03,SAR,14580,7511,7069,7519,6863,198,ITG,ITG2,20,Sardegna,Sardegna,1639591,61207,3.73,0.89
4044,2021-08-01,SAR,3055,1502,1553,1031,1988,36,ITG,ITG2,20,Sardegna,Sardegna,1639591,64262,3.92,0.19
4045,2021-04-23,SAR,13064,5791,7273,7361,5556,147,ITG,ITG2,20,Sardegna,Sardegna,1639591,77326,4.72,0.8
4046,2021-05-10,SAR,9948,4417,5531,7211,2560,177,ITG,ITG2,20,Sardegna,Sardegna,1639591,87274,5.32,0.61
4047,2021-01-30,SAR,3946,1426,2520,368,3578,0,ITG,ITG2,20,Sardegna,Sardegna,1639591,91220,5.56,0.24
4048,2021-06-19,SAR,15348,7516,7832,9121,6128,99,ITG,ITG2,20,Sardegna,Sardegna,1639591,106568,6.5,0.94
4049,2021-07-06,SAR,15935,7722,8213,4660,11175,100,ITG,ITG2,20,Sardegna,Sardegna,1639591,122503,7.47,0.97
4050,2021-03-28,SAR,4624,1825,2799,4471,79,74,ITG,ITG2,20,Sardegna,Sardegna,1639591,127127,7.75,0.28
4051,2021-01-04,SAR,609,230,379,609,0,0,ITG,ITG2,20,Sardegna,Sardegna,1639591,127736,7.79,0.04
4052,2021-03-09,SAR,5561,2753,2808,4757,732,72,ITG,ITG2,20,Sardegna,Sardegna,1639591,133297,8.13,0.34
4053,2021-08-13,SAR,9949,5418,4531,6314,3516,119,ITG,ITG2,20,Sardegna,Sardegna,1639591,143246,8.74,0.61
4054,2021-05-05,SAR,10281,4678,5603,8009,2061,211,ITG,ITG2,20,Sardegna,Sardegna,1639591,153527,9.36,0.63
4055,2021-08-27,SAR,8385,4495,3890,4909,3334,142,ITG,ITG2,20,Sardegna,Sardegna,1639591,161912,9.88,0.51
4056,2021-05-19,SAR,17082,8683,8399,12633,4279,170,ITG,ITG2,20,Sardegna,Sardegna,1639591,178994,10.92,1.04
4057,2021-06-05,SAR,17888,8441,9447,11285,6468,135,ITG,ITG2,20,Sardegna,Sardegna,1639591,196882,12.01,1.09
4058,2021-02-25,SAR,2939,1275,1664,2296,608,35,ITG,ITG2,20,Sardegna,Sardegna,1639591,199821,12.19,0.18
4059,2021-03-14,SAR,613,379,234,602,1,10,ITG,ITG2,20,Sardegna,Sardegna,1639591,200434,12.22,0.04
4060,2021-04-09,SAR,12475,5525,6950,7933,4400,142,ITG,ITG2,20,Sardegna,Sardegna,1639591,212909,12.99,0.76
4061,2021-07-20,SAR,16151,7931,8220,3654,12406,91,ITG,ITG2,20,Sardegna,Sardegna,1639591,229060,13.97,0.99
4062,2021-04-11,SAR,5416,2450,2966,4263,1124,29,ITG,ITG2,20,Sardegna,Sardegna,1639591,234476,14.3,0.33
4063,2021-06-07,SAR,12567,6145,6422,9437,3007,123,ITG,ITG2,20,Sardegna,Sardegna,1639591,247043,15.07,0.77
4064,2021-02-11,SAR,1322,490,832,1207,115,0,ITG,ITG2,20,Sardegna,Sardegna,1639591,248365,15.15,0.08
4065,2021-09-01,SAR,8248,4311,3937,3117,5040,91,ITG,ITG2,20,Sardegna,Sardegna,1639591,256613,15.65,0.5
4066,2021-05-24,SAR,14490,7258,7232,8359,5999,132,ITG,ITG2,20,Sardegna,Sardegna,1639591,271103,16.53,0.88
4067,2021-02-13,SAR,1458,563,895,1452,2,4,ITG,ITG2,20,Sardegna,Sardegna,1639591,272561,16.62,0.09
4068,2021-08-08,SAR,1884,979,905,1020,841,23,ITG,ITG2,20,Sardegna,Sardegna,1639591,274445,16.74,0.11
4069,2021-06-26,SAR,19165,9013,10152,5455,13633,77,ITG,ITG2,20,Sardegna,Sardegna,1639591,293610,17.91,1.17
4070,2021-08-22,SAR,1162,650,512,403,756,3,ITG,ITG2,20,Sardegna,Sardegna,1639591,294772,17.98,0.07
4071,2021-08-20,SAR,10172,5352,4820,4793,5229,150,ITG,ITG2,20,Sardegna,Sardegna,1639591,304944,18.6,0.62
4072,2021-05-12,SAR,11224,5281,5943,7863,3154,207,ITG,ITG2,20,Sardegna,Sardegna,1639591,316168,19.28,0.68
4073,2021-09-03,SAR,8713,4697,4016,3080,5539,94,ITG,ITG2,20,Sardegna,Sardegna,1639591,324881,19.81,0.53
4074,2020-12-28,SAR,69,27,42,69,0,0,ITG,ITG2,20,Sardegna,Sardegna,1639591,324950,19.82,0.0
4075,2021-06-14,SAR,13750,6643,7107,9790,3818,142,ITG,ITG2,20,Sardegna,Sardegna,1639591,338700,20.66,0.84
4076,2021-03-06,SAR,2950,1219,1731,1081,1795,74,ITG,ITG2,20,Sardegna,Sardegna,1639591,341650,20.84,0.18
4077,2021-06-12,SAR,14755,7194,7561,9935,4702,118,ITG,ITG2,20,Sardegna,Sardegna,1639591,356405,21.74,0.9
4078,2021-03-04,SAR,4393,2313,2080,3067,1260,66,ITG,ITG2,20,Sardegna,Sardegna,1639591,360798,22.01,0.27
4079,2021-03-21,SAR,4053,1815,2238,2586,1441,26,ITG,ITG2,20,Sardegna,Sardegna,1639591,364851,22.25,0.25
4080,2021-07-08,SAR,18445,8972,9473,3832,14528,85,ITG,ITG2,20,Sardegna,Sardegna,1639591,383296,23.38,1.12
4081,2021-07-25,SAR,4343,2142,2201,862,3466,15,ITG,ITG2,20,Sardegna,Sardegna,1639591,387639,23.64,0.26
4082,2021-04-16,SAR,14604,6529,8075,9005,5421,178,ITG,ITG2,20,Sardegna,Sardegna,1639591,402243,24.53,0.89
4083,2021-01-23,SAR,61,23,38,0,61,0,ITG,ITG2,20,Sardegna,Sardegna,1639591,402304,24.54,0.0
4084,2021-04-30,SAR,11313,5343,5970,6822,4301,190,ITG,ITG2,20,Sardegna,Sardegna,1639591,413617,25.23,0.69
4085,2021-05-17,SAR,12840,6265,6575,9138,3554,148,ITG,ITG2,20,Sardegna,Sardegna,1639591,426457,26.01,0.78
4086,2021-02-06,SAR,1983,706,1277,566,1414,3,ITG,ITG2,20,Sardegna,Sardegna,1639591,428440,26.13,0.12
4087,2021-02-23,SAR,1577,1050,527,1278,282,17,ITG,ITG2,20,Sardegna,Sardegna,1639591,430017,26.23,0.1
4088,2021-02-04,SAR,2302,825,1477,915,1384,3,ITG,ITG2,20,Sardegna,Sardegna,1639591,432319,26.37,0.14
4089,2021-04-02,SAR,9328,3624,5704,5928,3252,148,ITG,ITG2,20,Sardegna,Sardegna,1639591,441647,26.94,0.57
4090,2021-07-13,SAR,17806,8522,9284,3250,14478,78,ITG,ITG2,20,Sardegna,Sardegna,1639591,459453,28.02,1.09
4091,2021-04-04,SAR,2,1,1,0,2,0,ITG,ITG2,20,Sardegna,Sardegna,1639591,459455,28.02,0.0
4092,2021-05-29,SAR,18028,8656,9372,13249,4611,168,ITG,ITG2,20,Sardegna,Sardegna,1639591,477483,29.12,1.1
4093,2021-02-18,SAR,1898,738,1160,1794,64,40,ITG,ITG2,20,Sardegna,Sardegna,1639591,479381,29.24,0.12
4094,2021-09-08,SAR,12255,6566,5689,3188,8925,142,ITG,ITG2,20,Sardegna,Sardegna,1639591,491636,29.99,0.75
4095,2021-05-31,SAR,11371,5409,5962,8161,3112,98,ITG,ITG2,20,Sardegna,Sardegna,1639591,503007,30.68,0.69
4096,2021-07-27,SAR,16532,8383,8149,4216,12205,111,ITG,ITG2,20,Sardegna,Sardegna,1639591,519539,31.69,1.01
4097,2021-04-18,SAR,5153,2237,2916,2238,2885,30,ITG,ITG2,20,Sardegna,Sardegna,1639591,524692,32.0,0.31
4098,2021-01-08,SAR,3351,1235,2116,3349,0,2,ITG,ITG2,20,Sardegna,Sardegna,1639591,528043,32.21,0.2
4099,2021-03-02,SAR,3059,1634,1425,1823,1162,74,ITG,ITG2,20,Sardegna,Sardegna,1639591,531102,32.39,0.19
4100,2021-04-28,SAR,9125,4309,4816,5213,3760,152,ITG,ITG2,20,Sardegna,Sardegna,1639591,540227,32.95,0.56
4101,2021-01-18,SAR,910,328,582,781,129,0,ITG,ITG2,20,Sardegna,Sardegna,1639591,541137,33.0,0.06
4102,2021-06-24,SAR,19202,9213,9989,8113,10984,105,ITG,ITG2,20,Sardegna,Sardegna,1639591,560339,34.18,1.17
4103,2021-03-16,SAR,4446,1967,2479,3471,930,45,ITG,ITG2,20,Sardegna,Sardegna,1639591,564785,34.45,0.27
4104,2021-05-07,SAR,14605,6665,7940,9789,4557,259,ITG,ITG2,20,Sardegna,Sardegna,1639591,579390,35.34,0.89
4105,2021-01-27,SAR,1435,506,929,78,1357,0,ITG,ITG2,20,Sardegna,Sardegna,1639591,580825,35.42,0.09
4106,2021-07-03,SAR,15843,7562,8281,3235,12576,32,ITG,ITG2,20,Sardegna,Sardegna,1639591,596668,36.39,0.97
4107,2021-03-25,SAR,9276,4024,5252,7820,1308,148,ITG,ITG2,20,Sardegna,Sardegna,1639591,605944,36.96,0.57
4108,2021-08-29,SAR,467,250,217,355,98,14,ITG,ITG2,20,Sardegna,Sardegna,1639591,606411,36.99,0.03
4109,2021-05-21,SAR,22797,11231,11566,16383,6133,281,ITG,ITG2,20,Sardegna,Sardegna,1639591,629208,38.38,1.39
4110,2021-06-28,SAR,14994,7041,7953,3050,11878,66,ITG,ITG2,20,Sardegna,Sardegna,1639591,644202,39.29,0.91
4111,2021-04-06,SAR,7575,3157,4418,5061,2438,76,ITG,ITG2,20,Sardegna,Sardegna,1639591,651777,39.75,0.46
4112,2020-12-27,SAR,68,37,31,68,0,0,ITG,ITG2,20,Sardegna,Sardegna,1639591,651845,39.76,0.0
4113,2021-04-25,SAR,4534,2282,2252,3701,784,49,ITG,ITG2,20,Sardegna,Sardegna,1639591,656379,40.03,0.28
4114,2021-01-15,SAR,1575,576,999,1573,0,2,ITG,ITG2,20,Sardegna,Sardegna,1639591,657954,40.13,0.1
4115,2021-08-17,SAR,10608,5535,5073,6093,4389,126,ITG,ITG2,20,Sardegna,Sardegna,1639591,668562,40.78,0.65
4116,2021-02-01,SAR,1554,620,934,226,1328,0,ITG,ITG2,20,Sardegna,Sardegna,1639591,670116,40.87,0.09
4117,2021-05-09,SAR,6181,2888,3293,5162,926,93,ITG,ITG2,20,Sardegna,Sardegna,1639591,676297,41.25,0.38
4118,2021-05-26,SAR,15549,8195,7354,9706,5661,182,ITG,ITG2,20,Sardegna,Sardegna,1639591,691846,42.2,0.95
4119,2021-02-15,SAR,961,349,612,923,31,7,ITG,ITG2,20,Sardegna,Sardegna,1639591,692807,42.25,0.06
4120,2021-01-13,SAR,579,182,397,579,0,0,ITG,ITG2,20,Sardegna,Sardegna,1639591,693386,42.29,0.04
4121,2021-07-17,SAR,12871,6303,6568,3180,9624,67,ITG,ITG2,20,Sardegna,Sardegna,1639591,706257,43.08,0.79
4122,2021-07-31,SAR,10321,5457,4864,5277,4963,81,ITG,ITG2,20,Sardegna,Sardegna,1639591,716578,43.7,0.63
4123,2021-08-19,SAR,10761,5688,5073,5734,4895,132,ITG,ITG2,20,Sardegna,Sardegna,1639591,727339,44.36,0.66
4124,2021-09-05,SAR,664,370,294,133,525,6,ITG,ITG2,20,Sardegna,Sardegna,1639591,728003,44.4,0.04
4125,2021-05-28,SAR,18009,8712,9297,13525,4297,187,ITG,ITG2,20,Sardegna,Sardegna,1639591,746012,45.5,1.1
4126,2021-02-22,SAR,1651,954,697,1391,234,26,ITG,ITG2,20,Sardegna,Sardegna,1639591,747663,45.6,0.1
4127,2021-03-11,SAR,6462,3109,3353,5170,1209,83,ITG,ITG2,20,Sardegna,Sardegna,1639591,754125,45.99,0.39
4128,2021-06-04,SAR,14506,6943,7563,9784,4563,159,ITG,ITG2,20,Sardegna,Sardegna,1639591,768631,46.88,0.88
4129,2021-03-18,SAR,7317,3096,4221,5600,1640,77,ITG,ITG2,20,Sardegna,Sardegna,1639591,775948,47.33,0.45
4130,2021-05-14,SAR,14664,6893,7771,10819,3652,193,ITG,ITG2,20,Sardegna,Sardegna,1639591,790612,48.22,0.89
4131,2021-02-03,SAR,1122,419,703,426,695,1,ITG,ITG2,20,Sardegna,Sardegna,1639591,791734,48.29,0.07
4132,2021-07-10,SAR,14241,6889,7352,2705,11503,33,ITG,ITG2,20,Sardegna,Sardegna,1639591,805975,49.16,0.87
4133,2021-04-01,SAR,10294,4105,6189,7119,3024,151,ITG,ITG2,20,Sardegna,Sardegna,1639591,816269,49.78,0.63
4134,2021-09-02,SAR,10321,5546,4775,3967,6243,111,ITG,ITG2,20,Sardegna,Sardegna,1639591,826590,50.41,0.63
4135,2021-06-02,SAR,9786,4692,5094,8060,1640,86,ITG,ITG2,20,Sardegna,Sardegna,1639591,836376,51.01,0.6
4136,2021-07-29,SAR,17901,9045,8856,6530,11205,166,ITG,ITG2,20,Sardegna,Sardegna,1639591,854277,52.1,1.09
4137,2021-04-20,SAR,11195,5065,6130,7797,3297,101,ITG,ITG2,20,Sardegna,Sardegna,1639591,865472,52.79,0.68
4138,2021-07-24,SAR,12384,6385,5999,1993,10363,28,ITG,ITG2,20,Sardegna,Sardegna,1639591,877856,53.54,0.76
4139,2021-08-10,SAR,14240,7508,6732,6250,7828,162,ITG,ITG2,20,Sardegna,Sardegna,1639591,892096,54.41,0.87
4140,2021-05-02,SAR,6075,2727,3348,5296,676,103,ITG,ITG2,20,Sardegna,Sardegna,1639591,898171,54.78,0.37
4141,2021-02-08,SAR,1477,536,941,859,617,1,ITG,ITG2,20,Sardegna,Sardegna,1639591,899648,54.87,0.09
4142,2021-08-12,SAR,12481,6615,5866,6627,5686,168,ITG,ITG2,20,Sardegna,Sardegna,1639591,912129,55.63,0.76
4143,2021-01-20,SAR,215,78,137,213,2,0,ITG,ITG2,20,Sardegna,Sardegna,1639591,912344,55.64,0.01
4144,2021-03-29,SAR,4859,1886,2973,4169,595,95,ITG,ITG2,20,Sardegna,Sardegna,1639591,917203,55.94,0.3
4145,2021-04-15,SAR,11955,5574,6381,6817,5020,118,ITG,ITG2,20,Sardegna,Sardegna,1639591,929158,56.67,0.73
4146,2021-03-20,SAR,5222,2079,3143,2909,2286,27,ITG,ITG2,20,Sardegna,Sardegna,1639591,934380,56.99,0.32
4147,2021-09-04,SAR,5113,2803,2310,1553,3512,48,ITG,ITG2,20,Sardegna,Sardegna,1639591,939493,57.3,0.31
4148,2021-06-13,SAR,9502,4678,4824,6162,3260,80,ITG,ITG2,20,Sardegna,Sardegna,1639591,948995,57.88,0.58
4149,2021-08-05,SAR,15653,8231,7422,8691,6800,162,ITG,ITG2,20,Sardegna,Sardegna,1639591,964648,58.83,0.95
4150,2021-02-20,SAR,2044,856,1188,1683,337,24,ITG,ITG2,20,Sardegna,Sardegna,1639591,966692,58.96,0.12
4151,2021-07-21,SAR,19392,9500,9892,3907,15401,84,ITG,ITG2,20,Sardegna,Sardegna,1639591,986084,60.14,1.18
4152,2021-02-10,SAR,1976,775,1201,1444,526,6,ITG,ITG2,20,Sardegna,Sardegna,1639591,988060,60.26,0.12
4153,2021-04-21,SAR,12177,5578,6599,6477,5597,103,ITG,ITG2,20,Sardegna,Sardegna,1639591,1000237,61.01,0.74
4154,2021-01-11,SAR,1217,520,697,1216,0,1,ITG,ITG2,20,Sardegna,Sardegna,1639591,1001454,61.08,0.07
4155,2021-06-17,SAR,18466,8531,9935,9918,8427,121,ITG,ITG2,20,Sardegna,Sardegna,1639591,1019920,62.21,1.13
4156,2021-01-25,SAR,612,228,384,23,589,0,ITG,ITG2,20,Sardegna,Sardegna,1639591,1020532,62.24,0.04
4157,2021-08-24,SAR,10103,5401,4702,4811,5137,155,ITG,ITG2,20,Sardegna,Sardegna,1639591,1030635,62.86,0.62
4158,2021-05-16,SAR,8248,3838,4410,6002,2161,85,ITG,ITG2,20,Sardegna,Sardegna,1639591,1038883,63.36,0.5
4159,2021-07-12,SAR,15336,7414,7922,2401,12877,58,ITG,ITG2,20,Sardegna,Sardegna,1639591,1054219,64.3,0.94
4160,2021-09-07,SAR,9542,5087,4455,2523,6901,118,ITG,ITG2,20,Sardegna,Sardegna,1639591,1063761,64.88,0.58
4161,2021-02-17,SAR,1415,581,834,1279,74,62,ITG,ITG2,20,Sardegna,Sardegna,1639591,1065176,64.97,0.09
4162,2021-05-25,SAR,15158,7706,7452,8496,6487,175,ITG,ITG2,20,Sardegna,Sardegna,1639591,1080334,65.89,0.92
4163,2021-06-11,SAR,14783,7025,7758,9089,5538,156,ITG,ITG2,20,Sardegna,Sardegna,1639591,1095117,66.79,0.9
4164,2021-03-03,SAR,4139,2294,1845,2746,1306,87,ITG,ITG2,20,Sardegna,Sardegna,1639591,1099256,67.04,0.25
4165,2021-06-30,SAR,17774,8515,9259,4806,12886,82,ITG,ITG2,20,Sardegna,Sardegna,1639591,1117030,68.13,1.08
4166,2021-03-22,SAR,3744,1517,2227,3132,526,86,ITG,ITG2,20,Sardegna,Sardegna,1639591,1120774,68.36,0.23
4167,2021-04-08,SAR,13605,5969,7636,8333,5154,118,ITG,ITG2,20,Sardegna,Sardegna,1639591,1134379,69.19,0.83
4168,2021-07-14,SAR,16908,8191,8717,3774,13023,111,ITG,ITG2,20,Sardegna,Sardegna,1639591,1151287,70.22,1.03
4169,2020-12-29,SAR,57,32,25,57,0,0,ITG,ITG2,20,Sardegna,Sardegna,1639591,1151344,70.22,0.0
4170,2021-04-22,SAR,10629,4687,5942,5541,4993,95,ITG,ITG2,20,Sardegna,Sardegna,1639591,1161973,70.87,0.65
4171,2021-01-12,SAR,890,417,473,890,0,0,ITG,ITG2,20,Sardegna,Sardegna,1639591,1162863,70.92,0.05
4172,2021-08-07,SAR,8214,4309,3905,5440,2706,68,ITG,ITG2,20,Sardegna,Sardegna,1639591,1171077,71.42,0.5
4173,2021-04-29,SAR,11271,5131,6140,6683,4431,157,ITG,ITG2,20,Sardegna,Sardegna,1639591,1182348,72.11,0.69
4174,2021-06-25,SAR,16514,7811,8703,3901,12556,57,ITG,ITG2,20,Sardegna,Sardegna,1639591,1198862,73.12,1.01
4175,2021-01-10,SAR,2220,762,1458,2219,0,1,ITG,ITG2,20,Sardegna,Sardegna,1639591,1201082,73.25,0.14
4176,2021-01-05,SAR,1358,458,900,1358,0,0,ITG,ITG2,20,Sardegna,Sardegna,1639591,1202440,73.34,0.08
4177,2021-01-22,SAR,84,47,37,56,28,0,ITG,ITG2,20,Sardegna,Sardegna,1639591,1202524,73.34,0.01
4178,2021-07-26,SAR,14606,7289,7317,4121,10408,77,ITG,ITG2,20,Sardegna,Sardegna,1639591,1217130,74.23,0.89
4179,2021-04-17,SAR,10174,4524,5650,5421,4670,83,ITG,ITG2,20,Sardegna,Sardegna,1639591,1227304,74.85,0.62
4180,2021-04-12,SAR,7057,3202,3855,5256,1728,73,ITG,ITG2,20,Sardegna,Sardegna,1639591,1234361,75.28,0.43
4181,2021-01-02,SAR,61,22,39,61,0,0,ITG,ITG2,20,Sardegna,Sardegna,1639591,1234422,75.29,0.0
4182,2021-06-08,SAR,14837,7072,7765,11168,3512,157,ITG,ITG2,20,Sardegna,Sardegna,1639591,1249259,76.19,0.9
4183,2021-02-28,SAR,368,169,199,139,227,2,ITG,ITG2,20,Sardegna,Sardegna,1639591,1249627,76.22,0.02
4184,2021-08-04,SAR,16217,8528,7689,9601,6352,264,ITG,ITG2,20,Sardegna,Sardegna,1639591,1265844,77.2,0.99
4185,2021-04-26,SAR,6946,3297,3649,5921,926,99,ITG,ITG2,20,Sardegna,Sardegna,1639591,1272790,77.63,0.42
4186,2021-06-21,SAR,14034,6737,7297,5125,8835,74,ITG,ITG2,20,Sardegna,Sardegna,1639591,1286824,78.48,0.86
4187,2021-03-13,SAR,2773,1084,1689,2451,281,41,ITG,ITG2,20,Sardegna,Sardegna,1639591,1289597,78.65,0.17
4188,2021-03-30,SAR,8924,3622,5302,6484,2286,154,ITG,ITG2,20,Sardegna,Sardegna,1639591,1298521,79.2,0.54
4189,2021-01-06,SAR,1638,556,1082,1638,0,0,ITG,ITG2,20,Sardegna,Sardegna,1639591,1300159,79.3,0.1
4190,2021-06-23,SAR,20548,9669,10879,6193,14262,93,ITG,ITG2,20,Sardegna,Sardegna,1639591,1320707,80.55,1.25
4191,2021-07-05,SAR,15584,7572,8012,3328,12207,49,ITG,ITG2,20,Sardegna,Sardegna,1639591,1336291,81.5,0.95
4192,2021-08-31,SAR,9294,4957,4337,4748,4387,159,ITG,ITG2,20,Sardegna,Sardegna,1639591,1345585,82.07,0.57
4193,2021-05-11,SAR,9112,4247,4865,6454,2520,138,ITG,ITG2,20,Sardegna,Sardegna,1639591,1354697,82.62,0.56
4194,2021-01-31,SAR,2153,765,1388,45,2108,0,ITG,ITG2,20,Sardegna,Sardegna,1639591,1356850,82.76,0.13
4195,2021-02-14,SAR,542,263,279,540,2,0,ITG,ITG2,20,Sardegna,Sardegna,1639591,1357392,82.79,0.03
4196,2021-07-18,SAR,5693,2874,2819,982,4701,10,ITG,ITG2,20,Sardegna,Sardegna,1639591,1363085,83.14,0.35
4197,2021-08-18,SAR,10694,5533,5161,5707,4857,130,ITG,ITG2,20,Sardegna,Sardegna,1639591,1373779,83.79,0.65
4198,2021-07-02,SAR,18944,8893,10051,4405,14441,98,ITG,ITG2,20,Sardegna,Sardegna,1639591,1392723,84.94,1.16
4199,2021-04-27,SAR,7756,3590,4166,5573,2072,111,ITG,ITG2,20,Sardegna,Sardegna,1639591,1400479,85.42,0.47
4200,2021-01-17,SAR,867,278,589,866,1,0,ITG,ITG2,20,Sardegna,Sardegna,1639591,1401346,85.47,0.05
4201,2021-03-15,SAR,2827,1328,1499,2408,377,42,ITG,ITG2,20,Sardegna,Sardegna,1639591,1404173,85.64,0.17
4202,2021-07-04,SAR,8207,3988,4219,2067,6125,15,ITG,ITG2,20,Sardegna,Sardegna,1639591,1412380,86.14,0.5
4203,2021-03-26,SAR,8634,3550,5084,6962,1532,140,ITG,ITG2,20,Sardegna,Sardegna,1639591,1421014,86.67,0.53
4204,2021-08-30,SAR,8756,4672,4084,4839,3760,157,ITG,ITG2,20,Sardegna,Sardegna,1639591,1429770,87.2,0.53
4205,2021-05-22,SAR,25067,12011,13056,19587,5176,304,ITG,ITG2,20,Sardegna,Sardegna,1639591,1454837,88.73,1.53
4206,2021-01-19,SAR,751,271,480,695,55,1,ITG,ITG2,20,Sardegna,Sardegna,1639591,1455588,88.78,0.05
4207,2021-03-17,SAR,6627,2870,3757,4956,1633,38,ITG,ITG2,20,Sardegna,Sardegna,1639591,1462215,89.18,0.4
4208,2021-06-27,SAR,9019,4310,4709,2956,6035,28,ITG,ITG2,20,Sardegna,Sardegna,1639591,1471234,89.73,0.55
4209,2021-03-24,SAR,7504,3134,4370,5994,1360,150,ITG,ITG2,20,Sardegna,Sardegna,1639591,1478738,90.19,0.46
4210,2021-01-29,SAR,3044,1118,1926,45,2997,2,ITG,ITG2,20,Sardegna,Sardegna,1639591,1481782,90.38,0.19
4211,2021-08-02,SAR,13122,6604,6518,6213,6730,179,ITG,ITG2,20,Sardegna,Sardegna,1639591,1494904,91.18,0.8
4212,2021-01-28,SAR,3037,1083,1954,68,2969,0,ITG,ITG2,20,Sardegna,Sardegna,1639591,1497941,91.36,0.19
4213,2021-05-27,SAR,17862,9268,8594,12109,5544,209,ITG,ITG2,20,Sardegna,Sardegna,1639591,1515803,92.45,1.09
4214,2021-02-16,SAR,703,291,412,667,27,9,ITG,ITG2,20,Sardegna,Sardegna,1639591,1516506,92.49,0.04
4215,2021-03-05,SAR,5234,2621,2613,2823,2372,39,ITG,ITG2,20,Sardegna,Sardegna,1639591,1521740,92.81,0.32
4216,2021-03-19,SAR,7323,3064,4259,5017,2244,62,ITG,ITG2,20,Sardegna,Sardegna,1639591,1529063,93.26,0.45
4217,2021-06-01,SAR,14328,6659,7669,9637,4595,96,ITG,ITG2,20,Sardegna,Sardegna,1639591,1543391,94.13,0.87
4218,2021-02-21,SAR,1589,709,880,1558,30,1,ITG,ITG2,20,Sardegna,Sardegna,1639591,1544980,94.23,0.1
4219,2021-07-28,SAR,16793,8620,8173,6319,10326,148,ITG,ITG2,20,Sardegna,Sardegna,1639591,1561773,95.25,1.02
4220,2021-04-19,SAR,10253,4643,5610,8662,1447,144,ITG,ITG2,20,Sardegna,Sardegna,1639591,1572026,95.88,0.63
4221,2021-01-09,SAR,4086,1443,2643,4086,0,0,ITG,ITG2,20,Sardegna,Sardegna,1639591,1576112,96.13,0.25
4222,2021-06-15,SAR,14689,6808,7881,9813,4742,134,ITG,ITG2,20,Sardegna,Sardegna,1639591,1590801,97.02,0.9
4223,2021-03-07,SAR,1663,752,911,1114,545,4,ITG,ITG2,20,Sardegna,Sardegna,1639591,1592464,97.13,0.1
4224,2021-01-03,SAR,90,36,54,90,0,0,ITG,ITG2,20,Sardegna,Sardegna,1639591,1592554,97.13,0.01
4225,2021-07-07,SAR,15910,7731,8179,4086,11771,53,ITG,ITG2,20,Sardegna,Sardegna,1639591,1608464,98.1,0.97
4226,2021-06-22,SAR,19342,8991,10351,7164,12077,101,ITG,ITG2,20,Sardegna,Sardegna,1639591,1627806,99.28,1.18
4227,2021-07-09,SAR,15880,7599,8281,3431,12366,83,ITG,ITG2,20,Sardegna,Sardegna,1639591,1643686,100.25,0.97
4228,2021-03-31,SAR,10635,4233,6402,8065,2438,132,ITG,ITG2,20,Sardegna,Sardegna,1639591,1654321,100.9,0.65
4229,2021-02-05,SAR,1923,757,1166,435,1486,2,ITG,ITG2,20,Sardegna,Sardegna,1639591,1656244,101.02,0.12
4230,2021-04-03,SAR,4727,1824,2903,2670,1986,71,ITG,ITG2,20,Sardegna,Sardegna,1639591,1660971,101.3,0.29
4231,2021-05-30,SAR,9745,4841,4904,7311,2366,68,ITG,ITG2,20,Sardegna,Sardegna,1639591,1670716,101.9,0.59
4232,2021-02-19,SAR,1517,476,1041,1414,56,47,ITG,ITG2,20,Sardegna,Sardegna,1639591,1672233,101.99,0.09
4233,2021-04-05,SAR,2091,798,1293,2047,1,43,ITG,ITG2,20,Sardegna,Sardegna,1639591,1674324,102.12,0.13
4234,2021-09-06,SAR,9286,4875,4411,2548,6624,114,ITG,ITG2,20,Sardegna,Sardegna,1639591,1683610,102.68,0.57
4235,2021-06-29,SAR,17893,8606,9287,3753,14091,49,ITG,ITG2,20,Sardegna,Sardegna,1639591,1701503,103.78,1.09
4236,2021-08-09,SAR,13414,6972,6442,6474,6794,146,ITG,ITG2,20,Sardegna,Sardegna,1639591,1714917,104.59,0.82
4237,2021-08-26,SAR,9427,4997,4430,5354,3946,127,ITG,ITG2,20,Sardegna,Sardegna,1639591,1724344,105.17,0.57
4238,2021-05-18,SAR,14785,7386,7399,9425,5226,134,ITG,ITG2,20,Sardegna,Sardegna,1639591,1739129,106.07,0.9
4239,2021-02-24,SAR,2447,1309,1138,2211,195,41,ITG,ITG2,20,Sardegna,Sardegna,1639591,1741576,106.22,0.15
4240,2021-08-28,SAR,4163,2395,1768,2853,1251,59,ITG,ITG2,20,Sardegna,Sardegna,1639591,1745739,106.47,0.25
4241,2021-06-06,SAR,10037,5001,5036,6314,3654,69,ITG,ITG2,20,Sardegna,Sardegna,1639591,1755776,107.09,0.61
4242,2021-03-27,SAR,5829,2216,3613,5310,423,96,ITG,ITG2,20,Sardegna,Sardegna,1639591,1761605,107.44,0.36
4243,2021-05-23,SAR,10036,4817,5219,7685,2255,96,ITG,ITG2,20,Sardegna,Sardegna,1639591,1771641,108.05,0.61
4244,2021-02-12,SAR,2249,938,1311,2183,60,6,ITG,ITG2,20,Sardegna,Sardegna,1639591,1773890,108.19,0.14
4245,2021-07-19,SAR,15230,7630,7600,2797,12383,50,ITG,ITG2,20,Sardegna,Sardegna,1639591,1789120,109.12,0.93
4246,2021-04-10,SAR,10604,4784,5820,8535,1962,107,ITG,ITG2,20,Sardegna,Sardegna,1639591,1799724,109.77,0.65
4247,2021-01-07,SAR,3169,1110,2059,3165,0,4,ITG,ITG2,20,Sardegna,Sardegna,1639591,1802893,109.96,0.19
4248,2021-06-10,SAR,17812,8479,9333,11644,6042,126,ITG,ITG2,20,Sardegna,Sardegna,1639591,1820705,111.05,1.09
4249,2021-08-06,SAR,13824,7175,6649,7992,5659,173,ITG,ITG2,20,Sardegna,Sardegna,1639591,1834529,111.89,0.84
4250,2021-08-25,SAR,10063,5291,4772,4241,5711,111,ITG,ITG2,20,Sardegna,Sardegna,1639591,1844592,112.5,0.61
4251,2021-06-03,SAR,16398,7645,8753,10564,5693,141,ITG,ITG2,20,Sardegna,Sardegna,1639591,1860990,113.5,1.0
4252,2021-06-20,SAR,6295,2807,3488,3635,2628,32,ITG,ITG2,20,Sardegna,Sardegna,1639591,1867285,113.89,0.38
4253,2021-03-12,SAR,6022,2634,3388,4552,1317,153,ITG,ITG2,20,Sardegna,Sardegna,1639591,1873307,114.25,0.37
4254,2021-07-16,SAR,16935,8476,8459,4552,12248,135,ITG,ITG2,20,Sardegna,Sardegna,1639591,1890242,115.29,1.03
4255,2021-04-07,SAR,13730,6104,7626,7907,5739,84,ITG,ITG2,20,Sardegna,Sardegna,1639591,1903972,116.12,0.84
4256,2021-04-24,SAR,10534,4896,5638,7959,2440,135,ITG,ITG2,20,Sardegna,Sardegna,1639591,1914506,116.77,0.64
4257,2021-01-14,SAR,1128,433,695,1128,0,0,ITG,ITG2,20,Sardegna,Sardegna,1639591,1915634,116.84,0.07
4258,2021-07-23,SAR,15759,7787,7972,3405,12276,78,ITG,ITG2,20,Sardegna,Sardegna,1639591,1931393,117.8,0.96
4259,2021-04-14,SAR,8368,3927,4441,7029,1276,63,ITG,ITG2,20,Sardegna,Sardegna,1639591,1939761,118.31,0.51
4260,2021-05-01,SAR,10009,4797,5212,5421,4486,102,ITG,ITG2,20,Sardegna,Sardegna,1639591,1949770,118.92,0.61
4261,2021-01-21,SAR,140,69,71,98,42,0,ITG,ITG2,20,Sardegna,Sardegna,1639591,1949910,118.93,0.01
4262,2021-02-07,SAR,1128,397,731,228,899,1,ITG,ITG2,20,Sardegna,Sardegna,1639591,1951038,119.0,0.07
4263,2021-08-11,SAR,11927,6362,5565,6146,5601,180,ITG,ITG2,20,Sardegna,Sardegna,1639591,1962965,119.72,0.73
4264,2021-05-03,SAR,8335,3854,4481,6601,1623,111,ITG,ITG2,20,Sardegna,Sardegna,1639591,1971300,120.23,0.51
4265,2021-05-20,SAR,16415,7895,8520,11295,4913,207,ITG,ITG2,20,Sardegna,Sardegna,1639591,1987715,121.23,1.0
4266,2021-02-09,SAR,2299,840,1459,1290,1004,5,ITG,ITG2,20,Sardegna,Sardegna,1639591,1990014,121.37,0.14
4267,2021-02-26,SAR,2833,1116,1717,2473,308,52,ITG,ITG2,20,Sardegna,Sardegna,1639591,1992847,121.55,0.17
4268,2020-12-31,SAR,41,22,19,41,0,0,ITG,ITG2,20,Sardegna,Sardegna,1639591,1992888,121.55,0.0
4269,2021-07-30,SAR,15207,7858,7349,6624,8416,167,ITG,ITG2,20,Sardegna,Sardegna,1639591,2008095,122.48,0.93
4270,2021-06-16,SAR,17634,8275,9359,12163,5310,161,ITG,ITG2,20,Sardegna,Sardegna,1639591,2025729,123.55,1.08
4271,2021-01-01,SAR,33,17,16,33,0,0,ITG,ITG2,20,Sardegna,Sardegna,1639591,2025762,123.55,0.0
4272,2021-02-27,SAR,1930,646,1284,1326,561,43,ITG,ITG2,20,Sardegna,Sardegna,1639591,2027692,123.67,0.12
4273,2021-07-22,SAR,18339,9268,9071,4511,13719,109,ITG,ITG2,20,Sardegna,Sardegna,1639591,2046031,124.79,1.12
4274,2021-04-13,SAR,7705,3624,4081,5786,1854,65,ITG,ITG2,20,Sardegna,Sardegna,1639591,2053736,125.26,0.47
4275,2021-06-09,SAR,15472,7369,8103,11575,3746,151,ITG,ITG2,20,Sardegna,Sardegna,1639591,2069208,126.2,0.94
4276,2021-08-21,SAR,5620,3054,2566,3636,1894,90,ITG,ITG2,20,Sardegna,Sardegna,1639591,2074828,126.55,0.34
4277,2021-03-08,SAR,4734,2464,2270,3455,1226,53,ITG,ITG2,20,Sardegna,Sardegna,1639591,2079562,126.83,0.29
4278,2021-05-04,SAR,9682,4428,5254,7623,1904,155,ITG,ITG2,20,Sardegna,Sardegna,1639591,2089244,127.42,0.59
4279,2021-01-24,SAR,91,35,56,5,86,0,ITG,ITG2,20,Sardegna,Sardegna,1639591,2089335,127.43,0.01
4280,2021-06-18,SAR,16490,7509,8981,8603,7771,116,ITG,ITG2,20,Sardegna,Sardegna,1639591,2105825,128.44,1.01
4281,2021-03-10,SAR,6078,2963,3115,5147,855,76,ITG,ITG2,20,Sardegna,Sardegna,1639591,2111903,128.81,0.37
4282,2021-08-14,SAR,1794,1025,769,990,794,10,ITG,ITG2,20,Sardegna,Sardegna,1639591,2113697,128.92,0.11
4283,2021-05-06,SAR,13170,6063,7107,9734,3189,247,ITG,ITG2,20,Sardegna,Sardegna,1639591,2126867,129.72,0.8
4284,2021-03-01,SAR,2295,1166,1129,1598,667,30,ITG,ITG2,20,Sardegna,Sardegna,1639591,2129162,129.86,0.14
4285,2021-05-13,SAR,12453,5875,6578,8771,3469,213,ITG,ITG2,20,Sardegna,Sardegna,1639591,2141615,130.62,0.76
4286,2021-02-02,SAR,1534,681,853,258,1276,0,ITG,ITG2,20,Sardegna,Sardegna,1639591,2143149,130.71,0.09
4287,2021-08-23,SAR,10522,5566,4956,5635,4711,176,ITG,ITG2,20,Sardegna,Sardegna,1639591,2153671,131.35,0.64
4288,2021-05-15,SAR,13877,6443,7434,10243,3444,190,ITG,ITG2,20,Sardegna,Sardegna,1639591,2167548,132.2,0.85
4289,2021-07-11,SAR,6380,3119,3261,1424,4920,36,ITG,ITG2,20,Sardegna,Sardegna,1639591,2173928,132.59,0.39
4290,2021-01-26,SAR,1380,474,906,27,1353,0,ITG,ITG2,20,Sardegna,Sardegna,1639591,2175308,132.67,0.08
4291,2021-08-16,SAR,8462,4412,4050,4551,3795,116,ITG,ITG2,20,Sardegna,Sardegna,1639591,2183770,133.19,0.52
4292,2021-05-08,SAR,13209,5998,7211,10757,2289,163,ITG,ITG2,20,Sardegna,Sardegna,1639591,2196979,134.0,0.81
4293,2021-08-23,PAB,2128,1202,926,800,1326,2,ITH,ITH1,4,Provincia Autonoma Bolzano / Bozen,P.A. Bolzano,533050,2128,0.4,0.4
4294,2021-05-20,PAB,4975,2502,2473,3346,1480,149,ITH,ITH1,4,Provincia Autonoma Bolzano / Bozen,P.A. Bolzano,533050,7103,1.33,0.93
4295,2021-08-11,PAB,1200,602,598,712,486,2,ITH,ITH1,4,Provincia Autonoma Bolzano / Bozen,P.A. Bolzano,533050,8303,1.56,0.23
4296,2021-08-28,PAB,3268,1837,1431,1026,2212,30,ITH,ITH1,4,Provincia Autonoma Bolzano / Bozen,P.A. Bolzano,533050,11571,2.17,0.61
4297,2021-07-09,PAB,5227,2612,2615,917,4168,142,ITH,ITH1,4,Provincia Autonoma Bolzano / Bozen,P.A. Bolzano,533050,16798,3.15,0.98
4298,2021-06-20,PAB,5250,2854,2396,620,4604,26,ITH,ITH1,4,Provincia Autonoma Bolzano / Bozen,P.A. Bolzano,533050,22048,4.14,0.98
4299,2021-02-07,PAB,2680,1186,1494,330,2350,0,ITH,ITH1,4,Provincia Autonoma Bolzano / Bozen,P.A. Bolzano,533050,24728,4.64,0.5
4300,2021-05-18,PAB,3364,1765,1599,2091,1191,82,ITH,ITH1,4,Provincia Autonoma Bolzano / Bozen,P.A. Bolzano,533050,28092,5.27,0.63
4301,2021-03-22,PAB,1159,527,632,1124,17,18,ITH,ITH1,4,Provincia Autonoma Bolzano / Bozen,P.A. Bolzano,533050,29251,5.49,0.22
4302,2021-01-26,PAB,810,291,519,1,809,0,ITH,ITH1,4,Provincia Autonoma Bolzano / Bozen,P.A. Bolzano,533050,30061,5.64,0.15
4303,2021-07-02,PAB,3202,1658,1544,854,2172,176,ITH,ITH1,4,Provincia Autonoma Bolzano / Bozen,P.A. Bolzano,533050,33263,6.24,0.6
4304,2021-03-24,PAB,2068,1003,1065,2049,13,6,ITH,ITH1,4,Provincia Autonoma Bolzano / Bozen,P.A. Bolzano,533050,35331,6.63,0.39
4305,2021-03-10,PAB,1277,537,740,1133,144,0,ITH,ITH1,4,Provincia Autonoma Bolzano / Bozen,P.A. Bolzano,533050,36608,6.87,0.24
4306,2021-07-16,PAB,4511,2448,2063,1070,3319,122,ITH,ITH1,4,Provincia Autonoma Bolzano / Bozen,P.A. Bolzano,533050,41119,7.71,0.85
4307,2021-04-24,PAB,5119,2458,2661,4629,487,3,ITH,ITH1,4,Provincia Autonoma Bolzano / Bozen,P.A. Bolzano,533050,46238,8.67,0.96
4308,2021-08-02,PAB,2132,1278,854,1167,874,91,ITH,ITH1,4,Provincia Autonoma Bolzano / Bozen,P.A. Bolzano,533050,48370,9.07,0.4
4309,2021-07-14,PAB,873,453,420,482,361,30,ITH,ITH1,4,Provincia Autonoma Bolzano / Bozen,P.A. Bolzano,533050,49243,9.24,0.16
4310,2021-04-05,PAB,304,147,157,24,280,0,ITH,ITH1,4,Provincia Autonoma Bolzano / Bozen,P.A. Bolzano,533050,49547,9.3,0.06
4311,2021-06-27,PAB,4429,2315,2114,590,3810,29,ITH,ITH1,4,Provincia Autonoma Bolzano / Bozen,P.A. Bolzano,533050,53976,10.13,0.83
4312,2021-01-12,PAB,1711,460,1251,1711,0,0,ITH,ITH1,4,Provincia Autonoma Bolzano / Bozen,P.A. Bolzano,533050,55687,10.45,0.32
4313,2021-06-06,PAB,4553,2189,2364,812,3693,48,ITH,ITH1,4,Provincia Autonoma Bolzano / Bozen,P.A. Bolzano,533050,60240,11.3,0.85
4314,2021-02-26,PAB,1528,551,977,1498,30,0,ITH,ITH1,4,Provincia Autonoma Bolzano / Bozen,P.A. Bolzano,533050,61768,11.59,0.29
4315,2021-06-01,PAB,3677,2385,1292,2062,1479,136,ITH,ITH1,4,Provincia Autonoma Bolzano / Bozen,P.A. Bolzano,533050,65445,12.28,0.69
4316,2021-02-12,PAB,730,217,513,482,248,0,ITH,ITH1,4,Provincia Autonoma Bolzano / Bozen,P.A. Bolzano,533050,66175,12.41,0.14
4317,2021-04-10,PAB,5416,2673,2743,4825,590,1,ITH,ITH1,4,Provincia Autonoma Bolzano / Bozen,P.A. Bolzano,533050,71591,13.43,1.02
4318,2020-12-31,PAB,929,528,401,929,0,0,ITH,ITH1,4,Provincia Autonoma Bolzano / Bozen,P.A. Bolzano,533050,72520,13.6,0.17
4319,2021-04-19,PAB,1876,860,1016,1694,182,0,ITH,ITH1,4,Provincia Autonoma Bolzano / Bozen,P.A. Bolzano,533050,74396,13.96,0.35
4320,2021-06-15,PAB,2045,1184,861,481,1534,30,ITH,ITH1,4,Provincia Autonoma Bolzano / Bozen,P.A. Bolzano,533050,76441,14.34,0.38
4321,2021-07-28,PAB,1438,784,654,881,496,61,ITH,ITH1,4,Provincia Autonoma Bolzano / Bozen,P.A. Bolzano,533050,77879,14.61,0.27
4322,2021-01-24,PAB,12,10,2,0,12,0,ITH,ITH1,4,Provincia Autonoma Bolzano / Bozen,P.A. Bolzano,533050,77891,14.61,0.0
4323,2021-07-04,PAB,4422,2132,2290,160,4234,28,ITH,ITH1,4,Provincia Autonoma Bolzano / Bozen,P.A. Bolzano,533050,82313,15.44,0.83
4324,2021-08-30,PAB,2140,1125,1015,823,1293,24,ITH,ITH1,4,Provincia Autonoma Bolzano / Bozen,P.A. Bolzano,533050,84453,15.84,0.4
4325,2021-03-31,PAB,1836,696,1140,822,1014,0,ITH,ITH1,4,Provincia Autonoma Bolzano / Bozen,P.A. Bolzano,533050,86289,16.19,0.34
4326,2021-07-23,PAB,4357,2376,1981,1706,2391,260,ITH,ITH1,4,Provincia Autonoma Bolzano / Bozen,P.A. Bolzano,533050,90646,17.01,0.82
4327,2021-01-05,PAB,830,286,544,829,0,1,ITH,ITH1,4,Provincia Autonoma Bolzano / Bozen,P.A. Bolzano,533050,91476,17.16,0.16
4328,2021-01-23,PAB,197,117,80,0,197,0,ITH,ITH1,4,Provincia Autonoma Bolzano / Bozen,P.A. Bolzano,533050,91673,17.2,0.04
4329,2021-08-25,PAB,2733,1453,1280,779,1914,40,ITH,ITH1,4,Provincia Autonoma Bolzano / Bozen,P.A. Bolzano,533050,94406,17.71,0.51
4330,2021-08-09,PAB,1541,861,680,1121,413,7,ITH,ITH1,4,Provincia Autonoma Bolzano / Bozen,P.A. Bolzano,533050,95947,18.0,0.29
4331,2021-05-01,PAB,2105,1067,1038,1815,160,130,ITH,ITH1,4,Provincia Autonoma Bolzano / Bozen,P.A. Bolzano,533050,98052,18.39,0.39
4332,2021-03-12,PAB,1668,736,932,1252,413,3,ITH,ITH1,4,Provincia Autonoma Bolzano / Bozen,P.A. Bolzano,533050,99720,18.71,0.31
4333,2021-03-29,PAB,1172,500,672,411,760,1,ITH,ITH1,4,Provincia Autonoma Bolzano / Bozen,P.A. Bolzano,533050,100892,18.93,0.22
4334,2021-09-04,PAB,1358,714,644,578,747,33,ITH,ITH1,4,Provincia Autonoma Bolzano / Bozen,P.A. Bolzano,533050,102250,19.18,0.25
4335,2021-03-05,PAB,1843,627,1216,1397,443,3,ITH,ITH1,4,Provincia Autonoma Bolzano / Bozen,P.A. Bolzano,533050,104093,19.53,0.35
4336,2021-05-27,PAB,6211,3276,2935,3914,2014,283,ITH,ITH1,4,Provincia Autonoma Bolzano / Bozen,P.A. Bolzano,533050,110304,20.69,1.17
4337,2021-06-13,PAB,3689,2055,1634,453,3197,39,ITH,ITH1,4,Provincia Autonoma Bolzano / Bozen,P.A. Bolzano,533050,113993,21.39,0.69
4338,2021-05-25,PAB,3898,2024,1874,2910,888,100,ITH,ITH1,4,Provincia Autonoma Bolzano / Bozen,P.A. Bolzano,533050,117891,22.12,0.73
4339,2021-02-14,PAB,299,131,168,297,2,0,ITH,ITH1,4,Provincia Autonoma Bolzano / Bozen,P.A. Bolzano,533050,118190,22.17,0.06
4340,2021-08-16,PAB,1962,1114,848,875,1084,3,ITH,ITH1,4,Provincia Autonoma Bolzano / Bozen,P.A. Bolzano,533050,120152,22.54,0.37
4341,2021-05-08,PAB,4430,2383,2047,3574,664,192,ITH,ITH1,4,Provincia Autonoma Bolzano / Bozen,P.A. Bolzano,533050,124582,23.37,0.83
4342,2021-03-03,PAB,1181,395,786,1168,13,0,ITH,ITH1,4,Provincia Autonoma Bolzano / Bozen,P.A. Bolzano,533050,125763,23.59,0.22
4343,2021-06-29,PAB,1883,1016,867,247,1616,20,ITH,ITH1,4,Provincia Autonoma Bolzano / Bozen,P.A. Bolzano,533050,127646,23.95,0.35
4344,2021-02-19,PAB,2252,512,1740,2241,11,0,ITH,ITH1,4,Provincia Autonoma Bolzano / Bozen,P.A. Bolzano,533050,129898,24.37,0.42
4345,2021-08-04,PAB,3811,2017,1794,2719,978,114,ITH,ITH1,4,Provincia Autonoma Bolzano / Bozen,P.A. Bolzano,533050,133709,25.08,0.71
4346,2021-06-08,PAB,4267,2185,2082,893,3346,28,ITH,ITH1,4,Provincia Autonoma Bolzano / Bozen,P.A. Bolzano,533050,137976,25.88,0.8
4347,2021-04-17,PAB,5255,2609,2646,5210,44,1,ITH,ITH1,4,Provincia Autonoma Bolzano / Bozen,P.A. Bolzano,533050,143231,26.87,0.99
4348,2021-01-07,PAB,921,329,592,921,0,0,ITH,ITH1,4,Provincia Autonoma Bolzano / Bozen,P.A. Bolzano,533050,144152,27.04,0.17
4349,2021-07-21,PAB,3219,1881,1338,535,2644,40,ITH,ITH1,4,Provincia Autonoma Bolzano / Bozen,P.A. Bolzano,533050,147371,27.65,0.6
4350,2021-04-12,PAB,2110,948,1162,2104,6,0,ITH,ITH1,4,Provincia Autonoma Bolzano / Bozen,P.A. Bolzano,533050,149481,28.04,0.4
4351,2021-05-06,PAB,5191,2752,2439,2375,2571,245,ITH,ITH1,4,Provincia Autonoma Bolzano / Bozen,P.A. Bolzano,533050,154672,29.02,0.97
4352,2021-03-17,PAB,581,213,368,580,1,0,ITH,ITH1,4,Provincia Autonoma Bolzano / Bozen,P.A. Bolzano,533050,155253,29.13,0.11
4353,2021-08-21,PAB,1703,917,786,625,1074,4,ITH,ITH1,4,Provincia Autonoma Bolzano / Bozen,P.A. Bolzano,533050,156956,29.44,0.32
4354,2021-05-13,PAB,3005,1360,1645,1023,1934,48,ITH,ITH1,4,Provincia Autonoma Bolzano / Bozen,P.A. Bolzano,533050,159961,30.01,0.56
4355,2021-04-29,PAB,2641,1356,1285,1942,698,1,ITH,ITH1,4,Provincia Autonoma Bolzano / Bozen,P.A. Bolzano,533050,162602,30.5,0.5
4356,2021-05-15,PAB,7019,3695,3324,6336,294,389,ITH,ITH1,4,Provincia Autonoma Bolzano / Bozen,P.A. Bolzano,533050,169621,31.82,1.32
4357,2021-02-04,PAB,1966,596,1370,8,1958,0,ITH,ITH1,4,Provincia Autonoma Bolzano / Bozen,P.A. Bolzano,533050,171587,32.19,0.37
4358,2021-07-11,PAB,6075,3094,2981,1088,4879,108,ITH,ITH1,4,Provincia Autonoma Bolzano / Bozen,P.A. Bolzano,533050,177662,33.33,1.14
4359,2021-04-02,PAB,2090,841,1249,701,1357,32,ITH,ITH1,4,Provincia Autonoma Bolzano / Bozen,P.A. Bolzano,533050,179752,33.72,0.39
4360,2021-09-06,PAB,1127,581,546,574,534,19,ITH,ITH1,4,Provincia Autonoma Bolzano / Bozen,P.A. Bolzano,533050,180879,33.93,0.21
4361,2021-05-29,PAB,7340,3907,3433,4043,3144,153,ITH,ITH1,4,Provincia Autonoma Bolzano / Bozen,P.A. Bolzano,533050,188219,35.31,1.38
4362,2021-05-03,PAB,1838,851,987,398,1419,21,ITH,ITH1,4,Provincia Autonoma Bolzano / Bozen,P.A. Bolzano,533050,190057,35.65,0.34
4363,2021-02-23,PAB,769,324,445,763,6,0,ITH,ITH1,4,Provincia Autonoma Bolzano / Bozen,P.A. Bolzano,533050,190826,35.8,0.14
4364,2021-05-17,PAB,3154,1525,1629,2288,697,169,ITH,ITH1,4,Provincia Autonoma Bolzano / Bozen,P.A. Bolzano,533050,193980,36.39,0.59
4365,2021-06-03,PAB,4890,2663,2227,3691,972,227,ITH,ITH1,4,Provincia Autonoma Bolzano / Bozen,P.A. Bolzano,533050,198870,37.31,0.92
4366,2021-07-06,PAB,1722,925,797,691,983,48,ITH,ITH1,4,Provincia Autonoma Bolzano / Bozen,P.A. Bolzano,533050,200592,37.63,0.32
4367,2021-06-22,PAB,2471,1423,1048,319,2126,26,ITH,ITH1,4,Provincia Autonoma Bolzano / Bozen,P.A. Bolzano,533050,203063,38.09,0.46
4368,2021-03-14,PAB,758,336,422,25,733,0,ITH,ITH1,4,Provincia Autonoma Bolzano / Bozen,P.A. Bolzano,533050,203821,38.24,0.14
4369,2021-04-14,PAB,3603,1650,1953,3507,95,1,ITH,ITH1,4,Provincia Autonoma Bolzano / Bozen,P.A. Bolzano,533050,207424,38.91,0.68
4370,2021-01-04,PAB,510,201,309,510,0,0,ITH,ITH1,4,Provincia Autonoma Bolzano / Bozen,P.A. Bolzano,533050,207934,39.01,0.1
4371,2021-08-08,PAB,1875,1024,851,1008,855,12,ITH,ITH1,4,Provincia Autonoma Bolzano / Bozen,P.A. Bolzano,533050,209809,39.36,0.35
4372,2021-01-21,PAB,969,452,517,140,829,0,ITH,ITH1,4,Provincia Autonoma Bolzano / Bozen,P.A. Bolzano,533050,210778,39.54,0.18
4373,2021-07-25,PAB,1891,1127,764,665,1146,80,ITH,ITH1,4,Provincia Autonoma Bolzano / Bozen,P.A. Bolzano,533050,212669,39.9,0.35
4374,2021-06-05,PAB,6086,3034,3052,4699,1097,290,ITH,ITH1,4,Provincia Autonoma Bolzano / Bozen,P.A. Bolzano,533050,218755,41.04,1.14
4375,2021-08-27,PAB,2732,1419,1313,925,1728,79,ITH,ITH1,4,Provincia Autonoma Bolzano / Bozen,P.A. Bolzano,533050,221487,41.55,0.51
4376,2021-08-20,PAB,3923,2068,1855,944,2971,8,ITH,ITH1,4,Provincia Autonoma Bolzano / Bozen,P.A. Bolzano,533050,225410,42.29,0.74
4377,2021-05-10,PAB,3029,1306,1723,1338,1611,80,ITH,ITH1,4,Provincia Autonoma Bolzano / Bozen,P.A. Bolzano,533050,228439,42.86,0.57
4378,2021-03-26,PAB,1662,736,926,524,1136,2,ITH,ITH1,4,Provincia Autonoma Bolzano / Bozen,P.A. Bolzano,533050,230101,43.17,0.31
4379,2021-04-09,PAB,2942,1303,1639,2211,730,1,ITH,ITH1,4,Provincia Autonoma Bolzano / Bozen,P.A. Bolzano,533050,233043,43.72,0.55
4380,2021-05-22,PAB,6843,3571,3272,4479,2168,196,ITH,ITH1,4,Provincia Autonoma Bolzano / Bozen,P.A. Bolzano,533050,239886,45.0,1.28
4381,2021-02-11,PAB,1095,433,662,239,856,0,ITH,ITH1,4,Provincia Autonoma Bolzano / Bozen,P.A. Bolzano,533050,240981,45.21,0.21
4382,2021-07-18,PAB,1870,1033,837,649,1150,71,ITH,ITH1,4,Provincia Autonoma Bolzano / Bozen,P.A. Bolzano,533050,242851,45.56,0.35
4383,2021-03-07,PAB,440,150,290,19,420,1,ITH,ITH1,4,Provincia Autonoma Bolzano / Bozen,P.A. Bolzano,533050,243291,45.64,0.08
4384,2021-07-30,PAB,5301,2843,2458,3403,1543,355,ITH,ITH1,4,Provincia Autonoma Bolzano / Bozen,P.A. Bolzano,533050,248592,46.64,0.99
4385,2021-04-21,PAB,3017,1470,1547,2168,848,1,ITH,ITH1,4,Provincia Autonoma Bolzano / Bozen,P.A. Bolzano,533050,251609,47.2,0.57
4386,2021-06-24,PAB,3946,2042,1904,1570,2204,172,ITH,ITH1,4,Provincia Autonoma Bolzano / Bozen,P.A. Bolzano,533050,255555,47.94,0.74
4387,2021-01-09,PAB,612,326,286,612,0,0,ITH,ITH1,4,Provincia Autonoma Bolzano / Bozen,P.A. Bolzano,533050,256167,48.06,0.11
4388,2021-03-21,PAB,769,286,483,15,754,0,ITH,ITH1,4,Provincia Autonoma Bolzano / Bozen,P.A. Bolzano,533050,256936,48.2,0.14
4389,2021-06-12,PAB,5079,2754,2325,1675,3289,115,ITH,ITH1,4,Provincia Autonoma Bolzano / Bozen,P.A. Bolzano,533050,262015,49.15,0.95
4390,2021-01-14,PAB,1953,578,1375,1953,0,0,ITH,ITH1,4,Provincia Autonoma Bolzano / Bozen,P.A. Bolzano,533050,263968,49.52,0.37
4391,2021-04-07,PAB,1803,825,978,1262,541,0,ITH,ITH1,4,Provincia Autonoma Bolzano / Bozen,P.A. Bolzano,533050,265771,49.86,0.34
4392,2021-03-02,PAB,696,200,496,694,2,0,ITH,ITH1,4,Provincia Autonoma Bolzano / Bozen,P.A. Bolzano,533050,266467,49.99,0.13
4393,2021-03-19,PAB,1921,777,1144,800,1120,1,ITH,ITH1,4,Provincia Autonoma Bolzano / Bozen,P.A. Bolzano,533050,268388,50.35,0.36
4394,2021-07-01,PAB,4638,2305,2333,1311,3167,160,ITH,ITH1,4,Provincia Autonoma Bolzano / Bozen,P.A. Bolzano,533050,273026,51.22,0.87
4395,2021-02-06,PAB,2633,1176,1457,19,2614,0,ITH,ITH1,4,Provincia Autonoma Bolzano / Bozen,P.A. Bolzano,533050,275659,51.71,0.49
4396,2021-06-21,PAB,3168,1615,1553,260,2868,40,ITH,ITH1,4,Provincia Autonoma Bolzano / Bozen,P.A. Bolzano,533050,278827,52.31,0.59
4397,2021-06-17,PAB,1773,982,791,623,1078,72,ITH,ITH1,4,Provincia Autonoma Bolzano / Bozen,P.A. Bolzano,533050,280600,52.64,0.33
4398,2021-01-02,PAB,91,48,43,91,0,0,ITH,ITH1,4,Provincia Autonoma Bolzano / Bozen,P.A. Bolzano,533050,280691,52.66,0.02
4399,2021-06-26,PAB,4548,2331,2217,1365,3077,106,ITH,ITH1,4,Provincia Autonoma Bolzano / Bozen,P.A. Bolzano,533050,285239,53.51,0.85
4400,2021-02-18,PAB,1838,457,1381,1830,7,1,ITH,ITH1,4,Provincia Autonoma Bolzano / Bozen,P.A. Bolzano,533050,287077,53.86,0.34
4401,2021-07-29,PAB,1340,717,623,718,570,52,ITH,ITH1,4,Provincia Autonoma Bolzano / Bozen,P.A. Bolzano,533050,288417,54.11,0.25
4402,2021-01-19,PAB,853,371,482,723,130,0,ITH,ITH1,4,Provincia Autonoma Bolzano / Bozen,P.A. Bolzano,533050,289270,54.27,0.16
4403,2021-06-25,PAB,4179,2308,1871,1025,3014,140,ITH,ITH1,4,Provincia Autonoma Bolzano / Bozen,P.A. Bolzano,533050,293449,55.05,0.78
4404,2021-02-09,PAB,317,126,191,1,316,0,ITH,ITH1,4,Provincia Autonoma Bolzano / Bozen,P.A. Bolzano,533050,293766,55.11,0.06
4405,2021-09-08,PAB,458,243,215,236,222,0,ITH,ITH1,4,Provincia Autonoma Bolzano / Bozen,P.A. Bolzano,533050,294224,55.2,0.09
4406,2021-07-13,PAB,3383,1732,1651,1319,1930,134,ITH,ITH1,4,Provincia Autonoma Bolzano / Bozen,P.A. Bolzano,533050,297607,55.83,0.63
4407,2021-04-30,PAB,3348,1599,1749,1567,1778,3,ITH,ITH1,4,Provincia Autonoma Bolzano / Bozen,P.A. Bolzano,533050,300955,56.46,0.63
4408,2021-01-20,PAB,619,254,365,410,209,0,ITH,ITH1,4,Provincia Autonoma Bolzano / Bozen,P.A. Bolzano,533050,301574,56.58,0.12
4409,2021-07-22,PAB,3736,1941,1795,1735,1789,212,ITH,ITH1,4,Provincia Autonoma Bolzano / Bozen,P.A. Bolzano,533050,305310,57.28,0.7
4410,2021-01-06,PAB,59,18,41,59,0,0,ITH,ITH1,4,Provincia Autonoma Bolzano / Bozen,P.A. Bolzano,533050,305369,57.29,0.01
4411,2021-03-30,PAB,1302,532,770,220,1082,0,ITH,ITH1,4,Provincia Autonoma Bolzano / Bozen,P.A. Bolzano,533050,306671,57.53,0.24
4412,2021-04-16,PAB,2958,1424,1534,2445,512,1,ITH,ITH1,4,Provincia Autonoma Bolzano / Bozen,P.A. Bolzano,533050,309629,58.09,0.55
4413,2021-07-08,PAB,5511,2783,2728,549,4887,75,ITH,ITH1,4,Provincia Autonoma Bolzano / Bozen,P.A. Bolzano,533050,315140,59.12,1.03
4414,2021-06-19,PAB,5664,3016,2648,555,5037,72,ITH,ITH1,4,Provincia Autonoma Bolzano / Bozen,P.A. Bolzano,533050,320804,60.18,1.06
4415,2021-03-11,PAB,1691,830,861,1144,538,9,ITH,ITH1,4,Provincia Autonoma Bolzano / Bozen,P.A. Bolzano,533050,322495,60.5,0.32
4416,2021-02-25,PAB,1498,549,949,1497,1,0,ITH,ITH1,4,Provincia Autonoma Bolzano / Bozen,P.A. Bolzano,533050,323993,60.78,0.28
4417,2021-06-02,PAB,1468,824,644,978,459,31,ITH,ITH1,4,Provincia Autonoma Bolzano / Bozen,P.A. Bolzano,533050,325461,61.06,0.28
4418,2021-02-08,PAB,2,1,1,1,1,0,ITH,ITH1,4,Provincia Autonoma Bolzano / Bozen,P.A. Bolzano,533050,325463,61.06,0.0
4419,2021-03-18,PAB,1302,531,771,226,1076,0,ITH,ITH1,4,Provincia Autonoma Bolzano / Bozen,P.A. Bolzano,533050,326765,61.3,0.24
4420,2021-08-22,PAB,992,545,447,306,685,1,ITH,ITH1,4,Provincia Autonoma Bolzano / Bozen,P.A. Bolzano,533050,327757,61.49,0.19
4421,2021-05-14,PAB,5145,2323,2822,2905,2044,196,ITH,ITH1,4,Provincia Autonoma Bolzano / Bozen,P.A. Bolzano,533050,332902,62.45,0.97
4422,2021-03-16,PAB,1290,532,758,124,1166,0,ITH,ITH1,4,Provincia Autonoma Bolzano / Bozen,P.A. Bolzano,533050,334192,62.69,0.24
4423,2021-05-12,PAB,3805,2063,1742,3422,154,229,ITH,ITH1,4,Provincia Autonoma Bolzano / Bozen,P.A. Bolzano,533050,337997,63.41,0.71
4424,2021-02-01,PAB,1467,448,1019,14,1453,0,ITH,ITH1,4,Provincia Autonoma Bolzano / Bozen,P.A. Bolzano,533050,339464,63.68,0.28
4425,2021-03-04,PAB,1723,1011,712,1490,229,4,ITH,ITH1,4,Provincia Autonoma Bolzano / Bozen,P.A. Bolzano,533050,341187,64.01,0.32
4426,2021-09-05,PAB,1081,573,508,644,422,15,ITH,ITH1,4,Provincia Autonoma Bolzano / Bozen,P.A. Bolzano,533050,342268,64.21,0.2
4427,2021-09-03,PAB,3227,1707,1520,1067,2111,49,ITH,ITH1,4,Provincia Autonoma Bolzano / Bozen,P.A. Bolzano,533050,345495,64.81,0.61
4428,2021-05-26,PAB,5019,2537,2482,2869,1978,172,ITH,ITH1,4,Provincia Autonoma Bolzano / Bozen,P.A. Bolzano,533050,350514,65.76,0.94
4429,2021-08-17,PAB,1249,690,559,854,391,4,ITH,ITH1,4,Provincia Autonoma Bolzano / Bozen,P.A. Bolzano,533050,351763,65.99,0.23
4430,2020-12-30,PAB,389,183,206,389,0,0,ITH,ITH1,4,Provincia Autonoma Bolzano / Bozen,P.A. Bolzano,533050,352152,66.06,0.07
4431,2021-06-09,PAB,3870,1919,1951,1266,2498,106,ITH,ITH1,4,Provincia Autonoma Bolzano / Bozen,P.A. Bolzano,533050,356022,66.79,0.73
4432,2021-03-01,PAB,925,224,701,923,1,1,ITH,ITH1,4,Provincia Autonoma Bolzano / Bozen,P.A. Bolzano,533050,356947,66.96,0.17
4433,2021-08-05,PAB,3471,1888,1583,1802,1580,89,ITH,ITH1,4,Provincia Autonoma Bolzano / Bozen,P.A. Bolzano,533050,360418,67.61,0.65
4434,2021-03-15,PAB,1194,452,742,711,482,1,ITH,ITH1,4,Provincia Autonoma Bolzano / Bozen,P.A. Bolzano,533050,361612,67.84,0.22
4435,2021-04-27,PAB,2235,1015,1220,1156,1079,0,ITH,ITH1,4,Provincia Autonoma Bolzano / Bozen,P.A. Bolzano,533050,363847,68.26,0.42
4436,2021-01-17,PAB,2329,1044,1285,2318,11,0,ITH,ITH1,4,Provincia Autonoma Bolzano / Bozen,P.A. Bolzano,533050,366176,68.69,0.44
4437,2021-06-23,PAB,1153,595,558,333,768,52,ITH,ITH1,4,Provincia Autonoma Bolzano / Bozen,P.A. Bolzano,533050,367329,68.91,0.22
4438,2021-04-20,PAB,1565,785,780,1562,3,0,ITH,ITH1,4,Provincia Autonoma Bolzano / Bozen,P.A. Bolzano,533050,368894,69.2,0.29
4439,2021-01-10,PAB,2,2,0,2,0,0,ITH,ITH1,4,Provincia Autonoma Bolzano / Bozen,P.A. Bolzano,533050,368896,69.2,0.0
4440,2021-06-16,PAB,3823,2028,1795,11,3807,5,ITH,ITH1,4,Provincia Autonoma Bolzano / Bozen,P.A. Bolzano,533050,372719,69.92,0.72
4441,2021-08-01,PAB,1318,759,559,711,551,56,ITH,ITH1,4,Provincia Autonoma Bolzano / Bozen,P.A. Bolzano,533050,374037,70.17,0.25
4442,2021-08-18,PAB,881,461,420,380,498,3,ITH,ITH1,4,Provincia Autonoma Bolzano / Bozen,P.A. Bolzano,533050,374918,70.33,0.17
4443,2021-02-16,PAB,530,205,325,530,0,0,ITH,ITH1,4,Provincia Autonoma Bolzano / Bozen,P.A. Bolzano,533050,375448,70.43,0.1
4444,2021-01-28,PAB,872,309,563,9,863,0,ITH,ITH1,4,Provincia Autonoma Bolzano / Bozen,P.A. Bolzano,533050,376320,70.6,0.16
4445,2021-02-02,PAB,1752,509,1243,8,1744,0,ITH,ITH1,4,Provincia Autonoma Bolzano / Bozen,P.A. Bolzano,533050,378072,70.93,0.33
4446,2021-07-20,PAB,3133,1730,1403,1402,1524,207,ITH,ITH1,4,Provincia Autonoma Bolzano / Bozen,P.A. Bolzano,533050,381205,71.51,0.59
4447,2021-09-01,PAB,1058,503,555,596,450,12,ITH,ITH1,4,Provincia Autonoma Bolzano / Bozen,P.A. Bolzano,533050,382263,71.71,0.2
4448,2021-05-19,PAB,3887,1997,1890,1964,1789,134,ITH,ITH1,4,Provincia Autonoma Bolzano / Bozen,P.A. Bolzano,533050,386150,72.44,0.73
4449,2021-01-03,PAB,41,16,25,41,0,0,ITH,ITH1,4,Provincia Autonoma Bolzano / Bozen,P.A. Bolzano,533050,386191,72.45,0.01
4450,2021-04-13,PAB,2400,1134,1266,2393,7,0,ITH,ITH1,4,Provincia Autonoma Bolzano / Bozen,P.A. Bolzano,533050,388591,72.9,0.45
4451,2021-08-29,PAB,868,479,389,358,498,12,ITH,ITH1,4,Provincia Autonoma Bolzano / Bozen,P.A. Bolzano,533050,389459,73.06,0.16
4452,2021-03-09,PAB,1194,543,651,1192,2,0,ITH,ITH1,4,Provincia Autonoma Bolzano / Bozen,P.A. Bolzano,533050,390653,73.29,0.22
4453,2021-05-23,PAB,4343,2305,2038,4141,8,194,ITH,ITH1,4,Provincia Autonoma Bolzano / Bozen,P.A. Bolzano,533050,394996,74.1,0.81
4454,2021-07-19,PAB,2782,1395,1387,625,2047,110,ITH,ITH1,4,Provincia Autonoma Bolzano / Bozen,P.A. Bolzano,533050,397778,74.62,0.52
4455,2021-02-03,PAB,1506,479,1027,5,1501,0,ITH,ITH1,4,Provincia Autonoma Bolzano / Bozen,P.A. Bolzano,533050,399284,74.91,0.28
4456,2021-02-10,PAB,1637,605,1032,27,1610,0,ITH,ITH1,4,Provincia Autonoma Bolzano / Bozen,P.A. Bolzano,533050,400921,75.21,0.31
4457,2021-08-31,PAB,2029,1095,934,752,1259,18,ITH,ITH1,4,Provincia Autonoma Bolzano / Bozen,P.A. Bolzano,533050,402950,75.59,0.38
4458,2021-05-21,PAB,7396,4065,3331,5230,1879,287,ITH,ITH1,4,Provincia Autonoma Bolzano / Bozen,P.A. Bolzano,533050,410346,76.98,1.39
4459,2021-08-24,PAB,1968,1027,941,565,1396,7,ITH,ITH1,4,Provincia Autonoma Bolzano / Bozen,P.A. Bolzano,533050,412314,77.35,0.37
4460,2021-05-16,PAB,2029,935,1094,1285,694,50,ITH,ITH1,4,Provincia Autonoma Bolzano / Bozen,P.A. Bolzano,533050,414343,77.73,0.38
4461,2021-03-28,PAB,569,212,357,11,558,0,ITH,ITH1,4,Provincia Autonoma Bolzano / Bozen,P.A. Bolzano,533050,414912,77.84,0.11
4462,2021-08-10,PAB,1850,1016,834,1560,280,10,ITH,ITH1,4,Provincia Autonoma Bolzano / Bozen,P.A. Bolzano,533050,416762,78.18,0.35
4463,2021-06-04,PAB,6721,3388,3333,4950,1537,234,ITH,ITH1,4,Provincia Autonoma Bolzano / Bozen,P.A. Bolzano,533050,423483,79.45,1.26
4464,2021-02-24,PAB,1368,407,961,1356,12,0,ITH,ITH1,4,Provincia Autonoma Bolzano / Bozen,P.A. Bolzano,533050,424851,79.7,0.26
4465,2021-03-27,PAB,3053,1554,1499,1544,1508,1,ITH,ITH1,4,Provincia Autonoma Bolzano / Bozen,P.A. Bolzano,533050,427904,80.27,0.57
4466,2021-03-13,PAB,2886,1460,1426,2785,101,0,ITH,ITH1,4,Provincia Autonoma Bolzano / Bozen,P.A. Bolzano,533050,430790,80.82,0.54
4467,2021-03-08,PAB,1212,535,677,1184,27,1,ITH,ITH1,4,Provincia Autonoma Bolzano / Bozen,P.A. Bolzano,533050,432002,81.04,0.23
4468,2021-08-12,PAB,3362,1723,1639,648,2711,3,ITH,ITH1,4,Provincia Autonoma Bolzano / Bozen,P.A. Bolzano,533050,435364,81.67,0.63
4469,2021-05-04,PAB,3453,1845,1608,2270,1038,145,ITH,ITH1,4,Provincia Autonoma Bolzano / Bozen,P.A. Bolzano,533050,438817,82.32,0.65
4470,2021-06-14,PAB,2984,1617,1367,577,2361,46,ITH,ITH1,4,Provincia Autonoma Bolzano / Bozen,P.A. Bolzano,533050,441801,82.88,0.56
4471,2021-02-15,PAB,72,42,30,26,46,0,ITH,ITH1,4,Provincia Autonoma Bolzano / Bozen,P.A. Bolzano,533050,441873,82.9,0.01
4472,2021-08-19,PAB,1747,963,784,1128,614,5,ITH,ITH1,4,Provincia Autonoma Bolzano / Bozen,P.A. Bolzano,533050,443620,83.22,0.33
4473,2021-05-11,PAB,2854,1338,1516,1262,1523,69,ITH,ITH1,4,Provincia Autonoma Bolzano / Bozen,P.A. Bolzano,533050,446474,83.76,0.54
4474,2021-07-31,PAB,3168,1720,1448,2109,924,135,ITH,ITH1,4,Provincia Autonoma Bolzano / Bozen,P.A. Bolzano,533050,449642,84.35,0.59
4475,2021-01-29,PAB,1515,518,997,24,1491,0,ITH,ITH1,4,Provincia Autonoma Bolzano / Bozen,P.A. Bolzano,533050,451157,84.64,0.28
4476,2021-04-22,PAB,2939,1512,1427,1993,942,4,ITH,ITH1,4,Provincia Autonoma Bolzano / Bozen,P.A. Bolzano,533050,454096,85.19,0.55
4477,2021-05-09,PAB,4243,2410,1833,2935,1150,158,ITH,ITH1,4,Provincia Autonoma Bolzano / Bozen,P.A. Bolzano,533050,458339,85.98,0.8
4478,2021-05-31,PAB,3068,1514,1554,2087,868,113,ITH,ITH1,4,Provincia Autonoma Bolzano / Bozen,P.A. Bolzano,533050,461407,86.56,0.58
4479,2021-01-01,PAB,6,5,1,6,0,0,ITH,ITH1,4,Provincia Autonoma Bolzano / Bozen,P.A. Bolzano,533050,461413,86.56,0.0
4480,2021-06-07,PAB,2986,1554,1432,2523,324,139,ITH,ITH1,4,Provincia Autonoma Bolzano / Bozen,P.A. Bolzano,533050,464399,87.12,0.56
4481,2021-02-27,PAB,2458,759,1699,2448,10,0,ITH,ITH1,4,Provincia Autonoma Bolzano / Bozen,P.A. Bolzano,533050,466857,87.58,0.46
4482,2021-07-26,PAB,1628,940,688,1125,411,92,ITH,ITH1,4,Provincia Autonoma Bolzano / Bozen,P.A. Bolzano,533050,468485,87.89,0.31
4483,2021-02-22,PAB,526,143,383,514,12,0,ITH,ITH1,4,Provincia Autonoma Bolzano / Bozen,P.A. Bolzano,533050,469011,87.99,0.1
4484,2021-08-26,PAB,2236,1131,1105,828,1357,51,ITH,ITH1,4,Provincia Autonoma Bolzano / Bozen,P.A. Bolzano,533050,471247,88.41,0.42
4485,2021-07-07,PAB,1993,1033,960,600,1336,57,ITH,ITH1,4,Provincia Autonoma Bolzano / Bozen,P.A. Bolzano,533050,473240,88.78,0.37
4486,2021-04-25,PAB,3078,1501,1577,2405,672,1,ITH,ITH1,4,Provincia Autonoma Bolzano / Bozen,P.A. Bolzano,533050,476318,89.36,0.58
4487,2021-08-03,PAB,2948,1585,1363,1979,838,131,ITH,ITH1,4,Provincia Autonoma Bolzano / Bozen,P.A. Bolzano,533050,479266,89.91,0.55
4488,2021-01-13,PAB,1727,569,1158,1727,0,0,ITH,ITH1,4,Provincia Autonoma Bolzano / Bozen,P.A. Bolzano,533050,480993,90.23,0.32
4489,2021-01-30,PAB,498,245,253,4,494,0,ITH,ITH1,4,Provincia Autonoma Bolzano / Bozen,P.A. Bolzano,533050,481491,90.33,0.09
4490,2021-04-23,PAB,4554,2157,2397,3258,1293,3,ITH,ITH1,4,Provincia Autonoma Bolzano / Bozen,P.A. Bolzano,533050,486045,91.18,0.85
4491,2021-01-11,PAB,1594,522,1072,1594,0,0,ITH,ITH1,4,Provincia Autonoma Bolzano / Bozen,P.A. Bolzano,533050,487639,91.48,0.3
4492,2021-07-15,PAB,4395,2319,2076,1511,2703,181,ITH,ITH1,4,Provincia Autonoma Bolzano / Bozen,P.A. Bolzano,533050,492034,92.31,0.82
4493,2021-04-06,PAB,2254,1120,1134,2151,102,1,ITH,ITH1,4,Provincia Autonoma Bolzano / Bozen,P.A. Bolzano,533050,494288,92.73,0.42
4494,2021-02-13,PAB,318,79,239,312,6,0,ITH,ITH1,4,Provincia Autonoma Bolzano / Bozen,P.A. Bolzano,533050,494606,92.79,0.06
4495,2021-04-11,PAB,2734,1301,1433,2555,178,1,ITH,ITH1,4,Provincia Autonoma Bolzano / Bozen,P.A. Bolzano,533050,497340,93.3,0.51
4496,2021-05-24,PAB,1459,769,690,1061,335,63,ITH,ITH1,4,Provincia Autonoma Bolzano / Bozen,P.A. Bolzano,533050,498799,93.57,0.27
4497,2021-02-20,PAB,1802,540,1262,1784,18,0,ITH,ITH1,4,Provincia Autonoma Bolzano / Bozen,P.A. Bolzano,533050,500601,93.91,0.34
4498,2021-07-27,PAB,3157,1885,1272,908,2181,68,ITH,ITH1,4,Provincia Autonoma Bolzano / Bozen,P.A. Bolzano,533050,503758,94.5,0.59
4499,2021-04-18,PAB,3116,1611,1505,2104,1011,1,ITH,ITH1,4,Provincia Autonoma Bolzano / Bozen,P.A. Bolzano,533050,506874,95.09,0.58
4500,2021-01-15,PAB,3292,1234,2058,3292,0,0,ITH,ITH1,4,Provincia Autonoma Bolzano / Bozen,P.A. Bolzano,533050,510166,95.71,0.62
4501,2021-08-14,PAB,2060,1120,940,786,1271,3,ITH,ITH1,4,Provincia Autonoma Bolzano / Bozen,P.A. Bolzano,533050,512226,96.09,0.39
4502,2021-03-06,PAB,3976,2082,1894,3763,211,2,ITH,ITH1,4,Provincia Autonoma Bolzano / Bozen,P.A. Bolzano,533050,516202,96.84,0.75
4503,2021-05-28,PAB,7466,3942,3524,5369,1895,202,ITH,ITH1,4,Provincia Autonoma Bolzano / Bozen,P.A. Bolzano,533050,523668,98.24,1.4
4504,2021-02-17,PAB,156,51,105,139,17,0,ITH,ITH1,4,Provincia Autonoma Bolzano / Bozen,P.A. Bolzano,533050,523824,98.27,0.03
4505,2021-02-05,PAB,3203,1188,2015,8,3195,0,ITH,ITH1,4,Provincia Autonoma Bolzano / Bozen,P.A. Bolzano,533050,527027,98.87,0.6
4506,2021-04-15,PAB,4410,2314,2096,4141,266,3,ITH,ITH1,4,Provincia Autonoma Bolzano / Bozen,P.A. Bolzano,533050,531437,99.7,0.83
4507,2021-07-24,PAB,4829,2847,1982,1383,3329,117,ITH,ITH1,4,Provincia Autonoma Bolzano / Bozen,P.A. Bolzano,533050,536266,100.6,0.91
4508,2021-05-02,PAB,2453,1284,1169,1431,915,107,ITH,ITH1,4,Provincia Autonoma Bolzano / Bozen,P.A. Bolzano,533050,538719,101.06,0.46
4509,2021-01-22,PAB,248,143,105,124,124,0,ITH,ITH1,4,Provincia Autonoma Bolzano / Bozen,P.A. Bolzano,533050,538967,101.11,0.05
4510,2021-07-17,PAB,3147,1801,1346,707,2352,88,ITH,ITH1,4,Provincia Autonoma Bolzano / Bozen,P.A. Bolzano,533050,542114,101.7,0.59
4511,2021-04-08,PAB,2796,1360,1436,2587,204,5,ITH,ITH1,4,Provincia Autonoma Bolzano / Bozen,P.A. Bolzano,533050,544910,102.22,0.52
4512,2020-12-27,PAB,144,65,79,144,0,0,ITH,ITH1,4,Provincia Autonoma Bolzano / Bozen,P.A. Bolzano,533050,545054,102.25,0.03
4513,2021-06-30,PAB,3064,1565,1499,400,2608,56,ITH,ITH1,4,Provincia Autonoma Bolzano / Bozen,P.A. Bolzano,533050,548118,102.83,0.57
4514,2021-06-11,PAB,5839,3004,2835,2140,3486,213,ITH,ITH1,4,Provincia Autonoma Bolzano / Bozen,P.A. Bolzano,533050,553957,103.92,1.1
4515,2021-09-02,PAB,1207,626,581,714,467,26,ITH,ITH1,4,Provincia Autonoma Bolzano / Bozen,P.A. Bolzano,533050,555164,104.15,0.23
4516,2021-03-20,PAB,1760,851,909,1130,625,5,ITH,ITH1,4,Provincia Autonoma Bolzano / Bozen,P.A. Bolzano,533050,556924,104.48,0.33
4517,2021-06-28,PAB,4614,2308,2306,217,4373,24,ITH,ITH1,4,Provincia Autonoma Bolzano / Bozen,P.A. Bolzano,533050,561538,105.34,0.87
4518,2021-06-18,PAB,4544,2351,2193,1467,2912,165,ITH,ITH1,4,Provincia Autonoma Bolzano / Bozen,P.A. Bolzano,533050,566082,106.2,0.85
4519,2021-01-08,PAB,1537,484,1053,1537,0,0,ITH,ITH1,4,Provincia Autonoma Bolzano / Bozen,P.A. Bolzano,533050,567619,106.49,0.29
4520,2021-08-07,PAB,2373,1351,1022,1690,665,18,ITH,ITH1,4,Provincia Autonoma Bolzano / Bozen,P.A. Bolzano,533050,569992,106.93,0.45
4521,2021-08-06,PAB,3638,1917,1721,1200,2428,10,ITH,ITH1,4,Provincia Autonoma Bolzano / Bozen,P.A. Bolzano,533050,573630,107.61,0.68
4522,2021-04-28,PAB,2469,1307,1162,2459,5,5,ITH,ITH1,4,Provincia Autonoma Bolzano / Bozen,P.A. Bolzano,533050,576099,108.08,0.46
4523,2021-01-16,PAB,2841,1265,1576,2841,0,0,ITH,ITH1,4,Provincia Autonoma Bolzano / Bozen,P.A. Bolzano,533050,578940,108.61,0.53
4524,2021-06-10,PAB,4498,2334,2164,1308,3098,92,ITH,ITH1,4,Provincia Autonoma Bolzano / Bozen,P.A. Bolzano,533050,583438,109.45,0.84
4525,2021-08-13,PAB,2909,1556,1353,1599,1300,10,ITH,ITH1,4,Provincia Autonoma Bolzano / Bozen,P.A. Bolzano,533050,586347,110.0,0.55
4526,2021-04-26,PAB,1550,776,774,1544,5,1,ITH,ITH1,4,Provincia Autonoma Bolzano / Bozen,P.A. Bolzano,533050,587897,110.29,0.29
4527,2021-07-10,PAB,5813,3001,2812,953,4749,111,ITH,ITH1,4,Provincia Autonoma Bolzano / Bozen,P.A. Bolzano,533050,593710,111.38,1.09
4528,2021-01-18,PAB,1776,689,1087,1771,5,0,ITH,ITH1,4,Provincia Autonoma Bolzano / Bozen,P.A. Bolzano,533050,595486,111.71,0.33
4529,2021-08-15,PAB,615,333,282,282,333,0,ITH,ITH1,4,Provincia Autonoma Bolzano / Bozen,P.A. Bolzano,533050,596101,111.83,0.12
4530,2021-05-07,PAB,4200,2063,2137,3398,528,274,ITH,ITH1,4,Provincia Autonoma Bolzano / Bozen,P.A. Bolzano,533050,600301,112.62,0.79
4531,2021-07-03,PAB,5639,2793,2846,969,4566,104,ITH,ITH1,4,Provincia Autonoma Bolzano / Bozen,P.A. Bolzano,533050,605940,113.67,1.06
4532,2021-05-05,PAB,4161,1948,2213,1826,2118,217,ITH,ITH1,4,Provincia Autonoma Bolzano / Bozen,P.A. Bolzano,533050,610101,114.45,0.78
4533,2021-01-25,PAB,493,187,306,3,490,0,ITH,ITH1,4,Provincia Autonoma Bolzano / Bozen,P.A. Bolzano,533050,610594,114.55,0.09
4534,2021-03-23,PAB,1557,761,796,1544,1,12,ITH,ITH1,4,Provincia Autonoma Bolzano / Bozen,P.A. Bolzano,533050,612151,114.84,0.29
4535,2021-04-01,PAB,2791,1409,1382,2644,146,1,ITH,ITH1,4,Provincia Autonoma Bolzano / Bozen,P.A. Bolzano,533050,614942,115.36,0.52
4536,2021-07-05,PAB,2936,1406,1530,824,1984,128,ITH,ITH1,4,Provincia Autonoma Bolzano / Bozen,P.A. Bolzano,533050,617878,115.91,0.55
4537,2021-05-30,PAB,4793,2531,2262,733,4030,30,ITH,ITH1,4,Provincia Autonoma Bolzano / Bozen,P.A. Bolzano,533050,622671,116.81,0.9
4538,2021-07-12,PAB,3534,1755,1779,253,3243,38,ITH,ITH1,4,Provincia Autonoma Bolzano / Bozen,P.A. Bolzano,533050,626205,117.48,0.66
4539,2021-04-03,PAB,833,366,467,22,811,0,ITH,ITH1,4,Provincia Autonoma Bolzano / Bozen,P.A. Bolzano,533050,627038,117.63,0.16
4540,2021-09-07,PAB,1277,696,581,238,1039,0,ITH,ITH1,4,Provincia Autonoma Bolzano / Bozen,P.A. Bolzano,533050,628315,117.87,0.24
4541,2021-03-25,PAB,2173,1080,1093,1725,445,3,ITH,ITH1,4,Provincia Autonoma Bolzano / Bozen,P.A. Bolzano,533050,630488,118.28,0.41
4542,2021-01-27,PAB,85,29,56,2,83,0,ITH,ITH1,4,Provincia Autonoma Bolzano / Bozen,P.A. Bolzano,533050,630573,118.3,0.02
4543,2021-06-07,PIE,34972,17891,17081,29544,4807,621,ITC,ITC1,1,Piemonte,Piemonte,4356406,34972,0.8,0.8
4544,2021-08-03,PIE,30181,15791,14390,9318,20384,479,ITC,ITC1,1,Piemonte,Piemonte,4356406,65153,1.5,0.69
4545,2021-06-19,PIE,40133,20354,19779,22898,16679,556,ITC,ITC1,1,Piemonte,Piemonte,4356406,105286,2.42,0.92
4546,2021-02-04,PIE,10243,3358,6885,583,9658,2,ITC,ITC1,1,Piemonte,Piemonte,4356406,115529,2.65,0.24
4547,2021-07-06,PIE,38330,19399,18931,8650,29127,553,ITC,ITC1,1,Piemonte,Piemonte,4356406,153859,3.53,0.88
4548,2021-03-28,PIE,16090,6906,9184,8126,7624,340,ITC,ITC1,1,Piemonte,Piemonte,4356406,169949,3.9,0.37
4549,2021-07-20,PIE,39106,20575,18531,5755,32782,569,ITC,ITC1,1,Piemonte,Piemonte,4356406,209055,4.8,0.9
4550,2021-04-11,PIE,20854,9328,11526,18233,2151,470,ITC,ITC1,1,Piemonte,Piemonte,4356406,229909,5.28,0.48
4551,2021-01-04,PIE,5583,1689,3894,5582,0,1,ITC,ITC1,1,Piemonte,Piemonte,4356406,235492,5.41,0.13
4552,2021-04-28,PIE,26095,11762,14333,15481,10061,553,ITC,ITC1,1,Piemonte,Piemonte,4356406,261587,6.0,0.6
4553,2021-08-15,PIE,6576,3630,2946,5035,1269,272,ITC,ITC1,1,Piemonte,Piemonte,4356406,268163,6.16,0.15
4554,2021-09-01,PIE,18649,9643,9006,6712,11248,689,ITC,ITC1,1,Piemonte,Piemonte,4356406,286812,6.58,0.43
4555,2021-05-24,PIE,29029,13442,15587,16653,11987,389,ITC,ITC1,1,Piemonte,Piemonte,4356406,315841,7.25,0.67
4556,2021-03-02,PIE,11340,4620,6720,10332,815,193,ITC,ITC1,1,Piemonte,Piemonte,4356406,327181,7.51,0.26
4557,2021-02-11,PIE,6775,2110,4665,2990,3766,19,ITC,ITC1,1,Piemonte,Piemonte,4356406,333956,7.67,0.16
4558,2021-04-09,PIE,25918,11411,14507,20834,4507,577,ITC,ITC1,1,Piemonte,Piemonte,4356406,359874,8.26,0.59
4559,2020-12-30,PIE,736,324,412,736,0,0,ITC,ITC1,1,Piemonte,Piemonte,4356406,360610,8.28,0.02
4560,2021-06-05,PIE,37021,18957,18064,31908,4463,650,ITC,ITC1,1,Piemonte,Piemonte,4356406,397631,9.13,0.85
4561,2021-02-25,PIE,12285,5303,6982,11551,547,187,ITC,ITC1,1,Piemonte,Piemonte,4356406,409916,9.41,0.28
4562,2021-07-15,PIE,42619,22019,20600,4107,38053,459,ITC,ITC1,1,Piemonte,Piemonte,4356406,452535,10.39,0.98
4563,2021-08-01,PIE,27245,14436,12809,8480,18285,480,ITC,ITC1,1,Piemonte,Piemonte,4356406,479780,11.01,0.63
4564,2021-04-23,PIE,27472,12614,14858,19993,6765,714,ITC,ITC1,1,Piemonte,Piemonte,4356406,507252,11.64,0.63
4565,2021-08-27,PIE,17352,9261,8091,7466,9236,650,ITC,ITC1,1,Piemonte,Piemonte,4356406,524604,12.04,0.4
4566,2021-05-19,PIE,33210,15343,17867,21470,11140,600,ITC,ITC1,1,Piemonte,Piemonte,4356406,557814,12.8,0.76
4567,2021-03-14,PIE,8219,3342,4877,5175,2903,141,ITC,ITC1,1,Piemonte,Piemonte,4356406,566033,12.99,0.19
4568,2021-05-10,PIE,29086,14034,15052,15310,13140,636,ITC,ITC1,1,Piemonte,Piemonte,4356406,595119,13.66,0.67
4569,2021-01-30,PIE,6000,2144,3856,218,5781,1,ITC,ITC1,1,Piemonte,Piemonte,4356406,601119,13.8,0.14
4570,2021-06-24,PIE,39304,19725,19579,18353,20348,603,ITC,ITC1,1,Piemonte,Piemonte,4356406,640423,14.7,0.9
4571,2021-03-16,PIE,10541,4281,6260,4374,6073,94,ITC,ITC1,1,Piemonte,Piemonte,4356406,650964,14.94,0.24
4572,2021-08-20,PIE,16568,8894,7674,10321,5543,704,ITC,ITC1,1,Piemonte,Piemonte,4356406,667532,15.32,0.38
4573,2021-05-12,PIE,31962,15213,16749,18388,12946,628,ITC,ITC1,1,Piemonte,Piemonte,4356406,699494,16.06,0.73
4574,2021-03-23,PIE,13216,5577,7639,6645,6252,319,ITC,ITC1,1,Piemonte,Piemonte,4356406,712710,16.36,0.3
4575,2021-01-16,PIE,7780,2627,5153,7773,0,7,ITC,ITC1,1,Piemonte,Piemonte,4356406,720490,16.54,0.18
4576,2020-12-28,PIE,1,1,0,1,0,0,ITC,ITC1,1,Piemonte,Piemonte,4356406,720491,16.54,0.0
4577,2021-09-08,PIE,15579,8056,7523,6113,8710,756,ITC,ITC1,1,Piemonte,Piemonte,4356406,736070,16.9,0.36
4578,2021-07-27,PIE,33808,17653,16155,8257,24990,561,ITC,ITC1,1,Piemonte,Piemonte,4356406,769878,17.67,0.78
4579,2021-05-02,PIE,25159,11291,13868,14012,10751,396,ITC,ITC1,1,Piemonte,Piemonte,4356406,795037,18.25,0.58
4580,2021-08-08,PIE,20285,10834,9451,9013,10932,340,ITC,ITC1,1,Piemonte,Piemonte,4356406,815322,18.72,0.47
4581,2021-04-30,PIE,31991,14391,17600,17953,13347,691,ITC,ITC1,1,Piemonte,Piemonte,4356406,847313,19.45,0.73
4582,2021-01-18,PIE,6179,2051,4128,5924,251,4,ITC,ITC1,1,Piemonte,Piemonte,4356406,853492,19.59,0.14
4583,2021-05-17,PIE,31008,14641,16367,17383,13210,415,ITC,ITC1,1,Piemonte,Piemonte,4356406,884500,20.3,0.71
4584,2021-02-06,PIE,8009,2667,5342,396,7611,2,ITC,ITC1,1,Piemonte,Piemonte,4356406,892509,20.49,0.18
4585,2021-02-23,PIE,9272,3733,5539,8509,588,175,ITC,ITC1,1,Piemonte,Piemonte,4356406,901781,20.7,0.21
4586,2021-05-31,PIE,29164,14079,15085,20165,8588,411,ITC,ITC1,1,Piemonte,Piemonte,4356406,930945,21.37,0.67
4587,2021-06-17,PIE,41223,20693,20530,24228,16366,629,ITC,ITC1,1,Piemonte,Piemonte,4356406,972168,22.32,0.95
4588,2021-09-03,PIE,18345,9686,8659,6401,11293,651,ITC,ITC1,1,Piemonte,Piemonte,4356406,990513,22.74,0.42
4589,2021-06-12,PIE,42709,22509,20200,39274,2629,806,ITC,ITC1,1,Piemonte,Piemonte,4356406,1033222,23.72,0.98
4590,2021-06-26,PIE,41286,21010,20276,21973,18597,716,ITC,ITC1,1,Piemonte,Piemonte,4356406,1074508,24.67,0.95
4591,2021-07-13,PIE,38909,20074,18835,3676,34895,338,ITC,ITC1,1,Piemonte,Piemonte,4356406,1113417,25.56,0.89
4592,2021-04-04,PIE,9265,4059,5206,6397,2712,156,ITC,ITC1,1,Piemonte,Piemonte,4356406,1122682,25.77,0.21
4593,2021-04-21,PIE,25803,11853,13950,19774,5359,670,ITC,ITC1,1,Piemonte,Piemonte,4356406,1148485,26.36,0.59
4594,2021-01-11,PIE,8776,2993,5783,8770,0,6,ITC,ITC1,1,Piemonte,Piemonte,4356406,1157261,26.56,0.2
4595,2021-08-22,PIE,9606,5245,4361,5132,4098,376,ITC,ITC1,1,Piemonte,Piemonte,4356406,1166867,26.79,0.22
4596,2021-07-08,PIE,41042,20988,20054,7460,33005,577,ITC,ITC1,1,Piemonte,Piemonte,4356406,1207909,27.73,0.94
4597,2021-01-23,PIE,4263,1327,2936,878,3383,2,ITC,ITC1,1,Piemonte,Piemonte,4356406,1212172,27.83,0.1
4598,2021-03-21,PIE,10744,4746,5998,4029,6541,174,ITC,ITC1,1,Piemonte,Piemonte,4356406,1222916,28.07,0.25
4599,2021-08-13,PIE,19986,10647,9339,12057,7231,698,ITC,ITC1,1,Piemonte,Piemonte,4356406,1242902,28.53,0.46
4600,2021-05-05,PIE,34718,16265,18453,20343,13674,701,ITC,ITC1,1,Piemonte,Piemonte,4356406,1277620,29.33,0.8
4601,2021-07-01,PIE,41998,21015,20983,19819,21146,1033,ITC,ITC1,1,Piemonte,Piemonte,4356406,1319618,30.29,0.96
4602,2021-04-02,PIE,20177,8331,11846,11339,8433,405,ITC,ITC1,1,Piemonte,Piemonte,4356406,1339795,30.75,0.46
4603,2021-05-29,PIE,32854,15249,17605,20301,12191,362,ITC,ITC1,1,Piemonte,Piemonte,4356406,1372649,31.51,0.75
4604,2021-02-18,PIE,4815,2110,2705,4298,429,88,ITC,ITC1,1,Piemonte,Piemonte,4356406,1377464,31.62,0.11
4605,2021-07-25,PIE,28741,15246,13495,6596,21650,495,ITC,ITC1,1,Piemonte,Piemonte,4356406,1406205,32.28,0.66
4606,2021-04-16,PIE,28474,13236,15238,22692,5015,767,ITC,ITC1,1,Piemonte,Piemonte,4356406,1434679,32.93,0.65
4607,2021-02-27,PIE,12717,4856,7861,12138,337,242,ITC,ITC1,1,Piemonte,Piemonte,4356406,1447396,33.22,0.29
4608,2021-04-25,PIE,20265,9324,10941,17294,2506,465,ITC,ITC1,1,Piemonte,Piemonte,4356406,1467661,33.69,0.47
4609,2021-01-15,PIE,9124,3013,6111,9118,0,6,ITC,ITC1,1,Piemonte,Piemonte,4356406,1476785,33.9,0.21
4610,2021-06-21,PIE,38517,19258,19259,17166,20782,569,ITC,ITC1,1,Piemonte,Piemonte,4356406,1515302,34.78,0.88
4611,2021-03-13,PIE,13050,4725,8325,11345,1432,273,ITC,ITC1,1,Piemonte,Piemonte,4356406,1528352,35.08,0.3
4612,2021-06-02,PIE,26760,13096,13664,21667,4648,445,ITC,ITC1,1,Piemonte,Piemonte,4356406,1555112,35.7,0.61
4613,2021-02-22,PIE,8505,3475,5030,7805,595,105,ITC,ITC1,1,Piemonte,Piemonte,4356406,1563617,35.89,0.2
4614,2021-03-11,PIE,14037,5316,8721,10686,3100,251,ITC,ITC1,1,Piemonte,Piemonte,4356406,1577654,36.21,0.32
4615,2021-03-25,PIE,17164,7282,9882,8084,8637,443,ITC,ITC1,1,Piemonte,Piemonte,4356406,1594818,36.61,0.39
4616,2021-07-22,PIE,41647,21921,19726,7012,34042,593,ITC,ITC1,1,Piemonte,Piemonte,4356406,1636465,37.56,0.96
4617,2021-04-13,PIE,26760,12035,14725,22612,3464,684,ITC,ITC1,1,Piemonte,Piemonte,4356406,1663225,38.18,0.61
4618,2021-01-20,PIE,6624,2089,4535,5900,717,7,ITC,ITC1,1,Piemonte,Piemonte,4356406,1669849,38.33,0.15
4619,2021-02-03,PIE,10223,3312,6911,609,9612,2,ITC,ITC1,1,Piemonte,Piemonte,4356406,1680072,38.57,0.23
4620,2021-03-09,PIE,14335,5739,8596,11746,2353,236,ITC,ITC1,1,Piemonte,Piemonte,4356406,1694407,38.89,0.33
4621,2021-08-24,PIE,15216,8120,7096,7857,6724,635,ITC,ITC1,1,Piemonte,Piemonte,4356406,1709623,39.24,0.35
4622,2021-01-01,PIE,1041,396,645,1040,0,1,ITC,ITC1,1,Piemonte,Piemonte,4356406,1710664,39.27,0.02
4623,2021-07-05,PIE,35629,17827,17802,11700,23239,690,ITC,ITC1,1,Piemonte,Piemonte,4356406,1746293,40.09,0.82
4624,2021-02-20,PIE,3847,1263,2584,3571,174,102,ITC,ITC1,1,Piemonte,Piemonte,4356406,1750140,40.17,0.09
4625,2021-07-24,PIE,34891,18354,16537,7907,26385,599,ITC,ITC1,1,Piemonte,Piemonte,4356406,1785031,40.97,0.8
4626,2021-07-12,PIE,39231,20235,18996,4562,34196,473,ITC,ITC1,1,Piemonte,Piemonte,4356406,1824262,41.88,0.9
4627,2021-07-29,PIE,36678,19062,17616,9359,26662,657,ITC,ITC1,1,Piemonte,Piemonte,4356406,1860940,42.72,0.84
4628,2021-04-20,PIE,25537,11689,13848,18550,6357,630,ITC,ITC1,1,Piemonte,Piemonte,4356406,1886477,43.3,0.59
4629,2021-05-07,PIE,33153,15685,17468,18377,14155,621,ITC,ITC1,1,Piemonte,Piemonte,4356406,1919630,44.06,0.76
4630,2021-01-27,PIE,4206,1455,2751,994,3210,2,ITC,ITC1,1,Piemonte,Piemonte,4356406,1923836,44.16,0.1
4631,2021-02-13,PIE,4170,1343,2827,2929,1225,16,ITC,ITC1,1,Piemonte,Piemonte,4356406,1928006,44.26,0.1
4632,2021-07-31,PIE,35751,19005,16746,10745,24631,375,ITC,ITC1,1,Piemonte,Piemonte,4356406,1963757,45.08,0.82
4633,2021-08-17,PIE,18062,9683,8379,11691,5598,773,ITC,ITC1,1,Piemonte,Piemonte,4356406,1981819,45.49,0.41
4634,2021-05-09,PIE,27176,12941,14235,13160,13623,393,ITC,ITC1,1,Piemonte,Piemonte,4356406,2008995,46.12,0.62
4635,2021-04-18,PIE,22969,10818,12151,19632,2756,581,ITC,ITC1,1,Piemonte,Piemonte,4356406,2031964,46.64,0.53
4636,2021-01-08,PIE,5545,1765,3780,5543,0,2,ITC,ITC1,1,Piemonte,Piemonte,4356406,2037509,46.77,0.13
4637,2021-06-14,PIE,38078,19608,18470,30266,7098,714,ITC,ITC1,1,Piemonte,Piemonte,4356406,2075587,47.64,0.87
4638,2021-03-06,PIE,14040,5232,8808,11062,2798,180,ITC,ITC1,1,Piemonte,Piemonte,4356406,2089627,47.97,0.32
4639,2021-08-10,PIE,22040,11677,10363,12503,8890,647,ITC,ITC1,1,Piemonte,Piemonte,4356406,2111667,48.47,0.51
4640,2021-09-07,PIE,18277,9614,8663,6104,11521,652,ITC,ITC1,1,Piemonte,Piemonte,4356406,2129944,48.89,0.42
4641,2021-07-03,PIE,40143,20147,19996,15350,24048,745,ITC,ITC1,1,Piemonte,Piemonte,4356406,2170087,49.81,0.92
4642,2021-06-28,PIE,38489,19112,19377,15141,22751,597,ITC,ITC1,1,Piemonte,Piemonte,4356406,2208576,50.7,0.88
4643,2021-04-06,PIE,20788,9067,11721,15121,5212,455,ITC,ITC1,1,Piemonte,Piemonte,4356406,2229364,51.17,0.48
4644,2020-12-27,PIE,915,370,545,915,0,0,ITC,ITC1,1,Piemonte,Piemonte,4356406,2230279,51.2,0.02
4645,2021-08-31,PIE,18992,10019,8973,6810,11632,550,ITC,ITC1,1,Piemonte,Piemonte,4356406,2249271,51.63,0.44
4646,2021-06-09,PIE,38731,20401,18330,35183,2748,800,ITC,ITC1,1,Piemonte,Piemonte,4356406,2288002,52.52,0.89
4647,2021-03-18,PIE,11783,4817,6966,3840,7749,194,ITC,ITC1,1,Piemonte,Piemonte,4356406,2299785,52.79,0.27
4648,2021-03-03,PIE,12390,4870,7520,11375,820,195,ITC,ITC1,1,Piemonte,Piemonte,4356406,2312175,53.08,0.28
4649,2021-08-09,PIE,24734,12902,11832,12028,11995,711,ITC,ITC1,1,Piemonte,Piemonte,4356406,2336909,53.64,0.57
4650,2021-08-26,PIE,16878,9141,7737,8105,8024,749,ITC,ITC1,1,Piemonte,Piemonte,4356406,2353787,54.03,0.39
4651,2021-05-18,PIE,32232,14869,17363,19101,12683,448,ITC,ITC1,1,Piemonte,Piemonte,4356406,2386019,54.77,0.74
4652,2021-03-30,PIE,17007,7122,9885,8735,7875,397,ITC,ITC1,1,Piemonte,Piemonte,4356406,2403026,55.16,0.39
4653,2021-07-10,PIE,41226,20895,20331,6731,33953,542,ITC,ITC1,1,Piemonte,Piemonte,4356406,2444252,56.11,0.95
4654,2021-04-01,PIE,19442,8155,11287,10977,8140,325,ITC,ITC1,1,Piemonte,Piemonte,4356406,2463694,56.55,0.45
4655,2021-09-05,PIE,13012,6893,6119,4449,8092,471,ITC,ITC1,1,Piemonte,Piemonte,4356406,2476706,56.85,0.3
4656,2021-05-28,PIE,35119,16632,18487,18685,16021,413,ITC,ITC1,1,Piemonte,Piemonte,4356406,2511825,57.66,0.81
4657,2021-01-25,PIE,6230,1947,4283,975,5253,2,ITC,ITC1,1,Piemonte,Piemonte,4356406,2518055,57.8,0.14
4658,2021-01-22,PIE,3882,1256,2626,2536,1345,1,ITC,ITC1,1,Piemonte,Piemonte,4356406,2521937,57.89,0.09
4659,2021-08-21,PIE,13301,7110,6191,7698,5087,516,ITC,ITC1,1,Piemonte,Piemonte,4356406,2535238,58.2,0.31
4660,2021-07-02,PIE,43837,22054,21783,17382,25588,867,ITC,ITC1,1,Piemonte,Piemonte,4356406,2579075,59.2,1.01
4661,2021-08-28,PIE,17458,9195,8263,7283,9556,619,ITC,ITC1,1,Piemonte,Piemonte,4356406,2596533,59.6,0.4
4662,2021-01-13,PIE,10100,3235,6865,10091,0,9,ITC,ITC1,1,Piemonte,Piemonte,4356406,2606633,59.83,0.23
4663,2021-06-16,PIE,40469,20274,20195,23562,16272,635,ITC,ITC1,1,Piemonte,Piemonte,4356406,2647102,60.76,0.93
4664,2021-08-12,PIE,22042,11828,10214,13469,7822,751,ITC,ITC1,1,Piemonte,Piemonte,4356406,2669144,61.27,0.51
4665,2021-08-07,PIE,29767,15935,13832,12645,16646,476,ITC,ITC1,1,Piemonte,Piemonte,4356406,2698911,61.95,0.68
4666,2021-04-29,PIE,48579,22011,26568,34719,12648,1212,ITC,ITC1,1,Piemonte,Piemonte,4356406,2747490,63.07,1.12
4667,2021-05-16,PIE,28226,12808,15418,14761,13089,376,ITC,ITC1,1,Piemonte,Piemonte,4356406,2775716,63.72,0.65
4668,2021-02-05,PIE,9630,3145,6485,655,8973,2,ITC,ITC1,1,Piemonte,Piemonte,4356406,2785346,63.94,0.22
4669,2021-06-18,PIE,40713,20357,20356,25784,14239,690,ITC,ITC1,1,Piemonte,Piemonte,4356406,2826059,64.87,0.93
4670,2021-03-10,PIE,13955,5452,8503,11392,2295,268,ITC,ITC1,1,Piemonte,Piemonte,4356406,2840014,65.19,0.32
4671,2021-03-27,PIE,18426,7839,10587,9137,8835,454,ITC,ITC1,1,Piemonte,Piemonte,4356406,2858440,65.61,0.42
4672,2021-05-30,PIE,27826,13230,14596,18051,9397,378,ITC,ITC1,1,Piemonte,Piemonte,4356406,2886266,66.25,0.64
4673,2021-02-19,PIE,5556,2183,3373,4930,502,124,ITC,ITC1,1,Piemonte,Piemonte,4356406,2891822,66.38,0.13
4674,2021-06-04,PIE,37683,19705,17978,34094,2966,623,ITC,ITC1,1,Piemonte,Piemonte,4356406,2929505,67.25,0.87
4675,2021-02-24,PIE,11407,4615,6792,10750,505,152,ITC,ITC1,1,Piemonte,Piemonte,4356406,2940912,67.51,0.26
4676,2021-03-20,PIE,11933,4900,7033,5780,5901,252,ITC,ITC1,1,Piemonte,Piemonte,4356406,2952845,67.78,0.27
4677,2021-05-13,PIE,35770,17577,18193,19903,15145,722,ITC,ITC1,1,Piemonte,Piemonte,4356406,2988615,68.6,0.82
4678,2021-02-02,PIE,10283,3520,6763,812,9470,1,ITC,ITC1,1,Piemonte,Piemonte,4356406,2998898,68.84,0.24
4679,2021-07-09,PIE,40485,20658,19827,5764,34183,538,ITC,ITC1,1,Piemonte,Piemonte,4356406,3039383,69.77,0.93
4680,2021-03-31,PIE,19144,8128,11016,10104,8698,342,ITC,ITC1,1,Piemonte,Piemonte,4356406,3058527,70.21,0.44
4681,2021-09-04,PIE,18560,9704,8856,6340,11508,712,ITC,ITC1,1,Piemonte,Piemonte,4356406,3077087,70.63,0.43
4682,2021-05-27,PIE,37520,17444,20076,18866,18202,452,ITC,ITC1,1,Piemonte,Piemonte,4356406,3114607,71.49,0.86
4683,2021-02-16,PIE,3987,1766,2221,3173,765,49,ITC,ITC1,1,Piemonte,Piemonte,4356406,3118594,71.59,0.09
4684,2021-05-26,PIE,34226,15775,18451,15353,18511,362,ITC,ITC1,1,Piemonte,Piemonte,4356406,3152820,72.37,0.79
4685,2021-02-15,PIE,4442,1602,2840,3213,1206,23,ITC,ITC1,1,Piemonte,Piemonte,4356406,3157262,72.47,0.1
4686,2021-03-04,PIE,14751,5945,8806,11579,2948,224,ITC,ITC1,1,Piemonte,Piemonte,4356406,3172013,72.81,0.34
4687,2021-01-06,PIE,3119,1106,2013,3118,0,1,ITC,ITC1,1,Piemonte,Piemonte,4356406,3175132,72.88,0.07
4688,2021-08-05,PIE,30336,16093,14243,11229,18554,553,ITC,ITC1,1,Piemonte,Piemonte,4356406,3205468,73.58,0.7
4689,2021-06-23,PIE,39817,19779,20038,16418,22892,507,ITC,ITC1,1,Piemonte,Piemonte,4356406,3245285,74.49,0.91
4690,2021-08-19,PIE,15874,8543,7331,10550,4595,729,ITC,ITC1,1,Piemonte,Piemonte,4356406,3261159,74.86,0.36
4691,2021-01-19,PIE,6474,2108,4366,6456,9,9,ITC,ITC1,1,Piemonte,Piemonte,4356406,3267633,75.01,0.15
4692,2021-07-23,PIE,38152,20114,18038,8025,29495,632,ITC,ITC1,1,Piemonte,Piemonte,4356406,3305785,75.88,0.88
4693,2021-04-14,PIE,28349,12837,15512,23055,4573,721,ITC,ITC1,1,Piemonte,Piemonte,4356406,3334134,76.53,0.65
4694,2021-08-06,PIE,30473,16119,14354,13296,16506,671,ITC,ITC1,1,Piemonte,Piemonte,4356406,3364607,77.23,0.7
4695,2021-06-06,PIE,35168,18371,16797,32121,2491,556,ITC,ITC1,1,Piemonte,Piemonte,4356406,3399775,78.04,0.81
4696,2021-08-02,PIE,29976,15825,14151,9388,20061,527,ITC,ITC1,1,Piemonte,Piemonte,4356406,3429751,78.73,0.69
4697,2021-02-17,PIE,4813,2168,2645,3761,990,62,ITC,ITC1,1,Piemonte,Piemonte,4356406,3434564,78.84,0.11
4698,2021-06-08,PIE,37757,19530,18227,34184,2856,717,ITC,ITC1,1,Piemonte,Piemonte,4356406,3472321,79.71,0.87
4699,2021-08-04,PIE,29312,15496,13816,8959,19851,502,ITC,ITC1,1,Piemonte,Piemonte,4356406,3501633,80.38,0.67
4700,2021-04-26,PIE,19836,8765,11071,14920,4400,516,ITC,ITC1,1,Piemonte,Piemonte,4356406,3521469,80.83,0.46
4701,2021-08-11,PIE,23432,12606,10826,13437,9356,639,ITC,ITC1,1,Piemonte,Piemonte,4356406,3544901,81.37,0.54
4702,2021-05-03,PIE,26720,12221,14499,12047,14226,447,ITC,ITC1,1,Piemonte,Piemonte,4356406,3571621,81.99,0.61
4703,2021-02-26,PIE,12315,4941,7374,11362,742,211,ITC,ITC1,1,Piemonte,Piemonte,4356406,3583936,82.27,0.28
4704,2021-04-24,PIE,27553,12457,15096,21321,5664,568,ITC,ITC1,1,Piemonte,Piemonte,4356406,3611489,82.9,0.63
4705,2021-01-14,PIE,9795,3159,6636,9789,0,6,ITC,ITC1,1,Piemonte,Piemonte,4356406,3621284,83.13,0.22
4706,2021-01-03,PIE,3067,972,2095,3066,0,1,ITC,ITC1,1,Piemonte,Piemonte,4356406,3624351,83.2,0.07
4707,2021-07-07,PIE,38045,18906,19139,9700,27751,594,ITC,ITC1,1,Piemonte,Piemonte,4356406,3662396,84.07,0.87
4708,2021-03-29,PIE,15271,6485,8786,8392,6615,264,ITC,ITC1,1,Piemonte,Piemonte,4356406,3677667,84.42,0.35
4709,2021-07-21,PIE,38044,20181,17863,6549,30971,524,ITC,ITC1,1,Piemonte,Piemonte,4356406,3715711,85.29,0.87
4710,2021-04-12,PIE,22972,10372,12600,19452,2995,525,ITC,ITC1,1,Piemonte,Piemonte,4356406,3738683,85.82,0.53
4711,2021-01-02,PIE,3551,1133,2418,3550,0,1,ITC,ITC1,1,Piemonte,Piemonte,4356406,3742234,85.9,0.08
4712,2021-05-01,PIE,28595,13019,15576,16340,11803,452,ITC,ITC1,1,Piemonte,Piemonte,4356406,3770829,86.56,0.66
4713,2021-01-21,PIE,6884,2315,4569,3375,3503,6,ITC,ITC1,1,Piemonte,Piemonte,4356406,3777713,86.72,0.16
4714,2021-08-23,PIE,18339,9852,8487,8824,8926,589,ITC,ITC1,1,Piemonte,Piemonte,4356406,3796052,87.14,0.42
4715,2021-05-15,PIE,33832,15775,18057,19413,13743,676,ITC,ITC1,1,Piemonte,Piemonte,4356406,3829884,87.91,0.78
4716,2021-06-01,PIE,29612,14879,14733,24493,4684,435,ITC,ITC1,1,Piemonte,Piemonte,4356406,3859496,88.59,0.68
4717,2021-02-21,PIE,5103,2090,3013,4949,104,50,ITC,ITC1,1,Piemonte,Piemonte,4356406,3864599,88.71,0.12
4718,2021-03-24,PIE,15613,6413,9200,6109,9140,364,ITC,ITC1,1,Piemonte,Piemonte,4356406,3880212,89.07,0.36
4719,2021-05-20,PIE,38709,17984,20725,13368,24979,362,ITC,ITC1,1,Piemonte,Piemonte,4356406,3918921,89.96,0.89
4720,2021-02-09,PIE,7409,2319,5090,717,6690,2,ITC,ITC1,1,Piemonte,Piemonte,4356406,3926330,90.13,0.17
4721,2021-07-16,PIE,42142,22013,20129,3608,38115,419,ITC,ITC1,1,Piemonte,Piemonte,4356406,3968472,91.1,0.97
4722,2021-04-07,PIE,23695,10030,13665,17694,5462,539,ITC,ITC1,1,Piemonte,Piemonte,4356406,3992167,91.64,0.54
4723,2021-08-14,PIE,15100,8130,6970,9784,4757,559,ITC,ITC1,1,Piemonte,Piemonte,4356406,4007267,91.99,0.35
4724,2021-05-06,PIE,33468,15804,17664,19303,13558,607,ITC,ITC1,1,Piemonte,Piemonte,4356406,4040735,92.75,0.77
4725,2021-05-23,PIE,28816,13167,15649,15486,13013,317,ITC,ITC1,1,Piemonte,Piemonte,4356406,4069551,93.42,0.66
4726,2021-02-12,PIE,6915,2226,4689,3920,2970,25,ITC,ITC1,1,Piemonte,Piemonte,4356406,4076466,93.57,0.16
4727,2021-03-01,PIE,12184,4966,7218,11193,811,180,ITC,ITC1,1,Piemonte,Piemonte,4356406,4088650,93.85,0.28
4728,2021-09-02,PIE,16846,8778,8068,6140,10068,638,ITC,ITC1,1,Piemonte,Piemonte,4356406,4105496,94.24,0.39
4729,2021-05-25,PIE,31932,14797,17135,15640,15896,396,ITC,ITC1,1,Piemonte,Piemonte,4356406,4137428,94.97,0.73
4730,2021-06-11,PIE,43671,23109,20562,40005,2843,823,ITC,ITC1,1,Piemonte,Piemonte,4356406,4181099,95.98,1.0
4731,2021-08-18,PIE,18097,9771,8326,11593,5763,741,ITC,ITC1,1,Piemonte,Piemonte,4356406,4199196,96.39,0.42
4732,2021-04-19,PIE,22584,10782,11802,17660,4357,567,ITC,ITC1,1,Piemonte,Piemonte,4356406,4221780,96.91,0.52
4733,2021-01-09,PIE,6196,2192,4004,6194,0,2,ITC,ITC1,1,Piemonte,Piemonte,4356406,4227976,97.05,0.14
4734,2021-03-08,PIE,14309,5606,8703,11349,2717,243,ITC,ITC1,1,Piemonte,Piemonte,4356406,4242285,97.38,0.33
4735,2021-05-04,PIE,31615,14614,17001,17299,13721,595,ITC,ITC1,1,Piemonte,Piemonte,4356406,4273900,98.11,0.73
4736,2021-01-24,PIE,3161,964,2197,435,2724,2,ITC,ITC1,1,Piemonte,Piemonte,4356406,4277061,98.18,0.07
4737,2021-06-30,PIE,41337,20208,21129,18481,21975,881,ITC,ITC1,1,Piemonte,Piemonte,4356406,4318398,99.13,0.95
4738,2021-03-22,PIE,11544,4899,6645,3718,7609,217,ITC,ITC1,1,Piemonte,Piemonte,4356406,4329942,99.39,0.26
4739,2021-08-25,PIE,16416,8855,7561,8268,7427,721,ITC,ITC1,1,Piemonte,Piemonte,4356406,4346358,99.77,0.38
4740,2021-06-03,PIE,34809,18018,16791,29767,4493,549,ITC,ITC1,1,Piemonte,Piemonte,4356406,4381167,100.57,0.8
4741,2021-06-25,PIE,45602,22718,22884,20289,24585,728,ITC,ITC1,1,Piemonte,Piemonte,4356406,4426769,101.62,1.05
4742,2021-04-03,PIE,19497,8204,11293,10607,8576,314,ITC,ITC1,1,Piemonte,Piemonte,4356406,4446266,102.06,0.45
4743,2021-01-10,PIE,5239,2286,2953,5237,0,2,ITC,ITC1,1,Piemonte,Piemonte,4356406,4451505,102.18,0.12
4744,2021-07-14,PIE,39067,20090,18977,3600,35040,427,ITC,ITC1,1,Piemonte,Piemonte,4356406,4490572,103.08,0.9
4745,2021-04-22,PIE,27692,12754,14938,20203,6695,794,ITC,ITC1,1,Piemonte,Piemonte,4356406,4518264,103.72,0.64
4746,2021-01-12,PIE,10104,3420,6684,10098,0,6,ITC,ITC1,1,Piemonte,Piemonte,4356406,4528368,103.95,0.23
4747,2021-01-29,PIE,5956,1890,4066,452,5504,0,ITC,ITC1,1,Piemonte,Piemonte,4356406,4534324,104.08,0.14
4748,2021-04-27,PIE,22657,10236,12421,16839,5161,657,ITC,ITC1,1,Piemonte,Piemonte,4356406,4556981,104.6,0.52
4749,2021-01-17,PIE,3530,1169,2361,2878,650,2,ITC,ITC1,1,Piemonte,Piemonte,4356406,4560511,104.69,0.08
4750,2021-03-15,PIE,10704,4201,6503,4934,5614,156,ITC,ITC1,1,Piemonte,Piemonte,4356406,4571215,104.93,0.25
4751,2021-05-11,PIE,32324,15580,16744,18429,13255,640,ITC,ITC1,1,Piemonte,Piemonte,4356406,4603539,105.67,0.74
4752,2021-01-31,PIE,4149,1766,2383,115,4034,0,ITC,ITC1,1,Piemonte,Piemonte,4356406,4607688,105.77,0.1
4753,2021-07-18,PIE,32930,17271,15659,3249,29346,335,ITC,ITC1,1,Piemonte,Piemonte,4356406,4640618,106.52,0.76
4754,2021-02-07,PIE,3097,974,2123,444,2652,1,ITC,ITC1,1,Piemonte,Piemonte,4356406,4643715,106.6,0.07
4755,2021-01-26,PIE,6362,1896,4466,737,5624,1,ITC,ITC1,1,Piemonte,Piemonte,4356406,4650077,106.74,0.15
4756,2021-07-30,PIE,35823,18705,17118,9554,25769,500,ITC,ITC1,1,Piemonte,Piemonte,4356406,4685900,107.56,0.82
4757,2021-08-16,PIE,19238,10216,9022,11583,6810,845,ITC,ITC1,1,Piemonte,Piemonte,4356406,4705138,108.01,0.44
4758,2021-05-08,PIE,34355,16295,18060,18160,15665,530,ITC,ITC1,1,Piemonte,Piemonte,4356406,4739493,108.79,0.79
4759,2021-01-28,PIE,5612,1814,3798,380,5232,0,ITC,ITC1,1,Piemonte,Piemonte,4356406,4745105,108.92,0.13
4760,2021-02-14,PIE,1483,501,982,871,605,7,ITC,ITC1,1,Piemonte,Piemonte,4356406,4746588,108.96,0.03
4761,2021-06-20,PIE,34133,17111,17022,18786,14781,566,ITC,ITC1,1,Piemonte,Piemonte,4356406,4780721,109.74,0.78
4762,2021-03-12,PIE,14231,5410,8821,10992,2947,292,ITC,ITC1,1,Piemonte,Piemonte,4356406,4794952,110.07,0.33
4763,2021-07-04,PIE,33858,17064,16794,11244,21984,630,ITC,ITC1,1,Piemonte,Piemonte,4356406,4828810,110.84,0.78
4764,2021-03-26,PIE,17951,7137,10814,8531,8889,531,ITC,ITC1,1,Piemonte,Piemonte,4356406,4846761,111.26,0.41
4765,2021-02-28,PIE,10837,4066,6771,10416,241,180,ITC,ITC1,1,Piemonte,Piemonte,4356406,4857598,111.5,0.25
4766,2021-03-17,PIE,12532,5063,7469,5038,7305,189,ITC,ITC1,1,Piemonte,Piemonte,4356406,4870130,111.79,0.29
4767,2021-06-10,PIE,40598,21221,19377,37120,2593,885,ITC,ITC1,1,Piemonte,Piemonte,4356406,4910728,112.72,0.93
4768,2021-06-27,PIE,37589,18626,18963,15210,21772,607,ITC,ITC1,1,Piemonte,Piemonte,4356406,4948317,113.59,0.86
4769,2021-03-19,PIE,11042,4524,6518,4222,6611,209,ITC,ITC1,1,Piemonte,Piemonte,4356406,4959359,113.84,0.25
4770,2021-04-05,PIE,14772,6246,8526,11957,2562,253,ITC,ITC1,1,Piemonte,Piemonte,4356406,4974131,114.18,0.34
4771,2021-06-29,PIE,40661,20307,20354,19223,20729,709,ITC,ITC1,1,Piemonte,Piemonte,4356406,5014792,115.11,0.93
4772,2021-07-11,PIE,33221,16931,16290,4530,28370,321,ITC,ITC1,1,Piemonte,Piemonte,4356406,5048013,115.88,0.76
4773,2021-09-06,PIE,18190,9520,8670,6100,11408,682,ITC,ITC1,1,Piemonte,Piemonte,4356406,5066203,116.29,0.42
4774,2021-08-30,PIE,20844,10872,9972,7213,12966,665,ITC,ITC1,1,Piemonte,Piemonte,4356406,5087047,116.77,0.48
4775,2021-05-22,PIE,33582,15168,18414,16922,16247,413,ITC,ITC1,1,Piemonte,Piemonte,4356406,5120629,117.54,0.77
4776,2021-02-08,PIE,6929,2355,4574,662,6262,5,ITC,ITC1,1,Piemonte,Piemonte,4356406,5127558,117.7,0.16
4777,2021-08-29,PIE,15119,8110,7009,5029,9663,427,ITC,ITC1,1,Piemonte,Piemonte,4356406,5142677,118.05,0.35
4778,2021-05-21,PIE,36271,16849,19422,20084,15665,522,ITC,ITC1,1,Piemonte,Piemonte,4356406,5178948,118.88,0.83
4779,2021-07-17,PIE,42042,22128,19914,4954,36593,495,ITC,ITC1,1,Piemonte,Piemonte,4356406,5220990,119.85,0.97
4780,2021-02-01,PIE,8692,3068,5624,579,8112,1,ITC,ITC1,1,Piemonte,Piemonte,4356406,5229682,120.05,0.2
4781,2021-05-14,PIE,33488,16309,17179,17362,15451,675,ITC,ITC1,1,Piemonte,Piemonte,4356406,5263170,120.81,0.77
4782,2021-07-26,PIE,32823,17074,15749,8300,23890,633,ITC,ITC1,1,Piemonte,Piemonte,4356406,5295993,121.57,0.75
4783,2021-04-17,PIE,30515,14170,16345,26478,3313,724,ITC,ITC1,1,Piemonte,Piemonte,4356406,5326508,122.27,0.7
4784,2021-06-13,PIE,38139,20131,18008,33229,4135,775,ITC,ITC1,1,Piemonte,Piemonte,4356406,5364647,123.14,0.88
4785,2021-02-10,PIE,7558,2377,5181,1301,6242,15,ITC,ITC1,1,Piemonte,Piemonte,4356406,5372205,123.32,0.17
4786,2021-04-08,PIE,25355,11037,14318,20058,4729,568,ITC,ITC1,1,Piemonte,Piemonte,4356406,5397560,123.9,0.58
4787,2021-07-19,PIE,39645,20631,19014,4496,34731,418,ITC,ITC1,1,Piemonte,Piemonte,4356406,5437205,124.81,0.91
4788,2021-04-10,PIE,30203,13427,16776,25275,4268,660,ITC,ITC1,1,Piemonte,Piemonte,4356406,5467408,125.5,0.69
4789,2021-04-15,PIE,29647,13582,16065,23414,5540,693,ITC,ITC1,1,Piemonte,Piemonte,4356406,5497055,126.18,0.68
4790,2021-01-05,PIE,5403,1614,3789,5396,0,7,ITC,ITC1,1,Piemonte,Piemonte,4356406,5502458,126.31,0.12
4791,2021-06-22,PIE,40705,20130,20575,17806,22334,565,ITC,ITC1,1,Piemonte,Piemonte,4356406,5543163,127.24,0.93
4792,2021-01-07,PIE,5399,1738,3661,5397,0,2,ITC,ITC1,1,Piemonte,Piemonte,4356406,5548562,127.37,0.12
4793,2021-03-05,PIE,15664,6304,9360,11547,3837,280,ITC,ITC1,1,Piemonte,Piemonte,4356406,5564226,127.73,0.36
4794,2021-07-28,PIE,34825,18098,16727,9166,25054,605,ITC,ITC1,1,Piemonte,Piemonte,4356406,5599051,128.52,0.8
4795,2021-06-15,PIE,39026,20096,18930,26544,11788,694,ITC,ITC1,1,Piemonte,Piemonte,4356406,5638077,129.42,0.9
4796,2021-03-07,PIE,12001,4672,7329,10870,877,254,ITC,ITC1,1,Piemonte,Piemonte,4356406,5650078,129.7,0.28
4797,2020-12-31,PIE,3893,1327,2566,3893,0,0,ITC,ITC1,1,Piemonte,Piemonte,4356406,5653971,129.79,0.09
4798,2021-01-16,LOM,15647,5786,9861,15636,0,11,ITC,ITC4,3,Lombardia,Lombardia,10060574,15647,0.16,0.16
4799,2021-08-15,LOM,7000,3988,3012,2933,3884,183,ITC,ITC4,3,Lombardia,Lombardia,10060574,22647,0.23,0.07
4800,2021-02-16,LOM,9529,3081,6448,8977,451,101,ITC,ITC4,3,Lombardia,Lombardia,10060574,32176,0.32,0.09
4801,2021-06-10,LOM,102735,52273,50462,86429,14504,1802,ITC,ITC4,3,Lombardia,Lombardia,10060574,134911,1.34,1.02
4802,2021-03-02,LOM,22842,9711,13131,19530,3047,265,ITC,ITC4,3,Lombardia,Lombardia,10060574,157753,1.57,0.23
4803,2021-08-20,LOM,27132,15012,12120,14129,11908,1095,ITC,ITC4,3,Lombardia,Lombardia,10060574,184885,1.84,0.27
4804,2021-08-01,LOM,53144,28434,24710,27341,24264,1539,ITC,ITC4,3,Lombardia,Lombardia,10060574,238029,2.37,0.53
4805,2021-04-23,LOM,73645,33373,40272,55555,16655,1435,ITC,ITC4,3,Lombardia,Lombardia,10060574,311674,3.1,0.73
4806,2021-08-27,LOM,35741,19220,16521,18534,14620,2587,ITC,ITC4,3,Lombardia,Lombardia,10060574,347415,3.45,0.36
4807,2021-06-05,LOM,102450,52962,49488,91103,9834,1513,ITC,ITC4,3,Lombardia,Lombardia,10060574,449865,4.47,1.02
4808,2021-03-14,LOM,14883,5349,9534,11215,3290,378,ITC,ITC4,3,Lombardia,Lombardia,10060574,464748,4.62,0.15
4809,2021-08-06,LOM,85611,46653,38958,17798,66960,853,ITC,ITC4,3,Lombardia,Lombardia,10060574,550359,5.47,0.85
4810,2021-04-28,LOM,95806,43692,52114,66888,26947,1971,ITC,ITC4,3,Lombardia,Lombardia,10060574,646165,6.42,0.95
4811,2021-06-24,LOM,109765,56738,53027,78375,29011,2379,ITC,ITC4,3,Lombardia,Lombardia,10060574,755930,7.51,1.09
4812,2021-03-16,LOM,25540,10134,15406,16309,9109,122,ITC,ITC4,3,Lombardia,Lombardia,10060574,781470,7.77,0.25
4813,2021-05-12,LOM,87568,41776,45792,57284,27607,2677,ITC,ITC4,3,Lombardia,Lombardia,10060574,869038,8.64,0.87
4814,2021-03-28,LOM,20640,7882,12758,13968,6287,385,ITC,ITC4,3,Lombardia,Lombardia,10060574,889678,8.84,0.21
4815,2021-04-14,LOM,47238,21049,26189,33538,12987,713,ITC,ITC4,3,Lombardia,Lombardia,10060574,936916,9.31,0.47
4816,2021-01-04,LOM,6134,2119,4015,6127,0,7,ITC,ITC4,3,Lombardia,Lombardia,10060574,943050,9.37,0.06
4817,2021-06-19,LOM,104408,52034,52374,56231,46753,1424,ITC,ITC4,3,Lombardia,Lombardia,10060574,1047458,10.41,1.04
4818,2021-07-06,LOM,102180,50887,51293,23099,77665,1416,ITC,ITC4,3,Lombardia,Lombardia,10060574,1149638,11.43,1.02
4819,2021-09-01,LOM,60199,32350,27849,30531,25938,3730,ITC,ITC4,3,Lombardia,Lombardia,10060574,1209837,12.03,0.6
4820,2021-05-24,LOM,89625,43529,46096,48602,40086,937,ITC,ITC4,3,Lombardia,Lombardia,10060574,1299462,12.92,0.89
4821,2021-02-11,LOM,17136,5026,12110,9636,7421,79,ITC,ITC4,3,Lombardia,Lombardia,10060574,1316598,13.09,0.17
4822,2021-07-20,LOM,95028,49095,45933,6920,87369,739,ITC,ITC4,3,Lombardia,Lombardia,10060574,1411626,14.03,0.94
4823,2021-02-04,LOM,28018,8169,19849,2049,25964,5,ITC,ITC4,3,Lombardia,Lombardia,10060574,1439644,14.31,0.28
4824,2021-07-18,LOM,97108,50593,46515,8543,87871,694,ITC,ITC4,3,Lombardia,Lombardia,10060574,1536752,15.27,0.97
4825,2021-04-09,LOM,52456,22395,30061,35591,16022,843,ITC,ITC4,3,Lombardia,Lombardia,10060574,1589208,15.8,0.52
4826,2021-07-13,LOM,108717,56843,51874,15458,92026,1233,ITC,ITC4,3,Lombardia,Lombardia,10060574,1697925,16.88,1.08
4827,2021-04-04,LOM,7615,3232,4383,3682,3899,34,ITC,ITC4,3,Lombardia,Lombardia,10060574,1705540,16.95,0.08
4828,2021-01-09,LOM,12509,4612,7897,12501,0,8,ITC,ITC4,3,Lombardia,Lombardia,10060574,1718049,17.08,0.12
4829,2021-03-07,LOM,12098,5365,6733,9339,2563,196,ITC,ITC4,3,Lombardia,Lombardia,10060574,1730147,17.2,0.12
4830,2021-01-27,LOM,8073,2688,5385,807,7264,2,ITC,ITC4,3,Lombardia,Lombardia,10060574,1738220,17.28,0.08
4831,2021-07-03,LOM,102515,51721,50794,44540,55865,2110,ITC,ITC4,3,Lombardia,Lombardia,10060574,1840735,18.3,1.02
4832,2021-03-25,LOM,43049,16097,26952,29253,12880,916,ITC,ITC4,3,Lombardia,Lombardia,10060574,1883784,18.72,0.43
4833,2021-08-29,LOM,25186,13530,11656,12726,11159,1301,ITC,ITC4,3,Lombardia,Lombardia,10060574,1908970,18.97,0.25
4834,2021-05-21,LOM,93935,45280,48655,28391,64782,762,ITC,ITC4,3,Lombardia,Lombardia,10060574,2002905,19.91,0.93
4835,2020-12-28,LOM,108,47,61,108,0,0,ITC,ITC4,3,Lombardia,Lombardia,10060574,2003013,19.91,0.0
4836,2021-04-21,LOM,71885,32581,39304,55813,14699,1373,ITC,ITC4,3,Lombardia,Lombardia,10060574,2074898,20.62,0.71
4837,2021-01-11,LOM,16315,5394,10921,16305,0,10,ITC,ITC4,3,Lombardia,Lombardia,10060574,2091213,20.79,0.16
4838,2021-01-28,LOM,12277,3722,8555,795,11475,7,ITC,ITC4,3,Lombardia,Lombardia,10060574,2103490,20.91,0.12
4839,2021-09-03,LOM,52893,28421,24472,22715,27528,2650,ITC,ITC4,3,Lombardia,Lombardia,10060574,2156383,21.43,0.53
4840,2021-05-10,LOM,85320,40908,44412,61502,21601,2217,ITC,ITC4,3,Lombardia,Lombardia,10060574,2241703,22.28,0.85
4841,2021-01-30,LOM,12357,4585,7772,146,12202,9,ITC,ITC4,3,Lombardia,Lombardia,10060574,2254060,22.4,0.12
4842,2021-06-12,LOM,89332,48067,41265,84313,3175,1844,ITC,ITC4,3,Lombardia,Lombardia,10060574,2343392,23.29,0.89
4843,2021-02-23,LOM,11835,4807,7028,11292,332,211,ITC,ITC4,3,Lombardia,Lombardia,10060574,2355227,23.41,0.12
4844,2021-08-08,LOM,58838,31955,26883,16679,41364,795,ITC,ITC4,3,Lombardia,Lombardia,10060574,2414065,24.0,0.58
4845,2021-08-25,LOM,44516,24044,20472,21655,19752,3109,ITC,ITC4,3,Lombardia,Lombardia,10060574,2458581,24.44,0.44
4846,2021-05-17,LOM,94695,45374,49321,29504,64442,749,ITC,ITC4,3,Lombardia,Lombardia,10060574,2553276,25.38,0.94
4847,2021-07-08,LOM,114709,58455,56254,13231,100453,1025,ITC,ITC4,3,Lombardia,Lombardia,10060574,2667985,26.52,1.14
4848,2021-07-25,LOM,86639,45737,40902,9423,76435,781,ITC,ITC4,3,Lombardia,Lombardia,10060574,2754624,27.38,0.86
4849,2021-04-16,LOM,53732,23940,29792,38416,14396,920,ITC,ITC4,3,Lombardia,Lombardia,10060574,2808356,27.91,0.53
4850,2021-05-03,LOM,83747,39780,43967,69440,12142,2165,ITC,ITC4,3,Lombardia,Lombardia,10060574,2892103,28.75,0.83
4851,2021-01-23,LOM,1127,361,766,925,199,3,ITC,ITC4,3,Lombardia,Lombardia,10060574,2893230,28.76,0.01
4852,2021-09-08,LOM,58031,31683,26348,13455,42841,1735,ITC,ITC4,3,Lombardia,Lombardia,10060574,2951261,29.33,0.58
4853,2021-05-31,LOM,95746,47433,48313,78389,16254,1103,ITC,ITC4,3,Lombardia,Lombardia,10060574,3047007,30.29,0.95
4854,2021-07-27,LOM,104942,56846,48096,7482,96757,703,ITC,ITC4,3,Lombardia,Lombardia,10060574,3151949,31.33,1.04
4855,2021-03-26,LOM,41379,15730,25649,27503,13193,683,ITC,ITC4,3,Lombardia,Lombardia,10060574,3193328,31.74,0.41
4856,2021-05-22,LOM,70685,33871,36814,31728,38241,716,ITC,ITC4,3,Lombardia,Lombardia,10060574,3264013,32.44,0.7
4857,2021-05-29,LOM,88397,42445,45952,41399,46154,844,ITC,ITC4,3,Lombardia,Lombardia,10060574,3352410,33.32,0.88
4858,2021-02-18,LOM,14064,4931,9133,12827,1038,199,ITC,ITC4,3,Lombardia,Lombardia,10060574,3366474,33.46,0.14
4859,2021-04-02,LOM,41418,16953,24465,26214,14649,555,ITC,ITC4,3,Lombardia,Lombardia,10060574,3407892,33.87,0.41
4860,2021-08-12,LOM,56891,31251,25640,21994,33520,1377,ITC,ITC4,3,Lombardia,Lombardia,10060574,3464783,34.44,0.57
4861,2021-06-17,LOM,108665,52752,55913,50333,57152,1180,ITC,ITC4,3,Lombardia,Lombardia,10060574,3573448,35.52,1.08
4862,2021-03-09,LOM,33267,12882,20385,25250,7422,595,ITC,ITC4,3,Lombardia,Lombardia,10060574,3606715,35.85,0.33
4863,2021-08-13,LOM,53450,29606,23844,20523,31660,1267,ITC,ITC4,3,Lombardia,Lombardia,10060574,3660165,36.38,0.53
4864,2021-05-05,LOM,88118,42010,46108,70414,15362,2342,ITC,ITC4,3,Lombardia,Lombardia,10060574,3748283,37.26,0.88
4865,2021-07-01,LOM,105140,52892,52248,53341,49396,2403,ITC,ITC4,3,Lombardia,Lombardia,10060574,3853423,38.3,1.05
4866,2021-05-07,LOM,92461,43757,48704,67956,22466,2039,ITC,ITC4,3,Lombardia,Lombardia,10060574,3945884,39.22,0.92
4867,2021-03-18,LOM,27465,10982,16483,15939,11299,227,ITC,ITC4,3,Lombardia,Lombardia,10060574,3973349,39.49,0.27
4868,2021-08-03,LOM,85830,46539,39291,13484,71620,726,ITC,ITC4,3,Lombardia,Lombardia,10060574,4059179,40.35,0.85
4869,2021-04-25,LOM,51621,23667,27954,45521,4840,1260,ITC,ITC4,3,Lombardia,Lombardia,10060574,4110800,40.86,0.51
4870,2021-06-28,LOM,108101,55070,53031,74297,31193,2611,ITC,ITC4,3,Lombardia,Lombardia,10060574,4218901,41.93,1.07
4871,2021-07-15,LOM,109394,56281,53113,13385,94819,1190,ITC,ITC4,3,Lombardia,Lombardia,10060574,4328295,43.02,1.09
4872,2021-04-06,LOM,43102,17598,25504,24450,17957,695,ITC,ITC4,3,Lombardia,Lombardia,10060574,4371397,43.45,0.43
4873,2021-06-14,LOM,94879,48204,46675,49127,44634,1118,ITC,ITC4,3,Lombardia,Lombardia,10060574,4466276,44.39,0.94
4874,2021-08-17,LOM,33270,18414,14856,17409,14675,1186,ITC,ITC4,3,Lombardia,Lombardia,10060574,4499546,44.72,0.33
4875,2021-05-26,LOM,93786,44685,49101,42747,50149,890,ITC,ITC4,3,Lombardia,Lombardia,10060574,4593332,45.66,0.93
4876,2021-02-15,LOM,9062,3171,5891,8398,485,179,ITC,ITC4,3,Lombardia,Lombardia,10060574,4602394,45.75,0.09
4877,2021-06-29,LOM,107318,53218,54100,57425,47882,2011,ITC,ITC4,3,Lombardia,Lombardia,10060574,4709712,46.81,1.07
4878,2021-03-21,LOM,23522,8499,15023,17722,5197,603,ITC,ITC4,3,Lombardia,Lombardia,10060574,4733234,47.05,0.23
4879,2021-02-13,LOM,6427,2445,3982,4887,1479,61,ITC,ITC4,3,Lombardia,Lombardia,10060574,4739661,47.11,0.06
4880,2021-07-17,LOM,108507,57296,51211,10220,97360,927,ITC,ITC4,3,Lombardia,Lombardia,10060574,4848168,48.19,1.08
4881,2021-01-13,LOM,26489,8102,18387,26464,0,25,ITC,ITC4,3,Lombardia,Lombardia,10060574,4874657,48.45,0.26
4882,2021-09-05,LOM,33253,18028,15225,12429,19467,1357,ITC,ITC4,3,Lombardia,Lombardia,10060574,4907910,48.78,0.33
4883,2021-03-04,LOM,29375,12135,17240,20063,9087,225,ITC,ITC4,3,Lombardia,Lombardia,10060574,4937285,49.08,0.29
4884,2021-05-19,LOM,83304,39786,43518,33119,49374,811,ITC,ITC4,3,Lombardia,Lombardia,10060574,5020589,49.9,0.83
4885,2021-02-08,LOM,10134,2935,7199,2125,8001,8,ITC,ITC4,3,Lombardia,Lombardia,10060574,5030723,50.0,0.1
4886,2021-02-25,LOM,15359,6371,8988,13536,1623,200,ITC,ITC4,3,Lombardia,Lombardia,10060574,5046082,50.16,0.15
4887,2021-02-06,LOM,15310,5556,9754,1014,14291,5,ITC,ITC4,3,Lombardia,Lombardia,10060574,5061392,50.31,0.15
4888,2021-08-22,LOM,18209,10164,8045,7601,10066,542,ITC,ITC4,3,Lombardia,Lombardia,10060574,5079601,50.49,0.18
4889,2021-05-14,LOM,86050,41439,44611,53159,30370,2521,ITC,ITC4,3,Lombardia,Lombardia,10060574,5165651,51.35,0.86
4890,2021-07-10,LOM,107272,54303,52969,13914,92176,1182,ITC,ITC4,3,Lombardia,Lombardia,10060574,5272923,52.41,1.07
4891,2021-06-26,LOM,105931,55458,50473,77785,25741,2405,ITC,ITC4,3,Lombardia,Lombardia,10060574,5378854,53.46,1.05
4892,2021-04-11,LOM,32231,13947,18284,24321,7397,513,ITC,ITC4,3,Lombardia,Lombardia,10060574,5411085,53.79,0.32
4893,2021-01-01,LOM,24,7,17,24,0,0,ITC,ITC4,3,Lombardia,Lombardia,10060574,5411109,53.79,0.0
4894,2021-06-07,LOM,99039,50445,48594,84031,13382,1626,ITC,ITC4,3,Lombardia,Lombardia,10060574,5510148,54.77,0.98
4895,2021-02-27,LOM,13955,5876,8079,13153,645,157,ITC,ITC4,3,Lombardia,Lombardia,10060574,5524103,54.91,0.14
4896,2020-12-30,LOM,115,42,73,115,0,0,ITC,ITC4,3,Lombardia,Lombardia,10060574,5524218,54.91,0.0
4897,2021-06-16,LOM,99373,50477,48896,49855,48365,1153,ITC,ITC4,3,Lombardia,Lombardia,10060574,5623591,55.9,0.99
4898,2021-06-21,LOM,113385,58086,55299,78230,32983,2172,ITC,ITC4,3,Lombardia,Lombardia,10060574,5736976,57.02,1.13
4899,2021-06-02,LOM,84710,43617,41093,76987,6402,1321,ITC,ITC4,3,Lombardia,Lombardia,10060574,5821686,57.87,0.84
4900,2021-03-11,LOM,36281,13505,22776,25638,9956,687,ITC,ITC4,3,Lombardia,Lombardia,10060574,5857967,58.23,0.36
4901,2021-03-30,LOM,39744,15637,24107,24259,14869,616,ITC,ITC4,3,Lombardia,Lombardia,10060574,5897711,58.62,0.4
4902,2021-01-06,LOM,7168,2532,4636,7162,0,6,ITC,ITC4,3,Lombardia,Lombardia,10060574,5904879,58.69,0.07
4903,2021-03-20,LOM,32612,12172,20440,22247,9860,505,ITC,ITC4,3,Lombardia,Lombardia,10060574,5937491,59.02,0.32
4904,2020-12-27,LOM,718,414,304,718,0,0,ITC,ITC4,3,Lombardia,Lombardia,10060574,5938209,59.02,0.01
4905,2021-08-02,LOM,83638,45305,38333,18335,64392,911,ITC,ITC4,3,Lombardia,Lombardia,10060574,6021847,59.86,0.83
4906,2021-03-06,LOM,21364,9109,12255,16542,4519,303,ITC,ITC4,3,Lombardia,Lombardia,10060574,6043211,60.07,0.21
4907,2021-06-09,LOM,103743,52255,51488,87432,14583,1728,ITC,ITC4,3,Lombardia,Lombardia,10060574,6146954,61.1,1.03
4908,2021-03-08,LOM,29828,11212,18616,22167,7129,532,ITC,ITC4,3,Lombardia,Lombardia,10060574,6176782,61.4,0.3
4909,2021-05-04,LOM,86889,41101,45788,70260,14425,2204,ITC,ITC4,3,Lombardia,Lombardia,10060574,6263671,62.26,0.86
4910,2021-01-24,LOM,1202,458,744,538,664,0,ITC,ITC4,3,Lombardia,Lombardia,10060574,6264873,62.27,0.01
4911,2021-02-10,LOM,14461,4527,9934,7568,6864,29,ITC,ITC4,3,Lombardia,Lombardia,10060574,6279334,62.42,0.14
4912,2021-02-03,LOM,25733,7956,17777,1078,24650,5,ITC,ITC4,3,Lombardia,Lombardia,10060574,6305067,62.67,0.26
4913,2021-04-01,LOM,43197,17323,25874,26085,16397,715,ITC,ITC4,3,Lombardia,Lombardia,10060574,6348264,63.1,0.43
4914,2021-01-18,LOM,9267,2991,6276,8277,975,15,ITC,ITC4,3,Lombardia,Lombardia,10060574,6357531,63.19,0.09
4915,2021-03-23,LOM,42638,15493,27145,28863,12907,868,ITC,ITC4,3,Lombardia,Lombardia,10060574,6400169,63.62,0.42
4916,2021-08-24,LOM,47538,25867,21671,24444,19455,3639,ITC,ITC4,3,Lombardia,Lombardia,10060574,6447707,64.09,0.47
4917,2021-06-30,LOM,107005,53007,53998,56590,48293,2122,ITC,ITC4,3,Lombardia,Lombardia,10060574,6554712,65.15,1.06
4918,2021-03-22,LOM,40367,14315,26052,28947,10578,842,ITC,ITC4,3,Lombardia,Lombardia,10060574,6595079,65.55,0.4
4919,2021-04-08,LOM,52473,21799,30674,35302,16497,674,ITC,ITC4,3,Lombardia,Lombardia,10060574,6647552,66.08,0.52
4920,2020-12-29,LOM,106,45,61,106,0,0,ITC,ITC4,3,Lombardia,Lombardia,10060574,6647658,66.08,0.0
4921,2021-07-14,LOM,109450,56860,52590,14355,93687,1408,ITC,ITC4,3,Lombardia,Lombardia,10060574,6757108,67.16,1.09
4922,2021-07-31,LOM,71111,38779,32332,36368,32722,2021,ITC,ITC4,3,Lombardia,Lombardia,10060574,6828219,67.87,0.71
4923,2021-04-22,LOM,74071,33442,40629,56215,16443,1413,ITC,ITC4,3,Lombardia,Lombardia,10060574,6902290,68.61,0.74
4924,2021-03-03,LOM,27029,11533,15496,19492,7318,219,ITC,ITC4,3,Lombardia,Lombardia,10060574,6929319,68.88,0.27
4925,2021-08-19,LOM,28972,15937,13035,14773,13075,1124,ITC,ITC4,3,Lombardia,Lombardia,10060574,6958291,69.16,0.29
4926,2021-05-11,LOM,86947,41460,45487,58211,26248,2488,ITC,ITC4,3,Lombardia,Lombardia,10060574,7045238,70.03,0.86
4927,2021-09-02,LOM,56466,30556,25910,25774,27695,2997,ITC,ITC4,3,Lombardia,Lombardia,10060574,7101704,70.59,0.56
4928,2021-05-28,LOM,93706,44882,48824,42038,50755,913,ITC,ITC4,3,Lombardia,Lombardia,10060574,7195410,71.52,0.93
4929,2021-02-17,LOM,12037,3779,8258,10447,1392,198,ITC,ITC4,3,Lombardia,Lombardia,10060574,7207447,71.64,0.12
4930,2021-06-11,LOM,101536,51719,49817,84941,14700,1895,ITC,ITC4,3,Lombardia,Lombardia,10060574,7308983,72.65,1.01
4931,2021-08-21,LOM,21328,11876,9452,9485,11071,772,ITC,ITC4,3,Lombardia,Lombardia,10060574,7330311,72.86,0.21
4932,2021-08-26,LOM,38675,20774,17901,20337,15545,2793,ITC,ITC4,3,Lombardia,Lombardia,10060574,7368986,73.25,0.38
4933,2021-05-18,LOM,88251,42174,46077,31857,55591,803,ITC,ITC4,3,Lombardia,Lombardia,10060574,7457237,74.12,0.88
4934,2021-06-04,LOM,104652,54322,50330,93202,9663,1787,ITC,ITC4,3,Lombardia,Lombardia,10060574,7561889,75.16,1.04
4935,2021-02-24,LOM,14728,5961,8767,13576,958,194,ITC,ITC4,3,Lombardia,Lombardia,10060574,7576617,75.31,0.15
4936,2021-05-16,LOM,68740,32518,36222,35548,32234,958,ITC,ITC4,3,Lombardia,Lombardia,10060574,7645357,75.99,0.68
4937,2021-02-05,LOM,25790,7494,18296,2428,23349,13,ITC,ITC4,3,Lombardia,Lombardia,10060574,7671147,76.25,0.26
4938,2021-02-22,LOM,11951,4823,7128,11441,310,200,ITC,ITC4,3,Lombardia,Lombardia,10060574,7683098,76.37,0.12
4939,2021-06-01,LOM,94041,46130,47911,75800,17130,1111,ITC,ITC4,3,Lombardia,Lombardia,10060574,7777139,77.3,0.93
4940,2021-01-02,LOM,202,74,128,202,0,0,ITC,ITC4,3,Lombardia,Lombardia,10060574,7777341,77.31,0.0
4941,2021-06-08,LOM,102957,52319,50638,87173,14104,1680,ITC,ITC4,3,Lombardia,Lombardia,10060574,7880298,78.33,1.02
4942,2021-02-28,LOM,7886,3256,4630,7604,210,72,ITC,ITC4,3,Lombardia,Lombardia,10060574,7888184,78.41,0.08
4943,2021-08-04,LOM,90171,48832,41339,14481,75028,662,ITC,ITC4,3,Lombardia,Lombardia,10060574,7978355,79.3,0.9
4944,2021-04-26,LOM,88026,40948,47078,67031,19171,1824,ITC,ITC4,3,Lombardia,Lombardia,10060574,8066381,80.18,0.87
4945,2021-07-24,LOM,95879,50656,45223,9741,85281,857,ITC,ITC4,3,Lombardia,Lombardia,10060574,8162260,81.13,0.95
4946,2021-08-10,LOM,61487,33274,28213,18721,41696,1070,ITC,ITC4,3,Lombardia,Lombardia,10060574,8223747,81.74,0.61
4947,2021-05-02,LOM,83548,38351,45197,59227,22481,1840,ITC,ITC4,3,Lombardia,Lombardia,10060574,8307295,82.57,0.83
4948,2021-07-22,LOM,99403,52037,47366,12509,85443,1451,ITC,ITC4,3,Lombardia,Lombardia,10060574,8406698,83.56,0.99
4949,2021-04-13,LOM,47695,21289,26406,32927,14110,658,ITC,ITC4,3,Lombardia,Lombardia,10060574,8454393,84.03,0.47
4950,2021-04-30,LOM,117547,54900,62647,87201,27683,2663,ITC,ITC4,3,Lombardia,Lombardia,10060574,8571940,85.2,1.17
4951,2021-01-25,LOM,7125,2398,4727,514,6608,3,ITC,ITC4,3,Lombardia,Lombardia,10060574,8579065,85.27,0.07
4952,2021-02-01,LOM,16129,5340,10789,307,15820,2,ITC,ITC4,3,Lombardia,Lombardia,10060574,8595194,85.43,0.16
4953,2021-07-05,LOM,101933,49789,52144,31503,68539,1891,ITC,ITC4,3,Lombardia,Lombardia,10060574,8697127,86.45,1.01
4954,2021-08-31,LOM,62817,33489,29328,36690,21574,4553,ITC,ITC4,3,Lombardia,Lombardia,10060574,8759944,87.07,0.62
4955,2021-04-05,LOM,27391,11698,15693,19027,8109,255,ITC,ITC4,3,Lombardia,Lombardia,10060574,8787335,87.34,0.27
4956,2021-08-18,LOM,30908,17056,13852,17897,11641,1370,ITC,ITC4,3,Lombardia,Lombardia,10060574,8818243,87.65,0.31
4957,2021-06-18,LOM,107729,52914,54815,51835,54653,1241,ITC,ITC4,3,Lombardia,Lombardia,10060574,8925972,88.72,1.07
4958,2021-08-14,LOM,26545,14887,11658,11132,14861,552,ITC,ITC4,3,Lombardia,Lombardia,10060574,8952517,88.99,0.26
4959,2021-03-01,LOM,18801,8236,10565,16888,1708,205,ITC,ITC4,3,Lombardia,Lombardia,10060574,8971318,89.17,0.19
4960,2021-08-23,LOM,57478,31495,25983,23769,30422,3287,ITC,ITC4,3,Lombardia,Lombardia,10060574,9028796,89.74,0.57
4961,2021-05-15,LOM,80991,38808,42183,45385,33445,2161,ITC,ITC4,3,Lombardia,Lombardia,10060574,9109787,90.55,0.81
4962,2021-07-11,LOM,90337,45701,44636,11765,77514,1058,ITC,ITC4,3,Lombardia,Lombardia,10060574,9200124,91.45,0.9
4963,2021-05-13,LOM,87236,41797,45439,55593,28903,2740,ITC,ITC4,3,Lombardia,Lombardia,10060574,9287360,92.31,0.87
4964,2021-02-02,LOM,20007,6648,13359,497,19507,3,ITC,ITC4,3,Lombardia,Lombardia,10060574,9307367,92.51,0.2
4965,2021-03-31,LOM,42273,17148,25125,26200,15388,685,ITC,ITC4,3,Lombardia,Lombardia,10060574,9349640,92.93,0.42
4966,2021-03-10,LOM,33366,12761,20605,24853,7909,604,ITC,ITC4,3,Lombardia,Lombardia,10060574,9383006,93.27,0.33
4967,2021-05-06,LOM,89963,42235,47728,70959,16582,2422,ITC,ITC4,3,Lombardia,Lombardia,10060574,9472969,94.16,0.89
4968,2021-01-26,LOM,8394,2718,5676,348,8045,1,ITC,ITC4,3,Lombardia,Lombardia,10060574,9481363,94.24,0.08
4969,2021-05-09,LOM,69730,32893,36837,54425,13283,2022,ITC,ITC4,3,Lombardia,Lombardia,10060574,9551093,94.94,0.69
4970,2021-01-29,LOM,13550,4149,9401,686,12861,3,ITC,ITC4,3,Lombardia,Lombardia,10060574,9564643,95.07,0.13
4971,2021-06-13,LOM,76003,40566,35437,72283,2131,1589,ITC,ITC4,3,Lombardia,Lombardia,10060574,9640646,95.83,0.76
4972,2021-03-05,LOM,29006,11972,17034,20254,8445,307,ITC,ITC4,3,Lombardia,Lombardia,10060574,9669652,96.11,0.29
4973,2021-06-27,LOM,90954,46823,44131,69781,18871,2302,ITC,ITC4,3,Lombardia,Lombardia,10060574,9760606,97.02,0.9
4974,2021-03-19,LOM,32512,12952,19560,18920,13268,324,ITC,ITC4,3,Lombardia,Lombardia,10060574,9793118,97.34,0.32
4975,2021-09-04,LOM,45679,24751,20928,20577,22563,2539,ITC,ITC4,3,Lombardia,Lombardia,10060574,9838797,97.8,0.45
4976,2021-05-27,LOM,95021,45507,49514,40621,53609,791,ITC,ITC4,3,Lombardia,Lombardia,10060574,9933818,98.74,0.94
4977,2021-04-24,LOM,75862,33619,42243,53407,21163,1292,ITC,ITC4,3,Lombardia,Lombardia,10060574,10009680,99.49,0.75
4978,2021-07-21,LOM,94011,48497,45514,8618,84529,864,ITC,ITC4,3,Lombardia,Lombardia,10060574,10103691,100.43,0.93
4979,2021-04-12,LOM,47354,20625,26729,32291,14412,651,ITC,ITC4,3,Lombardia,Lombardia,10060574,10151045,100.9,0.47
4980,2021-02-21,LOM,5055,1864,3191,4940,17,98,ITC,ITC4,3,Lombardia,Lombardia,10060574,10156100,100.95,0.05
4981,2021-07-28,LOM,77459,41731,35728,19122,56587,1750,ITC,ITC4,3,Lombardia,Lombardia,10060574,10233559,101.72,0.77
4982,2021-04-19,LOM,60408,27489,32919,49683,9420,1305,ITC,ITC4,3,Lombardia,Lombardia,10060574,10293967,102.32,0.6
4983,2021-06-15,LOM,96076,48894,47182,49024,45997,1055,ITC,ITC4,3,Lombardia,Lombardia,10060574,10390043,103.27,0.95
4984,2021-03-13,LOM,27234,9794,17440,20556,6122,556,ITC,ITC4,3,Lombardia,Lombardia,10060574,10417277,103.55,0.27
4985,2021-07-23,LOM,95528,50070,45458,11433,82839,1256,ITC,ITC4,3,Lombardia,Lombardia,10060574,10512805,104.5,0.95
4986,2021-08-09,LOM,68985,37025,31960,18637,49295,1053,ITC,ITC4,3,Lombardia,Lombardia,10060574,10581790,105.18,0.69
4987,2021-05-01,LOM,96099,43731,52368,65017,29323,1759,ITC,ITC4,3,Lombardia,Lombardia,10060574,10677889,106.14,0.96
4988,2021-01-21,LOM,5533,1612,3921,4821,695,17,ITC,ITC4,3,Lombardia,Lombardia,10060574,10683422,106.19,0.05
4989,2021-02-07,LOM,7322,2831,4491,335,6984,3,ITC,ITC4,3,Lombardia,Lombardia,10060574,10690744,106.26,0.07
4990,2021-01-19,LOM,8063,2332,5731,7579,470,14,ITC,ITC4,3,Lombardia,Lombardia,10060574,10698807,106.34,0.08
4991,2021-07-12,LOM,111883,57511,54372,14803,95941,1139,ITC,ITC4,3,Lombardia,Lombardia,10060574,10810690,107.46,1.11
4992,2021-01-31,LOM,9826,3814,6012,29,9797,0,ITC,ITC4,3,Lombardia,Lombardia,10060574,10820516,107.55,0.1
4993,2021-05-25,LOM,91222,43645,47577,43859,46539,824,ITC,ITC4,3,Lombardia,Lombardia,10060574,10911738,108.46,0.91
4994,2021-02-14,LOM,3586,1547,2039,2934,637,15,ITC,ITC4,3,Lombardia,Lombardia,10060574,10915324,108.5,0.04
4995,2021-01-12,LOM,20341,6747,13594,20309,0,32,ITC,ITC4,3,Lombardia,Lombardia,10060574,10935665,108.7,0.2
4996,2021-01-20,LOM,5715,1392,4323,5595,115,5,ITC,ITC4,3,Lombardia,Lombardia,10060574,10941380,108.76,0.06
4997,2021-01-22,LOM,3199,885,2314,3125,69,5,ITC,ITC4,3,Lombardia,Lombardia,10060574,10944579,108.79,0.03
4998,2021-07-07,LOM,112059,56171,55888,18000,92899,1160,ITC,ITC4,3,Lombardia,Lombardia,10060574,11056638,109.9,1.11
4999,2021-04-15,LOM,49490,21873,27617,34891,13840,759,ITC,ITC4,3,Lombardia,Lombardia,10060574,11106128,110.39,0.49
5000,2021-01-05,LOM,7876,2583,5293,7870,0,6,ITC,ITC4,3,Lombardia,Lombardia,10060574,11114004,110.47,0.08
5001,2021-03-27,LOM,32528,12412,20116,23115,8773,640,ITC,ITC4,3,Lombardia,Lombardia,10060574,11146532,110.79,0.32
5002,2021-01-03,LOM,857,316,541,856,0,1,ITC,ITC4,3,Lombardia,Lombardia,10060574,11147389,110.8,0.01
5003,2021-04-03,LOM,36333,14901,21432,25790,10159,384,ITC,ITC4,3,Lombardia,Lombardia,10060574,11183722,111.16,0.36
5004,2021-09-07,LOM,60914,33261,27653,15560,43297,2057,ITC,ITC4,3,Lombardia,Lombardia,10060574,11244636,111.77,0.61
5005,2021-05-30,LOM,74422,35612,38810,33793,40010,619,ITC,ITC4,3,Lombardia,Lombardia,10060574,11319058,112.51,0.74
5006,2021-07-26,LOM,109612,58918,50694,7715,101142,755,ITC,ITC4,3,Lombardia,Lombardia,10060574,11428670,113.6,1.09
5007,2021-05-23,LOM,60822,28966,31856,26297,34012,513,ITC,ITC4,3,Lombardia,Lombardia,10060574,11489492,114.2,0.6
5008,2021-02-12,LOM,14026,4389,9637,8886,4981,159,ITC,ITC4,3,Lombardia,Lombardia,10060574,11503518,114.34,0.14
5009,2021-07-19,LOM,96928,50320,46608,10807,85041,1080,ITC,ITC4,3,Lombardia,Lombardia,10060574,11600446,115.31,0.96
5010,2021-04-10,LOM,52822,21877,30945,40096,11976,750,ITC,ITC4,3,Lombardia,Lombardia,10060574,11653268,115.83,0.53
5011,2021-06-06,LOM,90137,46352,43785,79536,9222,1379,ITC,ITC4,3,Lombardia,Lombardia,10060574,11743405,116.73,0.9
5012,2021-01-07,LOM,11811,3657,8154,11770,0,41,ITC,ITC4,3,Lombardia,Lombardia,10060574,11755216,116.84,0.12
5013,2021-02-19,LOM,14230,5402,8828,13329,725,176,ITC,ITC4,3,Lombardia,Lombardia,10060574,11769446,116.99,0.14
5014,2021-08-11,LOM,61399,33597,27802,22472,37579,1348,ITC,ITC4,3,Lombardia,Lombardia,10060574,11830845,117.6,0.61
5015,2021-08-28,LOM,35008,19241,15767,17764,15040,2204,ITC,ITC4,3,Lombardia,Lombardia,10060574,11865853,117.94,0.35
5016,2021-05-20,LOM,95615,46244,49371,31716,63082,817,ITC,ITC4,3,Lombardia,Lombardia,10060574,11961468,118.89,0.95
5017,2021-01-14,LOM,26980,7823,19157,26928,0,52,ITC,ITC4,3,Lombardia,Lombardia,10060574,11988448,119.16,0.27
5018,2021-08-16,LOM,38945,21056,17889,16840,21061,1044,ITC,ITC4,3,Lombardia,Lombardia,10060574,12027393,119.55,0.39
5019,2021-05-08,LOM,87841,40791,47050,63433,22117,2291,ITC,ITC4,3,Lombardia,Lombardia,10060574,12115234,120.42,0.87
5020,2021-07-16,LOM,108929,56716,52213,11138,96627,1164,ITC,ITC4,3,Lombardia,Lombardia,10060574,12224163,121.51,1.08
5021,2021-04-07,LOM,50657,20951,29706,34082,15864,711,ITC,ITC4,3,Lombardia,Lombardia,10060574,12274820,122.01,0.5
5022,2021-06-22,LOM,111256,58106,53150,79176,29956,2124,ITC,ITC4,3,Lombardia,Lombardia,10060574,12386076,123.12,1.11
5023,2021-07-09,LOM,115784,59014,56770,11739,103160,885,ITC,ITC4,3,Lombardia,Lombardia,10060574,12501860,124.27,1.15
5024,2021-06-03,LOM,97201,49742,47459,84614,10918,1669,ITC,ITC4,3,Lombardia,Lombardia,10060574,12599061,125.23,0.97
5025,2021-06-20,LOM,89047,44373,44674,52803,35003,1241,ITC,ITC4,3,Lombardia,Lombardia,10060574,12688108,126.12,0.89
5026,2021-03-12,LOM,35336,12990,22346,24458,10258,620,ITC,ITC4,3,Lombardia,Lombardia,10060574,12723444,126.47,0.35
5027,2021-03-29,LOM,40076,15557,24519,24537,14860,679,ITC,ITC4,3,Lombardia,Lombardia,10060574,12763520,126.87,0.4
5028,2021-04-17,LOM,48582,21330,27252,36978,10875,729,ITC,ITC4,3,Lombardia,Lombardia,10060574,12812102,127.35,0.48
5029,2021-02-26,LOM,18446,7572,10874,16331,1907,208,ITC,ITC4,3,Lombardia,Lombardia,10060574,12830548,127.53,0.18
5030,2021-07-30,LOM,73323,39812,33511,35108,36093,2122,ITC,ITC4,3,Lombardia,Lombardia,10060574,12903871,128.26,0.73
5031,2020-12-31,LOM,715,302,413,715,0,0,ITC,ITC4,3,Lombardia,Lombardia,10060574,12904586,128.27,0.01
5032,2021-07-29,LOM,74456,40445,34011,33803,38699,1954,ITC,ITC4,3,Lombardia,Lombardia,10060574,12979042,129.01,0.74
5033,2021-02-20,LOM,9374,3875,5499,8846,331,197,ITC,ITC4,3,Lombardia,Lombardia,10060574,12988416,129.1,0.09
5034,2021-04-18,LOM,36440,16241,20199,30525,5246,669,ITC,ITC4,3,Lombardia,Lombardia,10060574,13024856,129.46,0.36
5035,2021-01-08,LOM,12757,3941,8816,12746,0,11,ITC,ITC4,3,Lombardia,Lombardia,10060574,13037613,129.59,0.13
5036,2021-08-05,LOM,90295,49269,41026,15750,73755,790,ITC,ITC4,3,Lombardia,Lombardia,10060574,13127908,130.49,0.9
5037,2021-01-15,LOM,25293,7458,17835,25241,0,52,ITC,ITC4,3,Lombardia,Lombardia,10060574,13153201,130.74,0.25
5038,2021-08-07,LOM,79729,43278,36451,16073,62848,808,ITC,ITC4,3,Lombardia,Lombardia,10060574,13232930,131.53,0.79
5039,2021-04-29,LOM,115656,53635,62021,83086,29914,2656,ITC,ITC4,3,Lombardia,Lombardia,10060574,13348586,132.68,1.15
5040,2021-06-25,LOM,108339,56260,52079,78366,27666,2307,ITC,ITC4,3,Lombardia,Lombardia,10060574,13456925,133.76,1.08
5041,2021-04-20,LOM,67715,30852,36863,55893,10361,1461,ITC,ITC4,3,Lombardia,Lombardia,10060574,13524640,134.43,0.67
5042,2021-01-10,LOM,10556,3982,6574,10547,0,9,ITC,ITC4,3,Lombardia,Lombardia,10060574,13535196,134.54,0.1
5043,2021-01-17,LOM,8361,3351,5010,8154,201,6,ITC,ITC4,3,Lombardia,Lombardia,10060574,13543557,134.62,0.08
5044,2021-06-23,LOM,111084,57464,53620,76673,32272,2139,ITC,ITC4,3,Lombardia,Lombardia,10060574,13654641,135.72,1.1
5045,2021-03-15,LOM,31633,11360,20273,22425,8582,626,ITC,ITC4,3,Lombardia,Lombardia,10060574,13686274,136.04,0.31
5046,2021-04-27,LOM,86113,40009,46104,67633,16611,1869,ITC,ITC4,3,Lombardia,Lombardia,10060574,13772387,136.89,0.86
5047,2021-09-06,LOM,56254,30315,25939,16500,37724,2030,ITC,ITC4,3,Lombardia,Lombardia,10060574,13828641,137.45,0.56
5048,2021-03-17,LOM,26341,10529,15812,15140,11041,160,ITC,ITC4,3,Lombardia,Lombardia,10060574,13854982,137.72,0.26
5049,2021-07-04,LOM,86771,43400,43371,40190,44623,1958,ITC,ITC4,3,Lombardia,Lombardia,10060574,13941753,138.58,0.86
5050,2021-08-30,LOM,71228,37844,33384,43170,22406,5652,ITC,ITC4,3,Lombardia,Lombardia,10060574,14012981,139.29,0.71
5051,2021-07-02,LOM,104036,52143,51893,48879,52955,2202,ITC,ITC4,3,Lombardia,Lombardia,10060574,14117017,140.32,1.03
5052,2021-03-24,LOM,43428,15681,27747,30471,12058,899,ITC,ITC4,3,Lombardia,Lombardia,10060574,14160445,140.75,0.43
5053,2021-02-09,LOM,12233,3337,8896,4027,8192,14,ITC,ITC4,3,Lombardia,Lombardia,10060574,14172678,140.87,0.12
5054,2021-02-10,ABR,946,311,635,492,444,10,ITF,ITF1,13,Abruzzo,Abruzzo,1304970,946,0.07,0.07
5055,2020-12-27,ABR,47,24,23,47,0,0,ITF,ITF1,13,Abruzzo,Abruzzo,1304970,993,0.08,0.0
5056,2021-03-20,ABR,4794,2200,2594,2563,2171,60,ITF,ITF1,13,Abruzzo,Abruzzo,1304970,5787,0.44,0.37
5057,2021-06-13,ABR,9846,4925,4921,7846,1834,166,ITF,ITF1,13,Abruzzo,Abruzzo,1304970,15633,1.2,0.75
5058,2021-03-03,ABR,4641,1899,2742,3716,906,19,ITF,ITF1,13,Abruzzo,Abruzzo,1304970,20274,1.55,0.36
5059,2021-07-14,ABR,13723,6799,6924,2436,11135,152,ITF,ITF1,13,Abruzzo,Abruzzo,1304970,33997,2.61,1.05
5060,2021-04-08,ABR,7393,3334,4059,4934,2330,129,ITF,ITF1,13,Abruzzo,Abruzzo,1304970,41390,3.17,0.57
5061,2021-04-22,ABR,6736,3251,3485,4827,1733,176,ITF,ITF1,13,Abruzzo,Abruzzo,1304970,48126,3.69,0.52
5062,2021-07-31,ABR,11744,6343,5401,3481,8060,203,ITF,ITF1,13,Abruzzo,Abruzzo,1304970,59870,4.59,0.9
5063,2021-02-22,ABR,2642,1174,1468,2585,30,27,ITF,ITF1,13,Abruzzo,Abruzzo,1304970,62512,4.79,0.2
5064,2021-02-05,ABR,1535,521,1014,772,747,16,ITF,ITF1,13,Abruzzo,Abruzzo,1304970,64047,4.91,0.12
5065,2021-05-16,ABR,9578,4135,5443,5646,3812,120,ITF,ITF1,13,Abruzzo,Abruzzo,1304970,73625,5.64,0.73
5066,2021-06-04,ABR,15650,7395,8255,10758,4703,189,ITF,ITF1,13,Abruzzo,Abruzzo,1304970,89275,6.84,1.2
5067,2021-05-18,ABR,12112,5661,6451,7563,4379,170,ITF,ITF1,13,Abruzzo,Abruzzo,1304970,101387,7.77,0.93
5068,2021-02-24,ABR,3306,1442,1864,3112,177,17,ITF,ITF1,13,Abruzzo,Abruzzo,1304970,104693,8.02,0.25
5069,2021-08-09,ABR,10701,5546,5155,3094,7413,194,ITF,ITF1,13,Abruzzo,Abruzzo,1304970,115394,8.84,0.82
5070,2021-08-26,ABR,5801,3037,2764,2014,3636,151,ITF,ITF1,13,Abruzzo,Abruzzo,1304970,121195,9.29,0.44
5071,2021-05-30,ABR,8660,4110,4550,5326,3255,79,ITF,ITF1,13,Abruzzo,Abruzzo,1304970,129855,9.95,0.66
5072,2021-04-03,ABR,5162,2259,2903,3484,1598,80,ITF,ITF1,13,Abruzzo,Abruzzo,1304970,135017,10.35,0.4
5073,2021-09-07,ABR,5358,2817,2541,1476,3772,110,ITF,ITF1,13,Abruzzo,Abruzzo,1304970,140375,10.76,0.41
5074,2021-07-26,ABR,14259,7460,6799,3869,10192,198,ITF,ITF1,13,Abruzzo,Abruzzo,1304970,154634,11.85,1.09
5075,2021-07-12,ABR,15077,7458,7619,2358,12602,117,ITF,ITF1,13,Abruzzo,Abruzzo,1304970,169711,13.0,1.16
5076,2021-01-22,ABR,118,57,61,118,0,0,ITF,ITF1,13,Abruzzo,Abruzzo,1304970,169829,13.01,0.01
5077,2021-01-03,ABR,501,212,289,499,0,2,ITF,ITF1,13,Abruzzo,Abruzzo,1304970,170330,13.05,0.04
5078,2021-08-21,ABR,3841,2098,1743,1729,1990,122,ITF,ITF1,13,Abruzzo,Abruzzo,1304970,174171,13.35,0.29
5079,2021-05-04,ABR,10856,5093,5763,7041,3628,187,ITF,ITF1,13,Abruzzo,Abruzzo,1304970,185027,14.18,0.83
5080,2021-03-08,ABR,5155,1694,3461,4083,976,96,ITF,ITF1,13,Abruzzo,Abruzzo,1304970,190182,14.57,0.4
5081,2021-01-24,ABR,50,22,28,6,44,0,ITF,ITF1,13,Abruzzo,Abruzzo,1304970,190232,14.58,0.0
5082,2021-01-10,ABR,1271,539,732,1267,0,4,ITF,ITF1,13,Abruzzo,Abruzzo,1304970,191503,14.67,0.1
5083,2021-04-29,ABR,12683,5854,6829,9270,3098,315,ITF,ITF1,13,Abruzzo,Abruzzo,1304970,204186,15.65,0.97
5084,2021-08-07,ABR,6491,3616,2875,1837,4558,96,ITF,ITF1,13,Abruzzo,Abruzzo,1304970,210677,16.14,0.5
5085,2021-06-25,ABR,11062,5480,5582,4906,6013,143,ITF,ITF1,13,Abruzzo,Abruzzo,1304970,221739,16.99,0.85
5086,2021-01-15,ABR,385,155,230,371,0,14,ITF,ITF1,13,Abruzzo,Abruzzo,1304970,222124,17.02,0.03
5087,2021-07-21,ABR,11079,5718,5361,2426,8518,135,ITF,ITF1,13,Abruzzo,Abruzzo,1304970,233203,17.87,0.85
5088,2021-02-03,ABR,2062,717,1345,411,1643,8,ITF,ITF1,13,Abruzzo,Abruzzo,1304970,235265,18.03,0.16
5089,2021-01-29,ABR,1387,449,938,71,1315,1,ITF,ITF1,13,Abruzzo,Abruzzo,1304970,236652,18.13,0.11
5090,2021-08-02,ABR,13858,7156,6702,3546,10053,259,ITF,ITF1,13,Abruzzo,Abruzzo,1304970,250510,19.2,1.06
5091,2021-03-22,ABR,4348,1912,2436,2310,1971,67,ITF,ITF1,13,Abruzzo,Abruzzo,1304970,254858,19.53,0.33
5092,2021-06-30,ABR,11170,5430,5740,4494,6509,167,ITF,ITF1,13,Abruzzo,Abruzzo,1304970,266028,20.39,0.86
5093,2021-02-17,ABR,2071,948,1123,1780,282,9,ITF,ITF1,13,Abruzzo,Abruzzo,1304970,268099,20.54,0.16
5094,2021-09-02,ABR,6121,3202,2919,1862,4129,130,ITF,ITF1,13,Abruzzo,Abruzzo,1304970,274220,21.01,0.47
5095,2021-06-11,ABR,11783,5854,5929,8831,2766,186,ITF,ITF1,13,Abruzzo,Abruzzo,1304970,286003,21.92,0.9
5096,2021-08-19,ABR,6722,3610,3112,3256,3275,191,ITF,ITF1,13,Abruzzo,Abruzzo,1304970,292725,22.43,0.52
5097,2021-08-28,ABR,2302,1331,971,699,1554,49,ITF,ITF1,13,Abruzzo,Abruzzo,1304970,295027,22.61,0.18
5098,2021-03-27,ABR,6124,2622,3502,3560,2492,72,ITF,ITF1,13,Abruzzo,Abruzzo,1304970,301151,23.08,0.47
5099,2021-01-05,ABR,1735,721,1014,1730,0,5,ITF,ITF1,13,Abruzzo,Abruzzo,1304970,302886,23.21,0.13
5100,2021-04-15,ABR,7828,3686,4142,5824,1843,161,ITF,ITF1,13,Abruzzo,Abruzzo,1304970,310714,23.81,0.6
5101,2021-07-07,ABR,12065,5906,6159,4027,7796,242,ITF,ITF1,13,Abruzzo,Abruzzo,1304970,322779,24.73,0.92
5102,2021-03-01,ABR,3477,1384,2093,2702,751,24,ITF,ITF1,13,Abruzzo,Abruzzo,1304970,326256,25.0,0.27
5103,2021-08-14,ABR,128,69,59,101,25,2,ITF,ITF1,13,Abruzzo,Abruzzo,1304970,326384,25.01,0.01
5104,2021-06-18,ABR,10194,5006,5188,6551,3494,149,ITF,ITF1,13,Abruzzo,Abruzzo,1304970,336578,25.79,0.78
5105,2021-02-02,ABR,1764,668,1096,218,1542,4,ITF,ITF1,13,Abruzzo,Abruzzo,1304970,338342,25.93,0.14
5106,2021-05-13,ABR,11150,5043,6107,6955,3962,233,ITF,ITF1,13,Abruzzo,Abruzzo,1304970,349492,26.78,0.85
5107,2021-04-27,ABR,9083,4366,4717,6504,2466,113,ITF,ITF1,13,Abruzzo,Abruzzo,1304970,358575,27.48,0.7
5108,2021-07-02,ABR,11836,5947,5889,4830,6821,185,ITF,ITF1,13,Abruzzo,Abruzzo,1304970,370411,28.38,0.91
5109,2021-03-15,ABR,3680,1445,2235,1840,1808,32,ITF,ITF1,13,Abruzzo,Abruzzo,1304970,374091,28.67,0.28
5110,2021-01-17,ABR,193,64,129,185,7,1,ITF,ITF1,13,Abruzzo,Abruzzo,1304970,374284,28.68,0.01
5111,2021-06-23,ABR,11015,5284,5731,5578,5291,146,ITF,ITF1,13,Abruzzo,Abruzzo,1304970,385299,29.53,0.84
5112,2021-02-12,ABR,1228,567,661,1026,189,13,ITF,ITF1,13,Abruzzo,Abruzzo,1304970,386527,29.62,0.09
5113,2021-07-19,ABR,11781,5985,5796,2667,8943,171,ITF,ITF1,13,Abruzzo,Abruzzo,1304970,398308,30.52,0.9
5114,2021-05-23,ABR,9880,4693,5187,7067,2692,121,ITF,ITF1,13,Abruzzo,Abruzzo,1304970,408188,31.28,0.76
5115,2021-06-06,ABR,11149,5309,5840,8776,2240,133,ITF,ITF1,13,Abruzzo,Abruzzo,1304970,419337,32.13,0.85
5116,2021-04-10,ABR,8778,4060,4718,6123,2510,145,ITF,ITF1,13,Abruzzo,Abruzzo,1304970,428115,32.81,0.67
5117,2021-02-28,ABR,1703,509,1194,1665,2,36,ITF,ITF1,13,Abruzzo,Abruzzo,1304970,429818,32.94,0.13
5118,2021-08-04,ABR,10883,5629,5254,4302,6337,244,ITF,ITF1,13,Abruzzo,Abruzzo,1304970,440701,33.77,0.83
5119,2021-01-02,ABR,559,226,333,558,0,1,ITF,ITF1,13,Abruzzo,Abruzzo,1304970,441260,33.81,0.04
5120,2021-06-08,ABR,12872,6622,6250,10432,2197,243,ITF,ITF1,13,Abruzzo,Abruzzo,1304970,454132,34.8,0.99
5121,2021-04-26,ABR,8563,4067,4496,7137,1214,212,ITF,ITF1,13,Abruzzo,Abruzzo,1304970,462695,35.46,0.66
5122,2021-06-01,ABR,10999,4878,6121,6511,4367,121,ITF,ITF1,13,Abruzzo,Abruzzo,1304970,473694,36.3,0.84
5123,2021-05-27,ABR,13322,6104,7218,8315,4831,176,ITF,ITF1,13,Abruzzo,Abruzzo,1304970,487016,37.32,1.02
5124,2021-09-04,ABR,2139,1136,1003,740,1338,61,ITF,ITF1,13,Abruzzo,Abruzzo,1304970,489155,37.48,0.16
5125,2021-03-19,ABR,5798,2585,3213,2731,3024,43,ITF,ITF1,13,Abruzzo,Abruzzo,1304970,494953,37.93,0.44
5126,2021-03-05,ABR,5346,1958,3388,4590,697,59,ITF,ITF1,13,Abruzzo,Abruzzo,1304970,500299,38.34,0.41
5127,2021-06-27,ABR,8367,4299,4068,5019,3208,140,ITF,ITF1,13,Abruzzo,Abruzzo,1304970,508666,38.98,0.64
5128,2021-04-07,ABR,7554,3490,4064,4515,2904,135,ITF,ITF1,13,Abruzzo,Abruzzo,1304970,516220,39.56,0.58
5129,2021-07-16,ABR,16150,8239,7911,2469,13564,117,ITF,ITF1,13,Abruzzo,Abruzzo,1304970,532370,40.8,1.24
5130,2021-05-08,ABR,10291,4870,5421,6309,3836,146,ITF,ITF1,13,Abruzzo,Abruzzo,1304970,542661,41.58,0.79
5131,2021-04-24,ABR,8731,3975,4756,6937,1532,262,ITF,ITF1,13,Abruzzo,Abruzzo,1304970,551392,42.25,0.67
5132,2021-08-16,ABR,6096,3207,2889,2256,3694,146,ITF,ITF1,13,Abruzzo,Abruzzo,1304970,557488,42.72,0.47
5133,2021-01-14,ABR,568,227,341,566,0,2,ITF,ITF1,13,Abruzzo,Abruzzo,1304970,558056,42.76,0.04
5134,2021-05-11,ABR,10764,5120,5644,5731,4856,177,ITF,ITF1,13,Abruzzo,Abruzzo,1304970,568820,43.59,0.82
5135,2021-08-18,ABR,7384,3919,3465,3091,4102,191,ITF,ITF1,13,Abruzzo,Abruzzo,1304970,576204,44.15,0.57
5136,2021-04-05,ABR,2692,1147,1545,1729,880,83,ITF,ITF1,13,Abruzzo,Abruzzo,1304970,578896,44.36,0.21
5137,2021-01-12,ABR,1900,761,1139,1886,0,14,ITF,ITF1,13,Abruzzo,Abruzzo,1304970,580796,44.51,0.15
5138,2021-05-25,ABR,11422,5325,6097,8085,3139,198,ITF,ITF1,13,Abruzzo,Abruzzo,1304970,592218,45.38,0.88
5139,2021-01-31,ABR,1523,494,1029,286,1236,1,ITF,ITF1,13,Abruzzo,Abruzzo,1304970,593741,45.5,0.12
5140,2021-01-19,ABR,112,56,56,90,21,1,ITF,ITF1,13,Abruzzo,Abruzzo,1304970,593853,45.51,0.01
5141,2021-02-07,ABR,780,308,472,200,579,1,ITF,ITF1,13,Abruzzo,Abruzzo,1304970,594633,45.57,0.06
5142,2021-07-23,ABR,12573,6463,6110,2852,9561,160,ITF,ITF1,13,Abruzzo,Abruzzo,1304970,607206,46.53,0.96
5143,2021-01-21,ABR,157,47,110,157,0,0,ITF,ITF1,13,Abruzzo,Abruzzo,1304970,607363,46.54,0.01
5144,2021-05-01,ABR,10752,5052,5700,5630,4984,138,ITF,ITF1,13,Abruzzo,Abruzzo,1304970,618115,47.37,0.82
5145,2021-05-20,ABR,12807,5926,6881,7411,5268,128,ITF,ITF1,13,Abruzzo,Abruzzo,1304970,630922,48.35,0.98
5146,2021-04-19,ABR,6234,2863,3371,3787,2374,73,ITF,ITF1,13,Abruzzo,Abruzzo,1304970,637156,48.83,0.48
5147,2021-02-21,ABR,1218,550,668,1193,1,24,ITF,ITF1,13,Abruzzo,Abruzzo,1304970,638374,48.92,0.09
5148,2021-07-28,ABR,13274,6955,6319,3436,9671,167,ITF,ITF1,13,Abruzzo,Abruzzo,1304970,651648,49.94,1.02
5149,2021-06-15,ABR,11331,5562,5769,8683,2439,209,ITF,ITF1,13,Abruzzo,Abruzzo,1304970,662979,50.8,0.87
5150,2021-04-12,ABR,6240,2957,3283,4984,1174,82,ITF,ITF1,13,Abruzzo,Abruzzo,1304970,669219,51.28,0.48
5151,2021-03-17,ABR,4539,1872,2667,2776,1740,23,ITF,ITF1,13,Abruzzo,Abruzzo,1304970,673758,51.63,0.35
5152,2021-09-06,ABR,6222,3246,2976,2208,3866,148,ITF,ITF1,13,Abruzzo,Abruzzo,1304970,679980,52.11,0.48
5153,2021-03-24,ABR,6387,2786,3601,3992,2252,143,ITF,ITF1,13,Abruzzo,Abruzzo,1304970,686367,52.6,0.49
5154,2021-07-09,ABR,13611,6794,6817,2887,10585,139,ITF,ITF1,13,Abruzzo,Abruzzo,1304970,699978,53.64,1.04
5155,2021-06-22,ABR,10413,4879,5534,5386,4846,181,ITF,ITF1,13,Abruzzo,Abruzzo,1304970,710391,54.44,0.8
5156,2021-03-29,ABR,5710,2600,3110,3020,2640,50,ITF,ITF1,13,Abruzzo,Abruzzo,1304970,716101,54.87,0.44
5157,2021-06-03,ABR,13200,6287,6913,9246,3779,175,ITF,ITF1,13,Abruzzo,Abruzzo,1304970,729301,55.89,1.01
5158,2021-03-12,ABR,6043,1993,4050,4353,1611,79,ITF,ITF1,13,Abruzzo,Abruzzo,1304970,735344,56.35,0.46
5159,2021-06-20,ABR,8444,4237,4207,5409,2932,103,ITF,ITF1,13,Abruzzo,Abruzzo,1304970,743788,57.0,0.65
5160,2021-03-14,ABR,1883,732,1151,1201,669,13,ITF,ITF1,13,Abruzzo,Abruzzo,1304970,745671,57.14,0.14
5161,2021-02-16,ABR,1916,842,1074,1891,12,13,ITF,ITF1,13,Abruzzo,Abruzzo,1304970,747587,57.29,0.15
5162,2021-03-02,ABR,3967,1676,2291,3264,686,17,ITF,ITF1,13,Abruzzo,Abruzzo,1304970,751554,57.59,0.3
5163,2021-06-10,ABR,12710,6319,6391,10307,2164,239,ITF,ITF1,13,Abruzzo,Abruzzo,1304970,764264,58.57,0.97
5164,2021-02-09,ABR,923,325,598,513,409,1,ITF,ITF1,13,Abruzzo,Abruzzo,1304970,765187,58.64,0.07
5165,2021-07-04,ABR,8371,4215,4156,3331,4915,125,ITF,ITF1,13,Abruzzo,Abruzzo,1304970,773558,59.28,0.64
5166,2021-08-30,ABR,7419,4059,3360,1948,5342,129,ITF,ITF1,13,Abruzzo,Abruzzo,1304970,780977,59.85,0.57
5167,2021-09-01,ABR,6863,3656,3207,1583,5179,101,ITF,ITF1,13,Abruzzo,Abruzzo,1304970,787840,60.37,0.53
5168,2021-01-16,ABR,938,431,507,930,0,8,ITF,ITF1,13,Abruzzo,Abruzzo,1304970,788778,60.44,0.07
5169,2021-04-17,ABR,7358,3403,3955,4210,3051,97,ITF,ITF1,13,Abruzzo,Abruzzo,1304970,796136,61.01,0.56
5170,2021-02-19,ABR,3300,1552,1748,3161,100,39,ITF,ITF1,13,Abruzzo,Abruzzo,1304970,799436,61.26,0.25
5171,2021-05-10,ABR,10114,4786,5328,5343,4653,118,ITF,ITF1,13,Abruzzo,Abruzzo,1304970,809550,62.04,0.78
5172,2021-04-23,ABR,7404,3397,4007,4927,2308,169,ITF,ITF1,13,Abruzzo,Abruzzo,1304970,816954,62.6,0.57
5173,2021-01-30,ABR,1515,570,945,63,1451,1,ITF,ITF1,13,Abruzzo,Abruzzo,1304970,818469,62.72,0.12
5174,2021-08-01,ABR,7573,4057,3516,2006,5465,102,ITF,ITF1,13,Abruzzo,Abruzzo,1304970,826042,63.3,0.58
5175,2021-06-29,ABR,11430,5640,5790,5246,5996,188,ITF,ITF1,13,Abruzzo,Abruzzo,1304970,837472,64.18,0.88
5176,2021-03-21,ABR,2133,914,1219,838,1291,4,ITF,ITF1,13,Abruzzo,Abruzzo,1304970,839605,64.34,0.16
5177,2021-06-12,ABR,11424,5917,5507,9890,1352,182,ITF,ITF1,13,Abruzzo,Abruzzo,1304970,851029,65.21,0.88
5178,2021-02-11,ABR,815,262,553,770,43,2,ITF,ITF1,13,Abruzzo,Abruzzo,1304970,851844,65.28,0.06
5179,2021-05-24,ABR,12223,5839,6384,8725,3342,156,ITF,ITF1,13,Abruzzo,Abruzzo,1304970,864067,66.21,0.94
5180,2021-02-25,ABR,3056,1344,1712,2507,530,19,ITF,ITF1,13,Abruzzo,Abruzzo,1304970,867123,66.45,0.23
5181,2021-06-05,ABR,14619,6866,7753,10365,4051,203,ITF,ITF1,13,Abruzzo,Abruzzo,1304970,881742,67.57,1.12
5182,2021-08-08,ABR,4450,2428,2022,1886,2474,90,ITF,ITF1,13,Abruzzo,Abruzzo,1304970,886192,67.91,0.34
5183,2021-05-17,ABR,11040,5039,6001,6019,4858,163,ITF,ITF1,13,Abruzzo,Abruzzo,1304970,897232,68.75,0.85
5184,2021-03-07,ABR,2523,630,1893,2485,0,38,ITF,ITF1,13,Abruzzo,Abruzzo,1304970,899755,68.95,0.19
5185,2021-01-09,ABR,1614,693,921,1602,0,12,ITF,ITF1,13,Abruzzo,Abruzzo,1304970,901369,69.07,0.12
5186,2021-05-07,ABR,12215,5714,6501,7647,4425,143,ITF,ITF1,13,Abruzzo,Abruzzo,1304970,913584,70.01,0.94
5187,2021-03-25,ABR,5802,2666,3136,3065,2623,114,ITF,ITF1,13,Abruzzo,Abruzzo,1304970,919386,70.45,0.44
5188,2021-08-29,ABR,1468,878,590,522,932,14,ITF,ITF1,13,Abruzzo,Abruzzo,1304970,920854,70.57,0.11
5189,2021-01-27,ABR,1368,515,853,34,1334,0,ITF,ITF1,13,Abruzzo,Abruzzo,1304970,922222,70.67,0.1
5190,2021-07-03,ABR,10195,5149,5046,3501,6546,148,ITF,ITF1,13,Abruzzo,Abruzzo,1304970,932417,71.45,0.78
5191,2021-05-21,ABR,13020,6330,6690,7865,4979,176,ITF,ITF1,13,Abruzzo,Abruzzo,1304970,945437,72.45,1.0
5192,2021-03-18,ABR,3900,1652,2248,2038,1835,27,ITF,ITF1,13,Abruzzo,Abruzzo,1304970,949337,72.75,0.3
5193,2021-08-22,ABR,1832,948,884,537,1243,52,ITF,ITF1,13,Abruzzo,Abruzzo,1304970,951169,72.89,0.14
5194,2021-08-11,ABR,8279,4417,3862,2616,5505,158,ITF,ITF1,13,Abruzzo,Abruzzo,1304970,959448,73.52,0.63
5195,2021-01-07,ABR,1711,657,1054,1704,0,7,ITF,ITF1,13,Abruzzo,Abruzzo,1304970,961159,73.65,0.13
5196,2021-07-30,ABR,12088,6435,5653,3792,8070,226,ITF,ITF1,13,Abruzzo,Abruzzo,1304970,973247,74.58,0.93
5197,2021-02-26,ABR,3923,1679,2244,2928,969,26,ITF,ITF1,13,Abruzzo,Abruzzo,1304970,977170,74.88,0.3
5198,2021-01-13,ABR,1304,483,821,1296,0,8,ITF,ITF1,13,Abruzzo,Abruzzo,1304970,978474,74.98,0.1
5199,2021-02-13,ABR,867,394,473,439,424,4,ITF,ITF1,13,Abruzzo,Abruzzo,1304970,979341,75.05,0.07
5200,2021-02-18,ABR,2291,933,1358,2141,133,17,ITF,ITF1,13,Abruzzo,Abruzzo,1304970,981632,75.22,0.18
5201,2021-05-29,ABR,10318,4430,5888,4454,5772,92,ITF,ITF1,13,Abruzzo,Abruzzo,1304970,991950,76.01,0.79
5202,2021-05-22,ABR,13162,6393,6769,8132,4918,112,ITF,ITF1,13,Abruzzo,Abruzzo,1304970,1005112,77.02,1.01
5203,2021-03-26,ABR,5363,2315,3048,3175,2080,108,ITF,ITF1,13,Abruzzo,Abruzzo,1304970,1010475,77.43,0.41
5204,2021-09-08,ABR,4426,2351,2075,1591,2733,102,ITF,ITF1,13,Abruzzo,Abruzzo,1304970,1014901,77.77,0.34
5205,2021-07-27,ABR,15144,7906,7238,3344,11624,176,ITF,ITF1,13,Abruzzo,Abruzzo,1304970,1030045,78.93,1.16
5206,2021-05-31,ABR,11339,5115,6224,6769,4444,126,ITF,ITF1,13,Abruzzo,Abruzzo,1304970,1041384,79.8,0.87
5207,2021-04-20,ABR,5638,2714,2924,4104,1456,78,ITF,ITF1,13,Abruzzo,Abruzzo,1304970,1047022,80.23,0.43
5208,2021-07-29,ABR,15180,7972,7208,3929,11041,210,ITF,ITF1,13,Abruzzo,Abruzzo,1304970,1062202,81.4,1.16
5209,2021-04-25,ABR,9072,4625,4447,8053,809,210,ITF,ITF1,13,Abruzzo,Abruzzo,1304970,1071274,82.09,0.7
5210,2021-08-05,ABR,13901,7161,6740,4715,8915,271,ITF,ITF1,13,Abruzzo,Abruzzo,1304970,1085175,83.16,1.07
5211,2021-01-08,ABR,1659,638,1021,1650,0,9,ITF,ITF1,13,Abruzzo,Abruzzo,1304970,1086834,83.28,0.13
5212,2021-04-18,ABR,5821,2730,3091,4728,944,149,ITF,ITF1,13,Abruzzo,Abruzzo,1304970,1092655,83.73,0.45
5213,2021-02-20,ABR,4781,1845,2936,4661,76,44,ITF,ITF1,13,Abruzzo,Abruzzo,1304970,1097436,84.1,0.37
5214,2021-09-03,ABR,5939,3186,2753,1830,3978,131,ITF,ITF1,13,Abruzzo,Abruzzo,1304970,1103375,84.55,0.46
5215,2021-01-28,ABR,1434,495,939,11,1423,0,ITF,ITF1,13,Abruzzo,Abruzzo,1304970,1104809,84.66,0.11
5216,2021-01-11,ABR,1689,690,999,1685,0,4,ITF,ITF1,13,Abruzzo,Abruzzo,1304970,1106498,84.79,0.13
5217,2021-04-21,ABR,6394,3104,3290,4634,1673,87,ITF,ITF1,13,Abruzzo,Abruzzo,1304970,1112892,85.28,0.49
5218,2021-07-15,ABR,15946,8089,7857,3131,12639,176,ITF,ITF1,13,Abruzzo,Abruzzo,1304970,1128838,86.5,1.22
5219,2021-06-28,ABR,10055,4837,5218,5311,4574,170,ITF,ITF1,13,Abruzzo,Abruzzo,1304970,1138893,87.27,0.77
5220,2021-04-06,ABR,7677,3578,4099,5227,2320,130,ITF,ITF1,13,Abruzzo,Abruzzo,1304970,1146570,87.86,0.59
5221,2021-08-03,ABR,12724,6576,6148,3648,8907,169,ITF,ITF1,13,Abruzzo,Abruzzo,1304970,1159294,88.84,0.98
5222,2021-08-17,ABR,6583,3468,3115,2824,3541,218,ITF,ITF1,13,Abruzzo,Abruzzo,1304970,1165877,89.34,0.5
5223,2021-06-26,ABR,10053,5020,5033,5690,4201,162,ITF,ITF1,13,Abruzzo,Abruzzo,1304970,1175930,90.11,0.77
5224,2021-07-10,ABR,13122,6634,6488,3011,9946,165,ITF,ITF1,13,Abruzzo,Abruzzo,1304970,1189052,91.12,1.01
5225,2021-05-14,ABR,10595,5071,5524,5283,5151,161,ITF,ITF1,13,Abruzzo,Abruzzo,1304970,1199647,91.93,0.81
5226,2021-04-01,ABR,5627,2520,3107,3429,2120,78,ITF,ITF1,13,Abruzzo,Abruzzo,1304970,1205274,92.36,0.43
5227,2021-08-25,ABR,7126,3795,3331,2372,4585,169,ITF,ITF1,13,Abruzzo,Abruzzo,1304970,1212400,92.91,0.55
5228,2021-08-27,ABR,7970,4201,3769,2468,5342,160,ITF,ITF1,13,Abruzzo,Abruzzo,1304970,1220370,93.52,0.61
5229,2021-02-23,ABR,2780,1273,1507,2754,11,15,ITF,ITF1,13,Abruzzo,Abruzzo,1304970,1223150,93.73,0.21
5230,2021-02-06,ABR,1613,745,868,595,1011,7,ITF,ITF1,13,Abruzzo,Abruzzo,1304970,1224763,93.85,0.12
5231,2021-02-08,ABR,1196,396,800,486,710,0,ITF,ITF1,13,Abruzzo,Abruzzo,1304970,1225959,93.95,0.09
5232,2021-05-19,ABR,10730,5126,5604,7567,3037,126,ITF,ITF1,13,Abruzzo,Abruzzo,1304970,1236689,94.77,0.82
5233,2021-04-30,ABR,12512,5871,6641,6511,5728,273,ITF,ITF1,13,Abruzzo,Abruzzo,1304970,1249201,95.73,0.96
5234,2021-04-13,ABR,5895,2755,3140,4559,1238,98,ITF,ITF1,13,Abruzzo,Abruzzo,1304970,1255096,96.18,0.45
5235,2021-01-20,ABR,449,157,292,427,2,20,ITF,ITF1,13,Abruzzo,Abruzzo,1304970,1255545,96.21,0.03
5236,2021-01-18,ABR,154,71,83,53,101,0,ITF,ITF1,13,Abruzzo,Abruzzo,1304970,1255699,96.22,0.01
5237,2021-06-24,ABR,10874,5413,5461,5724,4979,171,ITF,ITF1,13,Abruzzo,Abruzzo,1304970,1266573,97.06,0.83
5238,2021-04-28,ABR,9517,4590,4927,7308,2025,184,ITF,ITF1,13,Abruzzo,Abruzzo,1304970,1276090,97.79,0.73
5239,2021-05-12,ABR,9630,4602,5028,5871,3582,177,ITF,ITF1,13,Abruzzo,Abruzzo,1304970,1285720,98.52,0.74
5240,2021-03-16,ABR,3486,1453,2033,1804,1654,28,ITF,ITF1,13,Abruzzo,Abruzzo,1304970,1289206,98.79,0.27
5241,2021-07-17,ABR,14100,7389,6711,2654,11269,177,ITF,ITF1,13,Abruzzo,Abruzzo,1304970,1303306,99.87,1.08
5242,2021-03-04,ABR,5942,2360,3582,4972,928,42,ITF,ITF1,13,Abruzzo,Abruzzo,1304970,1309248,100.33,0.46
5243,2021-05-28,ABR,14025,6311,7714,7492,6364,169,ITF,ITF1,13,Abruzzo,Abruzzo,1304970,1323273,101.4,1.07
5244,2021-09-05,ABR,1428,781,647,437,963,28,ITF,ITF1,13,Abruzzo,Abruzzo,1304970,1324701,101.51,0.11
5245,2021-06-19,ABR,10557,5201,5356,6483,3900,174,ITF,ITF1,13,Abruzzo,Abruzzo,1304970,1335258,102.32,0.81
5246,2021-03-28,ABR,2431,1018,1413,1994,386,51,ITF,ITF1,13,Abruzzo,Abruzzo,1304970,1337689,102.51,0.19
5247,2021-07-06,ABR,10463,5199,5264,4299,5989,175,ITF,ITF1,13,Abruzzo,Abruzzo,1304970,1348152,103.31,0.8
5248,2021-04-14,ABR,6597,2952,3645,4339,2123,135,ITF,ITF1,13,Abruzzo,Abruzzo,1304970,1354749,103.81,0.51
5249,2021-01-04,ABR,1514,685,829,1508,0,6,ITF,ITF1,13,Abruzzo,Abruzzo,1304970,1356263,103.93,0.12
5250,2021-01-23,ABR,265,116,149,51,208,6,ITF,ITF1,13,Abruzzo,Abruzzo,1304970,1356528,103.95,0.02
5251,2021-05-03,ABR,11151,5260,5891,7129,3837,185,ITF,ITF1,13,Abruzzo,Abruzzo,1304970,1367679,104.81,0.85
5252,2021-07-25,ABR,9862,5217,4645,2170,7569,123,ITF,ITF1,13,Abruzzo,Abruzzo,1304970,1377541,105.56,0.76
5253,2021-07-08,ABR,13497,6685,6812,3410,9921,166,ITF,ITF1,13,Abruzzo,Abruzzo,1304970,1391038,106.6,1.03
5254,2021-04-16,ABR,7545,3492,4053,5500,1916,129,ITF,ITF1,13,Abruzzo,Abruzzo,1304970,1398583,107.17,0.58
5255,2021-08-20,ABR,6046,3165,2881,2033,3882,131,ITF,ITF1,13,Abruzzo,Abruzzo,1304970,1404629,107.64,0.46
5256,2021-08-06,ABR,10675,5707,4968,3686,6746,243,ITF,ITF1,13,Abruzzo,Abruzzo,1304970,1415304,108.45,0.82
5257,2021-05-05,ABR,11649,5576,6073,6275,5211,163,ITF,ITF1,13,Abruzzo,Abruzzo,1304970,1426953,109.35,0.89
5258,2021-03-09,ABR,5176,1805,3371,4147,938,91,ITF,ITF1,13,Abruzzo,Abruzzo,1304970,1432129,109.74,0.4
5259,2021-08-13,ABR,7119,3830,3289,2014,5000,105,ITF,ITF1,13,Abruzzo,Abruzzo,1304970,1439248,110.29,0.55
5260,2021-07-01,ABR,12764,6283,6481,5770,6769,225,ITF,ITF1,13,Abruzzo,Abruzzo,1304970,1452012,111.27,0.98
5261,2021-06-17,ABR,10918,5460,5458,7303,3452,163,ITF,ITF1,13,Abruzzo,Abruzzo,1304970,1462930,112.1,0.84
5262,2021-08-24,ABR,6357,3409,2948,1876,4329,152,ITF,ITF1,13,Abruzzo,Abruzzo,1304970,1469287,112.59,0.49
5263,2021-07-05,ABR,10912,5349,5563,4047,6675,190,ITF,ITF1,13,Abruzzo,Abruzzo,1304970,1480199,113.43,0.84
5264,2021-07-22,ABR,14490,7413,7077,3519,10762,209,ITF,ITF1,13,Abruzzo,Abruzzo,1304970,1494689,114.54,1.11
5265,2021-07-24,ABR,12631,6840,5791,3810,8586,235,ITF,ITF1,13,Abruzzo,Abruzzo,1304970,1507320,115.51,0.97
5266,2021-05-02,ABR,10464,5115,5349,5087,5232,145,ITF,ITF1,13,Abruzzo,Abruzzo,1304970,1517784,116.31,0.8
5267,2021-08-10,ABR,9270,4964,4306,3398,5660,212,ITF,ITF1,13,Abruzzo,Abruzzo,1304970,1527054,117.02,0.71
5268,2021-05-09,ABR,9159,4091,5068,4172,4874,113,ITF,ITF1,13,Abruzzo,Abruzzo,1304970,1536213,117.72,0.7
5269,2021-02-15,ABR,1794,832,962,1735,42,17,ITF,ITF1,13,Abruzzo,Abruzzo,1304970,1538007,117.86,0.14
5270,2021-05-26,ABR,13552,6045,7507,8397,4996,159,ITF,ITF1,13,Abruzzo,Abruzzo,1304970,1551559,118.9,1.04
5271,2021-06-14,ABR,10981,5431,5550,7427,3379,175,ITF,ITF1,13,Abruzzo,Abruzzo,1304970,1562540,119.74,0.84
5272,2021-03-11,ABR,5491,2216,3275,4264,1139,88,ITF,ITF1,13,Abruzzo,Abruzzo,1304970,1568031,120.16,0.42
5273,2021-06-02,ABR,9774,4751,5023,6837,2819,118,ITF,ITF1,13,Abruzzo,Abruzzo,1304970,1577805,120.91,0.75
5274,2021-03-13,ABR,4124,1421,2703,3018,1043,63,ITF,ITF1,13,Abruzzo,Abruzzo,1304970,1581929,121.22,0.32
5275,2021-06-21,ABR,11057,5389,5668,4939,5990,128,ITF,ITF1,13,Abruzzo,Abruzzo,1304970,1592986,122.07,0.85
5276,2021-03-30,ABR,5130,2262,2868,3143,1824,163,ITF,ITF1,13,Abruzzo,Abruzzo,1304970,1598116,122.46,0.39
5277,2021-01-06,ABR,1991,819,1172,1981,0,10,ITF,ITF1,13,Abruzzo,Abruzzo,1304970,1600107,122.62,0.15
5278,2021-02-01,ABR,1633,574,1059,268,1364,1,ITF,ITF1,13,Abruzzo,Abruzzo,1304970,1601740,122.74,0.13
5279,2021-08-31,ABR,6394,3488,2906,1705,4579,110,ITF,ITF1,13,Abruzzo,Abruzzo,1304970,1608134,123.23,0.49
5280,2021-03-23,ABR,4835,2191,2644,2209,2567,59,ITF,ITF1,13,Abruzzo,Abruzzo,1304970,1612969,123.6,0.37
5281,2021-01-25,ABR,1607,635,972,13,1592,2,ITF,ITF1,13,Abruzzo,Abruzzo,1304970,1614576,123.73,0.12
5282,2021-03-31,ABR,6724,2947,3777,4560,2069,95,ITF,ITF1,13,Abruzzo,Abruzzo,1304970,1621300,124.24,0.52
5283,2021-05-15,ABR,11446,5185,6261,5940,5327,179,ITF,ITF1,13,Abruzzo,Abruzzo,1304970,1632746,125.12,0.88
5284,2021-08-23,ABR,5919,3108,2811,1658,4117,144,ITF,ITF1,13,Abruzzo,Abruzzo,1304970,1638665,125.57,0.45
5285,2021-07-11,ABR,9887,4976,4911,2364,7388,135,ITF,ITF1,13,Abruzzo,Abruzzo,1304970,1648552,126.33,0.76
5286,2021-03-10,ABR,5050,1686,3364,4026,957,67,ITF,ITF1,13,Abruzzo,Abruzzo,1304970,1653602,126.72,0.39
5287,2021-01-26,ABR,1550,568,982,31,1519,0,ITF,ITF1,13,Abruzzo,Abruzzo,1304970,1655152,126.83,0.12
5288,2021-05-06,ABR,13003,6087,6916,7796,5048,159,ITF,ITF1,13,Abruzzo,Abruzzo,1304970,1668155,127.83,1.0
5289,2021-04-09,ABR,8995,4261,4734,6248,2603,144,ITF,ITF1,13,Abruzzo,Abruzzo,1304970,1677150,128.52,0.69
5290,2021-07-18,ABR,12209,6312,5897,2002,10085,122,ITF,ITF1,13,Abruzzo,Abruzzo,1304970,1689359,129.46,0.94
5291,2021-04-02,ABR,6697,3105,3592,5113,1489,95,ITF,ITF1,13,Abruzzo,Abruzzo,1304970,1696056,129.97,0.51
5292,2021-02-04,ABR,1685,617,1068,601,1072,12,ITF,ITF1,13,Abruzzo,Abruzzo,1304970,1697741,130.1,0.13
5293,2021-07-20,ABR,12592,6391,6201,3226,9177,189,ITF,ITF1,13,Abruzzo,Abruzzo,1304970,1710333,131.06,0.96
5294,2021-04-04,ABR,1633,769,864,1458,129,46,ITF,ITF1,13,Abruzzo,Abruzzo,1304970,1711966,131.19,0.13
5295,2021-07-13,ABR,15526,7752,7774,2826,12523,177,ITF,ITF1,13,Abruzzo,Abruzzo,1304970,1727492,132.38,1.19
5296,2021-08-12,ABR,8771,4627,4144,3181,5410,180,ITF,ITF1,13,Abruzzo,Abruzzo,1304970,1736263,133.05,0.67
5297,2021-06-16,ABR,10897,5452,5445,7991,2689,217,ITF,ITF1,13,Abruzzo,Abruzzo,1304970,1747160,133.89,0.84
5298,2021-02-27,ABR,2812,1339,1473,2512,267,33,ITF,ITF1,13,Abruzzo,Abruzzo,1304970,1749972,134.1,0.22
5299,2021-06-07,ABR,11102,5290,5812,9072,1844,186,ITF,ITF1,13,Abruzzo,Abruzzo,1304970,1761074,134.95,0.85
5300,2021-04-11,ABR,5380,2629,2751,4835,487,58,ITF,ITF1,13,Abruzzo,Abruzzo,1304970,1766454,135.36,0.41
5301,2021-06-09,ABR,11574,6093,5481,9706,1685,183,ITF,ITF1,13,Abruzzo,Abruzzo,1304970,1778028,136.25,0.89
5302,2021-03-06,ABR,4182,1361,2821,3570,571,41,ITF,ITF1,13,Abruzzo,Abruzzo,1304970,1782210,136.57,0.32
