,data,area,Vaccinazioni giornaliere,sesso_maschile,sesso_femminile,prima_dose,seconda_dose,codice_NUTS1,codice_NUTS2,codice_regione_ISTAT,nome_area,Regione,popolazione,Totale vaccinazioni,Totale vaccinazioni ogni cento ab,Vaccinazioni giornaliere ogni cento ab
0,2021-02-07,MOL,66,32,34,19,47,ITF,ITF2,14,Molise,Molise,305617,66,0.02,0.02
1,2021-05-18,MOL,1645,877,768,990,655,ITF,ITF2,14,Molise,Molise,305617,1711,0.56,0.54
2,2021-03-22,MOL,1146,439,707,903,243,ITF,ITF2,14,Molise,Molise,305617,2857,0.93,0.37
3,2021-05-20,MOL,2659,1369,1290,2473,186,ITF,ITF2,14,Molise,Molise,305617,5516,1.8,0.87
4,2021-01-07,MOL,598,209,389,598,0,ITF,ITF2,14,Molise,Molise,305617,6114,2.0,0.2
5,2021-02-12,MOL,330,149,181,208,122,ITF,ITF2,14,Molise,Molise,305617,6444,2.11,0.11
6,2021-03-15,MOL,832,338,494,587,245,ITF,ITF2,14,Molise,Molise,305617,7276,2.38,0.27
7,2021-01-26,MOL,450,184,266,8,442,ITF,ITF2,14,Molise,Molise,305617,7726,2.53,0.15
8,2021-05-06,MOL,2679,1214,1465,2081,598,ITF,ITF2,14,Molise,Molise,305617,10405,3.4,0.88
9,2021-03-17,MOL,908,385,523,576,332,ITF,ITF2,14,Molise,Molise,305617,11313,3.7,0.3
10,2021-06-08,MOL,2844,1580,1264,2189,655,ITF,ITF2,14,Molise,Molise,305617,14157,4.63,0.93
11,2021-02-19,MOL,169,93,76,167,2,ITF,ITF2,14,Molise,Molise,305617,14326,4.69,0.06
12,2021-03-10,MOL,1737,720,1017,1687,50,ITF,ITF2,14,Molise,Molise,305617,16063,5.26,0.57
13,2021-06-01,MOL,2567,1316,1251,2488,79,ITF,ITF2,14,Molise,Molise,305617,18630,6.1,0.84
14,2021-05-13,MOL,3037,1409,1628,2580,457,ITF,ITF2,14,Molise,Molise,305617,21667,7.09,0.99
15,2021-03-24,MOL,1631,658,973,1229,402,ITF,ITF2,14,Molise,Molise,305617,23298,7.62,0.53
16,2021-01-17,MOL,78,38,40,48,30,ITF,ITF2,14,Molise,Molise,305617,23376,7.65,0.03
17,2021-04-10,MOL,2637,1260,1377,2485,152,ITF,ITF2,14,Molise,Molise,305617,26013,8.51,0.86
18,2021-02-05,MOL,593,269,324,55,538,ITF,ITF2,14,Molise,Molise,305617,26606,8.71,0.19
19,2021-01-19,MOL,173,63,110,162,11,ITF,ITF2,14,Molise,Molise,305617,26779,8.76,0.06
20,2021-04-29,MOL,2237,1144,1093,890,1347,ITF,ITF2,14,Molise,Molise,305617,29016,9.49,0.73
21,2021-04-05,MOL,391,189,202,292,99,ITF,ITF2,14,Molise,Molise,305617,29407,9.62,0.13
22,2021-03-29,MOL,2033,835,1198,1547,486,ITF,ITF2,14,Molise,Molise,305617,31440,10.29,0.67
23,2021-01-31,MOL,268,70,198,6,262,ITF,ITF2,14,Molise,Molise,305617,31708,10.38,0.09
24,2021-01-12,MOL,336,114,222,336,0,ITF,ITF2,14,Molise,Molise,305617,32044,10.49,0.11
25,2021-02-24,MOL,666,278,388,333,333,ITF,ITF2,14,Molise,Molise,305617,32710,10.7,0.22
26,2021-05-01,MOL,2646,1267,1379,423,2223,ITF,ITF2,14,Molise,Molise,305617,35356,11.57,0.87
27,2021-03-05,MOL,1219,649,570,1015,204,ITF,ITF2,14,Molise,Molise,305617,36575,11.97,0.4
28,2021-04-17,MOL,3051,1500,1551,1565,1486,ITF,ITF2,14,Molise,Molise,305617,39626,12.97,1.0
29,2021-04-24,MOL,2551,1202,1349,710,1841,ITF,ITF2,14,Molise,Molise,305617,42177,13.8,0.83
30,2021-02-26,MOL,563,260,303,490,73,ITF,ITF2,14,Molise,Molise,305617,42740,13.98,0.18
31,2021-06-06,MOL,2007,1035,972,1685,322,ITF,ITF2,14,Molise,Molise,305617,44747,14.64,0.66
32,2021-03-19,MOL,1184,482,702,757,427,ITF,ITF2,14,Molise,Molise,305617,45931,15.03,0.39
33,2021-01-21,MOL,6,2,4,6,0,ITF,ITF2,14,Molise,Molise,305617,45937,15.03,0.0
34,2021-01-09,MOL,450,152,298,450,0,ITF,ITF2,14,Molise,Molise,305617,46387,15.18,0.15
35,2021-04-19,MOL,1827,842,985,1049,778,ITF,ITF2,14,Molise,Molise,305617,48214,15.78,0.6
36,2021-04-28,MOL,1686,916,770,469,1217,ITF,ITF2,14,Molise,Molise,305617,49900,16.33,0.55
37,2021-02-21,MOL,574,227,347,572,2,ITF,ITF2,14,Molise,Molise,305617,50474,16.52,0.19
38,2021-02-04,MOL,758,295,463,77,681,ITF,ITF2,14,Molise,Molise,305617,51232,16.76,0.25
39,2021-05-15,MOL,2979,1398,1581,2595,384,ITF,ITF2,14,Molise,Molise,305617,54211,17.74,0.97
40,2021-02-02,MOL,539,176,363,216,323,ITF,ITF2,14,Molise,Molise,305617,54750,17.91,0.18
41,2021-03-02,MOL,667,383,284,509,158,ITF,ITF2,14,Molise,Molise,305617,55417,18.13,0.22
42,2021-04-02,MOL,1453,708,745,676,777,ITF,ITF2,14,Molise,Molise,305617,56870,18.61,0.48
43,2021-05-08,MOL,2973,1454,1519,1729,1244,ITF,ITF2,14,Molise,Molise,305617,59843,19.58,0.97
44,2021-04-21,MOL,1863,789,1074,968,895,ITF,ITF2,14,Molise,Molise,305617,61706,20.19,0.61
45,2021-05-25,MOL,1963,887,1076,1333,630,ITF,ITF2,14,Molise,Molise,305617,63669,20.83,0.64
46,2021-01-04,MOL,314,131,183,314,0,ITF,ITF2,14,Molise,Molise,305617,63983,20.94,0.1
47,2021-04-14,MOL,1806,767,1039,1145,661,ITF,ITF2,14,Molise,Molise,305617,65789,21.53,0.59
48,2021-02-16,MOL,156,70,86,150,6,ITF,ITF2,14,Molise,Molise,305617,65945,21.58,0.05
49,2021-05-27,MOL,2834,1348,1486,1998,836,ITF,ITF2,14,Molise,Molise,305617,68779,22.5,0.93
50,2021-05-29,MOL,2326,1207,1119,1940,386,ITF,ITF2,14,Molise,Molise,305617,71105,23.27,0.76
51,2021-02-09,MOL,359,170,189,197,162,ITF,ITF2,14,Molise,Molise,305617,71464,23.38,0.12
52,2021-04-12,MOL,1299,557,742,1048,251,ITF,ITF2,14,Molise,Molise,305617,72763,23.81,0.43
53,2021-03-07,MOL,1132,501,631,1130,2,ITF,ITF2,14,Molise,Molise,305617,73895,24.18,0.37
54,2021-01-28,MOL,613,217,396,17,596,ITF,ITF2,14,Molise,Molise,305617,74508,24.38,0.2
55,2021-03-12,MOL,1459,637,822,1423,36,ITF,ITF2,14,Molise,Molise,305617,75967,24.86,0.48
56,2021-01-14,MOL,646,239,407,646,0,ITF,ITF2,14,Molise,Molise,305617,76613,25.07,0.21
57,2021-03-31,MOL,2193,919,1274,1374,819,ITF,ITF2,14,Molise,Molise,305617,78806,25.79,0.72
58,2021-02-23,MOL,582,223,359,363,219,ITF,ITF2,14,Molise,Molise,305617,79388,25.98,0.19
59,2021-06-03,MOL,3133,1500,1633,2611,522,ITF,ITF2,14,Molise,Molise,305617,82521,27.0,1.03
60,2021-04-07,MOL,1688,847,841,1413,275,ITF,ITF2,14,Molise,Molise,305617,84209,27.55,0.55
61,2021-03-03,MOL,672,316,356,590,82,ITF,ITF2,14,Molise,Molise,305617,84881,27.77,0.22
62,2021-01-05,MOL,449,180,269,449,0,ITF,ITF2,14,Molise,Molise,305617,85330,27.92,0.15
63,2021-05-10,MOL,2889,1285,1604,2516,373,ITF,ITF2,14,Molise,Molise,305617,88219,28.87,0.95
64,2021-05-03,MOL,2484,1164,1320,2321,163,ITF,ITF2,14,Molise,Molise,305617,90703,29.68,0.81
65,2021-05-17,MOL,2228,1092,1136,1732,496,ITF,ITF2,14,Molise,Molise,305617,92931,30.41,0.73
66,2021-03-21,MOL,1246,542,704,479,767,ITF,ITF2,14,Molise,Molise,305617,94177,30.82,0.41
67,2021-02-28,MOL,832,334,498,790,42,ITF,ITF2,14,Molise,Molise,305617,95009,31.09,0.27
68,2021-02-27,MOL,1366,568,798,1347,19,ITF,ITF2,14,Molise,Molise,305617,96375,31.53,0.45
69,2021-06-07,MOL,1901,841,1060,1128,773,ITF,ITF2,14,Molise,Molise,305617,98276,32.16,0.62
70,2021-02-13,MOL,132,80,52,132,0,ITF,ITF2,14,Molise,Molise,305617,98408,32.2,0.04
71,2021-05-24,MOL,1959,851,1108,1293,666,ITF,ITF2,14,Molise,Molise,305617,100367,32.84,0.64
72,2021-05-07,MOL,2641,1226,1415,2044,597,ITF,ITF2,14,Molise,Molise,305617,103008,33.7,0.86
73,2021-04-18,MOL,1083,483,600,149,934,ITF,ITF2,14,Molise,Molise,305617,104091,34.06,0.35
74,2021-04-04,MOL,253,141,112,238,15,ITF,ITF2,14,Molise,Molise,305617,104344,34.14,0.08
75,2021-03-18,MOL,1156,476,680,692,464,ITF,ITF2,14,Molise,Molise,305617,105500,34.52,0.38
76,2021-02-11,MOL,293,133,160,257,36,ITF,ITF2,14,Molise,Molise,305617,105793,34.62,0.1
77,2021-05-22,MOL,1311,709,602,1227,84,ITF,ITF2,14,Molise,Molise,305617,107104,35.05,0.43
78,2021-03-16,MOL,614,230,384,267,347,ITF,ITF2,14,Molise,Molise,305617,107718,35.25,0.2
79,2021-01-11,MOL,557,194,363,557,0,ITF,ITF2,14,Molise,Molise,305617,108275,35.43,0.18
80,2021-03-26,MOL,2575,1045,1530,1933,642,ITF,ITF2,14,Molise,Molise,305617,110850,36.27,0.84
81,2021-02-18,MOL,319,74,245,306,13,ITF,ITF2,14,Molise,Molise,305617,111169,36.38,0.1
82,2021-03-09,MOL,1329,579,750,1177,152,ITF,ITF2,14,Molise,Molise,305617,112498,36.81,0.43
83,2021-02-20,MOL,1018,441,577,998,20,ITF,ITF2,14,Molise,Molise,305617,113516,37.14,0.33
84,2021-05-31,MOL,2273,1076,1197,1923,350,ITF,ITF2,14,Molise,Molise,305617,115789,37.89,0.74
85,2021-05-14,MOL,2644,1215,1429,1926,718,ITF,ITF2,14,Molise,Molise,305617,118433,38.75,0.87
86,2021-06-02,MOL,2748,1335,1413,2706,42,ITF,ITF2,14,Molise,Molise,305617,121181,39.65,0.9
87,2021-03-11,MOL,1463,636,827,1457,6,ITF,ITF2,14,Molise,Molise,305617,122644,40.13,0.48
88,2021-01-06,MOL,689,260,429,689,0,ITF,ITF2,14,Molise,Molise,305617,123333,40.36,0.23
89,2021-04-16,MOL,2430,1033,1397,1198,1232,ITF,ITF2,14,Molise,Molise,305617,125763,41.15,0.8
90,2021-04-25,MOL,792,395,397,559,233,ITF,ITF2,14,Molise,Molise,305617,126555,41.41,0.26
91,2021-01-16,MOL,420,166,254,420,0,ITF,ITF2,14,Molise,Molise,305617,126975,41.55,0.14
92,2021-04-26,MOL,1157,521,636,826,331,ITF,ITF2,14,Molise,Molise,305617,128132,41.93,0.38
93,2021-04-09,MOL,2318,1248,1070,2127,191,ITF,ITF2,14,Molise,Molise,305617,130450,42.68,0.76
94,2021-01-18,MOL,114,48,66,114,0,ITF,ITF2,14,Molise,Molise,305617,130564,42.72,0.04
95,2021-04-11,MOL,1196,591,605,1182,14,ITF,ITF2,14,Molise,Molise,305617,131760,43.11,0.39
96,2021-05-26,MOL,1540,691,849,793,747,ITF,ITF2,14,Molise,Molise,305617,133300,43.62,0.5
97,2021-03-30,MOL,2003,857,1146,1491,512,ITF,ITF2,14,Molise,Molise,305617,135303,44.27,0.66
98,2021-02-01,MOL,562,201,361,14,548,ITF,ITF2,14,Molise,Molise,305617,135865,44.46,0.18
99,2021-05-12,MOL,2847,1291,1556,2751,96,ITF,ITF2,14,Molise,Molise,305617,138712,45.39,0.93
100,2021-04-06,MOL,1494,701,793,1151,343,ITF,ITF2,14,Molise,Molise,305617,140206,45.88,0.49
101,2021-02-08,MOL,334,141,193,216,118,ITF,ITF2,14,Molise,Molise,305617,140540,45.99,0.11
102,2021-05-19,MOL,2338,1205,1133,1913,425,ITF,ITF2,14,Molise,Molise,305617,142878,46.75,0.77
103,2021-03-23,MOL,1642,694,948,1435,207,ITF,ITF2,14,Molise,Molise,305617,144520,47.29,0.54
104,2021-02-15,MOL,144,70,74,141,3,ITF,ITF2,14,Molise,Molise,305617,144664,47.34,0.05
105,2021-06-05,MOL,2827,1434,1393,2686,141,ITF,ITF2,14,Molise,Molise,305617,147491,48.26,0.93
106,2021-03-04,MOL,850,417,433,526,324,ITF,ITF2,14,Molise,Molise,305617,148341,48.54,0.28
107,2021-01-20,MOL,18,8,10,18,0,ITF,ITF2,14,Molise,Molise,305617,148359,48.54,0.01
108,2021-02-10,MOL,151,79,72,131,20,ITF,ITF2,14,Molise,Molise,305617,148510,48.59,0.05
109,2021-05-21,MOL,2095,1050,1045,1773,322,ITF,ITF2,14,Molise,Molise,305617,150605,49.28,0.69
110,2021-01-27,MOL,674,251,423,8,666,ITF,ITF2,14,Molise,Molise,305617,151279,49.5,0.22
111,2021-01-08,MOL,429,141,288,429,0,ITF,ITF2,14,Molise,Molise,305617,151708,49.64,0.14
112,2021-04-01,MOL,1469,667,802,743,726,ITF,ITF2,14,Molise,Molise,305617,153177,50.12,0.48
113,2021-02-03,MOL,731,249,482,338,393,ITF,ITF2,14,Molise,Molise,305617,153908,50.36,0.24
114,2021-04-27,MOL,1593,767,826,465,1128,ITF,ITF2,14,Molise,Molise,305617,155501,50.88,0.52
115,2021-05-16,MOL,1247,571,676,1065,182,ITF,ITF2,14,Molise,Molise,305617,156748,51.29,0.41
116,2021-01-25,MOL,319,130,189,3,316,ITF,ITF2,14,Molise,Molise,305617,157067,51.39,0.1
117,2021-05-05,MOL,2413,1042,1371,2272,141,ITF,ITF2,14,Molise,Molise,305617,159480,52.18,0.79
118,2021-05-04,MOL,2705,1181,1524,2577,128,ITF,ITF2,14,Molise,Molise,305617,162185,53.07,0.89
119,2021-01-10,MOL,270,72,198,270,0,ITF,ITF2,14,Molise,Molise,305617,162455,53.16,0.09
120,2021-04-20,MOL,2318,1025,1293,1220,1098,ITF,ITF2,14,Molise,Molise,305617,164773,53.91,0.76
121,2021-06-09,MOL,634,372,262,338,296,ITF,ITF2,14,Molise,Molise,305617,165407,54.12,0.21
122,2021-05-23,MOL,1699,863,836,1694,5,ITF,ITF2,14,Molise,Molise,305617,167106,54.68,0.56
123,2021-03-25,MOL,1806,730,1076,1309,497,ITF,ITF2,14,Molise,Molise,305617,168912,55.27,0.59
124,2021-03-08,MOL,1379,522,857,1239,140,ITF,ITF2,14,Molise,Molise,305617,170291,55.72,0.45
125,2021-04-13,MOL,1630,718,912,1043,587,ITF,ITF2,14,Molise,Molise,305617,171921,56.25,0.53
126,2021-03-27,MOL,2743,1273,1470,1310,1433,ITF,ITF2,14,Molise,Molise,305617,174664,57.15,0.9
127,2021-05-30,MOL,1827,908,919,1543,284,ITF,ITF2,14,Molise,Molise,305617,176491,57.75,0.6
128,2021-02-22,MOL,265,129,136,250,15,ITF,ITF2,14,Molise,Molise,305617,176756,57.84,0.09
129,2020-12-27,MOL,50,20,30,50,0,ITF,ITF2,14,Molise,Molise,305617,176806,57.85,0.02
130,2021-01-13,MOL,474,160,314,474,0,ITF,ITF2,14,Molise,Molise,305617,177280,58.01,0.16
131,2021-04-23,MOL,2049,882,1167,1390,659,ITF,ITF2,14,Molise,Molise,305617,179329,58.68,0.67
132,2021-03-13,MOL,1189,594,595,200,989,ITF,ITF2,14,Molise,Molise,305617,180518,59.07,0.39
133,2021-01-15,MOL,538,242,296,538,0,ITF,ITF2,14,Molise,Molise,305617,181056,59.24,0.18
134,2021-03-01,MOL,661,274,387,447,214,ITF,ITF2,14,Molise,Molise,305617,181717,59.46,0.22
135,2021-04-03,MOL,1770,850,920,1735,35,ITF,ITF2,14,Molise,Molise,305617,183487,60.04,0.58
136,2021-04-30,MOL,2936,1555,1381,830,2106,ITF,ITF2,14,Molise,Molise,305617,186423,61.0,0.96
137,2021-02-25,MOL,541,239,302,473,68,ITF,ITF2,14,Molise,Molise,305617,186964,61.18,0.18
138,2021-01-29,MOL,421,136,285,6,415,ITF,ITF2,14,Molise,Molise,305617,187385,61.31,0.14
139,2021-05-09,MOL,2051,932,1119,1955,96,ITF,ITF2,14,Molise,Molise,305617,189436,61.98,0.67
140,2021-05-11,MOL,3206,1414,1792,2956,250,ITF,ITF2,14,Molise,Molise,305617,192642,63.03,1.05
141,2021-01-22,MOL,126,35,91,126,0,ITF,ITF2,14,Molise,Molise,305617,192768,63.08,0.04
142,2021-05-02,MOL,1892,932,960,588,1304,ITF,ITF2,14,Molise,Molise,305617,194660,63.69,0.62
143,2021-03-06,MOL,1728,807,921,1569,159,ITF,ITF2,14,Molise,Molise,305617,196388,64.26,0.57
144,2021-03-20,MOL,2321,968,1353,1000,1321,ITF,ITF2,14,Molise,Molise,305617,198709,65.02,0.76
145,2021-03-14,MOL,596,240,356,17,579,ITF,ITF2,14,Molise,Molise,305617,199305,65.21,0.2
146,2021-03-28,MOL,1626,747,879,524,1102,ITF,ITF2,14,Molise,Molise,305617,200931,65.75,0.53
147,2021-01-30,MOL,461,158,303,12,449,ITF,ITF2,14,Molise,Molise,305617,201392,65.9,0.15
148,2021-02-06,MOL,429,179,250,29,400,ITF,ITF2,14,Molise,Molise,305617,201821,66.04,0.14
149,2021-06-04,MOL,2860,1393,1467,2432,428,ITF,ITF2,14,Molise,Molise,305617,204681,66.97,0.94
150,2021-04-08,MOL,1766,903,863,1564,202,ITF,ITF2,14,Molise,Molise,305617,206447,67.55,0.58
151,2021-04-22,MOL,1844,863,981,1065,779,ITF,ITF2,14,Molise,Molise,305617,208291,68.15,0.6
152,2021-02-17,MOL,72,32,40,57,15,ITF,ITF2,14,Molise,Molise,305617,208363,68.18,0.02
153,2021-05-28,MOL,2493,1301,1192,1980,513,ITF,ITF2,14,Molise,Molise,305617,210856,68.99,0.82
154,2021-04-15,MOL,1924,793,1131,1080,844,ITF,ITF2,14,Molise,Molise,305617,212780,69.62,0.63
155,2021-05-19,PIE,32935,15141,17794,21987,10948,ITC,ITC1,1,Piemonte,Piemonte,4356406,32935,0.76,0.76
156,2021-03-14,PIE,8205,3336,4869,5308,2897,ITC,ITC1,1,Piemonte,Piemonte,4356406,41140,0.94,0.19
157,2021-05-10,PIE,28766,13820,14946,15751,13015,ITC,ITC1,1,Piemonte,Piemonte,4356406,69906,1.6,0.66
158,2021-01-30,PIE,5980,2136,3844,218,5762,ITC,ITC1,1,Piemonte,Piemonte,4356406,75886,1.74,0.14
159,2021-03-16,PIE,10523,4269,6254,4463,6060,ITC,ITC1,1,Piemonte,Piemonte,4356406,86409,1.98,0.24
160,2021-05-12,PIE,31734,15074,16660,18961,12773,ITC,ITC1,1,Piemonte,Piemonte,4356406,118143,2.71,0.73
161,2021-03-28,PIE,16056,6899,9157,8435,7621,ITC,ITC1,1,Piemonte,Piemonte,4356406,134199,3.08,0.37
162,2021-04-11,PIE,20824,9317,11507,18663,2161,ITC,ITC1,1,Piemonte,Piemonte,4356406,155023,3.56,0.48
163,2021-01-04,PIE,5564,1679,3885,5564,0,ITC,ITC1,1,Piemonte,Piemonte,4356406,160587,3.69,0.13
164,2021-04-28,PIE,26028,11735,14293,15996,10032,ITC,ITC1,1,Piemonte,Piemonte,4356406,186615,4.28,0.6
165,2021-01-18,PIE,6166,2048,4118,5917,249,ITC,ITC1,1,Piemonte,Piemonte,4356406,192781,4.43,0.14
166,2021-02-04,PIE,10203,3339,6864,588,9615,ITC,ITC1,1,Piemonte,Piemonte,4356406,202984,4.66,0.23
167,2021-04-30,PIE,31770,14277,17493,18444,13326,ITC,ITC1,1,Piemonte,Piemonte,4356406,234754,5.39,0.73
168,2021-05-24,PIE,28621,13132,15489,16983,11638,ITC,ITC1,1,Piemonte,Piemonte,4356406,263375,6.05,0.66
169,2021-03-02,PIE,11202,4506,6696,10386,816,ITC,ITC1,1,Piemonte,Piemonte,4356406,274577,6.3,0.26
170,2021-04-23,PIE,27439,12599,14840,20677,6762,ITC,ITC1,1,Piemonte,Piemonte,4356406,302016,6.93,0.63
171,2021-04-04,PIE,9254,4059,5195,6541,2713,ITC,ITC1,1,Piemonte,Piemonte,4356406,311270,7.15,0.21
172,2021-04-21,PIE,25742,11833,13909,20408,5334,ITC,ITC1,1,Piemonte,Piemonte,4356406,337012,7.74,0.59
173,2021-01-11,PIE,8744,2980,5764,8744,0,ITC,ITC1,1,Piemonte,Piemonte,4356406,345756,7.94,0.2
174,2021-03-23,PIE,13077,5451,7626,6832,6245,ITC,ITC1,1,Piemonte,Piemonte,4356406,358833,8.24,0.3
175,2021-01-16,PIE,7771,2630,5141,7771,0,ITC,ITC1,1,Piemonte,Piemonte,4356406,366604,8.42,0.18
176,2021-01-23,PIE,4257,1325,2932,879,3378,ITC,ITC1,1,Piemonte,Piemonte,4356406,370861,8.51,0.1
177,2021-03-21,PIE,10724,4739,5985,4191,6533,ITC,ITC1,1,Piemonte,Piemonte,4356406,381585,8.76,0.25
178,2021-05-05,PIE,32139,15047,17092,19129,13010,ITC,ITC1,1,Piemonte,Piemonte,4356406,413724,9.5,0.74
179,2021-02-11,PIE,6764,2107,4657,3006,3758,ITC,ITC1,1,Piemonte,Piemonte,4356406,420488,9.65,0.16
180,2021-04-09,PIE,25848,11387,14461,21339,4509,ITC,ITC1,1,Piemonte,Piemonte,4356406,446336,10.25,0.59
181,2020-12-30,PIE,730,322,408,730,0,ITC,ITC1,1,Piemonte,Piemonte,4356406,447066,10.26,0.02
182,2021-06-05,PIE,34690,17646,17044,30252,4438,ITC,ITC1,1,Piemonte,Piemonte,4356406,481756,11.06,0.8
183,2021-02-25,PIE,12218,5252,6966,11671,547,ITC,ITC1,1,Piemonte,Piemonte,4356406,493974,11.34,0.28
184,2021-04-02,PIE,20131,8298,11833,11704,8427,ITC,ITC1,1,Piemonte,Piemonte,4356406,514105,11.8,0.46
185,2021-05-29,PIE,32755,15214,17541,20602,12153,ITC,ITC1,1,Piemonte,Piemonte,4356406,546860,12.55,0.75
186,2021-02-18,PIE,4790,2093,2697,4360,430,ITC,ITC1,1,Piemonte,Piemonte,4356406,551650,12.66,0.11
187,2021-04-16,PIE,28394,13209,15185,23409,4985,ITC,ITC1,1,Piemonte,Piemonte,4356406,580044,13.31,0.65
188,2021-06-07,PIE,34442,17594,16848,29759,4683,ITC,ITC1,1,Piemonte,Piemonte,4356406,614486,14.11,0.79
189,2020-12-28,PIE,1,1,0,1,0,ITC,ITC1,1,Piemonte,Piemonte,4356406,614487,14.11,0.0
190,2021-05-02,PIE,25056,11264,13792,14311,10745,ITC,ITC1,1,Piemonte,Piemonte,4356406,639543,14.68,0.58
191,2021-06-02,PIE,26521,12996,13525,22056,4465,ITC,ITC1,1,Piemonte,Piemonte,4356406,666064,15.29,0.61
192,2021-02-22,PIE,8483,3472,5011,7893,590,ITC,ITC1,1,Piemonte,Piemonte,4356406,674547,15.48,0.19
193,2021-03-11,PIE,13772,5074,8698,10675,3097,ITC,ITC1,1,Piemonte,Piemonte,4356406,688319,15.8,0.32
194,2021-03-25,PIE,17062,7203,9859,8423,8639,ITC,ITC1,1,Piemonte,Piemonte,4356406,705381,16.19,0.39
195,2021-04-13,PIE,25929,11608,14321,22469,3460,ITC,ITC1,1,Piemonte,Piemonte,4356406,731310,16.79,0.6
196,2021-01-20,PIE,6616,2089,4527,5899,717,ITC,ITC1,1,Piemonte,Piemonte,4356406,737926,16.94,0.15
197,2021-02-03,PIE,10199,3303,6896,611,9588,ITC,ITC1,1,Piemonte,Piemonte,4356406,748125,17.17,0.23
198,2021-04-20,PIE,25471,11661,13810,19125,6346,ITC,ITC1,1,Piemonte,Piemonte,4356406,773596,17.76,0.58
199,2021-05-07,PIE,32950,15552,17398,18904,14046,ITC,ITC1,1,Piemonte,Piemonte,4356406,806546,18.51,0.76
200,2021-01-27,PIE,4196,1453,2743,999,3197,ITC,ITC1,1,Piemonte,Piemonte,4356406,810742,18.61,0.1
201,2021-02-13,PIE,4153,1334,2819,2931,1222,ITC,ITC1,1,Piemonte,Piemonte,4356406,814895,18.71,0.1
202,2021-05-09,PIE,27055,12900,14155,13447,13608,ITC,ITC1,1,Piemonte,Piemonte,4356406,841950,19.33,0.62
203,2021-05-26,PIE,32335,14806,17529,15618,16717,ITC,ITC1,1,Piemonte,Piemonte,4356406,874285,20.07,0.74
204,2021-02-15,PIE,4432,1597,2835,3227,1205,ITC,ITC1,1,Piemonte,Piemonte,4356406,878717,20.17,0.1
205,2021-03-04,PIE,14497,5734,8763,11549,2948,ITC,ITC1,1,Piemonte,Piemonte,4356406,893214,20.5,0.33
206,2021-05-17,PIE,30617,14373,16244,17674,12943,ITC,ITC1,1,Piemonte,Piemonte,4356406,923831,21.21,0.7
207,2021-02-06,PIE,7995,2666,5329,400,7595,ITC,ITC1,1,Piemonte,Piemonte,4356406,931826,21.39,0.18
208,2021-02-23,PIE,9234,3713,5521,8653,581,ITC,ITC1,1,Piemonte,Piemonte,4356406,941060,21.6,0.21
209,2021-05-31,PIE,28877,13886,14991,20489,8388,ITC,ITC1,1,Piemonte,Piemonte,4356406,969937,22.26,0.66
210,2021-03-09,PIE,13967,5428,8539,11624,2343,ITC,ITC1,1,Piemonte,Piemonte,4356406,983904,22.59,0.32
211,2021-01-01,PIE,1038,395,643,1038,0,ITC,ITC1,1,Piemonte,Piemonte,4356406,984942,22.61,0.02
212,2021-02-08,PIE,6917,2356,4561,666,6251,ITC,ITC1,1,Piemonte,Piemonte,4356406,991859,22.77,0.16
213,2021-05-21,PIE,35879,16622,19257,20380,15499,ITC,ITC1,1,Piemonte,Piemonte,4356406,1027738,23.59,0.82
214,2021-02-01,PIE,8645,3055,5590,579,8066,ITC,ITC1,1,Piemonte,Piemonte,4356406,1036383,23.79,0.2
215,2021-04-06,PIE,20240,8810,11430,15044,5196,ITC,ITC1,1,Piemonte,Piemonte,4356406,1056623,24.25,0.46
216,2020-12-27,PIE,913,369,544,913,0,ITC,ITC1,1,Piemonte,Piemonte,4356406,1057536,24.28,0.02
217,2021-06-09,PIE,30889,16308,14581,28710,2179,ITC,ITC1,1,Piemonte,Piemonte,4356406,1088425,24.98,0.71
218,2021-03-18,PIE,11757,4804,6953,4029,7728,ITC,ITC1,1,Piemonte,Piemonte,4356406,1100182,25.25,0.27
219,2021-02-27,PIE,12691,4851,7840,12346,345,ITC,ITC1,1,Piemonte,Piemonte,4356406,1112873,25.55,0.29
220,2021-04-25,PIE,20227,9303,10924,17726,2501,ITC,ITC1,1,Piemonte,Piemonte,4356406,1133100,26.01,0.46
221,2021-01-15,PIE,9114,3012,6102,9114,0,ITC,ITC1,1,Piemonte,Piemonte,4356406,1142214,26.22,0.21
222,2021-03-13,PIE,13045,4721,8324,11601,1444,ITC,ITC1,1,Piemonte,Piemonte,4356406,1155259,26.52,0.3
223,2021-04-18,PIE,22961,10819,12142,20205,2756,ITC,ITC1,1,Piemonte,Piemonte,4356406,1178220,27.05,0.53
224,2021-03-30,PIE,16891,7033,9858,9020,7871,ITC,ITC1,1,Piemonte,Piemonte,4356406,1195111,27.43,0.39
225,2021-01-13,PIE,10080,3223,6857,10080,0,ITC,ITC1,1,Piemonte,Piemonte,4356406,1205191,27.66,0.23
226,2021-01-06,PIE,3116,1111,2005,3116,0,ITC,ITC1,1,Piemonte,Piemonte,4356406,1208307,27.74,0.07
227,2021-05-18,PIE,31834,14601,17233,19371,12463,ITC,ITC1,1,Piemonte,Piemonte,4356406,1240141,28.47,0.73
228,2021-01-03,PIE,3063,967,2096,3063,0,ITC,ITC1,1,Piemonte,Piemonte,4356406,1243204,28.54,0.07
229,2021-03-29,PIE,15161,6385,8776,8549,6612,ITC,ITC1,1,Piemonte,Piemonte,4356406,1258365,28.89,0.35
230,2021-02-20,PIE,3833,1253,2580,3659,174,ITC,ITC1,1,Piemonte,Piemonte,4356406,1262198,28.97,0.09
231,2021-04-29,PIE,48330,21871,26459,35712,12618,ITC,ITC1,1,Piemonte,Piemonte,4356406,1310528,30.08,1.11
232,2021-05-16,PIE,28112,12762,15350,15055,13057,ITC,ITC1,1,Piemonte,Piemonte,4356406,1338640,30.73,0.65
233,2021-02-05,PIE,9604,3139,6465,659,8945,ITC,ITC1,1,Piemonte,Piemonte,4356406,1348244,30.95,0.22
234,2021-03-10,PIE,13634,5169,8465,11340,2294,ITC,ITC1,1,Piemonte,Piemonte,4356406,1361878,31.26,0.31
235,2021-03-27,PIE,18387,7829,10558,9556,8831,ITC,ITC1,1,Piemonte,Piemonte,4356406,1380265,31.68,0.42
236,2021-03-03,PIE,12120,4644,7476,11301,819,ITC,ITC1,1,Piemonte,Piemonte,4356406,1392385,31.96,0.28
237,2021-03-20,PIE,11922,4899,7023,6024,5898,ITC,ITC1,1,Piemonte,Piemonte,4356406,1404307,32.24,0.27
238,2021-05-06,PIE,33240,15636,17604,19769,13471,ITC,ITC1,1,Piemonte,Piemonte,4356406,1437547,33.0,0.76
239,2021-05-23,PIE,28689,13127,15562,15749,12940,ITC,ITC1,1,Piemonte,Piemonte,4356406,1466236,33.66,0.66
240,2021-02-12,PIE,6891,2215,4676,3930,2961,ITC,ITC1,1,Piemonte,Piemonte,4356406,1473127,33.82,0.16
241,2021-03-01,PIE,12043,4846,7197,11234,809,ITC,ITC1,1,Piemonte,Piemonte,4356406,1485170,34.09,0.28
242,2021-05-14,PIE,33300,16214,17086,17941,15359,ITC,ITC1,1,Piemonte,Piemonte,4356406,1518470,34.86,0.76
243,2021-04-17,PIE,30450,14145,16305,27135,3315,ITC,ITC1,1,Piemonte,Piemonte,4356406,1548920,35.55,0.7
244,2021-02-10,PIE,7535,2371,5164,1316,6219,ITC,ITC1,1,Piemonte,Piemonte,4356406,1556455,35.73,0.17
245,2021-04-08,PIE,25144,10930,14214,20414,4730,ITC,ITC1,1,Piemonte,Piemonte,4356406,1581599,36.31,0.58
246,2021-04-03,PIE,19430,8156,11274,10883,8547,ITC,ITC1,1,Piemonte,Piemonte,4356406,1601029,36.75,0.45
247,2021-01-10,PIE,5214,2275,2939,5214,0,ITC,ITC1,1,Piemonte,Piemonte,4356406,1606243,36.87,0.12
248,2021-04-22,PIE,27650,12724,14926,20952,6698,ITC,ITC1,1,Piemonte,Piemonte,4356406,1633893,37.51,0.63
249,2021-01-12,PIE,10089,3415,6674,10089,0,ITC,ITC1,1,Piemonte,Piemonte,4356406,1643982,37.74,0.23
250,2021-01-29,PIE,5944,1887,4057,455,5489,ITC,ITC1,1,Piemonte,Piemonte,4356406,1649926,37.87,0.14
251,2021-01-08,PIE,5532,1762,3770,5532,0,ITC,ITC1,1,Piemonte,Piemonte,4356406,1655458,38.0,0.13
252,2021-03-06,PIE,13994,5211,8783,11205,2789,ITC,ITC1,1,Piemonte,Piemonte,4356406,1669452,38.32,0.32
253,2021-01-22,PIE,3867,1249,2618,2526,1341,ITC,ITC1,1,Piemonte,Piemonte,4356406,1673319,38.41,0.09
254,2021-05-13,PIE,35385,17291,18094,20526,14859,ITC,ITC1,1,Piemonte,Piemonte,4356406,1708704,39.22,0.81
255,2021-02-02,PIE,10241,3509,6732,816,9425,ITC,ITC1,1,Piemonte,Piemonte,4356406,1718945,39.46,0.24
256,2021-03-31,PIE,19108,8103,11005,10414,8694,ITC,ITC1,1,Piemonte,Piemonte,4356406,1738053,39.9,0.44
257,2021-05-27,PIE,36990,17130,19860,19064,17926,ITC,ITC1,1,Piemonte,Piemonte,4356406,1775043,40.75,0.85
258,2021-02-16,PIE,3967,1756,2211,3209,758,ITC,ITC1,1,Piemonte,Piemonte,4356406,1779010,40.84,0.09
259,2021-03-24,PIE,15505,6341,9164,6378,9127,ITC,ITC1,1,Piemonte,Piemonte,4356406,1794515,41.19,0.36
260,2021-04-01,PIE,19331,8073,11258,11211,8120,ITC,ITC1,1,Piemonte,Piemonte,4356406,1813846,41.64,0.44
261,2021-05-28,PIE,34683,16340,18343,18952,15731,ITC,ITC1,1,Piemonte,Piemonte,4356406,1848529,42.43,0.8
262,2021-01-25,PIE,6215,1938,4277,983,5232,ITC,ITC1,1,Piemonte,Piemonte,4356406,1854744,42.58,0.14
263,2021-05-30,PIE,27699,13185,14514,18375,9324,ITC,ITC1,1,Piemonte,Piemonte,4356406,1882443,43.21,0.64
264,2021-02-19,PIE,5535,2175,3360,5034,501,ITC,ITC1,1,Piemonte,Piemonte,4356406,1887978,43.34,0.13
265,2021-06-04,PIE,34904,18053,16851,32141,2763,ITC,ITC1,1,Piemonte,Piemonte,4356406,1922882,44.14,0.8
266,2021-02-24,PIE,11409,4629,6780,10904,505,ITC,ITC1,1,Piemonte,Piemonte,4356406,1934291,44.4,0.26
267,2021-06-06,PIE,32579,16924,15655,30162,2417,ITC,ITC1,1,Piemonte,Piemonte,4356406,1966870,45.15,0.75
268,2021-04-12,PIE,22944,10363,12581,19954,2990,ITC,ITC1,1,Piemonte,Piemonte,4356406,1989814,45.68,0.53
269,2021-01-02,PIE,3545,1134,2411,3545,0,ITC,ITC1,1,Piemonte,Piemonte,4356406,1993359,45.76,0.08
270,2021-05-01,PIE,28527,12993,15534,16729,11798,ITC,ITC1,1,Piemonte,Piemonte,4356406,2021886,46.41,0.65
271,2021-01-21,PIE,6923,2318,4605,3427,3496,ITC,ITC1,1,Piemonte,Piemonte,4356406,2028809,46.57,0.16
272,2021-05-15,PIE,33684,15709,17975,20037,13647,ITC,ITC1,1,Piemonte,Piemonte,4356406,2062493,47.34,0.77
273,2021-06-01,PIE,28979,14477,14502,24768,4211,ITC,ITC1,1,Piemonte,Piemonte,4356406,2091472,48.01,0.67
274,2021-02-21,PIE,5090,2083,3007,4988,102,ITC,ITC1,1,Piemonte,Piemonte,4356406,2096562,48.13,0.12
275,2021-03-12,PIE,13949,5183,8766,11014,2935,ITC,ITC1,1,Piemonte,Piemonte,4356406,2110511,48.45,0.32
276,2021-03-26,PIE,17749,6982,10767,8841,8908,ITC,ITC1,1,Piemonte,Piemonte,4356406,2128260,48.85,0.41
277,2021-05-25,PIE,31012,14368,16644,15971,15041,ITC,ITC1,1,Piemonte,Piemonte,4356406,2159272,49.57,0.71
278,2021-04-19,PIE,22537,10766,11771,18173,4364,ITC,ITC1,1,Piemonte,Piemonte,4356406,2181809,50.08,0.52
279,2021-01-09,PIE,6184,2185,3999,6184,0,ITC,ITC1,1,Piemonte,Piemonte,4356406,2187993,50.22,0.14
280,2021-01-26,PIE,6332,1880,4452,735,5597,ITC,ITC1,1,Piemonte,Piemonte,4356406,2194325,50.37,0.15
281,2021-05-08,PIE,34192,16222,17970,18557,15635,ITC,ITC1,1,Piemonte,Piemonte,4356406,2228517,51.15,0.78
282,2021-01-28,PIE,5591,1809,3782,384,5207,ITC,ITC1,1,Piemonte,Piemonte,4356406,2234108,51.28,0.13
283,2021-02-14,PIE,1476,498,978,876,600,ITC,ITC1,1,Piemonte,Piemonte,4356406,2235584,51.32,0.03
284,2021-01-19,PIE,6466,2105,4361,6454,12,ITC,ITC1,1,Piemonte,Piemonte,4356406,2242050,51.47,0.15
285,2021-04-14,PIE,27707,12560,15147,23182,4525,ITC,ITC1,1,Piemonte,Piemonte,4356406,2269757,52.1,0.64
286,2021-02-28,PIE,10816,4060,6756,10576,240,ITC,ITC1,1,Piemonte,Piemonte,4356406,2280573,52.35,0.25
287,2021-03-17,PIE,12518,5055,7463,5224,7294,ITC,ITC1,1,Piemonte,Piemonte,4356406,2293091,52.64,0.29
288,2021-03-19,PIE,11020,4511,6509,4414,6606,ITC,ITC1,1,Piemonte,Piemonte,4356406,2304111,52.89,0.25
289,2021-04-05,PIE,14746,6233,8513,12189,2557,ITC,ITC1,1,Piemonte,Piemonte,4356406,2318857,53.23,0.34
290,2021-05-20,PIE,38333,17724,20609,13589,24744,ITC,ITC1,1,Piemonte,Piemonte,4356406,2357190,54.11,0.88
291,2021-02-09,PIE,7392,2316,5076,722,6670,ITC,ITC1,1,Piemonte,Piemonte,4356406,2364582,54.28,0.17
292,2021-04-07,PIE,23606,9995,13611,18143,5463,ITC,ITC1,1,Piemonte,Piemonte,4356406,2388188,54.82,0.54
293,2021-04-10,PIE,30165,13416,16749,25886,4279,ITC,ITC1,1,Piemonte,Piemonte,4356406,2418353,55.51,0.69
294,2021-04-15,PIE,29636,13574,16062,24152,5484,ITC,ITC1,1,Piemonte,Piemonte,4356406,2447989,56.19,0.68
295,2021-01-05,PIE,5381,1603,3778,5381,0,ITC,ITC1,1,Piemonte,Piemonte,4356406,2453370,56.32,0.12
296,2021-01-07,PIE,5387,1739,3648,5387,0,ITC,ITC1,1,Piemonte,Piemonte,4356406,2458757,56.44,0.12
297,2021-03-05,PIE,15268,5961,9307,11451,3817,ITC,ITC1,1,Piemonte,Piemonte,4356406,2474025,56.79,0.35
298,2021-03-07,PIE,11977,4658,7319,11099,878,ITC,ITC1,1,Piemonte,Piemonte,4356406,2486002,57.07,0.27
299,2021-06-03,PIE,33722,17231,16491,29596,4126,ITC,ITC1,1,Piemonte,Piemonte,4356406,2519724,57.84,0.77
300,2021-02-17,PIE,4793,2156,2637,3803,990,ITC,ITC1,1,Piemonte,Piemonte,4356406,2524517,57.95,0.11
301,2021-06-08,PIE,36896,19116,17780,34181,2715,ITC,ITC1,1,Piemonte,Piemonte,4356406,2561413,58.8,0.85
302,2021-04-26,PIE,19764,8734,11030,15365,4399,ITC,ITC1,1,Piemonte,Piemonte,4356406,2581177,59.25,0.45
303,2021-05-03,PIE,26648,12162,14486,12509,14139,ITC,ITC1,1,Piemonte,Piemonte,4356406,2607825,59.86,0.61
304,2021-02-26,PIE,12293,4933,7360,11556,737,ITC,ITC1,1,Piemonte,Piemonte,4356406,2620118,60.14,0.28
305,2021-04-24,PIE,27454,12420,15034,21812,5642,ITC,ITC1,1,Piemonte,Piemonte,4356406,2647572,60.77,0.63
306,2021-01-14,PIE,9766,3152,6614,9766,0,ITC,ITC1,1,Piemonte,Piemonte,4356406,2657338,61.0,0.22
307,2020-12-31,PIE,3909,1334,2575,3909,0,ITC,ITC1,1,Piemonte,Piemonte,4356406,2661247,61.09,0.09
308,2021-03-08,PIE,13950,5296,8654,11236,2714,ITC,ITC1,1,Piemonte,Piemonte,4356406,2675197,61.41,0.32
309,2021-05-04,PIE,28493,13083,15410,16398,12095,ITC,ITC1,1,Piemonte,Piemonte,4356406,2703690,62.06,0.65
310,2021-01-24,PIE,3153,959,2194,434,2719,ITC,ITC1,1,Piemonte,Piemonte,4356406,2706843,62.13,0.07
311,2021-03-22,PIE,11512,4882,6630,3906,7606,ITC,ITC1,1,Piemonte,Piemonte,4356406,2718355,62.4,0.26
312,2021-04-27,PIE,22581,10208,12373,17444,5137,ITC,ITC1,1,Piemonte,Piemonte,4356406,2740936,62.92,0.52
313,2021-01-17,PIE,3518,1168,2350,2870,648,ITC,ITC1,1,Piemonte,Piemonte,4356406,2744454,63.0,0.08
314,2021-03-15,PIE,10661,4164,6497,5041,5620,ITC,ITC1,1,Piemonte,Piemonte,4356406,2755115,63.24,0.24
315,2021-05-11,PIE,31981,15402,16579,18841,13140,ITC,ITC1,1,Piemonte,Piemonte,4356406,2787096,63.98,0.73
316,2021-01-31,PIE,4113,1753,2360,112,4001,ITC,ITC1,1,Piemonte,Piemonte,4356406,2791209,64.07,0.09
317,2021-02-07,PIE,3088,974,2114,445,2643,ITC,ITC1,1,Piemonte,Piemonte,4356406,2794297,64.14,0.07
318,2021-05-22,PIE,33359,15071,18288,17232,16127,ITC,ITC1,1,Piemonte,Piemonte,4356406,2827656,64.91,0.77
319,2021-02-13,SIC,2976,1122,1854,2721,255,ITG,ITG1,19,Sicilia,Sicilia,4999891,2976,0.06,0.06
320,2021-05-24,SIC,35484,17082,18402,15739,19745,ITG,ITG1,19,Sicilia,Sicilia,4999891,38460,0.77,0.71
321,2021-05-17,SIC,31891,15362,16529,19237,12654,ITG,ITG1,19,Sicilia,Sicilia,4999891,70351,1.41,0.64
322,2021-03-21,SIC,15208,7330,7878,11238,3970,ITG,ITG1,19,Sicilia,Sicilia,4999891,85559,1.71,0.3
323,2021-02-06,SIC,4685,2088,2597,1464,3221,ITG,ITG1,19,Sicilia,Sicilia,4999891,90244,1.8,0.09
324,2021-02-04,SIC,6692,3044,3648,1451,5241,ITG,ITG1,19,Sicilia,Sicilia,4999891,96936,1.94,0.13
325,2021-02-25,SIC,9866,5156,4710,8704,1162,ITG,ITG1,19,Sicilia,Sicilia,4999891,106802,2.14,0.2
326,2021-06-05,SIC,59363,28250,31113,48800,10563,ITG,ITG1,19,Sicilia,Sicilia,4999891,166165,3.32,1.19
327,2021-03-14,SIC,8774,3928,4846,4938,3836,ITG,ITG1,19,Sicilia,Sicilia,4999891,174939,3.5,0.18
328,2021-02-11,SIC,5235,2060,3175,4774,461,ITG,ITG1,19,Sicilia,Sicilia,4999891,180174,3.6,0.1
329,2021-06-07,SIC,48788,22922,25866,41055,7733,ITG,ITG1,19,Sicilia,Sicilia,4999891,228962,4.58,0.98
330,2021-01-25,SIC,7397,3670,3727,300,7097,ITG,ITG1,19,Sicilia,Sicilia,4999891,236359,4.73,0.15
331,2021-05-05,SIC,26165,12119,14046,16676,9489,ITG,ITG1,19,Sicilia,Sicilia,4999891,262524,5.25,0.52
332,2021-05-19,SIC,42518,20514,22004,28311,14207,ITG,ITG1,19,Sicilia,Sicilia,4999891,305042,6.1,0.85
333,2021-03-16,SIC,9557,4276,5281,3623,5934,ITG,ITG1,19,Sicilia,Sicilia,4999891,314599,6.29,0.19
334,2021-05-31,SIC,37604,16791,20813,21513,16091,ITG,ITG1,19,Sicilia,Sicilia,4999891,352203,7.04,0.75
335,2021-02-18,SIC,5276,3100,2176,4847,429,ITG,ITG1,19,Sicilia,Sicilia,4999891,357479,7.15,0.11
336,2021-05-12,SIC,36673,17250,19423,21823,14850,ITG,ITG1,19,Sicilia,Sicilia,4999891,394152,7.88,0.73
337,2021-04-11,SIC,15336,7575,7761,8306,7030,ITG,ITG1,19,Sicilia,Sicilia,4999891,409488,8.19,0.31
338,2020-12-30,SIC,176,102,74,176,0,ITG,ITG1,19,Sicilia,Sicilia,4999891,409664,8.19,0.0
339,2021-01-16,SIC,2456,1098,1358,2456,0,ITG,ITG1,19,Sicilia,Sicilia,4999891,412120,8.24,0.05
340,2021-04-09,SIC,20241,9863,10378,11166,9075,ITG,ITG1,19,Sicilia,Sicilia,4999891,432361,8.65,0.4
341,2021-03-23,SIC,20776,9958,10818,15262,5514,ITG,ITG1,19,Sicilia,Sicilia,4999891,453137,9.06,0.42
342,2020-12-28,SIC,211,126,85,211,0,ITG,ITG1,19,Sicilia,Sicilia,4999891,453348,9.07,0.0
343,2021-01-30,SIC,7628,3497,4131,168,7460,ITG,ITG1,19,Sicilia,Sicilia,4999891,460976,9.22,0.15
344,2021-03-28,SIC,10913,5132,5781,6902,4011,ITG,ITG1,19,Sicilia,Sicilia,4999891,471889,9.44,0.22
345,2021-04-04,SIC,6824,3325,3499,5532,1292,ITG,ITG1,19,Sicilia,Sicilia,4999891,478713,9.57,0.14
346,2021-03-02,SIC,14607,6251,8356,11835,2772,ITG,ITG1,19,Sicilia,Sicilia,4999891,493320,9.87,0.29
347,2021-01-04,SIC,8234,4115,4119,8234,0,ITG,ITG1,19,Sicilia,Sicilia,4999891,501554,10.03,0.16
348,2021-01-18,SIC,1436,581,855,1289,147,ITG,ITG1,19,Sicilia,Sicilia,4999891,502990,10.06,0.03
349,2021-04-28,SIC,29167,13680,15487,20145,9022,ITG,ITG1,19,Sicilia,Sicilia,4999891,532157,10.64,0.58
350,2021-02-23,SIC,8682,4587,4095,8219,463,ITG,ITG1,19,Sicilia,Sicilia,4999891,540839,10.82,0.17
351,2021-03-09,SIC,12806,5437,7369,10607,2199,ITG,ITG1,19,Sicilia,Sicilia,4999891,553645,11.07,0.26
352,2021-01-11,SIC,5755,2533,3222,5755,0,ITG,ITG1,19,Sicilia,Sicilia,4999891,559400,11.19,0.12
353,2021-04-23,SIC,28619,13708,14911,22805,5814,ITG,ITG1,19,Sicilia,Sicilia,4999891,588019,11.76,0.57
354,2021-04-30,SIC,34919,16307,18612,23940,10979,ITG,ITG1,19,Sicilia,Sicilia,4999891,622938,12.46,0.7
355,2021-03-04,SIC,14943,6445,8498,10825,4118,ITG,ITG1,19,Sicilia,Sicilia,4999891,637881,12.76,0.3
356,2021-02-27,SIC,12240,5502,6738,11036,1204,ITG,ITG1,19,Sicilia,Sicilia,4999891,650121,13.0,0.24
357,2021-02-08,SIC,3882,1678,2204,2129,1753,ITG,ITG1,19,Sicilia,Sicilia,4999891,654003,13.08,0.08
358,2021-01-22,SIC,1250,630,620,243,1007,ITG,ITG1,19,Sicilia,Sicilia,4999891,655253,13.11,0.03
359,2021-01-08,SIC,8102,3775,4327,8102,0,ITG,ITG1,19,Sicilia,Sicilia,4999891,663355,13.27,0.16
360,2021-04-18,SIC,19705,9849,9856,15345,4360,ITG,ITG1,19,Sicilia,Sicilia,4999891,683060,13.66,0.39
361,2021-04-08,SIC,16571,8205,8366,8119,8452,ITG,ITG1,19,Sicilia,Sicilia,4999891,699631,13.99,0.33
362,2021-02-20,SIC,7139,3692,3447,6897,242,ITG,ITG1,19,Sicilia,Sicilia,4999891,706770,14.14,0.14
363,2021-02-03,SIC,5916,2776,3140,721,5195,ITG,ITG1,19,Sicilia,Sicilia,4999891,712686,14.25,0.12
364,2021-04-27,SIC,26211,12631,13580,15517,10694,ITG,ITG1,19,Sicilia,Sicilia,4999891,738897,14.78,0.52
365,2021-05-14,SIC,52032,24376,27656,36317,15715,ITG,ITG1,19,Sicilia,Sicilia,4999891,790929,15.82,1.04
366,2021-04-16,SIC,28559,14335,14224,20294,8265,ITG,ITG1,19,Sicilia,Sicilia,4999891,819488,16.39,0.57
367,2021-01-23,SIC,4342,2243,2099,215,4127,ITG,ITG1,19,Sicilia,Sicilia,4999891,823830,16.48,0.09
368,2021-01-06,SIC,6229,3280,2949,6229,0,ITG,ITG1,19,Sicilia,Sicilia,4999891,830059,16.6,0.12
369,2021-04-02,SIC,13841,6520,7321,9108,4733,ITG,ITG1,19,Sicilia,Sicilia,4999891,843900,16.88,0.28
370,2021-02-10,SIC,4355,1777,2578,3973,382,ITG,ITG1,19,Sicilia,Sicilia,4999891,848255,16.97,0.09
371,2021-05-21,SIC,45685,21501,24184,24376,21309,ITG,ITG1,19,Sicilia,Sicilia,4999891,893940,17.88,0.91
372,2021-04-01,SIC,14216,6582,7634,9552,4664,ITG,ITG1,19,Sicilia,Sicilia,4999891,908156,18.16,0.28
373,2021-01-01,SIC,816,437,379,816,0,ITG,ITG1,19,Sicilia,Sicilia,4999891,908972,18.18,0.02
374,2021-04-20,SIC,19127,9012,10115,13879,5248,ITG,ITG1,19,Sicilia,Sicilia,4999891,928099,18.56,0.38
375,2021-03-25,SIC,20282,9403,10879,14817,5465,ITG,ITG1,19,Sicilia,Sicilia,4999891,948381,18.97,0.41
376,2021-03-06,SIC,12640,5059,7581,9858,2782,ITG,ITG1,19,Sicilia,Sicilia,4999891,961021,19.22,0.25
377,2021-05-28,SIC,50972,22753,28219,24694,26278,ITG,ITG1,19,Sicilia,Sicilia,4999891,1011993,20.24,1.02
378,2021-05-07,SIC,36486,17238,19248,24930,11556,ITG,ITG1,19,Sicilia,Sicilia,4999891,1048479,20.97,0.73
379,2021-03-11,SIC,15091,6383,8708,12721,2370,ITG,ITG1,19,Sicilia,Sicilia,4999891,1063570,21.27,0.3
380,2021-01-27,SIC,7278,3711,3567,181,7097,ITG,ITG1,19,Sicilia,Sicilia,4999891,1070848,21.42,0.15
381,2021-01-13,SIC,5118,2421,2697,5118,0,ITG,ITG1,19,Sicilia,Sicilia,4999891,1075966,21.52,0.1
382,2021-01-20,SIC,785,398,387,531,254,ITG,ITG1,19,Sicilia,Sicilia,4999891,1076751,21.54,0.02
383,2021-03-18,SIC,15285,7664,7621,9790,5495,ITG,ITG1,19,Sicilia,Sicilia,4999891,1092036,21.84,0.31
384,2021-06-04,SIC,57101,26371,30730,45357,11744,ITG,ITG1,19,Sicilia,Sicilia,4999891,1149137,22.98,1.14
385,2021-04-06,SIC,17625,8451,9174,13343,4282,ITG,ITG1,19,Sicilia,Sicilia,4999891,1166762,23.34,0.35
386,2021-02-22,SIC,7888,4091,3797,7398,490,ITG,ITG1,19,Sicilia,Sicilia,4999891,1174650,23.49,0.16
387,2020-12-27,SIC,92,55,37,92,0,ITG,ITG1,19,Sicilia,Sicilia,4999891,1174742,23.5,0.0
388,2021-06-02,SIC,35158,16238,18920,27394,7764,ITG,ITG1,19,Sicilia,Sicilia,4999891,1209900,24.2,0.7
389,2021-03-01,SIC,12692,6012,6680,11038,1654,ITG,ITG1,19,Sicilia,Sicilia,4999891,1222592,24.45,0.25
390,2021-06-09,SIC,30811,14377,16434,25560,5251,ITG,ITG1,19,Sicilia,Sicilia,4999891,1253403,25.07,0.62
391,2021-05-16,SIC,33131,16133,16998,21807,11324,ITG,ITG1,19,Sicilia,Sicilia,4999891,1286534,25.73,0.66
392,2021-05-02,SIC,24622,11433,13189,18022,6600,ITG,ITG1,19,Sicilia,Sicilia,4999891,1311156,26.22,0.49
393,2021-03-20,SIC,18554,8949,9605,13418,5136,ITG,ITG1,19,Sicilia,Sicilia,4999891,1329710,26.59,0.37
394,2021-03-30,SIC,14423,6670,7753,9660,4763,ITG,ITG1,19,Sicilia,Sicilia,4999891,1344133,26.88,0.29
395,2021-03-13,SIC,12207,5385,6822,7717,4490,ITG,ITG1,19,Sicilia,Sicilia,4999891,1356340,27.13,0.24
396,2021-04-17,SIC,26034,13153,12881,18968,7066,ITG,ITG1,19,Sicilia,Sicilia,4999891,1382374,27.65,0.52
397,2021-03-17,SIC,14879,7354,7525,9188,5691,ITG,ITG1,19,Sicilia,Sicilia,4999891,1397253,27.95,0.3
398,2021-06-06,SIC,49026,23692,25334,41209,7817,ITG,ITG1,19,Sicilia,Sicilia,4999891,1446279,28.93,0.98
399,2021-02-26,SIC,11885,5812,6073,10203,1682,ITG,ITG1,19,Sicilia,Sicilia,4999891,1458164,29.16,0.24
400,2021-05-06,SIC,29165,13873,15292,18506,10659,ITG,ITG1,19,Sicilia,Sicilia,4999891,1487329,29.75,0.58
401,2021-01-24,SIC,4308,2252,2056,139,4169,ITG,ITG1,19,Sicilia,Sicilia,4999891,1491637,29.83,0.09
402,2021-05-04,SIC,26647,12395,14252,17515,9132,ITG,ITG1,19,Sicilia,Sicilia,4999891,1518284,30.37,0.53
403,2021-02-19,SIC,4909,2649,2260,4344,565,ITG,ITG1,19,Sicilia,Sicilia,4999891,1523193,30.46,0.1
404,2021-03-08,SIC,13175,5664,7511,10562,2613,ITG,ITG1,19,Sicilia,Sicilia,4999891,1536368,30.73,0.26
405,2021-05-30,SIC,35779,16175,19604,17736,18043,ITG,ITG1,19,Sicilia,Sicilia,4999891,1572147,31.44,0.72
406,2021-05-13,SIC,47148,22097,25051,30686,16462,ITG,ITG1,19,Sicilia,Sicilia,4999891,1619295,32.39,0.94
407,2021-01-31,SIC,4031,1926,2105,113,3918,ITG,ITG1,19,Sicilia,Sicilia,4999891,1623326,32.47,0.08
408,2021-05-11,SIC,32274,15359,16915,19802,12472,ITG,ITG1,19,Sicilia,Sicilia,4999891,1655600,33.11,0.65
409,2021-02-17,SIC,5215,3201,2014,4547,668,ITG,ITG1,19,Sicilia,Sicilia,4999891,1660815,33.22,0.1
410,2021-04-24,SIC,31108,14688,16420,23496,7612,ITG,ITG1,19,Sicilia,Sicilia,4999891,1691923,33.84,0.62
411,2021-02-15,SIC,3730,1733,1997,3166,564,ITG,ITG1,19,Sicilia,Sicilia,4999891,1695653,33.91,0.07
412,2021-05-26,SIC,44281,20589,23692,24049,20232,ITG,ITG1,19,Sicilia,Sicilia,4999891,1739934,34.8,0.89
413,2021-01-03,SIC,4710,2464,2246,4710,0,ITG,ITG1,19,Sicilia,Sicilia,4999891,1744644,34.89,0.09
414,2021-04-13,SIC,19684,9590,10094,10934,8750,ITG,ITG1,19,Sicilia,Sicilia,4999891,1764328,35.29,0.39
415,2021-01-10,SIC,3532,1578,1954,3532,0,ITG,ITG1,19,Sicilia,Sicilia,4999891,1767860,35.36,0.07
416,2021-01-05,SIC,10268,5041,5227,10268,0,ITG,ITG1,19,Sicilia,Sicilia,4999891,1778128,35.56,0.21
417,2021-04-15,SIC,21062,10262,10800,11731,9331,ITG,ITG1,19,Sicilia,Sicilia,4999891,1799190,35.98,0.42
418,2021-01-15,SIC,4718,2056,2662,4718,0,ITG,ITG1,19,Sicilia,Sicilia,4999891,1803908,36.08,0.09
419,2021-04-25,SIC,21352,10183,11169,16375,4977,ITG,ITG1,19,Sicilia,Sicilia,4999891,1825260,36.51,0.43
420,2021-02-01,SIC,5891,2614,3277,296,5595,ITG,ITG1,19,Sicilia,Sicilia,4999891,1831151,36.62,0.12
421,2021-03-22,SIC,16507,7783,8724,11145,5362,ITG,ITG1,19,Sicilia,Sicilia,4999891,1847658,36.95,0.33
422,2020-12-29,SIC,241,150,91,241,0,ITG,ITG1,19,Sicilia,Sicilia,4999891,1847899,36.96,0.0
423,2021-04-10,SIC,20404,9960,10444,11438,8966,ITG,ITG1,19,Sicilia,Sicilia,4999891,1868303,37.37,0.41
424,2021-02-07,SIC,2333,985,1348,674,1659,ITG,ITG1,19,Sicilia,Sicilia,4999891,1870636,37.41,0.05
425,2021-05-18,SIC,35947,17229,18718,23476,12471,ITG,ITG1,19,Sicilia,Sicilia,4999891,1906583,38.13,0.72
426,2021-05-25,SIC,33084,14984,18100,14082,19002,ITG,ITG1,19,Sicilia,Sicilia,4999891,1939667,38.79,0.66
427,2021-03-29,SIC,14891,6973,7918,10394,4497,ITG,ITG1,19,Sicilia,Sicilia,4999891,1954558,39.09,0.3
428,2021-06-01,SIC,38489,17418,21071,24887,13602,ITG,ITG1,19,Sicilia,Sicilia,4999891,1993047,39.86,0.77
429,2021-04-05,SIC,8023,3958,4065,6583,1440,ITG,ITG1,19,Sicilia,Sicilia,4999891,2001070,40.02,0.16
430,2021-04-12,SIC,18770,9117,9653,11520,7250,ITG,ITG1,19,Sicilia,Sicilia,4999891,2019840,40.4,0.38
431,2021-02-14,SIC,1058,403,655,918,140,ITG,ITG1,19,Sicilia,Sicilia,4999891,2020898,40.42,0.02
432,2021-01-02,SIC,4832,2511,2321,4832,0,ITG,ITG1,19,Sicilia,Sicilia,4999891,2025730,40.52,0.1
433,2021-01-19,SIC,1279,531,748,1077,202,ITG,ITG1,19,Sicilia,Sicilia,4999891,2027009,40.54,0.03
434,2021-04-29,SIC,31578,14774,16804,22248,9330,ITG,ITG1,19,Sicilia,Sicilia,4999891,2058587,41.17,0.63
435,2021-03-03,SIC,14359,6379,7980,11297,3062,ITG,ITG1,19,Sicilia,Sicilia,4999891,2072946,41.46,0.29
436,2021-03-31,SIC,14372,6649,7723,9444,4928,ITG,ITG1,19,Sicilia,Sicilia,4999891,2087318,41.75,0.29
437,2021-01-07,SIC,8890,4116,4774,8890,0,ITG,ITG1,19,Sicilia,Sicilia,4999891,2096208,41.93,0.18
438,2021-02-09,SIC,4351,1802,2549,3316,1035,ITG,ITG1,19,Sicilia,Sicilia,4999891,2100559,42.01,0.09
439,2021-05-20,SIC,43368,20697,22671,27601,15767,ITG,ITG1,19,Sicilia,Sicilia,4999891,2143927,42.88,0.87
440,2021-04-26,SIC,21689,10276,11413,13657,8032,ITG,ITG1,19,Sicilia,Sicilia,4999891,2165616,43.31,0.43
441,2021-02-02,SIC,5270,2472,2798,629,4641,ITG,ITG1,19,Sicilia,Sicilia,4999891,2170886,43.42,0.11
442,2021-01-14,SIC,5023,2381,2642,5023,0,ITG,ITG1,19,Sicilia,Sicilia,4999891,2175909,43.52,0.1
443,2021-03-15,SIC,10522,4599,5923,5630,4892,ITG,ITG1,19,Sicilia,Sicilia,4999891,2186431,43.73,0.21
444,2021-05-22,SIC,47985,22787,25198,28654,19331,ITG,ITG1,19,Sicilia,Sicilia,4999891,2234416,44.69,0.96
445,2021-02-28,SIC,7165,3063,4102,6535,630,ITG,ITG1,19,Sicilia,Sicilia,4999891,2241581,44.83,0.14
446,2021-06-08,SIC,46833,21956,24877,40370,6463,ITG,ITG1,19,Sicilia,Sicilia,4999891,2288414,45.77,0.94
447,2021-01-17,SIC,1302,589,713,1245,57,ITG,ITG1,19,Sicilia,Sicilia,4999891,2289716,45.8,0.03
448,2021-03-05,SIC,15588,6694,8894,11353,4235,ITG,ITG1,19,Sicilia,Sicilia,4999891,2305304,46.11,0.31
449,2021-02-16,SIC,4197,2208,1989,3732,465,ITG,ITG1,19,Sicilia,Sicilia,4999891,2309501,46.19,0.08
450,2020-12-31,SIC,881,470,411,881,0,ITG,ITG1,19,Sicilia,Sicilia,4999891,2310382,46.21,0.02
451,2021-03-07,SIC,9262,3455,5807,8179,1083,ITG,ITG1,19,Sicilia,Sicilia,4999891,2319644,46.39,0.19
452,2021-03-24,SIC,20843,9779,11064,15181,5662,ITG,ITG1,19,Sicilia,Sicilia,4999891,2340487,46.81,0.42
453,2021-05-29,SIC,47068,21384,25684,23893,23175,ITG,ITG1,19,Sicilia,Sicilia,4999891,2387555,47.75,0.94
454,2021-02-21,SIC,5168,2501,2667,5062,106,ITG,ITG1,19,Sicilia,Sicilia,4999891,2392723,47.86,0.1
455,2021-04-22,SIC,26880,12673,14207,20421,6459,ITG,ITG1,19,Sicilia,Sicilia,4999891,2419603,48.39,0.54
456,2021-03-10,SIC,13581,5803,7778,11397,2184,ITG,ITG1,19,Sicilia,Sicilia,4999891,2433184,48.66,0.27
457,2021-01-12,SIC,4295,2102,2193,4295,0,ITG,ITG1,19,Sicilia,Sicilia,4999891,2437479,48.75,0.09
458,2021-05-15,SIC,56561,26427,30134,41311,15250,ITG,ITG1,19,Sicilia,Sicilia,4999891,2494040,49.88,1.13
459,2021-03-19,SIC,16190,7962,8228,10709,5481,ITG,ITG1,19,Sicilia,Sicilia,4999891,2510230,50.21,0.32
460,2021-03-12,SIC,12746,5462,7284,10749,1997,ITG,ITG1,19,Sicilia,Sicilia,4999891,2522976,50.46,0.25
461,2021-01-09,SIC,7118,3350,3768,7118,0,ITG,ITG1,19,Sicilia,Sicilia,4999891,2530094,50.6,0.14
462,2021-05-03,SIC,23265,10737,12528,13545,9720,ITG,ITG1,19,Sicilia,Sicilia,4999891,2553359,51.07,0.47
463,2021-04-19,SIC,18245,8638,9607,12666,5579,ITG,ITG1,19,Sicilia,Sicilia,4999891,2571604,51.43,0.36
464,2021-02-24,SIC,9309,4760,4549,8749,560,ITG,ITG1,19,Sicilia,Sicilia,4999891,2580913,51.62,0.19
465,2021-01-21,SIC,1401,685,716,500,901,ITG,ITG1,19,Sicilia,Sicilia,4999891,2582314,51.65,0.03
466,2021-05-01,SIC,24431,11306,13125,19276,5155,ITG,ITG1,19,Sicilia,Sicilia,4999891,2606745,52.14,0.49
467,2021-05-10,SIC,28226,13558,14668,16157,12069,ITG,ITG1,19,Sicilia,Sicilia,4999891,2634971,52.7,0.56
468,2021-03-26,SIC,17778,8254,9524,12349,5429,ITG,ITG1,19,Sicilia,Sicilia,4999891,2652749,53.06,0.36
469,2021-01-28,SIC,9023,4268,4755,397,8626,ITG,ITG1,19,Sicilia,Sicilia,4999891,2661772,53.24,0.18
470,2021-05-08,SIC,35563,17000,18563,25311,10252,ITG,ITG1,19,Sicilia,Sicilia,4999891,2697335,53.95,0.71
471,2021-01-26,SIC,9221,4554,4667,259,8962,ITG,ITG1,19,Sicilia,Sicilia,4999891,2706556,54.13,0.18
472,2021-05-09,SIC,28076,13136,14940,19806,8270,ITG,ITG1,19,Sicilia,Sicilia,4999891,2734632,54.69,0.56
473,2021-02-05,SIC,6731,2976,3755,2125,4606,ITG,ITG1,19,Sicilia,Sicilia,4999891,2741363,54.83,0.13
474,2021-04-03,SIC,16388,7802,8586,13552,2836,ITG,ITG1,19,Sicilia,Sicilia,4999891,2757751,55.16,0.33
475,2021-03-27,SIC,15589,7352,8237,10737,4852,ITG,ITG1,19,Sicilia,Sicilia,4999891,2773340,55.47,0.31
476,2021-01-29,SIC,9123,4228,4895,425,8698,ITG,ITG1,19,Sicilia,Sicilia,4999891,2782463,55.65,0.18
477,2021-02-12,SIC,4585,1810,2775,4319,266,ITG,ITG1,19,Sicilia,Sicilia,4999891,2787048,55.74,0.09
478,2021-05-23,SIC,34142,16614,17528,20115,14027,ITG,ITG1,19,Sicilia,Sicilia,4999891,2821190,56.43,0.68
479,2021-05-27,SIC,47138,21505,25633,24820,22318,ITG,ITG1,19,Sicilia,Sicilia,4999891,2868328,57.37,0.94
480,2021-04-14,SIC,20114,9725,10389,11419,8695,ITG,ITG1,19,Sicilia,Sicilia,4999891,2888442,57.77,0.4
481,2021-04-21,SIC,22400,10742,11658,16292,6108,ITG,ITG1,19,Sicilia,Sicilia,4999891,2910842,58.22,0.45
482,2021-04-07,SIC,15386,7579,7807,8278,7108,ITG,ITG1,19,Sicilia,Sicilia,4999891,2926228,58.53,0.31
483,2021-06-03,SIC,45609,20838,24771,34156,11453,ITG,ITG1,19,Sicilia,Sicilia,4999891,2971837,59.44,0.91
484,2021-05-24,LOM,89207,43271,45936,49455,39752,ITC,ITC4,3,Lombardia,Lombardia,10060574,89207,0.89,0.89
485,2021-02-11,LOM,17032,5000,12032,9694,7338,ITC,ITC4,3,Lombardia,Lombardia,10060574,106239,1.06,0.17
486,2021-05-31,LOM,95487,47311,48176,79362,16125,ITC,ITC4,3,Lombardia,Lombardia,10060574,201726,2.01,0.95
487,2021-03-26,LOM,41137,15600,25537,28068,13069,ITC,ITC4,3,Lombardia,Lombardia,10060574,242863,2.41,0.41
488,2021-05-22,LOM,70497,33804,36693,32403,38094,ITC,ITC4,3,Lombardia,Lombardia,10060574,313360,3.11,0.7
489,2021-05-29,LOM,87949,42224,45725,42029,45920,ITC,ITC4,3,Lombardia,Lombardia,10060574,401309,3.99,0.87
490,2021-02-18,LOM,14026,4915,9111,13011,1015,ITC,ITC4,3,Lombardia,Lombardia,10060574,415335,4.13,0.14
491,2021-04-23,LOM,73388,33280,40108,56870,16518,ITC,ITC4,3,Lombardia,Lombardia,10060574,488723,4.86,0.73
492,2021-05-10,LOM,85190,40858,44332,63683,21507,ITC,ITC4,3,Lombardia,Lombardia,10060574,573913,5.7,0.85
493,2021-01-30,LOM,12306,4562,7744,154,12152,ITC,ITC4,3,Lombardia,Lombardia,10060574,586219,5.83,0.12
494,2021-02-16,LOM,9505,3073,6432,9057,448,ITC,ITC4,3,Lombardia,Lombardia,10060574,595724,5.92,0.09
495,2021-03-02,LOM,22802,9697,13105,19769,3033,ITC,ITC4,3,Lombardia,Lombardia,10060574,618526,6.15,0.23
496,2020-12-28,LOM,107,47,60,107,0,ITC,ITC4,3,Lombardia,Lombardia,10060574,618633,6.15,0.0
497,2021-04-21,LOM,71665,32505,39160,57078,14587,ITC,ITC4,3,Lombardia,Lombardia,10060574,690298,6.86,0.71
498,2021-01-11,LOM,16142,5346,10796,16142,0,ITC,ITC4,3,Lombardia,Lombardia,10060574,706440,7.02,0.16
499,2021-01-28,LOM,12186,3690,8496,766,11420,ITC,ITC4,3,Lombardia,Lombardia,10060574,718626,7.14,0.12
500,2021-06-05,LOM,101910,52708,49202,92318,9592,ITC,ITC4,3,Lombardia,Lombardia,10060574,820536,8.16,1.01
501,2021-03-14,LOM,14872,5348,9524,11589,3283,ITC,ITC4,3,Lombardia,Lombardia,10060574,835408,8.3,0.15
502,2021-02-23,LOM,11791,4797,6994,11465,326,ITC,ITC4,3,Lombardia,Lombardia,10060574,847199,8.42,0.12
503,2021-03-28,LOM,20462,7801,12661,14300,6162,ITC,ITC4,3,Lombardia,Lombardia,10060574,867661,8.62,0.2
504,2021-04-14,LOM,47138,21011,26127,34172,12966,ITC,ITC4,3,Lombardia,Lombardia,10060574,914799,9.09,0.47
505,2021-01-04,LOM,6094,2101,3993,6094,0,ITC,ITC4,3,Lombardia,Lombardia,10060574,920893,9.15,0.06
506,2021-04-16,LOM,53621,23905,29716,39283,14338,ITC,ITC4,3,Lombardia,Lombardia,10060574,974514,9.69,0.53
507,2021-02-04,LOM,27641,8068,19573,1991,25650,ITC,ITC4,3,Lombardia,Lombardia,10060574,1002155,9.96,0.27
508,2021-04-09,LOM,52233,22296,29937,36244,15989,ITC,ITC4,3,Lombardia,Lombardia,10060574,1054388,10.48,0.52
509,2021-04-04,LOM,7611,3230,4381,3716,3895,ITC,ITC4,3,Lombardia,Lombardia,10060574,1061999,10.56,0.08
510,2021-04-02,LOM,41136,16826,24310,26689,14447,ITC,ITC4,3,Lombardia,Lombardia,10060574,1103135,10.96,0.41
511,2021-04-28,LOM,95598,43608,51990,68756,26842,ITC,ITC4,3,Lombardia,Lombardia,10060574,1198733,11.92,0.95
512,2021-03-16,LOM,25478,10112,15366,16417,9061,ITC,ITC4,3,Lombardia,Lombardia,10060574,1224211,12.17,0.25
513,2021-05-12,LOM,87270,41627,45643,59807,27463,ITC,ITC4,3,Lombardia,Lombardia,10060574,1311481,13.04,0.87
514,2021-03-09,LOM,33199,12848,20351,25805,7394,ITC,ITC4,3,Lombardia,Lombardia,10060574,1344680,13.37,0.33
515,2021-05-05,LOM,87809,41876,45933,72547,15262,ITC,ITC4,3,Lombardia,Lombardia,10060574,1432489,14.24,0.87
516,2021-01-16,LOM,15425,5731,9694,15425,0,ITC,ITC4,3,Lombardia,Lombardia,10060574,1447914,14.39,0.15
517,2021-01-09,LOM,12411,4573,7838,12411,0,ITC,ITC4,3,Lombardia,Lombardia,10060574,1460325,14.52,0.12
518,2021-03-07,LOM,12079,5354,6725,9523,2556,ITC,ITC4,3,Lombardia,Lombardia,10060574,1472404,14.64,0.12
519,2021-01-27,LOM,8033,2672,5361,808,7225,ITC,ITC4,3,Lombardia,Lombardia,10060574,1480437,14.72,0.08
520,2021-03-25,LOM,42601,15892,26709,30013,12588,ITC,ITC4,3,Lombardia,Lombardia,10060574,1523038,15.14,0.42
521,2021-05-21,LOM,93640,45159,48481,29067,64573,ITC,ITC4,3,Lombardia,Lombardia,10060574,1616678,16.07,0.93
522,2021-04-25,LOM,51484,23609,27875,46748,4736,ITC,ITC4,3,Lombardia,Lombardia,10060574,1668162,16.58,0.51
523,2021-04-06,LOM,43019,17552,25467,25085,17934,ITC,ITC4,3,Lombardia,Lombardia,10060574,1711181,17.01,0.43
524,2021-05-26,LOM,93192,44396,48796,43546,49646,ITC,ITC4,3,Lombardia,Lombardia,10060574,1804373,17.94,0.93
525,2021-02-15,LOM,8939,3129,5810,8522,417,ITC,ITC4,3,Lombardia,Lombardia,10060574,1813312,18.02,0.09
526,2021-05-17,LOM,94539,45283,49256,30208,64331,ITC,ITC4,3,Lombardia,Lombardia,10060574,1907851,18.96,0.94
527,2021-05-19,LOM,82698,39521,43177,33785,48913,ITC,ITC4,3,Lombardia,Lombardia,10060574,1990549,19.79,0.82
528,2021-02-08,LOM,10077,2917,7160,2130,7947,ITC,ITC4,3,Lombardia,Lombardia,10060574,2000626,19.89,0.1
529,2021-02-25,LOM,15225,6313,8912,13667,1558,ITC,ITC4,3,Lombardia,Lombardia,10060574,2015851,20.04,0.15
530,2021-02-06,LOM,15235,5532,9703,1014,14221,ITC,ITC4,3,Lombardia,Lombardia,10060574,2031086,20.19,0.15
531,2021-05-02,LOM,83495,38330,45165,61035,22460,ITC,ITC4,3,Lombardia,Lombardia,10060574,2114581,21.02,0.83
532,2021-03-21,LOM,23506,8492,15014,18313,5193,ITC,ITC4,3,Lombardia,Lombardia,10060574,2138087,21.25,0.23
533,2021-02-13,LOM,6417,2441,3976,4941,1476,ITC,ITC4,3,Lombardia,Lombardia,10060574,2144504,21.32,0.06
534,2021-01-13,LOM,26358,8053,18305,26358,0,ITC,ITC4,3,Lombardia,Lombardia,10060574,2170862,21.58,0.26
535,2021-02-20,LOM,9335,3867,5468,9038,297,ITC,ITC4,3,Lombardia,Lombardia,10060574,2180197,21.67,0.09
536,2021-04-18,LOM,36343,16203,20140,31115,5228,ITC,ITC4,3,Lombardia,Lombardia,10060574,2216540,22.03,0.36
537,2021-01-08,LOM,12695,3916,8779,12695,0,ITC,ITC4,3,Lombardia,Lombardia,10060574,2229235,22.16,0.13
538,2021-05-03,LOM,83643,39734,43909,71527,12116,ITC,ITC4,3,Lombardia,Lombardia,10060574,2312878,22.99,0.83
539,2021-01-23,LOM,1114,357,757,916,198,ITC,ITC4,3,Lombardia,Lombardia,10060574,2313992,23.0,0.01
540,2021-06-02,LOM,84609,43569,41040,78295,6314,ITC,ITC4,3,Lombardia,Lombardia,10060574,2398601,23.84,0.84
541,2021-03-11,LOM,36183,13463,22720,26291,9892,ITC,ITC4,3,Lombardia,Lombardia,10060574,2434784,24.2,0.36
542,2021-03-30,LOM,39467,15478,23989,24695,14772,ITC,ITC4,3,Lombardia,Lombardia,10060574,2474251,24.59,0.39
543,2021-01-06,LOM,7058,2491,4567,7058,0,ITC,ITC4,3,Lombardia,Lombardia,10060574,2481309,24.66,0.07
544,2021-05-07,LOM,92134,43625,48509,69878,22256,ITC,ITC4,3,Lombardia,Lombardia,10060574,2573443,25.58,0.92
545,2021-03-18,LOM,27376,10951,16425,16146,11230,ITC,ITC4,3,Lombardia,Lombardia,10060574,2600819,25.85,0.27
546,2021-05-14,LOM,85657,41247,44410,55543,30114,ITC,ITC4,3,Lombardia,Lombardia,10060574,2686476,26.7,0.85
547,2021-04-11,LOM,32195,13935,18260,24806,7389,ITC,ITC4,3,Lombardia,Lombardia,10060574,2718671,27.02,0.32
548,2021-01-01,LOM,24,7,17,24,0,ITC,ITC4,3,Lombardia,Lombardia,10060574,2718695,27.02,0.0
549,2021-06-07,LOM,98187,49999,48188,85103,13084,ITC,ITC4,3,Lombardia,Lombardia,10060574,2816882,28.0,0.98
550,2021-02-27,LOM,13944,5869,8075,13303,641,ITC,ITC4,3,Lombardia,Lombardia,10060574,2830826,28.14,0.14
551,2020-12-30,LOM,114,42,72,114,0,ITC,ITC4,3,Lombardia,Lombardia,10060574,2830940,28.14,0.0
552,2021-03-06,LOM,21300,9082,12218,16788,4512,ITC,ITC4,3,Lombardia,Lombardia,10060574,2852240,28.35,0.21
553,2021-01-18,LOM,9144,2968,6176,8169,975,ITC,ITC4,3,Lombardia,Lombardia,10060574,2861384,28.44,0.09
554,2021-03-23,LOM,42496,15401,27095,29638,12858,ITC,ITC4,3,Lombardia,Lombardia,10060574,2903880,28.86,0.42
555,2021-01-25,LOM,7011,2367,4644,473,6538,ITC,ITC4,3,Lombardia,Lombardia,10060574,2910891,28.93,0.07
556,2021-02-01,LOM,16053,5315,10738,303,15750,ITC,ITC4,3,Lombardia,Lombardia,10060574,2926944,29.09,0.16
557,2021-03-20,LOM,32497,12144,20353,22650,9847,ITC,ITC4,3,Lombardia,Lombardia,10060574,2959441,29.42,0.32
558,2020-12-27,LOM,717,413,304,717,0,ITC,ITC4,3,Lombardia,Lombardia,10060574,2960158,29.42,0.01
559,2021-05-09,LOM,69539,32816,36723,56428,13111,ITC,ITC4,3,Lombardia,Lombardia,10060574,3029697,30.11,0.69
560,2021-01-29,LOM,13438,4115,9323,651,12787,ITC,ITC4,3,Lombardia,Lombardia,10060574,3043135,30.25,0.13
561,2021-03-04,LOM,29296,12099,17197,20241,9055,ITC,ITC4,3,Lombardia,Lombardia,10060574,3072431,30.54,0.29
562,2021-03-22,LOM,40308,14293,26015,29769,10539,ITC,ITC4,3,Lombardia,Lombardia,10060574,3112739,30.94,0.4
563,2021-04-08,LOM,52288,21738,30550,35844,16444,ITC,ITC4,3,Lombardia,Lombardia,10060574,3165027,31.46,0.52
564,2020-12-29,LOM,104,44,60,104,0,ITC,ITC4,3,Lombardia,Lombardia,10060574,3165131,31.46,0.0
565,2021-04-22,LOM,73825,33348,40477,57508,16317,ITC,ITC4,3,Lombardia,Lombardia,10060574,3238956,32.19,0.73
566,2021-03-03,LOM,26953,11506,15447,19678,7275,ITC,ITC4,3,Lombardia,Lombardia,10060574,3265909,32.46,0.27
567,2021-05-11,LOM,86782,41393,45389,60638,26144,ITC,ITC4,3,Lombardia,Lombardia,10060574,3352691,33.33,0.86
568,2021-05-18,LOM,88035,42065,45970,32582,55453,ITC,ITC4,3,Lombardia,Lombardia,10060574,3440726,34.2,0.88
569,2021-06-04,LOM,104132,54077,50055,94677,9455,ITC,ITC4,3,Lombardia,Lombardia,10060574,3544858,35.24,1.04
570,2021-02-24,LOM,14655,5922,8733,13730,925,ITC,ITC4,3,Lombardia,Lombardia,10060574,3559513,35.38,0.15
571,2021-05-16,LOM,68652,32492,36160,36483,32169,ITC,ITC4,3,Lombardia,Lombardia,10060574,3628165,36.06,0.68
572,2021-02-05,LOM,25610,7437,18173,2384,23226,ITC,ITC4,3,Lombardia,Lombardia,10060574,3653775,36.32,0.25
573,2021-02-22,LOM,11894,4807,7087,11589,305,ITC,ITC4,3,Lombardia,Lombardia,10060574,3665669,36.44,0.12
574,2021-03-13,LOM,27165,9767,17398,21076,6089,ITC,ITC4,3,Lombardia,Lombardia,10060574,3692834,36.71,0.27
575,2021-01-15,LOM,25197,7427,17770,25197,0,ITC,ITC4,3,Lombardia,Lombardia,10060574,3718031,36.96,0.25
576,2021-04-29,LOM,115420,53560,61860,85611,29809,ITC,ITC4,3,Lombardia,Lombardia,10060574,3833451,38.1,1.15
577,2021-04-20,LOM,67626,30819,36807,57291,10335,ITC,ITC4,3,Lombardia,Lombardia,10060574,3901077,38.78,0.67
578,2021-01-10,LOM,10513,3957,6556,10513,0,ITC,ITC4,3,Lombardia,Lombardia,10060574,3911590,38.88,0.1
579,2021-01-17,LOM,8336,3340,4996,8136,200,ITC,ITC4,3,Lombardia,Lombardia,10060574,3919926,38.96,0.08
580,2021-03-15,LOM,31545,11326,20219,23030,8515,ITC,ITC4,3,Lombardia,Lombardia,10060574,3951471,39.28,0.31
581,2021-04-13,LOM,47573,21238,26335,33503,14070,ITC,ITC4,3,Lombardia,Lombardia,10060574,3999044,39.75,0.47
582,2021-04-30,LOM,117022,54693,62329,89729,27293,ITC,ITC4,3,Lombardia,Lombardia,10060574,4116066,40.91,1.16
583,2021-01-20,LOM,5663,1377,4286,5549,114,ITC,ITC4,3,Lombardia,Lombardia,10060574,4121729,40.97,0.06
584,2021-01-22,LOM,3103,865,2238,3034,69,ITC,ITC4,3,Lombardia,Lombardia,10060574,4124832,41.0,0.03
585,2021-04-15,LOM,49396,21837,27559,35590,13806,ITC,ITC4,3,Lombardia,Lombardia,10060574,4174228,41.49,0.49
586,2021-02-10,LOM,14390,4503,9887,7573,6817,ITC,ITC4,3,Lombardia,Lombardia,10060574,4188618,41.63,0.14
587,2021-02-03,LOM,25525,7892,17633,1072,24453,ITC,ITC4,3,Lombardia,Lombardia,10060574,4214143,41.89,0.25
588,2021-04-01,LOM,42934,17218,25716,26741,16193,ITC,ITC4,3,Lombardia,Lombardia,10060574,4257077,42.31,0.43
589,2021-06-01,LOM,93674,45967,47707,76759,16915,ITC,ITC4,3,Lombardia,Lombardia,10060574,4350751,43.25,0.93
590,2021-01-02,LOM,199,72,127,199,0,ITC,ITC4,3,Lombardia,Lombardia,10060574,4350950,43.25,0.0
591,2021-06-08,LOM,101466,51568,49898,88134,13332,ITC,ITC4,3,Lombardia,Lombardia,10060574,4452416,44.26,1.01
592,2021-02-28,LOM,7882,3253,4629,7672,210,ITC,ITC4,3,Lombardia,Lombardia,10060574,4460298,44.33,0.08
593,2021-04-26,LOM,87926,40919,47007,68769,19157,ITC,ITC4,3,Lombardia,Lombardia,10060574,4548224,45.21,0.87
594,2021-06-09,LOM,70686,35033,35653,60340,10346,ITC,ITC4,3,Lombardia,Lombardia,10060574,4618910,45.91,0.7
595,2021-03-08,LOM,29713,11169,18544,22644,7069,ITC,ITC4,3,Lombardia,Lombardia,10060574,4648623,46.21,0.3
596,2021-05-04,LOM,86785,41063,45722,72404,14381,ITC,ITC4,3,Lombardia,Lombardia,10060574,4735408,47.07,0.86
597,2021-01-24,LOM,1199,457,742,536,663,ITC,ITC4,3,Lombardia,Lombardia,10060574,4736607,47.08,0.01
598,2021-03-05,LOM,28899,11918,16981,20497,8402,ITC,ITC4,3,Lombardia,Lombardia,10060574,4765506,47.37,0.29
599,2021-03-19,LOM,32404,12908,19496,19216,13188,ITC,ITC4,3,Lombardia,Lombardia,10060574,4797910,47.69,0.32
600,2021-05-27,LOM,94486,45271,49215,41295,53191,ITC,ITC4,3,Lombardia,Lombardia,10060574,4892396,48.63,0.94
601,2021-04-24,LOM,75698,33549,42149,54614,21084,ITC,ITC4,3,Lombardia,Lombardia,10060574,4968094,49.38,0.75
602,2021-01-14,LOM,26795,7779,19016,26795,0,ITC,ITC4,3,Lombardia,Lombardia,10060574,4994889,49.65,0.27
603,2021-05-08,LOM,87412,40613,46799,65660,21752,ITC,ITC4,3,Lombardia,Lombardia,10060574,5082301,50.52,0.87
604,2021-04-07,LOM,50507,20872,29635,34702,15805,ITC,ITC4,3,Lombardia,Lombardia,10060574,5132808,51.02,0.5
605,2021-05-01,LOM,95895,43649,52246,66750,29145,ITC,ITC4,3,Lombardia,Lombardia,10060574,5228703,51.97,0.95
606,2021-01-21,LOM,5317,1563,3754,4629,688,ITC,ITC4,3,Lombardia,Lombardia,10060574,5234020,52.03,0.05
607,2021-02-07,LOM,7308,2822,4486,338,6970,ITC,ITC4,3,Lombardia,Lombardia,10060574,5241328,52.1,0.07
608,2021-01-19,LOM,8051,2329,5722,7583,468,ITC,ITC4,3,Lombardia,Lombardia,10060574,5249379,52.18,0.08
609,2021-05-20,LOM,94242,45531,48711,31820,62422,ITC,ITC4,3,Lombardia,Lombardia,10060574,5343621,53.11,0.94
610,2021-05-28,LOM,93136,44616,48520,42866,50270,ITC,ITC4,3,Lombardia,Lombardia,10060574,5436757,54.04,0.93
611,2021-02-17,LOM,11985,3755,8230,10596,1389,ITC,ITC4,3,Lombardia,Lombardia,10060574,5448742,54.16,0.12
612,2021-04-05,LOM,27377,11694,15683,19274,8103,ITC,ITC4,3,Lombardia,Lombardia,10060574,5476119,54.43,0.27
613,2021-01-31,LOM,9732,3760,5972,29,9703,ITC,ITC4,3,Lombardia,Lombardia,10060574,5485851,54.53,0.1
614,2021-01-05,LOM,7821,2567,5254,7821,0,ITC,ITC4,3,Lombardia,Lombardia,10060574,5493672,54.61,0.08
615,2021-03-27,LOM,32419,12367,20052,23715,8704,ITC,ITC4,3,Lombardia,Lombardia,10060574,5526091,54.93,0.32
616,2021-01-03,LOM,854,316,538,854,0,ITC,ITC4,3,Lombardia,Lombardia,10060574,5526945,54.94,0.01
617,2021-06-03,LOM,96438,49334,47104,86010,10428,ITC,ITC4,3,Lombardia,Lombardia,10060574,5623383,55.9,0.96
618,2021-03-12,LOM,35248,12953,22295,25049,10199,ITC,ITC4,3,Lombardia,Lombardia,10060574,5658631,56.25,0.35
619,2021-03-29,LOM,40003,15508,24495,25173,14830,ITC,ITC4,3,Lombardia,Lombardia,10060574,5698634,56.64,0.4
620,2021-04-12,LOM,47217,20571,26646,32883,14334,ITC,ITC4,3,Lombardia,Lombardia,10060574,5745851,57.11,0.47
621,2021-02-21,LOM,5050,1861,3189,5033,17,ITC,ITC4,3,Lombardia,Lombardia,10060574,5750901,57.16,0.05
622,2021-04-19,LOM,60086,27336,32750,50683,9403,ITC,ITC4,3,Lombardia,Lombardia,10060574,5810987,57.76,0.6
623,2021-04-27,LOM,85939,39958,45981,69401,16538,ITC,ITC4,3,Lombardia,Lombardia,10060574,5896926,58.61,0.85
624,2021-03-17,LOM,26249,10492,15757,15252,10997,ITC,ITC4,3,Lombardia,Lombardia,10060574,5923175,58.88,0.26
625,2021-05-25,LOM,90850,43454,47396,44609,46241,ITC,ITC4,3,Lombardia,Lombardia,10060574,6014025,59.78,0.9
626,2021-02-14,LOM,3578,1545,2033,2943,635,ITC,ITC4,3,Lombardia,Lombardia,10060574,6017603,59.81,0.04
627,2021-01-12,LOM,20209,6694,13515,20209,0,ITC,ITC4,3,Lombardia,Lombardia,10060574,6037812,60.01,0.2
628,2021-03-01,LOM,18773,8227,10546,17068,1705,ITC,ITC4,3,Lombardia,Lombardia,10060574,6056585,60.2,0.19
629,2021-05-15,LOM,80809,38759,42050,47495,33314,ITC,ITC4,3,Lombardia,Lombardia,10060574,6137394,61.0,0.8
630,2021-05-13,LOM,86971,41695,45276,58242,28729,ITC,ITC4,3,Lombardia,Lombardia,10060574,6224365,61.87,0.86
631,2021-02-02,LOM,19863,6590,13273,497,19366,ITC,ITC4,3,Lombardia,Lombardia,10060574,6244228,62.07,0.2
632,2021-03-31,LOM,41942,16973,24969,26719,15223,ITC,ITC4,3,Lombardia,Lombardia,10060574,6286170,62.48,0.42
633,2021-03-10,LOM,33231,12709,20522,25372,7859,ITC,ITC4,3,Lombardia,Lombardia,10060574,6319401,62.81,0.33
634,2021-05-06,LOM,89749,42164,47585,73312,16437,ITC,ITC4,3,Lombardia,Lombardia,10060574,6409150,63.71,0.89
635,2021-01-26,LOM,8336,2704,5632,349,7987,ITC,ITC4,3,Lombardia,Lombardia,10060574,6417486,63.79,0.08
636,2021-03-24,LOM,43219,15600,27619,31342,11877,ITC,ITC4,3,Lombardia,Lombardia,10060574,6460705,64.22,0.43
637,2021-02-09,LOM,12205,3331,8874,4033,8172,ITC,ITC4,3,Lombardia,Lombardia,10060574,6472910,64.34,0.12
638,2021-04-03,LOM,36234,14859,21375,26147,10087,ITC,ITC4,3,Lombardia,Lombardia,10060574,6509144,64.7,0.36
639,2021-05-30,LOM,74280,35542,38738,34329,39951,ITC,ITC4,3,Lombardia,Lombardia,10060574,6583424,65.44,0.74
640,2021-05-23,LOM,60740,28919,31821,26793,33947,ITC,ITC4,3,Lombardia,Lombardia,10060574,6644164,66.04,0.6
641,2021-02-12,LOM,13938,4358,9580,9021,4917,ITC,ITC4,3,Lombardia,Lombardia,10060574,6658102,66.18,0.14
642,2021-04-10,LOM,52485,21731,30754,40698,11787,ITC,ITC4,3,Lombardia,Lombardia,10060574,6710587,66.7,0.52
643,2021-06-06,LOM,89699,46132,43567,80593,9106,ITC,ITC4,3,Lombardia,Lombardia,10060574,6800286,67.59,0.89
644,2021-01-07,LOM,11754,3634,8120,11754,0,ITC,ITC4,3,Lombardia,Lombardia,10060574,6812040,67.71,0.12
645,2021-02-19,LOM,14161,5385,8776,13482,679,ITC,ITC4,3,Lombardia,Lombardia,10060574,6826201,67.85,0.14
646,2021-04-17,LOM,48392,21257,27135,37624,10768,ITC,ITC4,3,Lombardia,Lombardia,10060574,6874593,68.33,0.48
647,2021-02-26,LOM,18353,7545,10808,16509,1844,ITC,ITC4,3,Lombardia,Lombardia,10060574,6892946,68.51,0.18
648,2020-12-31,LOM,713,301,412,713,0,ITC,ITC4,3,Lombardia,Lombardia,10060574,6893659,68.52,0.01
649,2021-02-18,EMR,7039,2892,4147,6456,583,ITH,ITH5,8,Emilia-Romagna,Emilia-Romagna,4459477,7039,0.16,0.16
650,2021-06-07,EMR,40015,20492,19523,33930,6085,ITH,ITH5,8,Emilia-Romagna,Emilia-Romagna,4459477,47054,1.06,0.9
651,2021-05-31,EMR,29523,13581,15942,18237,11286,ITH,ITH5,8,Emilia-Romagna,Emilia-Romagna,4459477,76577,1.72,0.66
652,2021-02-20,EMR,5318,2094,3224,5055,263,ITH,ITH5,8,Emilia-Romagna,Emilia-Romagna,4459477,81895,1.84,0.12
653,2021-03-30,EMR,23315,10307,13008,18277,5038,ITH,ITH5,8,Emilia-Romagna,Emilia-Romagna,4459477,105210,2.36,0.52
654,2021-01-04,EMR,7315,2527,4788,7315,0,ITH,ITH5,8,Emilia-Romagna,Emilia-Romagna,4459477,112525,2.52,0.16
655,2021-05-19,EMR,33656,14934,18722,18512,15144,ITH,ITH5,8,Emilia-Romagna,Emilia-Romagna,4459477,146181,3.28,0.75
656,2021-06-02,EMR,23901,11902,11999,19092,4809,ITH,ITH5,8,Emilia-Romagna,Emilia-Romagna,4459477,170082,3.81,0.54
657,2021-04-16,EMR,29210,13755,15455,20373,8837,ITH,ITH5,8,Emilia-Romagna,Emilia-Romagna,4459477,199292,4.47,0.66
658,2021-01-06,EMR,8287,2955,5332,8287,0,ITH,ITH5,8,Emilia-Romagna,Emilia-Romagna,4459477,207579,4.65,0.19
659,2021-04-30,EMR,36580,16779,19801,21790,14790,ITH,ITH5,8,Emilia-Romagna,Emilia-Romagna,4459477,244159,5.48,0.82
660,2021-03-28,EMR,13497,6024,7473,9633,3864,ITH,ITH5,8,Emilia-Romagna,Emilia-Romagna,4459477,257656,5.78,0.3
661,2021-02-25,EMR,9250,3499,5751,8296,954,ITH,ITH5,8,Emilia-Romagna,Emilia-Romagna,4459477,266906,5.99,0.21
662,2021-03-11,EMR,17263,7140,10123,11413,5850,ITH,ITH5,8,Emilia-Romagna,Emilia-Romagna,4459477,284169,6.37,0.39
663,2021-02-06,EMR,7602,2407,5195,2131,5471,ITH,ITH5,8,Emilia-Romagna,Emilia-Romagna,4459477,291771,6.54,0.17
664,2021-05-26,EMR,33001,14573,18428,10195,22806,ITH,ITH5,8,Emilia-Romagna,Emilia-Romagna,4459477,324772,7.28,0.74
665,2021-03-04,EMR,16450,5349,11101,13433,3017,ITH,ITH5,8,Emilia-Romagna,Emilia-Romagna,4459477,341222,7.65,0.37
666,2021-05-24,EMR,29675,13527,16148,18412,11263,ITH,ITH5,8,Emilia-Romagna,Emilia-Romagna,4459477,370897,8.32,0.67
667,2021-02-13,EMR,3628,1085,2543,3030,598,ITH,ITH5,8,Emilia-Romagna,Emilia-Romagna,4459477,374525,8.4,0.08
668,2021-01-30,EMR,10077,3519,6558,141,9936,ITH,ITH5,8,Emilia-Romagna,Emilia-Romagna,4459477,384602,8.62,0.23
669,2021-04-23,EMR,29557,13810,15747,14677,14880,ITH,ITH5,8,Emilia-Romagna,Emilia-Romagna,4459477,414159,9.29,0.66
670,2021-01-13,EMR,9075,2941,6134,9075,0,ITH,ITH5,8,Emilia-Romagna,Emilia-Romagna,4459477,423234,9.49,0.2
671,2021-04-04,EMR,9885,4718,5167,7616,2269,ITH,ITH5,8,Emilia-Romagna,Emilia-Romagna,4459477,433119,9.71,0.22
672,2021-04-11,EMR,15276,6933,8343,12228,3048,ITH,ITH5,8,Emilia-Romagna,Emilia-Romagna,4459477,448395,10.05,0.34
673,2021-02-11,EMR,4256,1416,2840,3415,841,ITH,ITH5,8,Emilia-Romagna,Emilia-Romagna,4459477,452651,10.15,0.1
674,2021-04-18,EMR,17509,8400,9109,12581,4928,ITH,ITH5,8,Emilia-Romagna,Emilia-Romagna,4459477,470160,10.54,0.39
675,2021-01-23,EMR,2448,871,1577,443,2005,ITH,ITH5,8,Emilia-Romagna,Emilia-Romagna,4459477,472608,10.6,0.05
676,2021-05-07,EMR,35204,16935,18269,23358,11846,ITH,ITH5,8,Emilia-Romagna,Emilia-Romagna,4459477,507812,11.39,0.79
677,2021-05-12,EMR,38817,18262,20555,29207,9610,ITH,ITH5,8,Emilia-Romagna,Emilia-Romagna,4459477,546629,12.26,0.87
678,2021-02-01,EMR,10320,3610,6710,362,9958,ITH,ITH5,8,Emilia-Romagna,Emilia-Romagna,4459477,556949,12.49,0.23
679,2021-01-18,EMR,3127,879,2248,2449,678,ITH,ITH5,8,Emilia-Romagna,Emilia-Romagna,4459477,560076,12.56,0.07
680,2021-03-16,EMR,12243,5027,7216,4935,7308,ITH,ITH5,8,Emilia-Romagna,Emilia-Romagna,4459477,572319,12.83,0.27
681,2021-01-25,EMR,6462,2146,4316,207,6255,ITH,ITH5,8,Emilia-Romagna,Emilia-Romagna,4459477,578781,12.98,0.14
682,2021-03-23,EMR,18720,8087,10633,12033,6687,ITH,ITH5,8,Emilia-Romagna,Emilia-Romagna,4459477,597501,13.4,0.42
683,2021-03-09,EMR,14712,5986,8726,10757,3955,ITH,ITH5,8,Emilia-Romagna,Emilia-Romagna,4459477,612213,13.73,0.33
684,2021-05-05,EMR,30080,13978,16102,18832,11248,ITH,ITH5,8,Emilia-Romagna,Emilia-Romagna,4459477,642293,14.4,0.67
685,2021-06-04,EMR,45241,22775,22466,37250,7991,ITH,ITH5,8,Emilia-Romagna,Emilia-Romagna,4459477,687534,15.42,1.01
686,2021-01-20,EMR,1325,270,1055,1324,1,ITH,ITH5,8,Emilia-Romagna,Emilia-Romagna,4459477,688859,15.45,0.03
687,2021-05-09,EMR,25605,12249,13356,18637,6968,ITH,ITH5,8,Emilia-Romagna,Emilia-Romagna,4459477,714464,16.02,0.57
688,2021-01-29,EMR,10415,3497,6918,290,10125,ITH,ITH5,8,Emilia-Romagna,Emilia-Romagna,4459477,724879,16.25,0.23
689,2021-02-15,EMR,2904,850,2054,2779,125,ITH,ITH5,8,Emilia-Romagna,Emilia-Romagna,4459477,727783,16.32,0.07
690,2021-01-27,EMR,8361,2947,5414,462,7899,ITH,ITH5,8,Emilia-Romagna,Emilia-Romagna,4459477,736144,16.51,0.19
691,2021-03-13,EMR,16084,6311,9773,10771,5313,ITH,ITH5,8,Emilia-Romagna,Emilia-Romagna,4459477,752228,16.87,0.36
692,2021-03-27,EMR,21650,9061,12589,14741,6909,ITH,ITH5,8,Emilia-Romagna,Emilia-Romagna,4459477,773878,17.35,0.49
693,2021-04-13,EMR,23679,11108,12571,19376,4303,ITH,ITH5,8,Emilia-Romagna,Emilia-Romagna,4459477,797557,17.88,0.53
694,2021-01-03,EMR,2763,943,1820,2763,0,ITH,ITH5,8,Emilia-Romagna,Emilia-Romagna,4459477,800320,17.95,0.06
695,2021-05-02,EMR,25573,11648,13925,13584,11989,ITH,ITH5,8,Emilia-Romagna,Emilia-Romagna,4459477,825893,18.52,0.57
696,2021-01-22,EMR,1829,477,1352,1088,741,ITH,ITH5,8,Emilia-Romagna,Emilia-Romagna,4459477,827722,18.56,0.04
697,2021-02-08,EMR,5230,1534,3696,2318,2912,ITH,ITH5,8,Emilia-Romagna,Emilia-Romagna,4459477,832952,18.68,0.12
698,2021-05-16,EMR,25842,12167,13675,18730,7112,ITH,ITH5,8,Emilia-Romagna,Emilia-Romagna,4459477,858794,19.26,0.58
699,2021-02-22,EMR,7482,3091,4391,7210,272,ITH,ITH5,8,Emilia-Romagna,Emilia-Romagna,4459477,866276,19.43,0.17
700,2021-01-15,EMR,7749,2404,5345,7749,0,ITH,ITH5,8,Emilia-Romagna,Emilia-Romagna,4459477,874025,19.6,0.17
701,2021-06-09,EMR,22600,11275,11325,19204,3396,ITH,ITH5,8,Emilia-Romagna,Emilia-Romagna,4459477,896625,20.11,0.51
702,2021-03-01,EMR,10099,3582,6517,7841,2258,ITH,ITH5,8,Emilia-Romagna,Emilia-Romagna,4459477,906724,20.33,0.23
703,2021-05-04,EMR,29260,13699,15561,15602,13658,ITH,ITH5,8,Emilia-Romagna,Emilia-Romagna,4459477,935984,20.99,0.66
704,2021-02-27,EMR,10967,3999,6968,9229,1738,ITH,ITH5,8,Emilia-Romagna,Emilia-Romagna,4459477,946951,21.23,0.25
705,2021-04-25,EMR,22344,10239,12105,14836,7508,ITH,ITH5,8,Emilia-Romagna,Emilia-Romagna,4459477,969295,21.74,0.5
706,2021-01-11,EMR,9348,3273,6075,9348,0,ITH,ITH5,8,Emilia-Romagna,Emilia-Romagna,4459477,978643,21.95,0.21
707,2021-03-20,EMR,16089,6832,9257,9125,6964,ITH,ITH5,8,Emilia-Romagna,Emilia-Romagna,4459477,994732,22.31,0.36
708,2021-04-06,EMR,24751,11163,13588,20012,4739,ITH,ITH5,8,Emilia-Romagna,Emilia-Romagna,4459477,1019483,22.86,0.56
709,2020-12-27,EMR,970,372,598,970,0,ITH,ITH5,8,Emilia-Romagna,Emilia-Romagna,4459477,1020453,22.88,0.02
710,2021-05-23,EMR,25450,11854,13596,13885,11565,ITH,ITH5,8,Emilia-Romagna,Emilia-Romagna,4459477,1045903,23.45,0.57
711,2021-01-10,EMR,7171,2684,4487,7171,0,ITH,ITH5,8,Emilia-Romagna,Emilia-Romagna,4459477,1053074,23.61,0.16
712,2021-03-08,EMR,12188,5071,7117,9512,2676,ITH,ITH5,8,Emilia-Romagna,Emilia-Romagna,4459477,1065262,23.89,0.27
713,2021-04-20,EMR,22616,10400,12216,14264,8352,ITH,ITH5,8,Emilia-Romagna,Emilia-Romagna,4459477,1087878,24.39,0.51
714,2021-03-25,EMR,21421,9373,12048,14433,6988,ITH,ITH5,8,Emilia-Romagna,Emilia-Romagna,4459477,1109299,24.88,0.48
715,2021-05-21,EMR,39117,17497,21620,22194,16923,ITH,ITH5,8,Emilia-Romagna,Emilia-Romagna,4459477,1148416,25.75,0.88
716,2021-02-10,EMR,4021,1384,2637,2766,1255,ITH,ITH5,8,Emilia-Romagna,Emilia-Romagna,4459477,1152437,25.84,0.09
717,2021-04-08,EMR,31198,14328,16870,25897,5301,ITH,ITH5,8,Emilia-Romagna,Emilia-Romagna,4459477,1183635,26.54,0.7
718,2021-04-15,EMR,29333,13978,15355,19658,9675,ITH,ITH5,8,Emilia-Romagna,Emilia-Romagna,4459477,1212968,27.2,0.66
719,2021-03-10,EMR,18738,7688,11050,13096,5642,ITH,ITH5,8,Emilia-Romagna,Emilia-Romagna,4459477,1231706,27.62,0.42
720,2021-05-18,EMR,29032,13228,15804,18566,10466,ITH,ITH5,8,Emilia-Romagna,Emilia-Romagna,4459477,1260738,28.27,0.65
721,2021-02-07,EMR,4794,1538,3256,1733,3061,ITH,ITH5,8,Emilia-Romagna,Emilia-Romagna,4459477,1265532,28.38,0.11
722,2021-02-24,EMR,9351,3566,5785,8467,884,ITH,ITH5,8,Emilia-Romagna,Emilia-Romagna,4459477,1274883,28.59,0.21
723,2021-01-05,EMR,9361,3170,6191,9361,0,ITH,ITH5,8,Emilia-Romagna,Emilia-Romagna,4459477,1284244,28.8,0.21
724,2021-04-29,EMR,44946,21133,23813,27399,17547,ITH,ITH5,8,Emilia-Romagna,Emilia-Romagna,4459477,1329190,29.81,1.01
725,2021-01-19,EMR,2045,505,1540,2028,17,ITH,ITH5,8,Emilia-Romagna,Emilia-Romagna,4459477,1331235,29.85,0.05
726,2021-03-29,EMR,21219,9450,11769,16568,4651,ITH,ITH5,8,Emilia-Romagna,Emilia-Romagna,4459477,1352454,30.33,0.48
727,2021-05-01,EMR,28399,12772,15627,15627,12772,ITH,ITH5,8,Emilia-Romagna,Emilia-Romagna,4459477,1380853,30.96,0.64
728,2021-03-05,EMR,17740,5764,11976,14287,3453,ITH,ITH5,8,Emilia-Romagna,Emilia-Romagna,4459477,1398593,31.36,0.4
729,2021-03-22,EMR,17505,7686,9819,10641,6864,ITH,ITH5,8,Emilia-Romagna,Emilia-Romagna,4459477,1416098,31.75,0.39
730,2021-03-03,EMR,15842,5254,10588,13365,2477,ITH,ITH5,8,Emilia-Romagna,Emilia-Romagna,4459477,1431940,32.11,0.36
731,2021-04-27,EMR,32085,14856,17229,19624,12461,ITH,ITH5,8,Emilia-Romagna,Emilia-Romagna,4459477,1464025,32.83,0.72
732,2021-05-06,EMR,35906,16597,19309,22853,13053,ITH,ITH5,8,Emilia-Romagna,Emilia-Romagna,4459477,1499931,33.63,0.81
733,2021-01-26,EMR,8334,3000,5334,215,8119,ITH,ITH5,8,Emilia-Romagna,Emilia-Romagna,4459477,1508265,33.82,0.19
734,2021-03-24,EMR,21099,9313,11786,13716,7383,ITH,ITH5,8,Emilia-Romagna,Emilia-Romagna,4459477,1529364,34.29,0.47
735,2021-01-24,EMR,2443,885,1558,298,2145,ITH,ITH5,8,Emilia-Romagna,Emilia-Romagna,4459477,1531807,34.35,0.05
736,2021-05-28,EMR,40807,18700,22107,17830,22977,ITH,ITH5,8,Emilia-Romagna,Emilia-Romagna,4459477,1572614,35.26,0.92
737,2021-04-22,EMR,29041,13444,15597,14966,14075,ITH,ITH5,8,Emilia-Romagna,Emilia-Romagna,4459477,1601655,35.92,0.65
738,2021-01-12,EMR,9476,3124,6352,9476,0,ITH,ITH5,8,Emilia-Romagna,Emilia-Romagna,4459477,1611131,36.13,0.21
739,2021-04-05,EMR,14861,6810,8051,11969,2892,ITH,ITH5,8,Emilia-Romagna,Emilia-Romagna,4459477,1625992,36.46,0.33
740,2021-02-12,EMR,5323,1679,3644,3920,1403,ITH,ITH5,8,Emilia-Romagna,Emilia-Romagna,4459477,1631315,36.58,0.12
741,2021-04-10,EMR,20917,9297,11620,16772,4145,ITH,ITH5,8,Emilia-Romagna,Emilia-Romagna,4459477,1652232,37.05,0.47
742,2021-04-17,EMR,27294,13073,14221,17943,9351,ITH,ITH5,8,Emilia-Romagna,Emilia-Romagna,4459477,1679526,37.66,0.61
743,2021-01-07,EMR,10273,3406,6867,10273,0,ITH,ITH5,8,Emilia-Romagna,Emilia-Romagna,4459477,1689799,37.89,0.23
744,2021-04-03,EMR,19937,8766,11171,16197,3740,ITH,ITH5,8,Emilia-Romagna,Emilia-Romagna,4459477,1709736,38.34,0.45
745,2021-05-30,EMR,27010,12750,14260,13333,13677,ITH,ITH5,8,Emilia-Romagna,Emilia-Romagna,4459477,1736746,38.95,0.61
746,2021-02-19,EMR,7327,3010,4317,6813,514,ITH,ITH5,8,Emilia-Romagna,Emilia-Romagna,4459477,1744073,39.11,0.16
747,2020-12-31,EMR,2215,780,1435,2215,0,ITH,ITH5,8,Emilia-Romagna,Emilia-Romagna,4459477,1746288,39.16,0.05
748,2021-06-06,EMR,36371,18895,17476,31967,4404,ITH,ITH5,8,Emilia-Romagna,Emilia-Romagna,4459477,1782659,39.97,0.82
749,2021-02-26,EMR,9634,3673,5961,8586,1048,ITH,ITH5,8,Emilia-Romagna,Emilia-Romagna,4459477,1792293,40.19,0.22
750,2021-04-28,EMR,33710,15583,18127,20822,12888,ITH,ITH5,8,Emilia-Romagna,Emilia-Romagna,4459477,1826003,40.95,0.76
751,2021-01-08,EMR,10866,3581,7285,10866,0,ITH,ITH5,8,Emilia-Romagna,Emilia-Romagna,4459477,1836869,41.19,0.24
752,2021-03-06,EMR,20875,5929,14946,18144,2731,ITH,ITH5,8,Emilia-Romagna,Emilia-Romagna,4459477,1857744,41.66,0.47
753,2021-05-20,EMR,40059,18209,21850,18857,21202,ITH,ITH5,8,Emilia-Romagna,Emilia-Romagna,4459477,1897803,42.56,0.9
754,2021-03-17,EMR,13721,5693,8028,5875,7846,ITH,ITH5,8,Emilia-Romagna,Emilia-Romagna,4459477,1911524,42.86,0.31
755,2021-05-13,EMR,35683,16438,19245,27916,7767,ITH,ITH5,8,Emilia-Romagna,Emilia-Romagna,4459477,1947207,43.66,0.8
756,2021-02-21,EMR,4450,1708,2742,4010,440,ITH,ITH5,8,Emilia-Romagna,Emilia-Romagna,4459477,1951657,43.76,0.1
757,2021-01-02,EMR,2374,915,1459,2374,0,ITH,ITH5,8,Emilia-Romagna,Emilia-Romagna,4459477,1954031,43.82,0.05
758,2021-06-05,EMR,43751,22157,21594,37021,6730,ITH,ITH5,8,Emilia-Romagna,Emilia-Romagna,4459477,1997782,44.8,0.98
759,2021-05-17,EMR,32353,15380,16973,22886,9467,ITH,ITH5,8,Emilia-Romagna,Emilia-Romagna,4459477,2030135,45.52,0.73
760,2021-05-25,EMR,24906,11096,13810,11606,13300,ITH,ITH5,8,Emilia-Romagna,Emilia-Romagna,4459477,2055041,46.08,0.56
761,2021-02-14,EMR,1402,378,1024,1282,120,ITH,ITH5,8,Emilia-Romagna,Emilia-Romagna,4459477,2056443,46.11,0.03
762,2021-05-27,EMR,41856,18520,23336,13983,27873,ITH,ITH5,8,Emilia-Romagna,Emilia-Romagna,4459477,2098299,47.05,0.94
763,2021-02-16,EMR,5772,2446,3326,5241,531,ITH,ITH5,8,Emilia-Romagna,Emilia-Romagna,4459477,2104071,47.18,0.13
764,2021-05-10,EMR,33831,16121,17710,26590,7241,ITH,ITH5,8,Emilia-Romagna,Emilia-Romagna,4459477,2137902,47.94,0.76
765,2021-04-21,EMR,23950,10960,12990,14205,9745,ITH,ITH5,8,Emilia-Romagna,Emilia-Romagna,4459477,2161852,48.48,0.54
766,2021-05-08,EMR,32321,15084,17237,20905,11416,ITH,ITH5,8,Emilia-Romagna,Emilia-Romagna,4459477,2194173,49.2,0.72
767,2021-01-28,EMR,10252,3339,6913,349,9903,ITH,ITH5,8,Emilia-Romagna,Emilia-Romagna,4459477,2204425,49.43,0.23
768,2021-02-05,EMR,9320,2967,6353,1638,7682,ITH,ITH5,8,Emilia-Romagna,Emilia-Romagna,4459477,2213745,49.64,0.21
769,2021-04-14,EMR,27032,12835,14197,20927,6105,ITH,ITH5,8,Emilia-Romagna,Emilia-Romagna,4459477,2240777,50.25,0.61
770,2021-01-21,EMR,2166,729,1437,820,1346,ITH,ITH5,8,Emilia-Romagna,Emilia-Romagna,4459477,2242943,50.3,0.05
771,2021-04-24,EMR,28599,13224,15375,14374,14225,ITH,ITH5,8,Emilia-Romagna,Emilia-Romagna,4459477,2271542,50.94,0.64
772,2021-05-11,EMR,35753,16785,18968,28490,7263,ITH,ITH5,8,Emilia-Romagna,Emilia-Romagna,4459477,2307295,51.74,0.8
773,2021-01-31,EMR,7697,2763,4934,241,7456,ITH,ITH5,8,Emilia-Romagna,Emilia-Romagna,4459477,2314992,51.91,0.17
774,2021-03-21,EMR,11955,5296,6659,7351,4604,ITH,ITH5,8,Emilia-Romagna,Emilia-Romagna,4459477,2326947,52.18,0.27
775,2021-03-02,EMR,12668,4272,8396,10580,2088,ITH,ITH5,8,Emilia-Romagna,Emilia-Romagna,4459477,2339615,52.46,0.28
776,2021-03-19,EMR,15923,6972,8951,7954,7969,ITH,ITH5,8,Emilia-Romagna,Emilia-Romagna,4459477,2355538,52.82,0.36
777,2021-04-07,EMR,26063,11846,14217,20051,6012,ITH,ITH5,8,Emilia-Romagna,Emilia-Romagna,4459477,2381601,53.41,0.58
778,2021-01-14,EMR,8129,2593,5536,8129,0,ITH,ITH5,8,Emilia-Romagna,Emilia-Romagna,4459477,2389730,53.59,0.18
779,2021-01-17,EMR,2890,887,2003,2644,246,ITH,ITH5,8,Emilia-Romagna,Emilia-Romagna,4459477,2392620,53.65,0.06
780,2021-04-02,EMR,23334,10510,12824,18872,4462,ITH,ITH5,8,Emilia-Romagna,Emilia-Romagna,4459477,2415954,54.18,0.52
781,2021-05-29,EMR,37586,16419,21167,17098,20488,ITH,ITH5,8,Emilia-Romagna,Emilia-Romagna,4459477,2453540,55.02,0.84
782,2021-06-03,EMR,37604,18278,19326,30229,7375,ITH,ITH5,8,Emilia-Romagna,Emilia-Romagna,4459477,2491144,55.86,0.84
783,2021-02-23,EMR,8215,3219,4996,7829,386,ITH,ITH5,8,Emilia-Romagna,Emilia-Romagna,4459477,2499359,56.05,0.18
784,2021-03-12,EMR,18127,7558,10569,11410,6717,ITH,ITH5,8,Emilia-Romagna,Emilia-Romagna,4459477,2517486,56.45,0.41
785,2021-03-15,EMR,13274,6095,7179,6775,6499,ITH,ITH5,8,Emilia-Romagna,Emilia-Romagna,4459477,2530760,56.75,0.3
786,2021-02-09,EMR,4154,1249,2905,2308,1846,ITH,ITH5,8,Emilia-Romagna,Emilia-Romagna,4459477,2534914,56.84,0.09
787,2021-05-15,EMR,33191,14972,18219,22818,10373,ITH,ITH5,8,Emilia-Romagna,Emilia-Romagna,4459477,2568105,57.59,0.74
788,2021-02-04,EMR,9939,3207,6732,1250,8689,ITH,ITH5,8,Emilia-Romagna,Emilia-Romagna,4459477,2578044,57.81,0.22
789,2021-05-22,EMR,32904,14103,18801,16895,16009,ITH,ITH5,8,Emilia-Romagna,Emilia-Romagna,4459477,2610948,58.55,0.74
790,2021-04-09,EMR,25708,11652,14056,20011,5697,ITH,ITH5,8,Emilia-Romagna,Emilia-Romagna,4459477,2636656,59.12,0.58
791,2021-02-02,EMR,9485,3053,6432,527,8958,ITH,ITH5,8,Emilia-Romagna,Emilia-Romagna,4459477,2646141,59.34,0.21
792,2021-03-31,EMR,25189,10974,14215,19732,5457,ITH,ITH5,8,Emilia-Romagna,Emilia-Romagna,4459477,2671330,59.9,0.56
793,2021-03-26,EMR,23438,9904,13534,17003,6435,ITH,ITH5,8,Emilia-Romagna,Emilia-Romagna,4459477,2694768,60.43,0.53
794,2021-03-18,EMR,13675,5807,7868,5675,8000,ITH,ITH5,8,Emilia-Romagna,Emilia-Romagna,4459477,2708443,60.73,0.31
795,2021-05-14,EMR,37143,17117,20026,27571,9572,ITH,ITH5,8,Emilia-Romagna,Emilia-Romagna,4459477,2745586,61.57,0.83
796,2021-02-03,EMR,9356,2996,6360,984,8372,ITH,ITH5,8,Emilia-Romagna,Emilia-Romagna,4459477,2754942,61.78,0.21
797,2021-04-01,EMR,23900,10742,13158,19353,4547,ITH,ITH5,8,Emilia-Romagna,Emilia-Romagna,4459477,2778842,62.31,0.54
798,2021-02-17,EMR,6537,2763,3774,5765,772,ITH,ITH5,8,Emilia-Romagna,Emilia-Romagna,4459477,2785379,62.46,0.15
799,2021-06-01,EMR,26977,12975,14002,17182,9795,ITH,ITH5,8,Emilia-Romagna,Emilia-Romagna,4459477,2812356,63.06,0.6
800,2021-04-12,EMR,19242,9005,10237,14796,4446,ITH,ITH5,8,Emilia-Romagna,Emilia-Romagna,4459477,2831598,63.5,0.43
801,2021-06-08,EMR,43710,22345,21365,36489,7221,ITH,ITH5,8,Emilia-Romagna,Emilia-Romagna,4459477,2875308,64.48,0.98
802,2021-04-19,EMR,20895,9795,11100,14623,6272,ITH,ITH5,8,Emilia-Romagna,Emilia-Romagna,4459477,2896203,64.94,0.47
803,2021-01-09,EMR,9983,3450,6533,9983,0,ITH,ITH5,8,Emilia-Romagna,Emilia-Romagna,4459477,2906186,65.17,0.22
804,2021-03-07,EMR,7824,2943,4881,6305,1519,ITH,ITH5,8,Emilia-Romagna,Emilia-Romagna,4459477,2914010,65.34,0.18
805,2021-05-03,EMR,28688,13551,15137,17811,10877,ITH,ITH5,8,Emilia-Romagna,Emilia-Romagna,4459477,2942698,65.99,0.64
806,2021-02-28,EMR,6823,2527,4296,4977,1846,ITH,ITH5,8,Emilia-Romagna,Emilia-Romagna,4459477,2949521,66.14,0.15
807,2021-04-26,EMR,27880,12927,14953,18575,9305,ITH,ITH5,8,Emilia-Romagna,Emilia-Romagna,4459477,2977401,66.77,0.63
808,2021-01-16,EMR,5628,1718,3910,5628,0,ITH,ITH5,8,Emilia-Romagna,Emilia-Romagna,4459477,2983029,66.89,0.13
809,2021-03-14,EMR,8700,3745,4955,4903,3797,ITH,ITH5,8,Emilia-Romagna,Emilia-Romagna,4459477,2991729,67.09,0.2
810,2021-05-04,BAS,4137,1991,2146,3614,523,ITF,ITF5,17,Basilicata,Basilicata,559084,4137,0.74,0.74
811,2021-03-08,BAS,1456,710,746,844,612,ITF,ITF5,17,Basilicata,Basilicata,559084,5593,1.0,0.26
812,2021-06-09,BAS,3065,1417,1648,2787,278,ITF,ITF5,17,Basilicata,Basilicata,559084,8658,1.55,0.55
813,2021-04-13,BAS,2113,1052,1061,1295,818,ITF,ITF5,17,Basilicata,Basilicata,559084,10771,1.93,0.38
814,2021-03-01,BAS,547,284,263,381,166,ITF,ITF5,17,Basilicata,Basilicata,559084,11318,2.02,0.1
815,2021-04-08,BAS,764,348,416,754,10,ITF,ITF5,17,Basilicata,Basilicata,559084,12082,2.16,0.14
816,2021-04-22,BAS,5036,2346,2690,3433,1603,ITF,ITF5,17,Basilicata,Basilicata,559084,17118,3.06,0.9
817,2021-02-17,BAS,1135,493,642,1059,76,ITF,ITF5,17,Basilicata,Basilicata,559084,18253,3.26,0.2
818,2021-05-28,BAS,3605,1803,1802,948,2657,ITF,ITF5,17,Basilicata,Basilicata,559084,21858,3.91,0.64
819,2021-01-15,BAS,813,350,463,813,0,ITF,ITF5,17,Basilicata,Basilicata,559084,22671,4.06,0.15
820,2020-12-27,BAS,106,41,65,106,0,ITF,ITF5,17,Basilicata,Basilicata,559084,22777,4.07,0.02
821,2021-03-20,BAS,1287,567,720,275,1012,ITF,ITF5,17,Basilicata,Basilicata,559084,24064,4.3,0.23
822,2021-03-06,BAS,1354,536,818,758,596,ITF,ITF5,17,Basilicata,Basilicata,559084,25418,4.55,0.24
823,2021-05-09,BAS,4685,2340,2345,2990,1695,ITF,ITF5,17,Basilicata,Basilicata,559084,30103,5.38,0.84
824,2021-02-15,BAS,622,232,390,580,42,ITF,ITF5,17,Basilicata,Basilicata,559084,30725,5.5,0.11
825,2021-01-29,BAS,615,230,385,63,552,ITF,ITF5,17,Basilicata,Basilicata,559084,31340,5.61,0.11
826,2021-06-04,BAS,4826,2282,2544,3781,1045,ITF,ITF5,17,Basilicata,Basilicata,559084,36166,6.47,0.86
827,2021-02-24,BAS,1803,743,1060,1734,69,ITF,ITF5,17,Basilicata,Basilicata,559084,37969,6.79,0.32
828,2021-02-22,BAS,1790,773,1017,1737,53,ITF,ITF5,17,Basilicata,Basilicata,559084,39759,7.11,0.32
829,2021-03-13,BAS,1796,889,907,751,1045,ITF,ITF5,17,Basilicata,Basilicata,559084,41555,7.43,0.32
830,2021-01-22,BAS,67,24,43,67,0,ITF,ITF5,17,Basilicata,Basilicata,559084,41622,7.44,0.01
831,2021-05-02,BAS,4179,2000,2179,3551,628,ITF,ITF5,17,Basilicata,Basilicata,559084,45801,8.19,0.75
832,2021-04-15,BAS,3386,1659,1727,2632,754,ITF,ITF5,17,Basilicata,Basilicata,559084,49187,8.8,0.61
833,2021-01-03,BAS,901,344,557,901,0,ITF,ITF5,17,Basilicata,Basilicata,559084,50088,8.96,0.16
834,2021-01-10,BAS,77,24,53,77,0,ITF,ITF5,17,Basilicata,Basilicata,559084,50165,8.97,0.01
835,2021-04-20,BAS,4033,1920,2113,2202,1831,ITF,ITF5,17,Basilicata,Basilicata,559084,54198,9.69,0.72
836,2021-01-08,BAS,554,219,335,554,0,ITF,ITF5,17,Basilicata,Basilicata,559084,54752,9.79,0.1
837,2021-03-15,BAS,2354,983,1371,523,1831,ITF,ITF5,17,Basilicata,Basilicata,559084,57106,10.21,0.42
838,2021-01-17,BAS,328,133,195,327,1,ITF,ITF5,17,Basilicata,Basilicata,559084,57434,10.27,0.06
839,2021-04-27,BAS,4726,2242,2484,4401,325,ITF,ITF5,17,Basilicata,Basilicata,559084,62160,11.12,0.85
840,2021-05-30,BAS,2771,1420,1351,921,1850,ITF,ITF5,17,Basilicata,Basilicata,559084,64931,11.61,0.5
841,2021-04-03,BAS,1806,748,1058,1471,335,ITF,ITF5,17,Basilicata,Basilicata,559084,66737,11.94,0.32
842,2021-02-05,BAS,986,443,543,64,922,ITF,ITF5,17,Basilicata,Basilicata,559084,67723,12.11,0.18
843,2021-05-16,BAS,4970,2467,2503,2858,2112,ITF,ITF5,17,Basilicata,Basilicata,559084,72693,13.0,0.89
844,2021-03-25,BAS,1883,602,1281,1537,346,ITF,ITF5,17,Basilicata,Basilicata,559084,74576,13.34,0.34
845,2021-01-27,BAS,411,175,236,113,298,ITF,ITF5,17,Basilicata,Basilicata,559084,74987,13.41,0.07
846,2021-02-10,BAS,548,238,310,496,52,ITF,ITF5,17,Basilicata,Basilicata,559084,75535,13.51,0.1
847,2021-05-21,BAS,4573,2319,2254,1492,3081,ITF,ITF5,17,Basilicata,Basilicata,559084,80108,14.33,0.82
848,2021-04-01,BAS,2803,1127,1676,2084,719,ITF,ITF5,17,Basilicata,Basilicata,559084,82911,14.83,0.5
849,2021-02-03,BAS,666,300,366,32,634,ITF,ITF5,17,Basilicata,Basilicata,559084,83577,14.95,0.12
850,2021-06-01,BAS,6132,2924,3208,3059,3073,ITF,ITF5,17,Basilicata,Basilicata,559084,89709,16.05,1.1
851,2021-03-05,BAS,1855,857,998,1109,746,ITF,ITF5,17,Basilicata,Basilicata,559084,91564,16.38,0.33
852,2021-05-27,BAS,3599,1853,1746,1072,2527,ITF,ITF5,17,Basilicata,Basilicata,559084,95163,17.02,0.64
853,2021-04-24,BAS,4544,2197,2347,3532,1012,ITF,ITF5,17,Basilicata,Basilicata,559084,99707,17.83,0.81
854,2021-02-07,BAS,373,159,214,49,324,ITF,ITF5,17,Basilicata,Basilicata,559084,100080,17.9,0.07
855,2021-05-18,BAS,5896,2855,3041,3403,2493,ITF,ITF5,17,Basilicata,Basilicata,559084,105976,18.96,1.05
856,2021-05-01,BAS,4703,2135,2568,3952,751,ITF,ITF5,17,Basilicata,Basilicata,559084,110679,19.8,0.84
857,2021-02-26,BAS,2149,904,1245,2069,80,ITF,ITF5,17,Basilicata,Basilicata,559084,112828,20.18,0.38
858,2021-05-11,BAS,2654,1353,1301,1621,1033,ITF,ITF5,17,Basilicata,Basilicata,559084,115482,20.66,0.47
859,2021-04-05,BAS,723,233,490,421,302,ITF,ITF5,17,Basilicata,Basilicata,559084,116205,20.78,0.13
860,2021-03-22,BAS,1176,531,645,629,547,ITF,ITF5,17,Basilicata,Basilicata,559084,117381,21.0,0.21
861,2021-03-03,BAS,1745,815,930,1186,559,ITF,ITF5,17,Basilicata,Basilicata,559084,119126,21.31,0.31
862,2021-05-25,BAS,4191,2107,2084,873,3318,ITF,ITF5,17,Basilicata,Basilicata,559084,123317,22.06,0.75
863,2021-02-14,BAS,151,48,103,151,0,ITF,ITF5,17,Basilicata,Basilicata,559084,123468,22.08,0.03
864,2021-01-31,BAS,77,24,53,0,77,ITF,ITF5,17,Basilicata,Basilicata,559084,123545,22.1,0.01
865,2021-01-24,BAS,837,300,537,58,779,ITF,ITF5,17,Basilicata,Basilicata,559084,124382,22.25,0.15
866,2021-05-13,BAS,5982,2966,3016,3385,2597,ITF,ITF5,17,Basilicata,Basilicata,559084,130364,23.32,1.07
867,2021-05-08,BAS,4835,2399,2436,3429,1406,ITF,ITF5,17,Basilicata,Basilicata,559084,135199,24.18,0.86
868,2021-04-17,BAS,3461,1655,1806,2199,1262,ITF,ITF5,17,Basilicata,Basilicata,559084,138660,24.8,0.62
869,2021-03-29,BAS,2435,881,1554,2149,286,ITF,ITF5,17,Basilicata,Basilicata,559084,141095,25.24,0.44
870,2021-01-05,BAS,946,409,537,946,0,ITF,ITF5,17,Basilicata,Basilicata,559084,142041,25.41,0.17
871,2021-06-08,BAS,4566,2179,2387,4209,357,ITF,ITF5,17,Basilicata,Basilicata,559084,146607,26.22,0.82
872,2021-04-12,BAS,2171,1052,1119,1680,491,ITF,ITF5,17,Basilicata,Basilicata,559084,148778,26.61,0.39
873,2021-04-19,BAS,4164,1911,2253,2526,1638,ITF,ITF5,17,Basilicata,Basilicata,559084,152942,27.36,0.74
874,2021-04-29,BAS,4831,2385,2446,4410,421,ITF,ITF5,17,Basilicata,Basilicata,559084,157773,28.22,0.86
875,2021-03-17,BAS,1453,609,844,28,1425,ITF,ITF5,17,Basilicata,Basilicata,559084,159226,28.48,0.26
876,2021-01-19,BAS,199,84,115,199,0,ITF,ITF5,17,Basilicata,Basilicata,559084,159425,28.52,0.04
877,2021-03-24,BAS,1758,690,1068,1361,397,ITF,ITF5,17,Basilicata,Basilicata,559084,161183,28.83,0.31
878,2021-05-23,BAS,4515,2300,2215,1533,2982,ITF,ITF5,17,Basilicata,Basilicata,559084,165698,29.64,0.81
879,2021-03-27,BAS,2233,853,1380,1816,417,ITF,ITF5,17,Basilicata,Basilicata,559084,167931,30.04,0.4
880,2021-01-07,BAS,640,319,321,640,0,ITF,ITF5,17,Basilicata,Basilicata,559084,168571,30.15,0.11
881,2021-02-19,BAS,1623,738,885,1561,62,ITF,ITF5,17,Basilicata,Basilicata,559084,170194,30.44,0.29
882,2021-03-19,BAS,2290,992,1298,262,2028,ITF,ITF5,17,Basilicata,Basilicata,559084,172484,30.85,0.41
883,2021-02-16,BAS,906,377,529,808,98,ITF,ITF5,17,Basilicata,Basilicata,559084,173390,31.01,0.16
884,2021-01-28,BAS,903,401,502,119,784,ITF,ITF5,17,Basilicata,Basilicata,559084,174293,31.17,0.16
885,2021-01-14,BAS,969,413,556,969,0,ITF,ITF5,17,Basilicata,Basilicata,559084,175262,31.35,0.17
886,2021-04-07,BAS,1220,550,670,1182,38,ITF,ITF5,17,Basilicata,Basilicata,559084,176482,31.57,0.22
887,2021-01-12,BAS,217,88,129,217,0,ITF,ITF5,17,Basilicata,Basilicata,559084,176699,31.61,0.04
888,2021-05-10,BAS,4807,2384,2423,2767,2040,ITF,ITF5,17,Basilicata,Basilicata,559084,181506,32.46,0.86
889,2021-03-14,BAS,1010,477,533,541,469,ITF,ITF5,17,Basilicata,Basilicata,559084,182516,32.65,0.18
890,2021-03-31,BAS,3095,1258,1837,2313,782,ITF,ITF5,17,Basilicata,Basilicata,559084,185611,33.2,0.55
891,2021-06-05,BAS,4793,2204,2589,3850,943,ITF,ITF5,17,Basilicata,Basilicata,559084,190404,34.06,0.86
892,2021-02-23,BAS,1901,771,1130,1763,138,ITF,ITF5,17,Basilicata,Basilicata,559084,192305,34.4,0.34
893,2021-06-03,BAS,4917,2255,2662,3736,1181,ITF,ITF5,17,Basilicata,Basilicata,559084,197222,35.28,0.88
894,2021-03-12,BAS,1903,979,924,803,1100,ITF,ITF5,17,Basilicata,Basilicata,559084,199125,35.62,0.34
895,2021-05-17,BAS,5539,2733,2806,3406,2133,ITF,ITF5,17,Basilicata,Basilicata,559084,204664,36.61,0.99
896,2021-03-10,BAS,1679,841,838,840,839,ITF,ITF5,17,Basilicata,Basilicata,559084,206343,36.91,0.3
897,2021-01-26,BAS,797,352,445,101,696,ITF,ITF5,17,Basilicata,Basilicata,559084,207140,37.05,0.14
898,2021-05-06,BAS,5052,2435,2617,3483,1569,ITF,ITF5,17,Basilicata,Basilicata,559084,212192,37.95,0.9
899,2021-05-15,BAS,6529,3343,3186,3957,2572,ITF,ITF5,17,Basilicata,Basilicata,559084,218721,39.12,1.17
900,2021-04-02,BAS,2318,1046,1272,1714,604,ITF,ITF5,17,Basilicata,Basilicata,559084,221039,39.54,0.41
901,2021-02-04,BAS,1096,442,654,63,1033,ITF,ITF5,17,Basilicata,Basilicata,559084,222135,39.73,0.2
902,2021-02-02,BAS,367,143,224,175,192,ITF,ITF5,17,Basilicata,Basilicata,559084,222502,39.8,0.07
903,2021-04-09,BAS,1152,350,802,1089,63,ITF,ITF5,17,Basilicata,Basilicata,559084,223654,40.0,0.21
904,2021-05-20,BAS,5855,2964,2891,2890,2965,ITF,ITF5,17,Basilicata,Basilicata,559084,229509,41.05,1.05
905,2021-06-06,BAS,4496,2066,2430,3720,776,ITF,ITF5,17,Basilicata,Basilicata,559084,234005,41.86,0.8
906,2021-04-14,BAS,2043,998,1045,1369,674,ITF,ITF5,17,Basilicata,Basilicata,559084,236048,42.22,0.37
907,2021-01-21,BAS,30,10,20,30,0,ITF,ITF5,17,Basilicata,Basilicata,559084,236078,42.23,0.01
908,2021-01-04,BAS,607,271,336,607,0,ITF,ITF5,17,Basilicata,Basilicata,559084,236685,42.33,0.11
909,2021-02-28,BAS,804,343,461,775,29,ITF,ITF5,17,Basilicata,Basilicata,559084,237489,42.48,0.14
910,2021-01-02,BAS,949,380,569,949,0,ITF,ITF5,17,Basilicata,Basilicata,559084,238438,42.65,0.17
911,2021-01-16,BAS,721,304,417,721,0,ITF,ITF5,17,Basilicata,Basilicata,559084,239159,42.78,0.13
912,2021-04-26,BAS,4465,2165,2300,4245,220,ITF,ITF5,17,Basilicata,Basilicata,559084,243624,43.58,0.8
913,2021-02-21,BAS,284,113,171,284,0,ITF,ITF5,17,Basilicata,Basilicata,559084,243908,43.63,0.05
914,2021-03-07,BAS,888,309,579,850,38,ITF,ITF5,17,Basilicata,Basilicata,559084,244796,43.79,0.16
915,2021-01-09,BAS,557,160,397,557,0,ITF,ITF5,17,Basilicata,Basilicata,559084,245353,43.88,0.1
916,2021-05-07,BAS,4649,2284,2365,3295,1354,ITF,ITF5,17,Basilicata,Basilicata,559084,250002,44.72,0.83
917,2021-05-14,BAS,5907,2798,3109,3374,2533,ITF,ITF5,17,Basilicata,Basilicata,559084,255909,45.77,1.06
918,2021-02-11,BAS,951,401,550,868,83,ITF,ITF5,17,Basilicata,Basilicata,559084,256860,45.94,0.17
919,2021-05-22,BAS,5488,2723,2765,1937,3551,ITF,ITF5,17,Basilicata,Basilicata,559084,262348,46.92,0.98
920,2021-03-26,BAS,1958,703,1255,1697,261,ITF,ITF5,17,Basilicata,Basilicata,559084,264306,47.27,0.35
921,2021-04-25,BAS,2986,1458,1528,2933,53,ITF,ITF5,17,Basilicata,Basilicata,559084,267292,47.81,0.53
922,2021-05-12,BAS,4722,2324,2398,2839,1883,ITF,ITF5,17,Basilicata,Basilicata,559084,272014,48.65,0.84
923,2021-04-06,BAS,1267,461,806,1082,185,ITF,ITF5,17,Basilicata,Basilicata,559084,273281,48.88,0.23
924,2021-03-23,BAS,1585,609,976,1412,173,ITF,ITF5,17,Basilicata,Basilicata,559084,274866,49.16,0.28
925,2021-02-01,BAS,242,91,151,46,196,ITF,ITF5,17,Basilicata,Basilicata,559084,275108,49.21,0.04
926,2021-05-26,BAS,4473,2248,2225,1706,2767,ITF,ITF5,17,Basilicata,Basilicata,559084,279581,50.01,0.8
927,2021-02-08,BAS,557,193,364,151,406,ITF,ITF5,17,Basilicata,Basilicata,559084,280138,50.11,0.1
928,2021-05-19,BAS,2870,1498,1372,1194,1676,ITF,ITF5,17,Basilicata,Basilicata,559084,283008,50.62,0.51
929,2021-02-25,BAS,1787,736,1051,1741,46,ITF,ITF5,17,Basilicata,Basilicata,559084,284795,50.94,0.32
930,2021-02-06,BAS,902,367,535,146,756,ITF,ITF5,17,Basilicata,Basilicata,559084,285697,51.1,0.16
931,2021-04-30,BAS,5284,2373,2911,4121,1163,ITF,ITF5,17,Basilicata,Basilicata,559084,290981,52.05,0.95
932,2021-01-20,BAS,84,22,62,84,0,ITF,ITF5,17,Basilicata,Basilicata,559084,291065,52.06,0.02
933,2021-03-21,BAS,1048,482,566,354,694,ITF,ITF5,17,Basilicata,Basilicata,559084,292113,52.25,0.19
934,2021-05-29,BAS,3012,1511,1501,831,2181,ITF,ITF5,17,Basilicata,Basilicata,559084,295125,52.79,0.54
935,2021-01-13,BAS,916,387,529,916,0,ITF,ITF5,17,Basilicata,Basilicata,559084,296041,52.95,0.16
936,2021-04-23,BAS,4536,2185,2351,3536,1000,ITF,ITF5,17,Basilicata,Basilicata,559084,300577,53.76,0.81
937,2021-01-30,BAS,704,227,477,128,576,ITF,ITF5,17,Basilicata,Basilicata,559084,301281,53.89,0.13
938,2021-01-23,BAS,719,303,416,33,686,ITF,ITF5,17,Basilicata,Basilicata,559084,302000,54.02,0.13
939,2021-05-03,BAS,4514,2044,2470,3687,827,ITF,ITF5,17,Basilicata,Basilicata,559084,306514,54.82,0.81
940,2021-02-09,BAS,491,213,278,316,175,ITF,ITF5,17,Basilicata,Basilicata,559084,307005,54.91,0.09
941,2021-03-28,BAS,2139,741,1398,2122,17,ITF,ITF5,17,Basilicata,Basilicata,559084,309144,55.29,0.38
942,2021-03-11,BAS,1791,925,866,832,959,ITF,ITF5,17,Basilicata,Basilicata,559084,310935,55.62,0.32
943,2021-03-30,BAS,2740,1157,1583,2395,345,ITF,ITF5,17,Basilicata,Basilicata,559084,313675,56.11,0.49
944,2021-01-06,BAS,294,129,165,294,0,ITF,ITF5,17,Basilicata,Basilicata,559084,313969,56.16,0.05
945,2021-04-16,BAS,3319,1632,1687,2421,898,ITF,ITF5,17,Basilicata,Basilicata,559084,317288,56.75,0.59
946,2021-03-18,BAS,1350,564,786,25,1325,ITF,ITF5,17,Basilicata,Basilicata,559084,318638,56.99,0.24
947,2021-02-27,BAS,1993,861,1132,1829,164,ITF,ITF5,17,Basilicata,Basilicata,559084,320631,57.35,0.36
948,2021-06-07,BAS,4217,1910,2307,3901,316,ITF,ITF5,17,Basilicata,Basilicata,559084,324848,58.1,0.75
949,2021-04-11,BAS,848,330,518,785,63,ITF,ITF5,17,Basilicata,Basilicata,559084,325696,58.26,0.15
950,2021-03-04,BAS,1879,892,987,1084,795,ITF,ITF5,17,Basilicata,Basilicata,559084,327575,58.59,0.34
951,2021-02-13,BAS,799,313,486,738,61,ITF,ITF5,17,Basilicata,Basilicata,559084,328374,58.73,0.14
952,2021-05-24,BAS,4826,2341,2485,1104,3722,ITF,ITF5,17,Basilicata,Basilicata,559084,333200,59.6,0.86
953,2021-06-02,BAS,5946,2796,3150,4409,1537,ITF,ITF5,17,Basilicata,Basilicata,559084,339146,60.66,1.06
954,2021-04-18,BAS,3719,1846,1873,2352,1367,ITF,ITF5,17,Basilicata,Basilicata,559084,342865,61.33,0.67
955,2021-02-20,BAS,1161,531,630,1043,118,ITF,ITF5,17,Basilicata,Basilicata,559084,344026,61.53,0.21
956,2021-05-31,BAS,4066,1936,2130,1699,2367,ITF,ITF5,17,Basilicata,Basilicata,559084,348092,62.26,0.73
957,2021-02-18,BAS,1070,401,669,855,215,ITF,ITF5,17,Basilicata,Basilicata,559084,349162,62.45,0.19
958,2021-04-04,BAS,610,225,385,197,413,ITF,ITF5,17,Basilicata,Basilicata,559084,349772,62.56,0.11
959,2021-02-12,BAS,775,332,443,744,31,ITF,ITF5,17,Basilicata,Basilicata,559084,350547,62.7,0.14
960,2021-04-10,BAS,1032,378,654,949,83,ITF,ITF5,17,Basilicata,Basilicata,559084,351579,62.88,0.18
961,2021-04-28,BAS,4704,2158,2546,4263,441,ITF,ITF5,17,Basilicata,Basilicata,559084,356283,63.73,0.84
962,2021-03-02,BAS,794,383,411,659,135,ITF,ITF5,17,Basilicata,Basilicata,559084,357077,63.87,0.14
963,2021-04-21,BAS,3921,1835,2086,2271,1650,ITF,ITF5,17,Basilicata,Basilicata,559084,360998,64.57,0.7
964,2021-01-18,BAS,463,157,306,364,99,ITF,ITF5,17,Basilicata,Basilicata,559084,361461,64.65,0.08
965,2021-03-16,BAS,1904,801,1103,229,1675,ITF,ITF5,17,Basilicata,Basilicata,559084,363365,64.99,0.34
966,2021-05-05,BAS,4334,2048,2286,3444,890,ITF,ITF5,17,Basilicata,Basilicata,559084,367699,65.77,0.78
967,2021-03-09,BAS,1397,710,687,792,605,ITF,ITF5,17,Basilicata,Basilicata,559084,369096,66.02,0.25
968,2021-01-25,BAS,1023,429,594,74,949,ITF,ITF5,17,Basilicata,Basilicata,559084,370119,66.2,0.18
969,2021-01-11,BAS,183,66,117,183,0,ITF,ITF5,17,Basilicata,Basilicata,559084,370302,66.23,0.03
970,2021-04-09,SAR,12261,5436,6825,7909,4352,ITG,ITG2,20,Sardegna,Sardegna,1639591,12261,0.75,0.75
971,2021-04-11,SAR,5393,2442,2951,4273,1120,ITG,ITG2,20,Sardegna,Sardegna,1639591,17654,1.08,0.33
972,2021-06-07,SAR,12214,5878,6336,9486,2728,ITG,ITG2,20,Sardegna,Sardegna,1639591,29868,1.82,0.74
973,2021-02-04,SAR,2271,816,1455,916,1355,ITG,ITG2,20,Sardegna,Sardegna,1639591,32139,1.96,0.14
974,2021-04-02,SAR,8987,3547,5440,5745,3242,ITG,ITG2,20,Sardegna,Sardegna,1639591,41126,2.51,0.55
975,2021-04-04,SAR,1,0,1,0,1,ITG,ITG2,20,Sardegna,Sardegna,1639591,41127,2.51,0.0
976,2021-04-23,SAR,12845,5735,7110,7384,5461,ITG,ITG2,20,Sardegna,Sardegna,1639591,53972,3.29,0.78
977,2021-05-10,SAR,9733,4337,5396,7196,2537,ITG,ITG2,20,Sardegna,Sardegna,1639591,63705,3.89,0.59
978,2021-01-30,SAR,3863,1392,2471,362,3501,ITG,ITG2,20,Sardegna,Sardegna,1639591,67568,4.12,0.24
979,2021-03-23,SAR,6157,2640,3517,5079,1078,ITG,ITG2,20,Sardegna,Sardegna,1639591,73725,4.5,0.38
980,2021-05-12,SAR,10780,5036,5744,7701,3079,ITG,ITG2,20,Sardegna,Sardegna,1639591,84505,5.15,0.66
981,2020-12-28,SAR,65,25,40,65,0,ITG,ITG2,20,Sardegna,Sardegna,1639591,84570,5.16,0.0
982,2021-03-28,SAR,4620,1815,2805,4541,79,ITG,ITG2,20,Sardegna,Sardegna,1639591,89190,5.44,0.28
983,2021-01-04,SAR,592,217,375,592,0,ITG,ITG2,20,Sardegna,Sardegna,1639591,89782,5.48,0.04
984,2021-04-16,SAR,14441,6488,7953,9098,5343,ITG,ITG2,20,Sardegna,Sardegna,1639591,104223,6.36,0.88
985,2021-01-23,SAR,60,22,38,0,60,ITG,ITG2,20,Sardegna,Sardegna,1639591,104283,6.36,0.0
986,2021-05-19,SAR,16387,8145,8242,12742,3645,ITG,ITG2,20,Sardegna,Sardegna,1639591,120670,7.36,1.0
987,2021-06-05,SAR,17409,8213,9196,11371,6038,ITG,ITG2,20,Sardegna,Sardegna,1639591,138079,8.42,1.06
988,2021-02-25,SAR,2899,1255,1644,2294,605,ITG,ITG2,20,Sardegna,Sardegna,1639591,140978,8.6,0.18
989,2021-03-14,SAR,607,376,231,607,0,ITG,ITG2,20,Sardegna,Sardegna,1639591,141585,8.64,0.04
990,2021-04-30,SAR,11132,5299,5833,6923,4209,ITG,ITG2,20,Sardegna,Sardegna,1639591,152717,9.31,0.68
991,2021-05-17,SAR,12118,5690,6428,9228,2890,ITG,ITG2,20,Sardegna,Sardegna,1639591,164835,10.05,0.74
992,2021-02-06,SAR,1970,697,1273,569,1401,ITG,ITG2,20,Sardegna,Sardegna,1639591,166805,10.17,0.12
993,2021-02-11,SAR,1315,490,825,1204,111,ITG,ITG2,20,Sardegna,Sardegna,1639591,168120,10.25,0.08
994,2021-05-24,SAR,13672,6545,7127,8482,5190,ITG,ITG2,20,Sardegna,Sardegna,1639591,181792,11.09,0.83
995,2021-02-13,SAR,1456,565,891,1454,2,ITG,ITG2,20,Sardegna,Sardegna,1639591,183248,11.18,0.09
996,2021-05-29,SAR,17977,8638,9339,13386,4591,ITG,ITG2,20,Sardegna,Sardegna,1639591,201225,12.27,1.1
997,2021-02-18,SAR,1878,732,1146,1814,64,ITG,ITG2,20,Sardegna,Sardegna,1639591,203103,12.39,0.11
998,2021-05-31,SAR,11157,5222,5935,8242,2915,ITG,ITG2,20,Sardegna,Sardegna,1639591,214260,13.07,0.68
999,2021-03-09,SAR,5153,2373,2780,4424,729,ITG,ITG2,20,Sardegna,Sardegna,1639591,219413,13.38,0.31
1000,2021-05-05,SAR,10154,4644,5510,8144,2010,ITG,ITG2,20,Sardegna,Sardegna,1639591,229567,14.0,0.62
1001,2021-03-02,SAR,2865,1459,1406,1712,1153,ITG,ITG2,20,Sardegna,Sardegna,1639591,232432,14.18,0.17
1002,2021-04-28,SAR,9019,4277,4742,5320,3699,ITG,ITG2,20,Sardegna,Sardegna,1639591,241451,14.73,0.55
1003,2021-01-18,SAR,904,326,578,780,124,ITG,ITG2,20,Sardegna,Sardegna,1639591,242355,14.78,0.06
1004,2021-03-16,SAR,4374,1949,2425,3452,922,ITG,ITG2,20,Sardegna,Sardegna,1639591,246729,15.05,0.27
1005,2021-01-16,SAR,1492,525,967,1492,0,ITG,ITG2,20,Sardegna,Sardegna,1639591,248221,15.14,0.09
1006,2021-03-06,SAR,2639,1079,1560,858,1781,ITG,ITG2,20,Sardegna,Sardegna,1639591,250860,15.3,0.16
1007,2021-04-06,SAR,7446,3113,4333,5018,2428,ITG,ITG2,20,Sardegna,Sardegna,1639591,258306,15.75,0.45
1008,2020-12-27,SAR,65,34,31,65,0,ITG,ITG2,20,Sardegna,Sardegna,1639591,258371,15.76,0.0
1009,2021-04-25,SAR,4497,2269,2228,3718,779,ITG,ITG2,20,Sardegna,Sardegna,1639591,262868,16.03,0.27
1010,2021-01-15,SAR,1563,573,990,1563,0,ITG,ITG2,20,Sardegna,Sardegna,1639591,264431,16.13,0.1
1011,2021-02-01,SAR,1524,605,919,225,1299,ITG,ITG2,20,Sardegna,Sardegna,1639591,265955,16.22,0.09
1012,2021-05-09,SAR,6129,2874,3255,5203,926,ITG,ITG2,20,Sardegna,Sardegna,1639591,272084,16.59,0.37
1013,2021-05-26,SAR,14353,7127,7226,9832,4521,ITG,ITG2,20,Sardegna,Sardegna,1639591,286437,17.47,0.88
1014,2021-02-15,SAR,958,349,609,927,31,ITG,ITG2,20,Sardegna,Sardegna,1639591,287395,17.53,0.06
1015,2021-02-22,SAR,1639,949,690,1411,228,ITG,ITG2,20,Sardegna,Sardegna,1639591,289034,17.63,0.1
1016,2021-03-11,SAR,6036,2726,3310,4835,1201,ITG,ITG2,20,Sardegna,Sardegna,1639591,295070,18.0,0.37
1017,2021-06-04,SAR,13942,6589,7353,9764,4178,ITG,ITG2,20,Sardegna,Sardegna,1639591,309012,18.85,0.85
1018,2021-03-13,SAR,2755,1076,1679,2474,281,ITG,ITG2,20,Sardegna,Sardegna,1639591,311767,19.01,0.17
1019,2021-03-30,SAR,8644,3463,5181,6368,2276,ITG,ITG2,20,Sardegna,Sardegna,1639591,320411,19.54,0.53
1020,2021-01-06,SAR,1615,549,1066,1615,0,ITG,ITG2,20,Sardegna,Sardegna,1639591,322026,19.64,0.1
1021,2021-03-04,SAR,4002,1953,2049,2747,1255,ITG,ITG2,20,Sardegna,Sardegna,1639591,326028,19.88,0.24
1022,2021-03-21,SAR,4030,1809,2221,2590,1440,ITG,ITG2,20,Sardegna,Sardegna,1639591,330058,20.13,0.25
1023,2021-01-13,SAR,573,178,395,573,0,ITG,ITG2,20,Sardegna,Sardegna,1639591,330631,20.17,0.03
1024,2021-01-01,SAR,32,17,15,32,0,ITG,ITG2,20,Sardegna,Sardegna,1639591,330663,20.17,0.0
1025,2021-02-27,SAR,1921,647,1274,1366,555,ITG,ITG2,20,Sardegna,Sardegna,1639591,332584,20.28,0.12
1026,2021-02-23,SAR,1519,1010,509,1285,234,ITG,ITG2,20,Sardegna,Sardegna,1639591,334103,20.38,0.09
1027,2021-05-02,SAR,5885,2669,3216,5304,581,ITG,ITG2,20,Sardegna,Sardegna,1639591,339988,20.74,0.36
1028,2021-02-08,SAR,1470,533,937,856,614,ITG,ITG2,20,Sardegna,Sardegna,1639591,341458,20.83,0.09
1029,2021-01-20,SAR,210,77,133,208,2,ITG,ITG2,20,Sardegna,Sardegna,1639591,341668,20.84,0.01
1030,2021-05-07,SAR,14127,6458,7669,9627,4500,ITG,ITG2,20,Sardegna,Sardegna,1639591,355795,21.7,0.86
1031,2021-01-27,SAR,1411,496,915,79,1332,ITG,ITG2,20,Sardegna,Sardegna,1639591,357206,21.79,0.09
1032,2021-03-25,SAR,8795,3704,5091,7490,1305,ITG,ITG2,20,Sardegna,Sardegna,1639591,366001,22.32,0.54
1033,2021-05-21,SAR,21104,10348,10756,15452,5652,ITG,ITG2,20,Sardegna,Sardegna,1639591,387105,23.61,1.29
1034,2021-03-18,SAR,7257,3071,4186,5652,1605,ITG,ITG2,20,Sardegna,Sardegna,1639591,394362,24.05,0.44
1035,2021-05-14,SAR,13891,6375,7516,10705,3186,ITG,ITG2,20,Sardegna,Sardegna,1639591,408253,24.9,0.85
1036,2021-02-03,SAR,1119,419,700,426,693,ITG,ITG2,20,Sardegna,Sardegna,1639591,409372,24.97,0.07
1037,2021-04-18,SAR,5127,2225,2902,2258,2869,ITG,ITG2,20,Sardegna,Sardegna,1639591,414499,25.28,0.31
1038,2021-01-08,SAR,3258,1184,2074,3258,0,ITG,ITG2,20,Sardegna,Sardegna,1639591,417757,25.48,0.2
1039,2021-06-02,SAR,9784,4690,5094,8143,1641,ITG,ITG2,20,Sardegna,Sardegna,1639591,427541,26.08,0.6
1040,2021-04-20,SAR,10993,4993,6000,7779,3214,ITG,ITG2,20,Sardegna,Sardegna,1639591,438534,26.75,0.67
1041,2021-04-21,SAR,12074,5557,6517,6541,5533,ITG,ITG2,20,Sardegna,Sardegna,1639591,450608,27.48,0.74
1042,2021-01-11,SAR,1183,505,678,1183,0,ITG,ITG2,20,Sardegna,Sardegna,1639591,451791,27.56,0.07
1043,2021-01-25,SAR,588,212,376,22,566,ITG,ITG2,20,Sardegna,Sardegna,1639591,452379,27.59,0.04
1044,2021-05-16,SAR,8186,3818,4368,6026,2160,ITG,ITG2,20,Sardegna,Sardegna,1639591,460565,28.09,0.5
1045,2021-03-20,SAR,5194,2074,3120,2917,2277,ITG,ITG2,20,Sardegna,Sardegna,1639591,465759,28.41,0.32
1046,2021-01-29,SAR,2955,1069,1886,48,2907,ITG,ITG2,20,Sardegna,Sardegna,1639591,468714,28.59,0.18
1047,2021-05-28,SAR,17706,8469,9237,13639,4067,ITG,ITG2,20,Sardegna,Sardegna,1639591,486420,29.67,1.08
1048,2021-02-17,SAR,1407,577,830,1333,74,ITG,ITG2,20,Sardegna,Sardegna,1639591,487827,29.75,0.09
1049,2021-05-25,SAR,14083,6840,7243,8534,5549,ITG,ITG2,20,Sardegna,Sardegna,1639591,501910,30.61,0.86
1050,2021-03-03,SAR,3859,2073,1786,2611,1248,ITG,ITG2,20,Sardegna,Sardegna,1639591,505769,30.85,0.24
1051,2021-03-22,SAR,3552,1363,2189,3039,513,ITG,ITG2,20,Sardegna,Sardegna,1639591,509321,31.06,0.22
1052,2021-04-08,SAR,13428,5925,7503,8308,5120,ITG,ITG2,20,Sardegna,Sardegna,1639591,522749,31.88,0.82
1053,2020-12-29,SAR,57,32,25,57,0,ITG,ITG2,20,Sardegna,Sardegna,1639591,522806,31.89,0.0
1054,2021-03-29,SAR,4425,1559,2866,3837,588,ITG,ITG2,20,Sardegna,Sardegna,1639591,527231,32.16,0.27
1055,2021-04-15,SAR,11821,5525,6296,6865,4956,ITG,ITG2,20,Sardegna,Sardegna,1639591,539052,32.88,0.72
1056,2021-01-05,SAR,1327,446,881,1327,0,ITG,ITG2,20,Sardegna,Sardegna,1639591,540379,32.96,0.08
1057,2021-01-22,SAR,83,47,36,55,28,ITG,ITG2,20,Sardegna,Sardegna,1639591,540462,32.96,0.01
1058,2021-04-17,SAR,10079,4500,5579,5482,4597,ITG,ITG2,20,Sardegna,Sardegna,1639591,550541,33.58,0.61
1059,2021-01-03,SAR,90,36,54,90,0,ITG,ITG2,20,Sardegna,Sardegna,1639591,550631,33.58,0.01
1060,2021-04-13,SAR,7607,3593,4014,5781,1826,ITG,ITG2,20,Sardegna,Sardegna,1639591,558238,34.05,0.46
1061,2021-06-09,SAR,9523,4451,5072,7283,2240,ITG,ITG2,20,Sardegna,Sardegna,1639591,567761,34.63,0.58
1062,2021-03-08,SAR,4008,1790,2218,2788,1220,ITG,ITG2,20,Sardegna,Sardegna,1639591,571769,34.87,0.24
1063,2021-05-04,SAR,9538,4386,5152,7685,1853,ITG,ITG2,20,Sardegna,Sardegna,1639591,581307,35.45,0.58
1064,2021-01-24,SAR,90,34,56,5,85,ITG,ITG2,20,Sardegna,Sardegna,1639591,581397,35.46,0.01
1065,2021-05-18,SAR,13920,6719,7201,9446,4474,ITG,ITG2,20,Sardegna,Sardegna,1639591,595317,36.31,0.85
1066,2021-02-24,SAR,2412,1293,1119,2223,189,ITG,ITG2,20,Sardegna,Sardegna,1639591,597729,36.46,0.15
1067,2021-04-01,SAR,10101,4026,6075,7088,3013,ITG,ITG2,20,Sardegna,Sardegna,1639591,607830,37.07,0.62
1068,2021-02-10,SAR,1959,765,1194,1441,518,ITG,ITG2,20,Sardegna,Sardegna,1639591,609789,37.19,0.12
1069,2021-04-12,SAR,6990,3179,3811,5276,1714,ITG,ITG2,20,Sardegna,Sardegna,1639591,616779,37.62,0.43
1070,2021-01-02,SAR,60,21,39,60,0,ITG,ITG2,20,Sardegna,Sardegna,1639591,616839,37.62,0.0
1071,2021-06-08,SAR,14188,6667,7521,11203,2985,ITG,ITG2,20,Sardegna,Sardegna,1639591,631027,38.49,0.87
1072,2021-02-28,SAR,368,169,199,142,226,ITG,ITG2,20,Sardegna,Sardegna,1639591,631395,38.51,0.02
1073,2021-04-26,SAR,6820,3263,3557,5945,875,ITG,ITG2,20,Sardegna,Sardegna,1639591,638215,38.93,0.42
1074,2021-06-01,SAR,14151,6503,7648,9674,4477,ITG,ITG2,20,Sardegna,Sardegna,1639591,652366,39.79,0.86
1075,2021-02-21,SAR,1589,710,879,1559,30,ITG,ITG2,20,Sardegna,Sardegna,1639591,653955,39.89,0.1
1076,2021-04-19,SAR,10181,4617,5564,8762,1419,ITG,ITG2,20,Sardegna,Sardegna,1639591,664136,40.51,0.62
1077,2021-01-09,SAR,4026,1417,2609,4026,0,ITG,ITG2,20,Sardegna,Sardegna,1639591,668162,40.75,0.25
1078,2021-02-20,SAR,2041,855,1186,1707,334,ITG,ITG2,20,Sardegna,Sardegna,1639591,670203,40.88,0.12
1079,2021-04-29,SAR,11114,5109,6005,6761,4353,ITG,ITG2,20,Sardegna,Sardegna,1639591,681317,41.55,0.68
1080,2021-01-10,SAR,2183,750,1433,2183,0,ITG,ITG2,20,Sardegna,Sardegna,1639591,683500,41.69,0.13
1081,2021-01-28,SAR,2970,1045,1925,69,2901,ITG,ITG2,20,Sardegna,Sardegna,1639591,686470,41.87,0.18
1082,2021-05-27,SAR,16908,8469,8439,12142,4766,ITG,ITG2,20,Sardegna,Sardegna,1639591,703378,42.9,1.03
1083,2021-02-16,SAR,700,289,411,673,27,ITG,ITG2,20,Sardegna,Sardegna,1639591,704078,42.94,0.04
1084,2021-03-05,SAR,5036,2445,2591,2682,2354,ITG,ITG2,20,Sardegna,Sardegna,1639591,709114,43.25,0.31
1085,2021-03-19,SAR,7269,3049,4220,5054,2215,ITG,ITG2,20,Sardegna,Sardegna,1639591,716383,43.69,0.44
1086,2021-04-07,SAR,13478,5986,7492,7830,5648,ITG,ITG2,20,Sardegna,Sardegna,1639591,729861,44.51,0.82
1087,2021-04-24,SAR,10366,4851,5515,8030,2336,ITG,ITG2,20,Sardegna,Sardegna,1639591,740227,45.15,0.63
1088,2021-01-14,SAR,1105,426,679,1105,0,ITG,ITG2,20,Sardegna,Sardegna,1639591,741332,45.21,0.07
1089,2021-03-31,SAR,10155,4051,6104,7708,2447,ITG,ITG2,20,Sardegna,Sardegna,1639591,751487,45.83,0.62
1090,2021-06-03,SAR,16058,7348,8710,10616,5442,ITG,ITG2,20,Sardegna,Sardegna,1639591,767545,46.81,0.98
1091,2021-03-12,SAR,5758,2408,3350,4450,1308,ITG,ITG2,20,Sardegna,Sardegna,1639591,773303,47.16,0.35
1092,2021-04-22,SAR,10491,4647,5844,5572,4919,ITG,ITG2,20,Sardegna,Sardegna,1639591,783794,47.8,0.64
1093,2021-01-12,SAR,865,408,457,865,0,ITG,ITG2,20,Sardegna,Sardegna,1639591,784659,47.86,0.05
1094,2021-05-11,SAR,8648,3989,4659,6317,2331,ITG,ITG2,20,Sardegna,Sardegna,1639591,793307,48.38,0.53
1095,2021-01-31,SAR,2121,750,1371,48,2073,ITG,ITG2,20,Sardegna,Sardegna,1639591,795428,48.51,0.13
1096,2021-02-14,SAR,539,263,276,537,2,ITG,ITG2,20,Sardegna,Sardegna,1639591,795967,48.55,0.03
1097,2021-04-05,SAR,2036,784,1252,2035,1,ITG,ITG2,20,Sardegna,Sardegna,1639591,798003,48.67,0.12
1098,2021-06-06,SAR,10027,4996,5031,6375,3652,ITG,ITG2,20,Sardegna,Sardegna,1639591,808030,49.28,0.61
1099,2021-04-14,SAR,8250,3902,4348,7013,1237,ITG,ITG2,20,Sardegna,Sardegna,1639591,816280,49.79,0.5
1100,2021-05-01,SAR,9907,4762,5145,5450,4457,ITG,ITG2,20,Sardegna,Sardegna,1639591,826187,50.39,0.6
1101,2021-01-21,SAR,126,60,66,94,32,ITG,ITG2,20,Sardegna,Sardegna,1639591,826313,50.4,0.01
1102,2021-02-07,SAR,1117,395,722,228,889,ITG,ITG2,20,Sardegna,Sardegna,1639591,827430,50.47,0.07
1103,2021-05-03,SAR,8182,3818,4364,6586,1596,ITG,ITG2,20,Sardegna,Sardegna,1639591,835612,50.96,0.5
1104,2021-05-20,SAR,15855,7500,8355,11306,4549,ITG,ITG2,20,Sardegna,Sardegna,1639591,851467,51.93,0.97
1105,2021-02-09,SAR,2287,837,1450,1290,997,ITG,ITG2,20,Sardegna,Sardegna,1639591,853754,52.07,0.14
1106,2021-02-26,SAR,2801,1109,1692,2495,306,ITG,ITG2,20,Sardegna,Sardegna,1639591,856555,52.24,0.17
1107,2021-03-07,SAR,1657,750,907,1117,540,ITG,ITG2,20,Sardegna,Sardegna,1639591,858212,52.34,0.1
1108,2021-03-10,SAR,6012,2919,3093,5162,850,ITG,ITG2,20,Sardegna,Sardegna,1639591,864224,52.71,0.37
1109,2021-05-06,SAR,12943,6008,6935,9797,3146,ITG,ITG2,20,Sardegna,Sardegna,1639591,877167,53.5,0.79
1110,2021-03-01,SAR,2162,1055,1107,1503,659,ITG,ITG2,20,Sardegna,Sardegna,1639591,879329,53.63,0.13
1111,2021-05-13,SAR,11412,5286,6126,8432,2980,ITG,ITG2,20,Sardegna,Sardegna,1639591,890741,54.33,0.7
1112,2021-02-02,SAR,1482,655,827,241,1241,ITG,ITG2,20,Sardegna,Sardegna,1639591,892223,54.42,0.09
1113,2021-05-15,SAR,13758,6417,7341,10325,3433,ITG,ITG2,20,Sardegna,Sardegna,1639591,905981,55.26,0.84
1114,2021-04-27,SAR,7608,3547,4061,5567,2041,ITG,ITG2,20,Sardegna,Sardegna,1639591,913589,55.72,0.46
1115,2021-01-17,SAR,860,277,583,859,1,ITG,ITG2,20,Sardegna,Sardegna,1639591,914449,55.77,0.05
1116,2021-03-15,SAR,2689,1219,1470,2316,373,ITG,ITG2,20,Sardegna,Sardegna,1639591,917138,55.94,0.16
1117,2021-03-26,SAR,8091,3180,4911,6566,1525,ITG,ITG2,20,Sardegna,Sardegna,1639591,925229,56.43,0.49
1118,2021-05-22,SAR,24663,11824,12839,19566,5097,ITG,ITG2,20,Sardegna,Sardegna,1639591,949892,57.93,1.5
1119,2021-01-19,SAR,747,270,477,692,55,ITG,ITG2,20,Sardegna,Sardegna,1639591,950639,57.98,0.05
1120,2021-03-17,SAR,6556,2849,3707,4949,1607,ITG,ITG2,20,Sardegna,Sardegna,1639591,957195,58.38,0.4
1121,2021-03-24,SAR,7287,2998,4289,5928,1359,ITG,ITG2,20,Sardegna,Sardegna,1639591,964482,58.82,0.44
1122,2021-01-26,SAR,1336,453,883,27,1309,ITG,ITG2,20,Sardegna,Sardegna,1639591,965818,58.91,0.08
1123,2021-05-08,SAR,13082,5967,7115,10794,2288,ITG,ITG2,20,Sardegna,Sardegna,1639591,978900,59.7,0.8
1124,2021-02-05,SAR,1897,749,1148,433,1464,ITG,ITG2,20,Sardegna,Sardegna,1639591,980797,59.82,0.12
1125,2021-04-03,SAR,4663,1802,2861,2696,1967,ITG,ITG2,20,Sardegna,Sardegna,1639591,985460,60.1,0.28
1126,2021-05-30,SAR,9725,4836,4889,7369,2356,ITG,ITG2,20,Sardegna,Sardegna,1639591,995185,60.7,0.59
1127,2021-02-19,SAR,1499,473,1026,1443,56,ITG,ITG2,20,Sardegna,Sardegna,1639591,996684,60.79,0.09
1128,2021-03-27,SAR,5720,2178,3542,5298,422,ITG,ITG2,20,Sardegna,Sardegna,1639591,1002404,61.14,0.35
1129,2021-05-23,SAR,9964,4805,5159,7720,2244,ITG,ITG2,20,Sardegna,Sardegna,1639591,1012368,61.75,0.61
1130,2021-02-12,SAR,2237,933,1304,2178,59,ITG,ITG2,20,Sardegna,Sardegna,1639591,1014605,61.88,0.14
1131,2021-04-10,SAR,10489,4748,5741,8554,1935,ITG,ITG2,20,Sardegna,Sardegna,1639591,1025094,62.52,0.64
1132,2021-01-07,SAR,3112,1077,2035,3112,0,ITG,ITG2,20,Sardegna,Sardegna,1639591,1028206,62.71,0.19
1133,2020-12-31,SAR,32,16,16,32,0,ITG,ITG2,20,Sardegna,Sardegna,1639591,1028238,62.71,0.0
1134,2021-06-06,PAB,4526,2175,2351,853,3673,ITH,ITH1,4,Provincia Autonoma Bolzano / Bozen,P.A. Bolzano,533050,4526,0.85,0.85
1135,2021-02-26,PAB,1526,551,975,1496,30,ITH,ITH1,4,Provincia Autonoma Bolzano / Bozen,P.A. Bolzano,533050,6052,1.14,0.29
1136,2021-06-01,PAB,3495,2261,1234,2071,1424,ITH,ITH1,4,Provincia Autonoma Bolzano / Bozen,P.A. Bolzano,533050,9547,1.79,0.66
1137,2021-02-19,PAB,2252,512,1740,2241,11,ITH,ITH1,4,Provincia Autonoma Bolzano / Bozen,P.A. Bolzano,533050,11799,2.21,0.42
1138,2021-02-07,PAB,2361,1057,1304,14,2347,ITH,ITH1,4,Provincia Autonoma Bolzano / Bozen,P.A. Bolzano,533050,14160,2.66,0.44
1139,2021-05-18,PAB,3313,1732,1581,2149,1164,ITH,ITH1,4,Provincia Autonoma Bolzano / Bozen,P.A. Bolzano,533050,17473,3.28,0.62
1140,2021-05-01,PAB,2104,1067,1037,1944,160,ITH,ITH1,4,Provincia Autonoma Bolzano / Bozen,P.A. Bolzano,533050,19577,3.67,0.39
1141,2021-05-20,PAB,4706,2321,2385,3250,1456,ITH,ITH1,4,Provincia Autonoma Bolzano / Bozen,P.A. Bolzano,533050,24283,4.56,0.88
1142,2021-03-31,PAB,1832,694,1138,821,1011,ITH,ITH1,4,Provincia Autonoma Bolzano / Bozen,P.A. Bolzano,533050,26115,4.9,0.34
1143,2021-01-05,PAB,830,286,544,830,0,ITH,ITH1,4,Provincia Autonoma Bolzano / Bozen,P.A. Bolzano,533050,26945,5.05,0.16
1144,2021-01-23,PAB,197,117,80,0,197,ITH,ITH1,4,Provincia Autonoma Bolzano / Bozen,P.A. Bolzano,533050,27142,5.09,0.04
1145,2021-03-22,PAB,1144,523,621,1139,5,ITH,ITH1,4,Provincia Autonoma Bolzano / Bozen,P.A. Bolzano,533050,28286,5.31,0.21
1146,2021-03-05,PAB,1839,625,1214,1397,442,ITH,ITH1,4,Provincia Autonoma Bolzano / Bozen,P.A. Bolzano,533050,30125,5.65,0.34
1147,2021-05-27,PAB,6072,3192,2880,4063,2009,ITH,ITH1,4,Provincia Autonoma Bolzano / Bozen,P.A. Bolzano,533050,36197,6.79,1.14
1148,2021-05-25,PAB,3814,1972,1842,2940,874,ITH,ITH1,4,Provincia Autonoma Bolzano / Bozen,P.A. Bolzano,533050,40011,7.51,0.72
1149,2021-02-14,PAB,297,130,167,297,0,ITH,ITH1,4,Provincia Autonoma Bolzano / Bozen,P.A. Bolzano,533050,40308,7.56,0.06
1150,2021-05-08,PAB,4426,2381,2045,3762,664,ITH,ITH1,4,Provincia Autonoma Bolzano / Bozen,P.A. Bolzano,533050,44734,8.39,0.83
1151,2021-04-24,PAB,5104,2449,2655,4619,485,ITH,ITH1,4,Provincia Autonoma Bolzano / Bozen,P.A. Bolzano,533050,49838,9.35,0.96
1152,2021-04-05,PAB,301,144,157,23,278,ITH,ITH1,4,Provincia Autonoma Bolzano / Bozen,P.A. Bolzano,533050,50139,9.41,0.06
1153,2021-01-12,PAB,1709,459,1250,1709,0,ITH,ITH1,4,Provincia Autonoma Bolzano / Bozen,P.A. Bolzano,533050,51848,9.73,0.32
1154,2021-02-12,PAB,730,217,513,482,248,ITH,ITH1,4,Provincia Autonoma Bolzano / Bozen,P.A. Bolzano,533050,52578,9.86,0.14
1155,2021-04-10,PAB,5391,2664,2727,4803,588,ITH,ITH1,4,Provincia Autonoma Bolzano / Bozen,P.A. Bolzano,533050,57969,10.87,1.01
1156,2020-12-31,PAB,913,519,394,913,0,ITH,ITH1,4,Provincia Autonoma Bolzano / Bozen,P.A. Bolzano,533050,58882,11.05,0.17
1157,2021-04-19,PAB,1871,858,1013,1689,182,ITH,ITH1,4,Provincia Autonoma Bolzano / Bozen,P.A. Bolzano,533050,60753,11.4,0.35
1158,2021-04-17,PAB,5233,2599,2634,5189,44,ITH,ITH1,4,Provincia Autonoma Bolzano / Bozen,P.A. Bolzano,533050,65986,12.38,0.98
1159,2021-01-07,PAB,917,327,590,917,0,ITH,ITH1,4,Provincia Autonoma Bolzano / Bozen,P.A. Bolzano,533050,66903,12.55,0.17
1160,2021-01-26,PAB,810,291,519,1,809,ITH,ITH1,4,Provincia Autonoma Bolzano / Bozen,P.A. Bolzano,533050,67713,12.7,0.15
1161,2021-03-24,PAB,2059,995,1064,2046,13,ITH,ITH1,4,Provincia Autonoma Bolzano / Bozen,P.A. Bolzano,533050,69772,13.09,0.39
1162,2021-03-10,PAB,1268,529,739,1125,143,ITH,ITH1,4,Provincia Autonoma Bolzano / Bozen,P.A. Bolzano,533050,71040,13.33,0.24
1163,2021-05-06,PAB,5181,2747,2434,2612,2569,ITH,ITH1,4,Provincia Autonoma Bolzano / Bozen,P.A. Bolzano,533050,76221,14.3,0.97
1164,2021-03-17,PAB,581,213,368,580,1,ITH,ITH1,4,Provincia Autonoma Bolzano / Bozen,P.A. Bolzano,533050,76802,14.41,0.11
1165,2021-05-13,PAB,2994,1355,1639,1064,1930,ITH,ITH1,4,Provincia Autonoma Bolzano / Bozen,P.A. Bolzano,533050,79796,14.97,0.56
1166,2021-01-24,PAB,12,10,2,0,12,ITH,ITH1,4,Provincia Autonoma Bolzano / Bozen,P.A. Bolzano,533050,79808,14.97,0.0
1167,2021-05-03,PAB,1830,847,983,417,1413,ITH,ITH1,4,Provincia Autonoma Bolzano / Bozen,P.A. Bolzano,533050,81638,15.32,0.34
1168,2021-02-23,PAB,769,324,445,763,6,ITH,ITH1,4,Provincia Autonoma Bolzano / Bozen,P.A. Bolzano,533050,82407,15.46,0.14
1169,2021-05-17,PAB,3124,1506,1618,2440,684,ITH,ITH1,4,Provincia Autonoma Bolzano / Bozen,P.A. Bolzano,533050,85531,16.05,0.59
1170,2021-06-03,PAB,4699,2544,2155,3774,925,ITH,ITH1,4,Provincia Autonoma Bolzano / Bozen,P.A. Bolzano,533050,90230,16.93,0.88
1171,2021-03-14,PAB,758,336,422,25,733,ITH,ITH1,4,Provincia Autonoma Bolzano / Bozen,P.A. Bolzano,533050,90988,17.07,0.14
1172,2021-04-14,PAB,3593,1645,1948,3502,91,ITH,ITH1,4,Provincia Autonoma Bolzano / Bozen,P.A. Bolzano,533050,94581,17.74,0.67
1173,2021-01-04,PAB,508,201,307,508,0,ITH,ITH1,4,Provincia Autonoma Bolzano / Bozen,P.A. Bolzano,533050,95089,17.84,0.1
1174,2021-03-03,PAB,1179,393,786,1166,13,ITH,ITH1,4,Provincia Autonoma Bolzano / Bozen,P.A. Bolzano,533050,96268,18.06,0.22
1175,2021-05-10,PAB,3018,1300,1718,1413,1605,ITH,ITH1,4,Provincia Autonoma Bolzano / Bozen,P.A. Bolzano,533050,99286,18.63,0.57
1176,2021-02-16,PAB,530,205,325,530,0,ITH,ITH1,4,Provincia Autonoma Bolzano / Bozen,P.A. Bolzano,533050,99816,18.73,0.1
1177,2021-01-28,PAB,871,308,563,10,861,ITH,ITH1,4,Provincia Autonoma Bolzano / Bozen,P.A. Bolzano,533050,100687,18.89,0.16
1178,2021-03-12,PAB,1664,734,930,1251,413,ITH,ITH1,4,Provincia Autonoma Bolzano / Bozen,P.A. Bolzano,533050,102351,19.2,0.31
1179,2021-03-29,PAB,1171,499,672,412,759,ITH,ITH1,4,Provincia Autonoma Bolzano / Bozen,P.A. Bolzano,533050,103522,19.42,0.22
1180,2021-01-21,PAB,953,442,511,139,814,ITH,ITH1,4,Provincia Autonoma Bolzano / Bozen,P.A. Bolzano,533050,104475,19.6,0.18
1181,2021-06-08,PAB,3762,1880,1882,455,3307,ITH,ITH1,4,Provincia Autonoma Bolzano / Bozen,P.A. Bolzano,533050,108237,20.31,0.71
1182,2021-04-28,PAB,2464,1302,1162,2459,5,ITH,ITH1,4,Provincia Autonoma Bolzano / Bozen,P.A. Bolzano,533050,110701,20.77,0.46
1183,2021-01-16,PAB,2840,1265,1575,2840,0,ITH,ITH1,4,Provincia Autonoma Bolzano / Bozen,P.A. Bolzano,533050,113541,21.3,0.53
1184,2021-03-21,PAB,768,285,483,14,754,ITH,ITH1,4,Provincia Autonoma Bolzano / Bozen,P.A. Bolzano,533050,114309,21.44,0.14
1185,2021-01-14,PAB,1946,575,1371,1946,0,ITH,ITH1,4,Provincia Autonoma Bolzano / Bozen,P.A. Bolzano,533050,116255,21.81,0.37
1186,2021-04-07,PAB,1798,823,975,1258,540,ITH,ITH1,4,Provincia Autonoma Bolzano / Bozen,P.A. Bolzano,533050,118053,22.15,0.34
1187,2021-03-02,PAB,695,200,495,693,2,ITH,ITH1,4,Provincia Autonoma Bolzano / Bozen,P.A. Bolzano,533050,118748,22.28,0.13
1188,2021-03-19,PAB,1906,773,1133,799,1107,ITH,ITH1,4,Provincia Autonoma Bolzano / Bozen,P.A. Bolzano,533050,120654,22.63,0.36
1189,2021-05-15,PAB,6997,3685,3312,6702,295,ITH,ITH1,4,Provincia Autonoma Bolzano / Bozen,P.A. Bolzano,533050,127651,23.95,1.31
1190,2021-02-04,PAB,1958,593,1365,8,1950,ITH,ITH1,4,Provincia Autonoma Bolzano / Bozen,P.A. Bolzano,533050,129609,24.31,0.37
1191,2021-04-02,PAB,2077,837,1240,720,1357,ITH,ITH1,4,Provincia Autonoma Bolzano / Bozen,P.A. Bolzano,533050,131686,24.7,0.39
1192,2021-05-29,PAB,7131,3767,3364,3994,3137,ITH,ITH1,4,Provincia Autonoma Bolzano / Bozen,P.A. Bolzano,533050,138817,26.04,1.34
1193,2021-03-26,PAB,1655,731,924,522,1133,ITH,ITH1,4,Provincia Autonoma Bolzano / Bozen,P.A. Bolzano,533050,140472,26.35,0.31
1194,2021-04-09,PAB,2937,1301,1636,2207,730,ITH,ITH1,4,Provincia Autonoma Bolzano / Bozen,P.A. Bolzano,533050,143409,26.9,0.55
1195,2021-04-12,PAB,2105,946,1159,2098,7,ITH,ITH1,4,Provincia Autonoma Bolzano / Bozen,P.A. Bolzano,533050,145514,27.3,0.39
1196,2021-03-07,PAB,114,13,101,9,105,ITH,ITH1,4,Provincia Autonoma Bolzano / Bozen,P.A. Bolzano,533050,145628,27.32,0.02
1197,2021-04-21,PAB,3012,1468,1544,2164,848,ITH,ITH1,4,Provincia Autonoma Bolzano / Bozen,P.A. Bolzano,533050,148640,27.88,0.57
1198,2021-01-09,PAB,612,326,286,612,0,ITH,ITH1,4,Provincia Autonoma Bolzano / Bozen,P.A. Bolzano,533050,149252,28.0,0.11
1199,2021-04-29,PAB,2630,1351,1279,1936,694,ITH,ITH1,4,Provincia Autonoma Bolzano / Bozen,P.A. Bolzano,533050,151882,28.49,0.49
1200,2021-01-19,PAB,853,371,482,723,130,ITH,ITH1,4,Provincia Autonoma Bolzano / Bozen,P.A. Bolzano,533050,152735,28.65,0.16
1201,2021-02-09,PAB,317,126,191,1,316,ITH,ITH1,4,Provincia Autonoma Bolzano / Bozen,P.A. Bolzano,533050,153052,28.71,0.06
1202,2021-02-02,PAB,1745,506,1239,8,1737,ITH,ITH1,4,Provincia Autonoma Bolzano / Bozen,P.A. Bolzano,533050,154797,29.04,0.33
1203,2021-02-06,PAB,2626,1171,1455,19,2607,ITH,ITH1,4,Provincia Autonoma Bolzano / Bozen,P.A. Bolzano,533050,157423,29.53,0.49
1204,2021-03-28,PAB,569,212,357,11,558,ITH,ITH1,4,Provincia Autonoma Bolzano / Bozen,P.A. Bolzano,533050,157992,29.64,0.11
1205,2021-06-05,PAB,6065,3021,3044,4972,1093,ITH,ITH1,4,Provincia Autonoma Bolzano / Bozen,P.A. Bolzano,533050,164057,30.78,1.14
1206,2021-04-30,PAB,3337,1592,1745,1562,1775,ITH,ITH1,4,Provincia Autonoma Bolzano / Bozen,P.A. Bolzano,533050,167394,31.4,0.63
1207,2021-01-20,PAB,617,252,365,409,208,ITH,ITH1,4,Provincia Autonoma Bolzano / Bozen,P.A. Bolzano,533050,168011,31.52,0.12
1208,2021-01-06,PAB,59,18,41,59,0,ITH,ITH1,4,Provincia Autonoma Bolzano / Bozen,P.A. Bolzano,533050,168070,31.53,0.01
1209,2021-03-30,PAB,1298,532,766,218,1080,ITH,ITH1,4,Provincia Autonoma Bolzano / Bozen,P.A. Bolzano,533050,169368,31.77,0.24
1210,2021-04-16,PAB,2949,1418,1531,2438,511,ITH,ITH1,4,Provincia Autonoma Bolzano / Bozen,P.A. Bolzano,533050,172317,32.33,0.55
1211,2021-03-11,PAB,1684,825,859,1146,538,ITH,ITH1,4,Provincia Autonoma Bolzano / Bozen,P.A. Bolzano,533050,174001,32.64,0.32
1212,2021-02-25,PAB,1498,549,949,1497,1,ITH,ITH1,4,Provincia Autonoma Bolzano / Bozen,P.A. Bolzano,533050,175499,32.92,0.28
1213,2021-06-02,PAB,1443,809,634,987,456,ITH,ITH1,4,Provincia Autonoma Bolzano / Bozen,P.A. Bolzano,533050,176942,33.19,0.27
1214,2021-03-04,PAB,1714,1004,710,1485,229,ITH,ITH1,4,Provincia Autonoma Bolzano / Bozen,P.A. Bolzano,533050,178656,33.52,0.32
1215,2021-05-26,PAB,4913,2474,2439,2961,1952,ITH,ITH1,4,Provincia Autonoma Bolzano / Bozen,P.A. Bolzano,533050,183569,34.44,0.92
1216,2021-04-26,PAB,1543,771,772,1538,5,ITH,ITH1,4,Provincia Autonoma Bolzano / Bozen,P.A. Bolzano,533050,185112,34.73,0.29
1217,2021-01-18,PAB,1772,687,1085,1767,5,ITH,ITH1,4,Provincia Autonoma Bolzano / Bozen,P.A. Bolzano,533050,186884,35.06,0.33
1218,2021-04-25,PAB,3072,1497,1575,2401,671,ITH,ITH1,4,Provincia Autonoma Bolzano / Bozen,P.A. Bolzano,533050,189956,35.64,0.58
1219,2021-01-13,PAB,1691,557,1134,1691,0,ITH,ITH1,4,Provincia Autonoma Bolzano / Bozen,P.A. Bolzano,533050,191647,35.95,0.32
1220,2021-01-30,PAB,498,245,253,4,494,ITH,ITH1,4,Provincia Autonoma Bolzano / Bozen,P.A. Bolzano,533050,192145,36.05,0.09
1221,2021-04-23,PAB,4542,2151,2391,3251,1291,ITH,ITH1,4,Provincia Autonoma Bolzano / Bozen,P.A. Bolzano,533050,196687,36.9,0.85
1222,2021-05-22,PAB,6821,3552,3269,4654,2167,ITH,ITH1,4,Provincia Autonoma Bolzano / Bozen,P.A. Bolzano,533050,203508,38.18,1.28
1223,2021-02-11,PAB,1093,431,662,239,854,ITH,ITH1,4,Provincia Autonoma Bolzano / Bozen,P.A. Bolzano,533050,204601,38.38,0.21
1224,2021-02-18,PAB,1839,457,1382,1832,7,ITH,ITH1,4,Provincia Autonoma Bolzano / Bozen,P.A. Bolzano,533050,206440,38.73,0.34
1225,2020-12-30,PAB,388,182,206,388,0,ITH,ITH1,4,Provincia Autonoma Bolzano / Bozen,P.A. Bolzano,533050,206828,38.8,0.07
1226,2021-06-09,PAB,3459,1687,1772,1129,2330,ITH,ITH1,4,Provincia Autonoma Bolzano / Bozen,P.A. Bolzano,533050,210287,39.45,0.65
1227,2021-03-01,PAB,922,221,701,921,1,ITH,ITH1,4,Provincia Autonoma Bolzano / Bozen,P.A. Bolzano,533050,211209,39.62,0.17
1228,2021-03-15,PAB,1192,451,741,710,482,ITH,ITH1,4,Provincia Autonoma Bolzano / Bozen,P.A. Bolzano,533050,212401,39.85,0.22
1229,2021-04-27,PAB,2226,1013,1213,1150,1076,ITH,ITH1,4,Provincia Autonoma Bolzano / Bozen,P.A. Bolzano,533050,214627,40.26,0.42
1230,2021-01-17,PAB,2328,1044,1284,2317,11,ITH,ITH1,4,Provincia Autonoma Bolzano / Bozen,P.A. Bolzano,533050,216955,40.7,0.44
1231,2021-04-20,PAB,1561,784,777,1560,1,ITH,ITH1,4,Provincia Autonoma Bolzano / Bozen,P.A. Bolzano,533050,218516,40.99,0.29
1232,2021-01-10,PAB,2,2,0,2,0,ITH,ITH1,4,Provincia Autonoma Bolzano / Bozen,P.A. Bolzano,533050,218518,40.99,0.0
1233,2021-01-02,PAB,91,48,43,91,0,ITH,ITH1,4,Provincia Autonoma Bolzano / Bozen,P.A. Bolzano,533050,218609,41.01,0.02
1234,2021-03-18,PAB,1302,531,771,226,1076,ITH,ITH1,4,Provincia Autonoma Bolzano / Bozen,P.A. Bolzano,533050,219911,41.26,0.24
1235,2021-05-14,PAB,5112,2302,2810,3096,2016,ITH,ITH1,4,Provincia Autonoma Bolzano / Bozen,P.A. Bolzano,533050,225023,42.21,0.96
1236,2021-03-16,PAB,1290,532,758,124,1166,ITH,ITH1,4,Provincia Autonoma Bolzano / Bozen,P.A. Bolzano,533050,226313,42.46,0.24
1237,2021-05-12,PAB,3790,2058,1732,3637,153,ITH,ITH1,4,Provincia Autonoma Bolzano / Bozen,P.A. Bolzano,533050,230103,43.17,0.71
1238,2021-02-01,PAB,1452,440,1012,12,1440,ITH,ITH1,4,Provincia Autonoma Bolzano / Bozen,P.A. Bolzano,533050,231555,43.44,0.27
1239,2021-06-04,PAB,6432,3214,3218,4925,1507,ITH,ITH1,4,Provincia Autonoma Bolzano / Bozen,P.A. Bolzano,533050,237987,44.65,1.21
1240,2021-02-24,PAB,1367,406,961,1355,12,ITH,ITH1,4,Provincia Autonoma Bolzano / Bozen,P.A. Bolzano,533050,239354,44.9,0.26
1241,2021-03-27,PAB,3050,1553,1497,1543,1507,ITH,ITH1,4,Provincia Autonoma Bolzano / Bozen,P.A. Bolzano,533050,242404,45.47,0.57
1242,2021-03-13,PAB,2885,1459,1426,2784,101,ITH,ITH1,4,Provincia Autonoma Bolzano / Bozen,P.A. Bolzano,533050,245289,46.02,0.54
1243,2021-02-05,PAB,3195,1181,2014,8,3187,ITH,ITH1,4,Provincia Autonoma Bolzano / Bozen,P.A. Bolzano,533050,248484,46.62,0.6
1244,2021-04-15,PAB,4399,2307,2092,4136,263,ITH,ITH1,4,Provincia Autonoma Bolzano / Bozen,P.A. Bolzano,533050,252883,47.44,0.83
1245,2021-05-02,PAB,2457,1288,1169,1536,921,ITH,ITH1,4,Provincia Autonoma Bolzano / Bozen,P.A. Bolzano,533050,255340,47.9,0.46
1246,2021-01-22,PAB,248,143,105,124,124,ITH,ITH1,4,Provincia Autonoma Bolzano / Bozen,P.A. Bolzano,533050,255588,47.95,0.05
1247,2021-02-15,PAB,72,42,30,26,46,ITH,ITH1,4,Provincia Autonoma Bolzano / Bozen,P.A. Bolzano,533050,255660,47.96,0.01
1248,2021-05-11,PAB,2842,1334,1508,1320,1522,ITH,ITH1,4,Provincia Autonoma Bolzano / Bozen,P.A. Bolzano,533050,258502,48.49,0.53
1249,2021-01-29,PAB,1497,510,987,24,1473,ITH,ITH1,4,Provincia Autonoma Bolzano / Bozen,P.A. Bolzano,533050,259999,48.78,0.28
1250,2021-04-22,PAB,2923,1500,1423,1981,942,ITH,ITH1,4,Provincia Autonoma Bolzano / Bozen,P.A. Bolzano,533050,262922,49.32,0.55
1251,2021-05-09,PAB,4234,2405,1829,3081,1153,ITH,ITH1,4,Provincia Autonoma Bolzano / Bozen,P.A. Bolzano,533050,267156,50.12,0.79
1252,2021-03-06,PAB,3973,2081,1892,3762,211,ITH,ITH1,4,Provincia Autonoma Bolzano / Bozen,P.A. Bolzano,533050,271129,50.86,0.75
1253,2021-05-28,PAB,5639,2862,2777,3788,1851,ITH,ITH1,4,Provincia Autonoma Bolzano / Bozen,P.A. Bolzano,533050,276768,51.92,1.06
1254,2021-02-17,PAB,156,51,105,139,17,ITH,ITH1,4,Provincia Autonoma Bolzano / Bozen,P.A. Bolzano,533050,276924,51.95,0.03
1255,2021-02-08,PAB,2,1,1,1,1,ITH,ITH1,4,Provincia Autonoma Bolzano / Bozen,P.A. Bolzano,533050,276926,51.95,0.0
1256,2021-05-19,PAB,3612,1837,1775,1839,1773,ITH,ITH1,4,Provincia Autonoma Bolzano / Bozen,P.A. Bolzano,533050,280538,52.63,0.68
1257,2021-01-03,PAB,41,16,25,41,0,ITH,ITH1,4,Provincia Autonoma Bolzano / Bozen,P.A. Bolzano,533050,280579,52.64,0.01
1258,2021-04-13,PAB,2391,1130,1261,2384,7,ITH,ITH1,4,Provincia Autonoma Bolzano / Bozen,P.A. Bolzano,533050,282970,53.09,0.45
1259,2021-02-22,PAB,526,143,383,514,12,ITH,ITH1,4,Provincia Autonoma Bolzano / Bozen,P.A. Bolzano,533050,283496,53.18,0.1
1260,2021-01-11,PAB,1570,513,1057,1570,0,ITH,ITH1,4,Provincia Autonoma Bolzano / Bozen,P.A. Bolzano,533050,285066,53.48,0.29
1261,2021-04-06,PAB,2250,1118,1132,2147,103,ITH,ITH1,4,Provincia Autonoma Bolzano / Bozen,P.A. Bolzano,533050,287316,53.9,0.42
1262,2021-04-08,PAB,2764,1346,1418,2561,203,ITH,ITH1,4,Provincia Autonoma Bolzano / Bozen,P.A. Bolzano,533050,290080,54.42,0.52
1263,2020-12-27,PAB,144,65,79,144,0,ITH,ITH1,4,Provincia Autonoma Bolzano / Bozen,P.A. Bolzano,533050,290224,54.45,0.03
1264,2021-03-20,PAB,1757,848,909,1132,625,ITH,ITH1,4,Provincia Autonoma Bolzano / Bozen,P.A. Bolzano,533050,291981,54.78,0.33
1265,2021-03-08,PAB,1210,534,676,1183,27,ITH,ITH1,4,Provincia Autonoma Bolzano / Bozen,P.A. Bolzano,533050,293191,55.0,0.23
1266,2021-05-04,PAB,3448,1843,1605,2411,1037,ITH,ITH1,4,Provincia Autonoma Bolzano / Bozen,P.A. Bolzano,533050,296639,55.65,0.65
1267,2021-05-07,PAB,4182,2055,2127,3664,518,ITH,ITH1,4,Provincia Autonoma Bolzano / Bozen,P.A. Bolzano,533050,300821,56.43,0.78
1268,2021-05-05,PAB,4154,1945,2209,2038,2116,ITH,ITH1,4,Provincia Autonoma Bolzano / Bozen,P.A. Bolzano,533050,304975,57.21,0.78
1269,2021-01-25,PAB,487,183,304,3,484,ITH,ITH1,4,Provincia Autonoma Bolzano / Bozen,P.A. Bolzano,533050,305462,57.3,0.09
1270,2021-03-23,PAB,1552,759,793,1551,1,ITH,ITH1,4,Provincia Autonoma Bolzano / Bozen,P.A. Bolzano,533050,307014,57.6,0.29
1271,2021-04-01,PAB,2786,1407,1379,2642,144,ITH,ITH1,4,Provincia Autonoma Bolzano / Bozen,P.A. Bolzano,533050,309800,58.12,0.52
1272,2021-05-30,PAB,4758,2514,2244,752,4006,ITH,ITH1,4,Provincia Autonoma Bolzano / Bozen,P.A. Bolzano,533050,314558,59.01,0.89
1273,2021-04-03,PAB,831,364,467,22,809,ITH,ITH1,4,Provincia Autonoma Bolzano / Bozen,P.A. Bolzano,533050,315389,59.17,0.16
1274,2021-03-25,PAB,2142,1059,1083,1699,443,ITH,ITH1,4,Provincia Autonoma Bolzano / Bozen,P.A. Bolzano,533050,317531,59.57,0.4
1275,2021-03-09,PAB,1194,543,651,1192,2,ITH,ITH1,4,Provincia Autonoma Bolzano / Bozen,P.A. Bolzano,533050,318725,59.79,0.22
1276,2021-05-23,PAB,4337,2303,2034,4329,8,ITH,ITH1,4,Provincia Autonoma Bolzano / Bozen,P.A. Bolzano,533050,323062,60.61,0.81
1277,2021-02-03,PAB,1503,478,1025,5,1498,ITH,ITH1,4,Provincia Autonoma Bolzano / Bozen,P.A. Bolzano,533050,324565,60.89,0.28
1278,2021-02-10,PAB,1635,604,1031,26,1609,ITH,ITH1,4,Provincia Autonoma Bolzano / Bozen,P.A. Bolzano,533050,326200,61.2,0.31
1279,2021-05-21,PAB,6851,3740,3111,5072,1779,ITH,ITH1,4,Provincia Autonoma Bolzano / Bozen,P.A. Bolzano,533050,333051,62.48,1.29
1280,2021-05-16,PAB,2024,931,1093,1330,694,ITH,ITH1,4,Provincia Autonoma Bolzano / Bozen,P.A. Bolzano,533050,335075,62.86,0.38
1281,2021-01-27,PAB,84,28,56,1,83,ITH,ITH1,4,Provincia Autonoma Bolzano / Bozen,P.A. Bolzano,533050,335159,62.88,0.02
1282,2021-05-31,PAB,2987,1464,1523,2120,867,ITH,ITH1,4,Provincia Autonoma Bolzano / Bozen,P.A. Bolzano,533050,338146,63.44,0.56
1283,2021-01-01,PAB,6,5,1,6,0,ITH,ITH1,4,Provincia Autonoma Bolzano / Bozen,P.A. Bolzano,533050,338152,63.44,0.0
1284,2021-06-07,PAB,2880,1489,1391,2571,309,ITH,ITH1,4,Provincia Autonoma Bolzano / Bozen,P.A. Bolzano,533050,341032,63.98,0.54
1285,2021-02-27,PAB,2458,759,1699,2448,10,ITH,ITH1,4,Provincia Autonoma Bolzano / Bozen,P.A. Bolzano,533050,343490,64.44,0.46
1286,2021-02-13,PAB,318,79,239,312,6,ITH,ITH1,4,Provincia Autonoma Bolzano / Bozen,P.A. Bolzano,533050,343808,64.5,0.06
1287,2021-04-11,PAB,2720,1291,1429,2543,177,ITH,ITH1,4,Provincia Autonoma Bolzano / Bozen,P.A. Bolzano,533050,346528,65.01,0.51
1288,2021-05-24,PAB,1444,762,682,1110,334,ITH,ITH1,4,Provincia Autonoma Bolzano / Bozen,P.A. Bolzano,533050,347972,65.28,0.27
1289,2021-02-20,PAB,1802,540,1262,1784,18,ITH,ITH1,4,Provincia Autonoma Bolzano / Bozen,P.A. Bolzano,533050,349774,65.62,0.34
1290,2021-04-18,PAB,3110,1607,1503,2100,1010,ITH,ITH1,4,Provincia Autonoma Bolzano / Bozen,P.A. Bolzano,533050,352884,66.2,0.58
1291,2021-01-15,PAB,3282,1228,2054,3282,0,ITH,ITH1,4,Provincia Autonoma Bolzano / Bozen,P.A. Bolzano,533050,356166,66.82,0.62
1292,2021-01-08,PAB,1521,479,1042,1521,0,ITH,ITH1,4,Provincia Autonoma Bolzano / Bozen,P.A. Bolzano,533050,357687,67.1,0.29
1293,2021-03-05,PUG,17379,6894,10485,15075,2304,ITF,ITF4,16,Puglia,Puglia,4029053,17379,0.43,0.43
1294,2021-02-26,PUG,13752,5047,8705,12718,1034,ITF,ITF4,16,Puglia,Puglia,4029053,31131,0.77,0.34
1295,2020-12-31,PUG,1634,782,852,1634,0,ITF,ITF4,16,Puglia,Puglia,4029053,32765,0.81,0.04
1296,2021-06-08,PUG,36696,17587,19109,20271,16425,ITF,ITF4,16,Puglia,Puglia,4029053,69461,1.72,0.91
1297,2021-04-05,PUG,12699,6169,6530,12166,533,ITF,ITF4,16,Puglia,Puglia,4029053,82160,2.04,0.32
1298,2021-03-19,PUG,7958,3653,4305,3413,4545,ITF,ITF4,16,Puglia,Puglia,4029053,90118,2.24,0.2
1299,2021-02-14,PUG,787,348,439,663,124,ITF,ITF4,16,Puglia,Puglia,4029053,90905,2.26,0.02
1300,2021-05-25,PUG,33624,15295,18329,20543,13081,ITF,ITF4,16,Puglia,Puglia,4029053,124529,3.09,0.83
1301,2021-05-08,PUG,54055,22869,31186,24368,29687,ITF,ITF4,16,Puglia,Puglia,4029053,178584,4.43,1.34
1302,2021-01-12,PUG,4212,1772,2440,4212,0,ITF,ITF4,16,Puglia,Puglia,4029053,182796,4.54,0.1
1303,2021-04-07,PUG,15335,6793,8542,8663,6672,ITF,ITF4,16,Puglia,Puglia,4029053,198131,4.92,0.38
1304,2021-05-27,PUG,39253,18049,21204,22675,16578,ITF,ITF4,16,Puglia,Puglia,4029053,237384,5.89,0.97
1305,2021-02-21,PUG,2176,474,1702,2114,62,ITF,ITF4,16,Puglia,Puglia,4029053,239560,5.95,0.05
1306,2021-06-01,PUG,33806,16627,17179,21407,12399,ITF,ITF4,16,Puglia,Puglia,4029053,273366,6.78,0.84
1307,2021-05-15,PUG,43234,18809,24425,23355,19879,ITF,ITF4,16,Puglia,Puglia,4029053,316600,7.86,1.07
1308,2021-06-03,PUG,48834,23367,25467,30508,18326,ITF,ITF4,16,Puglia,Puglia,4029053,365434,9.07,1.21
1309,2021-03-10,PUG,14413,6251,8162,11294,3119,ITF,ITF4,16,Puglia,Puglia,4029053,379847,9.43,0.36
1310,2021-03-29,PUG,12908,6015,6893,6172,6736,ITF,ITF4,16,Puglia,Puglia,4029053,392755,9.75,0.32
1311,2021-03-12,PUG,13938,6111,7827,10010,3928,ITF,ITF4,16,Puglia,Puglia,4029053,406693,10.09,0.35
1312,2021-02-07,PUG,1579,669,910,253,1326,ITF,ITF4,16,Puglia,Puglia,4029053,408272,10.13,0.04
1313,2021-01-21,PUG,2132,904,1228,1271,861,ITF,ITF4,16,Puglia,Puglia,4029053,410404,10.19,0.05
1314,2021-05-01,PUG,27506,12600,14906,16864,10642,ITF,ITF4,16,Puglia,Puglia,4029053,437910,10.87,0.68
1315,2021-01-02,PUG,2949,1301,1648,2949,0,ITF,ITF4,16,Puglia,Puglia,4029053,440859,10.94,0.07
1316,2021-04-12,PUG,29113,13714,15399,26287,2826,ITF,ITF4,16,Puglia,Puglia,4029053,469972,11.66,0.72
1317,2021-04-19,PUG,27592,12813,14779,24548,3044,ITF,ITF4,16,Puglia,Puglia,4029053,497564,12.35,0.68
1318,2021-04-24,PUG,29286,13334,15952,25341,3945,ITF,ITF4,16,Puglia,Puglia,4029053,526850,13.08,0.73
1319,2021-01-14,PUG,4069,1589,2480,4069,0,ITF,ITF4,16,Puglia,Puglia,4029053,530919,13.18,0.1
1320,2021-01-07,PUG,5717,2458,3259,5717,0,ITF,ITF4,16,Puglia,Puglia,4029053,536636,13.32,0.14
1321,2021-04-17,PUG,39869,18889,20980,36301,3568,ITF,ITF4,16,Puglia,Puglia,4029053,576505,14.31,0.99
1322,2021-02-19,PUG,4730,2009,2721,4338,392,ITF,ITF4,16,Puglia,Puglia,4029053,581235,14.43,0.12
1323,2021-04-26,PUG,26152,11972,14180,22921,3231,ITF,ITF4,16,Puglia,Puglia,4029053,607387,15.08,0.65
1324,2021-02-09,PUG,3840,1570,2270,2168,1672,ITF,ITF4,16,Puglia,Puglia,4029053,611227,15.17,0.1
1325,2021-05-20,PUG,32746,14568,18178,20640,12106,ITF,ITF4,16,Puglia,Puglia,4029053,643973,15.98,0.81
1326,2021-03-24,PUG,13047,6020,7027,5744,7303,ITF,ITF4,16,Puglia,Puglia,4029053,657020,16.31,0.32
1327,2021-01-26,PUG,5360,2397,2963,570,4790,ITF,ITF4,16,Puglia,Puglia,4029053,662380,16.44,0.13
1328,2021-05-06,PUG,39352,17175,22177,19708,19644,ITF,ITF4,16,Puglia,Puglia,4029053,701732,17.42,0.98
1329,2021-01-31,PUG,1813,829,984,75,1738,ITF,ITF4,16,Puglia,Puglia,4029053,703545,17.46,0.04
1330,2021-05-29,PUG,30123,14202,15921,20887,9236,ITF,ITF4,16,Puglia,Puglia,4029053,733668,18.21,0.75
1331,2021-04-02,PUG,12600,5770,6830,8078,4522,ITF,ITF4,16,Puglia,Puglia,4029053,746268,18.52,0.31
1332,2021-03-02,PUG,16366,6082,10284,15066,1300,ITF,ITF4,16,Puglia,Puglia,4029053,762634,18.93,0.41
1333,2021-04-04,PUG,5948,2953,2995,5943,5,ITF,ITF4,16,Puglia,Puglia,4029053,768582,19.08,0.15
1334,2021-03-21,PUG,2692,1226,1466,588,2104,ITF,ITF4,16,Puglia,Puglia,4029053,771274,19.14,0.07
1335,2021-01-11,PUG,3753,1588,2165,3753,0,ITF,ITF4,16,Puglia,Puglia,4029053,775027,19.24,0.09
1336,2021-04-21,PUG,23073,10646,12427,19341,3732,ITF,ITF4,16,Puglia,Puglia,4029053,798100,19.81,0.57
1337,2021-05-24,PUG,35003,16209,18794,24416,10587,ITF,ITF4,16,Puglia,Puglia,4029053,833103,20.68,0.87
1338,2021-02-16,PUG,3380,1453,1927,2736,644,ITF,ITF4,16,Puglia,Puglia,4029053,836483,20.76,0.08
1339,2021-01-30,PUG,5527,2514,3013,410,5117,ITF,ITF4,16,Puglia,Puglia,4029053,842010,20.9,0.14
1340,2021-02-04,PUG,5927,2366,3561,1195,4732,ITF,ITF4,16,Puglia,Puglia,4029053,847937,21.05,0.15
1341,2021-05-17,PUG,32262,14781,17481,20597,11665,ITF,ITF4,16,Puglia,Puglia,4029053,880199,21.85,0.8
1342,2021-02-23,PUG,9349,4421,4928,8874,475,ITF,ITF4,16,Puglia,Puglia,4029053,889548,22.08,0.23
1343,2021-01-28,PUG,5474,2278,3196,471,5003,ITF,ITF4,16,Puglia,Puglia,4029053,895022,22.21,0.14
1344,2021-02-28,PUG,6048,1806,4242,5862,186,ITF,ITF4,16,Puglia,Puglia,4029053,901070,22.36,0.15
1345,2021-05-12,PUG,36188,16085,20103,23805,12383,ITF,ITF4,16,Puglia,Puglia,4029053,937258,23.26,0.9
1346,2021-01-23,PUG,3040,1294,1746,886,2154,ITF,ITF4,16,Puglia,Puglia,4029053,940298,23.34,0.08
1347,2021-05-03,PUG,33190,14826,18364,22570,10620,ITF,ITF4,16,Puglia,Puglia,4029053,973488,24.16,0.82
1348,2021-03-07,PUG,4923,1943,2980,4352,571,ITF,ITF4,16,Puglia,Puglia,4029053,978411,24.28,0.12
1349,2021-05-05,PUG,38886,16995,21891,24744,14142,ITF,ITF4,16,Puglia,Puglia,4029053,1017297,25.25,0.97
1350,2021-01-19,PUG,1221,452,769,1211,10,ITF,ITF4,16,Puglia,Puglia,4029053,1018518,25.28,0.03
1351,2021-01-04,PUG,4508,2016,2492,4508,0,ITF,ITF4,16,Puglia,Puglia,4029053,1023026,25.39,0.11
1352,2021-03-26,PUG,11545,5424,6121,6900,4645,ITF,ITF4,16,Puglia,Puglia,4029053,1034571,25.68,0.29
1353,2021-03-09,PUG,13296,5794,7502,11287,2009,ITF,ITF4,16,Puglia,Puglia,4029053,1047867,26.01,0.33
1354,2021-04-14,PUG,31836,15033,16803,28530,3306,ITF,ITF4,16,Puglia,Puglia,4029053,1079703,26.8,0.79
1355,2021-03-28,PUG,3528,1650,1878,1203,2325,ITF,ITF4,16,Puglia,Puglia,4029053,1083231,26.89,0.09
1356,2021-04-16,PUG,35865,16861,19004,32584,3281,ITF,ITF4,16,Puglia,Puglia,4029053,1119096,27.78,0.89
1357,2021-02-18,PUG,4378,1846,2532,3774,604,ITF,ITF4,16,Puglia,Puglia,4029053,1123474,27.88,0.11
1358,2021-04-09,PUG,21855,9397,12458,17233,4622,ITF,ITF4,16,Puglia,Puglia,4029053,1145329,28.43,0.54
1359,2021-02-11,PUG,3699,1401,2298,2421,1278,ITF,ITF4,16,Puglia,Puglia,4029053,1149028,28.52,0.09
1360,2021-05-22,PUG,34209,15665,18544,23924,10285,ITF,ITF4,16,Puglia,Puglia,4029053,1183237,29.37,0.85
1361,2021-03-16,PUG,9868,4685,5183,3509,6359,ITF,ITF4,16,Puglia,Puglia,4029053,1193105,29.61,0.24
1362,2021-04-28,PUG,19744,8846,10898,14995,4749,ITF,ITF4,16,Puglia,Puglia,4029053,1212849,30.1,0.49
1363,2021-01-09,PUG,4886,2251,2635,4886,0,ITF,ITF4,16,Puglia,Puglia,4029053,1217735,30.22,0.12
1364,2021-03-31,PUG,14050,6358,7692,8494,5556,ITF,ITF4,16,Puglia,Puglia,4029053,1231785,30.57,0.35
1365,2021-02-02,PUG,4345,1847,2498,593,3752,ITF,ITF4,16,Puglia,Puglia,4029053,1236130,30.68,0.11
1366,2021-05-13,PUG,38387,17077,21310,21341,17046,ITF,ITF4,16,Puglia,Puglia,4029053,1274517,31.63,0.95
1367,2021-03-17,PUG,10344,4701,5643,4171,6173,ITF,ITF4,16,Puglia,Puglia,4029053,1284861,31.89,0.26
1368,2021-05-31,PUG,36403,17052,19351,23081,13322,ITF,ITF4,16,Puglia,Puglia,4029053,1321264,32.79,0.9
1369,2021-05-10,PUG,37424,16505,20919,19551,17873,ITF,ITF4,16,Puglia,Puglia,4029053,1358688,33.72,0.93
1370,2021-02-13,PUG,3727,1456,2271,3031,696,ITF,ITF4,16,Puglia,Puglia,4029053,1362415,33.81,0.09
1371,2021-04-23,PUG,29358,13638,15720,24148,5210,ITF,ITF4,16,Puglia,Puglia,4029053,1391773,34.54,0.73
1372,2021-03-18,PUG,9401,4254,5147,3284,6117,ITF,ITF4,16,Puglia,Puglia,4029053,1401174,34.78,0.23
1373,2021-03-04,PUG,15144,5914,9230,13725,1419,ITF,ITF4,16,Puglia,Puglia,4029053,1416318,35.15,0.38
1374,2021-06-09,PUG,20144,9810,10334,15259,4885,ITF,ITF4,16,Puglia,Puglia,4029053,1436462,35.65,0.5
1375,2021-02-15,PUG,3252,1268,1984,2632,620,ITF,ITF4,16,Puglia,Puglia,4029053,1439714,35.73,0.08
1376,2021-05-26,PUG,37323,17523,19800,26140,11183,ITF,ITF4,16,Puglia,Puglia,4029053,1477037,36.66,0.93
1377,2021-03-11,PUG,14399,6207,8192,11290,3109,ITF,ITF4,16,Puglia,Puglia,4029053,1491436,37.02,0.36
1378,2021-03-30,PUG,11881,5499,6382,5986,5895,ITF,ITF4,16,Puglia,Puglia,4029053,1503317,37.31,0.29
1379,2021-02-01,PUG,3963,1659,2304,373,3590,ITF,ITF4,16,Puglia,Puglia,4029053,1507280,37.41,0.1
1380,2021-05-14,PUG,44623,20355,24268,28563,16060,ITF,ITF4,16,Puglia,Puglia,4029053,1551903,38.52,1.11
1381,2021-01-25,PUG,3825,1681,2144,423,3402,ITF,ITF4,16,Puglia,Puglia,4029053,1555728,38.61,0.09
1382,2021-01-18,PUG,1845,770,1075,1496,349,ITF,ITF4,16,Puglia,Puglia,4029053,1557573,38.66,0.05
1383,2021-02-06,PUG,4546,1928,2618,1590,2956,ITF,ITF4,16,Puglia,Puglia,4029053,1562119,38.77,0.11
1384,2021-01-20,PUG,1545,540,1005,1537,8,ITF,ITF4,16,Puglia,Puglia,4029053,1563664,38.81,0.04
1385,2021-04-30,PUG,34797,15564,19233,22846,11951,ITF,ITF4,16,Puglia,Puglia,4029053,1598461,39.67,0.86
1386,2021-04-13,PUG,28648,13581,15067,25249,3399,ITF,ITF4,16,Puglia,Puglia,4029053,1627109,40.38,0.71
1387,2021-05-02,PUG,21270,9647,11623,14019,7251,ITF,ITF4,16,Puglia,Puglia,4029053,1648379,40.91,0.53
1388,2021-02-25,PUG,11965,5060,6905,10799,1166,ITF,ITF4,16,Puglia,Puglia,4029053,1660344,41.21,0.3
1389,2021-06-05,PUG,41201,20227,20974,29279,11922,ITF,ITF4,16,Puglia,Puglia,4029053,1701545,42.23,1.02
1390,2021-01-06,PUG,3945,1669,2276,3945,0,ITF,ITF4,16,Puglia,Puglia,4029053,1705490,42.33,0.1
1391,2020-12-30,PUG,1,0,1,1,0,ITF,ITF4,16,Puglia,Puglia,4029053,1705491,42.33,0.0
1392,2021-03-22,PUG,9354,4556,4798,3708,5646,ITF,ITF4,16,Puglia,Puglia,4029053,1714845,42.56,0.23
1393,2021-01-24,PUG,1669,749,920,153,1516,ITF,ITF4,16,Puglia,Puglia,4029053,1716514,42.6,0.04
1394,2021-03-15,PUG,11793,5634,6159,5292,6501,ITF,ITF4,16,Puglia,Puglia,4029053,1728307,42.9,0.29
1395,2021-01-17,PUG,1308,590,718,1239,69,ITF,ITF4,16,Puglia,Puglia,4029053,1729615,42.93,0.03
1396,2021-04-27,PUG,26610,12042,14568,21024,5586,ITF,ITF4,16,Puglia,Puglia,4029053,1756225,43.59,0.66
1397,2021-03-14,PUG,3320,1429,1891,2509,811,ITF,ITF4,16,Puglia,Puglia,4029053,1759545,43.67,0.08
1398,2021-01-16,PUG,2507,1033,1474,2507,0,ITF,ITF4,16,Puglia,Puglia,4029053,1762052,43.73,0.06
1399,2021-05-21,PUG,37988,17778,20210,28236,9752,ITF,ITF4,16,Puglia,Puglia,4029053,1800040,44.68,0.94
1400,2021-05-19,PUG,25643,12157,13486,19327,6316,ITF,ITF4,16,Puglia,Puglia,4029053,1825683,45.31,0.64
1401,2021-03-23,PUG,10424,5008,5416,3954,6470,ITF,ITF4,16,Puglia,Puglia,4029053,1836107,45.57,0.26
1402,2021-05-09,PUG,30560,12517,18043,14980,15580,ITF,ITF4,16,Puglia,Puglia,4029053,1866667,46.33,0.76
1403,2021-04-22,PUG,22914,10471,12443,18046,4868,ITF,ITF4,16,Puglia,Puglia,4029053,1889581,46.9,0.57
1404,2021-02-12,PUG,4212,1672,2540,3120,1092,ITF,ITF4,16,Puglia,Puglia,4029053,1893793,47.0,0.1
1405,2021-01-29,PUG,6198,2662,3536,436,5762,ITF,ITF4,16,Puglia,Puglia,4029053,1899991,47.16,0.15
1406,2021-03-20,PUG,8262,3737,4525,3669,4593,ITF,ITF4,16,Puglia,Puglia,4029053,1908253,47.36,0.21
1407,2021-03-03,PUG,16671,6705,9966,14759,1912,ITF,ITF4,16,Puglia,Puglia,4029053,1924924,47.78,0.41
1408,2021-04-03,PUG,10545,4636,5909,6992,3553,ITF,ITF4,16,Puglia,Puglia,4029053,1935469,48.04,0.26
1409,2021-06-02,PUG,26813,13115,13698,22012,4801,ITF,ITF4,16,Puglia,Puglia,4029053,1962282,48.7,0.67
1410,2021-03-13,PUG,10465,4134,6331,8657,1808,ITF,ITF4,16,Puglia,Puglia,4029053,1972747,48.96,0.26
1411,2021-02-24,PUG,10035,4703,5332,9445,590,ITF,ITF4,16,Puglia,Puglia,4029053,1982782,49.21,0.25
1412,2021-06-04,PUG,50487,24162,26325,33827,16660,ITF,ITF4,16,Puglia,Puglia,4029053,2033269,50.47,1.25
1413,2021-05-18,PUG,28241,12948,15293,15660,12581,ITF,ITF4,16,Puglia,Puglia,4029053,2061510,51.17,0.7
1414,2021-04-29,PUG,26011,12034,13977,19355,6656,ITF,ITF4,16,Puglia,Puglia,4029053,2087521,51.81,0.65
1415,2021-02-22,PUG,9628,4536,5092,9297,331,ITF,ITF4,16,Puglia,Puglia,4029053,2097149,52.05,0.24
1416,2021-02-05,PUG,5635,2273,3362,1333,4302,ITF,ITF4,16,Puglia,Puglia,4029053,2102784,52.19,0.14
1417,2021-05-16,PUG,24414,11009,13405,12610,11804,ITF,ITF4,16,Puglia,Puglia,4029053,2127198,52.8,0.61
1418,2021-01-27,PUG,4581,1932,2649,611,3970,ITF,ITF4,16,Puglia,Puglia,4029053,2131779,52.91,0.11
1419,2021-05-07,PUG,49495,22074,27421,26224,23271,ITF,ITF4,16,Puglia,Puglia,4029053,2181274,54.14,1.23
1420,2021-01-13,PUG,4542,1730,2812,4542,0,ITF,ITF4,16,Puglia,Puglia,4029053,2185816,54.25,0.11
1421,2021-04-06,PUG,13590,6030,7560,6840,6750,ITF,ITF4,16,Puglia,Puglia,4029053,2199406,54.59,0.34
1422,2021-03-01,PUG,15096,5864,9232,13726,1370,ITF,ITF4,16,Puglia,Puglia,4029053,2214502,54.96,0.37
1423,2021-01-03,PUG,2007,943,1064,2007,0,ITF,ITF4,16,Puglia,Puglia,4029053,2216509,55.01,0.05
1424,2021-03-27,PUG,12150,5706,6444,6982,5168,ITF,ITF4,16,Puglia,Puglia,4029053,2228659,55.31,0.3
1425,2021-01-05,PUG,5106,2251,2855,5106,0,ITF,ITF4,16,Puglia,Puglia,4029053,2233765,55.44,0.13
1426,2021-04-15,PUG,32399,15116,17283,28898,3501,ITF,ITF4,16,Puglia,Puglia,4029053,2266164,56.25,0.8
1427,2021-05-11,PUG,32303,14220,18083,13947,18356,ITF,ITF4,16,Puglia,Puglia,4029053,2298467,57.05,0.8
1428,2021-05-04,PUG,34876,14710,20166,18464,16412,ITF,ITF4,16,Puglia,Puglia,4029053,2333343,57.91,0.87
1429,2021-03-08,PUG,14611,6092,8519,12212,2399,ITF,ITF4,16,Puglia,Puglia,4029053,2347954,58.28,0.36
1430,2021-04-08,PUG,17448,7573,9875,11275,6173,ITF,ITF4,16,Puglia,Puglia,4029053,2365402,58.71,0.43
1431,2021-06-06,PUG,29916,15053,14863,25011,4905,ITF,ITF4,16,Puglia,Puglia,4029053,2395318,59.45,0.74
1432,2021-04-10,PUG,30739,13036,17703,26515,4224,ITF,ITF4,16,Puglia,Puglia,4029053,2426057,60.21,0.76
1433,2021-01-10,PUG,2348,1061,1287,2348,0,ITF,ITF4,16,Puglia,Puglia,4029053,2428405,60.27,0.06
1434,2021-04-20,PUG,21105,9795,11310,17641,3464,ITF,ITF4,16,Puglia,Puglia,4029053,2449510,60.8,0.52
1435,2020-12-27,PUG,509,252,257,509,0,ITF,ITF4,16,Puglia,Puglia,4029053,2450019,60.81,0.01
1436,2021-03-25,PUG,10929,5307,5622,4688,6241,ITF,ITF4,16,Puglia,Puglia,4029053,2460948,61.08,0.27
1437,2021-02-08,PUG,3992,1610,2382,1597,2395,ITF,ITF4,16,Puglia,Puglia,4029053,2464940,61.18,0.1
1438,2021-02-10,PUG,3644,1436,2208,2134,1510,ITF,ITF4,16,Puglia,Puglia,4029053,2468584,61.27,0.09
1439,2021-05-23,PUG,17864,8351,9513,14058,3806,ITF,ITF4,16,Puglia,Puglia,4029053,2486448,61.71,0.44
1440,2021-02-17,PUG,4273,1744,2529,3670,603,ITF,ITF4,16,Puglia,Puglia,4029053,2490721,61.82,0.11
1441,2021-05-28,PUG,42442,19757,22685,27154,15288,ITF,ITF4,16,Puglia,Puglia,4029053,2533163,62.87,1.05
1442,2021-05-30,PUG,20804,9956,10848,15833,4971,ITF,ITF4,16,Puglia,Puglia,4029053,2553967,63.39,0.52
1443,2021-04-01,PUG,13506,6159,7347,7162,6344,ITF,ITF4,16,Puglia,Puglia,4029053,2567473,63.72,0.34
1444,2021-02-03,PUG,5036,2005,3031,730,4306,ITF,ITF4,16,Puglia,Puglia,4029053,2572509,63.85,0.12
1445,2021-04-25,PUG,11236,5209,6027,10079,1157,ITF,ITF4,16,Puglia,Puglia,4029053,2583745,64.13,0.28
1446,2021-02-27,PUG,14219,4815,9404,12994,1225,ITF,ITF4,16,Puglia,Puglia,4029053,2597964,64.48,0.35
1447,2021-01-01,PUG,148,61,87,148,0,ITF,ITF4,16,Puglia,Puglia,4029053,2598112,64.48,0.0
1448,2021-06-07,PUG,41729,20006,21723,29608,12121,ITF,ITF4,16,Puglia,Puglia,4029053,2639841,65.52,1.04
1449,2021-04-11,PUG,16448,7244,9204,14792,1656,ITF,ITF4,16,Puglia,Puglia,4029053,2656289,65.93,0.41
1450,2021-03-06,PUG,15974,5967,10007,13886,2088,ITF,ITF4,16,Puglia,Puglia,4029053,2672263,66.32,0.4
1451,2021-01-08,PUG,5615,2355,3260,5615,0,ITF,ITF4,16,Puglia,Puglia,4029053,2677878,66.46,0.14
1452,2021-04-18,PUG,22542,10777,11765,21478,1064,ITF,ITF4,16,Puglia,Puglia,4029053,2700420,67.02,0.56
1453,2021-02-20,PUG,2970,1080,1890,2713,257,ITF,ITF4,16,Puglia,Puglia,4029053,2703390,67.1,0.07
1454,2021-01-15,PUG,4552,1866,2686,4552,0,ITF,ITF4,16,Puglia,Puglia,4029053,2707942,67.21,0.11
1455,2021-01-22,PUG,1409,578,831,991,418,ITF,ITF4,16,Puglia,Puglia,4029053,2709351,67.25,0.03
1456,2021-04-07,TOS,35634,15292,20342,28386,7248,ITI,ITI1,9,Toscana,Toscana,3729641,35634,0.96,0.96
1457,2021-04-16,TOS,28955,12889,16066,22045,6910,ITI,ITI1,9,Toscana,Toscana,3729641,64589,1.73,0.78
1458,2021-03-02,TOS,10598,3798,6800,7154,3444,ITI,ITI1,9,Toscana,Toscana,3729641,75187,2.02,0.28
1459,2021-01-04,TOS,5065,1894,3171,5065,0,ITI,ITI1,9,Toscana,Toscana,3729641,80252,2.15,0.14
1460,2021-03-26,TOS,20410,9166,11244,14644,5766,ITI,ITI1,9,Toscana,Toscana,3729641,100662,2.7,0.55
1461,2021-03-09,TOS,10674,4152,6522,5122,5552,ITI,ITI1,9,Toscana,Toscana,3729641,111336,2.99,0.29
1462,2021-04-09,TOS,24533,10546,13987,21124,3409,ITI,ITI1,9,Toscana,Toscana,3729641,135869,3.64,0.66
1463,2021-02-04,TOS,4253,1594,2659,961,3292,ITI,ITI1,9,Toscana,Toscana,3729641,140122,3.76,0.11
1464,2021-05-15,TOS,29312,13833,15479,23559,5753,ITI,ITI1,9,Toscana,Toscana,3729641,169434,4.54,0.79
1465,2021-04-28,TOS,19119,8186,10933,3832,15287,ITI,ITI1,9,Toscana,Toscana,3729641,188553,5.06,0.51
1466,2021-02-18,TOS,8819,3284,5535,7924,895,ITI,ITI1,9,Toscana,Toscana,3729641,197372,5.29,0.24
1467,2021-01-16,TOS,3271,1046,2225,3271,0,ITI,ITI1,9,Toscana,Toscana,3729641,200643,5.38,0.09
1468,2021-04-26,TOS,10151,4943,5208,7598,2553,ITI,ITI1,9,Toscana,Toscana,3729641,210794,5.65,0.27
1469,2021-01-02,TOS,3497,1096,2401,3497,0,ITI,ITI1,9,Toscana,Toscana,3729641,214291,5.75,0.09
1470,2021-03-07,TOS,5647,2357,3290,2104,3543,ITI,ITI1,9,Toscana,Toscana,3729641,219938,5.9,0.15
1471,2021-04-02,TOS,31945,13535,18410,23921,8024,ITI,ITI1,9,Toscana,Toscana,3729641,251883,6.75,0.86
1472,2021-01-09,TOS,4485,1596,2889,4485,0,ITI,ITI1,9,Toscana,Toscana,3729641,256368,6.87,0.12
1473,2021-05-22,TOS,25989,12639,13350,21724,4265,ITI,ITI1,9,Toscana,Toscana,3729641,282357,7.57,0.7
1474,2021-05-05,TOS,30118,13439,16679,15647,14471,ITI,ITI1,9,Toscana,Toscana,3729641,312475,8.38,0.81
1475,2021-02-28,TOS,1649,667,982,922,727,ITI,ITI1,9,Toscana,Toscana,3729641,314124,8.42,0.04
1476,2021-02-11,TOS,5383,2021,3362,5141,242,ITI,ITI1,9,Toscana,Toscana,3729641,319507,8.57,0.14
1477,2021-02-09,TOS,4488,1468,3020,3877,611,ITI,ITI1,9,Toscana,Toscana,3729641,323995,8.69,0.12
1478,2021-06-05,TOS,28318,13540,14778,20755,7563,ITI,ITI1,9,Toscana,Toscana,3729641,352313,9.45,0.76
1479,2021-01-11,TOS,5094,1691,3403,5094,0,ITI,ITI1,9,Toscana,Toscana,3729641,357407,9.58,0.14
1480,2021-04-21,TOS,29603,12665,16938,17517,12086,ITI,ITI1,9,Toscana,Toscana,3729641,387010,10.38,0.79
1481,2021-02-23,TOS,7721,3324,4397,7560,161,ITI,ITI1,9,Toscana,Toscana,3729641,394731,10.58,0.21
1482,2021-06-03,TOS,31786,15268,16518,27351,4435,ITI,ITI1,9,Toscana,Toscana,3729641,426517,11.44,0.85
1483,2021-05-17,TOS,29481,14631,14850,20807,8674,ITI,ITI1,9,Toscana,Toscana,3729641,455998,12.23,0.79
1484,2021-03-21,TOS,3231,1573,1658,1798,1433,ITI,ITI1,9,Toscana,Toscana,3729641,459229,12.31,0.09
1485,2021-01-23,TOS,3949,1354,2595,640,3309,ITI,ITI1,9,Toscana,Toscana,3729641,463178,12.42,0.11
1486,2021-05-03,TOS,11934,5510,6424,10615,1319,ITI,ITI1,9,Toscana,Toscana,3729641,475112,12.74,0.32
1487,2021-01-28,TOS,6282,1882,4400,354,5928,ITI,ITI1,9,Toscana,Toscana,3729641,481394,12.91,0.17
1488,2021-03-19,TOS,10141,4460,5681,7273,2868,ITI,ITI1,9,Toscana,Toscana,3729641,491535,13.18,0.27
1489,2021-01-21,TOS,1589,686,903,867,722,ITI,ITI1,9,Toscana,Toscana,3729641,493124,13.22,0.04
1490,2021-02-20,TOS,4640,1789,2851,4127,513,ITI,ITI1,9,Toscana,Toscana,3729641,497764,13.35,0.12
1491,2021-05-31,TOS,30054,14407,15647,19374,10680,ITI,ITI1,9,Toscana,Toscana,3729641,527818,14.15,0.81
1492,2021-05-14,TOS,33266,15385,17881,20636,12630,ITI,ITI1,9,Toscana,Toscana,3729641,561084,15.04,0.89
1493,2021-03-18,TOS,9978,3984,5994,6006,3972,ITI,ITI1,9,Toscana,Toscana,3729641,571062,15.31,0.27
1494,2021-06-09,TOS,17618,8753,8865,17390,228,ITI,ITI1,9,Toscana,Toscana,3729641,588680,15.78,0.47
1495,2021-04-04,TOS,13911,6602,7309,13658,253,ITI,ITI1,9,Toscana,Toscana,3729641,602591,16.16,0.37
1496,2021-03-16,TOS,4904,1884,3020,2653,2251,ITI,ITI1,9,Toscana,Toscana,3729641,607495,16.29,0.13
1497,2021-02-27,TOS,1984,756,1228,1082,902,ITI,ITI1,9,Toscana,Toscana,3729641,609479,16.34,0.05
1498,2021-05-29,TOS,31530,15243,16287,23387,8143,ITI,ITI1,9,Toscana,Toscana,3729641,641009,17.19,0.85
1499,2021-03-23,TOS,9094,4102,4992,6820,2274,ITI,ITI1,9,Toscana,Toscana,3729641,650103,17.43,0.24
1500,2020-12-30,TOS,327,104,223,327,0,ITI,ITI1,9,Toscana,Toscana,3729641,650430,17.44,0.01
1501,2021-05-12,TOS,34129,15548,18581,14160,19969,ITI,ITI1,9,Toscana,Toscana,3729641,684559,18.35,0.92
1502,2021-01-18,TOS,1119,636,483,1021,98,ITI,ITI1,9,Toscana,Toscana,3729641,685678,18.38,0.03
1503,2021-02-01,TOS,5509,1958,3551,521,4988,ITI,ITI1,9,Toscana,Toscana,3729641,691187,18.53,0.15
1504,2021-04-14,TOS,20167,8336,11831,15060,5107,ITI,ITI1,9,Toscana,Toscana,3729641,711354,19.07,0.54
1505,2021-03-04,TOS,17626,6760,10866,14544,3082,ITI,ITI1,9,Toscana,Toscana,3729641,728980,19.55,0.47
1506,2021-01-06,TOS,4520,1460,3060,4520,0,ITI,ITI1,9,Toscana,Toscana,3729641,733500,19.67,0.12
1507,2021-05-24,TOS,33368,16400,16968,24090,9278,ITI,ITI1,9,Toscana,Toscana,3729641,766868,20.56,0.89
1508,2021-01-25,TOS,5127,1896,3231,248,4879,ITI,ITI1,9,Toscana,Toscana,3729641,771995,20.7,0.14
1509,2021-04-18,TOS,8338,4083,4255,7342,996,ITI,ITI1,9,Toscana,Toscana,3729641,780333,20.92,0.22
1510,2021-05-07,TOS,32084,14674,17410,11994,20090,ITI,ITI1,9,Toscana,Toscana,3729641,812417,21.78,0.86
1511,2021-02-13,TOS,7785,2360,5425,7558,227,ITI,ITI1,9,Toscana,Toscana,3729641,820202,21.99,0.21
1512,2021-06-02,TOS,27544,13598,13946,22040,5504,ITI,ITI1,9,Toscana,Toscana,3729641,847746,22.73,0.74
1513,2021-04-06,TOS,22171,9774,12397,18457,3714,ITI,ITI1,9,Toscana,Toscana,3729641,869917,23.32,0.59
1514,2021-02-08,TOS,4097,1360,2737,3638,459,ITI,ITI1,9,Toscana,Toscana,3729641,874014,23.43,0.11
1515,2021-05-19,TOS,27831,13479,14352,18879,8952,ITI,ITI1,9,Toscana,Toscana,3729641,901845,24.18,0.75
1516,2021-04-13,TOS,8491,3509,4982,6031,2460,ITI,ITI1,9,Toscana,Toscana,3729641,910336,24.41,0.23
1517,2021-05-26,TOS,35181,16776,18405,20170,15011,ITI,ITI1,9,Toscana,Toscana,3729641,945517,25.35,0.94
1518,2021-03-30,TOS,16860,7498,9362,13297,3563,ITI,ITI1,9,Toscana,Toscana,3729641,962377,25.8,0.45
1519,2021-02-16,TOS,9279,3339,5940,8558,721,ITI,ITI1,9,Toscana,Toscana,3729641,971656,26.05,0.25
1520,2021-05-02,TOS,11167,4931,6236,9204,1963,ITI,ITI1,9,Toscana,Toscana,3729641,982823,26.35,0.3
1521,2021-02-25,TOS,10634,4306,6328,9635,999,ITI,ITI1,9,Toscana,Toscana,3729641,993457,26.64,0.29
1522,2021-01-20,TOS,1331,637,694,1083,248,ITI,ITI1,9,Toscana,Toscana,3729641,994788,26.67,0.04
1523,2021-04-30,TOS,40169,17770,22399,20316,19853,ITI,ITI1,9,Toscana,Toscana,3729641,1034957,27.75,1.08
1524,2021-04-25,TOS,11054,5248,5806,8917,2137,ITI,ITI1,9,Toscana,Toscana,3729641,1046011,28.05,0.3
1525,2021-01-13,TOS,4062,1398,2664,4062,0,ITI,ITI1,9,Toscana,Toscana,3729641,1050073,28.15,0.11
1526,2021-03-28,TOS,6212,2808,3404,5958,254,ITI,ITI1,9,Toscana,Toscana,3729641,1056285,28.32,0.17
1527,2021-01-30,TOS,4622,1622,3000,198,4424,ITI,ITI1,9,Toscana,Toscana,3729641,1060907,28.45,0.12
1528,2021-05-10,TOS,26140,12352,13788,15522,10618,ITI,ITI1,9,Toscana,Toscana,3729641,1087047,29.15,0.7
1529,2021-03-14,TOS,7165,2560,4605,3230,3935,ITI,ITI1,9,Toscana,Toscana,3729641,1094212,29.34,0.19
1530,2021-02-06,TOS,4527,1550,2977,1294,3233,ITI,ITI1,9,Toscana,Toscana,3729641,1098739,29.46,0.12
1531,2021-01-01,TOS,2369,787,1582,2369,0,ITI,ITI1,9,Toscana,Toscana,3729641,1101108,29.52,0.06
1532,2021-04-11,TOS,3642,1679,1963,3487,155,ITI,ITI1,9,Toscana,Toscana,3729641,1104750,29.62,0.1
1533,2021-03-06,TOS,7094,2838,4256,2901,4193,ITI,ITI1,9,Toscana,Toscana,3729641,1111844,29.81,0.19
1534,2021-02-03,TOS,4221,1452,2769,241,3980,ITI,ITI1,9,Toscana,Toscana,3729641,1116065,29.92,0.11
1535,2021-01-15,TOS,3878,1347,2531,3878,0,ITI,ITI1,9,Toscana,Toscana,3729641,1119943,30.03,0.1
1536,2021-04-27,TOS,10348,4910,5438,3866,6482,ITI,ITI1,9,Toscana,Toscana,3729641,1130291,30.31,0.28
1537,2021-01-17,TOS,2536,871,1665,2023,513,ITI,ITI1,9,Toscana,Toscana,3729641,1132827,30.37,0.07
1538,2021-01-08,TOS,5946,1642,4304,5946,0,ITI,ITI1,9,Toscana,Toscana,3729641,1138773,30.53,0.16
1539,2021-04-01,TOS,26935,11118,15817,16303,10632,ITI,ITI1,9,Toscana,Toscana,3729641,1165708,31.26,0.72
1540,2021-03-15,TOS,8359,3335,5024,3916,4443,ITI,ITI1,9,Toscana,Toscana,3729641,1174067,31.48,0.22
1541,2021-01-10,TOS,3001,1104,1897,3001,0,ITI,ITI1,9,Toscana,Toscana,3729641,1177068,31.56,0.08
1542,2021-04-20,TOS,18156,8110,10046,12599,5557,ITI,ITI1,9,Toscana,Toscana,3729641,1195224,32.05,0.49
1543,2021-04-03,TOS,15013,6646,8367,13887,1126,ITI,ITI1,9,Toscana,Toscana,3729641,1210237,32.45,0.4
1544,2021-03-11,TOS,15495,5993,9502,12169,3326,ITI,ITI1,9,Toscana,Toscana,3729641,1225732,32.86,0.42
1545,2021-02-05,TOS,5749,2245,3504,1924,3825,ITI,ITI1,9,Toscana,Toscana,3729641,1231481,33.02,0.15
1546,2021-05-16,TOS,26661,12879,13782,24201,2460,ITI,ITI1,9,Toscana,Toscana,3729641,1258142,33.73,0.71
1547,2021-05-11,TOS,27938,12981,14957,12481,15457,ITI,ITI1,9,Toscana,Toscana,3729641,1286080,34.48,0.75
1548,2021-03-13,TOS,9275,3301,5974,5312,3963,ITI,ITI1,9,Toscana,Toscana,3729641,1295355,34.73,0.25
1549,2021-06-07,TOS,34412,16776,17636,31038,3374,ITI,ITI1,9,Toscana,Toscana,3729641,1329767,35.65,0.92
1550,2021-05-21,TOS,28610,13227,15383,17450,11160,ITI,ITI1,9,Toscana,Toscana,3729641,1358377,36.42,0.77
1551,2021-03-01,TOS,4472,1733,2739,832,3640,ITI,ITI1,9,Toscana,Toscana,3729641,1362849,36.54,0.12
1552,2021-05-23,TOS,28370,13643,14727,25805,2565,ITI,ITI1,9,Toscana,Toscana,3729641,1391219,37.3,0.76
1553,2020-12-27,TOS,620,267,353,620,0,ITI,ITI1,9,Toscana,Toscana,3729641,1391839,37.32,0.02
1554,2021-01-03,TOS,3335,1051,2284,3335,0,ITI,ITI1,9,Toscana,Toscana,3729641,1395174,37.41,0.09
1555,2021-02-15,TOS,8771,3375,5396,7946,825,ITI,ITI1,9,Toscana,Toscana,3729641,1403945,37.64,0.24
1556,2021-02-22,TOS,9818,4254,5564,9541,277,ITI,ITI1,9,Toscana,Toscana,3729641,1413763,37.91,0.26
1557,2021-05-08,TOS,29149,13113,16036,13695,15454,ITI,ITI1,9,Toscana,Toscana,3729641,1442912,38.69,0.78
1558,2021-03-12,TOS,16524,6221,10303,12996,3528,ITI,ITI1,9,Toscana,Toscana,3729641,1459436,39.13,0.44
1559,2021-01-14,TOS,3255,1179,2076,3255,0,ITI,ITI1,9,Toscana,Toscana,3729641,1462691,39.22,0.09
1560,2021-04-24,TOS,13434,6164,7270,5990,7444,ITI,ITI1,9,Toscana,Toscana,3729641,1476125,39.58,0.36
1561,2021-04-23,TOS,25675,11428,14247,9360,16315,ITI,ITI1,9,Toscana,Toscana,3729641,1501800,40.27,0.69
1562,2021-03-20,TOS,6490,2884,3606,5354,1136,ITI,ITI1,9,Toscana,Toscana,3729641,1508290,40.44,0.17
1563,2021-01-22,TOS,2866,1064,1802,528,2338,ITI,ITI1,9,Toscana,Toscana,3729641,1511156,40.52,0.08
1564,2021-03-27,TOS,8860,4150,4710,8645,215,ITI,ITI1,9,Toscana,Toscana,3729641,1520016,40.76,0.24
1565,2021-03-25,TOS,23623,10128,13495,15274,8349,ITI,ITI1,9,Toscana,Toscana,3729641,1543639,41.39,0.63
1566,2021-04-12,TOS,2612,1183,1429,1958,654,ITI,ITI1,9,Toscana,Toscana,3729641,1546251,41.46,0.07
1567,2021-05-13,TOS,34881,15336,19545,13725,21156,ITI,ITI1,9,Toscana,Toscana,3729641,1581132,42.39,0.94
1568,2021-04-29,TOS,39343,17714,21629,19243,20100,ITI,ITI1,9,Toscana,Toscana,3729641,1620475,43.45,1.05
1569,2021-03-24,TOS,19686,8004,11682,10229,9457,ITI,ITI1,9,Toscana,Toscana,3729641,1640161,43.98,0.53
1570,2021-02-21,TOS,5105,2089,3016,4935,170,ITI,ITI1,9,Toscana,Toscana,3729641,1645266,44.11,0.14
1571,2021-06-01,TOS,26700,13203,13497,23017,3683,ITI,ITI1,9,Toscana,Toscana,3729641,1671966,44.83,0.72
1572,2021-03-10,TOS,18016,7075,10941,13998,4018,ITI,ITI1,9,Toscana,Toscana,3729641,1689982,45.31,0.48
1573,2021-02-02,TOS,3743,1475,2268,196,3547,ITI,ITI1,9,Toscana,Toscana,3729641,1693725,45.41,0.1
1574,2021-01-27,TOS,4835,1573,3262,206,4629,ITI,ITI1,9,Toscana,Toscana,3729641,1698560,45.54,0.13
1575,2021-03-17,TOS,11420,4586,6834,6892,4528,ITI,ITI1,9,Toscana,Toscana,3729641,1709980,45.85,0.31
1576,2021-06-08,TOS,31824,16223,15601,31512,312,ITI,ITI1,9,Toscana,Toscana,3729641,1741804,46.7,0.85
1577,2021-02-26,TOS,10076,3833,6243,8870,1206,ITI,ITI1,9,Toscana,Toscana,3729641,1751880,46.97,0.27
1578,2021-06-06,TOS,28277,13639,14638,22922,5355,ITI,ITI1,9,Toscana,Toscana,3729641,1780157,47.73,0.76
1579,2021-03-08,TOS,6371,2630,3741,1551,4820,ITI,ITI1,9,Toscana,Toscana,3729641,1786528,47.9,0.17
1580,2021-05-30,TOS,28653,13942,14711,21714,6939,ITI,ITI1,9,Toscana,Toscana,3729641,1815181,48.67,0.77
1581,2020-12-31,TOS,803,202,601,803,0,ITI,ITI1,9,Toscana,Toscana,3729641,1815984,48.69,0.02
1582,2021-04-10,TOS,11722,5348,6374,10977,745,ITI,ITI1,9,Toscana,Toscana,3729641,1827706,49.0,0.31
1583,2021-02-10,TOS,4263,1281,2982,3740,523,ITI,ITI1,9,Toscana,Toscana,3729641,1831969,49.12,0.11
1584,2021-05-04,TOS,18301,8207,10094,12854,5447,ITI,ITI1,9,Toscana,Toscana,3729641,1850270,49.61,0.49
1585,2021-02-12,TOS,7606,2683,4923,7393,213,ITI,ITI1,9,Toscana,Toscana,3729641,1857876,49.81,0.2
1586,2021-01-26,TOS,5393,1792,3601,220,5173,ITI,ITI1,9,Toscana,Toscana,3729641,1863269,49.96,0.14
1587,2021-05-06,TOS,31338,13624,17714,14174,17164,ITI,ITI1,9,Toscana,Toscana,3729641,1894607,50.8,0.84
1588,2021-04-19,TOS,9090,4504,4586,8062,1028,ITI,ITI1,9,Toscana,Toscana,3729641,1903697,51.04,0.24
1589,2021-04-17,TOS,20532,9206,11326,18410,2122,ITI,ITI1,9,Toscana,Toscana,3729641,1924229,51.59,0.55
1590,2021-01-24,TOS,3349,1073,2276,201,3148,ITI,ITI1,9,Toscana,Toscana,3729641,1927578,51.68,0.09
1591,2021-01-07,TOS,6018,1751,4267,6018,0,ITI,ITI1,9,Toscana,Toscana,3729641,1933596,51.84,0.16
1592,2021-05-01,TOS,23310,10061,13249,14135,9175,ITI,ITI1,9,Toscana,Toscana,3729641,1956906,52.47,0.62
1593,2021-03-05,TOS,16494,6335,10159,11752,4742,ITI,ITI1,9,Toscana,Toscana,3729641,1973400,52.91,0.44
1594,2021-01-29,TOS,6144,1700,4444,304,5840,ITI,ITI1,9,Toscana,Toscana,3729641,1979544,53.08,0.16
1595,2021-05-09,TOS,22527,9765,12762,9668,12859,ITI,ITI1,9,Toscana,Toscana,3729641,2002071,53.68,0.6
1596,2021-05-20,TOS,29512,13700,15812,18903,10609,ITI,ITI1,9,Toscana,Toscana,3729641,2031583,54.47,0.79
1597,2021-01-31,TOS,3050,1129,1921,106,2944,ITI,ITI1,9,Toscana,Toscana,3729641,2034633,54.55,0.08
1598,2021-04-05,TOS,15279,6823,8456,14542,737,ITI,ITI1,9,Toscana,Toscana,3729641,2049912,54.96,0.41
1599,2021-02-07,TOS,2806,952,1854,886,1920,ITI,ITI1,9,Toscana,Toscana,3729641,2052718,55.04,0.08
1600,2021-02-19,TOS,8291,2952,5339,7781,510,ITI,ITI1,9,Toscana,Toscana,3729641,2061009,55.26,0.22
1601,2021-02-14,TOS,9000,2569,6431,8890,110,ITI,ITI1,9,Toscana,Toscana,3729641,2070009,55.5,0.24
1602,2021-05-25,TOS,33814,16216,17598,19336,14478,ITI,ITI1,9,Toscana,Toscana,3729641,2103823,56.41,0.91
1603,2021-03-29,TOS,9390,4587,4803,9066,324,ITI,ITI1,9,Toscana,Toscana,3729641,2113213,56.66,0.25
1604,2021-05-27,TOS,27906,12822,15084,13253,14653,ITI,ITI1,9,Toscana,Toscana,3729641,2141119,57.41,0.75
1605,2021-03-31,TOS,32578,13137,19441,20419,12159,ITI,ITI1,9,Toscana,Toscana,3729641,2173697,58.28,0.87
1606,2021-03-22,TOS,4890,2451,2439,4446,444,ITI,ITI1,9,Toscana,Toscana,3729641,2178587,58.41,0.13
1607,2021-05-18,TOS,28725,14158,14567,19988,8737,ITI,ITI1,9,Toscana,Toscana,3729641,2207312,59.18,0.77
1608,2021-04-15,TOS,24403,10197,14206,15865,8538,ITI,ITI1,9,Toscana,Toscana,3729641,2231715,59.84,0.65
1609,2021-02-17,TOS,8175,3169,5006,7423,752,ITI,ITI1,9,Toscana,Toscana,3729641,2239890,60.06,0.22
1610,2021-05-28,TOS,29852,13720,16132,17499,12353,ITI,ITI1,9,Toscana,Toscana,3729641,2269742,60.86,0.8
1611,2021-04-22,TOS,35720,15301,20419,18281,17439,ITI,ITI1,9,Toscana,Toscana,3729641,2305462,61.81,0.96
1612,2021-02-24,TOS,10372,4467,5905,10171,201,ITI,ITI1,9,Toscana,Toscana,3729641,2315834,62.09,0.28
1613,2021-06-04,TOS,27975,13188,14787,20271,7704,ITI,ITI1,9,Toscana,Toscana,3729641,2343809,62.84,0.75
1614,2021-04-08,TOS,29665,12543,17122,23277,6388,ITI,ITI1,9,Toscana,Toscana,3729641,2373474,63.64,0.8
1615,2021-03-03,TOS,18193,6509,11684,14587,3606,ITI,ITI1,9,Toscana,Toscana,3729641,2391667,64.13,0.49
1616,2021-01-05,TOS,5249,1755,3494,5249,0,ITI,ITI1,9,Toscana,Toscana,3729641,2396916,64.27,0.14
1617,2021-01-19,TOS,1104,531,573,1104,0,ITI,ITI1,9,Toscana,Toscana,3729641,2398020,64.3,0.03
1618,2021-01-12,TOS,3581,1398,2183,3581,0,ITI,ITI1,9,Toscana,Toscana,3729641,2401601,64.39,0.1
1619,2021-01-06,CAL,930,502,428,930,0,ITF,ITF6,18,Calabria,Calabria,1947131,930,0.05,0.05
1620,2021-04-16,CAL,10298,5008,5290,8642,1656,ITF,ITF6,18,Calabria,Calabria,1947131,11228,0.58,0.53
1621,2021-02-18,CAL,1821,824,997,1595,226,ITF,ITF6,18,Calabria,Calabria,1947131,13049,0.67,0.09
1622,2021-01-04,CAL,1052,518,534,1052,0,ITF,ITF6,18,Calabria,Calabria,1947131,14101,0.72,0.05
1623,2021-04-23,CAL,12917,6346,6571,9459,3458,ITF,ITF6,18,Calabria,Calabria,1947131,27018,1.39,0.66
1624,2021-01-13,CAL,2038,1026,1012,2038,0,ITF,ITF6,18,Calabria,Calabria,1947131,29056,1.49,0.1
1625,2021-04-18,CAL,5840,2791,3049,4931,909,ITF,ITF6,18,Calabria,Calabria,1947131,34896,1.79,0.3
1626,2021-04-04,CAL,1762,886,876,1262,500,ITF,ITF6,18,Calabria,Calabria,1947131,36658,1.88,0.09
1627,2021-06-07,CAL,16941,7867,9074,13749,3192,ITF,ITF6,18,Calabria,Calabria,1947131,53599,2.75,0.87
1628,2021-05-24,CAL,17691,8810,8881,10023,7668,ITF,ITF6,18,Calabria,Calabria,1947131,71290,3.66,0.91
1629,2021-05-07,CAL,16087,7584,8503,9717,6370,ITF,ITF6,18,Calabria,Calabria,1947131,87377,4.49,0.83
1630,2021-01-11,CAL,2160,1044,1116,2160,0,ITF,ITF6,18,Calabria,Calabria,1947131,89537,4.6,0.11
1631,2021-01-25,CAL,1070,514,556,147,923,ITF,ITF6,18,Calabria,Calabria,1947131,90607,4.65,0.05
1632,2021-05-05,CAL,13601,6508,7093,8494,5107,ITF,ITF6,18,Calabria,Calabria,1947131,104208,5.35,0.7
1633,2021-03-02,CAL,4368,2490,1878,3612,756,ITF,ITF6,18,Calabria,Calabria,1947131,108576,5.58,0.22
1634,2021-03-16,CAL,3835,1883,1952,2175,1660,ITF,ITF6,18,Calabria,Calabria,1947131,112411,5.77,0.2
1635,2021-02-11,CAL,2330,1041,1289,1082,1248,ITF,ITF6,18,Calabria,Calabria,1947131,114741,5.89,0.12
1636,2021-04-30,CAL,14927,7321,7606,10602,4325,ITF,ITF6,18,Calabria,Calabria,1947131,129668,6.66,0.77
1637,2021-01-18,CAL,1271,573,698,1047,224,ITF,ITF6,18,Calabria,Calabria,1947131,130939,6.72,0.07
1638,2021-04-11,CAL,4166,1895,2271,2223,1943,ITF,ITF6,18,Calabria,Calabria,1947131,135105,6.94,0.21
1639,2021-03-09,CAL,6323,3252,3071,5344,979,ITF,ITF6,18,Calabria,Calabria,1947131,141428,7.26,0.32
1640,2021-02-20,CAL,1419,760,659,1101,318,ITF,ITF6,18,Calabria,Calabria,1947131,142847,7.34,0.07
1641,2021-05-31,CAL,15179,7243,7936,7341,7838,ITF,ITF6,18,Calabria,Calabria,1947131,158026,8.12,0.78
1642,2021-03-11,CAL,7264,3423,3841,6002,1262,ITF,ITF6,18,Calabria,Calabria,1947131,165290,8.49,0.37
1643,2021-03-04,CAL,5467,3185,2282,4671,796,ITF,ITF6,18,Calabria,Calabria,1947131,170757,8.77,0.28
1644,2021-02-25,CAL,2882,1551,1331,2287,595,ITF,ITF6,18,Calabria,Calabria,1947131,173639,8.92,0.15
1645,2021-02-01,CAL,2499,1193,1306,244,2255,ITF,ITF6,18,Calabria,Calabria,1947131,176138,9.05,0.13
1646,2021-05-12,CAL,16320,7924,8396,10894,5426,ITF,ITF6,18,Calabria,Calabria,1947131,192458,9.88,0.84
1647,2021-05-26,CAL,18589,9192,9397,10378,8211,ITF,ITF6,18,Calabria,Calabria,1947131,211047,10.84,0.95
1648,2021-03-30,CAL,6156,2641,3515,3440,2716,ITF,ITF6,18,Calabria,Calabria,1947131,217203,11.16,0.32
1649,2021-02-06,CAL,2906,1337,1569,442,2464,ITF,ITF6,18,Calabria,Calabria,1947131,220109,11.3,0.15
1650,2021-01-23,CAL,400,186,214,358,42,ITF,ITF6,18,Calabria,Calabria,1947131,220509,11.32,0.02
1651,2021-03-28,CAL,2597,1201,1396,1513,1084,ITF,ITF6,18,Calabria,Calabria,1947131,223106,11.46,0.13
1652,2021-01-30,CAL,2180,1149,1031,357,1823,ITF,ITF6,18,Calabria,Calabria,1947131,225286,11.57,0.11
1653,2021-02-17,CAL,1834,799,1035,1623,211,ITF,ITF6,18,Calabria,Calabria,1947131,227120,11.66,0.09
1654,2021-05-28,CAL,20938,10164,10774,11523,9415,ITF,ITF6,18,Calabria,Calabria,1947131,248058,12.74,1.08
1655,2021-04-15,CAL,7593,3721,3872,5982,1611,ITF,ITF6,18,Calabria,Calabria,1947131,255651,13.13,0.39
1656,2021-05-23,CAL,11366,5547,5819,7034,4332,ITF,ITF6,18,Calabria,Calabria,1947131,267017,13.71,0.58
1657,2021-03-01,CAL,2724,1546,1178,2269,455,ITF,ITF6,18,Calabria,Calabria,1947131,269741,13.85,0.14
1658,2021-06-09,CAL,9698,4444,5254,8197,1501,ITF,ITF6,18,Calabria,Calabria,1947131,279439,14.35,0.5
1659,2021-01-10,CAL,930,524,406,930,0,ITF,ITF6,18,Calabria,Calabria,1947131,280369,14.4,0.05
1660,2021-04-13,CAL,6775,3267,3508,5465,1310,ITF,ITF6,18,Calabria,Calabria,1947131,287144,14.75,0.35
1661,2021-01-20,CAL,1399,626,773,1398,1,ITF,ITF6,18,Calabria,Calabria,1947131,288543,14.82,0.07
1662,2021-01-03,CAL,6,3,3,6,0,ITF,ITF6,18,Calabria,Calabria,1947131,288549,14.82,0.0
1663,2021-03-27,CAL,8590,3890,4700,4591,3999,ITF,ITF6,18,Calabria,Calabria,1947131,297139,15.26,0.44
1664,2021-03-08,CAL,5416,2902,2514,4350,1066,ITF,ITF6,18,Calabria,Calabria,1947131,302555,15.54,0.28
1665,2021-03-25,CAL,7392,3466,3926,4546,2846,ITF,ITF6,18,Calabria,Calabria,1947131,309947,15.92,0.38
1666,2021-02-13,CAL,1397,604,793,1032,365,ITF,ITF6,18,Calabria,Calabria,1947131,311344,15.99,0.07
1667,2021-01-08,CAL,2136,1024,1112,2136,0,ITF,ITF6,18,Calabria,Calabria,1947131,313480,16.1,0.11
1668,2021-03-18,CAL,4399,2053,2346,2343,2056,ITF,ITF6,18,Calabria,Calabria,1947131,317879,16.33,0.23
1669,2021-02-27,CAL,3990,2054,1936,3611,379,ITF,ITF6,18,Calabria,Calabria,1947131,321869,16.53,0.2
1670,2021-01-27,CAL,1457,733,724,396,1061,ITF,ITF6,18,Calabria,Calabria,1947131,323326,16.61,0.07
1671,2021-03-13,CAL,6852,2990,3862,5880,972,ITF,ITF6,18,Calabria,Calabria,1947131,330178,16.96,0.35
1672,2021-01-15,CAL,2796,1258,1538,2796,0,ITF,ITF6,18,Calabria,Calabria,1947131,332974,17.1,0.14
1673,2021-04-25,CAL,15830,8033,7797,14695,1135,ITF,ITF6,18,Calabria,Calabria,1947131,348804,17.91,0.81
1674,2021-05-14,CAL,19941,9588,10353,13070,6871,ITF,ITF6,18,Calabria,Calabria,1947131,368745,18.94,1.02
1675,2021-04-27,CAL,9947,4890,5057,8004,1943,ITF,ITF6,18,Calabria,Calabria,1947131,378692,19.45,0.51
1676,2021-02-03,CAL,2768,1429,1339,578,2190,ITF,ITF6,18,Calabria,Calabria,1947131,381460,19.59,0.14
1677,2021-02-22,CAL,2037,1032,1005,1479,558,ITF,ITF6,18,Calabria,Calabria,1947131,383497,19.7,0.1
1678,2021-06-02,CAL,11904,5704,6200,8639,3265,ITF,ITF6,18,Calabria,Calabria,1947131,395401,20.31,0.61
1679,2021-04-01,CAL,8496,3845,4651,3980,4516,ITF,ITF6,18,Calabria,Calabria,1947131,403897,20.74,0.44
1680,2021-04-08,CAL,9391,4426,4965,5803,3588,ITF,ITF6,18,Calabria,Calabria,1947131,413288,21.23,0.48
1681,2021-02-10,CAL,2509,1078,1431,884,1625,ITF,ITF6,18,Calabria,Calabria,1947131,415797,21.35,0.13
1682,2021-06-04,CAL,17254,8001,9253,12735,4519,ITF,ITF6,18,Calabria,Calabria,1947131,433051,22.24,0.89
1683,2021-05-21,CAL,21344,10864,10480,13981,7363,ITF,ITF6,18,Calabria,Calabria,1947131,454395,23.34,1.1
1684,2021-03-06,CAL,8426,4339,4087,7634,792,ITF,ITF6,18,Calabria,Calabria,1947131,462821,23.77,0.43
1685,2021-05-09,CAL,9615,4479,5136,6086,3529,ITF,ITF6,18,Calabria,Calabria,1947131,472436,24.26,0.49
1686,2021-01-29,CAL,2049,988,1061,230,1819,ITF,ITF6,18,Calabria,Calabria,1947131,474485,24.37,0.11
1687,2021-05-04,CAL,16354,7534,8820,11716,4638,ITF,ITF6,18,Calabria,Calabria,1947131,490839,25.21,0.84
1688,2021-05-19,CAL,18348,9085,9263,11359,6989,ITF,ITF6,18,Calabria,Calabria,1947131,509187,26.15,0.94
1689,2021-03-23,CAL,5253,2460,2793,3444,1809,ITF,ITF6,18,Calabria,Calabria,1947131,514440,26.42,0.27
1690,2021-02-15,CAL,1140,539,601,991,149,ITF,ITF6,18,Calabria,Calabria,1947131,515580,26.48,0.06
1691,2021-04-20,CAL,7845,3956,3889,6119,1726,ITF,ITF6,18,Calabria,Calabria,1947131,523425,26.88,0.4
1692,2021-02-12,CAL,1710,667,1043,945,765,ITF,ITF6,18,Calabria,Calabria,1947131,525135,26.97,0.09
1693,2021-04-03,CAL,8885,3812,5073,4285,4600,ITF,ITF6,18,Calabria,Calabria,1947131,534020,27.43,0.46
1694,2021-02-14,CAL,464,211,253,434,30,ITF,ITF6,18,Calabria,Calabria,1947131,534484,27.45,0.02
1695,2021-05-25,CAL,16367,7990,8377,10290,6077,ITF,ITF6,18,Calabria,Calabria,1947131,550851,28.29,0.84
1696,2021-01-26,CAL,1810,861,949,278,1532,ITF,ITF6,18,Calabria,Calabria,1947131,552661,28.38,0.09
1697,2021-04-22,CAL,9623,4797,4826,6777,2846,ITF,ITF6,18,Calabria,Calabria,1947131,562284,28.88,0.49
1698,2021-05-06,CAL,13251,6270,6981,8992,4259,ITF,ITF6,18,Calabria,Calabria,1947131,575535,29.56,0.68
1699,2021-05-16,CAL,13770,6723,7047,9959,3811,ITF,ITF6,18,Calabria,Calabria,1947131,589305,30.27,0.71
1700,2021-01-17,CAL,867,418,449,801,66,ITF,ITF6,18,Calabria,Calabria,1947131,590172,30.31,0.04
1701,2021-03-24,CAL,7613,3468,4145,4374,3239,ITF,ITF6,18,Calabria,Calabria,1947131,597785,30.7,0.39
1702,2021-04-10,CAL,11371,5129,6242,6572,4799,ITF,ITF6,18,Calabria,Calabria,1947131,609156,31.28,0.58
1703,2021-02-05,CAL,3802,1711,2091,489,3313,ITF,ITF6,18,Calabria,Calabria,1947131,612958,31.48,0.2
1704,2021-03-20,CAL,6698,3070,3628,4197,2501,ITF,ITF6,18,Calabria,Calabria,1947131,619656,31.82,0.34
1705,2021-03-15,CAL,3556,1687,1869,2115,1441,ITF,ITF6,18,Calabria,Calabria,1947131,623212,32.01,0.18
1706,2021-05-20,CAL,16892,8433,8459,11286,5606,ITF,ITF6,18,Calabria,Calabria,1947131,640104,32.87,0.87
1707,2021-02-07,CAL,859,427,432,147,712,ITF,ITF6,18,Calabria,Calabria,1947131,640963,32.92,0.04
1708,2021-05-18,CAL,15380,7681,7699,11917,3463,ITF,ITF6,18,Calabria,Calabria,1947131,656343,33.71,0.79
1709,2021-03-10,CAL,6552,3313,3239,5271,1281,ITF,ITF6,18,Calabria,Calabria,1947131,662895,34.04,0.34
1710,2021-06-01,CAL,12788,5913,6875,7908,4880,ITF,ITF6,18,Calabria,Calabria,1947131,675683,34.7,0.66
1711,2021-01-05,CAL,1468,686,782,1468,0,ITF,ITF6,18,Calabria,Calabria,1947131,677151,34.78,0.08
1712,2021-01-12,CAL,2064,1020,1044,2064,0,ITF,ITF6,18,Calabria,Calabria,1947131,679215,34.88,0.11
1713,2021-02-24,CAL,1852,944,908,1374,478,ITF,ITF6,18,Calabria,Calabria,1947131,681067,34.98,0.1
1714,2021-03-03,CAL,5011,2738,2273,3930,1081,ITF,ITF6,18,Calabria,Calabria,1947131,686078,35.24,0.26
1715,2021-05-03,CAL,14743,6756,7987,10541,4202,ITF,ITF6,18,Calabria,Calabria,1947131,700821,35.99,0.76
1716,2021-03-21,CAL,4456,1926,2530,2732,1724,ITF,ITF6,18,Calabria,Calabria,1947131,705277,36.22,0.23
1717,2021-03-07,CAL,3336,1703,1633,3246,90,ITF,ITF6,18,Calabria,Calabria,1947131,708613,36.39,0.17
1718,2021-01-22,CAL,658,274,384,656,2,ITF,ITF6,18,Calabria,Calabria,1947131,709271,36.43,0.03
1719,2021-05-02,CAL,12502,5834,6668,10662,1840,ITF,ITF6,18,Calabria,Calabria,1947131,721773,37.07,0.64
1720,2021-03-29,CAL,5613,2370,3243,3857,1756,ITF,ITF6,18,Calabria,Calabria,1947131,727386,37.36,0.29
1721,2021-01-31,CAL,1111,555,556,154,957,ITF,ITF6,18,Calabria,Calabria,1947131,728497,37.41,0.06
1722,2021-05-11,CAL,15126,7315,7811,10350,4776,ITF,ITF6,18,Calabria,Calabria,1947131,743623,38.19,0.78
1723,2021-01-24,CAL,44,18,26,39,5,ITF,ITF6,18,Calabria,Calabria,1947131,743667,38.19,0.0
1724,2021-01-28,CAL,2238,1112,1126,83,2155,ITF,ITF6,18,Calabria,Calabria,1947131,745905,38.31,0.11
1725,2021-05-08,CAL,18284,8330,9954,10482,7802,ITF,ITF6,18,Calabria,Calabria,1947131,764189,39.25,0.94
1726,2021-05-22,CAL,22140,10544,11596,14317,7823,ITF,ITF6,18,Calabria,Calabria,1947131,786329,40.38,1.14
1727,2021-04-21,CAL,11566,5807,5759,8629,2937,ITF,ITF6,18,Calabria,Calabria,1947131,797895,40.98,0.59
1728,2021-04-02,CAL,8207,3744,4463,4336,3871,ITF,ITF6,18,Calabria,Calabria,1947131,806102,41.4,0.42
1729,2021-03-19,CAL,4186,1947,2239,1900,2286,ITF,ITF6,18,Calabria,Calabria,1947131,810288,41.61,0.21
1730,2021-04-29,CAL,11946,5811,6135,8390,3556,ITF,ITF6,18,Calabria,Calabria,1947131,822234,42.23,0.61
1731,2021-04-12,CAL,6898,3350,3548,5250,1648,ITF,ITF6,18,Calabria,Calabria,1947131,829132,42.58,0.35
1732,2021-01-19,CAL,1112,491,621,1101,11,ITF,ITF6,18,Calabria,Calabria,1947131,830244,42.64,0.06
1733,2021-03-26,CAL,7912,3745,4167,4792,3120,ITF,ITF6,18,Calabria,Calabria,1947131,838156,43.05,0.41
1734,2021-01-02,CAL,166,94,72,166,0,ITF,ITF6,18,Calabria,Calabria,1947131,838322,43.05,0.01
1735,2021-04-05,CAL,3501,1648,1853,2602,899,ITF,ITF6,18,Calabria,Calabria,1947131,841823,43.23,0.18
1736,2021-06-08,CAL,15777,7438,8339,13835,1942,ITF,ITF6,18,Calabria,Calabria,1947131,857600,44.04,0.81
1737,2021-03-17,CAL,3986,1773,2213,2138,1848,ITF,ITF6,18,Calabria,Calabria,1947131,861586,44.25,0.2
1738,2021-04-19,CAL,7844,3783,4061,6178,1666,ITF,ITF6,18,Calabria,Calabria,1947131,869430,44.65,0.4
1739,2021-01-09,CAL,1926,1041,885,1926,0,ITF,ITF6,18,Calabria,Calabria,1947131,871356,44.75,0.1
1740,2021-05-13,CAL,15872,7611,8261,11210,4662,ITF,ITF6,18,Calabria,Calabria,1947131,887228,45.57,0.82
1741,2021-02-19,CAL,1508,681,827,1247,261,ITF,ITF6,18,Calabria,Calabria,1947131,888736,45.64,0.08
1742,2021-05-30,CAL,10936,5249,5687,6783,4153,ITF,ITF6,18,Calabria,Calabria,1947131,899672,46.21,0.56
1743,2021-05-17,CAL,14855,7437,7418,10142,4713,ITF,ITF6,18,Calabria,Calabria,1947131,914527,46.97,0.76
1744,2021-02-21,CAL,613,288,325,536,77,ITF,ITF6,18,Calabria,Calabria,1947131,915140,47.0,0.03
1745,2021-04-28,CAL,12521,6059,6462,9664,2857,ITF,ITF6,18,Calabria,Calabria,1947131,927661,47.64,0.64
1746,2021-02-04,CAL,3554,1694,1860,653,2901,ITF,ITF6,18,Calabria,Calabria,1947131,931215,47.82,0.18
1747,2021-05-15,CAL,27114,12980,14134,20341,6773,ITF,ITF6,18,Calabria,Calabria,1947131,958329,49.22,1.39
1748,2021-02-02,CAL,2289,1114,1175,177,2112,ITF,ITF6,18,Calabria,Calabria,1947131,960618,49.34,0.12
1749,2021-01-16,CAL,2394,1120,1274,2394,0,ITF,ITF6,18,Calabria,Calabria,1947131,963012,49.46,0.12
1750,2021-03-14,CAL,2709,1066,1643,2293,416,ITF,ITF6,18,Calabria,Calabria,1947131,965721,49.6,0.14
1751,2021-05-10,CAL,13130,6092,7038,7732,5398,ITF,ITF6,18,Calabria,Calabria,1947131,978851,50.27,0.67
1752,2021-04-26,CAL,10196,5064,5132,7775,2421,ITF,ITF6,18,Calabria,Calabria,1947131,989047,50.8,0.52
1753,2021-03-22,CAL,4888,2292,2596,3134,1754,ITF,ITF6,18,Calabria,Calabria,1947131,993935,51.05,0.25
1754,2021-02-09,CAL,2157,911,1246,956,1201,ITF,ITF6,18,Calabria,Calabria,1947131,996092,51.16,0.11
1755,2021-05-29,CAL,19085,8858,10227,9261,9824,ITF,ITF6,18,Calabria,Calabria,1947131,1015177,52.14,0.98
1756,2021-02-28,CAL,2307,1047,1260,2155,152,ITF,ITF6,18,Calabria,Calabria,1947131,1017484,52.26,0.12
1757,2020-12-28,CAL,6,2,4,6,0,ITF,ITF6,18,Calabria,Calabria,1947131,1017490,52.26,0.0
1758,2021-06-03,CAL,14121,6593,7528,9567,4554,ITF,ITF6,18,Calabria,Calabria,1947131,1031611,52.98,0.73
1759,2021-04-07,CAL,6516,2944,3572,3716,2800,ITF,ITF6,18,Calabria,Calabria,1947131,1038127,53.32,0.33
1760,2021-02-23,CAL,1590,753,837,1475,115,ITF,ITF6,18,Calabria,Calabria,1947131,1039717,53.4,0.08
1761,2021-03-31,CAL,8807,4000,4807,4850,3957,ITF,ITF6,18,Calabria,Calabria,1947131,1048524,53.85,0.45
1762,2021-04-09,CAL,7934,3714,4220,5009,2925,ITF,ITF6,18,Calabria,Calabria,1947131,1056458,54.26,0.41
1763,2021-06-05,CAL,20076,9409,10667,17133,2943,ITF,ITF6,18,Calabria,Calabria,1947131,1076534,55.29,1.03
1764,2021-04-14,CAL,8166,3930,4236,6719,1447,ITF,ITF6,18,Calabria,Calabria,1947131,1084700,55.71,0.42
1765,2021-02-16,CAL,1736,733,1003,1458,278,ITF,ITF6,18,Calabria,Calabria,1947131,1086436,55.8,0.09
1766,2021-05-27,CAL,17516,8622,8894,9809,7707,ITF,ITF6,18,Calabria,Calabria,1947131,1103952,56.7,0.9
1767,2020-12-27,CAL,281,156,125,281,0,ITF,ITF6,18,Calabria,Calabria,1947131,1104233,56.71,0.01
1768,2021-04-06,CAL,7453,3368,4085,4177,3276,ITF,ITF6,18,Calabria,Calabria,1947131,1111686,57.09,0.38
1769,2021-02-08,CAL,1849,735,1114,663,1186,ITF,ITF6,18,Calabria,Calabria,1947131,1113535,57.19,0.09
1770,2021-04-24,CAL,18993,9476,9517,15584,3409,ITF,ITF6,18,Calabria,Calabria,1947131,1132528,58.16,0.98
1771,2021-02-26,CAL,3063,1632,1431,2610,453,ITF,ITF6,18,Calabria,Calabria,1947131,1135591,58.32,0.16
1772,2021-06-06,CAL,13370,6431,6939,11681,1689,ITF,ITF6,18,Calabria,Calabria,1947131,1148961,59.01,0.69
1773,2021-01-07,CAL,2187,1067,1120,2187,0,ITF,ITF6,18,Calabria,Calabria,1947131,1151148,59.12,0.11
1774,2021-04-17,CAL,10853,5086,5767,9046,1807,ITF,ITF6,18,Calabria,Calabria,1947131,1162001,59.68,0.56
1775,2021-05-01,CAL,16621,7931,8690,12430,4191,ITF,ITF6,18,Calabria,Calabria,1947131,1178622,60.53,0.85
1776,2021-03-05,CAL,6229,3612,2617,5656,573,ITF,ITF6,18,Calabria,Calabria,1947131,1184851,60.85,0.32
1777,2021-03-12,CAL,5156,2470,2686,4091,1065,ITF,ITF6,18,Calabria,Calabria,1947131,1190007,61.12,0.26
1778,2021-01-14,CAL,2635,1248,1387,2635,0,ITF,ITF6,18,Calabria,Calabria,1947131,1192642,61.25,0.14
1779,2021-01-21,CAL,960,445,515,930,30,ITF,ITF6,18,Calabria,Calabria,1947131,1193602,61.3,0.05
1780,2021-02-16,LIG,2425,956,1469,2004,421,ITC,ITC3,7,Liguria,Liguria,1550640,2425,0.16,0.16
1781,2021-05-27,LIG,16348,8229,8119,12398,3950,ITC,ITC3,7,Liguria,Liguria,1550640,18773,1.21,1.05
1782,2021-04-14,LIG,13066,5666,7400,10863,2203,ITC,ITC3,7,Liguria,Liguria,1550640,31839,2.05,0.84
1783,2021-05-29,LIG,6810,3227,3583,3971,2839,ITC,ITC3,7,Liguria,Liguria,1550640,38649,2.49,0.44
1784,2021-02-09,LIG,1936,689,1247,256,1680,ITC,ITC3,7,Liguria,Liguria,1550640,40585,2.62,0.12
1785,2021-02-28,LIG,1058,580,478,1049,9,ITC,ITC3,7,Liguria,Liguria,1550640,41643,2.69,0.07
1786,2021-01-09,LIG,1335,481,854,1335,0,ITC,ITC3,7,Liguria,Liguria,1550640,42978,2.77,0.09
1787,2021-04-19,LIG,12807,5613,7194,8999,3808,ITC,ITC3,7,Liguria,Liguria,1550640,55785,3.6,0.83
1788,2021-02-11,LIG,1979,767,1212,1103,876,ITC,ITC3,7,Liguria,Liguria,1550640,57764,3.73,0.13
1789,2021-05-22,LIG,6551,3195,3356,4943,1608,ITC,ITC3,7,Liguria,Liguria,1550640,64315,4.15,0.42
1790,2021-03-19,LIG,5294,2234,3060,2149,3145,ITC,ITC3,7,Liguria,Liguria,1550640,69609,4.49,0.34
1791,2021-03-02,LIG,4074,1689,2385,3764,310,ITC,ITC3,7,Liguria,Liguria,1550640,73683,4.75,0.26
1792,2021-04-02,LIG,11670,5116,6554,9184,2486,ITC,ITC3,7,Liguria,Liguria,1550640,85353,5.5,0.75
1793,2021-04-21,LIG,14243,6431,7812,8921,5322,ITC,ITC3,7,Liguria,Liguria,1550640,99596,6.42,0.92
1794,2021-05-08,LIG,7528,3333,4195,2314,5214,ITC,ITC3,7,Liguria,Liguria,1550640,107124,6.91,0.49
1795,2021-01-25,LIG,2722,888,1834,477,2245,ITC,ITC3,7,Liguria,Liguria,1550640,109846,7.08,0.18
1796,2021-04-26,LIG,10455,4916,5539,7829,2626,ITC,ITC3,7,Liguria,Liguria,1550640,120301,7.76,0.67
1797,2021-01-16,LIG,1278,557,721,1278,0,ITC,ITC3,7,Liguria,Liguria,1550640,121579,7.84,0.08
1798,2021-02-02,LIG,2668,1005,1663,134,2534,ITC,ITC3,7,Liguria,Liguria,1550640,124247,8.01,0.17
1799,2021-04-28,LIG,14443,6519,7924,6459,7984,ITC,ITC3,7,Liguria,Liguria,1550640,138690,8.94,0.93
1800,2021-02-04,LIG,2817,986,1831,179,2638,ITC,ITC3,7,Liguria,Liguria,1550640,141507,9.13,0.18
1801,2021-05-15,LIG,7254,3237,4017,4298,2956,ITC,ITC3,7,Liguria,Liguria,1550640,148761,9.59,0.47
1802,2021-02-21,LIG,869,491,378,865,4,ITC,ITC3,7,Liguria,Liguria,1550640,149630,9.65,0.06
1803,2021-03-26,LIG,9122,3856,5266,5968,3154,ITC,ITC3,7,Liguria,Liguria,1550640,158752,10.24,0.59
1804,2021-01-02,LIG,691,245,446,691,0,ITC,ITC3,7,Liguria,Liguria,1550640,159443,10.28,0.04
1805,2021-03-07,LIG,1858,1085,773,1557,301,ITC,ITC3,7,Liguria,Liguria,1550640,161301,10.4,0.12
1806,2021-06-05,LIG,8039,4101,3938,4918,3121,ITC,ITC3,7,Liguria,Liguria,1550640,169340,10.92,0.52
1807,2021-04-09,LIG,12422,5554,6868,10683,1739,ITC,ITC3,7,Liguria,Liguria,1550640,181762,11.72,0.8
1808,2021-03-31,LIG,11841,5206,6635,9071,2770,ITC,ITC3,7,Liguria,Liguria,1550640,193603,12.49,0.76
1809,2020-12-28,LIG,80,30,50,80,0,ITC,ITC3,7,Liguria,Liguria,1550640,193683,12.49,0.01
1810,2021-06-03,LIG,15350,7579,7771,9040,6310,ITC,ITC3,7,Liguria,Liguria,1550640,209033,13.48,0.99
1811,2021-04-07,LIG,13583,6031,7552,11294,2289,ITC,ITC3,7,Liguria,Liguria,1550640,222616,14.36,0.88
1812,2021-02-23,LIG,3806,1559,2247,3697,109,ITC,ITC3,7,Liguria,Liguria,1550640,226422,14.6,0.25
1813,2021-01-28,LIG,2847,971,1876,39,2808,ITC,ITC3,7,Liguria,Liguria,1550640,229269,14.79,0.18
1814,2021-01-21,LIG,1104,385,719,673,431,ITC,ITC3,7,Liguria,Liguria,1550640,230373,14.86,0.07
1815,2021-03-14,LIG,1659,752,907,1055,604,ITC,ITC3,7,Liguria,Liguria,1550640,232032,14.96,0.11
1816,2021-05-10,LIG,12504,5504,7000,6131,6373,ITC,ITC3,7,Liguria,Liguria,1550640,244536,15.77,0.81
1817,2021-05-03,LIG,13267,5918,7349,6455,6812,ITC,ITC3,7,Liguria,Liguria,1550640,257803,16.63,0.86
1818,2021-03-21,LIG,550,220,330,69,481,ITC,ITC3,7,Liguria,Liguria,1550640,258353,16.66,0.04
1819,2021-01-23,LIG,809,295,514,153,656,ITC,ITC3,7,Liguria,Liguria,1550640,259162,16.71,0.05
1820,2021-05-17,LIG,11851,5364,6487,8542,3309,ITC,ITC3,7,Liguria,Liguria,1550640,271013,17.48,0.76
1821,2021-05-05,LIG,13707,6130,7577,5286,8421,ITC,ITC3,7,Liguria,Liguria,1550640,284720,18.36,0.88
1822,2021-03-16,LIG,6073,2722,3351,2349,3724,ITC,ITC3,7,Liguria,Liguria,1550640,290793,18.75,0.39
1823,2020-12-30,LIG,12,5,7,12,0,ITC,ITC3,7,Liguria,Liguria,1550640,290805,18.75,0.0
1824,2021-04-11,LIG,4248,1930,2318,3999,249,ITC,ITC3,7,Liguria,Liguria,1550640,295053,19.03,0.27
1825,2021-01-18,LIG,2137,745,1392,1980,157,ITC,ITC3,7,Liguria,Liguria,1550640,297190,19.17,0.14
1826,2021-05-24,LIG,11658,5423,6235,9174,2484,ITC,ITC3,7,Liguria,Liguria,1550640,308848,19.92,0.75
1827,2021-05-07,LIG,13565,6019,7546,5780,7785,ITC,ITC3,7,Liguria,Liguria,1550640,322413,20.79,0.87
1828,2021-02-13,LIG,1080,508,572,800,280,ITC,ITC3,7,Liguria,Liguria,1550640,323493,20.86,0.07
1829,2021-06-07,LIG,15349,7405,7944,8477,6872,ITC,ITC3,7,Liguria,Liguria,1550640,338842,21.85,0.99
1830,2021-04-23,LIG,14672,6637,8035,8552,6120,ITC,ITC3,7,Liguria,Liguria,1550640,353514,22.8,0.95
1831,2021-03-11,LIG,6351,3053,3298,4345,2006,ITC,ITC3,7,Liguria,Liguria,1550640,359865,23.21,0.41
1832,2021-01-13,LIG,2754,1013,1741,2754,0,ITC,ITC3,7,Liguria,Liguria,1550640,362619,23.39,0.18
1833,2021-01-04,LIG,2615,854,1761,2615,0,ITC,ITC3,7,Liguria,Liguria,1550640,365234,23.55,0.17
1834,2021-04-16,LIG,11969,5279,6690,10159,1810,ITC,ITC3,7,Liguria,Liguria,1550640,377203,24.33,0.77
1835,2021-01-06,LIG,1660,616,1044,1660,0,ITC,ITC3,7,Liguria,Liguria,1550640,378863,24.43,0.11
1836,2021-06-02,LIG,8531,4343,4188,5364,3167,ITC,ITC3,7,Liguria,Liguria,1550640,387394,24.98,0.55
1837,2021-02-18,LIG,2764,1126,1638,2430,334,ITC,ITC3,7,Liguria,Liguria,1550640,390158,25.16,0.18
1838,2021-05-14,LIG,12913,5660,7253,8614,4299,ITC,ITC3,7,Liguria,Liguria,1550640,403071,25.99,0.83
1839,2021-05-31,LIG,14411,7123,7288,8951,5460,ITC,ITC3,7,Liguria,Liguria,1550640,417482,26.92,0.93
1840,2021-03-09,LIG,5930,2753,3177,4499,1431,ITC,ITC3,7,Liguria,Liguria,1550640,423412,27.31,0.38
1841,2021-01-30,LIG,1660,566,1094,24,1636,ITC,ITC3,7,Liguria,Liguria,1550640,425072,27.41,0.11
1842,2021-03-28,LIG,1141,511,630,390,751,ITC,ITC3,7,Liguria,Liguria,1550640,426213,27.49,0.07
1843,2021-02-06,LIG,1892,768,1124,145,1747,ITC,ITC3,7,Liguria,Liguria,1550640,428105,27.61,0.12
1844,2021-02-25,LIG,3455,1349,2106,3325,130,ITC,ITC3,7,Liguria,Liguria,1550640,431560,27.83,0.22
1845,2021-03-04,LIG,4738,2118,2620,3891,847,ITC,ITC3,7,Liguria,Liguria,1550640,436298,28.14,0.31
1846,2021-04-30,LIG,14346,6389,7957,5778,8568,ITC,ITC3,7,Liguria,Liguria,1550640,450644,29.06,0.93
1847,2021-01-14,LIG,2980,1055,1925,2980,0,ITC,ITC3,7,Liguria,Liguria,1550640,453624,29.25,0.19
1848,2021-03-12,LIG,6149,2812,3337,3680,2469,ITC,ITC3,7,Liguria,Liguria,1550640,459773,29.65,0.4
1849,2021-05-19,LIG,13548,5950,7598,10429,3119,ITC,ITC3,7,Liguria,Liguria,1550640,473321,30.52,0.87
1850,2021-03-23,LIG,9054,4091,4963,5845,3209,ITC,ITC3,7,Liguria,Liguria,1550640,482375,31.11,0.58
1851,2021-02-01,LIG,2557,922,1635,90,2467,ITC,ITC3,7,Liguria,Liguria,1550640,484932,31.27,0.16
1852,2021-05-12,LIG,11896,5332,6564,6556,5340,ITC,ITC3,7,Liguria,Liguria,1550640,496828,32.04,0.77
1853,2021-05-26,LIG,16183,8021,8162,12000,4183,ITC,ITC3,7,Liguria,Liguria,1550640,513011,33.08,1.04
1854,2021-03-30,LIG,12142,5378,6764,8753,3389,ITC,ITC3,7,Liguria,Liguria,1550640,525153,33.87,0.78
1855,2021-01-11,LIG,2653,989,1664,2653,0,ITC,ITC3,7,Liguria,Liguria,1550640,527806,34.04,0.17
1856,2021-01-10,LIG,648,262,386,648,0,ITC,ITC3,7,Liguria,Liguria,1550640,528454,34.08,0.04
1857,2021-04-20,LIG,14213,6504,7709,9867,4346,ITC,ITC3,7,Liguria,Liguria,1550640,542667,35.0,0.92
1858,2021-05-23,LIG,2305,1119,1186,1182,1123,ITC,ITC3,7,Liguria,Liguria,1550640,544972,35.14,0.15
1859,2021-03-01,LIG,3506,1430,2076,3384,122,ITC,ITC3,7,Liguria,Liguria,1550640,548478,35.37,0.23
1860,2021-06-09,LIG,13579,6738,6841,8717,4862,ITC,ITC3,7,Liguria,Liguria,1550640,562057,36.25,0.88
1861,2021-04-04,LIG,756,366,390,507,249,ITC,ITC3,7,Liguria,Liguria,1550640,562813,36.3,0.05
1862,2021-04-18,LIG,2613,1164,1449,2145,468,ITC,ITC3,7,Liguria,Liguria,1550640,565426,36.46,0.17
1863,2021-01-08,LIG,2926,999,1927,2926,0,ITC,ITC3,7,Liguria,Liguria,1550640,568352,36.65,0.19
1864,2021-01-27,LIG,1744,603,1141,141,1603,ITC,ITC3,7,Liguria,Liguria,1550640,570096,36.77,0.11
1865,2021-05-21,LIG,12829,5949,6880,9705,3124,ITC,ITC3,7,Liguria,Liguria,1550640,582925,37.59,0.83
1866,2021-02-27,LIG,1888,921,967,1759,129,ITC,ITC3,7,Liguria,Liguria,1550640,584813,37.71,0.12
1867,2021-02-10,LIG,2314,837,1477,1019,1295,ITC,ITC3,7,Liguria,Liguria,1550640,587127,37.86,0.15
1868,2021-02-20,LIG,1335,637,698,1334,1,ITC,ITC3,7,Liguria,Liguria,1550640,588462,37.95,0.09
1869,2021-05-16,LIG,3693,1855,1838,2133,1560,ITC,ITC3,7,Liguria,Liguria,1550640,592155,38.19,0.24
1870,2021-02-22,LIG,3334,1467,1867,3192,142,ITC,ITC3,7,Liguria,Liguria,1550640,595489,38.4,0.22
1871,2021-04-27,LIG,14746,6676,8070,7166,7580,ITC,ITC3,7,Liguria,Liguria,1550640,610235,39.35,0.95
1872,2021-03-20,LIG,2316,995,1321,1142,1174,ITC,ITC3,7,Liguria,Liguria,1550640,612551,39.5,0.15
1873,2021-01-15,LIG,2255,754,1501,2255,0,ITC,ITC3,7,Liguria,Liguria,1550640,614806,39.65,0.15
1874,2021-04-25,LIG,1936,921,1015,1521,415,ITC,ITC3,7,Liguria,Liguria,1550640,616742,39.77,0.12
1875,2021-03-13,LIG,3827,1616,2211,2972,855,ITC,ITC3,7,Liguria,Liguria,1550640,620569,40.02,0.25
1876,2021-03-08,LIG,5630,2460,3170,3941,1689,ITC,ITC3,7,Liguria,Liguria,1550640,626199,40.38,0.36
1877,2021-03-25,LIG,9592,4080,5512,6199,3393,ITC,ITC3,7,Liguria,Liguria,1550640,635791,41.0,0.62
1878,2021-01-01,LIG,144,55,89,144,0,ITC,ITC3,7,Liguria,Liguria,1550640,635935,41.01,0.01
1879,2021-03-27,LIG,3919,1537,2382,2524,1395,ITC,ITC3,7,Liguria,Liguria,1550640,639854,41.26,0.25
1880,2021-04-13,LIG,13076,5866,7210,11052,2024,ITC,ITC3,7,Liguria,Liguria,1550640,652930,42.11,0.84
1881,2021-04-15,LIG,11817,5218,6599,9965,1852,ITC,ITC3,7,Liguria,Liguria,1550640,664747,42.87,0.76
1882,2021-04-08,LIG,13723,6156,7567,11680,2043,ITC,ITC3,7,Liguria,Liguria,1550640,678470,43.75,0.88
1883,2021-06-04,LIG,14443,6998,7445,9100,5343,ITC,ITC3,7,Liguria,Liguria,1550640,692913,44.69,0.93
1884,2021-02-17,LIG,2688,1181,1507,2262,426,ITC,ITC3,7,Liguria,Liguria,1550640,695601,44.86,0.17
1885,2021-05-28,LIG,16025,7922,8103,11562,4463,ITC,ITC3,7,Liguria,Liguria,1550640,711626,45.89,1.03
1886,2021-01-05,LIG,2879,896,1983,2879,0,ITC,ITC3,7,Liguria,Liguria,1550640,714505,46.08,0.19
1887,2021-03-03,LIG,4580,1847,2733,3554,1026,ITC,ITC3,7,Liguria,Liguria,1550640,719085,46.37,0.3
1888,2021-02-24,LIG,3763,1560,2203,3505,258,ITC,ITC3,7,Liguria,Liguria,1550640,722848,46.62,0.24
1889,2020-12-29,LIG,125,33,92,125,0,ITC,ITC3,7,Liguria,Liguria,1550640,722973,46.62,0.01
1890,2021-01-12,LIG,2459,885,1574,2459,0,ITC,ITC3,7,Liguria,Liguria,1550640,725432,46.78,0.16
1891,2021-04-22,LIG,13817,6194,7623,8747,5070,ITC,ITC3,7,Liguria,Liguria,1550640,739249,47.67,0.89
1892,2021-03-06,LIG,3304,1842,1462,2599,705,ITC,ITC3,7,Liguria,Liguria,1550640,742553,47.89,0.21
1893,2021-01-22,LIG,1820,605,1215,1334,486,ITC,ITC3,7,Liguria,Liguria,1550640,744373,48.0,0.12
1894,2021-05-02,LIG,3878,1767,2111,506,3372,ITC,ITC3,7,Liguria,Liguria,1550640,748251,48.25,0.25
1895,2021-05-04,LIG,13605,6079,7526,5378,8227,ITC,ITC3,7,Liguria,Liguria,1550640,761856,49.13,0.88
1896,2021-05-09,LIG,2825,1245,1580,1115,1710,ITC,ITC3,7,Liguria,Liguria,1550640,764681,49.31,0.18
1897,2021-01-29,LIG,3079,1064,2015,67,3012,ITC,ITC3,7,Liguria,Liguria,1550640,767760,49.51,0.2
1898,2021-04-03,LIG,5404,2497,2907,4461,943,ITC,ITC3,7,Liguria,Liguria,1550640,773164,49.86,0.35
1899,2021-01-24,LIG,756,237,519,113,643,ITC,ITC3,7,Liguria,Liguria,1550640,773920,49.91,0.05
1900,2021-02-12,LIG,1927,689,1238,895,1032,ITC,ITC3,7,Liguria,Liguria,1550640,775847,50.03,0.12
1901,2021-03-15,LIG,7207,3061,4146,4506,2701,ITC,ITC3,7,Liguria,Liguria,1550640,783054,50.5,0.46
1902,2021-02-03,LIG,2314,790,1524,55,2259,ITC,ITC3,7,Liguria,Liguria,1550640,785368,50.65,0.15
1903,2021-04-29,LIG,15550,6974,8576,6733,8817,ITC,ITC3,7,Liguria,Liguria,1550640,800918,51.65,1.0
1904,2021-04-12,LIG,12381,5475,6906,10362,2019,ITC,ITC3,7,Liguria,Liguria,1550640,813299,52.45,0.8
1905,2021-01-19,LIG,1371,438,933,1281,90,ITC,ITC3,7,Liguria,Liguria,1550640,814670,52.54,0.09
1906,2021-02-05,LIG,2673,986,1687,304,2369,ITC,ITC3,7,Liguria,Liguria,1550640,817343,52.71,0.17
1907,2021-03-24,LIG,8943,3833,5110,5657,3286,ITC,ITC3,7,Liguria,Liguria,1550640,826286,53.29,0.58
1908,2020-12-31,LIG,989,354,635,989,0,ITC,ITC3,7,Liguria,Liguria,1550640,827275,53.35,0.06
1909,2021-04-10,LIG,7882,3556,4326,6968,914,ITC,ITC3,7,Liguria,Liguria,1550640,835157,53.86,0.51
1910,2021-01-17,LIG,862,300,562,862,0,ITC,ITC3,7,Liguria,Liguria,1550640,836019,53.91,0.06
1911,2021-03-18,LIG,4981,2124,2857,2008,2973,ITC,ITC3,7,Liguria,Liguria,1550640,841000,54.24,0.32
1912,2021-04-01,LIG,12375,5467,6908,9605,2770,ITC,ITC3,7,Liguria,Liguria,1550640,853375,55.03,0.8
1913,2021-06-08,LIG,17434,8701,8733,11006,6428,ITC,ITC3,7,Liguria,Liguria,1550640,870809,56.16,1.12
1914,2021-03-17,LIG,5552,2368,3184,2473,3079,ITC,ITC3,7,Liguria,Liguria,1550640,876361,56.52,0.36
1915,2021-05-13,LIG,13024,5848,7176,8811,4213,ITC,ITC3,7,Liguria,Liguria,1550640,889385,57.36,0.84
1916,2021-02-19,LIG,3213,1305,1908,3037,176,ITC,ITC3,7,Liguria,Liguria,1550640,892598,57.56,0.21
1917,2021-05-30,LIG,3275,1603,1672,1364,1911,ITC,ITC3,7,Liguria,Liguria,1550640,895873,57.77,0.21
1918,2021-06-01,LIG,15956,7945,8011,10659,5297,ITC,ITC3,7,Liguria,Liguria,1550640,911829,58.8,1.03
1919,2021-03-10,LIG,5877,2839,3038,3971,1906,ITC,ITC3,7,Liguria,Liguria,1550640,917706,59.18,0.38
1920,2021-02-14,LIG,233,122,111,233,0,ITC,ITC3,7,Liguria,Liguria,1550640,917939,59.2,0.02
1921,2021-05-25,LIG,13718,6598,7120,10729,2989,ITC,ITC3,7,Liguria,Liguria,1550640,931657,60.08,0.88
1922,2021-03-22,LIG,7665,3401,4264,4729,2936,ITC,ITC3,7,Liguria,Liguria,1550640,939322,60.58,0.49
1923,2021-02-07,LIG,407,153,254,2,405,ITC,ITC3,7,Liguria,Liguria,1550640,939729,60.6,0.03
1924,2021-05-18,LIG,13336,6018,7318,10051,3285,ITC,ITC3,7,Liguria,Liguria,1550640,953065,61.46,0.86
1925,2021-05-06,LIG,14467,6404,8063,6167,8300,ITC,ITC3,7,Liguria,Liguria,1550640,967532,62.4,0.93
1926,2021-01-26,LIG,2491,807,1684,20,2471,ITC,ITC3,7,Liguria,Liguria,1550640,970023,62.56,0.16
1927,2021-01-20,LIG,1550,555,995,1538,12,ITC,ITC3,7,Liguria,Liguria,1550640,971573,62.66,0.1
1928,2021-04-05,LIG,3976,1751,2225,2327,1649,ITC,ITC3,7,Liguria,Liguria,1550640,975549,62.91,0.26
1929,2021-05-11,LIG,13676,6181,7495,7074,6602,ITC,ITC3,7,Liguria,Liguria,1550640,989225,63.79,0.88
1930,2021-03-29,LIG,10438,4510,5928,7308,3130,ITC,ITC3,7,Liguria,Liguria,1550640,999663,64.47,0.67
1931,2021-01-31,LIG,624,270,354,9,615,ITC,ITC3,7,Liguria,Liguria,1550640,1000287,64.51,0.04
1932,2021-05-20,LIG,12816,5941,6875,8798,4018,ITC,ITC3,7,Liguria,Liguria,1550640,1013103,65.33,0.83
1933,2021-04-06,LIG,13170,5857,7313,10930,2240,ITC,ITC3,7,Liguria,Liguria,1550640,1026273,66.18,0.85
1934,2021-02-08,LIG,1976,741,1235,306,1670,ITC,ITC3,7,Liguria,Liguria,1550640,1028249,66.31,0.13
1935,2020-12-27,LIG,135,56,79,135,0,ITC,ITC3,7,Liguria,Liguria,1550640,1028384,66.32,0.01
1936,2021-02-15,LIG,2262,839,1423,1865,397,ITC,ITC3,7,Liguria,Liguria,1550640,1030646,66.47,0.15
1937,2021-01-03,LIG,734,230,504,734,0,ITC,ITC3,7,Liguria,Liguria,1550640,1031380,66.51,0.05
1938,2021-01-07,LIG,3229,1095,2134,3229,0,ITC,ITC3,7,Liguria,Liguria,1550640,1034609,66.72,0.21
1939,2021-04-17,LIG,7383,3217,4166,6633,750,ITC,ITC3,7,Liguria,Liguria,1550640,1041992,67.2,0.48
1940,2021-05-01,LIG,7131,3253,3878,1332,5799,ITC,ITC3,7,Liguria,Liguria,1550640,1049123,67.66,0.46
1941,2021-03-05,LIG,4869,2150,2719,3737,1132,ITC,ITC3,7,Liguria,Liguria,1550640,1053992,67.97,0.31
1942,2021-06-06,LIG,3798,2030,1768,2946,852,ITC,ITC3,7,Liguria,Liguria,1550640,1057790,68.22,0.24
1943,2021-04-24,LIG,8169,3785,4384,5018,3151,ITC,ITC3,7,Liguria,Liguria,1550640,1065959,68.74,0.53
1944,2021-02-26,LIG,3764,1523,2241,3436,328,ITC,ITC3,7,Liguria,Liguria,1550640,1069723,68.99,0.24
1945,2021-03-16,FVG,3153,1287,1866,1073,2080,ITH,ITH4,6,Friuli-Venezia Giulia,Friuli Venezia Giulia,1215220,3153,0.26,0.26
1946,2021-05-12,FVG,10748,4967,5781,9393,1355,ITH,ITH4,6,Friuli-Venezia Giulia,Friuli Venezia Giulia,1215220,13901,1.14,0.88
1947,2021-05-19,FVG,11857,5802,6055,9551,2306,ITH,ITH4,6,Friuli-Venezia Giulia,Friuli Venezia Giulia,1215220,25758,2.12,0.98
1948,2021-03-14,FVG,1397,549,848,1145,252,ITH,ITH4,6,Friuli-Venezia Giulia,Friuli Venezia Giulia,1215220,27155,2.23,0.11
1949,2021-03-28,FVG,4823,2277,2546,4682,141,ITH,ITH4,6,Friuli-Venezia Giulia,Friuli Venezia Giulia,1215220,31978,2.63,0.4
1950,2021-01-18,FVG,1961,606,1355,1867,94,ITH,ITH4,6,Friuli-Venezia Giulia,Friuli Venezia Giulia,1215220,33939,2.79,0.16
1951,2021-01-04,FVG,1507,558,949,1507,0,ITH,ITH4,6,Friuli-Venezia Giulia,Friuli Venezia Giulia,1215220,35446,2.92,0.12
1952,2021-02-06,FVG,1154,338,816,22,1132,ITH,ITH4,6,Friuli-Venezia Giulia,Friuli Venezia Giulia,1215220,36600,3.01,0.09
1953,2021-02-23,FVG,2643,1277,1366,2463,180,ITH,ITH4,6,Friuli-Venezia Giulia,Friuli Venezia Giulia,1215220,39243,3.23,0.22
1954,2021-05-17,FVG,8776,4076,4700,6294,2482,ITH,ITH4,6,Friuli-Venezia Giulia,Friuli Venezia Giulia,1215220,48019,3.95,0.72
1955,2021-03-09,FVG,3861,1589,2272,1114,2747,ITH,ITH4,6,Friuli-Venezia Giulia,Friuli Venezia Giulia,1215220,51880,4.27,0.32
1956,2021-02-04,FVG,2725,808,1917,35,2690,ITH,ITH4,6,Friuli-Venezia Giulia,Friuli Venezia Giulia,1215220,54605,4.49,0.22
1957,2021-04-30,FVG,7324,3231,4093,3693,3631,ITH,ITH4,6,Friuli-Venezia Giulia,Friuli Venezia Giulia,1215220,61929,5.1,0.6
1958,2021-05-24,FVG,11093,5310,5783,7593,3500,ITH,ITH4,6,Friuli-Venezia Giulia,Friuli Venezia Giulia,1215220,73022,6.01,0.91
1959,2021-02-13,FVG,566,179,387,560,6,ITH,ITH4,6,Friuli-Venezia Giulia,Friuli Venezia Giulia,1215220,73588,6.06,0.05
1960,2021-03-02,FVG,4219,1519,2700,2720,1499,ITH,ITH4,6,Friuli-Venezia Giulia,Friuli Venezia Giulia,1215220,77807,6.4,0.35
1961,2021-03-04,FVG,3447,1595,1852,2788,659,ITH,ITH4,6,Friuli-Venezia Giulia,Friuli Venezia Giulia,1215220,81254,6.69,0.28
1962,2021-03-21,FVG,2602,937,1665,2193,409,ITH,ITH4,6,Friuli-Venezia Giulia,Friuli Venezia Giulia,1215220,83856,6.9,0.21
1963,2021-01-30,FVG,2275,745,1530,270,2005,ITH,ITH4,6,Friuli-Venezia Giulia,Friuli Venezia Giulia,1215220,86131,7.09,0.19
1964,2021-04-21,FVG,7746,3454,4292,4067,3679,ITH,ITH4,6,Friuli-Venezia Giulia,Friuli Venezia Giulia,1215220,93877,7.73,0.64
1965,2021-01-11,FVG,1882,608,1274,1882,0,ITH,ITH4,6,Friuli-Venezia Giulia,Friuli Venezia Giulia,1215220,95759,7.88,0.15
1966,2021-04-28,FVG,7260,3201,4059,3796,3464,ITH,ITH4,6,Friuli-Venezia Giulia,Friuli Venezia Giulia,1215220,103019,8.48,0.6
1967,2021-01-23,FVG,816,324,492,4,812,ITH,ITH4,6,Friuli-Venezia Giulia,Friuli Venezia Giulia,1215220,103835,8.54,0.07
1968,2021-05-05,FVG,9711,4233,5478,6270,3441,ITH,ITH4,6,Friuli-Venezia Giulia,Friuli Venezia Giulia,1215220,113546,9.34,0.8
1969,2021-01-25,FVG,1583,567,1016,194,1389,ITH,ITH4,6,Friuli-Venezia Giulia,Friuli Venezia Giulia,1215220,115129,9.47,0.13
1970,2021-03-23,FVG,3753,1559,2194,1613,2140,ITH,ITH4,6,Friuli-Venezia Giulia,Friuli Venezia Giulia,1215220,118882,9.78,0.31
1971,2021-02-18,FVG,3218,1492,1726,2811,407,ITH,ITH4,6,Friuli-Venezia Giulia,Friuli Venezia Giulia,1215220,122100,10.05,0.26
1972,2021-04-02,FVG,6566,2915,3651,4733,1833,ITH,ITH4,6,Friuli-Venezia Giulia,Friuli Venezia Giulia,1215220,128666,10.59,0.54
1973,2021-04-16,FVG,6916,2997,3919,4992,1924,ITH,ITH4,6,Friuli-Venezia Giulia,Friuli Venezia Giulia,1215220,135582,11.16,0.57
1974,2021-01-06,FVG,710,264,446,710,0,ITH,ITH4,6,Friuli-Venezia Giulia,Friuli Venezia Giulia,1215220,136292,11.22,0.06
1975,2021-04-11,FVG,3433,1520,1913,2527,906,ITH,ITH4,6,Friuli-Venezia Giulia,Friuli Venezia Giulia,1215220,139725,11.5,0.28
1976,2021-06-07,FVG,8674,4428,4246,7966,708,ITH,ITH4,6,Friuli-Venezia Giulia,Friuli Venezia Giulia,1215220,148399,12.21,0.71
1977,2021-05-31,FVG,8401,4108,4293,6376,2025,ITH,ITH4,6,Friuli-Venezia Giulia,Friuli Venezia Giulia,1215220,156800,12.9,0.69
1978,2021-02-27,FVG,3529,1200,2329,3528,1,ITH,ITH4,6,Friuli-Venezia Giulia,Friuli Venezia Giulia,1215220,160329,13.19,0.29
1979,2021-03-11,FVG,3357,1414,1943,1606,1751,ITH,ITH4,6,Friuli-Venezia Giulia,Friuli Venezia Giulia,1215220,163686,13.47,0.28
1980,2021-04-13,FVG,7363,3289,4074,5759,1604,ITH,ITH4,6,Friuli-Venezia Giulia,Friuli Venezia Giulia,1215220,171049,14.08,0.61
1981,2021-01-03,FVG,312,122,190,312,0,ITH,ITH4,6,Friuli-Venezia Giulia,Friuli Venezia Giulia,1215220,171361,14.1,0.03
1982,2021-01-20,FVG,748,320,428,13,735,ITH,ITH4,6,Friuli-Venezia Giulia,Friuli Venezia Giulia,1215220,172109,14.16,0.06
1983,2021-01-27,FVG,1272,425,847,450,822,ITH,ITH4,6,Friuli-Venezia Giulia,Friuli Venezia Giulia,1215220,173381,14.27,0.1
1984,2021-05-07,FVG,10583,4840,5743,7091,3492,ITH,ITH4,6,Friuli-Venezia Giulia,Friuli Venezia Giulia,1215220,183964,15.14,0.87
1985,2021-05-09,FVG,7350,3298,4052,3495,3855,ITH,ITH4,6,Friuli-Venezia Giulia,Friuli Venezia Giulia,1215220,191314,15.74,0.6
1986,2021-05-26,FVG,12748,6310,6438,9440,3308,ITH,ITH4,6,Friuli-Venezia Giulia,Friuli Venezia Giulia,1215220,204062,16.79,1.05
1987,2021-02-15,FVG,2453,911,1542,2201,252,ITH,ITH4,6,Friuli-Venezia Giulia,Friuli Venezia Giulia,1215220,206515,16.99,0.2
1988,2021-06-04,FVG,11321,5763,5558,10147,1174,ITH,ITH4,6,Friuli-Venezia Giulia,Friuli Venezia Giulia,1215220,217836,17.93,0.93
1989,2021-03-13,FVG,2935,1120,1815,1664,1271,ITH,ITH4,6,Friuli-Venezia Giulia,Friuli Venezia Giulia,1215220,220771,18.17,0.24
1990,2021-04-08,FVG,7213,3018,4195,5291,1922,ITH,ITH4,6,Friuli-Venezia Giulia,Friuli Venezia Giulia,1215220,227984,18.76,0.59
1991,2021-05-21,FVG,11063,4926,6137,8171,2892,ITH,ITH4,6,Friuli-Venezia Giulia,Friuli Venezia Giulia,1215220,239047,19.67,0.91
1992,2021-02-10,FVG,1352,496,856,1266,86,ITH,ITH4,6,Friuli-Venezia Giulia,Friuli Venezia Giulia,1215220,240399,19.78,0.11
1993,2021-02-01,FVG,2097,688,1409,16,2081,ITH,ITH4,6,Friuli-Venezia Giulia,Friuli Venezia Giulia,1215220,242496,19.95,0.17
1994,2021-05-14,FVG,10620,5264,5356,8134,2486,ITH,ITH4,6,Friuli-Venezia Giulia,Friuli Venezia Giulia,1215220,253116,20.83,0.87
1995,2021-02-03,FVG,2647,791,1856,23,2624,ITH,ITH4,6,Friuli-Venezia Giulia,Friuli Venezia Giulia,1215220,255763,21.05,0.22
1996,2021-04-23,FVG,7457,3376,4081,3599,3858,ITH,ITH4,6,Friuli-Venezia Giulia,Friuli Venezia Giulia,1215220,263220,21.66,0.61
1997,2021-06-09,FVG,4427,2221,2206,4217,210,ITH,ITH4,6,Friuli-Venezia Giulia,Friuli Venezia Giulia,1215220,267647,22.02,0.36
1998,2021-03-01,FVG,2957,1041,1916,2905,52,ITH,ITH4,6,Friuli-Venezia Giulia,Friuli Venezia Giulia,1215220,270604,22.27,0.24
1999,2021-03-18,FVG,3372,1421,1951,1691,1681,ITH,ITH4,6,Friuli-Venezia Giulia,Friuli Venezia Giulia,1215220,273976,22.55,0.28
2000,2021-03-20,FVG,3341,1352,1989,1250,2091,ITH,ITH4,6,Friuli-Venezia Giulia,Friuli Venezia Giulia,1215220,277317,22.82,0.27
2001,2021-01-13,FVG,2650,834,1816,2650,0,ITH,ITH4,6,Friuli-Venezia Giulia,Friuli Venezia Giulia,1215220,279967,23.04,0.22
2002,2021-04-06,FVG,6279,2772,3507,5129,1150,ITH,ITH4,6,Friuli-Venezia Giulia,Friuli Venezia Giulia,1215220,286246,23.56,0.52
2003,2021-04-25,FVG,2363,990,1373,2352,11,ITH,ITH4,6,Friuli-Venezia Giulia,Friuli Venezia Giulia,1215220,288609,23.75,0.19
2004,2021-01-15,FVG,2021,605,1416,2021,0,ITH,ITH4,6,Friuli-Venezia Giulia,Friuli Venezia Giulia,1215220,290630,23.92,0.17
2005,2021-04-18,FVG,6038,2799,3239,5631,407,ITH,ITH4,6,Friuli-Venezia Giulia,Friuli Venezia Giulia,1215220,296668,24.41,0.5
2006,2021-01-08,FVG,2322,747,1575,2322,0,ITH,ITH4,6,Friuli-Venezia Giulia,Friuli Venezia Giulia,1215220,298990,24.6,0.19
2007,2021-02-20,FVG,2068,933,1135,1924,144,ITH,ITH4,6,Friuli-Venezia Giulia,Friuli Venezia Giulia,1215220,301058,24.77,0.17
2008,2021-01-22,FVG,90,30,60,0,90,ITH,ITH4,6,Friuli-Venezia Giulia,Friuli Venezia Giulia,1215220,301148,24.78,0.01
2009,2021-03-06,FVG,3500,1196,2304,3175,325,ITH,ITH4,6,Friuli-Venezia Giulia,Friuli Venezia Giulia,1215220,304648,25.07,0.29
2010,2021-01-16,FVG,1230,360,870,1230,0,ITH,ITH4,6,Friuli-Venezia Giulia,Friuli Venezia Giulia,1215220,305878,25.17,0.1
2011,2021-03-25,FVG,5314,2263,3051,3181,2133,ITH,ITH4,6,Friuli-Venezia Giulia,Friuli Venezia Giulia,1215220,311192,25.61,0.44
2012,2021-03-30,FVG,7094,3141,3953,6171,923,ITH,ITH4,6,Friuli-Venezia Giulia,Friuli Venezia Giulia,1215220,318286,26.19,0.58
2013,2021-04-01,FVG,6319,2996,3323,5304,1015,ITH,ITH4,6,Friuli-Venezia Giulia,Friuli Venezia Giulia,1215220,324605,26.71,0.52
2014,2021-05-28,FVG,9915,4593,5322,5952,3963,ITH,ITH4,6,Friuli-Venezia Giulia,Friuli Venezia Giulia,1215220,334520,27.53,0.82
2015,2021-02-11,FVG,1930,664,1266,1738,192,ITH,ITH4,6,Friuli-Venezia Giulia,Friuli Venezia Giulia,1215220,336450,27.69,0.16
2016,2021-04-09,FVG,7763,3528,4235,6519,1244,ITH,ITH4,6,Friuli-Venezia Giulia,Friuli Venezia Giulia,1215220,344213,28.33,0.64
2017,2020-12-30,FVG,626,244,382,626,0,ITH,ITH4,6,Friuli-Venezia Giulia,Friuli Venezia Giulia,1215220,344839,28.38,0.05
2018,2021-06-05,FVG,10193,5272,4921,8677,1516,ITH,ITH4,6,Friuli-Venezia Giulia,Friuli Venezia Giulia,1215220,355032,29.22,0.84
2019,2021-02-25,FVG,3164,1651,1513,3135,29,ITH,ITH4,6,Friuli-Venezia Giulia,Friuli Venezia Giulia,1215220,358196,29.48,0.26
2020,2021-04-27,FVG,8080,3704,4376,3622,4458,ITH,ITH4,6,Friuli-Venezia Giulia,Friuli Venezia Giulia,1215220,366276,30.14,0.66
2021,2021-02-22,FVG,2485,1193,1292,2067,418,ITH,ITH4,6,Friuli-Venezia Giulia,Friuli Venezia Giulia,1215220,368761,30.35,0.2
2022,2021-06-02,FVG,9389,4944,4445,9116,273,ITH,ITH4,6,Friuli-Venezia Giulia,Friuli Venezia Giulia,1215220,378150,31.12,0.77
2023,2021-02-07,FVG,1562,483,1079,385,1177,ITH,ITH4,6,Friuli-Venezia Giulia,Friuli Venezia Giulia,1215220,379712,31.25,0.13
2024,2021-05-18,FVG,10585,5281,5304,8567,2018,ITH,ITH4,6,Friuli-Venezia Giulia,Friuli Venezia Giulia,1215220,390297,32.12,0.87
2025,2021-06-01,FVG,9771,4877,4894,7692,2079,ITH,ITH4,6,Friuli-Venezia Giulia,Friuli Venezia Giulia,1215220,400068,32.92,0.8
2026,2021-03-29,FVG,6875,3001,3874,5296,1579,ITH,ITH4,6,Friuli-Venezia Giulia,Friuli Venezia Giulia,1215220,406943,33.49,0.57
2027,2021-05-02,FVG,6838,3210,3628,3939,2899,ITH,ITH4,6,Friuli-Venezia Giulia,Friuli Venezia Giulia,1215220,413781,34.05,0.56
2028,2021-05-16,FVG,9943,4762,5181,8546,1397,ITH,ITH4,6,Friuli-Venezia Giulia,Friuli Venezia Giulia,1215220,423724,34.87,0.82
2029,2021-03-10,FVG,3358,1493,1865,1566,1792,ITH,ITH4,6,Friuli-Venezia Giulia,Friuli Venezia Giulia,1215220,427082,35.14,0.28
2030,2021-02-24,FVG,2521,1085,1436,2503,18,ITH,ITH4,6,Friuli-Venezia Giulia,Friuli Venezia Giulia,1215220,429603,35.35,0.21
2031,2021-03-27,FVG,4987,2562,2425,3576,1411,ITH,ITH4,6,Friuli-Venezia Giulia,Friuli Venezia Giulia,1215220,434590,35.76,0.41
2032,2020-12-27,FVG,262,149,113,262,0,ITH,ITH4,6,Friuli-Venezia Giulia,Friuli Venezia Giulia,1215220,434852,35.78,0.02
2033,2021-02-12,FVG,1193,428,765,1146,47,ITH,ITH4,6,Friuli-Venezia Giulia,Friuli Venezia Giulia,1215220,436045,35.88,0.1
2034,2021-05-25,FVG,12476,6077,6399,9285,3191,ITH,ITH4,6,Friuli-Venezia Giulia,Friuli Venezia Giulia,1215220,448521,36.91,1.03
2035,2021-03-03,FVG,3638,1627,2011,2365,1273,ITH,ITH4,6,Friuli-Venezia Giulia,Friuli Venezia Giulia,1215220,452159,37.21,0.3
2036,2021-02-08,FVG,2357,694,1663,92,2265,ITH,ITH4,6,Friuli-Venezia Giulia,Friuli Venezia Giulia,1215220,454516,37.4,0.19
2037,2021-04-17,FVG,7449,3232,4217,5966,1483,ITH,ITH4,6,Friuli-Venezia Giulia,Friuli Venezia Giulia,1215220,461965,38.01,0.61
2038,2021-04-10,FVG,4986,2164,2822,3761,1225,ITH,ITH4,6,Friuli-Venezia Giulia,Friuli Venezia Giulia,1215220,466951,38.43,0.41
2039,2021-05-23,FVG,10263,4851,5412,6115,4148,ITH,ITH4,6,Friuli-Venezia Giulia,Friuli Venezia Giulia,1215220,477214,39.27,0.84
2040,2021-04-20,FVG,7107,3059,4048,3204,3903,ITH,ITH4,6,Friuli-Venezia Giulia,Friuli Venezia Giulia,1215220,484321,39.85,0.58
2041,2021-01-10,FVG,2939,918,2021,2939,0,ITH,ITH4,6,Friuli-Venezia Giulia,Friuli Venezia Giulia,1215220,487260,40.1,0.24
2042,2021-04-05,FVG,2868,1425,1443,2853,15,ITH,ITH4,6,Friuli-Venezia Giulia,Friuli Venezia Giulia,1215220,490128,40.33,0.24
2043,2021-01-12,FVG,2260,713,1547,2260,0,ITH,ITH4,6,Friuli-Venezia Giulia,Friuli Venezia Giulia,1215220,492388,40.52,0.19
2044,2021-01-29,FVG,2414,814,1600,264,2150,ITH,ITH4,6,Friuli-Venezia Giulia,Friuli Venezia Giulia,1215220,494802,40.72,0.2
2045,2021-04-22,FVG,6771,3079,3692,3084,3687,ITH,ITH4,6,Friuli-Venezia Giulia,Friuli Venezia Giulia,1215220,501573,41.27,0.56
2046,2021-05-06,FVG,11868,5513,6355,7915,3953,ITH,ITH4,6,Friuli-Venezia Giulia,Friuli Venezia Giulia,1215220,513441,42.25,0.98
2047,2021-03-17,FVG,3234,1266,1968,744,2490,ITH,ITH4,6,Friuli-Venezia Giulia,Friuli Venezia Giulia,1215220,516675,42.52,0.27
2048,2021-05-13,FVG,11028,5305,5723,9009,2019,ITH,ITH4,6,Friuli-Venezia Giulia,Friuli Venezia Giulia,1215220,527703,43.42,0.91
2049,2021-02-16,FVG,2516,1135,1381,2400,116,ITH,ITH4,6,Friuli-Venezia Giulia,Friuli Venezia Giulia,1215220,530219,43.63,0.21
2050,2021-03-24,FVG,3766,1530,2236,2286,1480,ITH,ITH4,6,Friuli-Venezia Giulia,Friuli Venezia Giulia,1215220,533985,43.94,0.31
2051,2021-05-20,FVG,12544,6189,6355,10118,2426,ITH,ITH4,6,Friuli-Venezia Giulia,Friuli Venezia Giulia,1215220,546529,44.97,1.03
2052,2021-01-26,FVG,1977,647,1330,217,1760,ITH,ITH4,6,Friuli-Venezia Giulia,Friuli Venezia Giulia,1215220,548506,45.14,0.16
2053,2021-02-09,FVG,1842,555,1287,1556,286,ITH,ITH4,6,Friuli-Venezia Giulia,Friuli Venezia Giulia,1215220,550348,45.29,0.15
2054,2021-02-19,FVG,3252,1290,1962,2825,427,ITH,ITH4,6,Friuli-Venezia Giulia,Friuli Venezia Giulia,1215220,553600,45.56,0.27
2055,2021-04-24,FVG,6673,2944,3729,5431,1242,ITH,ITH4,6,Friuli-Venezia Giulia,Friuli Venezia Giulia,1215220,560273,46.1,0.55
2056,2021-06-06,FVG,9374,4574,4800,7856,1518,ITH,ITH4,6,Friuli-Venezia Giulia,Friuli Venezia Giulia,1215220,569647,46.88,0.77
2057,2021-02-26,FVG,3736,2093,1643,3588,148,ITH,ITH4,6,Friuli-Venezia Giulia,Friuli Venezia Giulia,1215220,573383,47.18,0.31
2058,2021-02-17,FVG,2353,999,1354,1873,480,ITH,ITH4,6,Friuli-Venezia Giulia,Friuli Venezia Giulia,1215220,575736,47.38,0.19
2059,2021-05-15,FVG,12606,6078,6528,7923,4683,ITH,ITH4,6,Friuli-Venezia Giulia,Friuli Venezia Giulia,1215220,588342,48.41,1.04
2060,2021-05-01,FVG,7186,3244,3942,6143,1043,ITH,ITH4,6,Friuli-Venezia Giulia,Friuli Venezia Giulia,1215220,595528,49.01,0.59
2061,2021-01-21,FVG,896,345,551,1,895,ITH,ITH4,6,Friuli-Venezia Giulia,Friuli Venezia Giulia,1215220,596424,49.08,0.07
2062,2021-02-21,FVG,801,281,520,423,378,ITH,ITH4,6,Friuli-Venezia Giulia,Friuli Venezia Giulia,1215220,597225,49.15,0.07
2063,2021-03-26,FVG,5804,2428,3376,3790,2014,ITH,ITH4,6,Friuli-Venezia Giulia,Friuli Venezia Giulia,1215220,603029,49.62,0.48
2064,2021-03-12,FVG,3939,1545,2394,2558,1381,ITH,ITH4,6,Friuli-Venezia Giulia,Friuli Venezia Giulia,1215220,606968,49.95,0.32
2065,2021-01-02,FVG,1216,470,746,1216,0,ITH,ITH4,6,Friuli-Venezia Giulia,Friuli Venezia Giulia,1215220,608184,50.05,0.1
2066,2021-04-12,FVG,7255,3181,4074,6124,1131,ITH,ITH4,6,Friuli-Venezia Giulia,Friuli Venezia Giulia,1215220,615439,50.64,0.6
2067,2021-05-27,FVG,12324,5809,6515,7204,5120,ITH,ITH4,6,Friuli-Venezia Giulia,Friuli Venezia Giulia,1215220,627763,51.66,1.01
2068,2021-01-28,FVG,2239,794,1445,354,1885,ITH,ITH4,6,Friuli-Venezia Giulia,Friuli Venezia Giulia,1215220,630002,51.84,0.18
2069,2021-05-08,FVG,10261,4637,5624,5483,4778,ITH,ITH4,6,Friuli-Venezia Giulia,Friuli Venezia Giulia,1215220,640263,52.69,0.84
2070,2021-05-10,FVG,7914,3515,4399,6375,1539,ITH,ITH4,6,Friuli-Venezia Giulia,Friuli Venezia Giulia,1215220,648177,53.34,0.65
2071,2021-04-15,FVG,6488,2860,3628,5217,1271,ITH,ITH4,6,Friuli-Venezia Giulia,Friuli Venezia Giulia,1215220,654665,53.87,0.53
2072,2021-04-29,FVG,6697,2939,3758,4164,2533,ITH,ITH4,6,Friuli-Venezia Giulia,Friuli Venezia Giulia,1215220,661362,54.42,0.55
2073,2021-01-05,FVG,1678,551,1127,1678,0,ITH,ITH4,6,Friuli-Venezia Giulia,Friuli Venezia Giulia,1215220,663040,54.56,0.14
2074,2021-02-05,FVG,2614,785,1829,90,2524,ITH,ITH4,6,Friuli-Venezia Giulia,Friuli Venezia Giulia,1215220,665654,54.78,0.22
2075,2021-04-14,FVG,7215,3118,4097,5503,1712,ITH,ITH4,6,Friuli-Venezia Giulia,Friuli Venezia Giulia,1215220,672869,55.37,0.59
2076,2021-06-03,FVG,11462,6150,5312,9610,1852,ITH,ITH4,6,Friuli-Venezia Giulia,Friuli Venezia Giulia,1215220,684331,56.31,0.94
2077,2021-04-03,FVG,3982,1968,2014,2654,1328,ITH,ITH4,6,Friuli-Venezia Giulia,Friuli Venezia Giulia,1215220,688313,56.64,0.33
2078,2021-03-19,FVG,3235,1340,1895,1302,1933,ITH,ITH4,6,Friuli-Venezia Giulia,Friuli Venezia Giulia,1215220,691548,56.91,0.27
2079,2021-04-07,FVG,7500,3325,4175,6719,781,ITH,ITH4,6,Friuli-Venezia Giulia,Friuli Venezia Giulia,1215220,699048,57.52,0.62
2080,2021-02-02,FVG,2467,806,1661,217,2250,ITH,ITH4,6,Friuli-Venezia Giulia,Friuli Venezia Giulia,1215220,701515,57.73,0.2
2081,2021-03-31,FVG,8035,3504,4531,7189,846,ITH,ITH4,6,Friuli-Venezia Giulia,Friuli Venezia Giulia,1215220,709550,58.39,0.66
2082,2021-01-07,FVG,2091,717,1374,2091,0,ITH,ITH4,6,Friuli-Venezia Giulia,Friuli Venezia Giulia,1215220,711641,58.56,0.17
2083,2021-03-05,FVG,3736,1478,2258,2663,1073,ITH,ITH4,6,Friuli-Venezia Giulia,Friuli Venezia Giulia,1215220,715377,58.87,0.31
2084,2021-04-19,FVG,6706,3131,3575,3293,3413,ITH,ITH4,6,Friuli-Venezia Giulia,Friuli Venezia Giulia,1215220,722083,59.42,0.55
2085,2021-01-09,FVG,2513,841,1672,2513,0,ITH,ITH4,6,Friuli-Venezia Giulia,Friuli Venezia Giulia,1215220,724596,59.63,0.21
2086,2021-03-07,FVG,2547,932,1615,2546,1,ITH,ITH4,6,Friuli-Venezia Giulia,Friuli Venezia Giulia,1215220,727143,59.84,0.21
2087,2020-12-31,FVG,1053,384,669,1053,0,ITH,ITH4,6,Friuli-Venezia Giulia,Friuli Venezia Giulia,1215220,728196,59.92,0.09
2088,2021-01-19,FVG,6,2,4,6,0,ITH,ITH4,6,Friuli-Venezia Giulia,Friuli Venezia Giulia,1215220,728202,59.92,0.0
2089,2021-05-30,FVG,11050,4985,6065,7466,3584,ITH,ITH4,6,Friuli-Venezia Giulia,Friuli Venezia Giulia,1215220,739252,60.83,0.91
2090,2021-05-03,FVG,7198,3276,3922,3419,3779,ITH,ITH4,6,Friuli-Venezia Giulia,Friuli Venezia Giulia,1215220,746450,61.43,0.59
2091,2021-01-14,FVG,2584,789,1795,2584,0,ITH,ITH4,6,Friuli-Venezia Giulia,Friuli Venezia Giulia,1215220,749034,61.64,0.21
2092,2021-06-08,FVG,9562,4958,4604,9320,242,ITH,ITH4,6,Friuli-Venezia Giulia,Friuli Venezia Giulia,1215220,758596,62.42,0.79
2093,2021-02-28,FVG,2685,1002,1683,2292,393,ITH,ITH4,6,Friuli-Venezia Giulia,Friuli Venezia Giulia,1215220,761281,62.65,0.22
2094,2021-04-26,FVG,5457,2449,3008,3808,1649,ITH,ITH4,6,Friuli-Venezia Giulia,Friuli Venezia Giulia,1215220,766738,63.09,0.45
2095,2021-05-04,FVG,9516,4291,5225,6162,3354,ITH,ITH4,6,Friuli-Venezia Giulia,Friuli Venezia Giulia,1215220,776254,63.88,0.78
2096,2021-01-24,FVG,305,119,186,1,304,ITH,ITH4,6,Friuli-Venezia Giulia,Friuli Venezia Giulia,1215220,776559,63.9,0.03
2097,2021-03-08,FVG,4063,1593,2470,1978,2085,ITH,ITH4,6,Friuli-Venezia Giulia,Friuli Venezia Giulia,1215220,780622,64.24,0.33
2098,2021-03-22,FVG,3540,1343,2197,1586,1954,ITH,ITH4,6,Friuli-Venezia Giulia,Friuli Venezia Giulia,1215220,784162,64.53,0.29
2099,2021-01-17,FVG,1716,523,1193,1716,0,ITH,ITH4,6,Friuli-Venezia Giulia,Friuli Venezia Giulia,1215220,785878,64.67,0.14
2100,2021-03-15,FVG,3767,1637,2130,1446,2321,ITH,ITH4,6,Friuli-Venezia Giulia,Friuli Venezia Giulia,1215220,789645,64.98,0.31
2101,2021-05-11,FVG,8998,4318,4680,7201,1797,ITH,ITH4,6,Friuli-Venezia Giulia,Friuli Venezia Giulia,1215220,798643,65.72,0.74
2102,2021-01-31,FVG,2715,836,1879,385,2330,ITH,ITH4,6,Friuli-Venezia Giulia,Friuli Venezia Giulia,1215220,801358,65.94,0.22
2103,2021-05-29,FVG,11980,5825,6155,7015,4965,ITH,ITH4,6,Friuli-Venezia Giulia,Friuli Venezia Giulia,1215220,813338,66.93,0.99
2104,2021-05-22,FVG,11510,5168,6342,7287,4223,ITH,ITH4,6,Friuli-Venezia Giulia,Friuli Venezia Giulia,1215220,824848,67.88,0.95
2105,2021-02-25,VEN,7899,3339,4560,7294,605,ITH,ITH3,5,Veneto,Veneto,4905854,7899,0.16,0.16
2106,2021-04-09,VEN,31100,13694,17406,22763,8337,ITH,ITH3,5,Veneto,Veneto,4905854,38999,0.79,0.63
2107,2021-06-05,VEN,46497,23910,22587,38603,7894,ITH,ITH3,5,Veneto,Veneto,4905854,85496,1.74,0.95
2108,2021-01-11,VEN,7239,2102,5137,7239,0,ITH,ITH3,5,Veneto,Veneto,4905854,92735,1.89,0.15
2109,2021-04-21,VEN,32313,13174,19139,16250,16063,ITH,ITH3,5,Veneto,Veneto,4905854,125048,2.55,0.66
2110,2021-05-22,VEN,34722,16658,18064,13331,21391,ITH,ITH3,5,Veneto,Veneto,4905854,159770,3.26,0.71
2111,2021-02-11,VEN,4012,1238,2774,3384,628,ITH,ITH3,5,Veneto,Veneto,4905854,163782,3.34,0.08
2112,2021-01-28,VEN,9209,2662,6547,173,9036,ITH,ITH3,5,Veneto,Veneto,4905854,172991,3.53,0.19
2113,2021-03-02,VEN,11483,4622,6861,8176,3307,ITH,ITH3,5,Veneto,Veneto,4905854,184474,3.76,0.23
2114,2021-04-04,VEN,7775,3531,4244,6624,1151,ITH,ITH3,5,Veneto,Veneto,4905854,192249,3.92,0.16
2115,2021-05-24,VEN,32717,16152,16565,7752,24965,ITH,ITH3,5,Veneto,Veneto,4905854,224966,4.59,0.67
2116,2021-01-09,VEN,7927,2539,5388,7927,0,ITH,ITH3,5,Veneto,Veneto,4905854,232893,4.75,0.16
2117,2021-03-09,VEN,16465,7381,9084,10143,6322,ITH,ITH3,5,Veneto,Veneto,4905854,249358,5.08,0.34
2118,2021-05-31,VEN,31378,16043,15335,21659,9719,ITH,ITH3,5,Veneto,Veneto,4905854,280736,5.72,0.64
2119,2021-03-26,VEN,29539,13117,16422,24072,5467,ITH,ITH3,5,Veneto,Veneto,4905854,310275,6.32,0.6
2120,2021-03-28,VEN,31237,13580,17657,27618,3619,ITH,ITH3,5,Veneto,Veneto,4905854,341512,6.96,0.64
2121,2021-04-14,VEN,15883,6883,9000,9258,6625,ITH,ITH3,5,Veneto,Veneto,4905854,357395,7.29,0.32
2122,2021-01-04,VEN,6735,2033,4702,6735,0,ITH,ITH3,5,Veneto,Veneto,4905854,364130,7.42,0.14
2123,2021-05-17,VEN,26440,12962,13478,16442,9998,ITH,ITH3,5,Veneto,Veneto,4905854,390570,7.96,0.54
2124,2021-02-06,VEN,4095,1354,2741,709,3386,ITH,ITH3,5,Veneto,Veneto,4905854,394665,8.04,0.08
2125,2021-02-23,VEN,7376,3251,4125,7106,270,ITH,ITH3,5,Veneto,Veneto,4905854,402041,8.2,0.15
2126,2021-04-28,VEN,32376,15161,17215,23355,9021,ITH,ITH3,5,Veneto,Veneto,4905854,434417,8.86,0.66
2127,2021-01-18,VEN,2762,776,1986,2563,199,ITH,ITH3,5,Veneto,Veneto,4905854,437179,8.91,0.06
2128,2021-02-04,VEN,7386,2025,5361,553,6833,ITH,ITH3,5,Veneto,Veneto,4905854,444565,9.06,0.15
2129,2021-04-23,VEN,31167,13805,17362,22465,8702,ITH,ITH3,5,Veneto,Veneto,4905854,475732,9.7,0.64
2130,2021-02-16,VEN,6642,2871,3771,6465,177,ITH,ITH3,5,Veneto,Veneto,4905854,482374,9.83,0.14
2131,2021-05-29,VEN,32657,16496,16161,25270,7387,ITH,ITH3,5,Veneto,Veneto,4905854,515031,10.5,0.67
2132,2021-02-18,VEN,5828,2455,3373,5764,64,ITH,ITH3,5,Veneto,Veneto,4905854,520859,10.62,0.12
2133,2021-01-23,VEN,4050,1246,2804,31,4019,ITH,ITH3,5,Veneto,Veneto,4905854,524909,10.7,0.08
2134,2021-03-21,VEN,11983,4754,7229,8521,3462,ITH,ITH3,5,Veneto,Veneto,4905854,536892,10.94,0.24
2135,2021-01-16,VEN,4611,1542,3069,4611,0,ITH,ITH3,5,Veneto,Veneto,4905854,541503,11.04,0.09
2136,2021-03-14,VEN,15172,5939,9233,14278,894,ITH,ITH3,5,Veneto,Veneto,4905854,556675,11.35,0.31
2137,2021-05-10,VEN,36414,17022,19392,26537,9877,ITH,ITH3,5,Veneto,Veneto,4905854,593089,12.09,0.74
2138,2021-01-30,VEN,8747,2672,6075,693,8054,ITH,ITH3,5,Veneto,Veneto,4905854,601836,12.27,0.18
2139,2021-05-05,VEN,44178,21177,23001,37615,6563,ITH,ITH3,5,Veneto,Veneto,4905854,646014,13.17,0.9
2140,2021-05-12,VEN,36582,17709,18873,31490,5092,ITH,ITH3,5,Veneto,Veneto,4905854,682596,13.91,0.75
2141,2021-03-16,VEN,12517,5348,7169,6902,5615,ITH,ITH3,5,Veneto,Veneto,4905854,695113,14.17,0.26
2142,2021-03-18,VEN,12610,5136,7474,7384,5226,ITH,ITH3,5,Veneto,Veneto,4905854,707723,14.43,0.26
2143,2021-05-07,VEN,48296,23159,25137,39643,8653,ITH,ITH3,5,Veneto,Veneto,4905854,756019,15.41,0.98
2144,2021-01-27,VEN,7138,2062,5076,241,6897,ITH,ITH3,5,Veneto,Veneto,4905854,763157,15.56,0.15
2145,2021-02-13,VEN,3266,1473,1793,3246,20,ITH,ITH3,5,Veneto,Veneto,4905854,766423,15.62,0.07
2146,2021-05-14,VEN,46430,22070,24360,25698,20732,ITH,ITH3,5,Veneto,Veneto,4905854,812853,16.57,0.95
2147,2021-02-20,VEN,6424,2014,4410,6353,71,ITH,ITH3,5,Veneto,Veneto,4905854,819277,16.7,0.13
2148,2021-06-02,VEN,20298,10231,10067,15952,4346,ITH,ITH3,5,Veneto,Veneto,4905854,839575,17.11,0.41
2149,2021-03-11,VEN,19707,8779,10928,14138,5569,ITH,ITH3,5,Veneto,Veneto,4905854,859282,17.52,0.4
2150,2021-04-02,VEN,23985,10554,13431,17655,6330,ITH,ITH3,5,Veneto,Veneto,4905854,883267,18.0,0.49
2151,2021-06-09,VEN,28048,14142,13906,23125,4923,ITH,ITH3,5,Veneto,Veneto,4905854,911315,18.58,0.57
2152,2021-01-25,VEN,6468,2075,4393,159,6309,ITH,ITH3,5,Veneto,Veneto,4905854,917783,18.71,0.13
2153,2021-04-20,VEN,22410,9487,12923,8412,13998,ITH,ITH3,5,Veneto,Veneto,4905854,940193,19.16,0.46
2154,2021-05-09,VEN,34997,16087,18910,24936,10061,ITH,ITH3,5,Veneto,Veneto,4905854,975190,19.88,0.71
2155,2021-05-02,VEN,37238,17263,19975,26903,10335,ITH,ITH3,5,Veneto,Veneto,4905854,1012428,20.64,0.76
2156,2021-03-06,VEN,10627,4316,6311,7365,3262,ITH,ITH3,5,Veneto,Veneto,4905854,1023055,20.85,0.22
2157,2020-12-30,VEN,699,245,454,699,0,ITH,ITH3,5,Veneto,Veneto,4905854,1023754,20.87,0.01
2158,2021-06-07,VEN,44128,22993,21135,37300,6828,ITH,ITH3,5,Veneto,Veneto,4905854,1067882,21.77,0.9
2159,2021-02-27,VEN,8988,2691,6297,8141,847,ITH,ITH3,5,Veneto,Veneto,4905854,1076870,21.95,0.18
2160,2021-04-30,VEN,49964,23467,26497,34312,15652,ITH,ITH3,5,Veneto,Veneto,4905854,1126834,22.97,1.02
2161,2021-01-20,VEN,1038,368,670,386,652,ITH,ITH3,5,Veneto,Veneto,4905854,1127872,22.99,0.02
2162,2021-01-01,VEN,1528,471,1057,1528,0,ITH,ITH3,5,Veneto,Veneto,4905854,1129400,23.02,0.03
2163,2021-03-25,VEN,25856,10970,14886,19750,6106,ITH,ITH3,5,Veneto,Veneto,4905854,1155256,23.55,0.53
2164,2021-04-11,VEN,21002,8873,12129,14695,6307,ITH,ITH3,5,Veneto,Veneto,4905854,1176258,23.98,0.43
2165,2021-04-13,VEN,14020,6320,7700,8535,5485,ITH,ITH3,5,Veneto,Veneto,4905854,1190278,24.26,0.29
2166,2021-03-23,VEN,22149,10187,11962,17430,4719,ITH,ITH3,5,Veneto,Veneto,4905854,1212427,24.71,0.45
2167,2021-05-19,VEN,32698,14978,17720,16860,15838,ITH,ITH3,5,Veneto,Veneto,4905854,1245125,25.38,0.67
2168,2021-02-08,VEN,4976,1541,3435,1929,3047,ITH,ITH3,5,Veneto,Veneto,4905854,1250101,25.48,0.1
2169,2021-04-06,VEN,28879,13277,15602,23811,5068,ITH,ITH3,5,Veneto,Veneto,4905854,1278980,26.07,0.59
2170,2021-02-01,VEN,8560,2502,6058,161,8399,ITH,ITH3,5,Veneto,Veneto,4905854,1287540,26.24,0.17
2171,2021-02-15,VEN,4389,1824,2565,4149,240,ITH,ITH3,5,Veneto,Veneto,4905854,1291929,26.33,0.09
2172,2021-03-30,VEN,35890,15241,20649,30640,5250,ITH,ITH3,5,Veneto,Veneto,4905854,1327819,27.07,0.73
2173,2021-04-16,VEN,24419,10481,13938,12538,11881,ITH,ITH3,5,Veneto,Veneto,4905854,1352238,27.56,0.5
2174,2021-04-18,VEN,17511,7252,10259,9944,7567,ITH,ITH3,5,Veneto,Veneto,4905854,1369749,27.92,0.36
2175,2021-01-08,VEN,9405,2835,6570,9405,0,ITH,ITH3,5,Veneto,Veneto,4905854,1379154,28.11,0.19
2176,2021-01-13,VEN,5985,1606,4379,5985,0,ITH,ITH3,5,Veneto,Veneto,4905854,1385139,28.23,0.12
2177,2021-04-25,VEN,18316,8148,10168,13480,4836,ITH,ITH3,5,Veneto,Veneto,4905854,1403455,28.61,0.37
2178,2021-03-07,VEN,4475,1756,2719,3914,561,ITH,ITH3,5,Veneto,Veneto,4905854,1407930,28.7,0.09
2179,2021-05-03,VEN,40611,19771,20840,34180,6431,ITH,ITH3,5,Veneto,Veneto,4905854,1448541,29.53,0.83
2180,2021-05-28,VEN,46013,22507,23506,24768,21245,ITH,ITH3,5,Veneto,Veneto,4905854,1494554,30.46,0.94
2181,2021-05-21,VEN,44622,21939,22683,20907,23715,ITH,ITH3,5,Veneto,Veneto,4905854,1539176,31.37,0.91
2182,2021-03-03,VEN,12044,4597,7447,8546,3498,ITH,ITH3,5,Veneto,Veneto,4905854,1551220,31.62,0.25
2183,2021-04-22,VEN,31925,13897,18028,16185,15740,ITH,ITH3,5,Veneto,Veneto,4905854,1583145,32.27,0.65
2184,2021-05-26,VEN,30731,14964,15767,14464,16267,ITH,ITH3,5,Veneto,Veneto,4905854,1613876,32.9,0.63
2185,2021-03-01,VEN,9394,3716,5678,7572,1822,ITH,ITH3,5,Veneto,Veneto,4905854,1623270,33.09,0.19
2186,2021-04-03,VEN,21941,9624,12317,14226,7715,ITH,ITH3,5,Veneto,Veneto,4905854,1645211,33.54,0.45
2187,2021-03-20,VEN,12937,5337,7600,10853,2084,ITH,ITH3,5,Veneto,Veneto,4905854,1658148,33.8,0.26
2188,2021-01-03,VEN,5157,1562,3595,5157,0,ITH,ITH3,5,Veneto,Veneto,4905854,1663305,33.9,0.11
2189,2021-03-08,VEN,13548,6193,7355,9479,4069,ITH,ITH3,5,Veneto,Veneto,4905854,1676853,34.18,0.28
2190,2021-03-04,VEN,12921,4830,8091,9449,3472,ITH,ITH3,5,Veneto,Veneto,4905854,1689774,34.44,0.26
2191,2021-05-11,VEN,33032,16450,16582,28320,4712,ITH,ITH3,5,Veneto,Veneto,4905854,1722806,35.12,0.67
2192,2021-01-22,VEN,1080,332,748,25,1055,ITH,ITH3,5,Veneto,Veneto,4905854,1723886,35.14,0.02
2193,2021-05-04,VEN,42835,20288,22547,34806,8029,ITH,ITH3,5,Veneto,Veneto,4905854,1766721,36.01,0.87
2194,2021-04-27,VEN,28113,12748,15365,21196,6917,ITH,ITH3,5,Veneto,Veneto,4905854,1794834,36.59,0.57
2195,2021-01-17,VEN,1933,781,1152,1584,349,ITH,ITH3,5,Veneto,Veneto,4905854,1796767,36.62,0.04
2196,2021-02-03,VEN,5943,1665,4278,480,5463,ITH,ITH3,5,Veneto,Veneto,4905854,1802710,36.75,0.12
2197,2021-04-29,VEN,50204,23356,26848,37023,13181,ITH,ITH3,5,Veneto,Veneto,4905854,1852914,37.77,1.02
2198,2021-02-05,VEN,8373,2535,5838,1415,6958,ITH,ITH3,5,Veneto,Veneto,4905854,1861287,37.94,0.17
2199,2021-02-22,VEN,7013,3040,3973,6626,387,ITH,ITH3,5,Veneto,Veneto,4905854,1868300,38.08,0.14
2200,2021-05-16,VEN,28404,14005,14399,21322,7082,ITH,ITH3,5,Veneto,Veneto,4905854,1896704,38.66,0.58
2201,2021-04-10,VEN,27444,11971,15473,18964,8480,ITH,ITH3,5,Veneto,Veneto,4905854,1924148,39.22,0.56
2202,2021-06-06,VEN,37238,19077,18161,32563,4675,ITH,ITH3,5,Veneto,Veneto,4905854,1961386,39.98,0.76
2203,2020-12-27,VEN,880,395,485,880,0,ITH,ITH3,5,Veneto,Veneto,4905854,1962266,40.0,0.02
2204,2021-05-30,VEN,22527,11262,11265,15842,6685,ITH,ITH3,5,Veneto,Veneto,4905854,1984793,40.46,0.46
2205,2021-02-26,VEN,8295,3271,5024,7038,1257,ITH,ITH3,5,Veneto,Veneto,4905854,1993088,40.63,0.17
2206,2021-04-24,VEN,24743,10819,13924,15664,9079,ITH,ITH3,5,Veneto,Veneto,4905854,2017831,41.13,0.5
2207,2021-01-14,VEN,7064,1925,5139,7064,0,ITH,ITH3,5,Veneto,Veneto,4905854,2024895,41.28,0.14
2208,2021-03-12,VEN,18589,8139,10450,11846,6743,ITH,ITH3,5,Veneto,Veneto,4905854,2043484,41.65,0.38
2209,2021-04-17,VEN,22403,9078,13325,15124,7279,ITH,ITH3,5,Veneto,Veneto,4905854,2065887,42.11,0.46
2210,2021-01-07,VEN,8358,2317,6041,8358,0,ITH,ITH3,5,Veneto,Veneto,4905854,2074245,42.28,0.17
2211,2021-01-21,VEN,2293,719,1574,21,2272,ITH,ITH3,5,Veneto,Veneto,4905854,2076538,42.33,0.05
2212,2021-01-06,VEN,8132,2385,5747,8132,0,ITH,ITH3,5,Veneto,Veneto,4905854,2084670,42.49,0.17
2213,2021-03-15,VEN,16595,7262,9333,11385,5210,ITH,ITH3,5,Veneto,Veneto,4905854,2101265,42.83,0.34
2214,2021-05-18,VEN,26814,12478,14336,13273,13541,ITH,ITH3,5,Veneto,Veneto,4905854,2128079,43.38,0.55
2215,2021-03-22,VEN,18093,8135,9958,13050,5043,ITH,ITH3,5,Veneto,Veneto,4905854,2146172,43.75,0.37
2216,2021-06-08,VEN,42438,21921,20517,36908,5530,ITH,ITH3,5,Veneto,Veneto,4905854,2188610,44.61,0.87
2217,2021-05-25,VEN,27398,13157,14241,11527,15871,ITH,ITH3,5,Veneto,Veneto,4905854,2216008,45.17,0.56
2218,2021-02-14,VEN,125,56,69,112,13,ITH,ITH3,5,Veneto,Veneto,4905854,2216133,45.17,0.0
2219,2021-02-28,VEN,4136,1389,2747,3299,837,ITH,ITH3,5,Veneto,Veneto,4905854,2220269,45.26,0.08
2220,2021-03-17,VEN,14643,5991,8652,7849,6794,ITH,ITH3,5,Veneto,Veneto,4905854,2234912,45.56,0.3
2221,2021-01-12,VEN,5230,1516,3714,5230,0,ITH,ITH3,5,Veneto,Veneto,4905854,2240142,45.66,0.11
2222,2021-04-19,VEN,21532,8916,12616,5124,16408,ITH,ITH3,5,Veneto,Veneto,4905854,2261674,46.1,0.44
2223,2021-04-05,VEN,19140,8367,10773,13700,5440,ITH,ITH3,5,Veneto,Veneto,4905854,2280814,46.49,0.39
2224,2021-01-26,VEN,6917,2091,4826,152,6765,ITH,ITH3,5,Veneto,Veneto,4905854,2287731,46.63,0.14
2225,2021-05-06,VEN,46802,21960,24842,38344,8458,ITH,ITH3,5,Veneto,Veneto,4905854,2334533,47.59,0.95
2226,2021-03-27,VEN,32049,13991,18058,26243,5806,ITH,ITH3,5,Veneto,Veneto,4905854,2366582,48.24,0.65
2227,2021-06-03,VEN,53924,27687,26237,42147,11777,ITH,ITH3,5,Veneto,Veneto,4905854,2420506,49.34,1.1
2228,2021-02-19,VEN,7322,3140,4182,7118,204,ITH,ITH3,5,Veneto,Veneto,4905854,2427828,49.49,0.15
2229,2021-02-21,VEN,4634,1209,3425,4629,5,ITH,ITH3,5,Veneto,Veneto,4905854,2432462,49.58,0.09
2230,2021-05-15,VEN,36118,17463,18655,26159,9959,ITH,ITH3,5,Veneto,Veneto,4905854,2468580,50.32,0.74
2231,2021-06-01,VEN,26773,13431,13342,16396,10377,ITH,ITH3,5,Veneto,Veneto,4905854,2495353,50.86,0.55
2232,2021-03-10,VEN,18936,8638,10298,13255,5681,ITH,ITH3,5,Veneto,Veneto,4905854,2514289,51.25,0.39
2233,2021-01-10,VEN,5032,1671,3361,5032,0,ITH,ITH3,5,Veneto,Veneto,4905854,2519321,51.35,0.1
2234,2021-05-23,VEN,34459,16447,18012,11068,23391,ITH,ITH3,5,Veneto,Veneto,4905854,2553780,52.06,0.7
2235,2021-02-12,VEN,4314,1447,2867,3742,572,ITH,ITH3,5,Veneto,Veneto,4905854,2558094,52.14,0.09
2236,2021-01-29,VEN,9020,2788,6232,367,8653,ITH,ITH3,5,Veneto,Veneto,4905854,2567114,52.33,0.18
2237,2021-05-08,VEN,41308,18680,22628,29505,11803,ITH,ITH3,5,Veneto,Veneto,4905854,2608422,53.17,0.84
2238,2020-12-31,VEN,3220,1042,2178,3220,0,ITH,ITH3,5,Veneto,Veneto,4905854,2611642,53.24,0.07
2239,2021-04-12,VEN,14901,6333,8568,6684,8217,ITH,ITH3,5,Veneto,Veneto,4905854,2626543,53.54,0.3
2240,2021-01-02,VEN,5743,1766,3977,5743,0,ITH,ITH3,5,Veneto,Veneto,4905854,2632286,53.66,0.12
2241,2021-01-19,VEN,1309,472,837,1159,150,ITH,ITH3,5,Veneto,Veneto,4905854,2633595,53.68,0.03
2242,2021-05-01,VEN,38840,18234,20606,29895,8945,ITH,ITH3,5,Veneto,Veneto,4905854,2672435,54.47,0.79
2243,2021-03-05,VEN,13295,4983,8312,9625,3670,ITH,ITH3,5,Veneto,Veneto,4905854,2685730,54.75,0.27
2244,2021-01-24,VEN,4117,1219,2898,28,4089,ITH,ITH3,5,Veneto,Veneto,4905854,2689847,54.83,0.08
2245,2021-04-07,VEN,35898,16117,19781,28570,7328,ITH,ITH3,5,Veneto,Veneto,4905854,2725745,55.56,0.73
2246,2021-01-31,VEN,4769,1562,3207,392,4377,ITH,ITH3,5,Veneto,Veneto,4905854,2730514,55.66,0.1
2247,2021-03-29,VEN,31405,13640,17765,27573,3832,ITH,ITH3,5,Veneto,Veneto,4905854,2761919,56.3,0.64
2248,2021-05-13,VEN,44078,21749,22329,34192,9886,ITH,ITH3,5,Veneto,Veneto,4905854,2805997,57.2,0.9
2249,2021-02-02,VEN,6508,1878,4630,396,6112,ITH,ITH3,5,Veneto,Veneto,4905854,2812505,57.33,0.13
2250,2021-03-31,VEN,38657,16260,22397,31163,7494,ITH,ITH3,5,Veneto,Veneto,4905854,2851162,58.12,0.79
2251,2021-03-19,VEN,13789,5668,8121,7696,6093,ITH,ITH3,5,Veneto,Veneto,4905854,2864951,58.4,0.28
2252,2021-03-13,VEN,17179,7259,9920,14048,3131,ITH,ITH3,5,Veneto,Veneto,4905854,2882130,58.75,0.35
2253,2021-01-15,VEN,5874,1819,4055,5874,0,ITH,ITH3,5,Veneto,Veneto,4905854,2888004,58.87,0.12
2254,2021-05-20,VEN,44589,21154,23435,20333,24256,ITH,ITH3,5,Veneto,Veneto,4905854,2932593,59.78,0.91
2255,2021-02-09,VEN,5247,1889,3358,3446,1801,ITH,ITH3,5,Veneto,Veneto,4905854,2937840,59.88,0.11
2256,2021-05-27,VEN,45994,22555,23439,23111,22883,ITH,ITH3,5,Veneto,Veneto,4905854,2983834,60.82,0.94
2257,2021-02-07,VEN,2315,862,1453,714,1601,ITH,ITH3,5,Veneto,Veneto,4905854,2986149,60.87,0.05
2258,2021-03-24,VEN,22022,9506,12516,15214,6808,ITH,ITH3,5,Veneto,Veneto,4905854,3008171,61.32,0.45
2259,2021-02-17,VEN,6022,2772,3250,5928,94,ITH,ITH3,5,Veneto,Veneto,4905854,3014193,61.44,0.12
2260,2021-04-01,VEN,25202,11056,14146,18794,6408,ITH,ITH3,5,Veneto,Veneto,4905854,3039395,61.95,0.51
2261,2021-04-15,VEN,20845,8608,12237,10038,10807,ITH,ITH3,5,Veneto,Veneto,4905854,3060240,62.38,0.42
2262,2021-01-05,VEN,7329,2182,5147,7329,0,ITH,ITH3,5,Veneto,Veneto,4905854,3067569,62.53,0.15
2263,2021-02-10,VEN,4751,1588,3163,3697,1054,ITH,ITH3,5,Veneto,Veneto,4905854,3072320,62.63,0.1
2264,2021-04-08,VEN,32315,14345,17970,24437,7878,ITH,ITH3,5,Veneto,Veneto,4905854,3104635,63.28,0.66
2265,2021-06-04,VEN,49040,25495,23545,41178,7862,ITH,ITH3,5,Veneto,Veneto,4905854,3153675,64.28,1.0
2266,2021-02-24,VEN,8614,3678,4936,8128,486,ITH,ITH3,5,Veneto,Veneto,4905854,3162289,64.46,0.18
2267,2021-04-26,VEN,20707,9450,11257,15569,5138,ITH,ITH3,5,Veneto,Veneto,4905854,3182996,64.88,0.42
2268,2021-03-09,PAT,1581,589,992,938,643,ITH,ITH2,4,Provincia Autonoma Trento,P.A. Trento,541380,1581,0.29,0.29
2269,2021-03-14,PAT,107,65,42,20,87,ITH,ITH2,4,Provincia Autonoma Trento,P.A. Trento,541380,1688,0.31,0.02
2270,2021-03-07,PAT,22,6,16,22,0,ITH,ITH2,4,Provincia Autonoma Trento,P.A. Trento,541380,1710,0.32,0.0
2271,2021-01-09,PAT,190,40,150,190,0,ITH,ITH2,4,Provincia Autonoma Trento,P.A. Trento,541380,1900,0.35,0.04
2272,2021-02-06,PAT,574,298,276,433,141,ITH,ITH2,4,Provincia Autonoma Trento,P.A. Trento,541380,2474,0.46,0.11
2273,2021-02-23,PAT,1110,395,715,897,213,ITH,ITH2,4,Provincia Autonoma Trento,P.A. Trento,541380,3584,0.66,0.21
2274,2021-05-17,PAT,4293,2122,2171,3942,351,ITH,ITH2,4,Provincia Autonoma Trento,P.A. Trento,541380,7877,1.45,0.79
2275,2021-04-14,PAT,3115,1464,1651,2379,736,ITH,ITH2,4,Provincia Autonoma Trento,P.A. Trento,541380,10992,2.03,0.58
2276,2021-03-28,PAT,750,293,457,748,2,ITH,ITH2,4,Provincia Autonoma Trento,P.A. Trento,541380,11742,2.17,0.14
2277,2021-01-04,PAT,870,227,643,870,0,ITH,ITH2,4,Provincia Autonoma Trento,P.A. Trento,541380,12612,2.33,0.16
2278,2021-03-26,PAT,3161,1228,1933,2562,599,ITH,ITH2,4,Provincia Autonoma Trento,P.A. Trento,541380,15773,2.91,0.58
2279,2021-02-04,PAT,976,304,672,422,554,ITH,ITH2,4,Provincia Autonoma Trento,P.A. Trento,541380,16749,3.09,0.18
2280,2021-03-21,PAT,129,69,60,129,0,ITH,ITH2,4,Provincia Autonoma Trento,P.A. Trento,541380,16878,3.12,0.02
2281,2021-05-24,PAT,4379,2010,2369,1352,3027,ITH,ITH2,4,Provincia Autonoma Trento,P.A. Trento,541380,21257,3.93,0.81
2282,2021-03-02,PAT,1304,440,864,928,376,ITH,ITH2,4,Provincia Autonoma Trento,P.A. Trento,541380,22561,4.17,0.24
2283,2021-04-21,PAT,2893,1349,1544,2843,50,ITH,ITH2,4,Provincia Autonoma Trento,P.A. Trento,541380,25454,4.7,0.53
2284,2021-01-28,PAT,530,147,383,48,482,ITH,ITH2,4,Provincia Autonoma Trento,P.A. Trento,541380,25984,4.8,0.1
2285,2021-01-11,PAT,730,221,509,730,0,ITH,ITH2,4,Provincia Autonoma Trento,P.A. Trento,541380,26714,4.93,0.13
2286,2021-02-16,PAT,663,244,419,658,5,ITH,ITH2,4,Provincia Autonoma Trento,P.A. Trento,541380,27377,5.06,0.12
2287,2021-04-23,PAT,3606,1752,1854,3552,54,ITH,ITH2,4,Provincia Autonoma Trento,P.A. Trento,541380,30983,5.72,0.67
2288,2021-01-30,PAT,386,132,254,152,234,ITH,ITH2,4,Provincia Autonoma Trento,P.A. Trento,541380,31369,5.79,0.07
2289,2021-05-10,PAT,3207,1645,1562,2702,505,ITH,ITH2,4,Provincia Autonoma Trento,P.A. Trento,541380,34576,6.39,0.59
2290,2021-01-23,PAT,577,334,243,388,189,ITH,ITH2,4,Provincia Autonoma Trento,P.A. Trento,541380,35153,6.49,0.11
2291,2021-05-03,PAT,4244,2185,2059,4091,153,ITH,ITH2,4,Provincia Autonoma Trento,P.A. Trento,541380,39397,7.28,0.78
2292,2021-05-05,PAT,4975,2575,2400,4689,286,ITH,ITH2,4,Provincia Autonoma Trento,P.A. Trento,541380,44372,8.2,0.92
2293,2021-01-16,PAT,319,148,171,319,0,ITH,ITH2,4,Provincia Autonoma Trento,P.A. Trento,541380,44691,8.26,0.06
2294,2021-04-28,PAT,4242,1971,2271,4104,138,ITH,ITH2,4,Provincia Autonoma Trento,P.A. Trento,541380,48933,9.04,0.78
2295,2021-04-09,PAT,2709,1145,1564,1509,1200,ITH,ITH2,4,Provincia Autonoma Trento,P.A. Trento,541380,51642,9.54,0.5
2296,2021-02-11,PAT,1132,365,767,796,336,ITH,ITH2,4,Provincia Autonoma Trento,P.A. Trento,541380,52774,9.75,0.21
2297,2021-02-25,PAT,1641,643,998,1200,441,ITH,ITH2,4,Provincia Autonoma Trento,P.A. Trento,541380,54415,10.05,0.3
2298,2020-12-30,PAT,7,3,4,7,0,ITH,ITH2,4,Provincia Autonoma Trento,P.A. Trento,541380,54422,10.05,0.0
2299,2021-06-05,PAT,4005,1876,2129,751,3254,ITH,ITH2,4,Provincia Autonoma Trento,P.A. Trento,541380,58427,10.79,0.74
2300,2021-05-22,PAT,3243,1591,1652,922,2321,ITH,ITH2,4,Provincia Autonoma Trento,P.A. Trento,541380,61670,11.39,0.6
2301,2021-05-31,PAT,4697,2165,2532,1672,3025,ITH,ITH2,4,Provincia Autonoma Trento,P.A. Trento,541380,66367,12.26,0.87
2302,2021-02-20,PAT,407,245,162,123,284,ITH,ITH2,4,Provincia Autonoma Trento,P.A. Trento,541380,66774,12.33,0.08
2303,2021-04-13,PAT,2553,1058,1495,2046,507,ITH,ITH2,4,Provincia Autonoma Trento,P.A. Trento,541380,69327,12.81,0.47
2304,2021-01-20,PAT,291,73,218,279,12,ITH,ITH2,4,Provincia Autonoma Trento,P.A. Trento,541380,69618,12.86,0.05
2305,2021-04-30,PAT,4916,2400,2516,4770,146,ITH,ITH2,4,Provincia Autonoma Trento,P.A. Trento,541380,74534,13.77,0.91
2306,2021-05-19,PAT,5094,2454,2640,3842,1252,ITH,ITH2,4,Provincia Autonoma Trento,P.A. Trento,541380,79628,14.71,0.94
2307,2021-06-02,PAT,2837,1358,1479,942,1895,ITH,ITH2,4,Provincia Autonoma Trento,P.A. Trento,541380,82465,15.23,0.52
2308,2021-03-11,PAT,2298,851,1447,1474,824,ITH,ITH2,4,Provincia Autonoma Trento,P.A. Trento,541380,84763,15.66,0.42
2309,2021-03-04,PAT,2359,794,1565,1581,778,ITH,ITH2,4,Provincia Autonoma Trento,P.A. Trento,541380,87122,16.09,0.44
2310,2021-01-27,PAT,803,277,526,92,711,ITH,ITH2,4,Provincia Autonoma Trento,P.A. Trento,541380,87925,16.24,0.15
2311,2021-02-13,PAT,537,333,204,172,365,ITH,ITH2,4,Provincia Autonoma Trento,P.A. Trento,541380,88462,16.34,0.1
2312,2021-05-07,PAT,5988,3080,2908,5149,839,ITH,ITH2,4,Provincia Autonoma Trento,P.A. Trento,541380,94450,17.45,1.11
2313,2021-04-20,PAT,2877,1376,1501,2841,36,ITH,ITH2,4,Provincia Autonoma Trento,P.A. Trento,541380,97327,17.98,0.53
2314,2021-01-18,PAT,643,154,489,588,55,ITH,ITH2,4,Provincia Autonoma Trento,P.A. Trento,541380,97970,18.1,0.12
2315,2021-05-02,PAT,3512,1955,1557,3475,37,ITH,ITH2,4,Provincia Autonoma Trento,P.A. Trento,541380,101482,18.75,0.65
2316,2021-03-13,PAT,831,381,450,783,48,ITH,ITH2,4,Provincia Autonoma Trento,P.A. Trento,541380,102313,18.9,0.15
2317,2021-05-12,PAT,3299,1491,1808,2114,1185,ITH,ITH2,4,Provincia Autonoma Trento,P.A. Trento,541380,105612,19.51,0.61
2318,2021-03-16,PAT,1391,506,885,608,783,ITH,ITH2,4,Provincia Autonoma Trento,P.A. Trento,541380,107003,19.76,0.26
2319,2021-05-14,PAT,5304,2536,2768,3932,1372,ITH,ITH2,4,Provincia Autonoma Trento,P.A. Trento,541380,112307,20.74,0.98
2320,2021-02-08,PAT,1151,318,833,342,809,ITH,ITH2,4,Provincia Autonoma Trento,P.A. Trento,541380,113458,20.96,0.21
2321,2021-05-21,PAT,5027,2412,2615,3331,1696,ITH,ITH2,4,Provincia Autonoma Trento,P.A. Trento,541380,118485,21.89,0.93
2322,2021-03-18,PAT,2319,957,1362,1239,1080,ITH,ITH2,4,Provincia Autonoma Trento,P.A. Trento,541380,120804,22.31,0.43
2323,2021-06-09,PAT,4332,2139,2193,1380,2952,ITH,ITH2,4,Provincia Autonoma Trento,P.A. Trento,541380,125136,23.11,0.8
2324,2021-04-06,PAT,2259,949,1310,1494,765,ITH,ITH2,4,Provincia Autonoma Trento,P.A. Trento,541380,127395,23.53,0.42
2325,2021-01-13,PAT,421,123,298,421,0,ITH,ITH2,4,Provincia Autonoma Trento,P.A. Trento,541380,127816,23.61,0.08
2326,2021-01-08,PAT,1449,313,1136,1449,0,ITH,ITH2,4,Provincia Autonoma Trento,P.A. Trento,541380,129265,23.88,0.27
2327,2021-04-18,PAT,1855,845,1010,1846,9,ITH,ITH2,4,Provincia Autonoma Trento,P.A. Trento,541380,131120,24.22,0.34
2328,2021-03-06,PAT,785,277,508,634,151,ITH,ITH2,4,Provincia Autonoma Trento,P.A. Trento,541380,131905,24.36,0.14
2329,2021-04-11,PAT,2340,1135,1205,2249,91,ITH,ITH2,4,Provincia Autonoma Trento,P.A. Trento,541380,134245,24.8,0.43
2330,2021-02-27,PAT,1029,457,572,608,421,ITH,ITH2,4,Provincia Autonoma Trento,P.A. Trento,541380,135274,24.99,0.19
2331,2021-01-01,PAT,213,50,163,213,0,ITH,ITH2,4,Provincia Autonoma Trento,P.A. Trento,541380,135487,25.03,0.04
2332,2021-06-07,PAT,5720,2849,2871,2786,2934,ITH,ITH2,4,Provincia Autonoma Trento,P.A. Trento,541380,141207,26.08,1.06
2333,2021-04-01,PAT,2894,1228,1666,1800,1094,ITH,ITH2,4,Provincia Autonoma Trento,P.A. Trento,541380,144101,26.62,0.53
2334,2021-03-23,PAT,2445,944,1501,1705,740,ITH,ITH2,4,Provincia Autonoma Trento,P.A. Trento,541380,146546,27.07,0.45
2335,2021-05-28,PAT,3678,1719,1959,1445,2233,ITH,ITH2,4,Provincia Autonoma Trento,P.A. Trento,541380,150224,27.75,0.68
2336,2021-01-25,PAT,818,215,603,24,794,ITH,ITH2,4,Provincia Autonoma Trento,P.A. Trento,541380,151042,27.9,0.15
2337,2021-03-25,PAT,2874,1104,1770,1825,1049,ITH,ITH2,4,Provincia Autonoma Trento,P.A. Trento,541380,153916,28.43,0.53
2338,2021-03-30,PAT,2387,973,1414,1750,637,ITH,ITH2,4,Provincia Autonoma Trento,P.A. Trento,541380,156303,28.87,0.44
2339,2021-05-29,PAT,2220,1157,1063,822,1398,ITH,ITH2,4,Provincia Autonoma Trento,P.A. Trento,541380,158523,29.28,0.41
2340,2021-04-02,PAT,2802,1146,1656,2127,675,ITH,ITH2,4,Provincia Autonoma Trento,P.A. Trento,541380,161325,29.8,0.52
2341,2021-04-16,PAT,2837,1344,1493,2692,145,ITH,ITH2,4,Provincia Autonoma Trento,P.A. Trento,541380,164162,30.32,0.52
2342,2021-02-18,PAT,1208,426,782,1146,62,ITH,ITH2,4,Provincia Autonoma Trento,P.A. Trento,541380,165370,30.55,0.22
2343,2021-01-06,PAT,42,13,29,42,0,ITH,ITH2,4,Provincia Autonoma Trento,P.A. Trento,541380,165412,30.55,0.01
2344,2021-01-03,PAT,492,160,332,492,0,ITH,ITH2,4,Provincia Autonoma Trento,P.A. Trento,541380,165904,30.64,0.09
2345,2021-02-22,PAT,745,259,486,661,84,ITH,ITH2,4,Provincia Autonoma Trento,P.A. Trento,541380,166649,30.78,0.14
2346,2021-05-18,PAT,4246,2009,2237,3405,841,ITH,ITH2,4,Provincia Autonoma Trento,P.A. Trento,541380,170895,31.57,0.78
2347,2021-04-29,PAT,4622,2232,2390,4414,208,ITH,ITH2,4,Provincia Autonoma Trento,P.A. Trento,541380,175517,32.42,0.85
2348,2021-01-22,PAT,1668,433,1235,329,1339,ITH,ITH2,4,Provincia Autonoma Trento,P.A. Trento,541380,177185,32.73,0.31
2349,2021-02-05,PAT,802,272,530,283,519,ITH,ITH2,4,Provincia Autonoma Trento,P.A. Trento,541380,177987,32.88,0.15
2350,2021-05-16,PAT,1329,735,594,1091,238,ITH,ITH2,4,Provincia Autonoma Trento,P.A. Trento,541380,179316,33.12,0.25
2351,2021-01-05,PAT,709,232,477,709,0,ITH,ITH2,4,Provincia Autonoma Trento,P.A. Trento,541380,180025,33.25,0.13
2352,2021-04-15,PAT,3184,1437,1747,3030,154,ITH,ITH2,4,Provincia Autonoma Trento,P.A. Trento,541380,183209,33.84,0.59
2353,2021-02-12,PAT,1010,340,670,589,421,ITH,ITH2,4,Provincia Autonoma Trento,P.A. Trento,541380,184219,34.03,0.19
2354,2021-03-01,PAT,1237,454,783,942,295,ITH,ITH2,4,Provincia Autonoma Trento,P.A. Trento,541380,185456,34.26,0.23
2355,2021-03-20,PAT,874,403,471,671,203,ITH,ITH2,4,Provincia Autonoma Trento,P.A. Trento,541380,186330,34.42,0.16
2356,2021-03-03,PAT,1658,622,1036,1141,517,ITH,ITH2,4,Provincia Autonoma Trento,P.A. Trento,541380,187988,34.72,0.31
2357,2020-12-27,PAT,103,40,63,103,0,ITH,ITH2,4,Provincia Autonoma Trento,P.A. Trento,541380,188091,34.74,0.02
2358,2021-02-01,PAT,1220,335,885,92,1128,ITH,ITH2,4,Provincia Autonoma Trento,P.A. Trento,541380,189311,34.97,0.23
2359,2021-02-03,PAT,847,315,532,414,433,ITH,ITH2,4,Provincia Autonoma Trento,P.A. Trento,541380,190158,35.12,0.16
2360,2021-05-23,PAT,1955,993,962,447,1508,ITH,ITH2,4,Provincia Autonoma Trento,P.A. Trento,541380,192113,35.49,0.36
2361,2021-04-10,PAT,2798,1307,1491,2004,794,ITH,ITH2,4,Provincia Autonoma Trento,P.A. Trento,541380,194911,36.0,0.52
2362,2021-02-10,PAT,852,291,561,510,342,ITH,ITH2,4,Provincia Autonoma Trento,P.A. Trento,541380,195763,36.16,0.16
2363,2021-05-09,PAT,2322,1210,1112,1978,344,ITH,ITH2,4,Provincia Autonoma Trento,P.A. Trento,541380,198085,36.59,0.43
2364,2021-02-15,PAT,534,188,346,420,114,ITH,ITH2,4,Provincia Autonoma Trento,P.A. Trento,541380,198619,36.69,0.1
2365,2021-05-26,PAT,3903,1838,2065,1223,2680,ITH,ITH2,4,Provincia Autonoma Trento,P.A. Trento,541380,202522,37.41,0.72
2366,2021-01-10,PAT,84,19,65,84,0,ITH,ITH2,4,Provincia Autonoma Trento,P.A. Trento,541380,202606,37.42,0.02
2367,2021-04-25,PAT,1970,939,1031,1963,7,ITH,ITH2,4,Provincia Autonoma Trento,P.A. Trento,541380,204576,37.79,0.36
2368,2021-01-15,PAT,595,132,463,595,0,ITH,ITH2,4,Provincia Autonoma Trento,P.A. Trento,541380,205171,37.9,0.11
2369,2021-05-20,PAT,4998,2353,2645,3374,1624,ITH,ITH2,4,Provincia Autonoma Trento,P.A. Trento,541380,210169,38.82,0.92
2370,2021-03-24,PAT,2376,940,1436,1556,820,ITH,ITH2,4,Provincia Autonoma Trento,P.A. Trento,541380,212545,39.26,0.44
2371,2021-02-09,PAT,916,287,629,442,474,ITH,ITH2,4,Provincia Autonoma Trento,P.A. Trento,541380,213461,39.43,0.17
2372,2021-03-17,PAT,2067,790,1277,1199,868,ITH,ITH2,4,Provincia Autonoma Trento,P.A. Trento,541380,215528,39.81,0.38
2373,2021-02-02,PAT,908,240,668,191,717,ITH,ITH2,4,Provincia Autonoma Trento,P.A. Trento,541380,216436,39.98,0.17
2374,2021-05-13,PAT,3406,1579,1827,2305,1101,ITH,ITH2,4,Provincia Autonoma Trento,P.A. Trento,541380,219842,40.61,0.63
2375,2021-06-06,PAT,2225,1059,1166,440,1785,ITH,ITH2,4,Provincia Autonoma Trento,P.A. Trento,541380,222067,41.02,0.41
2376,2021-02-17,PAT,1112,425,687,1021,91,ITH,ITH2,4,Provincia Autonoma Trento,P.A. Trento,541380,223179,41.22,0.21
2377,2021-05-30,PAT,1770,872,898,930,840,ITH,ITH2,4,Provincia Autonoma Trento,P.A. Trento,541380,224949,41.55,0.33
2378,2021-04-03,PAT,1138,471,667,971,167,ITH,ITH2,4,Provincia Autonoma Trento,P.A. Trento,541380,226087,41.76,0.21
2379,2021-03-12,PAT,2508,937,1571,1702,806,ITH,ITH2,4,Provincia Autonoma Trento,P.A. Trento,541380,228595,42.22,0.46
2380,2021-01-02,PAT,502,143,359,502,0,ITH,ITH2,4,Provincia Autonoma Trento,P.A. Trento,541380,229097,42.32,0.09
2381,2021-03-29,PAT,2467,960,1507,1732,735,ITH,ITH2,4,Provincia Autonoma Trento,P.A. Trento,541380,231564,42.77,0.46
2382,2021-04-12,PAT,3092,1409,1683,2596,496,ITH,ITH2,4,Provincia Autonoma Trento,P.A. Trento,541380,234656,43.34,0.57
2383,2021-01-21,PAT,352,95,257,228,124,ITH,ITH2,4,Provincia Autonoma Trento,P.A. Trento,541380,235008,43.41,0.07
2384,2021-05-01,PAT,4840,2464,2376,4805,35,ITH,ITH2,4,Provincia Autonoma Trento,P.A. Trento,541380,239848,44.3,0.89
2385,2021-02-21,PAT,155,92,63,43,112,ITH,ITH2,4,Provincia Autonoma Trento,P.A. Trento,541380,240003,44.33,0.03
2386,2021-05-15,PAT,1567,815,752,679,888,ITH,ITH2,4,Provincia Autonoma Trento,P.A. Trento,541380,241570,44.62,0.29
2387,2021-06-01,PAT,3976,1859,2117,1135,2841,ITH,ITH2,4,Provincia Autonoma Trento,P.A. Trento,541380,245546,45.36,0.73
2388,2021-05-25,PAT,4747,2261,2486,1859,2888,ITH,ITH2,4,Provincia Autonoma Trento,P.A. Trento,541380,250293,46.23,0.88
2389,2021-05-08,PAT,3156,1723,1433,2737,419,ITH,ITH2,4,Provincia Autonoma Trento,P.A. Trento,541380,253449,46.82,0.58
2390,2021-02-14,PAT,246,186,60,11,235,ITH,ITH2,4,Provincia Autonoma Trento,P.A. Trento,541380,253695,46.86,0.05
2391,2021-05-27,PAT,4259,1978,2281,1242,3017,ITH,ITH2,4,Provincia Autonoma Trento,P.A. Trento,541380,257954,47.65,0.79
2392,2021-03-27,PAT,1618,710,908,1363,255,ITH,ITH2,4,Provincia Autonoma Trento,P.A. Trento,541380,259572,47.95,0.3
2393,2021-06-04,PAT,5765,2581,3184,1812,3953,ITH,ITH2,4,Provincia Autonoma Trento,P.A. Trento,541380,265337,49.01,1.06
2394,2021-02-24,PAT,1322,524,798,924,398,ITH,ITH2,4,Provincia Autonoma Trento,P.A. Trento,541380,266659,49.26,0.24
2395,2021-06-03,PAT,4738,2222,2516,1296,3442,ITH,ITH2,4,Provincia Autonoma Trento,P.A. Trento,541380,271397,50.13,0.88
2396,2021-01-19,PAT,405,77,328,405,0,ITH,ITH2,4,Provincia Autonoma Trento,P.A. Trento,541380,271802,50.21,0.07
2397,2021-01-29,PAT,1353,331,1022,55,1298,ITH,ITH2,4,Provincia Autonoma Trento,P.A. Trento,541380,273155,50.46,0.25
2398,2021-04-22,PAT,3148,1469,1679,3104,44,ITH,ITH2,4,Provincia Autonoma Trento,P.A. Trento,541380,276303,51.04,0.58
2399,2021-04-07,PAT,2599,1012,1587,1658,941,ITH,ITH2,4,Provincia Autonoma Trento,P.A. Trento,541380,278902,51.52,0.48
2400,2021-01-12,PAT,505,158,347,505,0,ITH,ITH2,4,Provincia Autonoma Trento,P.A. Trento,541380,279407,51.61,0.09
2401,2021-03-19,PAT,2423,915,1508,1571,852,ITH,ITH2,4,Provincia Autonoma Trento,P.A. Trento,541380,281830,52.06,0.45
2402,2021-04-05,PAT,35,17,18,33,2,ITH,ITH2,4,Provincia Autonoma Trento,P.A. Trento,541380,281865,52.06,0.01
2403,2021-03-31,PAT,2568,983,1585,1711,857,ITH,ITH2,4,Provincia Autonoma Trento,P.A. Trento,541380,284433,52.54,0.47
2404,2021-01-26,PAT,542,154,388,27,515,ITH,ITH2,4,Provincia Autonoma Trento,P.A. Trento,541380,284975,52.64,0.1
2405,2021-05-06,PAT,5512,2730,2782,4733,779,ITH,ITH2,4,Provincia Autonoma Trento,P.A. Trento,541380,290487,53.66,1.02
2406,2021-04-08,PAT,3114,1294,1820,1996,1118,ITH,ITH2,4,Provincia Autonoma Trento,P.A. Trento,541380,293601,54.23,0.58
2407,2020-12-31,PAT,1624,449,1175,1624,0,ITH,ITH2,4,Provincia Autonoma Trento,P.A. Trento,541380,295225,54.53,0.3
2408,2021-03-05,PAT,2244,703,1541,1678,566,ITH,ITH2,4,Provincia Autonoma Trento,P.A. Trento,541380,297469,54.95,0.41
2409,2021-01-07,PAT,1270,310,960,1270,0,ITH,ITH2,4,Provincia Autonoma Trento,P.A. Trento,541380,298739,55.18,0.23
2410,2021-03-10,PAT,2401,928,1473,1480,921,ITH,ITH2,4,Provincia Autonoma Trento,P.A. Trento,541380,301140,55.62,0.44
2411,2021-04-24,PAT,3511,1682,1829,3497,14,ITH,ITH2,4,Provincia Autonoma Trento,P.A. Trento,541380,304651,56.27,0.65
2412,2021-02-26,PAT,1218,435,783,923,295,ITH,ITH2,4,Provincia Autonoma Trento,P.A. Trento,541380,305869,56.5,0.22
2413,2021-01-14,PAT,700,203,497,700,0,ITH,ITH2,4,Provincia Autonoma Trento,P.A. Trento,541380,306569,56.63,0.13
2414,2021-02-28,PAT,242,121,121,242,0,ITH,ITH2,4,Provincia Autonoma Trento,P.A. Trento,541380,306811,56.67,0.04
2415,2021-06-08,PAT,5616,2723,2893,1816,3800,ITH,ITH2,4,Provincia Autonoma Trento,P.A. Trento,541380,312427,57.71,1.04
2416,2021-04-26,PAT,2651,1249,1402,2557,94,ITH,ITH2,4,Provincia Autonoma Trento,P.A. Trento,541380,315078,58.2,0.49
2417,2021-02-19,PAT,928,358,570,869,59,ITH,ITH2,4,Provincia Autonoma Trento,P.A. Trento,541380,316006,58.37,0.17
2418,2021-04-17,PAT,2203,1120,1083,2146,57,ITH,ITH2,4,Provincia Autonoma Trento,P.A. Trento,541380,318209,58.78,0.41
2419,2021-04-19,PAT,2624,1235,1389,2602,22,ITH,ITH2,4,Provincia Autonoma Trento,P.A. Trento,541380,320833,59.26,0.48
2420,2021-03-15,PAT,1411,545,866,947,464,ITH,ITH2,4,Provincia Autonoma Trento,P.A. Trento,541380,322244,59.52,0.26
2421,2021-01-17,PAT,251,195,56,251,0,ITH,ITH2,4,Provincia Autonoma Trento,P.A. Trento,541380,322495,59.57,0.05
2422,2021-05-11,PAT,3697,1749,1948,2849,848,ITH,ITH2,4,Provincia Autonoma Trento,P.A. Trento,541380,326192,60.25,0.68
2423,2021-04-27,PAT,3908,1877,2031,3840,68,ITH,ITH2,4,Provincia Autonoma Trento,P.A. Trento,541380,330100,60.97,0.72
2424,2021-05-04,PAT,4476,2423,2053,4386,90,ITH,ITH2,4,Provincia Autonoma Trento,P.A. Trento,541380,334576,61.8,0.83
2425,2021-03-08,PAT,1410,434,976,1056,354,ITH,ITH2,4,Provincia Autonoma Trento,P.A. Trento,541380,335986,62.06,0.26
2426,2021-03-22,PAT,2306,973,1333,1431,875,ITH,ITH2,4,Provincia Autonoma Trento,P.A. Trento,541380,338292,62.49,0.43
2427,2021-01-24,PAT,547,276,271,224,323,ITH,ITH2,4,Provincia Autonoma Trento,P.A. Trento,541380,338839,62.59,0.1
2428,2021-01-31,PAT,75,15,60,1,74,ITH,ITH2,4,Provincia Autonoma Trento,P.A. Trento,541380,338914,62.6,0.01
2429,2021-03-23,UMB,3797,1685,2112,2168,1629,ITI,ITI2,10,Umbria,Umbria,882015,3797,0.43,0.43
2430,2021-02-08,UMB,637,203,434,88,549,ITI,ITI2,10,Umbria,Umbria,882015,4434,0.5,0.07
2431,2021-05-19,UMB,9396,4199,5197,5651,3745,ITI,ITI2,10,Umbria,Umbria,882015,13830,1.57,1.07
2432,2021-02-06,UMB,396,138,258,34,362,ITI,ITI2,10,Umbria,Umbria,882015,14226,1.61,0.04
2433,2021-05-26,UMB,9615,4546,5069,8384,1231,ITI,ITI2,10,Umbria,Umbria,882015,23841,2.7,1.09
2434,2021-05-07,UMB,10106,4695,5411,6906,3200,ITI,ITI2,10,Umbria,Umbria,882015,33947,3.85,1.15
2435,2021-03-18,UMB,2942,1164,1778,1704,1238,ITI,ITI2,10,Umbria,Umbria,882015,36889,4.18,0.33
2436,2021-02-13,UMB,115,28,87,112,3,ITI,ITI2,10,Umbria,Umbria,882015,37004,4.2,0.01
2437,2021-05-24,UMB,9015,4480,4535,8169,846,ITI,ITI2,10,Umbria,Umbria,882015,46019,5.22,1.02
2438,2021-04-18,UMB,1530,680,850,600,930,ITI,ITI2,10,Umbria,Umbria,882015,47549,5.39,0.17
2439,2021-01-11,UMB,1315,346,969,1315,0,ITI,ITI2,10,Umbria,Umbria,882015,48864,5.54,0.15
2440,2021-05-05,UMB,7196,3291,3905,3896,3300,ITI,ITI2,10,Umbria,Umbria,882015,56060,6.36,0.82
2441,2021-01-25,UMB,648,323,325,5,643,ITI,ITI2,10,Umbria,Umbria,882015,56708,6.43,0.07
2442,2021-04-04,UMB,59,20,39,23,36,ITI,ITI2,10,Umbria,Umbria,882015,56767,6.44,0.01
2443,2021-06-07,UMB,6852,3352,3500,6211,641,ITI,ITI2,10,Umbria,Umbria,882015,63619,7.21,0.78
2444,2021-03-16,UMB,3538,1454,2084,1911,1627,ITI,ITI2,10,Umbria,Umbria,882015,67157,7.61,0.4
2445,2021-02-27,UMB,1658,354,1304,1642,16,ITI,ITI2,10,Umbria,Umbria,882015,68815,7.8,0.19
2446,2021-04-03,UMB,2111,716,1395,1058,1053,ITI,ITI2,10,Umbria,Umbria,882015,70926,8.04,0.24
2447,2021-06-02,UMB,3941,1894,2047,3901,40,ITI,ITI2,10,Umbria,Umbria,882015,74867,8.49,0.45
2448,2021-02-20,UMB,282,100,182,258,24,ITI,ITI2,10,Umbria,Umbria,882015,75149,8.52,0.03
2449,2021-03-09,UMB,4051,1971,2080,2760,1291,ITI,ITI2,10,Umbria,Umbria,882015,79200,8.98,0.46
2450,2021-05-31,UMB,5782,2817,2965,4919,863,ITI,ITI2,10,Umbria,Umbria,882015,84982,9.63,0.66
2451,2021-05-14,UMB,5250,2439,2811,3443,1807,ITI,ITI2,10,Umbria,Umbria,882015,90232,10.23,0.6
2452,2021-02-01,UMB,1285,342,943,48,1237,ITI,ITI2,10,Umbria,Umbria,882015,91517,10.38,0.15
2453,2021-02-18,UMB,1496,582,914,1030,466,ITI,ITI2,10,Umbria,Umbria,882015,93013,10.55,0.17
2454,2021-01-01,UMB,274,105,169,274,0,ITI,ITI2,10,Umbria,Umbria,882015,93287,10.58,0.03
2455,2021-04-11,UMB,3102,1503,1599,3053,49,ITI,ITI2,10,Umbria,Umbria,882015,96389,10.93,0.35
2456,2021-01-18,UMB,614,219,395,529,85,ITI,ITI2,10,Umbria,Umbria,882015,97003,11.0,0.07
2457,2021-04-06,UMB,5290,2169,3121,2901,2389,ITI,ITI2,10,Umbria,Umbria,882015,102293,11.6,0.6
2458,2021-03-28,UMB,1096,442,654,1072,24,ITI,ITI2,10,Umbria,Umbria,882015,103389,11.72,0.12
2459,2021-01-30,UMB,1590,490,1100,44,1546,ITI,ITI2,10,Umbria,Umbria,882015,104979,11.9,0.18
2460,2021-05-12,UMB,6478,3015,3463,4335,2143,ITI,ITI2,10,Umbria,Umbria,882015,111457,12.64,0.73
2461,2021-04-23,UMB,6610,2786,3824,3489,3121,ITI,ITI2,10,Umbria,Umbria,882015,118067,13.39,0.75
2462,2021-02-25,UMB,1336,497,839,1284,52,ITI,ITI2,10,Umbria,Umbria,882015,119403,13.54,0.15
2463,2021-03-11,UMB,3565,1697,1868,2559,1006,ITI,ITI2,10,Umbria,Umbria,882015,122968,13.94,0.4
2464,2021-01-13,UMB,450,139,311,450,0,ITI,ITI2,10,Umbria,Umbria,882015,123418,13.99,0.05
2465,2021-01-06,UMB,846,325,521,846,0,ITI,ITI2,10,Umbria,Umbria,882015,124264,14.09,0.1
2466,2021-04-16,UMB,8111,3747,4364,6273,1838,ITI,ITI2,10,Umbria,Umbria,882015,132375,15.01,0.92
2467,2021-04-30,UMB,6232,2962,3270,2843,3389,ITI,ITI2,10,Umbria,Umbria,882015,138607,15.71,0.71
2468,2021-03-04,UMB,4485,1853,2632,3657,828,ITI,ITI2,10,Umbria,Umbria,882015,143092,16.22,0.51
2469,2021-01-20,UMB,613,222,391,613,0,ITI,ITI2,10,Umbria,Umbria,882015,143705,16.29,0.07
2470,2021-01-08,UMB,1190,345,845,1190,0,ITI,ITI2,10,Umbria,Umbria,882015,144895,16.43,0.13
2471,2021-05-23,UMB,5068,1855,3213,652,4416,ITI,ITI2,10,Umbria,Umbria,882015,149963,17.0,0.57
2472,2021-05-16,UMB,5318,2535,2783,5266,52,ITI,ITI2,10,Umbria,Umbria,882015,155281,17.61,0.6
2473,2021-04-27,UMB,5665,2403,3262,3088,2577,ITI,ITI2,10,Umbria,Umbria,882015,160946,18.25,0.64
2474,2021-02-03,UMB,725,174,551,67,658,ITI,ITI2,10,Umbria,Umbria,882015,161671,18.33,0.08
2475,2021-04-20,UMB,5439,2356,3083,3492,1947,ITI,ITI2,10,Umbria,Umbria,882015,167110,18.95,0.62
2476,2021-01-27,UMB,840,330,510,13,827,ITI,ITI2,10,Umbria,Umbria,882015,167950,19.04,0.1
2477,2021-01-10,UMB,1070,277,793,1070,0,ITI,ITI2,10,Umbria,Umbria,882015,169020,19.16,0.12
2478,2021-05-21,UMB,8927,3639,5288,4123,4804,ITI,ITI2,10,Umbria,Umbria,882015,177947,20.18,1.01
2479,2021-05-04,UMB,5531,2543,2988,2410,3121,ITI,ITI2,10,Umbria,Umbria,882015,183478,20.8,0.63
2480,2021-04-01,UMB,4374,1836,2538,2366,2008,ITI,ITI2,10,Umbria,Umbria,882015,187852,21.3,0.5
2481,2021-03-01,UMB,1503,774,729,1389,114,ITI,ITI2,10,Umbria,Umbria,882015,189355,21.47,0.17
2482,2021-06-09,UMB,5514,2703,2811,4980,534,ITI,ITI2,10,Umbria,Umbria,882015,194869,22.09,0.63
2483,2021-03-15,UMB,4596,1930,2666,2828,1768,ITI,ITI2,10,Umbria,Umbria,882015,199465,22.61,0.52
2484,2021-02-10,UMB,715,349,366,700,15,ITI,ITI2,10,Umbria,Umbria,882015,200180,22.7,0.08
2485,2021-05-28,UMB,9507,4369,5138,7268,2239,ITI,ITI2,10,Umbria,Umbria,882015,209687,23.77,1.08
2486,2021-04-15,UMB,7630,3484,4146,5744,1886,ITI,ITI2,10,Umbria,Umbria,882015,217317,24.64,0.87
2487,2021-02-17,UMB,1618,748,870,1267,351,ITI,ITI2,10,Umbria,Umbria,882015,218935,24.82,0.18
2488,2021-04-13,UMB,7679,3400,4279,6010,1669,ITI,ITI2,10,Umbria,Umbria,882015,226614,25.69,0.87
2489,2021-02-15,UMB,1368,692,676,1367,1,ITI,ITI2,10,Umbria,Umbria,882015,227982,25.85,0.16
2490,2021-01-03,UMB,270,112,158,270,0,ITI,ITI2,10,Umbria,Umbria,882015,228252,25.88,0.03
2491,2021-05-30,UMB,5971,2992,2979,5780,191,ITI,ITI2,10,Umbria,Umbria,882015,234223,26.56,0.68
2492,2021-03-08,UMB,3672,1801,1871,2309,1363,ITI,ITI2,10,Umbria,Umbria,882015,237895,26.97,0.42
2493,2021-03-25,UMB,3904,1699,2205,2840,1064,ITI,ITI2,10,Umbria,Umbria,882015,241799,27.41,0.44
2494,2021-03-27,UMB,4253,1512,2741,3913,340,ITI,ITI2,10,Umbria,Umbria,882015,246052,27.9,0.48
2495,2021-05-11,UMB,6230,2828,3402,4028,2202,ITI,ITI2,10,Umbria,Umbria,882015,252282,28.6,0.71
2496,2021-03-30,UMB,3948,1705,2243,2416,1532,ITI,ITI2,10,Umbria,Umbria,882015,256230,29.05,0.45
2497,2020-12-27,UMB,86,45,41,86,0,ITI,ITI2,10,Umbria,Umbria,882015,256316,29.06,0.01
2498,2021-02-22,UMB,1859,778,1081,1773,86,ITI,ITI2,10,Umbria,Umbria,882015,258175,29.27,0.21
2499,2021-04-08,UMB,5873,2506,3367,4078,1795,ITI,ITI2,10,Umbria,Umbria,882015,264048,29.94,0.67
2500,2021-04-25,UMB,4364,1685,2679,4282,82,ITI,ITI2,10,Umbria,Umbria,882015,268412,30.43,0.49
2501,2021-03-06,UMB,4267,1110,3157,4124,143,ITI,ITI2,10,Umbria,Umbria,882015,272679,30.92,0.48
2502,2021-01-22,UMB,276,105,171,32,244,ITI,ITI2,10,Umbria,Umbria,882015,272955,30.95,0.03
2503,2021-05-02,UMB,3787,1868,1919,1333,2454,ITI,ITI2,10,Umbria,Umbria,882015,276742,31.38,0.43
2504,2021-03-20,UMB,2298,833,1465,2273,25,ITI,ITI2,10,Umbria,Umbria,882015,279040,31.64,0.26
2505,2021-03-17,UMB,3331,1313,2018,1859,1472,ITI,ITI2,10,Umbria,Umbria,882015,282371,32.01,0.38
2506,2021-01-07,UMB,1300,387,913,1300,0,ITI,ITI2,10,Umbria,Umbria,882015,283671,32.16,0.15
2507,2021-01-26,UMB,816,390,426,18,798,ITI,ITI2,10,Umbria,Umbria,882015,284487,32.25,0.09
2508,2021-02-12,UMB,671,224,447,665,6,ITI,ITI2,10,Umbria,Umbria,882015,285158,32.33,0.08
2509,2021-02-26,UMB,660,253,407,652,8,ITI,ITI2,10,Umbria,Umbria,882015,285818,32.41,0.07
2510,2021-01-24,UMB,258,106,152,1,257,ITI,ITI2,10,Umbria,Umbria,882015,286076,32.43,0.03
2511,2021-06-08,UMB,7226,3562,3664,6734,492,ITI,ITI2,10,Umbria,Umbria,882015,293302,33.25,0.82
2512,2021-05-13,UMB,5898,2657,3241,3825,2073,ITI,ITI2,10,Umbria,Umbria,882015,299200,33.92,0.67
2513,2021-02-19,UMB,743,293,450,526,217,ITI,ITI2,10,Umbria,Umbria,882015,299943,34.01,0.08
2514,2021-04-22,UMB,5430,2231,3199,2768,2662,ITI,ITI2,10,Umbria,Umbria,882015,305373,34.62,0.62
2515,2021-04-17,UMB,6665,3059,3606,5325,1340,ITI,ITI2,10,Umbria,Umbria,882015,312038,35.38,0.76
2516,2021-01-05,UMB,854,429,425,854,0,ITI,ITI2,10,Umbria,Umbria,882015,312892,35.47,0.1
2517,2021-02-05,UMB,780,234,546,18,762,ITI,ITI2,10,Umbria,Umbria,882015,313672,35.56,0.09
2518,2021-04-12,UMB,7088,3078,4010,5370,1718,ITI,ITI2,10,Umbria,Umbria,882015,320760,36.37,0.8
2519,2021-01-19,UMB,103,23,80,103,0,ITI,ITI2,10,Umbria,Umbria,882015,320863,36.38,0.01
2520,2021-04-29,UMB,5214,2247,2967,2888,2326,ITI,ITI2,10,Umbria,Umbria,882015,326077,36.97,0.59
2521,2021-03-24,UMB,4073,1760,2313,2750,1323,ITI,ITI2,10,Umbria,Umbria,882015,330150,37.43,0.46
2522,2021-04-10,UMB,7468,3512,3956,7333,135,ITI,ITI2,10,Umbria,Umbria,882015,337618,38.28,0.85
2523,2021-01-17,UMB,54,17,37,54,0,ITI,ITI2,10,Umbria,Umbria,882015,337672,38.28,0.01
2524,2020-12-31,UMB,322,127,195,322,0,ITI,ITI2,10,Umbria,Umbria,882015,337994,38.32,0.04
2525,2021-03-29,UMB,3844,1692,2152,2365,1479,ITI,ITI2,10,Umbria,Umbria,882015,341838,38.76,0.44
2526,2021-01-31,UMB,1058,276,782,25,1033,ITI,ITI2,10,Umbria,Umbria,882015,342896,38.88,0.12
2527,2021-05-25,UMB,8759,4260,4499,7736,1023,ITI,ITI2,10,Umbria,Umbria,882015,351655,39.87,0.99
2528,2021-05-18,UMB,7723,3342,4381,3885,3838,ITI,ITI2,10,Umbria,Umbria,882015,359378,40.75,0.88
2529,2021-03-22,UMB,3560,1655,1905,2314,1246,ITI,ITI2,10,Umbria,Umbria,882015,362938,41.15,0.4
2530,2021-04-05,UMB,4250,1728,2522,2195,2055,ITI,ITI2,10,Umbria,Umbria,882015,367188,41.63,0.48
2531,2021-02-07,UMB,54,17,37,1,53,ITI,ITI2,10,Umbria,Umbria,882015,367242,41.64,0.01
2532,2021-06-05,UMB,8145,3740,4405,5496,2649,ITI,ITI2,10,Umbria,Umbria,882015,375387,42.56,0.92
2533,2021-06-04,UMB,8868,4384,4484,7692,1176,ITI,ITI2,10,Umbria,Umbria,882015,384255,43.57,1.01
2534,2021-05-01,UMB,5374,2640,2734,2146,3228,ITI,ITI2,10,Umbria,Umbria,882015,389629,44.17,0.61
2535,2021-03-05,UMB,4592,1379,3213,3936,656,ITI,ITI2,10,Umbria,Umbria,882015,394221,44.7,0.52
2536,2021-03-03,UMB,4438,1773,2665,3727,711,ITI,ITI2,10,Umbria,Umbria,882015,398659,45.2,0.5
2537,2021-06-06,UMB,7610,3903,3707,6917,693,ITI,ITI2,10,Umbria,Umbria,882015,406269,46.06,0.86
2538,2021-05-06,UMB,9461,4313,5148,6151,3310,ITI,ITI2,10,Umbria,Umbria,882015,415730,47.13,1.07
2539,2021-04-21,UMB,5312,2309,3003,3086,2226,ITI,ITI2,10,Umbria,Umbria,882015,421042,47.74,0.6
2540,2021-03-02,UMB,3642,1346,2296,3638,4,ITI,ITI2,10,Umbria,Umbria,882015,424684,48.15,0.41
2541,2021-06-01,UMB,4375,2086,2289,4222,153,ITI,ITI2,10,Umbria,Umbria,882015,429059,48.65,0.5
2542,2021-03-10,UMB,4013,1927,2086,2757,1256,ITI,ITI2,10,Umbria,Umbria,882015,433072,49.1,0.45
2543,2021-01-16,UMB,221,73,148,221,0,ITI,ITI2,10,Umbria,Umbria,882015,433293,49.13,0.03
2544,2021-02-02,UMB,944,274,670,32,912,ITI,ITI2,10,Umbria,Umbria,882015,434237,49.23,0.11
2545,2021-04-26,UMB,5376,2329,3047,3124,2252,ITI,ITI2,10,Umbria,Umbria,882015,439613,49.84,0.61
2546,2021-04-09,UMB,6793,3162,3631,6574,219,ITI,ITI2,10,Umbria,Umbria,882015,446406,50.61,0.77
2547,2021-04-28,UMB,5347,2317,3030,2964,2383,ITI,ITI2,10,Umbria,Umbria,882015,451753,51.22,0.61
2548,2021-02-04,UMB,733,226,507,25,708,ITI,ITI2,10,Umbria,Umbria,882015,452486,51.3,0.08
2549,2021-05-15,UMB,4984,1875,3109,1819,3165,ITI,ITI2,10,Umbria,Umbria,882015,457470,51.87,0.57
2550,2021-02-11,UMB,842,349,493,837,5,ITI,ITI2,10,Umbria,Umbria,882015,458312,51.96,0.1
2551,2021-05-22,UMB,6911,2712,4199,2640,4271,ITI,ITI2,10,Umbria,Umbria,882015,465223,52.75,0.78
2552,2021-03-26,UMB,4571,1683,2888,4399,172,ITI,ITI2,10,Umbria,Umbria,882015,469794,53.26,0.52
2553,2021-01-02,UMB,304,111,193,304,0,ITI,ITI2,10,Umbria,Umbria,882015,470098,53.3,0.03
2554,2021-03-07,UMB,845,180,665,838,7,ITI,ITI2,10,Umbria,Umbria,882015,470943,53.39,0.1
2555,2021-05-29,UMB,7833,3596,4237,6273,1560,ITI,ITI2,10,Umbria,Umbria,882015,478776,54.28,0.89
2556,2021-04-24,UMB,4562,1963,2599,3384,1178,ITI,ITI2,10,Umbria,Umbria,882015,483338,54.8,0.52
2557,2021-01-12,UMB,838,248,590,838,0,ITI,ITI2,10,Umbria,Umbria,882015,484176,54.89,0.1
2558,2021-03-14,UMB,66,48,18,66,0,ITI,ITI2,10,Umbria,Umbria,882015,484242,54.9,0.01
2559,2021-03-12,UMB,2653,1040,1613,2157,496,ITI,ITI2,10,Umbria,Umbria,882015,486895,55.2,0.3
2560,2021-03-21,UMB,665,330,335,665,0,ITI,ITI2,10,Umbria,Umbria,882015,487560,55.28,0.08
2561,2021-04-02,UMB,4308,1746,2562,3551,757,ITI,ITI2,10,Umbria,Umbria,882015,491868,55.77,0.49
2562,2021-01-09,UMB,1745,499,1246,1745,0,ITI,ITI2,10,Umbria,Umbria,882015,493613,55.96,0.2
2563,2021-04-19,UMB,5015,2216,2799,2966,2049,ITI,ITI2,10,Umbria,Umbria,882015,498628,56.53,0.57
2564,2021-02-24,UMB,1520,565,955,1505,15,ITI,ITI2,10,Umbria,Umbria,882015,500148,56.71,0.17
2565,2021-05-10,UMB,5982,2799,3183,3830,2152,ITI,ITI2,10,Umbria,Umbria,882015,506130,57.38,0.68
2566,2021-05-08,UMB,8102,3730,4372,4906,3196,ITI,ITI2,10,Umbria,Umbria,882015,514232,58.3,0.92
2567,2021-01-28,UMB,1247,394,853,19,1228,ITI,ITI2,10,Umbria,Umbria,882015,515479,58.44,0.14
2568,2021-05-03,UMB,5091,2271,2820,2204,2887,ITI,ITI2,10,Umbria,Umbria,882015,520570,59.02,0.58
2569,2021-01-23,UMB,280,100,180,2,278,ITI,ITI2,10,Umbria,Umbria,882015,520850,59.05,0.03
2570,2021-01-21,UMB,610,202,408,341,269,ITI,ITI2,10,Umbria,Umbria,882015,521460,59.12,0.07
2571,2021-05-17,UMB,6360,3058,3302,4187,2173,ITI,ITI2,10,Umbria,Umbria,882015,527820,59.84,0.72
2572,2021-01-14,UMB,752,201,551,752,0,ITI,ITI2,10,Umbria,Umbria,882015,528572,59.93,0.09
2573,2021-03-19,UMB,1743,565,1178,1087,656,ITI,ITI2,10,Umbria,Umbria,882015,530315,60.13,0.2
2574,2021-03-13,UMB,1731,524,1207,1486,245,ITI,ITI2,10,Umbria,Umbria,882015,532046,60.32,0.2
2575,2021-01-15,UMB,701,215,486,701,0,ITI,ITI2,10,Umbria,Umbria,882015,532747,60.4,0.08
2576,2021-01-29,UMB,1232,348,884,79,1153,ITI,ITI2,10,Umbria,Umbria,882015,533979,60.54,0.14
2577,2021-05-09,UMB,5765,2757,3008,5374,391,ITI,ITI2,10,Umbria,Umbria,882015,539744,61.19,0.65
2578,2021-05-20,UMB,9831,4585,5246,6193,3638,ITI,ITI2,10,Umbria,Umbria,882015,549575,62.31,1.11
2579,2021-03-31,UMB,3903,1733,2170,2216,1687,ITI,ITI2,10,Umbria,Umbria,882015,553478,62.75,0.44
2580,2021-02-16,UMB,1308,655,653,1299,9,ITI,ITI2,10,Umbria,Umbria,882015,554786,62.9,0.15
2581,2021-05-27,UMB,9934,4829,5105,8649,1285,ITI,ITI2,10,Umbria,Umbria,882015,564720,64.03,1.13
2582,2021-01-04,UMB,810,398,412,810,0,ITI,ITI2,10,Umbria,Umbria,882015,565530,64.12,0.09
2583,2021-04-14,UMB,8150,3673,4477,6171,1979,ITI,ITI2,10,Umbria,Umbria,882015,573680,65.04,0.92
2584,2021-06-03,UMB,9019,4456,4563,8750,269,ITI,ITI2,10,Umbria,Umbria,882015,582699,66.06,1.02
2585,2021-04-07,UMB,5568,2289,3279,3562,2006,ITI,ITI2,10,Umbria,Umbria,882015,588267,66.7,0.63
2586,2021-02-23,UMB,1693,658,1035,1651,42,ITI,ITI2,10,Umbria,Umbria,882015,589960,66.89,0.19
2587,2021-05-04,ABR,10690,5017,5673,7073,3617,ITF,ITF1,13,Abruzzo,Abruzzo,1304970,10690,0.82,0.82
2588,2021-03-08,ABR,5119,1666,3453,4148,971,ITF,ITF1,13,Abruzzo,Abruzzo,1304970,15809,1.21,0.39
2589,2021-01-24,ABR,50,22,28,6,44,ITF,ITF1,13,Abruzzo,Abruzzo,1304970,15859,1.22,0.0
2590,2021-03-01,ABR,3479,1386,2093,2727,752,ITF,ITF1,13,Abruzzo,Abruzzo,1304970,19338,1.48,0.27
2591,2021-03-03,ABR,4622,1881,2741,3716,906,ITF,ITF1,13,Abruzzo,Abruzzo,1304970,23960,1.84,0.35
2592,2021-04-08,ABR,7394,3336,4058,5069,2325,ITF,ITF1,13,Abruzzo,Abruzzo,1304970,31354,2.4,0.57
2593,2021-04-22,ABR,6661,3192,3469,4980,1681,ITF,ITF1,13,Abruzzo,Abruzzo,1304970,38015,2.91,0.51
2594,2021-03-22,ABR,4281,1852,2429,2310,1971,ITF,ITF1,13,Abruzzo,Abruzzo,1304970,42296,3.24,0.33
2595,2020-12-27,ABR,37,19,18,37,0,ITF,ITF1,13,Abruzzo,Abruzzo,1304970,42333,3.24,0.0
2596,2021-03-20,ABR,4787,2197,2590,2618,2169,ITF,ITF1,13,Abruzzo,Abruzzo,1304970,47120,3.61,0.37
2597,2021-01-29,ABR,1387,449,938,74,1313,ITF,ITF1,13,Abruzzo,Abruzzo,1304970,48507,3.72,0.11
2598,2021-02-22,ABR,2642,1173,1469,2612,30,ITF,ITF1,13,Abruzzo,Abruzzo,1304970,51149,3.92,0.2
2599,2021-02-05,ABR,1534,521,1013,788,746,ITF,ITF1,13,Abruzzo,Abruzzo,1304970,52683,4.04,0.12
2600,2021-05-16,ABR,9579,4138,5441,5764,3815,ITF,ITF1,13,Abruzzo,Abruzzo,1304970,62262,4.77,0.73
2601,2021-06-04,ABR,15562,7338,8224,10870,4692,ITF,ITF1,13,Abruzzo,Abruzzo,1304970,77824,5.96,1.19
2602,2021-05-18,ABR,12116,5662,6454,7732,4384,ITF,ITF1,13,Abruzzo,Abruzzo,1304970,89940,6.89,0.93
2603,2021-02-24,ABR,3305,1441,1864,3129,176,ITF,ITF1,13,Abruzzo,Abruzzo,1304970,93245,7.15,0.25
2604,2021-01-22,ABR,118,57,61,118,0,ITF,ITF1,13,Abruzzo,Abruzzo,1304970,93363,7.15,0.01
2605,2021-01-03,ABR,471,185,286,471,0,ITF,ITF1,13,Abruzzo,Abruzzo,1304970,93834,7.19,0.04
2606,2021-03-27,ABR,6121,2620,3501,3636,2485,ITF,ITF1,13,Abruzzo,Abruzzo,1304970,99955,7.66,0.47
2607,2021-01-05,ABR,1615,604,1011,1615,0,ITF,ITF1,13,Abruzzo,Abruzzo,1304970,101570,7.78,0.12
2608,2021-04-15,ABR,7820,3680,4140,5980,1840,ITF,ITF1,13,Abruzzo,Abruzzo,1304970,109390,8.38,0.6
2609,2021-01-10,ABR,1139,409,730,1139,0,ITF,ITF1,13,Abruzzo,Abruzzo,1304970,110529,8.47,0.09
2610,2021-04-29,ABR,12668,5850,6818,9573,3095,ITF,ITF1,13,Abruzzo,Abruzzo,1304970,123197,9.44,0.97
2611,2021-01-15,ABR,379,149,230,379,0,ITF,ITF1,13,Abruzzo,Abruzzo,1304970,123576,9.47,0.03
2612,2021-04-27,ABR,9085,4370,4715,6617,2468,ITF,ITF1,13,Abruzzo,Abruzzo,1304970,132661,10.17,0.7
2613,2021-03-15,ABR,3624,1389,2235,1816,1808,ITF,ITF1,13,Abruzzo,Abruzzo,1304970,136285,10.44,0.28
2614,2021-01-17,ABR,188,59,129,181,7,ITF,ITF1,13,Abruzzo,Abruzzo,1304970,136473,10.46,0.01
2615,2021-05-30,ABR,8561,4067,4494,5348,3213,ITF,ITF1,13,Abruzzo,Abruzzo,1304970,145034,11.11,0.66
2616,2021-04-03,ABR,5085,2221,2864,3489,1596,ITF,ITF1,13,Abruzzo,Abruzzo,1304970,150119,11.5,0.39
2617,2021-02-12,ABR,1228,567,661,1039,189,ITF,ITF1,13,Abruzzo,Abruzzo,1304970,151347,11.6,0.09
2618,2021-05-23,ABR,9886,4700,5186,7189,2697,ITF,ITF1,13,Abruzzo,Abruzzo,1304970,161233,12.36,0.76
2619,2021-06-06,ABR,11025,5256,5769,8832,2193,ITF,ITF1,13,Abruzzo,Abruzzo,1304970,172258,13.2,0.84
2620,2021-04-10,ABR,8772,4057,4715,6264,2508,ITF,ITF1,13,Abruzzo,Abruzzo,1304970,181030,13.87,0.67
2621,2021-02-10,ABR,947,312,635,503,444,ITF,ITF1,13,Abruzzo,Abruzzo,1304970,181977,13.94,0.07
2622,2021-02-03,ABR,2060,717,1343,419,1641,ITF,ITF1,13,Abruzzo,Abruzzo,1304970,184037,14.1,0.16
2623,2021-02-28,ABR,1702,508,1194,1700,2,ITF,ITF1,13,Abruzzo,Abruzzo,1304970,185739,14.23,0.13
2624,2021-05-27,ABR,12924,5875,7049,8243,4681,ITF,ITF1,13,Abruzzo,Abruzzo,1304970,198663,15.22,0.99
2625,2021-03-19,ABR,5794,2584,3210,2774,3020,ITF,ITF1,13,Abruzzo,Abruzzo,1304970,204457,15.67,0.44
2626,2021-03-05,ABR,5346,1958,3388,4649,697,ITF,ITF1,13,Abruzzo,Abruzzo,1304970,209803,16.08,0.41
2627,2021-04-07,ABR,7163,3293,3870,4405,2758,ITF,ITF1,13,Abruzzo,Abruzzo,1304970,216966,16.63,0.55
2628,2021-05-08,ABR,10301,4876,5425,6467,3834,ITF,ITF1,13,Abruzzo,Abruzzo,1304970,227267,17.42,0.79
2629,2021-01-19,ABR,111,55,56,91,20,ITF,ITF1,13,Abruzzo,Abruzzo,1304970,227378,17.42,0.01
2630,2021-02-07,ABR,778,307,471,201,577,ITF,ITF1,13,Abruzzo,Abruzzo,1304970,228156,17.48,0.06
2631,2021-01-21,ABR,157,47,110,157,0,ITF,ITF1,13,Abruzzo,Abruzzo,1304970,228313,17.5,0.01
2632,2021-05-01,ABR,10746,5052,5694,5772,4974,ITF,ITF1,13,Abruzzo,Abruzzo,1304970,239059,18.32,0.82
2633,2021-05-20,ABR,12553,5785,6768,7335,5218,ITF,ITF1,13,Abruzzo,Abruzzo,1304970,251612,19.28,0.96
2634,2021-02-17,ABR,2071,948,1123,1789,282,ITF,ITF1,13,Abruzzo,Abruzzo,1304970,253683,19.44,0.16
2635,2021-05-11,ABR,10739,5098,5641,5908,4831,ITF,ITF1,13,Abruzzo,Abruzzo,1304970,264422,20.26,0.82
2636,2021-04-05,ABR,2693,1147,1546,1813,880,ITF,ITF1,13,Abruzzo,Abruzzo,1304970,267115,20.47,0.21
2637,2021-01-12,ABR,1804,666,1138,1804,0,ITF,ITF1,13,Abruzzo,Abruzzo,1304970,268919,20.61,0.14
2638,2021-05-25,ABR,11248,5204,6044,8115,3133,ITF,ITF1,13,Abruzzo,Abruzzo,1304970,280167,21.47,0.86
2639,2021-02-02,ABR,1778,672,1106,222,1556,ITF,ITF1,13,Abruzzo,Abruzzo,1304970,281945,21.61,0.14
2640,2021-05-13,ABR,11148,5042,6106,7188,3960,ITF,ITF1,13,Abruzzo,Abruzzo,1304970,293093,22.46,0.85
2641,2021-03-31,ABR,6651,2881,3770,4583,2068,ITF,ITF1,13,Abruzzo,Abruzzo,1304970,299744,22.97,0.51
2642,2021-05-15,ABR,11421,5174,6247,6126,5295,ITF,ITF1,13,Abruzzo,Abruzzo,1304970,311165,23.84,0.88
2643,2021-03-10,ABR,5013,1656,3357,4057,956,ITF,ITF1,13,Abruzzo,Abruzzo,1304970,316178,24.23,0.38
2644,2021-01-26,ABR,1542,567,975,30,1512,ITF,ITF1,13,Abruzzo,Abruzzo,1304970,317720,24.35,0.12
2645,2021-05-06,ABR,13045,6111,6934,7999,5046,ITF,ITF1,13,Abruzzo,Abruzzo,1304970,330765,25.35,1.0
2646,2021-03-29,ABR,5624,2524,3100,2985,2639,ITF,ITF1,13,Abruzzo,Abruzzo,1304970,336389,25.78,0.43
2647,2021-06-03,ABR,12972,6153,6819,9269,3703,ITF,ITF1,13,Abruzzo,Abruzzo,1304970,349361,26.77,0.99
2648,2021-01-02,ABR,548,218,330,548,0,ITF,ITF1,13,Abruzzo,Abruzzo,1304970,349909,26.81,0.04
2649,2021-06-08,ABR,12698,6473,6225,10551,2147,ITF,ITF1,13,Abruzzo,Abruzzo,1304970,362607,27.79,0.97
2650,2021-04-26,ABR,8563,4066,4497,7349,1214,ITF,ITF1,13,Abruzzo,Abruzzo,1304970,371170,28.44,0.66
2651,2021-06-01,ABR,10921,4821,6100,6557,4364,ITF,ITF1,13,Abruzzo,Abruzzo,1304970,382091,29.28,0.84
2652,2021-04-19,ABR,6226,2857,3369,3855,2371,ITF,ITF1,13,Abruzzo,Abruzzo,1304970,388317,29.76,0.48
2653,2021-02-21,ABR,1218,550,668,1217,1,ITF,ITF1,13,Abruzzo,Abruzzo,1304970,389535,29.85,0.09
2654,2021-04-12,ABR,6224,2949,3275,5050,1174,ITF,ITF1,13,Abruzzo,Abruzzo,1304970,395759,30.33,0.48
2655,2021-03-17,ABR,4539,1873,2666,2799,1740,ITF,ITF1,13,Abruzzo,Abruzzo,1304970,400298,30.67,0.35
2656,2021-03-24,ABR,6385,2784,3601,4133,2252,ITF,ITF1,13,Abruzzo,Abruzzo,1304970,406683,31.16,0.49
2657,2021-02-09,ABR,908,311,597,499,409,ITF,ITF1,13,Abruzzo,Abruzzo,1304970,407591,31.23,0.07
2658,2021-04-17,ABR,7346,3398,3948,4293,3053,ITF,ITF1,13,Abruzzo,Abruzzo,1304970,414937,31.8,0.56
2659,2021-02-19,ABR,3300,1551,1749,3200,100,ITF,ITF1,13,Abruzzo,Abruzzo,1304970,418237,32.05,0.25
2660,2021-01-07,ABR,1603,552,1051,1603,0,ITF,ITF1,13,Abruzzo,Abruzzo,1304970,419840,32.17,0.12
2661,2021-04-24,ABR,8709,3970,4739,7179,1530,ITF,ITF1,13,Abruzzo,Abruzzo,1304970,428549,32.84,0.67
2662,2021-01-14,ABR,530,189,341,530,0,ITF,ITF1,13,Abruzzo,Abruzzo,1304970,429079,32.88,0.04
2663,2021-02-16,ABR,1917,842,1075,1905,12,ITF,ITF1,13,Abruzzo,Abruzzo,1304970,430996,33.03,0.15
2664,2021-03-02,ABR,3962,1675,2287,3278,684,ITF,ITF1,13,Abruzzo,Abruzzo,1304970,434958,33.33,0.3
2665,2021-01-28,ABR,1433,495,938,12,1421,ITF,ITF1,13,Abruzzo,Abruzzo,1304970,436391,33.44,0.11
2666,2021-01-31,ABR,1518,492,1026,286,1232,ITF,ITF1,13,Abruzzo,Abruzzo,1304970,437909,33.56,0.12
2667,2021-05-10,ABR,10107,4783,5324,5458,4649,ITF,ITF1,13,Abruzzo,Abruzzo,1304970,448016,34.33,0.77
2668,2021-04-23,ABR,7382,3387,3995,5080,2302,ITF,ITF1,13,Abruzzo,Abruzzo,1304970,455398,34.9,0.57
2669,2021-01-30,ABR,1510,567,943,69,1441,ITF,ITF1,13,Abruzzo,Abruzzo,1304970,456908,35.01,0.12
2670,2021-03-12,ABR,6015,1987,4028,4433,1582,ITF,ITF1,13,Abruzzo,Abruzzo,1304970,462923,35.47,0.46
2671,2021-03-14,ABR,1873,731,1142,1207,666,ITF,ITF1,13,Abruzzo,Abruzzo,1304970,464796,35.62,0.14
2672,2021-02-25,ABR,3042,1330,1712,2514,528,ITF,ITF1,13,Abruzzo,Abruzzo,1304970,467838,35.85,0.23
2673,2021-06-05,ABR,14605,6859,7746,10554,4051,ITF,ITF1,13,Abruzzo,Abruzzo,1304970,482443,36.97,1.12
2674,2021-05-17,ABR,11038,5040,5998,6179,4859,ITF,ITF1,13,Abruzzo,Abruzzo,1304970,493481,37.82,0.85
2675,2021-04-09,ABR,8796,4141,4655,6257,2539,ITF,ITF1,13,Abruzzo,Abruzzo,1304970,502277,38.49,0.67
2676,2021-04-02,ABR,6684,3093,3591,5197,1487,ITF,ITF1,13,Abruzzo,Abruzzo,1304970,508961,39.0,0.51
2677,2021-02-04,ABR,1679,615,1064,609,1070,ITF,ITF1,13,Abruzzo,Abruzzo,1304970,510640,39.13,0.13
2678,2021-03-28,ABR,2414,1016,1398,2043,371,ITF,ITF1,13,Abruzzo,Abruzzo,1304970,513054,39.32,0.18
2679,2021-04-14,ABR,6574,2939,3635,4491,2083,ITF,ITF1,13,Abruzzo,Abruzzo,1304970,519628,39.82,0.5
2680,2021-01-04,ABR,1402,575,827,1402,0,ITF,ITF1,13,Abruzzo,Abruzzo,1304970,521030,39.93,0.11
2681,2021-01-23,ABR,264,115,149,57,207,ITF,ITF1,13,Abruzzo,Abruzzo,1304970,521294,39.95,0.02
2682,2021-05-03,ABR,11107,5239,5868,7259,3848,ITF,ITF1,13,Abruzzo,Abruzzo,1304970,532401,40.8,0.85
2683,2021-01-16,ABR,930,429,501,930,0,ITF,ITF1,13,Abruzzo,Abruzzo,1304970,533331,40.87,0.07
2684,2021-03-07,ABR,2522,630,1892,2522,0,ITF,ITF1,13,Abruzzo,Abruzzo,1304970,535853,41.06,0.19
2685,2021-01-09,ABR,1483,565,918,1483,0,ITF,ITF1,13,Abruzzo,Abruzzo,1304970,537336,41.18,0.11
2686,2021-05-07,ABR,12191,5702,6489,7766,4425,ITF,ITF1,13,Abruzzo,Abruzzo,1304970,549527,42.11,0.93
2687,2021-03-25,ABR,5686,2561,3125,3070,2616,ITF,ITF1,13,Abruzzo,Abruzzo,1304970,555213,42.55,0.44
2688,2021-01-27,ABR,1364,515,849,39,1325,ITF,ITF1,13,Abruzzo,Abruzzo,1304970,556577,42.65,0.1
2689,2021-05-21,ABR,13018,6333,6685,8040,4978,ITF,ITF1,13,Abruzzo,Abruzzo,1304970,569595,43.65,1.0
2690,2021-03-18,ABR,3896,1651,2245,2065,1831,ITF,ITF1,13,Abruzzo,Abruzzo,1304970,573491,43.95,0.3
2691,2021-02-11,ABR,816,262,554,773,43,ITF,ITF1,13,Abruzzo,Abruzzo,1304970,574307,44.01,0.06
2692,2021-05-24,ABR,12181,5786,6395,8882,3299,ITF,ITF1,13,Abruzzo,Abruzzo,1304970,586488,44.94,0.93
2693,2021-02-18,ABR,2288,933,1355,2158,130,ITF,ITF1,13,Abruzzo,Abruzzo,1304970,588776,45.12,0.18
2694,2021-05-29,ABR,10178,4410,5768,4543,5635,ITF,ITF1,13,Abruzzo,Abruzzo,1304970,598954,45.9,0.78
2695,2021-01-11,ABR,1551,557,994,1551,0,ITF,ITF1,13,Abruzzo,Abruzzo,1304970,600505,46.02,0.12
2696,2021-04-21,ABR,6387,3100,3287,4713,1674,ITF,ITF1,13,Abruzzo,Abruzzo,1304970,606892,46.51,0.49
2697,2021-04-06,ABR,7681,3581,4100,5362,2319,ITF,ITF1,13,Abruzzo,Abruzzo,1304970,614573,47.09,0.59
2698,2021-05-09,ABR,9151,4087,5064,4283,4868,ITF,ITF1,13,Abruzzo,Abruzzo,1304970,623724,47.8,0.7
2699,2021-02-15,ABR,1794,831,963,1752,42,ITF,ITF1,13,Abruzzo,Abruzzo,1304970,625518,47.93,0.14
2700,2021-05-26,ABR,13323,5908,7415,8396,4927,ITF,ITF1,13,Abruzzo,Abruzzo,1304970,638841,48.95,1.02
2701,2021-02-23,ABR,2782,1275,1507,2771,11,ITF,ITF1,13,Abruzzo,Abruzzo,1304970,641623,49.17,0.21
2702,2021-02-06,ABR,1611,743,868,602,1009,ITF,ITF1,13,Abruzzo,Abruzzo,1304970,643234,49.29,0.12
2703,2021-02-08,ABR,1197,396,801,487,710,ITF,ITF1,13,Abruzzo,Abruzzo,1304970,644431,49.38,0.09
2704,2021-05-19,ABR,10693,5109,5584,7654,3039,ITF,ITF1,13,Abruzzo,Abruzzo,1304970,655124,50.2,0.82
2705,2021-04-30,ABR,12392,5803,6589,6702,5690,ITF,ITF1,13,Abruzzo,Abruzzo,1304970,667516,51.15,0.95
2706,2021-04-13,ABR,5879,2752,3127,4679,1200,ITF,ITF1,13,Abruzzo,Abruzzo,1304970,673395,51.6,0.45
2707,2021-01-20,ABR,447,156,291,445,2,ITF,ITF1,13,Abruzzo,Abruzzo,1304970,673842,51.64,0.03
2708,2021-05-02,ABR,10425,5089,5336,5215,5210,ITF,ITF1,13,Abruzzo,Abruzzo,1304970,684267,52.44,0.8
2709,2021-03-21,ABR,2135,914,1221,844,1291,ITF,ITF1,13,Abruzzo,Abruzzo,1304970,686402,52.6,0.16
2710,2021-01-13,ABR,1253,440,813,1253,0,ITF,ITF1,13,Abruzzo,Abruzzo,1304970,687655,52.7,0.1
2711,2021-02-13,ABR,852,384,468,438,414,ITF,ITF1,13,Abruzzo,Abruzzo,1304970,688507,52.76,0.07
2712,2021-03-04,ABR,5936,2360,3576,5013,923,ITF,ITF1,13,Abruzzo,Abruzzo,1304970,694443,53.22,0.45
2713,2021-04-16,ABR,7536,3488,4048,5619,1917,ITF,ITF1,13,Abruzzo,Abruzzo,1304970,701979,53.79,0.58
2714,2021-03-11,ABR,5471,2199,3272,4333,1138,ITF,ITF1,13,Abruzzo,Abruzzo,1304970,707450,54.21,0.42
2715,2021-06-02,ABR,9687,4694,4993,6876,2811,ITF,ITF1,13,Abruzzo,Abruzzo,1304970,717137,54.95,0.74
2716,2021-03-13,ABR,4124,1420,2704,3081,1043,ITF,ITF1,13,Abruzzo,Abruzzo,1304970,721261,55.27,0.32
2717,2021-03-30,ABR,5057,2198,2859,3233,1824,ITF,ITF1,13,Abruzzo,Abruzzo,1304970,726318,55.66,0.39
2718,2021-01-06,ABR,1830,664,1166,1830,0,ITF,ITF1,13,Abruzzo,Abruzzo,1304970,728148,55.8,0.14
2719,2021-05-14,ABR,10600,5076,5524,5442,5158,ITF,ITF1,13,Abruzzo,Abruzzo,1304970,738748,56.61,0.81
2720,2021-04-01,ABR,5522,2442,3080,3435,2087,ITF,ITF1,13,Abruzzo,Abruzzo,1304970,744270,57.03,0.42
2721,2021-04-04,ABR,1631,768,863,1502,129,ITF,ITF1,13,Abruzzo,Abruzzo,1304970,745901,57.16,0.12
2722,2021-02-27,ABR,2810,1337,1473,2545,265,ITF,ITF1,13,Abruzzo,Abruzzo,1304970,748711,57.37,0.22
2723,2021-06-07,ABR,11054,5280,5774,9239,1815,ITF,ITF1,13,Abruzzo,Abruzzo,1304970,759765,58.22,0.85
2724,2021-04-11,ABR,5330,2606,2724,4847,483,ITF,ITF1,13,Abruzzo,Abruzzo,1304970,765095,58.63,0.41
2725,2021-06-09,ABR,7073,3730,3343,6039,1034,ITF,ITF1,13,Abruzzo,Abruzzo,1304970,772168,59.17,0.54
2726,2021-05-28,ABR,13963,6279,7684,7613,6350,ITF,ITF1,13,Abruzzo,Abruzzo,1304970,786131,60.24,1.07
2727,2021-05-22,ABR,13072,6351,6721,8171,4901,ITF,ITF1,13,Abruzzo,Abruzzo,1304970,799203,61.24,1.0
2728,2021-03-26,ABR,5308,2266,3042,3232,2076,ITF,ITF1,13,Abruzzo,Abruzzo,1304970,804511,61.65,0.41
2729,2021-05-31,ABR,11246,5057,6189,6932,4314,ITF,ITF1,13,Abruzzo,Abruzzo,1304970,815757,62.51,0.86
2730,2021-04-20,ABR,5589,2689,2900,4179,1410,ITF,ITF1,13,Abruzzo,Abruzzo,1304970,821346,62.94,0.43
2731,2021-04-25,ABR,9066,4621,4445,8256,810,ITF,ITF1,13,Abruzzo,Abruzzo,1304970,830412,63.63,0.69
2732,2021-01-08,ABR,1525,507,1018,1525,0,ITF,ITF1,13,Abruzzo,Abruzzo,1304970,831937,63.75,0.12
2733,2021-04-18,ABR,5812,2726,3086,4870,942,ITF,ITF1,13,Abruzzo,Abruzzo,1304970,837749,64.2,0.45
2734,2021-02-20,ABR,4776,1842,2934,4700,76,ITF,ITF1,13,Abruzzo,Abruzzo,1304970,842525,64.56,0.37
2735,2021-03-06,ABR,4175,1357,2818,3605,570,ITF,ITF1,13,Abruzzo,Abruzzo,1304970,846700,64.88,0.32
2736,2021-02-26,ABR,3914,1670,2244,2946,968,ITF,ITF1,13,Abruzzo,Abruzzo,1304970,850614,65.18,0.3
2737,2021-01-18,ABR,123,49,74,46,77,ITF,ITF1,13,Abruzzo,Abruzzo,1304970,850737,65.19,0.01
2738,2021-04-28,ABR,9510,4585,4925,7486,2024,ITF,ITF1,13,Abruzzo,Abruzzo,1304970,860247,65.92,0.73
2739,2021-05-12,ABR,9615,4585,5030,6046,3569,ITF,ITF1,13,Abruzzo,Abruzzo,1304970,869862,66.66,0.74
2740,2021-03-16,ABR,3484,1452,2032,1830,1654,ITF,ITF1,13,Abruzzo,Abruzzo,1304970,873346,66.92,0.27
2741,2021-05-05,ABR,11594,5552,6042,6450,5144,ITF,ITF1,13,Abruzzo,Abruzzo,1304970,884940,67.81,0.89
2742,2021-03-09,ABR,5166,1795,3371,4228,938,ITF,ITF1,13,Abruzzo,Abruzzo,1304970,890106,68.21,0.4
2743,2021-02-01,ABR,1632,573,1059,271,1361,ITF,ITF1,13,Abruzzo,Abruzzo,1304970,891738,68.33,0.13
2744,2021-03-23,ABR,4782,2143,2639,2216,2566,ITF,ITF1,13,Abruzzo,Abruzzo,1304970,896520,68.7,0.37
2745,2021-01-25,ABR,1605,632,973,19,1586,ITF,ITF1,13,Abruzzo,Abruzzo,1304970,898125,68.82,0.12
2746,2021-05-17,LAZ,43921,20058,23863,35460,8461,ITI,ITI4,12,Lazio,Lazio,5879082,43921,0.75,0.75
2747,2021-02-06,LAZ,6137,2475,3662,817,5320,ITI,ITI4,12,Lazio,Lazio,5879082,50058,0.85,0.1
2748,2021-02-11,LAZ,6999,3013,3986,6467,532,ITI,ITI4,12,Lazio,Lazio,5879082,57057,0.97,0.12
2749,2021-04-11,LAZ,19115,8431,10684,13234,5881,ITI,ITI4,12,Lazio,Lazio,5879082,76172,1.3,0.33
2750,2021-02-13,LAZ,6609,2626,3983,6194,415,ITI,ITI4,12,Lazio,Lazio,5879082,82781,1.41,0.11
2751,2021-05-24,LAZ,42831,19180,23651,34040,8791,ITI,ITI4,12,Lazio,Lazio,5879082,125612,2.14,0.73
2752,2021-04-16,LAZ,34402,15681,18721,22335,12067,ITI,ITI4,12,Lazio,Lazio,5879082,160014,2.72,0.59
2753,2021-01-23,LAZ,7213,2869,4344,584,6629,ITI,ITI4,12,Lazio,Lazio,5879082,167227,2.84,0.12
2754,2021-01-06,LAZ,5123,1961,3162,5123,0,ITI,ITI4,12,Lazio,Lazio,5879082,172350,2.93,0.09
2755,2021-02-25,LAZ,12652,5517,7135,11602,1050,ITI,ITI4,12,Lazio,Lazio,5879082,185002,3.15,0.22
2756,2021-06-05,LAZ,65151,31947,33204,43021,22130,ITI,ITI4,12,Lazio,Lazio,5879082,250153,4.25,1.11
2757,2021-03-30,LAZ,25256,11584,13672,18108,7148,ITI,ITI4,12,Lazio,Lazio,5879082,275409,4.68,0.43
2758,2021-04-18,LAZ,23772,10556,13216,16138,7634,ITI,ITI4,12,Lazio,Lazio,5879082,299181,5.09,0.4
2759,2021-05-19,LAZ,46480,21223,25257,36650,9830,ITI,ITI4,12,Lazio,Lazio,5879082,345661,5.88,0.79
2760,2021-01-04,LAZ,7482,2908,4574,7482,0,ITI,ITI4,12,Lazio,Lazio,5879082,353143,6.01,0.13
2761,2021-06-07,LAZ,59945,27333,32612,32443,27502,ITI,ITI4,12,Lazio,Lazio,5879082,413088,7.03,1.02
2762,2021-02-18,LAZ,10018,4976,5042,9209,809,ITI,ITI4,12,Lazio,Lazio,5879082,423106,7.2,0.17
2763,2021-05-12,LAZ,47408,21475,25933,30880,16528,ITI,ITI4,12,Lazio,Lazio,5879082,470514,8.0,0.81
2764,2021-02-01,LAZ,5675,2177,3498,354,5321,ITI,ITI4,12,Lazio,Lazio,5879082,476189,8.1,0.1
2765,2021-01-13,LAZ,5692,2150,3542,5692,0,ITI,ITI4,12,Lazio,Lazio,5879082,481881,8.2,0.1
2766,2021-04-23,LAZ,37658,18083,19575,22404,15254,ITI,ITI4,12,Lazio,Lazio,5879082,519539,8.84,0.64
2767,2021-01-30,LAZ,7010,2892,4118,807,6203,ITI,ITI4,12,Lazio,Lazio,5879082,526549,8.96,0.12
2768,2021-05-26,LAZ,46098,20601,25497,34930,11168,ITI,ITI4,12,Lazio,Lazio,5879082,572647,9.74,0.78
2769,2021-03-04,LAZ,18657,8015,10642,13640,5017,ITI,ITI4,12,Lazio,Lazio,5879082,591304,10.06,0.32
2770,2021-03-21,LAZ,17863,6827,11036,12812,5051,ITI,ITI4,12,Lazio,Lazio,5879082,609167,10.36,0.3
2771,2020-12-30,LAZ,1630,629,1001,1630,0,ITI,ITI4,12,Lazio,Lazio,5879082,610797,10.39,0.03
2772,2021-04-09,LAZ,27316,12278,15038,19076,8240,ITI,ITI4,12,Lazio,Lazio,5879082,638113,10.85,0.46
2773,2021-03-23,LAZ,23504,10229,13275,16927,6577,ITI,ITI4,12,Lazio,Lazio,5879082,661617,11.25,0.4
2774,2021-02-20,LAZ,9206,4274,4932,8438,768,ITI,ITI4,12,Lazio,Lazio,5879082,670823,11.41,0.16
2775,2021-05-31,LAZ,49698,21315,28383,31269,18429,ITI,ITI4,12,Lazio,Lazio,5879082,720521,12.26,0.85
2776,2021-04-04,LAZ,17463,8036,9427,12197,5266,ITI,ITI4,12,Lazio,Lazio,5879082,737984,12.55,0.3
2777,2021-03-16,LAZ,13537,5732,7805,7093,6444,ITI,ITI4,12,Lazio,Lazio,5879082,751521,12.78,0.23
2778,2021-03-09,LAZ,20873,8939,11934,15676,5197,ITI,ITI4,12,Lazio,Lazio,5879082,772394,13.14,0.36
2779,2021-01-11,LAZ,5531,2105,3426,5531,0,ITI,ITI4,12,Lazio,Lazio,5879082,777925,13.23,0.09
2780,2021-01-25,LAZ,8111,3246,4865,770,7341,ITI,ITI4,12,Lazio,Lazio,5879082,786036,13.37,0.14
2781,2021-05-05,LAZ,46731,21435,25296,30912,15819,ITI,ITI4,12,Lazio,Lazio,5879082,832767,14.16,0.79
2782,2021-04-30,LAZ,41247,18262,22985,27073,14174,ITI,ITI4,12,Lazio,Lazio,5879082,874014,14.87,0.7
2783,2021-05-07,LAZ,48166,22577,25589,30440,17726,ITI,ITI4,12,Lazio,Lazio,5879082,922180,15.69,0.82
2784,2021-03-11,LAZ,23829,10597,13232,17599,6230,ITI,ITI4,12,Lazio,Lazio,5879082,946009,16.09,0.41
2785,2021-03-13,LAZ,21473,8441,13032,15579,5894,ITI,ITI4,12,Lazio,Lazio,5879082,967482,16.46,0.37
2786,2021-02-08,LAZ,9740,4153,5587,4508,5232,ITI,ITI4,12,Lazio,Lazio,5879082,977222,16.62,0.17
2787,2021-05-02,LAZ,32629,14336,18293,23268,9361,ITI,ITI4,12,Lazio,Lazio,5879082,1009851,17.18,0.56
2788,2021-01-22,LAZ,4004,1635,2369,489,3515,ITI,ITI4,12,Lazio,Lazio,5879082,1013855,17.25,0.07
2789,2021-02-27,LAZ,11426,4268,7158,10471,955,ITI,ITI4,12,Lazio,Lazio,5879082,1025281,17.44,0.19
2790,2021-01-15,LAZ,6577,2705,3872,6577,0,ITI,ITI4,12,Lazio,Lazio,5879082,1031858,17.55,0.11
2791,2021-04-25,LAZ,24512,11242,13270,16701,7811,ITI,ITI4,12,Lazio,Lazio,5879082,1056370,17.97,0.42
2792,2021-04-06,LAZ,23883,10654,13229,16775,7108,ITI,ITI4,12,Lazio,Lazio,5879082,1080253,18.37,0.41
2793,2020-12-27,LAZ,274,132,142,274,0,ITI,ITI4,12,Lazio,Lazio,5879082,1080527,18.38,0.0
2794,2021-03-20,LAZ,18226,6811,11415,12342,5884,ITI,ITI4,12,Lazio,Lazio,5879082,1098753,18.69,0.31
2795,2021-04-01,LAZ,28406,13044,15362,21266,7140,ITI,ITI4,12,Lazio,Lazio,5879082,1127159,19.17,0.48
2796,2021-04-15,LAZ,31906,14299,17607,21101,10805,ITI,ITI4,12,Lazio,Lazio,5879082,1159065,19.72,0.54
2797,2021-02-10,LAZ,8187,3398,4789,4849,3338,ITI,ITI4,12,Lazio,Lazio,5879082,1167252,19.85,0.14
2798,2021-01-03,LAZ,5251,1973,3278,5251,0,ITI,ITI4,12,Lazio,Lazio,5879082,1172503,19.94,0.09
2799,2021-04-13,LAZ,25670,11872,13798,17957,7713,ITI,ITI4,12,Lazio,Lazio,5879082,1198173,20.38,0.44
2800,2021-01-08,LAZ,7729,2895,4834,7729,0,ITI,ITI4,12,Lazio,Lazio,5879082,1205902,20.51,0.13
2801,2021-02-15,LAZ,8025,3539,4486,7394,631,ITI,ITI4,12,Lazio,Lazio,5879082,1213927,20.65,0.14
2802,2021-01-29,LAZ,8042,3079,4963,813,7229,ITI,ITI4,12,Lazio,Lazio,5879082,1221969,20.79,0.14
2803,2021-02-17,LAZ,9181,4603,4578,8307,874,ITI,ITI4,12,Lazio,Lazio,5879082,1231150,20.94,0.16
2804,2021-05-28,LAZ,55927,25582,30345,43429,12498,ITI,ITI4,12,Lazio,Lazio,5879082,1287077,21.89,0.95
2805,2021-03-06,LAZ,18334,7065,11269,14077,4257,ITI,ITI4,12,Lazio,Lazio,5879082,1305411,22.2,0.31
2806,2021-02-03,LAZ,6487,2487,4000,963,5524,ITI,ITI4,12,Lazio,Lazio,5879082,1311898,22.31,0.11
2807,2021-01-20,LAZ,4806,1942,2864,3263,1543,ITI,ITI4,12,Lazio,Lazio,5879082,1316704,22.4,0.08
2808,2021-05-14,LAZ,50949,23246,27703,32733,18216,ITI,ITI4,12,Lazio,Lazio,5879082,1367653,23.26,0.87
2809,2021-03-18,LAZ,14225,6077,8148,7835,6390,ITI,ITI4,12,Lazio,Lazio,5879082,1381878,23.5,0.24
2810,2021-03-28,LAZ,18836,7541,11295,13526,5310,ITI,ITI4,12,Lazio,Lazio,5879082,1400714,23.83,0.32
2811,2021-06-09,LAZ,51035,23457,27578,27537,23498,ITI,ITI4,12,Lazio,Lazio,5879082,1451749,24.69,0.87
2812,2021-04-27,LAZ,30636,13826,16810,19792,10844,ITI,ITI4,12,Lazio,Lazio,5879082,1482385,25.21,0.52
2813,2021-03-01,LAZ,17092,7346,9746,13207,3885,ITI,ITI4,12,Lazio,Lazio,5879082,1499477,25.51,0.29
2814,2021-02-22,LAZ,11455,4989,6466,10953,502,ITI,ITI4,12,Lazio,Lazio,5879082,1510932,25.7,0.19
2815,2021-06-02,LAZ,43135,21400,21735,31729,11406,ITI,ITI4,12,Lazio,Lazio,5879082,1554067,26.43,0.73
2816,2021-03-02,LAZ,16988,7430,9558,13054,3934,ITI,ITI4,12,Lazio,Lazio,5879082,1571055,26.72,0.29
2817,2021-01-18,LAZ,6268,2557,3711,5290,978,ITI,ITI4,12,Lazio,Lazio,5879082,1577323,26.83,0.11
2818,2021-04-28,LAZ,32866,15003,17863,21317,11549,ITI,ITI4,12,Lazio,Lazio,5879082,1610189,27.39,0.56
2819,2021-03-27,LAZ,26020,10402,15618,19549,6471,ITI,ITI4,12,Lazio,Lazio,5879082,1636209,27.83,0.44
2820,2021-05-23,LAZ,47026,22786,24240,39685,7341,ITI,ITI4,12,Lazio,Lazio,5879082,1683235,28.63,0.8
2821,2021-05-09,LAZ,37527,17250,20277,26260,11267,ITI,ITI4,12,Lazio,Lazio,5879082,1720762,29.27,0.64
2822,2021-05-16,LAZ,50898,24508,26390,37423,13475,ITI,ITI4,12,Lazio,Lazio,5879082,1771660,30.13,0.87
2823,2021-05-20,LAZ,50707,24196,26511,37433,13274,ITI,ITI4,12,Lazio,Lazio,5879082,1822367,31.0,0.86
2824,2021-06-06,LAZ,57713,27750,29963,35353,22360,ITI,ITI4,12,Lazio,Lazio,5879082,1880080,31.98,0.98
2825,2021-02-26,LAZ,13076,5700,7376,11714,1362,ITI,ITI4,12,Lazio,Lazio,5879082,1893156,32.2,0.22
2826,2021-05-01,LAZ,37938,17077,20861,25987,11951,ITI,ITI4,12,Lazio,Lazio,5879082,1931094,32.85,0.65
2827,2021-04-17,LAZ,32319,14182,18137,20363,11956,ITI,ITI4,12,Lazio,Lazio,5879082,1963413,33.4,0.55
2828,2021-05-21,LAZ,50282,23638,26644,37407,12875,ITI,ITI4,12,Lazio,Lazio,5879082,2013695,34.25,0.86
2829,2021-06-04,LAZ,59745,28782,30963,42985,16760,ITI,ITI4,12,Lazio,Lazio,5879082,2073440,35.27,1.02
2830,2021-05-04,LAZ,39766,18287,21479,26287,13479,ITI,ITI4,12,Lazio,Lazio,5879082,2113206,35.94,0.68
2831,2021-02-24,LAZ,12045,5204,6841,11051,994,ITI,ITI4,12,Lazio,Lazio,5879082,2125251,36.15,0.2
2832,2021-03-29,LAZ,23962,10759,13203,16924,7038,ITI,ITI4,12,Lazio,Lazio,5879082,2149213,36.56,0.41
2833,2021-03-15,LAZ,19278,8334,10944,12539,6739,ITI,ITI4,12,Lazio,Lazio,5879082,2168491,36.88,0.33
2834,2021-01-31,LAZ,4460,1854,2606,477,3983,ITI,ITI4,12,Lazio,Lazio,5879082,2172951,36.96,0.08
2835,2021-05-11,LAZ,48111,22071,26040,31709,16402,ITI,ITI4,12,Lazio,Lazio,5879082,2221062,37.78,0.82
2836,2021-04-24,LAZ,33343,15030,18313,20593,12750,ITI,ITI4,12,Lazio,Lazio,5879082,2254405,38.35,0.57
2837,2021-05-30,LAZ,41074,17536,23538,33820,7254,ITI,ITI4,12,Lazio,Lazio,5879082,2295479,39.04,0.7
2838,2021-05-13,LAZ,49605,22221,27384,31959,17646,ITI,ITI4,12,Lazio,Lazio,5879082,2345084,39.89,0.84
2839,2021-01-01,LAZ,3554,1382,2172,3554,0,ITI,ITI4,12,Lazio,Lazio,5879082,2348638,39.95,0.06
2840,2021-01-10,LAZ,4039,1700,2339,4039,0,ITI,ITI4,12,Lazio,Lazio,5879082,2352677,40.02,0.07
2841,2021-04-20,LAZ,31002,14229,16773,19719,11283,ITI,ITI4,12,Lazio,Lazio,5879082,2383679,40.55,0.53
2842,2021-03-08,LAZ,20070,8319,11751,14797,5273,ITI,ITI4,12,Lazio,Lazio,5879082,2403749,40.89,0.34
2843,2021-04-22,LAZ,38538,18933,19605,23956,14582,ITI,ITI4,12,Lazio,Lazio,5879082,2442287,41.54,0.66
2844,2021-03-10,LAZ,22021,9490,12531,16375,5646,ITI,ITI4,12,Lazio,Lazio,5879082,2464308,41.92,0.37
2845,2021-01-12,LAZ,5413,1981,3432,5413,0,ITI,ITI4,12,Lazio,Lazio,5879082,2469721,42.01,0.09
2846,2021-03-17,LAZ,13788,5896,7892,7533,6255,ITI,ITI4,12,Lazio,Lazio,5879082,2483509,42.24,0.23
2847,2021-04-08,LAZ,26654,12175,14479,18971,7683,ITI,ITI4,12,Lazio,Lazio,5879082,2510163,42.7,0.45
2848,2021-03-25,LAZ,26918,11512,15406,20314,6604,ITI,ITI4,12,Lazio,Lazio,5879082,2537081,43.15,0.46
2849,2021-01-27,LAZ,6114,2387,3727,997,5117,ITI,ITI4,12,Lazio,Lazio,5879082,2543195,43.26,0.1
2850,2021-06-01,LAZ,47561,22552,25009,29901,17660,ITI,ITI4,12,Lazio,Lazio,5879082,2590756,44.07,0.81
2851,2021-04-05,LAZ,19768,8991,10777,13590,6178,ITI,ITI4,12,Lazio,Lazio,5879082,2610524,44.4,0.34
2852,2021-05-25,LAZ,46228,21214,25014,35444,10784,ITI,ITI4,12,Lazio,Lazio,5879082,2656752,45.19,0.79
2853,2021-04-12,LAZ,23760,10677,13083,16862,6898,ITI,ITI4,12,Lazio,Lazio,5879082,2680512,45.59,0.4
2854,2021-06-08,LAZ,63674,29530,34144,35589,28085,ITI,ITI4,12,Lazio,Lazio,5879082,2744186,46.68,1.08
2855,2021-01-09,LAZ,6297,2562,3735,6297,0,ITI,ITI4,12,Lazio,Lazio,5879082,2750483,46.78,0.11
2856,2021-04-19,LAZ,30059,13661,16398,19381,10678,ITI,ITI4,12,Lazio,Lazio,5879082,2780542,47.3,0.51
2857,2021-02-21,LAZ,6988,3179,3809,6525,463,ITI,ITI4,12,Lazio,Lazio,5879082,2787530,47.41,0.12
2858,2021-02-14,LAZ,5774,2371,3403,5303,471,ITI,ITI4,12,Lazio,Lazio,5879082,2793304,47.51,0.1
2859,2021-05-06,LAZ,48631,22616,26015,31106,17525,ITI,ITI4,12,Lazio,Lazio,5879082,2841935,48.34,0.83
2860,2021-01-17,LAZ,4894,2028,2866,4682,212,ITI,ITI4,12,Lazio,Lazio,5879082,2846829,48.42,0.08
2861,2021-01-19,LAZ,4768,1954,2814,4314,454,ITI,ITI4,12,Lazio,Lazio,5879082,2851597,48.5,0.08
2862,2021-04-29,LAZ,38597,17223,21374,25369,13228,ITI,ITI4,12,Lazio,Lazio,5879082,2890194,49.16,0.66
2863,2021-03-03,LAZ,17395,7438,9957,13101,4294,ITI,ITI4,12,Lazio,Lazio,5879082,2907589,49.46,0.3
2864,2021-03-12,LAZ,22923,10143,12780,16609,6314,ITI,ITI4,12,Lazio,Lazio,5879082,2930512,49.85,0.39
2865,2021-02-09,LAZ,8798,3768,5030,4580,4218,ITI,ITI4,12,Lazio,Lazio,5879082,2939310,50.0,0.15
2866,2021-02-23,LAZ,11087,4780,6307,10325,762,ITI,ITI4,12,Lazio,Lazio,5879082,2950397,50.18,0.19
2867,2021-01-21,LAZ,5602,2349,3253,549,5053,ITI,ITI4,12,Lazio,Lazio,5879082,2955999,50.28,0.1
2868,2021-03-31,LAZ,26113,12049,14064,19020,7093,ITI,ITI4,12,Lazio,Lazio,5879082,2982112,50.72,0.44
2869,2021-01-07,LAZ,7747,2902,4845,7747,0,ITI,ITI4,12,Lazio,Lazio,5879082,2989859,50.86,0.13
2870,2021-01-14,LAZ,5482,2144,3338,5482,0,ITI,ITI4,12,Lazio,Lazio,5879082,2995341,50.95,0.09
2871,2021-04-07,LAZ,24962,11322,13640,17656,7306,ITI,ITI4,12,Lazio,Lazio,5879082,3020303,51.37,0.42
2872,2020-12-28,LAZ,959,412,547,959,0,ITI,ITI4,12,Lazio,Lazio,5879082,3021262,51.39,0.02
2873,2021-01-16,LAZ,5646,2281,3365,5646,0,ITI,ITI4,12,Lazio,Lazio,5879082,3026908,51.49,0.1
2874,2021-04-26,LAZ,29187,13433,15754,19985,9202,ITI,ITI4,12,Lazio,Lazio,5879082,3056095,51.98,0.5
2875,2021-02-02,LAZ,5910,2213,3697,638,5272,ITI,ITI4,12,Lazio,Lazio,5879082,3062005,52.08,0.1
2876,2021-01-05,LAZ,7374,2802,4572,7374,0,ITI,ITI4,12,Lazio,Lazio,5879082,3069379,52.21,0.13
2877,2021-01-24,LAZ,5694,2229,3465,612,5082,ITI,ITI4,12,Lazio,Lazio,5879082,3075073,52.31,0.1
2878,2021-02-07,LAZ,4944,2025,2919,387,4557,ITI,ITI4,12,Lazio,Lazio,5879082,3080017,52.39,0.08
2879,2021-05-18,LAZ,44257,20169,24088,34914,9343,ITI,ITI4,12,Lazio,Lazio,5879082,3124274,53.14,0.75
2880,2021-05-03,LAZ,39135,17653,21482,26556,12579,ITI,ITI4,12,Lazio,Lazio,5879082,3163409,53.81,0.67
2881,2021-03-14,LAZ,17102,6614,10488,11948,5154,ITI,ITI4,12,Lazio,Lazio,5879082,3180511,54.1,0.29
2882,2021-03-22,LAZ,21710,9070,12640,15045,6665,ITI,ITI4,12,Lazio,Lazio,5879082,3202221,54.47,0.37
2883,2020-12-29,LAZ,488,176,312,488,0,ITI,ITI4,12,Lazio,Lazio,5879082,3202709,54.48,0.01
2884,2021-03-07,LAZ,14109,5442,8667,10516,3593,ITI,ITI4,12,Lazio,Lazio,5879082,3216818,54.72,0.24
2885,2021-03-24,LAZ,25899,11307,14592,19662,6237,ITI,ITI4,12,Lazio,Lazio,5879082,3242717,55.16,0.44
2886,2021-05-29,LAZ,51333,22897,28436,40920,10413,ITI,ITI4,12,Lazio,Lazio,5879082,3294050,56.03,0.87
2887,2021-05-10,LAZ,44365,20261,24104,30990,13375,ITI,ITI4,12,Lazio,Lazio,5879082,3338415,56.78,0.75
2888,2021-05-27,LAZ,56306,25444,30862,43878,12428,ITI,ITI4,12,Lazio,Lazio,5879082,3394721,57.74,0.96
2889,2021-03-05,LAZ,18792,7961,10831,14059,4733,ITI,ITI4,12,Lazio,Lazio,5879082,3413513,58.06,0.32
2890,2021-02-16,LAZ,8355,4034,4321,7750,605,ITI,ITI4,12,Lazio,Lazio,5879082,3421868,58.2,0.14
2891,2021-02-28,LAZ,10248,4007,6241,9734,514,ITI,ITI4,12,Lazio,Lazio,5879082,3432116,58.38,0.17
2892,2021-01-02,LAZ,6707,2631,4076,6707,0,ITI,ITI4,12,Lazio,Lazio,5879082,3438823,58.49,0.11
2893,2021-02-04,LAZ,6302,2481,3821,987,5315,ITI,ITI4,12,Lazio,Lazio,5879082,3445125,58.6,0.11
2894,2021-01-26,LAZ,7958,3125,4833,724,7234,ITI,ITI4,12,Lazio,Lazio,5879082,3453083,58.74,0.14
2895,2021-04-02,LAZ,28550,13376,15174,21220,7330,ITI,ITI4,12,Lazio,Lazio,5879082,3481633,59.22,0.49
2896,2021-01-28,LAZ,8279,3165,5114,782,7497,ITI,ITI4,12,Lazio,Lazio,5879082,3489912,59.36,0.14
2897,2021-05-08,LAZ,45187,20616,24571,29817,15370,ITI,ITI4,12,Lazio,Lazio,5879082,3535099,60.13,0.77
2898,2021-03-26,LAZ,28229,12253,15976,21385,6844,ITI,ITI4,12,Lazio,Lazio,5879082,3563328,60.61,0.48
2899,2021-05-22,LAZ,54753,26709,28044,44256,10497,ITI,ITI4,12,Lazio,Lazio,5879082,3618081,61.54,0.93
2900,2021-05-15,LAZ,57083,27260,29823,40629,16454,ITI,ITI4,12,Lazio,Lazio,5879082,3675164,62.51,0.97
2901,2021-03-19,LAZ,17214,7364,9850,10886,6328,ITI,ITI4,12,Lazio,Lazio,5879082,3692378,62.81,0.29
2902,2021-02-12,LAZ,6846,2847,3999,6432,414,ITI,ITI4,12,Lazio,Lazio,5879082,3699224,62.92,0.12
2903,2020-12-31,LAZ,5293,2121,3172,5293,0,ITI,ITI4,12,Lazio,Lazio,5879082,3704517,63.01,0.09
2904,2021-04-10,LAZ,23811,10314,13497,16629,7182,ITI,ITI4,12,Lazio,Lazio,5879082,3728328,63.42,0.41
2905,2021-02-05,LAZ,7279,2961,4318,1184,6095,ITI,ITI4,12,Lazio,Lazio,5879082,3735607,63.54,0.12
2906,2021-04-03,LAZ,24688,11093,13595,17989,6699,ITI,ITI4,12,Lazio,Lazio,5879082,3760295,63.96,0.42
2907,2021-02-19,LAZ,10046,5080,4966,9215,831,ITI,ITI4,12,Lazio,Lazio,5879082,3770341,64.13,0.17
2908,2021-04-21,LAZ,32982,14974,18008,20616,12366,ITI,ITI4,12,Lazio,Lazio,5879082,3803323,64.69,0.56
2909,2021-06-03,LAZ,54536,27078,27458,38189,16347,ITI,ITI4,12,Lazio,Lazio,5879082,3857859,65.62,0.93
2910,2021-04-14,LAZ,29275,13262,16013,19154,10121,ITI,ITI4,12,Lazio,Lazio,5879082,3887134,66.12,0.5
2911,2021-05-27,MAR,13730,6817,6913,9429,4301,ITI,ITI3,11,Marche,Marche,1525271,13730,0.9,0.9
2912,2021-03-31,MAR,7374,3086,4288,4350,3024,ITI,ITI3,11,Marche,Marche,1525271,21104,1.38,0.48
2913,2021-03-29,MAR,5860,2567,3293,3435,2425,ITI,ITI3,11,Marche,Marche,1525271,26964,1.77,0.38
2914,2021-03-24,MAR,7033,2984,4049,3365,3668,ITI,ITI3,11,Marche,Marche,1525271,33997,2.23,0.46
2915,2021-06-01,MAR,12053,6155,5898,9962,2091,ITI,ITI3,11,Marche,Marche,1525271,46050,3.02,0.79
2916,2021-03-10,MAR,5666,2400,3266,4529,1137,ITI,ITI3,11,Marche,Marche,1525271,51716,3.39,0.37
2917,2021-02-21,MAR,376,141,235,375,1,ITI,ITI3,11,Marche,Marche,1525271,52092,3.42,0.02
2918,2021-01-19,MAR,228,83,145,142,86,ITI,ITI3,11,Marche,Marche,1525271,52320,3.43,0.01
2919,2021-02-02,MAR,1191,397,794,72,1119,ITI,ITI3,11,Marche,Marche,1525271,53511,3.51,0.08
2920,2021-05-13,MAR,12601,5694,6907,7102,5499,ITI,ITI3,11,Marche,Marche,1525271,66112,4.33,0.83
2921,2021-04-12,MAR,8567,3772,4795,8083,484,ITI,ITI3,11,Marche,Marche,1525271,74679,4.9,0.56
2922,2021-05-15,MAR,13967,6376,7591,8078,5889,ITI,ITI3,11,Marche,Marche,1525271,88646,5.81,0.92
2923,2021-02-19,MAR,1962,712,1250,1827,135,ITI,ITI3,11,Marche,Marche,1525271,90608,5.94,0.13
2924,2020-12-31,MAR,387,181,206,387,0,ITI,ITI3,11,Marche,Marche,1525271,90995,5.97,0.03
2925,2021-04-05,MAR,5688,2355,3333,4419,1269,ITI,ITI3,11,Marche,Marche,1525271,96683,6.34,0.37
2926,2021-03-19,MAR,3835,1597,2238,339,3496,ITI,ITI3,11,Marche,Marche,1525271,100518,6.59,0.25
2927,2021-03-17,MAR,3428,1494,1934,107,3321,ITI,ITI3,11,Marche,Marche,1525271,103946,6.81,0.22
2928,2021-02-28,MAR,2836,1251,1585,2830,6,ITI,ITI3,11,Marche,Marche,1525271,106782,7.0,0.19
2929,2021-06-08,MAR,13917,7015,6902,11305,2612,ITI,ITI3,11,Marche,Marche,1525271,120699,7.91,0.91
2930,2021-01-26,MAR,2019,748,1271,91,1928,ITI,ITI3,11,Marche,Marche,1525271,122718,8.05,0.13
2931,2021-04-19,MAR,9601,4497,5104,8020,1581,ITI,ITI3,11,Marche,Marche,1525271,132319,8.68,0.63
2932,2021-02-14,MAR,738,301,437,738,0,ITI,ITI3,11,Marche,Marche,1525271,133057,8.72,0.05
2933,2021-05-08,MAR,12268,5476,6792,5021,7247,ITI,ITI3,11,Marche,Marche,1525271,145325,9.53,0.8
2934,2021-05-20,MAR,12365,5814,6551,7666,4699,ITI,ITI3,11,Marche,Marche,1525271,157690,10.34,0.81
2935,2021-02-07,MAR,1870,734,1136,344,1526,ITI,ITI3,11,Marche,Marche,1525271,159560,10.46,0.12
2936,2021-01-31,MAR,1918,769,1149,103,1815,ITI,ITI3,11,Marche,Marche,1525271,161478,10.59,0.13
2937,2021-04-07,MAR,7810,3435,4375,7475,335,ITI,ITI3,11,Marche,Marche,1525271,169288,11.1,0.51
2938,2021-02-09,MAR,124,42,82,46,78,ITI,ITI3,11,Marche,Marche,1525271,169412,11.11,0.01
2939,2021-01-21,MAR,906,259,647,585,321,ITI,ITI3,11,Marche,Marche,1525271,170318,11.17,0.06
2940,2021-05-01,MAR,9318,3924,5394,3576,5742,ITI,ITI3,11,Marche,Marche,1525271,179636,11.78,0.61
2941,2021-03-05,MAR,6171,2856,3315,4703,1468,ITI,ITI3,11,Marche,Marche,1525271,185807,12.18,0.4
2942,2021-01-07,MAR,1808,636,1172,1808,0,ITI,ITI3,11,Marche,Marche,1525271,187615,12.3,0.12
2943,2021-01-12,MAR,1227,413,814,1227,0,ITI,ITI3,11,Marche,Marche,1525271,188842,12.38,0.08
2944,2021-04-26,MAR,8980,3983,4997,5958,3022,ITI,ITI3,11,Marche,Marche,1525271,197822,12.97,0.59
2945,2021-01-23,MAR,557,190,367,123,434,ITI,ITI3,11,Marche,Marche,1525271,198379,13.01,0.04
2946,2021-05-03,MAR,10196,4605,5591,4790,5406,ITI,ITI3,11,Marche,Marche,1525271,208575,13.67,0.67
2947,2021-02-04,MAR,2341,809,1532,112,2229,ITI,ITI3,11,Marche,Marche,1525271,210916,13.83,0.15
2948,2021-01-18,MAR,677,233,444,547,130,ITI,ITI3,11,Marche,Marche,1525271,211593,13.87,0.04
2949,2021-04-28,MAR,10734,4890,5844,6003,4731,ITI,ITI3,11,Marche,Marche,1525271,222327,14.58,0.7
2950,2021-03-26,MAR,6331,2606,3725,3523,2808,ITI,ITI3,11,Marche,Marche,1525271,228658,14.99,0.42
2951,2021-03-02,MAR,4953,1941,3012,4387,566,ITI,ITI3,11,Marche,Marche,1525271,233611,15.32,0.32
2952,2021-05-24,MAR,10796,5111,5685,8122,2674,ITI,ITI3,11,Marche,Marche,1525271,244407,16.02,0.71
2953,2021-05-22,MAR,11933,5718,6215,7485,4448,ITI,ITI3,11,Marche,Marche,1525271,256340,16.81,0.78
2954,2021-02-11,MAR,1987,657,1330,1598,389,ITI,ITI3,11,Marche,Marche,1525271,258327,16.94,0.13
2955,2021-01-02,MAR,454,139,315,454,0,ITI,ITI3,11,Marche,Marche,1525271,258781,16.97,0.03
2956,2021-03-07,MAR,5179,2106,3073,4425,754,ITI,ITI3,11,Marche,Marche,1525271,263960,17.31,0.34
2957,2021-01-16,MAR,2034,732,1302,2034,0,ITI,ITI3,11,Marche,Marche,1525271,265994,17.44,0.13
2958,2021-06-03,MAR,14648,7480,7168,12385,2263,ITI,ITI3,11,Marche,Marche,1525271,280642,18.4,0.96
2959,2021-02-18,MAR,2101,745,1356,1815,286,ITI,ITI3,11,Marche,Marche,1525271,282743,18.54,0.14
2960,2021-05-29,MAR,12789,6195,6594,8261,4528,ITI,ITI3,11,Marche,Marche,1525271,295532,19.38,0.84
2961,2021-02-16,MAR,1288,475,813,1258,30,ITI,ITI3,11,Marche,Marche,1525271,296820,19.46,0.08
2962,2021-02-25,MAR,3510,1434,2076,3331,179,ITI,ITI3,11,Marche,Marche,1525271,300330,19.69,0.23
2963,2021-06-05,MAR,13856,6963,6893,11796,2060,ITI,ITI3,11,Marche,Marche,1525271,314186,20.6,0.91
2964,2021-04-23,MAR,11159,5140,6019,8104,3055,ITI,ITI3,11,Marche,Marche,1525271,325345,21.33,0.73
2965,2021-01-09,MAR,1710,605,1105,1710,0,ITI,ITI3,11,Marche,Marche,1525271,327055,21.44,0.11
2966,2021-04-02,MAR,6875,2973,3902,6135,740,ITI,ITI3,11,Marche,Marche,1525271,333930,21.89,0.45
2967,2021-03-16,MAR,3471,1485,1986,290,3181,ITI,ITI3,11,Marche,Marche,1525271,337401,22.12,0.23
2968,2021-01-11,MAR,1176,411,765,1176,0,ITI,ITI3,11,Marche,Marche,1525271,338577,22.2,0.08
2969,2021-04-21,MAR,10781,4967,5814,9587,1194,ITI,ITI3,11,Marche,Marche,1525271,349358,22.9,0.71
2970,2021-01-28,MAR,2086,725,1361,165,1921,ITI,ITI3,11,Marche,Marche,1525271,351444,23.04,0.14
2971,2021-03-28,MAR,4126,1739,2387,2435,1691,ITI,ITI3,11,Marche,Marche,1525271,355570,23.31,0.27
2972,2021-01-30,MAR,1907,668,1239,29,1878,ITI,ITI3,11,Marche,Marche,1525271,357477,23.44,0.13
2973,2021-05-10,MAR,9447,4336,5111,4895,4552,ITI,ITI3,11,Marche,Marche,1525271,366924,24.06,0.62
2974,2021-03-14,MAR,2500,1032,1468,1907,593,ITI,ITI3,11,Marche,Marche,1525271,369424,24.22,0.16
2975,2021-03-21,MAR,4506,1873,2633,1630,2876,ITI,ITI3,11,Marche,Marche,1525271,373930,24.52,0.3
2976,2021-04-16,MAR,10082,4702,5380,9557,525,ITI,ITI3,11,Marche,Marche,1525271,384012,25.18,0.66
2977,2021-01-04,MAR,1506,568,938,1506,0,ITI,ITI3,11,Marche,Marche,1525271,385518,25.28,0.1
2978,2021-04-14,MAR,10214,4563,5651,9842,372,ITI,ITI3,11,Marche,Marche,1525271,395732,25.95,0.67
2979,2020-12-30,MAR,17,5,12,17,0,ITI,ITI3,11,Marche,Marche,1525271,395749,25.95,0.0
2980,2021-04-09,MAR,9560,4189,5371,9360,200,ITI,ITI3,11,Marche,Marche,1525271,405309,26.57,0.63
2981,2021-03-12,MAR,4640,1972,2668,3402,1238,ITI,ITI3,11,Marche,Marche,1525271,409949,26.88,0.3
2982,2021-01-14,MAR,2010,692,1318,2010,0,ITI,ITI3,11,Marche,Marche,1525271,411959,27.01,0.13
2983,2021-04-24,MAR,12022,5303,6719,7558,4464,ITI,ITI3,11,Marche,Marche,1525271,423981,27.8,0.79
2984,2021-02-26,MAR,3630,1499,2131,3154,476,ITI,ITI3,11,Marche,Marche,1525271,427611,28.04,0.24
2985,2021-05-12,MAR,10422,4685,5737,4922,5500,ITI,ITI3,11,Marche,Marche,1525271,438033,28.72,0.68
2986,2021-03-09,MAR,5428,2290,3138,4548,880,ITI,ITI3,11,Marche,Marche,1525271,443461,29.07,0.36
2987,2021-04-13,MAR,9838,4259,5579,9605,233,ITI,ITI3,11,Marche,Marche,1525271,453299,29.72,0.65
2988,2021-06-02,MAR,11904,5943,5961,11227,677,ITI,ITI3,11,Marche,Marche,1525271,465203,30.5,0.78
2989,2021-02-22,MAR,3414,1499,1915,3339,75,ITI,ITI3,11,Marche,Marche,1525271,468617,30.72,0.22
2990,2021-05-31,MAR,11779,5941,5838,8851,2928,ITI,ITI3,11,Marche,Marche,1525271,480396,31.5,0.77
2991,2021-05-17,MAR,11854,5568,6286,7691,4163,ITI,ITI3,11,Marche,Marche,1525271,492250,32.27,0.78
2992,2021-04-30,MAR,13939,6100,7839,5398,8541,ITI,ITI3,11,Marche,Marche,1525271,506189,33.19,0.91
2993,2021-04-11,MAR,7116,3115,4001,6830,286,ITI,ITI3,11,Marche,Marche,1525271,513305,33.65,0.47
2994,2021-03-11,MAR,6591,2784,3807,5221,1370,ITI,ITI3,11,Marche,Marche,1525271,519896,34.09,0.43
2995,2021-03-25,MAR,6656,2772,3884,3247,3409,ITI,ITI3,11,Marche,Marche,1525271,526552,34.52,0.44
2996,2021-04-04,MAR,3824,1792,2032,2655,1169,ITI,ITI3,11,Marche,Marche,1525271,530376,34.77,0.25
2997,2021-06-09,MAR,9624,4994,4630,8140,1484,ITI,ITI3,11,Marche,Marche,1525271,540000,35.4,0.63
2998,2021-06-07,MAR,13159,6497,6662,10708,2451,ITI,ITI3,11,Marche,Marche,1525271,553159,36.27,0.86
2999,2021-02-27,MAR,3356,1435,1921,3147,209,ITI,ITI3,11,Marche,Marche,1525271,556515,36.49,0.22
3000,2021-02-23,MAR,3267,1397,1870,3211,56,ITI,ITI3,11,Marche,Marche,1525271,559782,36.7,0.21
3001,2021-01-15,MAR,1771,500,1271,1771,0,ITI,ITI3,11,Marche,Marche,1525271,561553,36.82,0.12
3002,2021-04-25,MAR,8599,3993,4606,7024,1575,ITI,ITI3,11,Marche,Marche,1525271,570152,37.38,0.56
3003,2021-01-13,MAR,2105,746,1359,2105,0,ITI,ITI3,11,Marche,Marche,1525271,572257,37.52,0.14
3004,2021-05-05,MAR,11647,5300,6347,5218,6429,ITI,ITI3,11,Marche,Marche,1525271,583904,38.28,0.76
3005,2021-05-07,MAR,12838,5805,7033,3660,9178,ITI,ITI3,11,Marche,Marche,1525271,596742,39.12,0.84
3006,2021-02-13,MAR,1093,462,631,1011,82,ITI,ITI3,11,Marche,Marche,1525271,597835,39.2,0.07
3007,2021-01-27,MAR,2122,783,1339,122,2000,ITI,ITI3,11,Marche,Marche,1525271,599957,39.33,0.14
3008,2021-04-20,MAR,10696,4995,5701,9279,1417,ITI,ITI3,11,Marche,Marche,1525271,610653,40.04,0.7
3009,2021-01-25,MAR,1597,559,1038,96,1501,ITI,ITI3,11,Marche,Marche,1525271,612250,40.14,0.1
3010,2021-02-06,MAR,2462,902,1560,522,1940,ITI,ITI3,11,Marche,Marche,1525271,614712,40.3,0.16
3011,2021-05-21,MAR,12951,6113,6838,6695,6256,ITI,ITI3,11,Marche,Marche,1525271,627663,41.15,0.85
3012,2021-05-28,MAR,13955,6735,7220,9097,4858,ITI,ITI3,11,Marche,Marche,1525271,641618,42.07,0.91
3013,2021-04-01,MAR,7576,3182,4394,4160,3416,ITI,ITI3,11,Marche,Marche,1525271,649194,42.56,0.5
3014,2021-04-22,MAR,10795,4930,5865,9217,1578,ITI,ITI3,11,Marche,Marche,1525271,659989,43.27,0.71
3015,2021-02-24,MAR,3486,1515,1971,3408,78,ITI,ITI3,11,Marche,Marche,1525271,663475,43.5,0.23
3016,2021-06-04,MAR,14339,7291,7048,11900,2439,ITI,ITI3,11,Marche,Marche,1525271,677814,44.44,0.94
3017,2021-04-08,MAR,7521,3285,4236,7194,327,ITI,ITI3,11,Marche,Marche,1525271,685335,44.93,0.49
3018,2021-03-03,MAR,6646,3046,3600,5762,884,ITI,ITI3,11,Marche,Marche,1525271,691981,45.37,0.44
3019,2021-01-05,MAR,1564,587,977,1564,0,ITI,ITI3,11,Marche,Marche,1525271,693545,45.47,0.1
3020,2021-01-06,MAR,2186,796,1390,2186,0,ITI,ITI3,11,Marche,Marche,1525271,695731,45.61,0.14
3021,2021-03-04,MAR,6487,2869,3618,5094,1393,ITI,ITI3,11,Marche,Marche,1525271,702218,46.04,0.43
3022,2021-03-13,MAR,5766,2656,3110,1809,3957,ITI,ITI3,11,Marche,Marche,1525271,707984,46.42,0.38
3023,2021-05-09,MAR,8769,3985,4784,3638,5131,ITI,ITI3,11,Marche,Marche,1525271,716753,46.99,0.57
3024,2021-03-06,MAR,5699,2622,3077,4432,1267,ITI,ITI3,11,Marche,Marche,1525271,722452,47.37,0.37
3025,2021-03-27,MAR,7380,3074,4306,5022,2358,ITI,ITI3,11,Marche,Marche,1525271,729832,47.85,0.48
3026,2021-04-10,MAR,10916,4620,6296,10603,313,ITI,ITI3,11,Marche,Marche,1525271,740748,48.57,0.72
3027,2021-01-03,MAR,906,354,552,906,0,ITI,ITI3,11,Marche,Marche,1525271,741654,48.62,0.06
3028,2021-03-08,MAR,6264,2744,3520,5262,1002,ITI,ITI3,11,Marche,Marche,1525271,747918,49.04,0.41
3029,2021-02-05,MAR,2154,653,1501,439,1715,ITI,ITI3,11,Marche,Marche,1525271,750072,49.18,0.14
3030,2021-05-16,MAR,10898,4957,5941,6670,4228,ITI,ITI3,11,Marche,Marche,1525271,760970,49.89,0.71
3031,2021-05-30,MAR,9736,4690,5046,6747,2989,ITI,ITI3,11,Marche,Marche,1525271,770706,50.53,0.64
3032,2021-04-27,MAR,9399,4309,5090,5413,3986,ITI,ITI3,11,Marche,Marche,1525271,780105,51.15,0.62
3033,2021-01-17,MAR,1609,688,921,1550,59,ITI,ITI3,11,Marche,Marche,1525271,781714,51.25,0.11
3034,2021-03-18,MAR,3389,1475,1914,162,3227,ITI,ITI3,11,Marche,Marche,1525271,785103,51.47,0.22
3035,2021-05-23,MAR,9208,4282,4926,7537,1671,ITI,ITI3,11,Marche,Marche,1525271,794311,52.08,0.6
3036,2021-05-06,MAR,12655,5820,6835,5582,7073,ITI,ITI3,11,Marche,Marche,1525271,806966,52.91,0.83
3037,2021-02-12,MAR,1582,618,964,1430,152,ITI,ITI3,11,Marche,Marche,1525271,808548,53.01,0.1
3038,2021-02-10,MAR,1439,452,987,1080,359,ITI,ITI3,11,Marche,Marche,1525271,809987,53.1,0.09
3039,2021-05-25,MAR,11647,5745,5902,8717,2930,ITI,ITI3,11,Marche,Marche,1525271,821634,53.87,0.76
3040,2021-03-01,MAR,3724,1487,2237,3476,248,ITI,ITI3,11,Marche,Marche,1525271,825358,54.11,0.24
3041,2021-02-20,MAR,4121,1705,2416,4010,111,ITI,ITI3,11,Marche,Marche,1525271,829479,54.38,0.27
3042,2021-01-20,MAR,403,100,303,384,19,ITI,ITI3,11,Marche,Marche,1525271,829882,54.41,0.03
3043,2021-02-03,MAR,2124,741,1383,119,2005,ITI,ITI3,11,Marche,Marche,1525271,832006,54.55,0.14
3044,2021-05-14,MAR,13493,6218,7275,6720,6773,ITI,ITI3,11,Marche,Marche,1525271,845499,55.43,0.88
3045,2021-01-08,MAR,1578,590,988,1578,0,ITI,ITI3,11,Marche,Marche,1525271,847077,55.54,0.1
3046,2021-04-18,MAR,8820,4131,4689,7899,921,ITI,ITI3,11,Marche,Marche,1525271,855897,56.11,0.58
3047,2021-01-10,MAR,1739,700,1039,1739,0,ITI,ITI3,11,Marche,Marche,1525271,857636,56.23,0.11
3048,2021-04-03,MAR,7573,3204,4369,6903,670,ITI,ITI3,11,Marche,Marche,1525271,865209,56.72,0.5
3049,2021-04-15,MAR,10376,4674,5702,9811,565,ITI,ITI3,11,Marche,Marche,1525271,875585,57.41,0.68
3050,2021-02-17,MAR,1786,662,1124,1669,117,ITI,ITI3,11,Marche,Marche,1525271,877371,57.52,0.12
3051,2021-05-02,MAR,8899,3936,4963,3161,5738,ITI,ITI3,11,Marche,Marche,1525271,886270,58.11,0.58
3052,2021-03-22,MAR,5658,2379,3279,2530,3128,ITI,ITI3,11,Marche,Marche,1525271,891928,58.48,0.37
3053,2021-01-24,MAR,890,345,545,5,885,ITI,ITI3,11,Marche,Marche,1525271,892818,58.54,0.06
3054,2021-05-04,MAR,10845,4789,6056,4950,5895,ITI,ITI3,11,Marche,Marche,1525271,903663,59.25,0.71
3055,2021-04-29,MAR,13246,6061,7185,7149,6097,ITI,ITI3,11,Marche,Marche,1525271,916909,60.11,0.87
3056,2021-01-29,MAR,1992,731,1261,167,1825,ITI,ITI3,11,Marche,Marche,1525271,918901,60.25,0.13
3057,2021-05-18,MAR,11059,5257,5802,7655,3404,ITI,ITI3,11,Marche,Marche,1525271,929960,60.97,0.73
3058,2021-05-11,MAR,10622,4832,5790,5678,4944,ITI,ITI3,11,Marche,Marche,1525271,940582,61.67,0.7
3059,2021-03-15,MAR,4401,2026,2375,1311,3090,ITI,ITI3,11,Marche,Marche,1525271,944983,61.96,0.29
3060,2021-03-20,MAR,4134,1739,2395,1048,3086,ITI,ITI3,11,Marche,Marche,1525271,949117,62.23,0.27
3061,2021-01-22,MAR,487,167,320,194,293,ITI,ITI3,11,Marche,Marche,1525271,949604,62.26,0.03
3062,2021-02-15,MAR,967,412,555,954,13,ITI,ITI3,11,Marche,Marche,1525271,950571,62.32,0.06
3063,2021-05-26,MAR,11803,5916,5887,8620,3183,ITI,ITI3,11,Marche,Marche,1525271,962374,63.1,0.77
3064,2021-03-30,MAR,7419,3044,4375,4604,2815,ITI,ITI3,11,Marche,Marche,1525271,969793,63.58,0.49
3065,2021-02-01,MAR,1362,479,883,98,1264,ITI,ITI3,11,Marche,Marche,1525271,971155,63.67,0.09
3066,2021-04-06,MAR,8879,3693,5186,8066,813,ITI,ITI3,11,Marche,Marche,1525271,980034,64.25,0.58
3067,2021-03-23,MAR,5789,2529,3260,2262,3527,ITI,ITI3,11,Marche,Marche,1525271,985823,64.63,0.38
3068,2021-02-08,MAR,833,258,575,371,462,ITI,ITI3,11,Marche,Marche,1525271,986656,64.69,0.05
3069,2021-05-19,MAR,11469,5272,6197,8561,2908,ITI,ITI3,11,Marche,Marche,1525271,998125,65.44,0.75
3070,2021-04-17,MAR,11700,5316,6384,10627,1073,ITI,ITI3,11,Marche,Marche,1525271,1009825,66.21,0.77
3071,2020-12-27,MAR,202,98,104,202,0,ITI,ITI3,11,Marche,Marche,1525271,1010027,66.22,0.01
3072,2021-06-06,MAR,12299,6074,6225,10810,1489,ITI,ITI3,11,Marche,Marche,1525271,1022326,67.03,0.81
3073,2021-02-11,CAM,6278,2704,3574,6212,66,ITF,ITF3,15,Campania,Campania,5801692,6278,0.11,0.11
3074,2021-04-16,CAM,34304,16552,17752,23646,10658,ITF,ITF3,15,Campania,Campania,5801692,40582,0.7,0.59
3075,2021-01-06,CAM,7652,3749,3903,7652,0,ITF,ITF3,15,Campania,Campania,5801692,48234,0.83,0.13
3076,2021-05-24,CAM,31077,14899,16178,16187,14890,ITF,ITF3,15,Campania,Campania,5801692,79311,1.37,0.54
3077,2021-02-13,CAM,5508,2550,2958,5291,217,ITF,ITF3,15,Campania,Campania,5801692,84819,1.46,0.09
3078,2021-04-23,CAM,32302,15509,16793,23161,9141,ITF,ITF3,15,Campania,Campania,5801692,117121,2.02,0.56
3079,2021-03-02,CAM,12757,4554,8203,8412,4345,ITF,ITF3,15,Campania,Campania,5801692,129878,2.24,0.22
3080,2021-01-11,CAM,4072,1871,2201,4072,0,ITF,ITF3,15,Campania,Campania,5801692,133950,2.31,0.07
3081,2021-05-26,CAM,52363,25582,26781,21457,30906,ITF,ITF3,15,Campania,Campania,5801692,186313,3.21,0.9
3082,2021-04-11,CAM,17523,8606,8917,15441,2082,ITF,ITF3,15,Campania,Campania,5801692,203836,3.51,0.3
3083,2021-04-28,CAM,36412,17621,18791,26662,9750,ITF,ITF3,15,Campania,Campania,5801692,240248,4.14,0.63
3084,2021-01-18,CAM,957,399,558,713,244,ITF,ITF3,15,Campania,Campania,5801692,241205,4.16,0.02
3085,2021-05-17,CAM,49228,21608,27620,24088,25140,ITF,ITF3,15,Campania,Campania,5801692,290433,5.01,0.85
3086,2021-02-06,CAM,5340,2665,2675,2102,3238,ITF,ITF3,15,Campania,Campania,5801692,295773,5.1,0.09
3087,2021-04-30,CAM,42242,20136,22106,25794,16448,ITF,ITF3,15,Campania,Campania,5801692,338015,5.83,0.73
3088,2021-02-04,CAM,7943,3429,4514,1308,6635,ITF,ITF3,15,Campania,Campania,5801692,345958,5.96,0.14
3089,2021-03-28,CAM,15552,7501,8051,13927,1625,ITF,ITF3,15,Campania,Campania,5801692,361510,6.23,0.27
3090,2021-01-04,CAM,5825,2962,2863,5825,0,ITF,ITF3,15,Campania,Campania,5801692,367335,6.33,0.1
3091,2021-03-09,CAM,13881,6637,7244,10096,3785,ITF,ITF3,15,Campania,Campania,5801692,381216,6.57,0.24
3092,2021-05-31,CAM,40079,20079,20000,30073,10006,ITF,ITF3,15,Campania,Campania,5801692,421295,7.26,0.69
3093,2021-06-07,CAM,55236,26336,28900,51598,3638,ITF,ITF3,15,Campania,Campania,5801692,476531,8.21,0.95
3094,2021-02-25,CAM,12425,4478,7947,11237,1188,ITF,ITF3,15,Campania,Campania,5801692,488956,8.43,0.21
3095,2021-04-09,CAM,29847,13965,15882,23719,6128,ITF,ITF3,15,Campania,Campania,5801692,518803,8.94,0.51
3096,2021-06-05,CAM,76894,37176,39718,70960,5934,ITF,ITF3,15,Campania,Campania,5801692,595697,10.27,1.33
3097,2021-03-16,CAM,8087,3519,4568,3773,4314,ITF,ITF3,15,Campania,Campania,5801692,603784,10.41,0.14
3098,2021-01-25,CAM,5745,2927,2818,164,5581,ITF,ITF3,15,Campania,Campania,5801692,609529,10.51,0.1
3099,2021-03-23,CAM,15335,7055,8280,12822,2513,ITF,ITF3,15,Campania,Campania,5801692,624864,10.77,0.26
3100,2021-05-19,CAM,51016,22493,28523,34516,16500,ITF,ITF3,15,Campania,Campania,5801692,675880,11.65,0.88
3101,2021-05-05,CAM,51154,24850,26304,44775,6379,ITF,ITF3,15,Campania,Campania,5801692,727034,12.53,0.88
3102,2021-01-30,CAM,10721,5079,5642,38,10683,ITF,ITF3,15,Campania,Campania,5801692,737755,12.72,0.18
3103,2021-01-16,CAM,3369,1675,1694,3369,0,ITF,ITF3,15,Campania,Campania,5801692,741124,12.77,0.06
3104,2021-01-23,CAM,3838,2028,1810,273,3565,ITF,ITF3,15,Campania,Campania,5801692,744962,12.84,0.07
3105,2021-03-21,CAM,9983,4591,5392,7593,2390,ITF,ITF3,15,Campania,Campania,5801692,754945,13.01,0.17
3106,2021-02-10,CAM,6904,3413,3491,6728,176,ITF,ITF3,15,Campania,Campania,5801692,761849,13.13,0.12
3107,2021-04-08,CAM,28271,13639,14632,22435,5836,ITF,ITF3,15,Campania,Campania,5801692,790120,13.62,0.49
3108,2021-06-04,CAM,73761,35240,38521,65063,8698,ITF,ITF3,15,Campania,Campania,5801692,863881,14.89,1.27
3109,2021-04-06,CAM,24371,11420,12951,19847,4524,ITF,ITF3,15,Campania,Campania,5801692,888252,15.31,0.42
3110,2020-12-27,CAM,720,422,298,720,0,ITF,ITF3,15,Campania,Campania,5801692,888972,15.32,0.01
3111,2021-04-20,CAM,32036,15498,16538,20727,11309,ITF,ITF3,15,Campania,Campania,5801692,921008,15.87,0.55
3112,2021-03-20,CAM,13880,6428,7452,10141,3739,ITF,ITF3,15,Campania,Campania,5801692,934888,16.11,0.24
3113,2021-02-15,CAM,5470,2516,2954,5297,173,ITF,ITF3,15,Campania,Campania,5801692,940358,16.21,0.09
3114,2021-06-09,CAM,34006,16500,17506,26721,7285,ITF,ITF3,15,Campania,Campania,5801692,974364,16.79,0.59
3115,2021-01-01,CAM,919,506,413,919,0,ITF,ITF3,15,Campania,Campania,5801692,975283,16.81,0.02
3116,2021-03-25,CAM,19992,9336,10656,16489,3503,ITF,ITF3,15,Campania,Campania,5801692,995275,17.15,0.34
3117,2021-01-20,CAM,1257,650,607,1257,0,ITF,ITF3,15,Campania,Campania,5801692,996532,17.18,0.02
3118,2021-04-04,CAM,7962,4014,3948,6918,1044,ITF,ITF3,15,Campania,Campania,5801692,1004494,17.31,0.14
3119,2021-03-04,CAM,14658,5352,9306,8765,5893,ITF,ITF3,15,Campania,Campania,5801692,1019152,17.57,0.25
3120,2021-05-07,CAM,59723,29185,30538,43779,15944,ITF,ITF3,15,Campania,Campania,5801692,1078875,18.6,1.03
3121,2021-01-27,CAM,7738,3820,3918,162,7576,ITF,ITF3,15,Campania,Campania,5801692,1086613,18.73,0.13
3122,2021-03-18,CAM,12172,5378,6794,5984,6188,ITF,ITF3,15,Campania,Campania,5801692,1098785,18.94,0.21
3123,2021-02-18,CAM,9080,3812,5268,8372,708,ITF,ITF3,15,Campania,Campania,5801692,1107865,19.1,0.16
3124,2021-04-25,CAM,30731,15171,15560,25339,5392,ITF,ITF3,15,Campania,Campania,5801692,1138596,19.63,0.53
3125,2021-01-13,CAM,8020,3666,4354,8020,0,ITF,ITF3,15,Campania,Campania,5801692,1146616,19.76,0.14
3126,2021-04-18,CAM,27216,13281,13935,18318,8898,ITF,ITF3,15,Campania,Campania,5801692,1173832,20.23,0.47
3127,2021-01-08,CAM,10454,4967,5487,10454,0,ITF,ITF3,15,Campania,Campania,5801692,1184286,20.41,0.18
3128,2021-04-27,CAM,32131,15598,16533,24211,7920,ITF,ITF3,15,Campania,Campania,5801692,1216417,20.97,0.55
3129,2021-06-02,CAM,42732,20102,22630,38105,4627,ITF,ITF3,15,Campania,Campania,5801692,1259149,21.7,0.74
3130,2021-02-22,CAM,10680,3294,7386,10417,263,ITF,ITF3,15,Campania,Campania,5801692,1269829,21.89,0.18
3131,2021-03-11,CAM,17584,8672,8912,10306,7278,ITF,ITF3,15,Campania,Campania,5801692,1287413,22.19,0.3
3132,2021-05-16,CAM,51118,23199,27919,33572,17546,ITF,ITF3,15,Campania,Campania,5801692,1338531,23.07,0.88
3133,2021-02-20,CAM,8573,3080,5493,8270,303,ITF,ITF3,15,Campania,Campania,5801692,1347104,23.22,0.15
3134,2021-02-03,CAM,8903,4003,4900,878,8025,ITF,ITF3,15,Campania,Campania,5801692,1356007,23.37,0.15
3135,2021-05-21,CAM,63385,29339,34046,43178,20207,ITF,ITF3,15,Campania,Campania,5801692,1419392,24.47,1.09
3136,2021-04-01,CAM,24338,11687,12651,20205,4133,ITF,ITF3,15,Campania,Campania,5801692,1443730,24.88,0.42
3137,2021-05-28,CAM,72252,34638,37614,26640,45612,ITF,ITF3,15,Campania,Campania,5801692,1515982,26.13,1.25
3138,2021-05-14,CAM,60804,27472,33332,36312,24492,ITF,ITF3,15,Campania,Campania,5801692,1576786,27.18,1.05
3139,2021-02-27,CAM,13950,4473,9477,12308,1642,ITF,ITF3,15,Campania,Campania,5801692,1590736,27.42,0.24
3140,2021-05-02,CAM,43492,21539,21953,32138,11354,ITF,ITF3,15,Campania,Campania,5801692,1634228,28.17,0.75
3141,2021-01-22,CAM,1524,776,748,673,851,ITF,ITF3,15,Campania,Campania,5801692,1635752,28.19,0.03
3142,2021-03-06,CAM,16308,6753,9555,10639,5669,ITF,ITF3,15,Campania,Campania,5801692,1652060,28.48,0.28
3143,2021-05-12,CAM,40832,19923,20909,31692,9140,ITF,ITF3,15,Campania,Campania,5801692,1692892,29.18,0.7
3144,2021-02-08,CAM,5113,2449,2664,4310,803,ITF,ITF3,15,Campania,Campania,5801692,1698005,29.27,0.09
3145,2021-03-01,CAM,12130,4247,7883,8017,4113,ITF,ITF3,15,Campania,Campania,5801692,1710135,29.48,0.21
3146,2021-05-09,CAM,43170,20272,22898,32078,11092,ITF,ITF3,15,Campania,Campania,5801692,1753305,30.22,0.74
3147,2021-01-10,CAM,8165,3736,4429,8165,0,ITF,ITF3,15,Campania,Campania,5801692,1761470,30.36,0.14
3148,2021-04-03,CAM,21115,10315,10800,18735,2380,ITF,ITF3,15,Campania,Campania,5801692,1782585,30.73,0.36
3149,2021-05-23,CAM,58714,28617,30097,37837,20877,ITF,ITF3,15,Campania,Campania,5801692,1841299,31.74,1.01
3150,2021-02-12,CAM,6529,2861,3668,6343,186,ITF,ITF3,15,Campania,Campania,5801692,1847828,31.85,0.11
3151,2021-04-05,CAM,11639,5544,6095,9216,2423,ITF,ITF3,15,Campania,Campania,5801692,1859467,32.05,0.2
3152,2021-03-17,CAM,11588,5099,6489,5008,6580,ITF,ITF3,15,Campania,Campania,5801692,1871055,32.25,0.2
3153,2021-03-03,CAM,13921,5494,8427,7291,6630,ITF,ITF3,15,Campania,Campania,5801692,1884976,32.49,0.24
3154,2021-05-25,CAM,45967,21932,24035,22884,23083,ITF,ITF3,15,Campania,Campania,5801692,1930943,33.28,0.79
3155,2021-05-18,CAM,52070,23148,28922,32506,19564,ITF,ITF3,15,Campania,Campania,5801692,1983013,34.18,0.9
3156,2021-02-05,CAM,7260,3463,3797,2133,5127,ITF,ITF3,15,Campania,Campania,5801692,1990273,34.31,0.13
3157,2021-04-29,CAM,41296,20009,21287,24821,16475,ITF,ITF3,15,Campania,Campania,5801692,2031569,35.02,0.71
3158,2021-01-19,CAM,1095,474,621,1092,3,ITF,ITF3,15,Campania,Campania,5801692,2032664,35.04,0.02
3159,2021-01-15,CAM,4980,2381,2599,4980,0,ITF,ITF3,15,Campania,Campania,5801692,2037644,35.12,0.09
3160,2021-03-13,CAM,14253,6797,7456,8971,5282,ITF,ITF3,15,Campania,Campania,5801692,2051897,35.37,0.25
3161,2021-03-22,CAM,12740,5921,6819,10700,2040,ITF,ITF3,15,Campania,Campania,5801692,2064637,35.59,0.22
3162,2021-02-07,CAM,2929,1382,1547,2158,771,ITF,ITF3,15,Campania,Campania,5801692,2067566,35.64,0.05
3163,2021-04-13,CAM,26601,12682,13919,21071,5530,ITF,ITF3,15,Campania,Campania,5801692,2094167,36.1,0.46
3164,2021-01-03,CAM,3836,2009,1827,3836,0,ITF,ITF3,15,Campania,Campania,5801692,2098003,36.16,0.07
3165,2021-03-29,CAM,18947,9134,9813,17401,1546,ITF,ITF3,15,Campania,Campania,5801692,2116950,36.49,0.33
3166,2021-02-24,CAM,11785,4149,7636,11097,688,ITF,ITF3,15,Campania,Campania,5801692,2128735,36.69,0.2
3167,2021-01-05,CAM,7237,3637,3600,7237,0,ITF,ITF3,15,Campania,Campania,5801692,2135972,36.82,0.12
3168,2021-02-17,CAM,7388,3210,4178,6328,1060,ITF,ITF3,15,Campania,Campania,5801692,2143360,36.94,0.13
3169,2021-04-15,CAM,34337,16659,17678,24439,9898,ITF,ITF3,15,Campania,Campania,5801692,2177697,37.54,0.59
3170,2021-03-14,CAM,8501,3721,4780,4362,4139,ITF,ITF3,15,Campania,Campania,5801692,2186198,37.68,0.15
3171,2021-05-10,CAM,35416,16374,19042,25498,9918,ITF,ITF3,15,Campania,Campania,5801692,2221614,38.29,0.61
3172,2021-06-08,CAM,51008,24649,26359,44313,6695,ITF,ITF3,15,Campania,Campania,5801692,2272622,39.17,0.88
3173,2021-04-26,CAM,34022,16644,17378,28400,5622,ITF,ITF3,15,Campania,Campania,5801692,2306644,39.76,0.59
3174,2021-03-08,CAM,14542,6717,7825,9766,4776,ITF,ITF3,15,Campania,Campania,5801692,2321186,40.01,0.25
3175,2021-05-04,CAM,48468,23340,25128,39571,8897,ITF,ITF3,15,Campania,Campania,5801692,2369654,40.84,0.84
3176,2021-01-24,CAM,4122,2119,2003,377,3745,ITF,ITF3,15,Campania,Campania,5801692,2373776,40.92,0.07
3177,2021-05-13,CAM,55417,24816,30601,39424,15993,ITF,ITF3,15,Campania,Campania,5801692,2429193,41.87,0.96
3178,2021-01-31,CAM,8067,3711,4356,23,8044,ITF,ITF3,15,Campania,Campania,5801692,2437260,42.01,0.14
3179,2021-01-29,CAM,10052,4812,5240,47,10005,ITF,ITF3,15,Campania,Campania,5801692,2447312,42.18,0.17
3180,2021-03-19,CAM,11038,4871,6167,7166,3872,ITF,ITF3,15,Campania,Campania,5801692,2458350,42.37,0.19
3181,2021-05-08,CAM,56359,27103,29256,40535,15824,ITF,ITF3,15,Campania,Campania,5801692,2514709,43.34,0.97
3182,2021-01-28,CAM,8832,4121,4711,134,8698,ITF,ITF3,15,Campania,Campania,5801692,2523541,43.5,0.15
3183,2021-04-21,CAM,30228,14725,15503,18001,12227,ITF,ITF3,15,Campania,Campania,5801692,2553769,44.02,0.52
3184,2021-01-21,CAM,2092,1115,977,676,1416,ITF,ITF3,15,Campania,Campania,5801692,2555861,44.05,0.04
3185,2021-04-14,CAM,27637,13330,14307,19070,8567,ITF,ITF3,15,Campania,Campania,5801692,2583498,44.53,0.48
3186,2021-05-01,CAM,46334,22659,23675,30231,16103,ITF,ITF3,15,Campania,Campania,5801692,2629832,45.33,0.8
3187,2021-04-12,CAM,23299,10917,12382,20263,3036,ITF,ITF3,15,Campania,Campania,5801692,2653131,45.73,0.4
3188,2021-01-02,CAM,3672,1962,1710,3672,0,ITF,ITF3,15,Campania,Campania,5801692,2656803,45.79,0.06
3189,2021-03-26,CAM,19459,8930,10529,15645,3814,ITF,ITF3,15,Campania,Campania,5801692,2676262,46.13,0.34
3190,2021-04-22,CAM,33941,16531,17410,21538,12403,ITF,ITF3,15,Campania,Campania,5801692,2710203,46.71,0.59
3191,2021-01-12,CAM,5214,2563,2651,5214,0,ITF,ITF3,15,Campania,Campania,5801692,2715417,46.8,0.09
3192,2021-05-06,CAM,57261,27897,29364,42820,14441,ITF,ITF3,15,Campania,Campania,5801692,2772678,47.79,0.99
3193,2021-02-28,CAM,10411,3206,7205,8511,1900,ITF,ITF3,15,Campania,Campania,5801692,2783089,47.97,0.18
3194,2021-02-14,CAM,3928,1923,2005,3894,34,ITF,ITF3,15,Campania,Campania,5801692,2787017,48.04,0.07
3195,2021-03-27,CAM,21283,10034,11249,17418,3865,ITF,ITF3,15,Campania,Campania,5801692,2808300,48.4,0.37
3196,2021-06-01,CAM,41372,20340,21032,31255,10117,ITF,ITF3,15,Campania,Campania,5801692,2849672,49.12,0.71
3197,2021-03-10,CAM,15254,7381,7873,8419,6835,ITF,ITF3,15,Campania,Campania,5801692,2864926,49.38,0.26
3198,2021-05-15,CAM,62590,29021,33569,43910,18680,ITF,ITF3,15,Campania,Campania,5801692,2927516,50.46,1.08
3199,2021-03-12,CAM,14249,7097,7152,8166,6083,ITF,ITF3,15,Campania,Campania,5801692,2941765,50.71,0.25
3200,2021-06-03,CAM,71764,34485,37279,61607,10157,ITF,ITF3,15,Campania,Campania,5801692,3013529,51.94,1.24
3201,2021-02-23,CAM,11003,3388,7615,10477,526,ITF,ITF3,15,Campania,Campania,5801692,3024532,52.13,0.19
3202,2021-02-21,CAM,5834,2239,3595,5609,225,ITF,ITF3,15,Campania,Campania,5801692,3030366,52.23,0.1
3203,2021-03-07,CAM,11911,5344,6567,8068,3843,ITF,ITF3,15,Campania,Campania,5801692,3042277,52.44,0.21
3204,2021-05-03,CAM,40754,19889,20865,28905,11849,ITF,ITF3,15,Campania,Campania,5801692,3083031,53.14,0.7
3205,2021-01-17,CAM,1155,551,604,702,453,ITF,ITF3,15,Campania,Campania,5801692,3084186,53.16,0.02
3206,2021-03-15,CAM,12932,6088,6844,8187,4745,ITF,ITF3,15,Campania,Campania,5801692,3097118,53.38,0.22
3207,2021-05-27,CAM,72110,34649,37461,26018,46092,ITF,ITF3,15,Campania,Campania,5801692,3169228,54.63,1.24
3208,2021-02-16,CAM,5440,2411,3029,4669,771,ITF,ITF3,15,Campania,Campania,5801692,3174668,54.72,0.09
3209,2021-05-22,CAM,67842,32442,35400,46441,21401,ITF,ITF3,15,Campania,Campania,5801692,3242510,55.89,1.17
3210,2021-01-26,CAM,7340,3726,3614,351,6989,ITF,ITF3,15,Campania,Campania,5801692,3249850,56.02,0.13
3211,2021-04-19,CAM,30734,14819,15915,19167,11567,ITF,ITF3,15,Campania,Campania,5801692,3280584,56.55,0.53
3212,2021-01-09,CAM,10567,5024,5543,10567,0,ITF,ITF3,15,Campania,Campania,5801692,3291151,56.73,0.18
3213,2021-05-11,CAM,39829,19228,20601,30459,9370,ITF,ITF3,15,Campania,Campania,5801692,3330980,57.41,0.69
3214,2021-02-02,CAM,5723,2804,2919,444,5279,ITF,ITF3,15,Campania,Campania,5801692,3336703,57.51,0.1
3215,2021-03-31,CAM,22688,10907,11781,19249,3439,ITF,ITF3,15,Campania,Campania,5801692,3359391,57.9,0.39
3216,2021-04-07,CAM,24758,11781,12977,20036,4722,ITF,ITF3,15,Campania,Campania,5801692,3384149,58.33,0.43
3217,2021-04-02,CAM,21732,10411,11321,19411,2321,ITF,ITF3,15,Campania,Campania,5801692,3405881,58.7,0.37
3218,2021-03-24,CAM,17622,8082,9540,14665,2957,ITF,ITF3,15,Campania,Campania,5801692,3423503,59.01,0.3
3219,2021-05-20,CAM,60457,27824,32633,43078,17379,ITF,ITF3,15,Campania,Campania,5801692,3483960,60.05,1.04
3220,2021-02-09,CAM,4643,2202,2441,4391,252,ITF,ITF3,15,Campania,Campania,5801692,3488603,60.13,0.08
3221,2021-05-29,CAM,67673,32154,35519,43925,23748,ITF,ITF3,15,Campania,Campania,5801692,3556276,61.3,1.17
3222,2021-02-01,CAM,3985,1813,2172,110,3875,ITF,ITF3,15,Campania,Campania,5801692,3560261,61.37,0.07
3223,2021-03-30,CAM,21729,10271,11458,18771,2958,ITF,ITF3,15,Campania,Campania,5801692,3581990,61.74,0.37
3224,2021-04-17,CAM,36173,17507,18666,24667,11506,ITF,ITF3,15,Campania,Campania,5801692,3618163,62.36,0.62
3225,2021-05-30,CAM,52080,25385,26695,38835,13245,ITF,ITF3,15,Campania,Campania,5801692,3670243,63.26,0.9
3226,2021-02-19,CAM,9570,3559,6011,8920,650,ITF,ITF3,15,Campania,Campania,5801692,3679813,63.43,0.16
3227,2020-12-31,CAM,1490,811,679,1490,0,ITF,ITF3,15,Campania,Campania,5801692,3681303,63.45,0.03
3228,2021-06-06,CAM,62303,30966,31337,61673,630,ITF,ITF3,15,Campania,Campania,5801692,3743606,64.53,1.07
3229,2021-02-26,CAM,13338,4230,9108,12003,1335,ITF,ITF3,15,Campania,Campania,5801692,3756944,64.76,0.23
3230,2021-04-24,CAM,36330,17519,18811,25083,11247,ITF,ITF3,15,Campania,Campania,5801692,3793274,65.38,0.63
3231,2021-04-10,CAM,28341,13487,14854,23428,4913,ITF,ITF3,15,Campania,Campania,5801692,3821615,65.87,0.49
3232,2021-01-07,CAM,8910,4166,4744,8910,0,ITF,ITF3,15,Campania,Campania,5801692,3830525,66.02,0.15
3233,2021-03-05,CAM,16484,6348,10136,9821,6663,ITF,ITF3,15,Campania,Campania,5801692,3847009,66.31,0.28
3234,2021-01-14,CAM,7073,2977,4096,7073,0,ITF,ITF3,15,Campania,Campania,5801692,3854082,66.43,0.12
3235,2021-02-03,VDA,351,114,237,14,337,ITC,ITC2,2,Valle d'Aosta / Vallée d'Aoste,Valle d'Aosta,125666,351,0.28,0.28
3236,2021-04-01,VDA,776,394,382,764,12,ITC,ITC2,2,Valle d'Aosta / Vallée d'Aoste,Valle d'Aosta,125666,1127,0.9,0.62
3237,2021-02-24,VDA,183,82,101,164,19,ITC,ITC2,2,Valle d'Aosta / Vallée d'Aoste,Valle d'Aosta,125666,1310,1.04,0.15
3238,2021-04-08,VDA,584,282,302,441,143,ITC,ITC2,2,Valle d'Aosta / Vallée d'Aoste,Valle d'Aosta,125666,1894,1.51,0.46
3239,2021-01-27,VDA,151,71,80,79,72,ITC,ITC2,2,Valle d'Aosta / Vallée d'Aoste,Valle d'Aosta,125666,2045,1.63,0.12
3240,2021-04-20,VDA,933,430,503,739,194,ITC,ITC2,2,Valle d'Aosta / Vallée d'Aoste,Valle d'Aosta,125666,2978,2.37,0.74
3241,2021-01-10,VDA,220,71,149,220,0,ITC,ITC2,2,Valle d'Aosta / Vallée d'Aoste,Valle d'Aosta,125666,3198,2.54,0.18
3242,2020-12-27,VDA,20,9,11,20,0,ITC,ITC2,2,Valle d'Aosta / Vallée d'Aoste,Valle d'Aosta,125666,3218,2.56,0.02
3243,2021-06-09,VDA,531,257,274,502,29,ITC,ITC2,2,Valle d'Aosta / Vallée d'Aoste,Valle d'Aosta,125666,3749,2.98,0.42
3244,2021-03-01,VDA,181,66,115,147,34,ITC,ITC2,2,Valle d'Aosta / Vallée d'Aoste,Valle d'Aosta,125666,3930,3.13,0.14
3245,2021-02-15,VDA,264,136,128,229,35,ITC,ITC2,2,Valle d'Aosta / Vallée d'Aoste,Valle d'Aosta,125666,4194,3.34,0.21
3246,2021-04-03,VDA,676,341,335,661,15,ITC,ITC2,2,Valle d'Aosta / Vallée d'Aoste,Valle d'Aosta,125666,4870,3.88,0.54
3247,2021-03-20,VDA,208,86,122,172,36,ITC,ITC2,2,Valle d'Aosta / Vallée d'Aoste,Valle d'Aosta,125666,5078,4.04,0.17
3248,2021-05-23,VDA,999,465,534,658,341,ITC,ITC2,2,Valle d'Aosta / Vallée d'Aoste,Valle d'Aosta,125666,6077,4.84,0.79
3249,2021-01-29,VDA,318,138,180,2,316,ITC,ITC2,2,Valle d'Aosta / Vallée d'Aoste,Valle d'Aosta,125666,6395,5.09,0.25
3250,2021-04-22,VDA,1067,449,618,684,383,ITC,ITC2,2,Valle d'Aosta / Vallée d'Aoste,Valle d'Aosta,125666,7462,5.94,0.85
3251,2021-05-09,VDA,574,287,287,444,130,ITC,ITC2,2,Valle d'Aosta / Vallée d'Aoste,Valle d'Aosta,125666,8036,6.39,0.46
3252,2021-04-15,VDA,810,377,433,671,139,ITC,ITC2,2,Valle d'Aosta / Vallée d'Aoste,Valle d'Aosta,125666,8846,7.04,0.64
3253,2021-04-13,VDA,373,171,202,329,44,ITC,ITC2,2,Valle d'Aosta / Vallée d'Aoste,Valle d'Aosta,125666,9219,7.34,0.3
3254,2021-03-27,VDA,333,164,169,302,31,ITC,ITC2,2,Valle d'Aosta / Vallée d'Aoste,Valle d'Aosta,125666,9552,7.6,0.26
3255,2021-02-05,VDA,294,102,192,101,193,ITC,ITC2,2,Valle d'Aosta / Vallée d'Aoste,Valle d'Aosta,125666,9846,7.84,0.23
3256,2021-02-22,VDA,316,94,222,213,103,ITC,ITC2,2,Valle d'Aosta / Vallée d'Aoste,Valle d'Aosta,125666,10162,8.09,0.25
3257,2021-05-16,VDA,688,341,347,347,341,ITC,ITC2,2,Valle d'Aosta / Vallée d'Aoste,Valle d'Aosta,125666,10850,8.63,0.55
3258,2021-06-04,VDA,908,383,525,474,434,ITC,ITC2,2,Valle d'Aosta / Vallée d'Aoste,Valle d'Aosta,125666,11758,9.36,0.72
3259,2021-05-30,VDA,865,429,436,694,171,ITC,ITC2,2,Valle d'Aosta / Vallée d'Aoste,Valle d'Aosta,125666,12623,10.04,0.69
3260,2021-05-28,VDA,975,414,561,563,412,ITC,ITC2,2,Valle d'Aosta / Vallée d'Aoste,Valle d'Aosta,125666,13598,10.82,0.78
3261,2021-02-17,VDA,327,144,183,227,100,ITC,ITC2,2,Valle d'Aosta / Vallée d'Aoste,Valle d'Aosta,125666,13925,11.08,0.26
3262,2021-02-10,VDA,248,77,171,141,107,ITC,ITC2,2,Valle d'Aosta / Vallée d'Aoste,Valle d'Aosta,125666,14173,11.28,0.2
3263,2021-05-02,VDA,765,345,420,605,160,ITC,ITC2,2,Valle d'Aosta / Vallée d'Aoste,Valle d'Aosta,125666,14938,11.89,0.61
3264,2021-01-22,VDA,56,21,35,20,36,ITC,ITC2,2,Valle d'Aosta / Vallée d'Aoste,Valle d'Aosta,125666,14994,11.93,0.04
3265,2021-01-08,VDA,299,130,169,299,0,ITC,ITC2,2,Valle d'Aosta / Vallée d'Aoste,Valle d'Aosta,125666,15293,12.17,0.24
3266,2021-03-06,VDA,22,4,18,22,0,ITC,ITC2,2,Valle d'Aosta / Vallée d'Aoste,Valle d'Aosta,125666,15315,12.19,0.02
3267,2021-03-13,VDA,147,88,59,147,0,ITC,ITC2,2,Valle d'Aosta / Vallée d'Aoste,Valle d'Aosta,125666,15462,12.3,0.12
3268,2021-03-08,VDA,482,231,251,237,245,ITC,ITC2,2,Valle d'Aosta / Vallée d'Aoste,Valle d'Aosta,125666,15944,12.69,0.38
3269,2021-05-04,VDA,1135,510,625,462,673,ITC,ITC2,2,Valle d'Aosta / Vallée d'Aoste,Valle d'Aosta,125666,17079,13.59,0.9
3270,2021-03-15,VDA,362,123,239,159,203,ITC,ITC2,2,Valle d'Aosta / Vallée d'Aoste,Valle d'Aosta,125666,17441,13.88,0.29
3271,2021-05-11,VDA,647,325,322,496,151,ITC,ITC2,2,Valle d'Aosta / Vallée d'Aoste,Valle d'Aosta,125666,18088,14.39,0.51
3272,2021-04-27,VDA,978,423,555,686,292,ITC,ITC2,2,Valle d'Aosta / Vallée d'Aoste,Valle d'Aosta,125666,19066,15.17,0.78
3273,2021-01-17,VDA,131,56,75,131,0,ITC,ITC2,2,Valle d'Aosta / Vallée d'Aoste,Valle d'Aosta,125666,19197,15.28,0.1
3274,2021-03-17,VDA,433,185,248,273,160,ITC,ITC2,2,Valle d'Aosta / Vallée d'Aoste,Valle d'Aosta,125666,19630,15.62,0.34
3275,2021-03-03,VDA,255,118,137,187,68,ITC,ITC2,2,Valle d'Aosta / Vallée d'Aoste,Valle d'Aosta,125666,19885,15.82,0.2
3276,2021-01-26,VDA,139,48,91,0,139,ITC,ITC2,2,Valle d'Aosta / Vallée d'Aoste,Valle d'Aosta,125666,20024,15.93,0.11
3277,2021-02-12,VDA,263,96,167,217,46,ITC,ITC2,2,Valle d'Aosta / Vallée d'Aoste,Valle d'Aosta,125666,20287,16.14,0.21
3278,2021-01-12,VDA,302,72,230,302,0,ITC,ITC2,2,Valle d'Aosta / Vallée d'Aoste,Valle d'Aosta,125666,20589,16.38,0.24
3279,2021-03-29,VDA,493,233,260,453,40,ITC,ITC2,2,Valle d'Aosta / Vallée d'Aoste,Valle d'Aosta,125666,21082,16.78,0.39
3280,2021-03-12,VDA,531,175,356,305,226,ITC,ITC2,2,Valle d'Aosta / Vallée d'Aoste,Valle d'Aosta,125666,21613,17.2,0.42
3281,2021-03-10,VDA,438,183,255,225,213,ITC,ITC2,2,Valle d'Aosta / Vallée d'Aoste,Valle d'Aosta,125666,22051,17.55,0.35
3282,2021-02-21,VDA,18,3,15,0,18,ITC,ITC2,2,Valle d'Aosta / Vallée d'Aoste,Valle d'Aosta,125666,22069,17.56,0.01
3283,2021-05-25,VDA,1115,530,585,541,574,ITC,ITC2,2,Valle d'Aosta / Vallée d'Aoste,Valle d'Aosta,125666,23184,18.45,0.89
3284,2021-02-14,VDA,48,16,32,1,47,ITC,ITC2,2,Valle d'Aosta / Vallée d'Aoste,Valle d'Aosta,125666,23232,18.49,0.04
3285,2021-05-08,VDA,904,540,364,526,378,ITC,ITC2,2,Valle d'Aosta / Vallée d'Aoste,Valle d'Aosta,125666,24136,19.21,0.72
3286,2021-06-08,VDA,712,356,356,679,33,ITC,ITC2,2,Valle d'Aosta / Vallée d'Aoste,Valle d'Aosta,125666,24848,19.77,0.57
3287,2021-02-26,VDA,207,58,149,122,85,ITC,ITC2,2,Valle d'Aosta / Vallée d'Aoste,Valle d'Aosta,125666,25055,19.94,0.16
3288,2021-04-10,VDA,404,190,214,399,5,ITC,ITC2,2,Valle d'Aosta / Vallée d'Aoste,Valle d'Aosta,125666,25459,20.26,0.32
3289,2020-12-31,VDA,18,4,14,18,0,ITC,ITC2,2,Valle d'Aosta / Vallée d'Aoste,Valle d'Aosta,125666,25477,20.27,0.01
3290,2021-06-06,VDA,1160,582,578,787,373,ITC,ITC2,2,Valle d'Aosta / Vallée d'Aoste,Valle d'Aosta,125666,26637,21.2,0.92
3291,2021-01-19,VDA,256,77,179,256,0,ITC,ITC2,2,Valle d'Aosta / Vallée d'Aoste,Valle d'Aosta,125666,26893,21.4,0.2
3292,2021-04-12,VDA,486,186,300,323,163,ITC,ITC2,2,Valle d'Aosta / Vallée d'Aoste,Valle d'Aosta,125666,27379,21.79,0.39
3293,2021-04-29,VDA,1291,634,657,757,534,ITC,ITC2,2,Valle d'Aosta / Vallée d'Aoste,Valle d'Aosta,125666,28670,22.81,1.03
3294,2021-05-18,VDA,970,484,486,353,617,ITC,ITC2,2,Valle d'Aosta / Vallée d'Aoste,Valle d'Aosta,125666,29640,23.59,0.77
3295,2021-02-07,VDA,292,120,172,190,102,ITC,ITC2,2,Valle d'Aosta / Vallée d'Aoste,Valle d'Aosta,125666,29932,23.82,0.23
3296,2021-01-31,VDA,291,91,200,58,233,ITC,ITC2,2,Valle d'Aosta / Vallée d'Aoste,Valle d'Aosta,125666,30223,24.05,0.23
3297,2021-03-25,VDA,389,154,235,379,10,ITC,ITC2,2,Valle d'Aosta / Vallée d'Aoste,Valle d'Aosta,125666,30612,24.36,0.31
3298,2021-05-21,VDA,917,433,484,531,386,ITC,ITC2,2,Valle d'Aosta / Vallée d'Aoste,Valle d'Aosta,125666,31529,25.09,0.73
3299,2021-04-17,VDA,638,407,231,636,2,ITC,ITC2,2,Valle d'Aosta / Vallée d'Aoste,Valle d'Aosta,125666,32167,25.6,0.51
3300,2021-01-07,VDA,276,111,165,276,0,ITC,ITC2,2,Valle d'Aosta / Vallée d'Aoste,Valle d'Aosta,125666,32443,25.82,0.22
3301,2021-02-19,VDA,292,102,190,268,24,ITC,ITC2,2,Valle d'Aosta / Vallée d'Aoste,Valle d'Aosta,125666,32735,26.05,0.23
3302,2021-01-05,VDA,150,54,96,150,0,ITC,ITC2,2,Valle d'Aosta / Vallée d'Aoste,Valle d'Aosta,125666,32885,26.17,0.12
3303,2021-01-14,VDA,237,69,168,237,0,ITC,ITC2,2,Valle d'Aosta / Vallée d'Aoste,Valle d'Aosta,125666,33122,26.36,0.19
3304,2021-04-24,VDA,722,400,322,555,167,ITC,ITC2,2,Valle d'Aosta / Vallée d'Aoste,Valle d'Aosta,125666,33844,26.93,0.57
3305,2021-04-19,VDA,751,325,426,542,209,ITC,ITC2,2,Valle d'Aosta / Vallée d'Aoste,Valle d'Aosta,125666,34595,27.53,0.6
3306,2021-01-15,VDA,218,82,136,218,0,ITC,ITC2,2,Valle d'Aosta / Vallée d'Aoste,Valle d'Aosta,125666,34813,27.7,0.17
3307,2021-03-31,VDA,555,302,253,529,26,ITC,ITC2,2,Valle d'Aosta / Vallée d'Aoste,Valle d'Aosta,125666,35368,28.14,0.44
3308,2021-05-27,VDA,1089,497,592,586,503,ITC,ITC2,2,Valle d'Aosta / Vallée d'Aoste,Valle d'Aosta,125666,36457,29.01,0.87
3309,2021-05-13,VDA,1139,556,583,540,599,ITC,ITC2,2,Valle d'Aosta / Vallée d'Aoste,Valle d'Aosta,125666,37596,29.92,0.91
3310,2021-02-02,VDA,272,70,202,2,270,ITC,ITC2,2,Valle d'Aosta / Vallée d'Aoste,Valle d'Aosta,125666,37868,30.13,0.22
3311,2021-05-20,VDA,807,363,444,367,440,ITC,ITC2,2,Valle d'Aosta / Vallée d'Aoste,Valle d'Aosta,125666,38675,30.78,0.64
3312,2021-03-24,VDA,515,230,285,258,257,ITC,ITC2,2,Valle d'Aosta / Vallée d'Aoste,Valle d'Aosta,125666,39190,31.19,0.41
3313,2021-05-06,VDA,1063,509,554,679,384,ITC,ITC2,2,Valle d'Aosta / Vallée d'Aoste,Valle d'Aosta,125666,40253,32.03,0.85
3314,2021-05-24,VDA,1135,516,619,688,447,ITC,ITC2,2,Valle d'Aosta / Vallée d'Aoste,Valle d'Aosta,125666,41388,32.93,0.9
3315,2021-05-10,VDA,782,381,401,547,235,ITC,ITC2,2,Valle d'Aosta / Vallée d'Aoste,Valle d'Aosta,125666,42170,33.56,0.62
3316,2021-04-21,VDA,868,410,458,620,248,ITC,ITC2,2,Valle d'Aosta / Vallée d'Aoste,Valle d'Aosta,125666,43038,34.25,0.69
3317,2021-03-21,VDA,355,165,190,355,0,ITC,ITC2,2,Valle d'Aosta / Vallée d'Aoste,Valle d'Aosta,125666,43393,34.53,0.28
3318,2021-04-05,VDA,461,222,239,457,4,ITC,ITC2,2,Valle d'Aosta / Vallée d'Aoste,Valle d'Aosta,125666,43854,34.9,0.37
3319,2021-01-28,VDA,291,123,168,56,235,ITC,ITC2,2,Valle d'Aosta / Vallée d'Aoste,Valle d'Aosta,125666,44145,35.13,0.23
3320,2021-05-01,VDA,940,563,377,456,484,ITC,ITC2,2,Valle d'Aosta / Vallée d'Aoste,Valle d'Aosta,125666,45085,35.88,0.75
3321,2021-04-14,VDA,941,430,511,717,224,ITC,ITC2,2,Valle d'Aosta / Vallée d'Aoste,Valle d'Aosta,125666,46026,36.63,0.75
3322,2021-01-02,VDA,6,5,1,6,0,ITC,ITC2,2,Valle d'Aosta / Vallée d'Aoste,Valle d'Aosta,125666,46032,36.63,0.0
3323,2021-03-26,VDA,498,204,294,491,7,ITC,ITC2,2,Valle d'Aosta / Vallée d'Aoste,Valle d'Aosta,125666,46530,37.03,0.4
3324,2021-03-05,VDA,275,124,151,53,222,ITC,ITC2,2,Valle d'Aosta / Vallée d'Aoste,Valle d'Aosta,125666,46805,37.25,0.22
3325,2021-02-28,VDA,260,86,174,77,183,ITC,ITC2,2,Valle d'Aosta / Vallée d'Aoste,Valle d'Aosta,125666,47065,37.45,0.21
3326,2021-05-05,VDA,1038,566,472,456,582,ITC,ITC2,2,Valle d'Aosta / Vallée d'Aoste,Valle d'Aosta,125666,48103,38.28,0.83
3327,2021-06-01,VDA,871,469,402,518,353,ITC,ITC2,2,Valle d'Aosta / Vallée d'Aoste,Valle d'Aosta,125666,48974,38.97,0.69
3328,2021-02-23,VDA,216,123,93,216,0,ITC,ITC2,2,Valle d'Aosta / Vallée d'Aoste,Valle d'Aosta,125666,49190,39.14,0.17
3329,2021-06-03,VDA,1305,666,639,896,409,ITC,ITC2,2,Valle d'Aosta / Vallée d'Aoste,Valle d'Aosta,125666,50495,40.18,1.04
3330,2021-05-17,VDA,809,417,392,375,434,ITC,ITC2,2,Valle d'Aosta / Vallée d'Aoste,Valle d'Aosta,125666,51304,40.83,0.64
3331,2021-03-22,VDA,560,205,355,333,227,ITC,ITC2,2,Valle d'Aosta / Vallée d'Aoste,Valle d'Aosta,125666,51864,41.27,0.45
3332,2021-06-05,VDA,925,476,449,737,188,ITC,ITC2,2,Valle d'Aosta / Vallée d'Aoste,Valle d'Aosta,125666,52789,42.01,0.74
3333,2021-02-11,VDA,231,107,124,222,9,ITC,ITC2,2,Valle d'Aosta / Vallée d'Aoste,Valle d'Aosta,125666,53020,42.19,0.18
3334,2021-04-09,VDA,237,111,126,204,33,ITC,ITC2,2,Valle d'Aosta / Vallée d'Aoste,Valle d'Aosta,125666,53257,42.38,0.19
3335,2021-05-22,VDA,940,494,446,540,400,ITC,ITC2,2,Valle d'Aosta / Vallée d'Aoste,Valle d'Aosta,125666,54197,43.13,0.75
3336,2021-04-16,VDA,599,261,338,597,2,ITC,ITC2,2,Valle d'Aosta / Vallée d'Aoste,Valle d'Aosta,125666,54796,43.6,0.48
3337,2021-04-02,VDA,873,344,529,648,225,ITC,ITC2,2,Valle d'Aosta / Vallée d'Aoste,Valle d'Aosta,125666,55669,44.3,0.69
3338,2021-05-29,VDA,798,434,364,561,237,ITC,ITC2,2,Valle d'Aosta / Vallée d'Aoste,Valle d'Aosta,125666,56467,44.93,0.64
3339,2021-02-25,VDA,201,101,100,194,7,ITC,ITC2,2,Valle d'Aosta / Vallée d'Aoste,Valle d'Aosta,125666,56668,45.09,0.16
3340,2021-01-06,VDA,65,33,32,65,0,ITC,ITC2,2,Valle d'Aosta / Vallée d'Aoste,Valle d'Aosta,125666,56733,45.15,0.05
3341,2021-01-16,VDA,236,80,156,236,0,ITC,ITC2,2,Valle d'Aosta / Vallée d'Aoste,Valle d'Aosta,125666,56969,45.33,0.19
3342,2021-03-14,VDA,392,200,192,392,0,ITC,ITC2,2,Valle d'Aosta / Vallée d'Aoste,Valle d'Aosta,125666,57361,45.65,0.31
3343,2021-04-26,VDA,715,327,388,545,170,ITC,ITC2,2,Valle d'Aosta / Vallée d'Aoste,Valle d'Aosta,125666,58076,46.21,0.57
3344,2021-01-09,VDA,443,199,244,443,0,ITC,ITC2,2,Valle d'Aosta / Vallée d'Aoste,Valle d'Aosta,125666,58519,46.57,0.35
3345,2021-03-02,VDA,339,166,173,336,3,ITC,ITC2,2,Valle d'Aosta / Vallée d'Aoste,Valle d'Aosta,125666,58858,46.84,0.27
3346,2021-01-11,VDA,325,112,213,325,0,ITC,ITC2,2,Valle d'Aosta / Vallée d'Aoste,Valle d'Aosta,125666,59183,47.1,0.26
3347,2021-04-04,VDA,572,253,319,571,1,ITC,ITC2,2,Valle d'Aosta / Vallée d'Aoste,Valle d'Aosta,125666,59755,47.55,0.46
3348,2021-02-13,VDA,216,196,20,215,1,ITC,ITC2,2,Valle d'Aosta / Vallée d'Aoste,Valle d'Aosta,125666,59971,47.72,0.17
3349,2021-01-21,VDA,33,12,21,33,0,ITC,ITC2,2,Valle d'Aosta / Vallée d'Aoste,Valle d'Aosta,125666,60004,47.75,0.03
3350,2021-01-04,VDA,142,59,83,142,0,ITC,ITC2,2,Valle d'Aosta / Vallée d'Aoste,Valle d'Aosta,125666,60146,47.86,0.11
3351,2021-03-28,VDA,522,212,310,521,1,ITC,ITC2,2,Valle d'Aosta / Vallée d'Aoste,Valle d'Aosta,125666,60668,48.28,0.42
3352,2021-03-11,VDA,197,76,121,66,131,ITC,ITC2,2,Valle d'Aosta / Vallée d'Aoste,Valle d'Aosta,125666,60865,48.43,0.16
3353,2021-06-02,VDA,1215,688,527,814,401,ITC,ITC2,2,Valle d'Aosta / Vallée d'Aoste,Valle d'Aosta,125666,62080,49.4,0.97
3354,2021-03-09,VDA,206,96,110,174,32,ITC,ITC2,2,Valle d'Aosta / Vallée d'Aoste,Valle d'Aosta,125666,62286,49.56,0.16
3355,2021-02-20,VDA,251,210,41,241,10,ITC,ITC2,2,Valle d'Aosta / Vallée d'Aoste,Valle d'Aosta,125666,62537,49.76,0.2
3356,2021-03-19,VDA,322,85,237,286,36,ITC,ITC2,2,Valle d'Aosta / Vallée d'Aoste,Valle d'Aosta,125666,62859,50.02,0.26
3357,2021-05-07,VDA,564,245,319,533,31,ITC,ITC2,2,Valle d'Aosta / Vallée d'Aoste,Valle d'Aosta,125666,63423,50.47,0.45
3358,2021-04-23,VDA,921,443,478,538,383,ITC,ITC2,2,Valle d'Aosta / Vallée d'Aoste,Valle d'Aosta,125666,64344,51.2,0.73
3359,2021-01-13,VDA,337,110,227,337,0,ITC,ITC2,2,Valle d'Aosta / Vallée d'Aoste,Valle d'Aosta,125666,64681,51.47,0.27
3360,2021-04-06,VDA,741,381,360,629,112,ITC,ITC2,2,Valle d'Aosta / Vallée d'Aoste,Valle d'Aosta,125666,65422,52.06,0.59
3361,2021-03-18,VDA,136,43,93,99,37,ITC,ITC2,2,Valle d'Aosta / Vallée d'Aoste,Valle d'Aosta,125666,65558,52.17,0.11
3362,2021-05-15,VDA,1065,614,451,380,685,ITC,ITC2,2,Valle d'Aosta / Vallée d'Aoste,Valle d'Aosta,125666,66623,53.02,0.85
3363,2021-02-04,VDA,294,86,208,8,286,ITC,ITC2,2,Valle d'Aosta / Vallée d'Aoste,Valle d'Aosta,125666,66917,53.25,0.23
3364,2021-04-28,VDA,1218,632,586,715,503,ITC,ITC2,2,Valle d'Aosta / Vallée d'Aoste,Valle d'Aosta,125666,68135,54.22,0.97
3365,2021-02-06,VDA,289,104,185,92,197,ITC,ITC2,2,Valle d'Aosta / Vallée d'Aoste,Valle d'Aosta,125666,68424,54.45,0.23
3366,2021-04-30,VDA,831,355,476,485,346,ITC,ITC2,2,Valle d'Aosta / Vallée d'Aoste,Valle d'Aosta,125666,69255,55.11,0.66
3367,2021-01-20,VDA,23,8,15,23,0,ITC,ITC2,2,Valle d'Aosta / Vallée d'Aoste,Valle d'Aosta,125666,69278,55.13,0.02
3368,2021-01-18,VDA,213,74,139,213,0,ITC,ITC2,2,Valle d'Aosta / Vallée d'Aoste,Valle d'Aosta,125666,69491,55.3,0.17
3369,2021-04-11,VDA,479,208,271,479,0,ITC,ITC2,2,Valle d'Aosta / Vallée d'Aoste,Valle d'Aosta,125666,69970,55.68,0.38
3370,2021-02-18,VDA,349,153,196,261,88,ITC,ITC2,2,Valle d'Aosta / Vallée d'Aoste,Valle d'Aosta,125666,70319,55.96,0.28
3371,2021-05-03,VDA,839,400,439,488,351,ITC,ITC2,2,Valle d'Aosta / Vallée d'Aoste,Valle d'Aosta,125666,71158,56.62,0.67
3372,2021-03-07,VDA,64,30,34,11,53,ITC,ITC2,2,Valle d'Aosta / Vallée d'Aoste,Valle d'Aosta,125666,71222,56.68,0.05
3373,2021-01-30,VDA,439,202,237,14,425,ITC,ITC2,2,Valle d'Aosta / Vallée d'Aoste,Valle d'Aosta,125666,71661,57.02,0.35
3374,2021-01-25,VDA,147,65,82,0,147,ITC,ITC2,2,Valle d'Aosta / Vallée d'Aoste,Valle d'Aosta,125666,71808,57.14,0.12
3375,2021-05-14,VDA,960,442,518,291,669,ITC,ITC2,2,Valle d'Aosta / Vallée d'Aoste,Valle d'Aosta,125666,72768,57.91,0.76
3376,2021-03-04,VDA,291,139,152,42,249,ITC,ITC2,2,Valle d'Aosta / Vallée d'Aoste,Valle d'Aosta,125666,73059,58.14,0.23
3377,2021-05-26,VDA,1209,587,622,576,633,ITC,ITC2,2,Valle d'Aosta / Vallée d'Aoste,Valle d'Aosta,125666,74268,59.1,0.96
3378,2021-02-08,VDA,223,83,140,25,198,ITC,ITC2,2,Valle d'Aosta / Vallée d'Aoste,Valle d'Aosta,125666,74491,59.28,0.18
3379,2021-03-23,VDA,379,150,229,245,134,ITC,ITC2,2,Valle d'Aosta / Vallée d'Aoste,Valle d'Aosta,125666,74870,59.58,0.3
3380,2021-05-19,VDA,993,498,495,418,575,ITC,ITC2,2,Valle d'Aosta / Vallée d'Aoste,Valle d'Aosta,125666,75863,60.37,0.79
3381,2021-03-16,VDA,182,37,145,118,64,ITC,ITC2,2,Valle d'Aosta / Vallée d'Aoste,Valle d'Aosta,125666,76045,60.51,0.14
3382,2021-02-01,VDA,404,127,277,87,317,ITC,ITC2,2,Valle d'Aosta / Vallée d'Aoste,Valle d'Aosta,125666,76449,60.84,0.32
3383,2021-03-30,VDA,402,223,179,382,20,ITC,ITC2,2,Valle d'Aosta / Vallée d'Aoste,Valle d'Aosta,125666,76851,61.15,0.32
3384,2021-05-12,VDA,1138,549,589,468,670,ITC,ITC2,2,Valle d'Aosta / Vallée d'Aoste,Valle d'Aosta,125666,77989,62.06,0.91
3385,2021-02-16,VDA,325,53,272,320,5,ITC,ITC2,2,Valle d'Aosta / Vallée d'Aoste,Valle d'Aosta,125666,78314,62.32,0.26
3386,2021-04-07,VDA,910,474,436,681,229,ITC,ITC2,2,Valle d'Aosta / Vallée d'Aoste,Valle d'Aosta,125666,79224,63.04,0.72
3387,2021-02-09,VDA,251,84,167,68,183,ITC,ITC2,2,Valle d'Aosta / Vallée d'Aoste,Valle d'Aosta,125666,79475,63.24,0.2
3388,2021-04-18,VDA,522,254,268,518,4,ITC,ITC2,2,Valle d'Aosta / Vallée d'Aoste,Valle d'Aosta,125666,79997,63.66,0.42
3389,2021-05-31,VDA,879,395,484,500,379,ITC,ITC2,2,Valle d'Aosta / Vallée d'Aoste,Valle d'Aosta,125666,80876,64.36,0.7
3390,2021-04-25,VDA,849,408,441,710,139,ITC,ITC2,2,Valle d'Aosta / Vallée d'Aoste,Valle d'Aosta,125666,81725,65.03,0.68
3391,2021-06-07,VDA,710,347,363,649,61,ITC,ITC2,2,Valle d'Aosta / Vallée d'Aoste,Valle d'Aosta,125666,82435,65.6,0.56
3392,2021-02-27,VDA,231,85,146,124,107,ITC,ITC2,2,Valle d'Aosta / Vallée d'Aoste,Valle d'Aosta,125666,82666,65.78,0.18
