,data,area,Vaccinazioni giornaliere,sesso_maschile,sesso_femminile,prima_dose,seconda_dose,codice_NUTS1,codice_NUTS2,codice_regione_ISTAT,nome_area,Regione,popolazione,Totale vaccinazioni,Totale vaccinazioni ogni cento ab,Vaccinazioni giornaliere ogni cento ab
0,2021-05-17,VEN,26355,12930,13425,16429,9926,ITH,ITH3,5,Veneto,Veneto,4905854,26355,0.54,0.54
1,2021-02-06,VEN,4095,1354,2741,709,3386,ITH,ITH3,5,Veneto,Veneto,4905854,30450,0.62,0.08
2,2021-01-01,VEN,1528,471,1057,1528,0,ITH,ITH3,5,Veneto,Veneto,4905854,31978,0.65,0.03
3,2021-04-11,VEN,21002,8873,12129,14695,6307,ITH,ITH3,5,Veneto,Veneto,4905854,52980,1.08,0.43
4,2021-04-13,VEN,14020,6319,7701,8534,5486,ITH,ITH3,5,Veneto,Veneto,4905854,67000,1.37,0.29
5,2021-01-11,VEN,7238,2101,5137,7238,0,ITH,ITH3,5,Veneto,Veneto,4905854,74238,1.51,0.15
6,2021-05-22,VEN,34641,16625,18016,13283,21358,ITH,ITH3,5,Veneto,Veneto,4905854,108879,2.22,0.71
7,2021-01-28,VEN,9209,2662,6547,173,9036,ITH,ITH3,5,Veneto,Veneto,4905854,118088,2.41,0.19
8,2021-03-02,VEN,11483,4622,6861,8175,3308,ITH,ITH3,5,Veneto,Veneto,4905854,129571,2.64,0.23
9,2021-04-02,VEN,23974,10549,13425,17643,6331,ITH,ITH3,5,Veneto,Veneto,4905854,153545,3.13,0.49
10,2021-05-09,VEN,34928,16057,18871,24871,10057,ITH,ITH3,5,Veneto,Veneto,4905854,188473,3.84,0.71
11,2021-05-02,VEN,37221,17254,19967,26886,10335,ITH,ITH3,5,Veneto,Veneto,4905854,225694,4.6,0.76
12,2021-03-06,VEN,10627,4316,6311,7365,3262,ITH,ITH3,5,Veneto,Veneto,4905854,236321,4.82,0.22
13,2021-02-27,VEN,8987,2691,6296,8140,847,ITH,ITH3,5,Veneto,Veneto,4905854,245308,5.0,0.18
14,2021-05-05,VEN,43918,21067,22851,37405,6513,ITH,ITH3,5,Veneto,Veneto,4905854,289226,5.9,0.9
15,2021-03-16,VEN,12516,5347,7169,6902,5614,ITH,ITH3,5,Veneto,Veneto,4905854,301742,6.15,0.26
16,2021-03-23,VEN,22148,10186,11962,17429,4719,ITH,ITH3,5,Veneto,Veneto,4905854,323890,6.6,0.45
17,2021-05-19,VEN,32352,14843,17509,16634,15718,ITH,ITH3,5,Veneto,Veneto,4905854,356242,7.26,0.66
18,2021-04-06,VEN,28876,13275,15601,23802,5074,ITH,ITH3,5,Veneto,Veneto,4905854,385118,7.85,0.59
19,2021-02-01,VEN,8557,2500,6057,161,8396,ITH,ITH3,5,Veneto,Veneto,4905854,393675,8.02,0.17
20,2021-01-23,VEN,4050,1246,2804,31,4019,ITH,ITH3,5,Veneto,Veneto,4905854,397725,8.11,0.08
21,2021-03-21,VEN,11984,4754,7230,8522,3462,ITH,ITH3,5,Veneto,Veneto,4905854,409709,8.35,0.24
22,2021-01-16,VEN,4611,1542,3069,4611,0,ITH,ITH3,5,Veneto,Veneto,4905854,414320,8.45,0.09
23,2021-03-14,VEN,15166,5935,9231,14272,894,ITH,ITH3,5,Veneto,Veneto,4905854,429486,8.75,0.31
24,2021-05-10,VEN,36343,16996,19347,26508,9835,ITH,ITH3,5,Veneto,Veneto,4905854,465829,9.5,0.74
25,2021-01-30,VEN,8747,2672,6075,693,8054,ITH,ITH3,5,Veneto,Veneto,4905854,474576,9.67,0.18
26,2021-03-07,VEN,4475,1756,2719,3914,561,ITH,ITH3,5,Veneto,Veneto,4905854,479051,9.76,0.09
27,2021-05-03,VEN,40585,19765,20820,34158,6427,ITH,ITH3,5,Veneto,Veneto,4905854,519636,10.59,0.83
28,2021-05-31,VEN,30978,15864,15114,21577,9401,ITH,ITH3,5,Veneto,Veneto,4905854,550614,11.22,0.63
29,2021-03-28,VEN,31250,13586,17664,27614,3636,ITH,ITH3,5,Veneto,Veneto,4905854,581864,11.86,0.64
30,2021-04-14,VEN,15875,6880,8995,9249,6626,ITH,ITH3,5,Veneto,Veneto,4905854,597739,12.18,0.32
31,2021-05-14,VEN,46275,22017,24258,25641,20634,ITH,ITH3,5,Veneto,Veneto,4905854,644014,13.13,0.94
32,2021-03-11,VEN,19708,8775,10933,14128,5580,ITH,ITH3,5,Veneto,Veneto,4905854,663722,13.53,0.4
33,2021-02-16,VEN,6639,2870,3769,6462,177,ITH,ITH3,5,Veneto,Veneto,4905854,670361,13.66,0.14
34,2021-05-29,VEN,32013,16223,15790,25191,6822,ITH,ITH3,5,Veneto,Veneto,4905854,702374,14.32,0.65
35,2021-04-16,VEN,24421,10481,13940,12538,11883,ITH,ITH3,5,Veneto,Veneto,4905854,726795,14.81,0.5
36,2021-01-08,VEN,9404,2835,6569,9404,0,ITH,ITH3,5,Veneto,Veneto,4905854,736199,15.01,0.19
37,2021-01-13,VEN,5985,1606,4379,5985,0,ITH,ITH3,5,Veneto,Veneto,4905854,742184,15.13,0.12
38,2021-04-25,VEN,18312,8147,10165,13479,4833,ITH,ITH3,5,Veneto,Veneto,4905854,760496,15.5,0.37
39,2021-05-12,VEN,36232,17528,18704,31177,5055,ITH,ITH3,5,Veneto,Veneto,4905854,796728,16.24,0.74
40,2021-02-08,VEN,4976,1541,3435,1929,3047,ITH,ITH3,5,Veneto,Veneto,4905854,801704,16.34,0.1
41,2021-02-15,VEN,4386,1821,2565,4146,240,ITH,ITH3,5,Veneto,Veneto,4905854,806090,16.43,0.09
42,2021-03-30,VEN,35886,15238,20648,30637,5249,ITH,ITH3,5,Veneto,Veneto,4905854,841976,17.16,0.73
43,2021-02-23,VEN,7375,3250,4125,7105,270,ITH,ITH3,5,Veneto,Veneto,4905854,849351,17.31,0.15
44,2021-04-28,VEN,32373,15158,17215,23353,9020,ITH,ITH3,5,Veneto,Veneto,4905854,881724,17.97,0.66
45,2021-01-18,VEN,2762,776,1986,2563,199,ITH,ITH3,5,Veneto,Veneto,4905854,884486,18.03,0.06
46,2021-02-04,VEN,7388,2024,5364,553,6835,ITH,ITH3,5,Veneto,Veneto,4905854,891874,18.18,0.15
47,2021-04-30,VEN,49917,23440,26477,34268,15649,ITH,ITH3,5,Veneto,Veneto,4905854,941791,19.2,1.02
48,2021-01-20,VEN,1038,368,670,386,652,ITH,ITH3,5,Veneto,Veneto,4905854,942829,19.22,0.02
49,2021-03-25,VEN,25836,10950,14886,19716,6120,ITH,ITH3,5,Veneto,Veneto,4905854,968665,19.75,0.53
50,2021-03-09,VEN,16463,7381,9082,10144,6319,ITH,ITH3,5,Veneto,Veneto,4905854,985128,20.08,0.34
51,2021-03-26,VEN,29541,13118,16423,24074,5467,ITH,ITH3,5,Veneto,Veneto,4905854,1014669,20.68,0.6
52,2021-01-04,VEN,6736,2033,4703,6736,0,ITH,ITH3,5,Veneto,Veneto,4905854,1021405,20.82,0.14
53,2021-02-20,VEN,6424,2014,4410,6353,71,ITH,ITH3,5,Veneto,Veneto,4905854,1027829,20.95,0.13
54,2021-02-25,VEN,7899,3339,4560,7294,605,ITH,ITH3,5,Veneto,Veneto,4905854,1035728,21.11,0.16
55,2021-04-09,VEN,31096,13692,17404,22759,8337,ITH,ITH3,5,Veneto,Veneto,4905854,1066824,21.75,0.63
56,2020-12-30,VEN,699,245,454,699,0,ITH,ITH3,5,Veneto,Veneto,4905854,1067523,21.76,0.01
57,2021-03-04,VEN,12919,4828,8091,9448,3471,ITH,ITH3,5,Veneto,Veneto,4905854,1080442,22.02,0.26
58,2021-05-28,VEN,44625,21915,22710,24573,20052,ITH,ITH3,5,Veneto,Veneto,4905854,1125067,22.93,0.91
59,2021-05-21,VEN,44488,21886,22602,20825,23663,ITH,ITH3,5,Veneto,Veneto,4905854,1169555,23.84,0.91
60,2021-01-03,VEN,5157,1562,3595,5157,0,ITH,ITH3,5,Veneto,Veneto,4905854,1174712,23.95,0.11
61,2021-03-08,VEN,13549,6195,7354,9480,4069,ITH,ITH3,5,Veneto,Veneto,4905854,1188261,24.22,0.28
62,2021-03-27,VEN,32048,13987,18061,26243,5805,ITH,ITH3,5,Veneto,Veneto,4905854,1220309,24.87,0.65
63,2021-02-19,VEN,7322,3140,4182,7118,204,ITH,ITH3,5,Veneto,Veneto,4905854,1227631,25.02,0.15
64,2021-02-21,VEN,4633,1209,3424,4628,5,ITH,ITH3,5,Veneto,Veneto,4905854,1232264,25.12,0.09
65,2021-06-01,VEN,19499,9729,9770,12093,7406,ITH,ITH3,5,Veneto,Veneto,4905854,1251763,25.52,0.4
66,2021-04-04,VEN,7775,3531,4244,6624,1151,ITH,ITH3,5,Veneto,Veneto,4905854,1259538,25.67,0.16
67,2021-05-24,VEN,32553,16088,16465,7713,24840,ITH,ITH3,5,Veneto,Veneto,4905854,1292091,26.34,0.66
68,2021-01-09,VEN,7927,2539,5388,7927,0,ITH,ITH3,5,Veneto,Veneto,4905854,1300018,26.5,0.16
69,2021-02-13,VEN,3267,1474,1793,3247,20,ITH,ITH3,5,Veneto,Veneto,4905854,1303285,26.57,0.07
70,2021-05-26,VEN,29472,14373,15099,13533,15939,ITH,ITH3,5,Veneto,Veneto,4905854,1332757,27.17,0.6
71,2021-03-20,VEN,12943,5340,7603,10848,2095,ITH,ITH3,5,Veneto,Veneto,4905854,1345700,27.43,0.26
72,2021-01-10,VEN,5032,1671,3361,5032,0,ITH,ITH3,5,Veneto,Veneto,4905854,1350732,27.53,0.1
73,2021-05-23,VEN,34439,16443,17996,11067,23372,ITH,ITH3,5,Veneto,Veneto,4905854,1385171,28.24,0.7
74,2021-03-19,VEN,13790,5668,8122,7697,6093,ITH,ITH3,5,Veneto,Veneto,4905854,1398961,28.52,0.28
75,2021-04-21,VEN,32314,13176,19138,16248,16066,ITH,ITH3,5,Veneto,Veneto,4905854,1431275,29.17,0.66
76,2021-02-11,VEN,4013,1238,2775,3385,628,ITH,ITH3,5,Veneto,Veneto,4905854,1435288,29.26,0.08
77,2021-01-25,VEN,6468,2075,4393,159,6309,ITH,ITH3,5,Veneto,Veneto,4905854,1441756,29.39,0.13
78,2021-04-20,VEN,22403,9486,12917,8404,13999,ITH,ITH3,5,Veneto,Veneto,4905854,1464159,29.85,0.46
79,2021-05-11,VEN,32898,16405,16493,28217,4681,ITH,ITH3,5,Veneto,Veneto,4905854,1497057,30.52,0.67
80,2021-01-22,VEN,1080,332,748,25,1055,ITH,ITH3,5,Veneto,Veneto,4905854,1498137,30.54,0.02
81,2021-05-04,VEN,42778,20261,22517,34771,8007,ITH,ITH3,5,Veneto,Veneto,4905854,1540915,31.41,0.87
82,2021-01-24,VEN,4117,1219,2898,28,4089,ITH,ITH3,5,Veneto,Veneto,4905854,1545032,31.49,0.08
83,2021-01-31,VEN,4769,1562,3207,392,4377,ITH,ITH3,5,Veneto,Veneto,4905854,1549801,31.59,0.1
84,2021-03-29,VEN,31393,13631,17762,27559,3834,ITH,ITH3,5,Veneto,Veneto,4905854,1581194,32.23,0.64
85,2021-04-23,VEN,31148,13800,17348,22448,8700,ITH,ITH3,5,Veneto,Veneto,4905854,1612342,32.87,0.63
86,2021-02-18,VEN,5828,2455,3373,5764,64,ITH,ITH3,5,Veneto,Veneto,4905854,1618170,32.98,0.12
87,2021-04-18,VEN,17517,7255,10262,9945,7572,ITH,ITH3,5,Veneto,Veneto,4905854,1635687,33.34,0.36
88,2021-01-06,VEN,8132,2385,5747,8132,0,ITH,ITH3,5,Veneto,Veneto,4905854,1643819,33.51,0.17
89,2021-04-10,VEN,27444,11971,15473,18963,8481,ITH,ITH3,5,Veneto,Veneto,4905854,1671263,34.07,0.56
90,2021-05-30,VEN,22448,11227,11221,15814,6634,ITH,ITH3,5,Veneto,Veneto,4905854,1693711,34.52,0.46
91,2021-02-26,VEN,8294,3271,5023,7036,1258,ITH,ITH3,5,Veneto,Veneto,4905854,1702005,34.69,0.17
92,2021-01-14,VEN,7062,1924,5138,7062,0,ITH,ITH3,5,Veneto,Veneto,4905854,1709067,34.84,0.14
93,2021-03-12,VEN,18572,8125,10447,11826,6746,ITH,ITH3,5,Veneto,Veneto,4905854,1727639,35.22,0.38
94,2021-01-07,VEN,8358,2318,6040,8358,0,ITH,ITH3,5,Veneto,Veneto,4905854,1735997,35.39,0.17
95,2021-04-26,VEN,20710,9451,11259,15567,5143,ITH,ITH3,5,Veneto,Veneto,4905854,1756707,35.81,0.42
96,2021-04-27,VEN,28110,12747,15363,21193,6917,ITH,ITH3,5,Veneto,Veneto,4905854,1784817,36.38,0.57
97,2021-02-05,VEN,8373,2535,5838,1415,6958,ITH,ITH3,5,Veneto,Veneto,4905854,1793190,36.55,0.17
98,2021-02-22,VEN,7013,3040,3973,6626,387,ITH,ITH3,5,Veneto,Veneto,4905854,1800203,36.69,0.14
99,2021-01-02,VEN,5743,1766,3977,5743,0,ITH,ITH3,5,Veneto,Veneto,4905854,1805946,36.81,0.12
100,2021-01-19,VEN,1309,472,837,1159,150,ITH,ITH3,5,Veneto,Veneto,4905854,1807255,36.84,0.03
101,2021-05-01,VEN,38761,18197,20564,29847,8914,ITH,ITH3,5,Veneto,Veneto,4905854,1846016,37.63,0.79
102,2021-03-22,VEN,18093,8134,9959,13050,5043,ITH,ITH3,5,Veneto,Veneto,4905854,1864109,38.0,0.37
103,2021-03-13,VEN,17178,7259,9919,14045,3133,ITH,ITH3,5,Veneto,Veneto,4905854,1881287,38.35,0.35
104,2021-05-20,VEN,44228,21009,23219,20104,24124,ITH,ITH3,5,Veneto,Veneto,4905854,1925515,39.25,0.9
105,2021-02-07,VEN,2315,862,1453,714,1601,ITH,ITH3,5,Veneto,Veneto,4905854,1927830,39.3,0.05
106,2020-12-27,VEN,880,395,485,880,0,ITH,ITH3,5,Veneto,Veneto,4905854,1928710,39.31,0.02
107,2021-04-24,VEN,24731,10819,13912,15653,9078,ITH,ITH3,5,Veneto,Veneto,4905854,1953441,39.82,0.5
108,2021-04-17,VEN,22403,9078,13325,15121,7282,ITH,ITH3,5,Veneto,Veneto,4905854,1975844,40.28,0.46
109,2021-01-21,VEN,2292,719,1573,21,2271,ITH,ITH3,5,Veneto,Veneto,4905854,1978136,40.32,0.05
110,2021-03-05,VEN,13286,4978,8308,9625,3661,ITH,ITH3,5,Veneto,Veneto,4905854,1991422,40.59,0.27
111,2021-05-25,VEN,27124,13021,14103,11473,15651,ITH,ITH3,5,Veneto,Veneto,4905854,2018546,41.15,0.55
112,2021-02-14,VEN,125,56,69,112,13,ITH,ITH3,5,Veneto,Veneto,4905854,2018671,41.15,0.0
113,2021-02-28,VEN,4136,1389,2747,3299,837,ITH,ITH3,5,Veneto,Veneto,4905854,2022807,41.23,0.08
114,2021-04-19,VEN,21527,8916,12611,5117,16410,ITH,ITH3,5,Veneto,Veneto,4905854,2044334,41.67,0.44
115,2021-04-05,VEN,19137,8367,10770,13697,5440,ITH,ITH3,5,Veneto,Veneto,4905854,2063471,42.06,0.39
116,2021-02-17,VEN,6022,2772,3250,5928,94,ITH,ITH3,5,Veneto,Veneto,4905854,2069493,42.18,0.12
117,2021-04-01,VEN,25197,11052,14145,18786,6411,ITH,ITH3,5,Veneto,Veneto,4905854,2094690,42.7,0.51
118,2021-04-15,VEN,20824,8596,12228,10018,10806,ITH,ITH3,5,Veneto,Veneto,4905854,2115514,43.12,0.42
119,2021-01-05,VEN,7329,2182,5147,7329,0,ITH,ITH3,5,Veneto,Veneto,4905854,2122843,43.27,0.15
120,2021-02-10,VEN,4751,1588,3163,3697,1054,ITH,ITH3,5,Veneto,Veneto,4905854,2127594,43.37,0.1
121,2021-04-08,VEN,32313,14345,17968,24440,7873,ITH,ITH3,5,Veneto,Veneto,4905854,2159907,44.03,0.66
122,2021-02-24,VEN,8614,3678,4936,8128,486,ITH,ITH3,5,Veneto,Veneto,4905854,2168521,44.2,0.18
123,2021-05-15,VEN,36038,17426,18612,26122,9916,ITH,ITH3,5,Veneto,Veneto,4905854,2204559,44.94,0.73
124,2021-04-07,VEN,35894,16114,19780,28564,7330,ITH,ITH3,5,Veneto,Veneto,4905854,2240453,45.67,0.73
125,2021-05-13,VEN,43797,21633,22164,33943,9854,ITH,ITH3,5,Veneto,Veneto,4905854,2284250,46.56,0.89
126,2021-02-02,VEN,6508,1878,4630,396,6112,ITH,ITH3,5,Veneto,Veneto,4905854,2290758,46.69,0.13
127,2021-03-31,VEN,38639,16250,22389,31145,7494,ITH,ITH3,5,Veneto,Veneto,4905854,2329397,47.48,0.79
128,2021-01-17,VEN,1933,781,1152,1584,349,ITH,ITH3,5,Veneto,Veneto,4905854,2331330,47.52,0.04
129,2021-02-03,VEN,5938,1664,4274,480,5458,ITH,ITH3,5,Veneto,Veneto,4905854,2337268,47.64,0.12
130,2021-04-29,VEN,50208,23354,26854,37024,13184,ITH,ITH3,5,Veneto,Veneto,4905854,2387476,48.67,1.02
131,2021-05-16,VEN,28397,14002,14395,21319,7078,ITH,ITH3,5,Veneto,Veneto,4905854,2415873,49.24,0.58
132,2020-12-31,VEN,3219,1042,2177,3219,0,ITH,ITH3,5,Veneto,Veneto,4905854,2419092,49.31,0.07
133,2021-04-12,VEN,14903,6335,8568,6684,8219,ITH,ITH3,5,Veneto,Veneto,4905854,2433995,49.61,0.3
134,2021-03-15,VEN,16601,7266,9335,11384,5217,ITH,ITH3,5,Veneto,Veneto,4905854,2450596,49.95,0.34
135,2021-05-18,VEN,26628,12411,14217,13219,13409,ITH,ITH3,5,Veneto,Veneto,4905854,2477224,50.5,0.54
136,2021-01-15,VEN,5874,1819,4055,5874,0,ITH,ITH3,5,Veneto,Veneto,4905854,2483098,50.61,0.12
137,2021-02-09,VEN,5246,1889,3357,3446,1800,ITH,ITH3,5,Veneto,Veneto,4905854,2488344,50.72,0.11
138,2021-05-27,VEN,45294,22255,23039,22848,22446,ITH,ITH3,5,Veneto,Veneto,4905854,2533638,51.65,0.92
139,2021-03-10,VEN,18938,8638,10300,13255,5683,ITH,ITH3,5,Veneto,Veneto,4905854,2552576,52.03,0.39
140,2021-03-01,VEN,9394,3716,5678,7572,1822,ITH,ITH3,5,Veneto,Veneto,4905854,2561970,52.22,0.19
141,2021-04-03,VEN,21941,9626,12315,14225,7716,ITH,ITH3,5,Veneto,Veneto,4905854,2583911,52.67,0.45
142,2021-02-12,VEN,4314,1447,2867,3742,572,ITH,ITH3,5,Veneto,Veneto,4905854,2588225,52.76,0.09
143,2021-01-29,VEN,9019,2788,6231,367,8652,ITH,ITH3,5,Veneto,Veneto,4905854,2597244,52.94,0.18
144,2021-05-08,VEN,41179,18627,22552,29390,11789,ITH,ITH3,5,Veneto,Veneto,4905854,2638423,53.78,0.84
145,2021-03-24,VEN,22020,9504,12516,15212,6808,ITH,ITH3,5,Veneto,Veneto,4905854,2660443,54.23,0.45
146,2021-03-18,VEN,12608,5136,7472,7382,5226,ITH,ITH3,5,Veneto,Veneto,4905854,2673051,54.49,0.26
147,2021-05-07,VEN,48030,23029,25001,39417,8613,ITH,ITH3,5,Veneto,Veneto,4905854,2721081,55.47,0.98
148,2021-01-27,VEN,7138,2062,5076,241,6897,ITH,ITH3,5,Veneto,Veneto,4905854,2728219,55.61,0.15
149,2021-03-03,VEN,12044,4597,7447,8546,3498,ITH,ITH3,5,Veneto,Veneto,4905854,2740263,55.86,0.25
150,2021-04-22,VEN,31901,13887,18014,16156,15745,ITH,ITH3,5,Veneto,Veneto,4905854,2772164,56.51,0.65
151,2021-03-17,VEN,14643,5991,8652,7849,6794,ITH,ITH3,5,Veneto,Veneto,4905854,2786807,56.81,0.3
152,2021-01-12,VEN,5230,1516,3714,5230,0,ITH,ITH3,5,Veneto,Veneto,4905854,2792037,56.91,0.11
153,2021-01-26,VEN,6917,2091,4826,152,6765,ITH,ITH3,5,Veneto,Veneto,4905854,2798954,57.05,0.14
154,2021-05-06,VEN,46503,21818,24685,38077,8426,ITH,ITH3,5,Veneto,Veneto,4905854,2845457,58.0,0.95
155,2021-03-28,LOM,20474,7807,12667,14310,6164,ITC,ITC4,3,Lombardia,Lombardia,10060574,20474,0.2,0.2
156,2021-04-16,LOM,53618,23902,29716,39279,14339,ITC,ITC4,3,Lombardia,Lombardia,10060574,74092,0.74,0.53
157,2021-05-03,LOM,83639,39731,43908,71523,12116,ITC,ITC4,3,Lombardia,Lombardia,10060574,157731,1.57,0.83
158,2021-01-23,LOM,1114,357,757,916,198,ITC,ITC4,3,Lombardia,Lombardia,10060574,158845,1.58,0.01
159,2021-03-11,LOM,36239,13479,22760,26324,9915,ITC,ITC4,3,Lombardia,Lombardia,10060574,195084,1.94,0.36
160,2021-01-06,LOM,7061,2492,4569,7061,0,ITC,ITC4,3,Lombardia,Lombardia,10060574,202145,2.01,0.07
161,2021-01-30,LOM,12323,4570,7753,173,12150,ITC,ITC4,3,Lombardia,Lombardia,10060574,214468,2.13,0.12
162,2021-02-13,LOM,6416,2443,3973,4939,1477,ITC,ITC4,3,Lombardia,Lombardia,10060574,220884,2.2,0.06
163,2021-01-13,LOM,26378,8053,18325,26378,0,ITC,ITC4,3,Lombardia,Lombardia,10060574,247262,2.46,0.26
164,2021-05-24,LOM,89126,43243,45883,49427,39699,ITC,ITC4,3,Lombardia,Lombardia,10060574,336388,3.34,0.89
165,2021-02-11,LOM,17045,5004,12041,9700,7345,ITC,ITC4,3,Lombardia,Lombardia,10060574,353433,3.51,0.17
166,2021-05-31,LOM,95066,47121,47945,79267,15799,ITC,ITC4,3,Lombardia,Lombardia,10060574,448499,4.46,0.94
167,2021-03-26,LOM,41177,15617,25560,28108,13069,ITC,ITC4,3,Lombardia,Lombardia,10060574,489676,4.87,0.41
168,2021-05-22,LOM,70272,33706,36566,32348,37924,ITC,ITC4,3,Lombardia,Lombardia,10060574,559948,5.57,0.7
169,2021-05-29,LOM,87733,42138,45595,42000,45733,ITC,ITC4,3,Lombardia,Lombardia,10060574,647681,6.44,0.87
170,2021-02-18,LOM,14043,4928,9115,13015,1028,ITC,ITC4,3,Lombardia,Lombardia,10060574,661724,6.58,0.14
171,2021-02-20,LOM,9474,3905,5569,9175,299,ITC,ITC4,3,Lombardia,Lombardia,10060574,671198,6.67,0.09
172,2021-04-18,LOM,36344,16204,20140,31116,5228,ITC,ITC4,3,Lombardia,Lombardia,10060574,707542,7.03,0.36
173,2021-01-08,LOM,12698,3916,8782,12698,0,ITC,ITC4,3,Lombardia,Lombardia,10060574,720240,7.16,0.13
174,2021-01-09,LOM,12410,4573,7837,12410,0,ITC,ITC4,3,Lombardia,Lombardia,10060574,732650,7.28,0.12
175,2021-01-27,LOM,8045,2677,5368,821,7224,ITC,ITC4,3,Lombardia,Lombardia,10060574,740695,7.36,0.08
176,2021-05-21,LOM,93472,45094,48378,29047,64425,ITC,ITC4,3,Lombardia,Lombardia,10060574,834167,8.29,0.93
177,2021-03-18,LOM,27446,10966,16480,16196,11250,ITC,ITC4,3,Lombardia,Lombardia,10060574,861613,8.56,0.27
178,2021-03-14,LOM,14876,5349,9527,11590,3286,ITC,ITC4,3,Lombardia,Lombardia,10060574,876489,8.71,0.15
179,2021-05-17,LOM,94499,45265,49234,30197,64302,ITC,ITC4,3,Lombardia,Lombardia,10060574,970988,9.65,0.94
180,2021-02-08,LOM,10081,2918,7163,2139,7942,ITC,ITC4,3,Lombardia,Lombardia,10060574,981069,9.75,0.1
181,2021-02-25,LOM,15241,6313,8928,13663,1578,ITC,ITC4,3,Lombardia,Lombardia,10060574,996310,9.9,0.15
182,2021-04-02,LOM,41138,16828,24310,26692,14446,ITC,ITC4,3,Lombardia,Lombardia,10060574,1037448,10.31,0.41
183,2021-04-11,LOM,32187,13937,18250,24795,7392,ITC,ITC4,3,Lombardia,Lombardia,10060574,1069635,10.63,0.32
184,2021-02-27,LOM,13950,5872,8078,13308,642,ITC,ITC4,3,Lombardia,Lombardia,10060574,1083585,10.77,0.14
185,2020-12-30,LOM,114,42,72,114,0,ITC,ITC4,3,Lombardia,Lombardia,10060574,1083699,10.77,0.0
186,2021-01-16,LOM,15417,5725,9692,15417,0,ITC,ITC4,3,Lombardia,Lombardia,10060574,1099116,10.92,0.15
187,2021-03-07,LOM,12082,5355,6727,9523,2559,ITC,ITC4,3,Lombardia,Lombardia,10060574,1111198,11.05,0.12
188,2021-03-25,LOM,42654,15932,26722,30074,12580,ITC,ITC4,3,Lombardia,Lombardia,10060574,1153852,11.47,0.42
189,2021-05-07,LOM,92043,43579,48464,69870,22173,ITC,ITC4,3,Lombardia,Lombardia,10060574,1245895,12.38,0.91
190,2021-05-14,LOM,85581,41224,44357,55527,30054,ITC,ITC4,3,Lombardia,Lombardia,10060574,1331476,13.23,0.85
191,2021-04-14,LOM,47139,21018,26121,34172,12967,ITC,ITC4,3,Lombardia,Lombardia,10060574,1378615,13.7,0.47
192,2021-01-04,LOM,6080,2098,3982,6080,0,ITC,ITC4,3,Lombardia,Lombardia,10060574,1384695,13.76,0.06
193,2021-03-30,LOM,39491,15488,24003,24704,14787,ITC,ITC4,3,Lombardia,Lombardia,10060574,1424186,14.16,0.39
194,2021-02-23,LOM,11773,4792,6981,11465,308,ITC,ITC4,3,Lombardia,Lombardia,10060574,1435959,14.27,0.12
195,2021-05-19,LOM,82613,39493,43120,33780,48833,ITC,ITC4,3,Lombardia,Lombardia,10060574,1518572,15.09,0.82
196,2021-02-06,LOM,15260,5534,9726,1038,14222,ITC,ITC4,3,Lombardia,Lombardia,10060574,1533832,15.25,0.15
197,2021-05-02,LOM,83497,38330,45167,61037,22460,ITC,ITC4,3,Lombardia,Lombardia,10060574,1617329,16.08,0.83
198,2021-04-28,LOM,95585,43603,51982,68730,26855,ITC,ITC4,3,Lombardia,Lombardia,10060574,1712914,17.03,0.95
199,2021-03-16,LOM,25476,10112,15364,16418,9058,ITC,ITC4,3,Lombardia,Lombardia,10060574,1738390,17.28,0.25
200,2021-05-12,LOM,87201,41613,45588,59779,27422,ITC,ITC4,3,Lombardia,Lombardia,10060574,1825591,18.15,0.87
201,2021-03-09,LOM,33243,12854,20389,25817,7426,ITC,ITC4,3,Lombardia,Lombardia,10060574,1858834,18.48,0.33
202,2021-05-05,LOM,87782,41867,45915,72544,15238,ITC,ITC4,3,Lombardia,Lombardia,10060574,1946616,19.35,0.87
203,2021-01-18,LOM,9156,2968,6188,8175,981,ITC,ITC4,3,Lombardia,Lombardia,10060574,1955772,19.44,0.09
204,2021-03-23,LOM,42516,15403,27113,29639,12877,ITC,ITC4,3,Lombardia,Lombardia,10060574,1998288,19.86,0.42
205,2021-01-25,LOM,7025,2372,4653,487,6538,ITC,ITC4,3,Lombardia,Lombardia,10060574,2005313,19.93,0.07
206,2021-02-01,LOM,16056,5317,10739,304,15752,ITC,ITC4,3,Lombardia,Lombardia,10060574,2021369,20.09,0.16
207,2021-05-16,LOM,68484,32408,36076,36483,32001,ITC,ITC4,3,Lombardia,Lombardia,10060574,2089853,20.77,0.68
208,2021-02-05,LOM,25616,7442,18174,2397,23219,ITC,ITC4,3,Lombardia,Lombardia,10060574,2115469,21.03,0.25
209,2021-03-13,LOM,27176,9767,17409,21080,6096,ITC,ITC4,3,Lombardia,Lombardia,10060574,2142645,21.3,0.27
210,2021-05-01,LOM,95878,43646,52232,66745,29133,ITC,ITC4,3,Lombardia,Lombardia,10060574,2238523,22.25,0.95
211,2021-01-21,LOM,5342,1569,3773,4653,689,ITC,ITC4,3,Lombardia,Lombardia,10060574,2243865,22.3,0.05
212,2021-01-28,LOM,12196,3693,8503,777,11419,ITC,ITC4,3,Lombardia,Lombardia,10060574,2256061,22.42,0.12
213,2021-04-25,LOM,51451,23600,27851,46735,4716,ITC,ITC4,3,Lombardia,Lombardia,10060574,2307512,22.94,0.51
214,2021-03-22,LOM,40305,14291,26014,29761,10544,ITC,ITC4,3,Lombardia,Lombardia,10060574,2347817,23.34,0.4
215,2021-04-08,LOM,52329,21754,30575,35873,16456,ITC,ITC4,3,Lombardia,Lombardia,10060574,2400146,23.86,0.52
216,2021-04-22,LOM,73780,33333,40447,57486,16294,ITC,ITC4,3,Lombardia,Lombardia,10060574,2473926,24.59,0.73
217,2021-02-17,LOM,11975,3747,8228,10585,1390,ITC,ITC4,3,Lombardia,Lombardia,10060574,2485901,24.71,0.12
218,2021-04-05,LOM,27387,11697,15690,19277,8110,ITC,ITC4,3,Lombardia,Lombardia,10060574,2513288,24.98,0.27
219,2021-01-31,LOM,9747,3763,5984,34,9713,ITC,ITC4,3,Lombardia,Lombardia,10060574,2523035,25.08,0.1
220,2021-05-25,LOM,90746,43424,47322,44576,46170,ITC,ITC4,3,Lombardia,Lombardia,10060574,2613781,25.98,0.9
221,2021-04-23,LOM,73368,33272,40096,56858,16510,ITC,ITC4,3,Lombardia,Lombardia,10060574,2687149,26.71,0.73
222,2021-05-10,LOM,85184,40858,44326,63680,21504,ITC,ITC4,3,Lombardia,Lombardia,10060574,2772333,27.56,0.85
223,2021-03-21,LOM,23577,8549,15028,18316,5261,ITC,ITC4,3,Lombardia,Lombardia,10060574,2795910,27.79,0.23
224,2021-03-04,LOM,29418,12149,17269,20287,9131,ITC,ITC4,3,Lombardia,Lombardia,10060574,2825328,28.08,0.29
225,2021-01-15,LOM,25207,7431,17776,25207,0,ITC,ITC4,3,Lombardia,Lombardia,10060574,2850535,28.33,0.25
226,2021-02-04,LOM,27681,8076,19605,1998,25683,ITC,ITC4,3,Lombardia,Lombardia,10060574,2878216,28.61,0.28
227,2021-04-09,LOM,52222,22289,29933,36225,15997,ITC,ITC4,3,Lombardia,Lombardia,10060574,2930438,29.13,0.52
228,2021-04-04,LOM,7617,3232,4385,3718,3899,ITC,ITC4,3,Lombardia,Lombardia,10060574,2938055,29.2,0.08
229,2021-01-01,LOM,24,7,17,24,0,ITC,ITC4,3,Lombardia,Lombardia,10060574,2938079,29.2,0.0
230,2021-03-06,LOM,21317,9087,12230,16801,4516,ITC,ITC4,3,Lombardia,Lombardia,10060574,2959396,29.42,0.21
231,2021-02-03,LOM,25577,7908,17669,1151,24426,ITC,ITC4,3,Lombardia,Lombardia,10060574,2984973,29.67,0.25
232,2021-04-01,LOM,42935,17218,25717,26741,16194,ITC,ITC4,3,Lombardia,Lombardia,10060574,3027908,30.1,0.43
233,2021-04-26,LOM,87926,40915,47011,68767,19159,ITC,ITC4,3,Lombardia,Lombardia,10060574,3115834,30.97,0.87
234,2021-04-12,LOM,47226,20573,26653,32893,14333,ITC,ITC4,3,Lombardia,Lombardia,10060574,3163060,31.44,0.47
235,2021-02-21,LOM,5052,1862,3190,5034,18,ITC,ITC4,3,Lombardia,Lombardia,10060574,3168112,31.49,0.05
236,2021-04-03,LOM,36240,14861,21379,26160,10080,ITC,ITC4,3,Lombardia,Lombardia,10060574,3204352,31.85,0.36
237,2021-05-30,LOM,74233,35535,38698,34317,39916,ITC,ITC4,3,Lombardia,Lombardia,10060574,3278585,32.59,0.74
238,2021-05-23,LOM,60726,28915,31811,26788,33938,ITC,ITC4,3,Lombardia,Lombardia,10060574,3339311,33.19,0.6
239,2021-02-12,LOM,13946,4355,9591,9027,4919,ITC,ITC4,3,Lombardia,Lombardia,10060574,3353257,33.33,0.14
240,2021-04-10,LOM,52374,21699,30675,40581,11793,ITC,ITC4,3,Lombardia,Lombardia,10060574,3405631,33.85,0.52
241,2021-01-07,LOM,11761,3636,8125,11761,0,ITC,ITC4,3,Lombardia,Lombardia,10060574,3417392,33.97,0.12
242,2021-02-19,LOM,14115,5369,8746,13435,680,ITC,ITC4,3,Lombardia,Lombardia,10060574,3431507,34.11,0.14
243,2021-04-17,LOM,48394,21259,27135,37625,10769,ITC,ITC4,3,Lombardia,Lombardia,10060574,3479901,34.59,0.48
244,2021-02-26,LOM,18382,7557,10825,16516,1866,ITC,ITC4,3,Lombardia,Lombardia,10060574,3498283,34.77,0.18
245,2021-04-13,LOM,47579,21239,26340,33511,14068,ITC,ITC4,3,Lombardia,Lombardia,10060574,3545862,35.25,0.47
246,2021-04-30,LOM,116894,54639,62255,89700,27194,ITC,ITC4,3,Lombardia,Lombardia,10060574,3662756,36.41,1.16
247,2021-01-22,LOM,3105,866,2239,3035,70,ITC,ITC4,3,Lombardia,Lombardia,10060574,3665861,36.44,0.03
248,2021-01-05,LOM,7821,2566,5255,7821,0,ITC,ITC4,3,Lombardia,Lombardia,10060574,3673682,36.52,0.08
249,2021-03-27,LOM,32440,12373,20067,23717,8723,ITC,ITC4,3,Lombardia,Lombardia,10060574,3706122,36.84,0.32
250,2021-03-08,LOM,29769,11187,18582,22698,7071,ITC,ITC4,3,Lombardia,Lombardia,10060574,3735891,37.13,0.3
251,2021-01-24,LOM,1201,459,742,537,664,ITC,ITC4,3,Lombardia,Lombardia,10060574,3737092,37.15,0.01
252,2021-05-15,LOM,80530,38660,41870,47329,33201,ITC,ITC4,3,Lombardia,Lombardia,10060574,3817622,37.95,0.8
253,2021-02-02,LOM,19850,6584,13266,491,19359,ITC,ITC4,3,Lombardia,Lombardia,10060574,3837472,38.14,0.2
254,2021-05-06,LOM,89714,42155,47559,73291,16423,ITC,ITC4,3,Lombardia,Lombardia,10060574,3927186,39.04,0.89
255,2021-02-10,LOM,14392,4504,9888,7572,6820,ITC,ITC4,3,Lombardia,Lombardia,10060574,3941578,39.18,0.14
256,2021-06-01,LOM,64357,31101,33256,51728,12629,ITC,ITC4,3,Lombardia,Lombardia,10060574,4005935,39.82,0.64
257,2021-01-02,LOM,199,72,127,199,0,ITC,ITC4,3,Lombardia,Lombardia,10060574,4006134,39.82,0.0
258,2021-02-28,LOM,7890,3257,4633,7674,216,ITC,ITC4,3,Lombardia,Lombardia,10060574,4014024,39.9,0.08
259,2021-04-19,LOM,60097,27341,32756,50691,9406,ITC,ITC4,3,Lombardia,Lombardia,10060574,4074121,40.5,0.6
260,2021-03-20,LOM,32513,12152,20361,22661,9852,ITC,ITC4,3,Lombardia,Lombardia,10060574,4106634,40.82,0.32
261,2021-05-09,LOM,69514,32811,36703,56427,13087,ITC,ITC4,3,Lombardia,Lombardia,10060574,4176148,41.51,0.69
262,2021-01-29,LOM,13439,4115,9324,654,12785,ITC,ITC4,3,Lombardia,Lombardia,10060574,4189587,41.64,0.13
263,2021-03-05,LOM,28993,11949,17044,20586,8407,ITC,ITC4,3,Lombardia,Lombardia,10060574,4218580,41.93,0.29
264,2021-03-19,LOM,32421,12908,19513,19216,13205,ITC,ITC4,3,Lombardia,Lombardia,10060574,4251001,42.25,0.32
265,2021-04-24,LOM,75677,33539,42138,54614,21063,ITC,ITC4,3,Lombardia,Lombardia,10060574,4326678,43.01,0.75
266,2021-01-14,LOM,26801,7782,19019,26801,0,ITC,ITC4,3,Lombardia,Lombardia,10060574,4353479,43.27,0.27
267,2021-05-08,LOM,87347,40589,46758,65654,21693,ITC,ITC4,3,Lombardia,Lombardia,10060574,4440826,44.14,0.87
268,2021-05-18,LOM,88010,42053,45957,32581,55429,ITC,ITC4,3,Lombardia,Lombardia,10060574,4528836,45.02,0.87
269,2021-02-24,LOM,14677,5928,8749,13749,928,ITC,ITC4,3,Lombardia,Lombardia,10060574,4543513,45.16,0.15
270,2021-02-22,LOM,11894,4808,7086,11586,308,ITC,ITC4,3,Lombardia,Lombardia,10060574,4555407,45.28,0.12
271,2021-02-07,LOM,7308,2821,4487,340,6968,ITC,ITC4,3,Lombardia,Lombardia,10060574,4562715,45.35,0.07
272,2021-01-19,LOM,8125,2348,5777,7651,474,ITC,ITC4,3,Lombardia,Lombardia,10060574,4570840,45.43,0.08
273,2021-04-29,LOM,115379,53540,61839,85587,29792,ITC,ITC4,3,Lombardia,Lombardia,10060574,4686219,46.58,1.15
274,2021-04-20,LOM,67619,30815,36804,57290,10329,ITC,ITC4,3,Lombardia,Lombardia,10060574,4753838,47.25,0.67
275,2021-01-10,LOM,10519,3957,6562,10519,0,ITC,ITC4,3,Lombardia,Lombardia,10060574,4764357,47.36,0.1
276,2021-01-17,LOM,8348,3347,5001,8147,201,ITC,ITC4,3,Lombardia,Lombardia,10060574,4772705,47.44,0.08
277,2021-03-15,LOM,31571,11334,20237,23053,8518,ITC,ITC4,3,Lombardia,Lombardia,10060574,4804276,47.75,0.31
278,2021-04-27,LOM,85906,39949,45957,69370,16536,ITC,ITC4,3,Lombardia,Lombardia,10060574,4890182,48.61,0.85
279,2021-03-17,LOM,26256,10492,15764,15245,11011,ITC,ITC4,3,Lombardia,Lombardia,10060574,4916438,48.87,0.26
280,2021-03-24,LOM,43326,15629,27697,31439,11887,ITC,ITC4,3,Lombardia,Lombardia,10060574,4959764,49.3,0.43
281,2021-02-09,LOM,12285,3344,8941,4113,8172,ITC,ITC4,3,Lombardia,Lombardia,10060574,4972049,49.42,0.12
282,2021-01-20,LOM,5608,1373,4235,5493,115,ITC,ITC4,3,Lombardia,Lombardia,10060574,4977657,49.48,0.06
283,2021-04-15,LOM,49396,21840,27556,35584,13812,ITC,ITC4,3,Lombardia,Lombardia,10060574,5027053,49.97,0.49
284,2021-01-03,LOM,854,316,538,854,0,ITC,ITC4,3,Lombardia,Lombardia,10060574,5027907,49.98,0.01
285,2021-03-12,LOM,35249,12955,22294,25044,10205,ITC,ITC4,3,Lombardia,Lombardia,10060574,5063156,50.33,0.35
286,2021-03-29,LOM,40016,15514,24502,25181,14835,ITC,ITC4,3,Lombardia,Lombardia,10060574,5103172,50.72,0.4
287,2021-05-04,LOM,86764,41049,45715,72401,14363,ITC,ITC4,3,Lombardia,Lombardia,10060574,5189936,51.59,0.86
288,2021-03-01,LOM,18797,8232,10565,17092,1705,ITC,ITC4,3,Lombardia,Lombardia,10060574,5208733,51.77,0.19
289,2021-05-13,LOM,86931,41682,45249,58231,28700,ITC,ITC4,3,Lombardia,Lombardia,10060574,5295664,52.64,0.86
290,2021-03-31,LOM,41974,16988,24986,26739,15235,ITC,ITC4,3,Lombardia,Lombardia,10060574,5337638,53.06,0.42
291,2021-03-10,LOM,33244,12731,20513,25386,7858,ITC,ITC4,3,Lombardia,Lombardia,10060574,5370882,53.39,0.33
292,2021-01-26,LOM,8376,2721,5655,371,8005,ITC,ITC4,3,Lombardia,Lombardia,10060574,5379258,53.47,0.08
293,2021-05-20,LOM,94136,45490,48646,31771,62365,ITC,ITC4,3,Lombardia,Lombardia,10060574,5473394,54.4,0.94
294,2020-12-29,LOM,104,44,60,104,0,ITC,ITC4,3,Lombardia,Lombardia,10060574,5473498,54.41,0.0
295,2021-03-03,LOM,26944,11505,15439,19671,7273,ITC,ITC4,3,Lombardia,Lombardia,10060574,5500442,54.67,0.27
296,2021-05-11,LOM,86707,41367,45340,60604,26103,ITC,ITC4,3,Lombardia,Lombardia,10060574,5587149,55.54,0.86
297,2021-05-28,LOM,92727,44480,48247,42753,49974,ITC,ITC4,3,Lombardia,Lombardia,10060574,5679876,56.46,0.92
298,2021-02-14,LOM,3578,1546,2032,2944,634,ITC,ITC4,3,Lombardia,Lombardia,10060574,5683454,56.49,0.04
299,2021-01-12,LOM,20220,6698,13522,20220,0,ITC,ITC4,3,Lombardia,Lombardia,10060574,5703674,56.69,0.2
300,2020-12-31,LOM,714,301,413,714,0,ITC,ITC4,3,Lombardia,Lombardia,10060574,5704388,56.7,0.01
301,2021-02-16,LOM,9544,3086,6458,9088,456,ITC,ITC4,3,Lombardia,Lombardia,10060574,5713932,56.8,0.09
302,2021-03-02,LOM,22850,9713,13137,19815,3035,ITC,ITC4,3,Lombardia,Lombardia,10060574,5736782,57.02,0.23
303,2020-12-28,LOM,107,47,60,107,0,ITC,ITC4,3,Lombardia,Lombardia,10060574,5736889,57.02,0.0
304,2021-04-21,LOM,71658,32506,39152,57068,14590,ITC,ITC4,3,Lombardia,Lombardia,10060574,5808547,57.74,0.71
305,2021-01-11,LOM,16174,5362,10812,16174,0,ITC,ITC4,3,Lombardia,Lombardia,10060574,5824721,57.9,0.16
306,2021-04-06,LOM,43045,17563,25482,25092,17953,ITC,ITC4,3,Lombardia,Lombardia,10060574,5867766,58.32,0.43
307,2021-05-26,LOM,92993,44323,48670,43472,49521,ITC,ITC4,3,Lombardia,Lombardia,10060574,5960759,59.25,0.92
308,2021-02-15,LOM,8916,3120,5796,8495,421,ITC,ITC4,3,Lombardia,Lombardia,10060574,5969675,59.34,0.09
309,2020-12-27,LOM,717,413,304,717,0,ITC,ITC4,3,Lombardia,Lombardia,10060574,5970392,59.34,0.01
310,2021-05-27,LOM,94157,45170,48987,41195,52962,ITC,ITC4,3,Lombardia,Lombardia,10060574,6064549,60.28,0.94
311,2021-04-07,LOM,50525,20877,29648,34712,15813,ITC,ITC4,3,Lombardia,Lombardia,10060574,6115074,60.78,0.5
312,2021-05-22,TOS,25954,12623,13331,21699,4255,ITI,ITI1,9,Toscana,Toscana,3729641,25954,0.7,0.7
313,2021-05-05,TOS,30016,13368,16648,15644,14372,ITI,ITI1,9,Toscana,Toscana,3729641,55970,1.5,0.8
314,2021-02-11,TOS,5383,2021,3362,5141,242,ITI,ITI1,9,Toscana,Toscana,3729641,61353,1.65,0.14
315,2021-02-09,TOS,4488,1468,3020,3877,611,ITI,ITI1,9,Toscana,Toscana,3729641,65841,1.77,0.12
316,2021-01-25,TOS,5127,1896,3231,248,4879,ITI,ITI1,9,Toscana,Toscana,3729641,70968,1.9,0.14
317,2021-05-07,TOS,32057,14668,17389,11986,20071,ITI,ITI1,9,Toscana,Toscana,3729641,103025,2.76,0.86
318,2021-03-26,TOS,20404,9160,11244,14644,5760,ITI,ITI1,9,Toscana,Toscana,3729641,123429,3.31,0.55
319,2021-03-09,TOS,10674,4152,6522,5122,5552,ITI,ITI1,9,Toscana,Toscana,3729641,134103,3.6,0.29
320,2021-04-09,TOS,24531,10545,13986,21122,3409,ITI,ITI1,9,Toscana,Toscana,3729641,158634,4.25,0.66
321,2021-02-04,TOS,4253,1594,2659,961,3292,ITI,ITI1,9,Toscana,Toscana,3729641,162887,4.37,0.11
322,2021-05-29,TOS,31222,15092,16130,23276,7946,ITI,ITI1,9,Toscana,Toscana,3729641,194109,5.2,0.84
323,2021-03-23,TOS,9093,4102,4991,6819,2274,ITI,ITI1,9,Toscana,Toscana,3729641,203202,5.45,0.24
324,2021-05-12,TOS,34123,15545,18578,14160,19963,ITI,ITI1,9,Toscana,Toscana,3729641,237325,6.36,0.91
325,2021-01-18,TOS,1119,636,483,1021,98,ITI,ITI1,9,Toscana,Toscana,3729641,238444,6.39,0.03
326,2021-04-07,TOS,35634,15292,20342,28386,7248,ITI,ITI1,9,Toscana,Toscana,3729641,274078,7.35,0.96
327,2021-04-16,TOS,28955,12889,16066,22045,6910,ITI,ITI1,9,Toscana,Toscana,3729641,303033,8.12,0.78
328,2021-03-02,TOS,10598,3798,6800,7154,3444,ITI,ITI1,9,Toscana,Toscana,3729641,313631,8.41,0.28
329,2021-01-04,TOS,5065,1894,3171,5065,0,ITI,ITI1,9,Toscana,Toscana,3729641,318696,8.54,0.14
330,2021-04-14,TOS,20158,8334,11824,15049,5109,ITI,ITI1,9,Toscana,Toscana,3729641,338854,9.09,0.54
331,2021-03-04,TOS,17625,6759,10866,14543,3082,ITI,ITI1,9,Toscana,Toscana,3729641,356479,9.56,0.47
332,2021-01-06,TOS,4520,1460,3060,4520,0,ITI,ITI1,9,Toscana,Toscana,3729641,360999,9.68,0.12
333,2021-03-19,TOS,10136,4457,5679,7271,2865,ITI,ITI1,9,Toscana,Toscana,3729641,371135,9.95,0.27
334,2021-01-21,TOS,1589,686,903,867,722,ITI,ITI1,9,Toscana,Toscana,3729641,372724,9.99,0.04
335,2021-02-08,TOS,4097,1360,2737,3638,459,ITI,ITI1,9,Toscana,Toscana,3729641,376821,10.1,0.11
336,2021-04-13,TOS,8490,3508,4982,6032,2458,ITI,ITI1,9,Toscana,Toscana,3729641,385311,10.33,0.23
337,2021-05-26,TOS,35177,16775,18402,20168,15009,ITI,ITI1,9,Toscana,Toscana,3729641,420488,11.27,0.94
338,2021-03-30,TOS,16861,7498,9363,13297,3564,ITI,ITI1,9,Toscana,Toscana,3729641,437349,11.73,0.45
339,2021-01-09,TOS,4485,1596,2889,4485,0,ITI,ITI1,9,Toscana,Toscana,3729641,441834,11.85,0.12
340,2021-03-18,TOS,9970,3981,5989,6005,3965,ITI,ITI1,9,Toscana,Toscana,3729641,451804,12.11,0.27
341,2021-04-04,TOS,13910,6601,7309,13657,253,ITI,ITI1,9,Toscana,Toscana,3729641,465714,12.49,0.37
342,2021-01-11,TOS,5094,1691,3403,5094,0,ITI,ITI1,9,Toscana,Toscana,3729641,470808,12.62,0.14
343,2021-02-23,TOS,7721,3324,4397,7560,161,ITI,ITI1,9,Toscana,Toscana,3729641,478529,12.83,0.21
344,2021-05-02,TOS,11167,4931,6236,9204,1963,ITI,ITI1,9,Toscana,Toscana,3729641,489696,13.13,0.3
345,2021-01-20,TOS,1331,637,694,1083,248,ITI,ITI1,9,Toscana,Toscana,3729641,491027,13.17,0.04
346,2021-04-23,TOS,25676,11429,14247,9361,16315,ITI,ITI1,9,Toscana,Toscana,3729641,516703,13.85,0.69
347,2021-01-28,TOS,6282,1882,4400,354,5928,ITI,ITI1,9,Toscana,Toscana,3729641,522985,14.02,0.17
348,2021-04-06,TOS,22170,9774,12396,18456,3714,ITI,ITI1,9,Toscana,Toscana,3729641,545155,14.62,0.59
349,2021-05-19,TOS,27755,13434,14321,18865,8890,ITI,ITI1,9,Toscana,Toscana,3729641,572910,15.36,0.74
350,2021-02-28,TOS,1649,667,982,922,727,ITI,ITI1,9,Toscana,Toscana,3729641,574559,15.41,0.04
351,2021-05-24,TOS,33367,16400,16967,24090,9277,ITI,ITI1,9,Toscana,Toscana,3729641,607926,16.3,0.89
352,2021-04-18,TOS,8338,4083,4255,7342,996,ITI,ITI1,9,Toscana,Toscana,3729641,616264,16.52,0.22
353,2021-02-13,TOS,7785,2360,5425,7558,227,ITI,ITI1,9,Toscana,Toscana,3729641,624049,16.73,0.21
354,2021-04-02,TOS,31944,13534,18410,23921,8023,ITI,ITI1,9,Toscana,Toscana,3729641,655993,17.59,0.86
355,2021-03-16,TOS,4903,1884,3019,2653,2250,ITI,ITI1,9,Toscana,Toscana,3729641,660896,17.72,0.13
356,2021-02-27,TOS,1982,755,1227,1080,902,ITI,ITI1,9,Toscana,Toscana,3729641,662878,17.77,0.05
357,2021-05-17,TOS,29477,14631,14846,20806,8671,ITI,ITI1,9,Toscana,Toscana,3729641,692355,18.56,0.79
358,2021-03-21,TOS,3231,1573,1658,1798,1433,ITI,ITI1,9,Toscana,Toscana,3729641,695586,18.65,0.09
359,2021-01-23,TOS,3949,1354,2595,640,3309,ITI,ITI1,9,Toscana,Toscana,3729641,699535,18.76,0.11
360,2021-05-03,TOS,11933,5510,6423,10614,1319,ITI,ITI1,9,Toscana,Toscana,3729641,711468,19.08,0.32
361,2021-03-28,TOS,6212,2808,3404,5958,254,ITI,ITI1,9,Toscana,Toscana,3729641,717680,19.24,0.17
362,2021-01-30,TOS,4622,1622,3000,198,4424,ITI,ITI1,9,Toscana,Toscana,3729641,722302,19.37,0.12
363,2021-05-10,TOS,26137,12350,13787,15521,10616,ITI,ITI1,9,Toscana,Toscana,3729641,748439,20.07,0.7
364,2021-03-14,TOS,7207,2574,4633,3272,3935,ITI,ITI1,9,Toscana,Toscana,3729641,755646,20.26,0.19
365,2021-02-06,TOS,4527,1550,2977,1294,3233,ITI,ITI1,9,Toscana,Toscana,3729641,760173,20.38,0.12
366,2021-04-01,TOS,26904,11107,15797,16301,10603,ITI,ITI1,9,Toscana,Toscana,3729641,787077,21.1,0.72
367,2021-01-27,TOS,4835,1573,3262,206,4629,ITI,ITI1,9,Toscana,Toscana,3729641,791912,21.23,0.13
368,2021-03-17,TOS,11421,4586,6835,6893,4528,ITI,ITI1,9,Toscana,Toscana,3729641,803333,21.54,0.31
369,2021-05-14,TOS,33252,15381,17871,20633,12619,ITI,ITI1,9,Toscana,Toscana,3729641,836585,22.43,0.89
370,2021-01-17,TOS,2536,871,1665,2023,513,ITI,ITI1,9,Toscana,Toscana,3729641,839121,22.5,0.07
371,2021-05-30,TOS,28535,13886,14649,21687,6848,ITI,ITI1,9,Toscana,Toscana,3729641,867656,23.26,0.77
372,2020-12-31,TOS,804,202,602,804,0,ITI,ITI1,9,Toscana,Toscana,3729641,868460,23.29,0.02
373,2021-05-15,TOS,29295,13829,15466,23559,5736,ITI,ITI1,9,Toscana,Toscana,3729641,897755,24.07,0.79
374,2021-04-28,TOS,19119,8188,10931,3830,15289,ITI,ITI1,9,Toscana,Toscana,3729641,916874,24.58,0.51
375,2021-02-18,TOS,8819,3284,5535,7924,895,ITI,ITI1,9,Toscana,Toscana,3729641,925693,24.82,0.24
376,2020-12-30,TOS,327,104,223,327,0,ITI,ITI1,9,Toscana,Toscana,3729641,926020,24.83,0.01
377,2021-02-01,TOS,5509,1958,3551,521,4988,ITI,ITI1,9,Toscana,Toscana,3729641,931529,24.98,0.15
378,2021-03-11,TOS,15495,5993,9502,12169,3326,ITI,ITI1,9,Toscana,Toscana,3729641,947024,25.39,0.42
379,2021-05-20,TOS,29445,13649,15796,18896,10549,ITI,ITI1,9,Toscana,Toscana,3729641,976469,26.18,0.79
380,2021-04-21,TOS,29599,12663,16936,17515,12084,ITI,ITI1,9,Toscana,Toscana,3729641,1006068,26.97,0.79
381,2021-02-16,TOS,9279,3339,5940,8558,721,ITI,ITI1,9,Toscana,Toscana,3729641,1015347,27.22,0.25
382,2021-02-25,TOS,10635,4306,6329,9636,999,ITI,ITI1,9,Toscana,Toscana,3729641,1025982,27.51,0.29
383,2021-04-30,TOS,40059,17717,22342,20204,19855,ITI,ITI1,9,Toscana,Toscana,3729641,1066041,28.58,1.07
384,2021-04-25,TOS,11054,5248,5806,8917,2137,ITI,ITI1,9,Toscana,Toscana,3729641,1077095,28.88,0.3
385,2021-01-13,TOS,4062,1398,2664,4062,0,ITI,ITI1,9,Toscana,Toscana,3729641,1081157,28.99,0.11
386,2020-12-27,TOS,620,267,353,620,0,ITI,ITI1,9,Toscana,Toscana,3729641,1081777,29.0,0.02
387,2021-05-08,TOS,29123,13104,16019,13693,15430,ITI,ITI1,9,Toscana,Toscana,3729641,1110900,29.79,0.78
388,2021-01-14,TOS,3255,1179,2076,3255,0,ITI,ITI1,9,Toscana,Toscana,3729641,1114155,29.87,0.09
389,2021-04-15,TOS,24385,10190,14195,15864,8521,ITI,ITI1,9,Toscana,Toscana,3729641,1138540,30.53,0.65
390,2021-02-17,TOS,8175,3169,5006,7423,752,ITI,ITI1,9,Toscana,Toscana,3729641,1146715,30.75,0.22
391,2021-05-28,TOS,29734,13664,16070,17461,12273,ITI,ITI1,9,Toscana,Toscana,3729641,1176449,31.54,0.8
392,2021-04-22,TOS,35721,15303,20418,18281,17440,ITI,ITI1,9,Toscana,Toscana,3729641,1212170,32.5,0.96
393,2021-02-24,TOS,10372,4467,5905,10171,201,ITI,ITI1,9,Toscana,Toscana,3729641,1222542,32.78,0.28
394,2021-04-08,TOS,29655,12538,17117,23275,6380,ITI,ITI1,9,Toscana,Toscana,3729641,1252197,33.57,0.8
395,2021-03-03,TOS,18193,6509,11684,14587,3606,ITI,ITI1,9,Toscana,Toscana,3729641,1270390,34.06,0.49
396,2021-01-05,TOS,5249,1755,3494,5249,0,ITI,ITI1,9,Toscana,Toscana,3729641,1275639,34.2,0.14
397,2021-01-19,TOS,1104,531,573,1104,0,ITI,ITI1,9,Toscana,Toscana,3729641,1276743,34.23,0.03
398,2021-05-21,TOS,28598,13225,15373,17445,11153,ITI,ITI1,9,Toscana,Toscana,3729641,1305341,35.0,0.77
399,2021-03-01,TOS,4472,1733,2739,832,3640,ITI,ITI1,9,Toscana,Toscana,3729641,1309813,35.12,0.12
400,2021-05-04,TOS,18301,8207,10094,12854,5447,ITI,ITI1,9,Toscana,Toscana,3729641,1328114,35.61,0.49
401,2021-02-12,TOS,7606,2683,4923,7393,213,ITI,ITI1,9,Toscana,Toscana,3729641,1335720,35.81,0.2
402,2021-01-26,TOS,5393,1792,3601,220,5173,ITI,ITI1,9,Toscana,Toscana,3729641,1341113,35.96,0.14
403,2021-04-17,TOS,20533,9206,11327,18411,2122,ITI,ITI1,9,Toscana,Toscana,3729641,1361646,36.51,0.55
404,2021-03-20,TOS,6489,2883,3606,5353,1136,ITI,ITI1,9,Toscana,Toscana,3729641,1368135,36.68,0.17
405,2021-02-14,TOS,9000,2569,6431,8890,110,ITI,ITI1,9,Toscana,Toscana,3729641,1377135,36.92,0.24
406,2021-03-29,TOS,9391,4588,4803,9067,324,ITI,ITI1,9,Toscana,Toscana,3729641,1386526,37.18,0.25
407,2021-05-27,TOS,27867,12808,15059,13249,14618,ITI,ITI1,9,Toscana,Toscana,3729641,1414393,37.92,0.75
408,2021-01-03,TOS,3335,1051,2284,3335,0,ITI,ITI1,9,Toscana,Toscana,3729641,1417728,38.01,0.09
409,2021-02-15,TOS,8771,3375,5396,7946,825,ITI,ITI1,9,Toscana,Toscana,3729641,1426499,38.25,0.24
410,2021-02-22,TOS,9818,4254,5564,9541,277,ITI,ITI1,9,Toscana,Toscana,3729641,1436317,38.51,0.26
411,2021-03-12,TOS,16521,6220,10301,12993,3528,ITI,ITI1,9,Toscana,Toscana,3729641,1452838,38.95,0.44
412,2021-04-24,TOS,13433,6163,7270,5989,7444,ITI,ITI1,9,Toscana,Toscana,3729641,1466271,39.31,0.36
413,2021-02-03,TOS,4221,1452,2769,241,3980,ITI,ITI1,9,Toscana,Toscana,3729641,1470492,39.43,0.11
414,2021-03-25,TOS,23613,10124,13489,15275,8338,ITI,ITI1,9,Toscana,Toscana,3729641,1494105,40.06,0.63
415,2021-05-13,TOS,34822,15305,19517,13720,21102,ITI,ITI1,9,Toscana,Toscana,3729641,1528927,40.99,0.93
416,2021-04-29,TOS,39341,17711,21630,19237,20104,ITI,ITI1,9,Toscana,Toscana,3729641,1568268,42.05,1.05
417,2021-03-24,TOS,19687,8004,11683,10230,9457,ITI,ITI1,9,Toscana,Toscana,3729641,1587955,42.58,0.53
418,2021-03-10,TOS,18013,7073,10940,13996,4017,ITI,ITI1,9,Toscana,Toscana,3729641,1605968,43.06,0.48
419,2021-01-08,TOS,5946,1642,4304,5946,0,ITI,ITI1,9,Toscana,Toscana,3729641,1611914,43.22,0.16
420,2021-03-15,TOS,8356,3332,5024,3913,4443,ITI,ITI1,9,Toscana,Toscana,3729641,1620270,43.44,0.22
421,2021-01-10,TOS,3001,1104,1897,3001,0,ITI,ITI1,9,Toscana,Toscana,3729641,1623271,43.52,0.08
422,2021-04-20,TOS,18157,8111,10046,12599,5558,ITI,ITI1,9,Toscana,Toscana,3729641,1641428,44.01,0.49
423,2021-04-03,TOS,15013,6646,8367,13887,1126,ITI,ITI1,9,Toscana,Toscana,3729641,1656441,44.41,0.4
424,2021-02-26,TOS,10076,3833,6243,8870,1206,ITI,ITI1,9,Toscana,Toscana,3729641,1666517,44.68,0.27
425,2021-02-05,TOS,5749,2245,3504,1924,3825,ITI,ITI1,9,Toscana,Toscana,3729641,1672266,44.84,0.15
426,2021-05-16,TOS,26659,12879,13780,24200,2459,ITI,ITI1,9,Toscana,Toscana,3729641,1698925,45.55,0.71
427,2021-05-11,TOS,27936,12979,14957,12479,15457,ITI,ITI1,9,Toscana,Toscana,3729641,1726861,46.3,0.75
428,2021-03-13,TOS,9275,3301,5974,5312,3963,ITI,ITI1,9,Toscana,Toscana,3729641,1736136,46.55,0.25
429,2021-01-29,TOS,6144,1700,4444,304,5840,ITI,ITI1,9,Toscana,Toscana,3729641,1742280,46.71,0.16
430,2021-05-09,TOS,22515,9760,12755,9656,12859,ITI,ITI1,9,Toscana,Toscana,3729641,1764795,47.32,0.6
431,2021-01-31,TOS,3050,1129,1921,106,2944,ITI,ITI1,9,Toscana,Toscana,3729641,1767845,47.4,0.08
432,2021-04-05,TOS,15279,6823,8456,14542,737,ITI,ITI1,9,Toscana,Toscana,3729641,1783124,47.81,0.41
433,2021-02-07,TOS,2805,952,1853,885,1920,ITI,ITI1,9,Toscana,Toscana,3729641,1785929,47.88,0.08
434,2021-05-18,TOS,28689,14133,14556,19976,8713,ITI,ITI1,9,Toscana,Toscana,3729641,1814618,48.65,0.77
435,2021-05-23,TOS,28368,13642,14726,25804,2564,ITI,ITI1,9,Toscana,Toscana,3729641,1842986,49.41,0.76
436,2021-02-10,TOS,4263,1281,2982,3740,523,ITI,ITI1,9,Toscana,Toscana,3729641,1847249,49.53,0.11
437,2021-05-06,TOS,31291,13599,17692,14171,17120,ITI,ITI1,9,Toscana,Toscana,3729641,1878540,50.37,0.84
438,2021-04-19,TOS,9097,4506,4591,8069,1028,ITI,ITI1,9,Toscana,Toscana,3729641,1887637,50.61,0.24
439,2021-02-02,TOS,3742,1475,2267,195,3547,ITI,ITI1,9,Toscana,Toscana,3729641,1891379,50.71,0.1
440,2021-01-22,TOS,2866,1064,1802,528,2338,ITI,ITI1,9,Toscana,Toscana,3729641,1894245,50.79,0.08
441,2021-03-27,TOS,8860,4150,4710,8645,215,ITI,ITI1,9,Toscana,Toscana,3729641,1903105,51.03,0.24
442,2021-05-25,TOS,33814,16216,17598,19336,14478,ITI,ITI1,9,Toscana,Toscana,3729641,1936919,51.93,0.91
443,2021-03-31,TOS,32574,13135,19439,20418,12156,ITI,ITI1,9,Toscana,Toscana,3729641,1969493,52.81,0.87
444,2021-03-05,TOS,16494,6336,10158,11752,4742,ITI,ITI1,9,Toscana,Toscana,3729641,1985987,53.25,0.44
445,2021-04-27,TOS,10347,4910,5437,3866,6481,ITI,ITI1,9,Toscana,Toscana,3729641,1996334,53.53,0.28
446,2021-03-08,TOS,6371,2630,3741,1551,4820,ITI,ITI1,9,Toscana,Toscana,3729641,2002705,53.7,0.17
447,2021-04-10,TOS,11723,5349,6374,10978,745,ITI,ITI1,9,Toscana,Toscana,3729641,2014428,54.01,0.31
448,2021-02-19,TOS,8291,2952,5339,7781,510,ITI,ITI1,9,Toscana,Toscana,3729641,2022719,54.23,0.22
449,2021-01-24,TOS,3349,1073,2276,201,3148,ITI,ITI1,9,Toscana,Toscana,3729641,2026068,54.32,0.09
450,2021-01-07,TOS,6018,1751,4267,6018,0,ITI,ITI1,9,Toscana,Toscana,3729641,2032086,54.48,0.16
451,2021-05-01,TOS,23308,10060,13248,14135,9173,ITI,ITI1,9,Toscana,Toscana,3729641,2055394,55.11,0.62
452,2021-03-22,TOS,4890,2451,2439,4446,444,ITI,ITI1,9,Toscana,Toscana,3729641,2060284,55.24,0.13
453,2021-01-12,TOS,3581,1398,2183,3581,0,ITI,ITI1,9,Toscana,Toscana,3729641,2063865,55.34,0.1
454,2021-01-16,TOS,3271,1046,2225,3271,0,ITI,ITI1,9,Toscana,Toscana,3729641,2067136,55.42,0.09
455,2021-04-26,TOS,10153,4943,5210,7598,2555,ITI,ITI1,9,Toscana,Toscana,3729641,2077289,55.7,0.27
456,2021-01-02,TOS,3497,1096,2401,3497,0,ITI,ITI1,9,Toscana,Toscana,3729641,2080786,55.79,0.09
457,2021-03-07,TOS,5647,2357,3290,2105,3542,ITI,ITI1,9,Toscana,Toscana,3729641,2086433,55.94,0.15
458,2021-02-20,TOS,4640,1789,2851,4127,513,ITI,ITI1,9,Toscana,Toscana,3729641,2091073,56.07,0.12
459,2021-05-31,TOS,29895,14330,15565,19250,10645,ITI,ITI1,9,Toscana,Toscana,3729641,2120968,56.87,0.8
460,2021-01-01,TOS,2369,787,1582,2369,0,ITI,ITI1,9,Toscana,Toscana,3729641,2123337,56.93,0.06
461,2021-04-11,TOS,3642,1679,1963,3487,155,ITI,ITI1,9,Toscana,Toscana,3729641,2126979,57.03,0.1
462,2021-03-06,TOS,7094,2838,4256,2901,4193,ITI,ITI1,9,Toscana,Toscana,3729641,2134073,57.22,0.19
463,2021-01-15,TOS,3878,1347,2531,3878,0,ITI,ITI1,9,Toscana,Toscana,3729641,2137951,57.32,0.1
464,2021-04-12,TOS,2612,1183,1429,1958,654,ITI,ITI1,9,Toscana,Toscana,3729641,2140563,57.39,0.07
465,2021-02-21,TOS,5105,2089,3016,4935,170,ITI,ITI1,9,Toscana,Toscana,3729641,2145668,57.53,0.14
466,2021-06-01,TOS,14815,7195,7620,12373,2442,ITI,ITI1,9,Toscana,Toscana,3729641,2160483,57.93,0.4
467,2021-03-26,LIG,9121,3855,5266,5967,3154,ITC,ITC3,7,Liguria,Liguria,1550640,9121,0.59,0.59
468,2021-02-18,LIG,2761,1126,1635,2430,331,ITC,ITC3,7,Liguria,Liguria,1550640,11882,0.77,0.18
469,2021-05-14,LIG,12875,5647,7228,8578,4297,ITC,ITC3,7,Liguria,Liguria,1550640,24757,1.6,0.83
470,2021-05-31,LIG,14266,7078,7188,8905,5361,ITC,ITC3,7,Liguria,Liguria,1550640,39023,2.52,0.92
471,2021-02-20,LIG,1335,637,698,1334,1,ITC,ITC3,7,Liguria,Liguria,1550640,40358,2.6,0.09
472,2021-01-09,LIG,1335,481,854,1335,0,ITC,ITC3,7,Liguria,Liguria,1550640,41693,2.69,0.09
473,2021-02-13,LIG,1080,508,572,800,280,ITC,ITC3,7,Liguria,Liguria,1550640,42773,2.76,0.07
474,2021-05-29,LIG,6788,3222,3566,3949,2839,ITC,ITC3,7,Liguria,Liguria,1550640,49561,3.2,0.44
475,2021-04-23,LIG,14672,6637,8035,8552,6120,ITC,ITC3,7,Liguria,Liguria,1550640,64233,4.14,0.95
476,2021-03-11,LIG,6351,3053,3298,4345,2006,ITC,ITC3,7,Liguria,Liguria,1550640,70584,4.55,0.41
477,2021-01-13,LIG,2754,1013,1741,2754,0,ITC,ITC3,7,Liguria,Liguria,1550640,73338,4.73,0.18
478,2021-04-16,LIG,11970,5279,6691,10160,1810,ITC,ITC3,7,Liguria,Liguria,1550640,85308,5.5,0.77
479,2021-01-06,LIG,1660,616,1044,1660,0,ITC,ITC3,7,Liguria,Liguria,1550640,86968,5.61,0.11
480,2021-03-14,LIG,1659,752,907,1055,604,ITC,ITC3,7,Liguria,Liguria,1550640,88627,5.72,0.11
481,2021-01-23,LIG,809,295,514,153,656,ITC,ITC3,7,Liguria,Liguria,1550640,89436,5.77,0.05
482,2021-05-17,LIG,11828,5358,6470,8526,3302,ITC,ITC3,7,Liguria,Liguria,1550640,101264,6.53,0.76
483,2021-01-30,LIG,1661,567,1094,25,1636,ITC,ITC3,7,Liguria,Liguria,1550640,102925,6.64,0.11
484,2021-03-28,LIG,1141,511,630,390,751,ITC,ITC3,7,Liguria,Liguria,1550640,104066,6.71,0.07
485,2021-01-28,LIG,2847,971,1876,39,2808,ITC,ITC3,7,Liguria,Liguria,1550640,106913,6.89,0.18
486,2021-01-21,LIG,1103,385,718,672,431,ITC,ITC3,7,Liguria,Liguria,1550640,108016,6.97,0.07
487,2021-01-14,LIG,2980,1055,1925,2980,0,ITC,ITC3,7,Liguria,Liguria,1550640,110996,7.16,0.19
488,2021-03-12,LIG,6150,2814,3336,3681,2469,ITC,ITC3,7,Liguria,Liguria,1550640,117146,7.55,0.4
489,2021-04-26,LIG,10446,4914,5532,7820,2626,ITC,ITC3,7,Liguria,Liguria,1550640,127592,8.23,0.67
490,2021-02-04,LIG,2817,986,1831,179,2638,ITC,ITC3,7,Liguria,Liguria,1550640,130409,8.41,0.18
491,2021-02-21,LIG,869,491,378,865,4,ITC,ITC3,7,Liguria,Liguria,1550640,131278,8.47,0.06
492,2021-01-18,LIG,2137,745,1392,1980,157,ITC,ITC3,7,Liguria,Liguria,1550640,133415,8.6,0.14
493,2021-04-07,LIG,13583,6031,7552,11294,2289,ITC,ITC3,7,Liguria,Liguria,1550640,146998,9.48,0.88
494,2021-02-23,LIG,3806,1559,2247,3697,109,ITC,ITC3,7,Liguria,Liguria,1550640,150804,9.73,0.25
495,2021-03-04,LIG,4738,2118,2620,3891,847,ITC,ITC3,7,Liguria,Liguria,1550640,155542,10.03,0.31
496,2021-05-10,LIG,12505,5504,7001,6132,6373,ITC,ITC3,7,Liguria,Liguria,1550640,168047,10.84,0.81
497,2021-05-03,LIG,13266,5918,7348,6454,6812,ITC,ITC3,7,Liguria,Liguria,1550640,181313,11.69,0.86
498,2021-03-21,LIG,550,220,330,69,481,ITC,ITC3,7,Liguria,Liguria,1550640,181863,11.73,0.04
499,2021-02-06,LIG,1892,768,1124,145,1747,ITC,ITC3,7,Liguria,Liguria,1550640,183755,11.85,0.12
500,2021-01-02,LIG,691,245,446,691,0,ITC,ITC3,7,Liguria,Liguria,1550640,184446,11.89,0.04
501,2021-03-07,LIG,1858,1085,773,1557,301,ITC,ITC3,7,Liguria,Liguria,1550640,186304,12.01,0.12
502,2021-03-09,LIG,5930,2753,3177,4500,1430,ITC,ITC3,7,Liguria,Liguria,1550640,192234,12.4,0.38
503,2021-01-16,LIG,1278,557,721,1278,0,ITC,ITC3,7,Liguria,Liguria,1550640,193512,12.48,0.08
504,2021-02-02,LIG,2668,1005,1663,134,2534,ITC,ITC3,7,Liguria,Liguria,1550640,196180,12.65,0.17
505,2021-04-28,LIG,14442,6519,7923,6458,7984,ITC,ITC3,7,Liguria,Liguria,1550640,210622,13.58,0.93
506,2021-05-15,LIG,7183,3195,3988,4296,2887,ITC,ITC3,7,Liguria,Liguria,1550640,217805,14.05,0.46
507,2020-12-30,LIG,12,5,7,12,0,ITC,ITC3,7,Liguria,Liguria,1550640,217817,14.05,0.0
508,2021-04-11,LIG,4248,1930,2318,3999,249,ITC,ITC3,7,Liguria,Liguria,1550640,222065,14.32,0.27
509,2021-02-16,LIG,2397,954,1443,2004,393,ITC,ITC3,7,Liguria,Liguria,1550640,224462,14.48,0.15
510,2021-05-27,LIG,16319,8219,8100,12398,3921,ITC,ITC3,7,Liguria,Liguria,1550640,240781,15.53,1.05
511,2021-04-14,LIG,13028,5658,7370,10826,2202,ITC,ITC3,7,Liguria,Liguria,1550640,253809,16.37,0.84
512,2021-02-09,LIG,1936,689,1247,256,1680,ITC,ITC3,7,Liguria,Liguria,1550640,255745,16.49,0.12
513,2021-01-04,LIG,2615,854,1761,2615,0,ITC,ITC3,7,Liguria,Liguria,1550640,258360,16.66,0.17
514,2021-05-19,LIG,13516,5943,7573,10407,3109,ITC,ITC3,7,Liguria,Liguria,1550640,271876,17.53,0.87
515,2021-03-23,LIG,9036,4082,4954,5827,3209,ITC,ITC3,7,Liguria,Liguria,1550640,280912,18.12,0.58
516,2021-02-01,LIG,2557,922,1635,90,2467,ITC,ITC3,7,Liguria,Liguria,1550640,283469,18.28,0.16
517,2021-05-12,LIG,11881,5325,6556,6541,5340,ITC,ITC3,7,Liguria,Liguria,1550640,295350,19.05,0.77
518,2021-05-26,LIG,16134,8004,8130,11981,4153,ITC,ITC3,7,Liguria,Liguria,1550640,311484,20.09,1.04
519,2021-03-30,LIG,12141,5378,6763,8752,3389,ITC,ITC3,7,Liguria,Liguria,1550640,323625,20.87,0.78
520,2021-05-16,LIG,3693,1855,1838,2133,1560,ITC,ITC3,7,Liguria,Liguria,1550640,327318,21.11,0.24
521,2021-02-03,LIG,2314,790,1524,55,2259,ITC,ITC3,7,Liguria,Liguria,1550640,329632,21.26,0.15
522,2021-02-05,LIG,2673,986,1687,304,2369,ITC,ITC3,7,Liguria,Liguria,1550640,332305,21.43,0.17
523,2020-12-31,LIG,989,354,635,989,0,ITC,ITC3,7,Liguria,Liguria,1550640,333294,21.49,0.06
524,2021-04-10,LIG,7883,3556,4327,6969,914,ITC,ITC3,7,Liguria,Liguria,1550640,341177,22.0,0.51
525,2021-02-11,LIG,1979,767,1212,1103,876,ITC,ITC3,7,Liguria,Liguria,1550640,343156,22.13,0.13
526,2021-05-22,LIG,6551,3195,3356,4943,1608,ITC,ITC3,7,Liguria,Liguria,1550640,349707,22.55,0.42
527,2021-03-19,LIG,5294,2234,3060,2149,3145,ITC,ITC3,7,Liguria,Liguria,1550640,355001,22.89,0.34
528,2021-04-02,LIG,11670,5116,6554,9184,2486,ITC,ITC3,7,Liguria,Liguria,1550640,366671,23.65,0.75
529,2021-05-08,LIG,7527,3332,4195,2314,5213,ITC,ITC3,7,Liguria,Liguria,1550640,374198,24.13,0.49
530,2021-04-04,LIG,756,366,390,507,249,ITC,ITC3,7,Liguria,Liguria,1550640,374954,24.18,0.05
531,2021-04-18,LIG,2613,1164,1449,2145,468,ITC,ITC3,7,Liguria,Liguria,1550640,377567,24.35,0.17
532,2021-01-27,LIG,1744,603,1141,141,1603,ITC,ITC3,7,Liguria,Liguria,1550640,379311,24.46,0.11
533,2021-05-21,LIG,12831,5950,6881,9706,3125,ITC,ITC3,7,Liguria,Liguria,1550640,392142,25.29,0.83
534,2021-03-18,LIG,4981,2124,2857,2008,2973,ITC,ITC3,7,Liguria,Liguria,1550640,397123,25.61,0.32
535,2021-04-01,LIG,12374,5467,6907,9604,2770,ITC,ITC3,7,Liguria,Liguria,1550640,409497,26.41,0.8
536,2021-01-26,LIG,2484,803,1681,13,2471,ITC,ITC3,7,Liguria,Liguria,1550640,411981,26.57,0.16
537,2021-02-28,LIG,1058,580,478,1049,9,ITC,ITC3,7,Liguria,Liguria,1550640,413039,26.64,0.07
538,2021-04-19,LIG,12807,5613,7194,8999,3808,ITC,ITC3,7,Liguria,Liguria,1550640,425846,27.46,0.83
539,2021-05-24,LIG,11654,5421,6233,9175,2479,ITC,ITC3,7,Liguria,Liguria,1550640,437500,28.21,0.75
540,2021-05-07,LIG,13566,6020,7546,5782,7784,ITC,ITC3,7,Liguria,Liguria,1550640,451066,29.09,0.87
541,2021-03-20,LIG,2316,995,1321,1142,1174,ITC,ITC3,7,Liguria,Liguria,1550640,453382,29.24,0.15
542,2021-01-15,LIG,2255,754,1501,2255,0,ITC,ITC3,7,Liguria,Liguria,1550640,455637,29.38,0.15
543,2021-04-25,LIG,1936,921,1015,1521,415,ITC,ITC3,7,Liguria,Liguria,1550640,457573,29.51,0.12
544,2021-03-13,LIG,3827,1616,2211,2972,855,ITC,ITC3,7,Liguria,Liguria,1550640,461400,29.76,0.25
545,2021-04-09,LIG,12422,5554,6868,10683,1739,ITC,ITC3,7,Liguria,Liguria,1550640,473822,30.56,0.8
546,2021-03-31,LIG,11841,5206,6635,9071,2770,ITC,ITC3,7,Liguria,Liguria,1550640,485663,31.32,0.76
547,2020-12-28,LIG,80,30,50,80,0,ITC,ITC3,7,Liguria,Liguria,1550640,485743,31.33,0.01
548,2021-02-25,LIG,3455,1349,2106,3325,130,ITC,ITC3,7,Liguria,Liguria,1550640,489198,31.55,0.22
549,2021-04-30,LIG,14346,6389,7957,5778,8568,ITC,ITC3,7,Liguria,Liguria,1550640,503544,32.47,0.93
550,2021-04-08,LIG,13723,6156,7567,11680,2043,ITC,ITC3,7,Liguria,Liguria,1550640,517267,33.36,0.88
551,2021-02-17,LIG,2688,1181,1507,2262,426,ITC,ITC3,7,Liguria,Liguria,1550640,519955,33.53,0.17
552,2021-01-05,LIG,2879,896,1983,2879,0,ITC,ITC3,7,Liguria,Liguria,1550640,522834,33.72,0.19
553,2021-04-22,LIG,13816,6194,7622,8746,5070,ITC,ITC3,7,Liguria,Liguria,1550640,536650,34.61,0.89
554,2021-01-07,LIG,3229,1095,2134,3229,0,ITC,ITC3,7,Liguria,Liguria,1550640,539879,34.82,0.21
555,2021-04-17,LIG,7383,3217,4166,6633,750,ITC,ITC3,7,Liguria,Liguria,1550640,547262,35.29,0.48
556,2021-05-01,LIG,7131,3253,3878,1332,5799,ITC,ITC3,7,Liguria,Liguria,1550640,554393,35.75,0.46
557,2021-03-05,LIG,4869,2150,2719,3737,1132,ITC,ITC3,7,Liguria,Liguria,1550640,559262,36.07,0.31
558,2021-01-01,LIG,144,55,89,144,0,ITC,ITC3,7,Liguria,Liguria,1550640,559406,36.08,0.01
559,2021-03-27,LIG,3921,1538,2383,2525,1396,ITC,ITC3,7,Liguria,Liguria,1550640,563327,36.33,0.25
560,2021-04-13,LIG,13076,5866,7210,11052,2024,ITC,ITC3,7,Liguria,Liguria,1550640,576403,37.17,0.84
561,2021-05-13,LIG,13017,5843,7174,8804,4213,ITC,ITC3,7,Liguria,Liguria,1550640,589420,38.01,0.84
562,2021-05-30,LIG,3275,1603,1672,1364,1911,ITC,ITC3,7,Liguria,Liguria,1550640,592695,38.22,0.21
563,2021-03-10,LIG,5877,2839,3038,3971,1906,ITC,ITC3,7,Liguria,Liguria,1550640,598572,38.6,0.38
564,2021-05-02,LIG,3876,1767,2109,505,3371,ITC,ITC3,7,Liguria,Liguria,1550640,602448,38.85,0.25
565,2021-01-29,LIG,3079,1064,2015,67,3012,ITC,ITC3,7,Liguria,Liguria,1550640,605527,39.05,0.2
566,2021-01-20,LIG,1550,555,995,1538,12,ITC,ITC3,7,Liguria,Liguria,1550640,607077,39.15,0.1
567,2021-05-11,LIG,13658,6171,7487,7068,6590,ITC,ITC3,7,Liguria,Liguria,1550640,620735,40.03,0.88
568,2021-04-15,LIG,11819,5220,6599,9967,1852,ITC,ITC3,7,Liguria,Liguria,1550640,632554,40.79,0.76
569,2021-05-28,LIG,15898,7877,8021,11517,4381,ITC,ITC3,7,Liguria,Liguria,1550640,648452,41.82,1.03
570,2021-03-03,LIG,4580,1847,2733,3554,1026,ITC,ITC3,7,Liguria,Liguria,1550640,653032,42.11,0.3
571,2021-02-24,LIG,3763,1560,2203,3505,258,ITC,ITC3,7,Liguria,Liguria,1550640,656795,42.36,0.24
572,2020-12-29,LIG,125,33,92,125,0,ITC,ITC3,7,Liguria,Liguria,1550640,656920,42.36,0.01
573,2021-01-12,LIG,2459,885,1574,2459,0,ITC,ITC3,7,Liguria,Liguria,1550640,659379,42.52,0.16
574,2021-05-23,LIG,2305,1119,1186,1182,1123,ITC,ITC3,7,Liguria,Liguria,1550640,661684,42.67,0.15
575,2021-04-03,LIG,5404,2497,2907,4461,943,ITC,ITC3,7,Liguria,Liguria,1550640,667088,43.02,0.35
576,2021-02-12,LIG,1927,689,1238,895,1032,ITC,ITC3,7,Liguria,Liguria,1550640,669015,43.14,0.12
577,2021-04-06,LIG,13170,5857,7313,10930,2240,ITC,ITC3,7,Liguria,Liguria,1550640,682185,43.99,0.85
578,2021-02-08,LIG,1976,741,1235,306,1670,ITC,ITC3,7,Liguria,Liguria,1550640,684161,44.12,0.13
579,2020-12-27,LIG,135,56,79,135,0,ITC,ITC3,7,Liguria,Liguria,1550640,684296,44.13,0.01
580,2021-02-15,LIG,2262,839,1423,1865,397,ITC,ITC3,7,Liguria,Liguria,1550640,686558,44.28,0.15
581,2021-01-03,LIG,734,230,504,734,0,ITC,ITC3,7,Liguria,Liguria,1550640,687292,44.32,0.05
582,2021-02-22,LIG,3334,1467,1867,3192,142,ITC,ITC3,7,Liguria,Liguria,1550640,690626,44.54,0.22
583,2021-04-27,LIG,14735,6675,8060,7156,7579,ITC,ITC3,7,Liguria,Liguria,1550640,705361,45.49,0.95
584,2021-04-29,LIG,15548,6974,8574,6731,8817,ITC,ITC3,7,Liguria,Liguria,1550640,720909,46.49,1.0
585,2021-04-12,LIG,12381,5475,6906,10362,2019,ITC,ITC3,7,Liguria,Liguria,1550640,733290,47.29,0.8
586,2021-01-19,LIG,1371,438,933,1281,90,ITC,ITC3,7,Liguria,Liguria,1550640,734661,47.38,0.09
587,2021-03-24,LIG,8942,3833,5109,5656,3286,ITC,ITC3,7,Liguria,Liguria,1550640,743603,47.95,0.58
588,2021-01-17,LIG,862,300,562,862,0,ITC,ITC3,7,Liguria,Liguria,1550640,744465,48.01,0.06
589,2021-02-14,LIG,233,122,111,233,0,ITC,ITC3,7,Liguria,Liguria,1550640,744698,48.03,0.02
590,2021-05-25,LIG,13718,6598,7120,10729,2989,ITC,ITC3,7,Liguria,Liguria,1550640,758416,48.91,0.88
591,2021-03-22,LIG,7663,3399,4264,4727,2936,ITC,ITC3,7,Liguria,Liguria,1550640,766079,49.4,0.49
592,2021-02-07,LIG,407,153,254,2,405,ITC,ITC3,7,Liguria,Liguria,1550640,766486,49.43,0.03
593,2021-05-18,LIG,13320,6010,7310,10035,3285,ITC,ITC3,7,Liguria,Liguria,1550640,779806,50.29,0.86
594,2021-05-20,LIG,12814,5941,6873,8796,4018,ITC,ITC3,7,Liguria,Liguria,1550640,792620,51.12,0.83
595,2021-03-08,LIG,5629,2459,3170,3940,1689,ITC,ITC3,7,Liguria,Liguria,1550640,798249,51.48,0.36
596,2021-03-25,LIG,9593,4080,5513,6200,3393,ITC,ITC3,7,Liguria,Liguria,1550640,807842,52.1,0.62
597,2021-02-19,LIG,3213,1305,1908,3037,176,ITC,ITC3,7,Liguria,Liguria,1550640,811055,52.3,0.21
598,2021-06-01,LIG,11111,5525,5586,7324,3787,ITC,ITC3,7,Liguria,Liguria,1550640,822166,53.02,0.72
599,2021-03-06,LIG,3304,1842,1462,2599,705,ITC,ITC3,7,Liguria,Liguria,1550640,825470,53.23,0.21
600,2021-01-22,LIG,1817,604,1213,1331,486,ITC,ITC3,7,Liguria,Liguria,1550640,827287,53.35,0.12
601,2021-05-04,LIG,13601,6079,7522,5374,8227,ITC,ITC3,7,Liguria,Liguria,1550640,840888,54.23,0.88
602,2021-05-09,LIG,2825,1245,1580,1115,1710,ITC,ITC3,7,Liguria,Liguria,1550640,843713,54.41,0.18
603,2021-04-05,LIG,3976,1751,2225,2327,1649,ITC,ITC3,7,Liguria,Liguria,1550640,847689,54.67,0.26
604,2021-01-08,LIG,2926,999,1927,2926,0,ITC,ITC3,7,Liguria,Liguria,1550640,850615,54.86,0.19
605,2021-02-27,LIG,1888,921,967,1759,129,ITC,ITC3,7,Liguria,Liguria,1550640,852503,54.98,0.12
606,2021-02-10,LIG,2314,837,1477,1019,1295,ITC,ITC3,7,Liguria,Liguria,1550640,854817,55.13,0.15
607,2021-03-17,LIG,5552,2368,3184,2473,3079,ITC,ITC3,7,Liguria,Liguria,1550640,860369,55.48,0.36
608,2021-05-06,LIG,14462,6404,8058,6162,8300,ITC,ITC3,7,Liguria,Liguria,1550640,874831,56.42,0.93
609,2021-01-31,LIG,624,270,354,9,615,ITC,ITC3,7,Liguria,Liguria,1550640,875455,56.46,0.04
610,2021-04-24,LIG,8169,3785,4384,5018,3151,ITC,ITC3,7,Liguria,Liguria,1550640,883624,56.98,0.53
611,2021-02-26,LIG,3765,1523,2242,3437,328,ITC,ITC3,7,Liguria,Liguria,1550640,887389,57.23,0.24
612,2021-03-29,LIG,10437,4509,5928,7308,3129,ITC,ITC3,7,Liguria,Liguria,1550640,897826,57.9,0.67
613,2021-03-02,LIG,4074,1689,2385,3764,310,ITC,ITC3,7,Liguria,Liguria,1550640,901900,58.16,0.26
614,2021-04-21,LIG,14244,6432,7812,8922,5322,ITC,ITC3,7,Liguria,Liguria,1550640,916144,59.08,0.92
615,2021-01-25,LIG,2723,888,1835,478,2245,ITC,ITC3,7,Liguria,Liguria,1550640,918867,59.26,0.18
616,2021-05-05,LIG,13666,6122,7544,5250,8416,ITC,ITC3,7,Liguria,Liguria,1550640,932533,60.14,0.88
617,2021-03-16,LIG,6073,2722,3351,2349,3724,ITC,ITC3,7,Liguria,Liguria,1550640,938606,60.53,0.39
618,2021-01-11,LIG,2653,989,1664,2653,0,ITC,ITC3,7,Liguria,Liguria,1550640,941259,60.7,0.17
619,2021-01-10,LIG,648,262,386,648,0,ITC,ITC3,7,Liguria,Liguria,1550640,941907,60.74,0.04
620,2021-04-20,LIG,14207,6503,7704,9861,4346,ITC,ITC3,7,Liguria,Liguria,1550640,956114,61.66,0.92
621,2021-03-01,LIG,3506,1430,2076,3384,122,ITC,ITC3,7,Liguria,Liguria,1550640,959620,61.89,0.23
622,2021-01-24,LIG,756,237,519,113,643,ITC,ITC3,7,Liguria,Liguria,1550640,960376,61.93,0.05
623,2021-03-15,LIG,7193,3056,4137,4492,2701,ITC,ITC3,7,Liguria,Liguria,1550640,967569,62.4,0.46
624,2021-02-20,CAL,1415,758,657,1097,318,ITF,ITF6,18,Calabria,Calabria,1947131,1415,0.07,0.07
625,2021-05-31,CAL,15188,7267,7921,7348,7840,ITF,ITF6,18,Calabria,Calabria,1947131,16603,0.85,0.78
626,2021-03-11,CAL,7249,3419,3830,5987,1262,ITF,ITF6,18,Calabria,Calabria,1947131,23852,1.22,0.37
627,2021-05-14,CAL,19943,9588,10355,13073,6870,ITF,ITF6,18,Calabria,Calabria,1947131,43795,2.25,1.02
628,2021-02-03,CAL,2765,1429,1336,581,2184,ITF,ITF6,18,Calabria,Calabria,1947131,46560,2.39,0.14
629,2021-05-16,CAL,13774,6725,7049,9960,3814,ITF,ITF6,18,Calabria,Calabria,1947131,60334,3.1,0.71
630,2021-04-18,CAL,5840,2790,3050,4931,909,ITF,ITF6,18,Calabria,Calabria,1947131,66174,3.4,0.3
631,2021-04-04,CAL,1763,887,876,1262,501,ITF,ITF6,18,Calabria,Calabria,1947131,67937,3.49,0.09
632,2021-02-13,CAL,1395,603,792,1031,364,ITF,ITF6,18,Calabria,Calabria,1947131,69332,3.56,0.07
633,2021-03-18,CAL,4369,2037,2332,2342,2027,ITF,ITF6,18,Calabria,Calabria,1947131,73701,3.79,0.22
634,2021-01-27,CAL,1457,733,724,396,1061,ITF,ITF6,18,Calabria,Calabria,1947131,75158,3.86,0.07
635,2021-01-06,CAL,928,501,427,928,0,ITF,ITF6,18,Calabria,Calabria,1947131,76086,3.91,0.05
636,2021-04-16,CAL,10298,5009,5289,8645,1653,ITF,ITF6,18,Calabria,Calabria,1947131,86384,4.44,0.53
637,2021-02-18,CAL,1822,825,997,1596,226,ITF,ITF6,18,Calabria,Calabria,1947131,88206,4.53,0.09
638,2021-04-23,CAL,12851,6318,6533,9442,3409,ITF,ITF6,18,Calabria,Calabria,1947131,101057,5.19,0.66
639,2021-01-13,CAL,2031,1023,1008,2031,0,ITF,ITF6,18,Calabria,Calabria,1947131,103088,5.29,0.1
640,2021-03-13,CAL,6839,2984,3855,5871,968,ITF,ITF6,18,Calabria,Calabria,1947131,109927,5.65,0.35
641,2021-01-15,CAL,2795,1258,1537,2795,0,ITF,ITF6,18,Calabria,Calabria,1947131,112722,5.79,0.14
642,2021-04-25,CAL,15833,8033,7800,14696,1137,ITF,ITF6,18,Calabria,Calabria,1947131,128555,6.6,0.81
643,2021-01-23,CAL,400,186,214,358,42,ITF,ITF6,18,Calabria,Calabria,1947131,128955,6.62,0.02
644,2021-03-28,CAL,2567,1184,1383,1434,1133,ITF,ITF6,18,Calabria,Calabria,1947131,131522,6.75,0.13
645,2021-01-30,CAL,2178,1149,1029,358,1820,ITF,ITF6,18,Calabria,Calabria,1947131,133700,6.87,0.11
646,2021-02-17,CAL,1832,797,1035,1621,211,ITF,ITF6,18,Calabria,Calabria,1947131,135532,6.96,0.09
647,2021-04-01,CAL,8518,3857,4661,3980,4538,ITF,ITF6,18,Calabria,Calabria,1947131,144050,7.4,0.44
648,2021-04-08,CAL,9403,4430,4973,5808,3595,ITF,ITF6,18,Calabria,Calabria,1947131,153453,7.88,0.48
649,2021-05-21,CAL,21329,10858,10471,13967,7362,ITF,ITF6,18,Calabria,Calabria,1947131,174782,8.98,1.1
650,2021-04-30,CAL,14905,7315,7590,10597,4308,ITF,ITF6,18,Calabria,Calabria,1947131,189687,9.74,0.77
651,2021-01-18,CAL,1263,569,694,1043,220,ITF,ITF6,18,Calabria,Calabria,1947131,190950,9.81,0.06
652,2021-04-13,CAL,6778,3268,3510,5469,1309,ITF,ITF6,18,Calabria,Calabria,1947131,197728,10.15,0.35
653,2021-03-27,CAL,8584,3895,4689,4589,3995,ITF,ITF6,18,Calabria,Calabria,1947131,206312,10.6,0.44
654,2021-03-04,CAL,5465,3183,2282,4668,797,ITF,ITF6,18,Calabria,Calabria,1947131,211777,10.88,0.28
655,2021-01-29,CAL,2048,986,1062,230,1818,ITF,ITF6,18,Calabria,Calabria,1947131,213825,10.98,0.11
656,2021-05-02,CAL,12502,5834,6668,10664,1838,ITF,ITF6,18,Calabria,Calabria,1947131,226327,11.62,0.64
657,2021-02-06,CAL,2906,1337,1569,442,2464,ITF,ITF6,18,Calabria,Calabria,1947131,229233,11.77,0.15
658,2021-05-28,CAL,20958,10162,10796,11477,9481,ITF,ITF6,18,Calabria,Calabria,1947131,250191,12.85,1.08
659,2021-04-15,CAL,7604,3725,3879,5980,1624,ITF,ITF6,18,Calabria,Calabria,1947131,257795,13.24,0.39
660,2021-02-10,CAL,2509,1078,1431,884,1625,ITF,ITF6,18,Calabria,Calabria,1947131,260304,13.37,0.13
661,2021-03-09,CAL,6305,3246,3059,5326,979,ITF,ITF6,18,Calabria,Calabria,1947131,266609,13.69,0.32
662,2021-04-27,CAL,9946,4889,5057,8004,1942,ITF,ITF6,18,Calabria,Calabria,1947131,276555,14.2,0.51
663,2021-02-22,CAL,2031,1028,1003,1475,556,ITF,ITF6,18,Calabria,Calabria,1947131,278586,14.31,0.1
664,2021-04-11,CAL,4166,1895,2271,2223,1943,ITF,ITF6,18,Calabria,Calabria,1947131,282752,14.52,0.21
665,2021-01-20,CAL,1399,626,773,1398,1,ITF,ITF6,18,Calabria,Calabria,1947131,284151,14.59,0.07
666,2021-01-03,CAL,6,3,3,6,0,ITF,ITF6,18,Calabria,Calabria,1947131,284157,14.59,0.0
667,2021-03-08,CAL,5411,2900,2511,4350,1061,ITF,ITF6,18,Calabria,Calabria,1947131,289568,14.87,0.28
668,2021-03-25,CAL,7386,3463,3923,4547,2839,ITF,ITF6,18,Calabria,Calabria,1947131,296954,15.25,0.38
669,2021-01-04,CAL,1051,517,534,1051,0,ITF,ITF6,18,Calabria,Calabria,1947131,298005,15.3,0.05
670,2021-02-01,CAL,2494,1191,1303,243,2251,ITF,ITF6,18,Calabria,Calabria,1947131,300499,15.43,0.13
671,2021-05-12,CAL,16380,7956,8424,10954,5426,ITF,ITF6,18,Calabria,Calabria,1947131,316879,16.27,0.84
672,2021-05-26,CAL,18491,9140,9351,10284,8207,ITF,ITF6,18,Calabria,Calabria,1947131,335370,17.22,0.95
673,2021-03-30,CAL,6190,2657,3533,3485,2705,ITF,ITF6,18,Calabria,Calabria,1947131,341560,17.54,0.32
674,2021-05-19,CAL,18447,9138,9309,11430,7017,ITF,ITF6,18,Calabria,Calabria,1947131,360007,18.49,0.95
675,2021-03-23,CAL,5253,2459,2794,3443,1810,ITF,ITF6,18,Calabria,Calabria,1947131,365260,18.76,0.27
676,2021-02-15,CAL,1140,539,601,991,149,ITF,ITF6,18,Calabria,Calabria,1947131,366400,18.82,0.06
677,2020-12-27,CAL,281,156,125,281,0,ITF,ITF6,18,Calabria,Calabria,1947131,366681,18.83,0.01
678,2021-04-06,CAL,7549,3401,4148,4195,3354,ITF,ITF6,18,Calabria,Calabria,1947131,374230,19.22,0.39
679,2021-04-10,CAL,11373,5128,6245,6559,4814,ITF,ITF6,18,Calabria,Calabria,1947131,385603,19.8,0.58
680,2021-02-05,CAL,3800,1710,2090,490,3310,ITF,ITF6,18,Calabria,Calabria,1947131,389403,20.0,0.2
681,2021-03-26,CAL,7856,3724,4132,4730,3126,ITF,ITF6,18,Calabria,Calabria,1947131,397259,20.4,0.4
682,2021-02-11,CAL,2329,1040,1289,1082,1247,ITF,ITF6,18,Calabria,Calabria,1947131,399588,20.52,0.12
683,2021-05-23,CAL,11369,5550,5819,7036,4333,ITF,ITF6,18,Calabria,Calabria,1947131,410957,21.11,0.58
684,2021-05-25,CAL,16397,7989,8408,10296,6101,ITF,ITF6,18,Calabria,Calabria,1947131,427354,21.95,0.84
685,2021-01-26,CAL,1808,861,947,278,1530,ITF,ITF6,18,Calabria,Calabria,1947131,429162,22.04,0.09
686,2021-04-22,CAL,9619,4796,4823,6778,2841,ITF,ITF6,18,Calabria,Calabria,1947131,438781,22.53,0.49
687,2021-04-05,CAL,3501,1648,1853,2602,899,ITF,ITF6,18,Calabria,Calabria,1947131,442282,22.71,0.18
688,2021-01-09,CAL,1924,1040,884,1924,0,ITF,ITF6,18,Calabria,Calabria,1947131,444206,22.81,0.1
689,2021-05-24,CAL,17624,8777,8847,9958,7666,ITF,ITF6,18,Calabria,Calabria,1947131,461830,23.72,0.91
690,2021-05-07,CAL,16065,7573,8492,9702,6363,ITF,ITF6,18,Calabria,Calabria,1947131,477895,24.54,0.83
691,2021-01-08,CAL,2135,1023,1112,2135,0,ITF,ITF6,18,Calabria,Calabria,1947131,480030,24.65,0.11
692,2021-02-27,CAL,3987,2051,1936,3608,379,ITF,ITF6,18,Calabria,Calabria,1947131,484017,24.86,0.2
693,2021-03-20,CAL,6693,3068,3625,4196,2497,ITF,ITF6,18,Calabria,Calabria,1947131,490710,25.2,0.34
694,2021-05-29,CAL,19021,8831,10190,9194,9827,ITF,ITF6,18,Calabria,Calabria,1947131,509731,26.18,0.98
695,2021-02-25,CAL,2867,1545,1322,2280,587,ITF,ITF6,18,Calabria,Calabria,1947131,512598,26.33,0.15
696,2021-03-06,CAL,8419,4335,4084,7627,792,ITF,ITF6,18,Calabria,Calabria,1947131,521017,26.76,0.43
697,2021-05-09,CAL,9668,4499,5169,6139,3529,ITF,ITF6,18,Calabria,Calabria,1947131,530685,27.25,0.5
698,2021-05-04,CAL,16321,7518,8803,11694,4627,ITF,ITF6,18,Calabria,Calabria,1947131,547006,28.09,0.84
699,2021-01-22,CAL,658,274,384,656,2,ITF,ITF6,18,Calabria,Calabria,1947131,547664,28.13,0.03
700,2021-01-05,CAL,1464,684,780,1464,0,ITF,ITF6,18,Calabria,Calabria,1947131,549128,28.2,0.08
701,2021-03-14,CAL,2702,1065,1637,2287,415,ITF,ITF6,18,Calabria,Calabria,1947131,551830,28.34,0.14
702,2021-04-24,CAL,18997,9476,9521,15587,3410,ITF,ITF6,18,Calabria,Calabria,1947131,570827,29.32,0.98
703,2021-02-26,CAL,3062,1631,1431,2609,453,ITF,ITF6,18,Calabria,Calabria,1947131,573889,29.47,0.16
704,2021-01-07,CAL,2185,1065,1120,2185,0,ITF,ITF6,18,Calabria,Calabria,1947131,576074,29.59,0.11
705,2021-04-17,CAL,10928,5121,5807,9047,1881,ITF,ITF6,18,Calabria,Calabria,1947131,587002,30.15,0.56
706,2021-05-01,CAL,16631,7932,8699,12431,4200,ITF,ITF6,18,Calabria,Calabria,1947131,603633,31.0,0.85
707,2021-03-05,CAL,6228,3612,2616,5655,573,ITF,ITF6,18,Calabria,Calabria,1947131,609861,31.32,0.32
708,2021-03-12,CAL,5115,2452,2663,4045,1070,ITF,ITF6,18,Calabria,Calabria,1947131,614976,31.58,0.26
709,2021-01-14,CAL,2634,1248,1386,2634,0,ITF,ITF6,18,Calabria,Calabria,1947131,617610,31.72,0.14
710,2021-01-21,CAL,960,445,515,930,30,ITF,ITF6,18,Calabria,Calabria,1947131,618570,31.77,0.05
711,2021-03-10,CAL,6553,3314,3239,5274,1279,ITF,ITF6,18,Calabria,Calabria,1947131,625123,32.1,0.34
712,2021-05-13,CAL,15871,7612,8259,11212,4659,ITF,ITF6,18,Calabria,Calabria,1947131,640994,32.92,0.82
713,2021-05-30,CAL,11134,5360,5774,6978,4156,ITF,ITF6,18,Calabria,Calabria,1947131,652128,33.49,0.57
714,2021-05-17,CAL,15071,7531,7540,10358,4713,ITF,ITF6,18,Calabria,Calabria,1947131,667199,34.27,0.77
715,2021-02-21,CAL,609,286,323,532,77,ITF,ITF6,18,Calabria,Calabria,1947131,667808,34.3,0.03
716,2021-02-04,CAL,3495,1667,1828,652,2843,ITF,ITF6,18,Calabria,Calabria,1947131,671303,34.48,0.18
717,2021-03-29,CAL,5687,2405,3282,3931,1756,ITF,ITF6,18,Calabria,Calabria,1947131,676990,34.77,0.29
718,2021-05-11,CAL,15128,7315,7813,10351,4777,ITF,ITF6,18,Calabria,Calabria,1947131,692118,35.55,0.78
719,2021-01-24,CAL,44,18,26,39,5,ITF,ITF6,18,Calabria,Calabria,1947131,692162,35.55,0.0
720,2021-04-07,CAL,6514,2942,3572,3716,2798,ITF,ITF6,18,Calabria,Calabria,1947131,698676,35.88,0.33
721,2021-02-23,CAL,1590,753,837,1475,115,ITF,ITF6,18,Calabria,Calabria,1947131,700266,35.96,0.08
722,2021-01-12,CAL,2063,1020,1043,2063,0,ITF,ITF6,18,Calabria,Calabria,1947131,702329,36.07,0.11
723,2021-02-24,CAL,1847,942,905,1372,475,ITF,ITF6,18,Calabria,Calabria,1947131,704176,36.16,0.09
724,2021-03-03,CAL,5000,2730,2270,3928,1072,ITF,ITF6,18,Calabria,Calabria,1947131,709176,36.42,0.26
725,2021-05-03,CAL,14740,6755,7985,10536,4204,ITF,ITF6,18,Calabria,Calabria,1947131,723916,37.18,0.76
726,2021-03-21,CAL,4455,1925,2530,2730,1725,ITF,ITF6,18,Calabria,Calabria,1947131,728371,37.41,0.23
727,2021-03-07,CAL,3330,1701,1629,3241,89,ITF,ITF6,18,Calabria,Calabria,1947131,731701,37.58,0.17
728,2021-02-12,CAL,1710,667,1043,945,765,ITF,ITF6,18,Calabria,Calabria,1947131,733411,37.67,0.09
729,2021-04-03,CAL,8925,3826,5099,4282,4643,ITF,ITF6,18,Calabria,Calabria,1947131,742336,38.12,0.46
730,2021-01-28,CAL,2235,1109,1126,83,2152,ITF,ITF6,18,Calabria,Calabria,1947131,744571,38.24,0.11
731,2021-05-08,CAL,18275,8327,9948,10469,7806,ITF,ITF6,18,Calabria,Calabria,1947131,762846,39.18,0.94
732,2021-05-22,CAL,22044,10503,11541,14220,7824,ITF,ITF6,18,Calabria,Calabria,1947131,784890,40.31,1.13
733,2021-04-02,CAL,8130,3701,4429,4331,3799,ITF,ITF6,18,Calabria,Calabria,1947131,793020,40.73,0.42
734,2021-03-19,CAL,4186,1947,2239,1900,2286,ITF,ITF6,18,Calabria,Calabria,1947131,797206,40.94,0.21
735,2021-02-08,CAL,1850,735,1115,662,1188,ITF,ITF6,18,Calabria,Calabria,1947131,799056,41.04,0.1
736,2021-01-17,CAL,867,418,449,801,66,ITF,ITF6,18,Calabria,Calabria,1947131,799923,41.08,0.04
737,2021-03-24,CAL,7605,3462,4143,4367,3238,ITF,ITF6,18,Calabria,Calabria,1947131,807528,41.47,0.39
738,2021-04-29,CAL,11825,5744,6081,8308,3517,ITF,ITF6,18,Calabria,Calabria,1947131,819353,42.08,0.61
739,2021-04-12,CAL,6901,3349,3552,5248,1653,ITF,ITF6,18,Calabria,Calabria,1947131,826254,42.43,0.35
740,2021-01-19,CAL,1111,490,621,1101,10,ITF,ITF6,18,Calabria,Calabria,1947131,827365,42.49,0.06
741,2021-03-15,CAL,3543,1682,1861,2108,1435,ITF,ITF6,18,Calabria,Calabria,1947131,830908,42.67,0.18
742,2021-05-20,CAL,16896,8437,8459,11291,5605,ITF,ITF6,18,Calabria,Calabria,1947131,847804,43.54,0.87
743,2021-02-07,CAL,859,427,432,147,712,ITF,ITF6,18,Calabria,Calabria,1947131,848663,43.59,0.04
744,2021-05-18,CAL,15546,7785,7761,12083,3463,ITF,ITF6,18,Calabria,Calabria,1947131,864209,44.38,0.8
745,2021-03-22,CAL,4880,2289,2591,3129,1751,ITF,ITF6,18,Calabria,Calabria,1947131,869089,44.63,0.25
746,2021-02-09,CAL,2147,905,1242,947,1200,ITF,ITF6,18,Calabria,Calabria,1947131,871236,44.74,0.11
747,2021-04-14,CAL,8130,3906,4224,6677,1453,ITF,ITF6,18,Calabria,Calabria,1947131,879366,45.16,0.42
748,2021-02-16,CAL,1735,732,1003,1456,279,ITF,ITF6,18,Calabria,Calabria,1947131,881101,45.25,0.09
749,2021-05-27,CAL,17423,8574,8849,9732,7691,ITF,ITF6,18,Calabria,Calabria,1947131,898524,46.15,0.89
750,2021-06-01,CAL,7902,3598,4304,4473,3429,ITF,ITF6,18,Calabria,Calabria,1947131,906426,46.55,0.41
751,2021-02-19,CAL,1508,681,827,1247,261,ITF,ITF6,18,Calabria,Calabria,1947131,907934,46.63,0.08
752,2021-04-28,CAL,12534,6063,6471,9676,2858,ITF,ITF6,18,Calabria,Calabria,1947131,920468,47.27,0.64
753,2021-05-15,CAL,26826,12852,13974,20053,6773,ITF,ITF6,18,Calabria,Calabria,1947131,947294,48.65,1.38
754,2021-02-02,CAL,2287,1114,1173,177,2110,ITF,ITF6,18,Calabria,Calabria,1947131,949581,48.77,0.12
755,2021-01-31,CAL,1108,555,553,154,954,ITF,ITF6,18,Calabria,Calabria,1947131,950689,48.83,0.06
756,2020-12-28,CAL,6,2,4,6,0,ITF,ITF6,18,Calabria,Calabria,1947131,950695,48.83,0.0
757,2021-03-31,CAL,8863,4025,4838,4906,3957,ITF,ITF6,18,Calabria,Calabria,1947131,959558,49.28,0.46
758,2021-01-02,CAL,166,94,72,166,0,ITF,ITF6,18,Calabria,Calabria,1947131,959724,49.29,0.01
759,2021-04-26,CAL,10199,5067,5132,7778,2421,ITF,ITF6,18,Calabria,Calabria,1947131,969923,49.81,0.52
760,2021-02-14,CAL,462,210,252,432,30,ITF,ITF6,18,Calabria,Calabria,1947131,970385,49.84,0.02
761,2021-05-06,CAL,13265,6274,6991,8993,4272,ITF,ITF6,18,Calabria,Calabria,1947131,983650,50.52,0.68
762,2021-03-17,CAL,3977,1768,2209,2138,1839,ITF,ITF6,18,Calabria,Calabria,1947131,987627,50.72,0.2
763,2021-04-19,CAL,7822,3773,4049,6174,1648,ITF,ITF6,18,Calabria,Calabria,1947131,995449,51.12,0.4
764,2021-02-28,CAL,2304,1045,1259,2152,152,ITF,ITF6,18,Calabria,Calabria,1947131,997753,51.24,0.12
765,2021-01-16,CAL,2394,1120,1274,2394,0,ITF,ITF6,18,Calabria,Calabria,1947131,1000147,51.37,0.12
766,2021-05-10,CAL,13137,6093,7044,7735,5402,ITF,ITF6,18,Calabria,Calabria,1947131,1013284,52.04,0.67
767,2021-04-09,CAL,7934,3714,4220,5010,2924,ITF,ITF6,18,Calabria,Calabria,1947131,1021218,52.45,0.41
768,2021-01-11,CAL,2156,1041,1115,2156,0,ITF,ITF6,18,Calabria,Calabria,1947131,1023374,52.56,0.11
769,2021-01-25,CAL,1069,514,555,148,921,ITF,ITF6,18,Calabria,Calabria,1947131,1024443,52.61,0.05
770,2021-05-05,CAL,13598,6508,7090,8489,5109,ITF,ITF6,18,Calabria,Calabria,1947131,1038041,53.31,0.7
771,2021-03-02,CAL,4367,2489,1878,3611,756,ITF,ITF6,18,Calabria,Calabria,1947131,1042408,53.54,0.22
772,2021-03-16,CAL,3835,1883,1952,2175,1660,ITF,ITF6,18,Calabria,Calabria,1947131,1046243,53.73,0.2
773,2021-03-01,CAL,2723,1545,1178,2269,454,ITF,ITF6,18,Calabria,Calabria,1947131,1048966,53.87,0.14
774,2021-01-10,CAL,929,524,405,929,0,ITF,ITF6,18,Calabria,Calabria,1947131,1049895,53.92,0.05
775,2021-04-20,CAL,7845,3956,3889,6119,1726,ITF,ITF6,18,Calabria,Calabria,1947131,1057740,54.32,0.4
776,2021-04-21,CAL,11574,5816,5758,8640,2934,ITF,ITF6,18,Calabria,Calabria,1947131,1069314,54.92,0.59
777,2021-03-04,LAZ,18654,8014,10640,13638,5016,ITI,ITI4,12,Lazio,Lazio,5879082,18654,0.32,0.32
778,2021-03-21,LAZ,17858,6826,11032,12807,5051,ITI,ITI4,12,Lazio,Lazio,5879082,36512,0.62,0.3
779,2020-12-30,LAZ,1630,629,1001,1630,0,ITI,ITI4,12,Lazio,Lazio,5879082,38142,0.65,0.03
780,2021-04-09,LAZ,27298,12267,15031,19075,8223,ITI,ITI4,12,Lazio,Lazio,5879082,65440,1.11,0.46
781,2021-01-29,LAZ,8042,3079,4963,813,7229,ITI,ITI4,12,Lazio,Lazio,5879082,73482,1.25,0.14
782,2021-03-06,LAZ,18301,7050,11251,14044,4257,ITI,ITI4,12,Lazio,Lazio,5879082,91783,1.56,0.31
783,2021-04-16,LAZ,34394,15676,18718,22335,12059,ITI,ITI4,12,Lazio,Lazio,5879082,126177,2.15,0.59
784,2021-02-25,LAZ,12654,5518,7136,11604,1050,ITI,ITI4,12,Lazio,Lazio,5879082,138831,2.36,0.22
785,2021-05-21,LAZ,50253,23625,26628,37392,12861,ITI,ITI4,12,Lazio,Lazio,5879082,189084,3.22,0.85
786,2021-05-17,LAZ,43780,19995,23785,35335,8445,ITI,ITI4,12,Lazio,Lazio,5879082,232864,3.96,0.74
787,2021-02-06,LAZ,6136,2474,3662,817,5319,ITI,ITI4,12,Lazio,Lazio,5879082,239000,4.07,0.1
788,2021-02-11,LAZ,6998,3012,3986,6467,531,ITI,ITI4,12,Lazio,Lazio,5879082,245998,4.18,0.12
789,2021-04-11,LAZ,19115,8431,10684,13234,5881,ITI,ITI4,12,Lazio,Lazio,5879082,265113,4.51,0.33
790,2021-02-13,LAZ,6608,2626,3982,6194,414,ITI,ITI4,12,Lazio,Lazio,5879082,271721,4.62,0.11
791,2021-05-24,LAZ,42786,19158,23628,34001,8785,ITI,ITI4,12,Lazio,Lazio,5879082,314507,5.35,0.73
792,2021-01-08,LAZ,7728,2894,4834,7728,0,ITI,ITI4,12,Lazio,Lazio,5879082,322235,5.48,0.13
793,2021-04-30,LAZ,41232,18255,22977,27060,14172,ITI,ITI4,12,Lazio,Lazio,5879082,363467,6.18,0.7
794,2021-05-07,LAZ,48142,22568,25574,30427,17715,ITI,ITI4,12,Lazio,Lazio,5879082,411609,7.0,0.82
795,2021-02-03,LAZ,6488,2488,4000,964,5524,ITI,ITI4,12,Lazio,Lazio,5879082,418097,7.11,0.11
796,2021-03-18,LAZ,14225,6077,8148,7835,6390,ITI,ITI4,12,Lazio,Lazio,5879082,432322,7.35,0.24
797,2021-03-27,LAZ,26009,10395,15614,19539,6470,ITI,ITI4,12,Lazio,Lazio,5879082,458331,7.8,0.44
798,2021-05-23,LAZ,47009,22770,24239,39683,7326,ITI,ITI4,12,Lazio,Lazio,5879082,505340,8.6,0.8
799,2021-05-09,LAZ,37523,17248,20275,26257,11266,ITI,ITI4,12,Lazio,Lazio,5879082,542863,9.23,0.64
800,2021-05-16,LAZ,50893,24505,26388,37419,13474,ITI,ITI4,12,Lazio,Lazio,5879082,593756,10.1,0.87
801,2021-05-12,LAZ,47395,21471,25924,30877,16518,ITI,ITI4,12,Lazio,Lazio,5879082,641151,10.91,0.81
802,2021-01-13,LAZ,5691,2150,3541,5691,0,ITI,ITI4,12,Lazio,Lazio,5879082,646842,11.0,0.1
803,2021-01-30,LAZ,7009,2891,4118,807,6202,ITI,ITI4,12,Lazio,Lazio,5879082,653851,11.12,0.12
804,2021-04-25,LAZ,24511,11240,13271,16701,7810,ITI,ITI4,12,Lazio,Lazio,5879082,678362,11.54,0.42
805,2020-12-27,LAZ,274,132,142,274,0,ITI,ITI4,12,Lazio,Lazio,5879082,678636,11.54,0.0
806,2021-04-08,LAZ,26648,12173,14475,18966,7682,ITI,ITI4,12,Lazio,Lazio,5879082,705284,12.0,0.45
807,2021-05-31,LAZ,49162,21037,28125,31091,18071,ITI,ITI4,12,Lazio,Lazio,5879082,754446,12.83,0.84
808,2021-03-28,LAZ,18838,7541,11297,13528,5310,ITI,ITI4,12,Lazio,Lazio,5879082,773284,13.15,0.32
809,2021-04-27,LAZ,30628,13821,16807,19785,10843,ITI,ITI4,12,Lazio,Lazio,5879082,803912,13.67,0.52
810,2021-02-22,LAZ,11456,4990,6466,10954,502,ITI,ITI4,12,Lazio,Lazio,5879082,815368,13.87,0.19
811,2021-03-11,LAZ,23793,10582,13211,17564,6229,ITI,ITI4,12,Lazio,Lazio,5879082,839161,14.27,0.4
812,2021-01-20,LAZ,4806,1942,2864,3263,1543,ITI,ITI4,12,Lazio,Lazio,5879082,843967,14.36,0.08
813,2021-05-14,LAZ,50730,23154,27576,32521,18209,ITI,ITI4,12,Lazio,Lazio,5879082,894697,15.22,0.86
814,2021-03-25,LAZ,26915,11511,15404,20312,6603,ITI,ITI4,12,Lazio,Lazio,5879082,921612,15.68,0.46
815,2021-01-27,LAZ,6114,2387,3727,997,5117,ITI,ITI4,12,Lazio,Lazio,5879082,927726,15.78,0.1
816,2021-05-26,LAZ,46067,20587,25480,34925,11142,ITI,ITI4,12,Lazio,Lazio,5879082,973793,16.56,0.78
817,2021-03-23,LAZ,23503,10229,13274,16926,6577,ITI,ITI4,12,Lazio,Lazio,5879082,997296,16.96,0.4
818,2021-02-15,LAZ,8025,3540,4485,7394,631,ITI,ITI4,12,Lazio,Lazio,5879082,1005321,17.1,0.14
819,2021-02-17,LAZ,9181,4603,4578,8307,874,ITI,ITI4,12,Lazio,Lazio,5879082,1014502,17.26,0.16
820,2021-05-28,LAZ,55743,25502,30241,43287,12456,ITI,ITI4,12,Lazio,Lazio,5879082,1070245,18.2,0.95
821,2021-02-18,LAZ,10017,4976,5041,9208,809,ITI,ITI4,12,Lazio,Lazio,5879082,1080262,18.37,0.17
822,2021-02-01,LAZ,5675,2177,3498,354,5321,ITI,ITI4,12,Lazio,Lazio,5879082,1085937,18.47,0.1
823,2021-04-23,LAZ,37653,18080,19573,22404,15249,ITI,ITI4,12,Lazio,Lazio,5879082,1123590,19.11,0.64
824,2021-01-15,LAZ,6574,2705,3869,6574,0,ITI,ITI4,12,Lazio,Lazio,5879082,1130164,19.22,0.11
825,2021-04-06,LAZ,23879,10653,13226,16776,7103,ITI,ITI4,12,Lazio,Lazio,5879082,1154043,19.63,0.41
826,2021-03-20,LAZ,18224,6810,11414,12340,5884,ITI,ITI4,12,Lazio,Lazio,5879082,1172267,19.94,0.31
827,2021-01-03,LAZ,5250,1972,3278,5250,0,ITI,ITI4,12,Lazio,Lazio,5879082,1177517,20.03,0.09
828,2021-04-13,LAZ,25661,11869,13792,17955,7706,ITI,ITI4,12,Lazio,Lazio,5879082,1203178,20.47,0.44
829,2021-01-10,LAZ,4039,1700,2339,4039,0,ITI,ITI4,12,Lazio,Lazio,5879082,1207217,20.53,0.07
830,2021-04-20,LAZ,30997,14226,16771,19716,11281,ITI,ITI4,12,Lazio,Lazio,5879082,1238214,21.06,0.53
831,2021-03-08,LAZ,20068,8315,11753,14795,5273,ITI,ITI4,12,Lazio,Lazio,5879082,1258282,21.4,0.34
832,2021-03-16,LAZ,13538,5732,7806,7094,6444,ITI,ITI4,12,Lazio,Lazio,5879082,1271820,21.63,0.23
833,2021-03-09,LAZ,20873,8939,11934,15676,5197,ITI,ITI4,12,Lazio,Lazio,5879082,1292693,21.99,0.36
834,2021-01-11,LAZ,5531,2105,3426,5531,0,ITI,ITI4,12,Lazio,Lazio,5879082,1298224,22.08,0.09
835,2021-01-25,LAZ,8111,3246,4865,770,7341,ITI,ITI4,12,Lazio,Lazio,5879082,1306335,22.22,0.14
836,2021-05-05,LAZ,46705,21424,25281,30901,15804,ITI,ITI4,12,Lazio,Lazio,5879082,1353040,23.01,0.79
837,2021-03-02,LAZ,16987,7429,9558,13053,3934,ITI,ITI4,12,Lazio,Lazio,5879082,1370027,23.3,0.29
838,2021-01-18,LAZ,6267,2557,3710,5289,978,ITI,ITI4,12,Lazio,Lazio,5879082,1376294,23.41,0.11
839,2021-04-28,LAZ,32844,14995,17849,21298,11546,ITI,ITI4,12,Lazio,Lazio,5879082,1409138,23.97,0.56
840,2021-04-24,LAZ,33319,15013,18306,20572,12747,ITI,ITI4,12,Lazio,Lazio,5879082,1442457,24.54,0.57
841,2021-05-30,LAZ,41002,17499,23503,33781,7221,ITI,ITI4,12,Lazio,Lazio,5879082,1483459,25.23,0.7
842,2021-01-14,LAZ,5473,2142,3331,5473,0,ITI,ITI4,12,Lazio,Lazio,5879082,1488932,25.33,0.09
843,2021-01-16,LAZ,5645,2280,3365,5645,0,ITI,ITI4,12,Lazio,Lazio,5879082,1494577,25.42,0.1
844,2021-04-26,LAZ,29176,13429,15747,19974,9202,ITI,ITI4,12,Lazio,Lazio,5879082,1523753,25.92,0.5
845,2021-04-18,LAZ,23773,10556,13217,16139,7634,ITI,ITI4,12,Lazio,Lazio,5879082,1547526,26.32,0.4
846,2021-03-13,LAZ,21445,8427,13018,15551,5894,ITI,ITI4,12,Lazio,Lazio,5879082,1568971,26.69,0.36
847,2021-05-02,LAZ,32620,14333,18287,23259,9361,ITI,ITI4,12,Lazio,Lazio,5879082,1601591,27.24,0.55
848,2021-01-22,LAZ,4002,1633,2369,487,3515,ITI,ITI4,12,Lazio,Lazio,5879082,1605593,27.31,0.07
849,2021-02-27,LAZ,11427,4268,7159,10472,955,ITI,ITI4,12,Lazio,Lazio,5879082,1617020,27.5,0.19
850,2021-05-04,LAZ,39751,18280,21471,26275,13476,ITI,ITI4,12,Lazio,Lazio,5879082,1656771,28.18,0.68
851,2021-02-24,LAZ,12047,5204,6843,11053,994,ITI,ITI4,12,Lazio,Lazio,5879082,1668818,28.39,0.2
852,2021-01-05,LAZ,7374,2802,4572,7374,0,ITI,ITI4,12,Lazio,Lazio,5879082,1676192,28.51,0.13
853,2021-02-07,LAZ,4942,2023,2919,387,4555,ITI,ITI4,12,Lazio,Lazio,5879082,1681134,28.6,0.08
854,2021-05-03,LAZ,39102,17638,21464,26532,12570,ITI,ITI4,12,Lazio,Lazio,5879082,1720236,29.26,0.67
855,2021-03-14,LAZ,17101,6612,10489,11947,5154,ITI,ITI4,12,Lazio,Lazio,5879082,1737337,29.55,0.29
856,2021-01-23,LAZ,7212,2869,4343,583,6629,ITI,ITI4,12,Lazio,Lazio,5879082,1744549,29.67,0.12
857,2021-01-06,LAZ,5122,1961,3161,5122,0,ITI,ITI4,12,Lazio,Lazio,5879082,1749671,29.76,0.09
858,2021-04-01,LAZ,28404,13047,15357,21264,7140,ITI,ITI4,12,Lazio,Lazio,5879082,1778075,30.24,0.48
859,2021-04-15,LAZ,31907,14300,17607,21103,10804,ITI,ITI4,12,Lazio,Lazio,5879082,1809982,30.79,0.54
860,2021-02-10,LAZ,8187,3398,4789,4850,3337,ITI,ITI4,12,Lazio,Lazio,5879082,1818169,30.93,0.14
861,2021-01-01,LAZ,3554,1382,2172,3554,0,ITI,ITI4,12,Lazio,Lazio,5879082,1821723,30.99,0.06
862,2021-02-04,LAZ,6302,2481,3821,987,5315,ITI,ITI4,12,Lazio,Lazio,5879082,1828025,31.09,0.11
863,2021-05-22,LAZ,54625,26609,28016,44249,10376,ITI,ITI4,12,Lazio,Lazio,5879082,1882650,32.02,0.93
864,2021-02-20,LAZ,9204,4273,4931,8437,767,ITI,ITI4,12,Lazio,Lazio,5879082,1891854,32.18,0.16
865,2021-04-04,LAZ,17463,8036,9427,12197,5266,ITI,ITI4,12,Lazio,Lazio,5879082,1909317,32.48,0.3
866,2021-03-01,LAZ,17084,7344,9740,13199,3885,ITI,ITI4,12,Lazio,Lazio,5879082,1926401,32.77,0.29
867,2021-05-25,LAZ,46180,21184,24996,35422,10758,ITI,ITI4,12,Lazio,Lazio,5879082,1972581,33.55,0.79
868,2021-04-12,LAZ,23758,10677,13081,16861,6897,ITI,ITI4,12,Lazio,Lazio,5879082,1996339,33.96,0.4
869,2021-01-09,LAZ,6296,2561,3735,6296,0,ITI,ITI4,12,Lazio,Lazio,5879082,2002635,34.06,0.11
870,2021-02-21,LAZ,6987,3179,3808,6525,462,ITI,ITI4,12,Lazio,Lazio,5879082,2009622,34.18,0.12
871,2021-02-28,LAZ,10248,4007,6241,9734,514,ITI,ITI4,12,Lazio,Lazio,5879082,2019870,34.36,0.17
872,2021-02-12,LAZ,6844,2845,3999,6432,412,ITI,ITI4,12,Lazio,Lazio,5879082,2026714,34.47,0.12
873,2020-12-31,LAZ,5293,2121,3172,5293,0,ITI,ITI4,12,Lazio,Lazio,5879082,2032007,34.56,0.09
874,2021-04-10,LAZ,23808,10314,13494,16626,7182,ITI,ITI4,12,Lazio,Lazio,5879082,2055815,34.97,0.4
875,2021-02-05,LAZ,7278,2960,4318,1183,6095,ITI,ITI4,12,Lazio,Lazio,5879082,2063093,35.09,0.12
876,2021-04-03,LAZ,24687,11094,13593,17988,6699,ITI,ITI4,12,Lazio,Lazio,5879082,2087780,35.51,0.42
877,2021-02-19,LAZ,10047,5081,4966,9216,831,ITI,ITI4,12,Lazio,Lazio,5879082,2097827,35.68,0.17
878,2021-03-22,LAZ,21701,9066,12635,15040,6661,ITI,ITI4,12,Lazio,Lazio,5879082,2119528,36.05,0.37
879,2021-05-29,LAZ,51109,22789,28320,40780,10329,ITI,ITI4,12,Lazio,Lazio,5879082,2170637,36.92,0.87
880,2021-05-06,LAZ,48625,22615,26010,31102,17523,ITI,ITI4,12,Lazio,Lazio,5879082,2219262,37.75,0.83
881,2021-01-19,LAZ,4768,1954,2814,4314,454,ITI,ITI4,12,Lazio,Lazio,5879082,2224030,37.83,0.08
882,2021-03-03,LAZ,17395,7438,9957,13101,4294,ITI,ITI4,12,Lazio,Lazio,5879082,2241425,38.13,0.3
883,2021-04-02,LAZ,28547,13376,15171,21219,7328,ITI,ITI4,12,Lazio,Lazio,5879082,2269972,38.61,0.49
884,2021-01-28,LAZ,8279,3165,5114,782,7497,ITI,ITI4,12,Lazio,Lazio,5879082,2278251,38.75,0.14
885,2021-06-01,LAZ,31715,14868,16847,19809,11906,ITI,ITI4,12,Lazio,Lazio,5879082,2309966,39.29,0.54
886,2021-04-05,LAZ,19769,8992,10777,13591,6178,ITI,ITI4,12,Lazio,Lazio,5879082,2329735,39.63,0.34
887,2021-04-19,LAZ,30060,13661,16399,19383,10677,ITI,ITI4,12,Lazio,Lazio,5879082,2359795,40.14,0.51
888,2021-02-14,LAZ,5773,2370,3403,5303,470,ITI,ITI4,12,Lazio,Lazio,5879082,2365568,40.24,0.1
889,2021-01-02,LAZ,6707,2631,4076,6707,0,ITI,ITI4,12,Lazio,Lazio,5879082,2372275,40.35,0.11
890,2021-02-26,LAZ,13075,5700,7375,11713,1362,ITI,ITI4,12,Lazio,Lazio,5879082,2385350,40.57,0.22
891,2021-05-01,LAZ,37914,17065,20849,25968,11946,ITI,ITI4,12,Lazio,Lazio,5879082,2423264,41.22,0.64
892,2021-04-17,LAZ,32304,14175,18129,20357,11947,ITI,ITI4,12,Lazio,Lazio,5879082,2455568,41.77,0.55
893,2021-03-12,LAZ,22903,10130,12773,16589,6314,ITI,ITI4,12,Lazio,Lazio,5879082,2478471,42.16,0.39
894,2021-01-21,LAZ,5600,2348,3252,548,5052,ITI,ITI4,12,Lazio,Lazio,5879082,2484071,42.25,0.1
895,2021-04-21,LAZ,32975,14973,18002,20613,12362,ITI,ITI4,12,Lazio,Lazio,5879082,2517046,42.81,0.56
896,2021-05-15,LAZ,57040,27245,29795,40615,16425,ITI,ITI4,12,Lazio,Lazio,5879082,2574086,43.78,0.97
897,2021-03-19,LAZ,17216,7364,9852,10888,6328,ITI,ITI4,12,Lazio,Lazio,5879082,2591302,44.08,0.29
898,2021-01-31,LAZ,4459,1854,2605,476,3983,ITI,ITI4,12,Lazio,Lazio,5879082,2595761,44.15,0.08
899,2021-05-11,LAZ,47902,21959,25943,31512,16390,ITI,ITI4,12,Lazio,Lazio,5879082,2643663,44.97,0.81
900,2021-05-13,LAZ,49499,22177,27322,31858,17641,ITI,ITI4,12,Lazio,Lazio,5879082,2693162,45.81,0.84
901,2021-04-07,LAZ,24958,11320,13638,17654,7304,ITI,ITI4,12,Lazio,Lazio,5879082,2718120,46.23,0.42
902,2020-12-28,LAZ,959,412,547,959,0,ITI,ITI4,12,Lazio,Lazio,5879082,2719079,46.25,0.02
903,2021-02-02,LAZ,5909,2213,3696,637,5272,ITI,ITI4,12,Lazio,Lazio,5879082,2724988,46.35,0.1
904,2021-04-22,LAZ,38527,18929,19598,23951,14576,ITI,ITI4,12,Lazio,Lazio,5879082,2763515,47.01,0.66
905,2021-03-10,LAZ,22021,9489,12532,16375,5646,ITI,ITI4,12,Lazio,Lazio,5879082,2785536,47.38,0.37
906,2021-01-12,LAZ,5412,1981,3431,5412,0,ITI,ITI4,12,Lazio,Lazio,5879082,2790948,47.47,0.09
907,2021-03-17,LAZ,13786,5896,7890,7531,6255,ITI,ITI4,12,Lazio,Lazio,5879082,2804734,47.71,0.23
908,2020-12-29,LAZ,488,176,312,488,0,ITI,ITI4,12,Lazio,Lazio,5879082,2805222,47.72,0.01
909,2021-03-07,LAZ,14110,5442,8668,10517,3593,ITI,ITI4,12,Lazio,Lazio,5879082,2819332,47.96,0.24
910,2021-03-24,LAZ,25876,11297,14579,19639,6237,ITI,ITI4,12,Lazio,Lazio,5879082,2845208,48.4,0.44
911,2021-05-10,LAZ,44186,20152,24034,30814,13372,ITI,ITI4,12,Lazio,Lazio,5879082,2889394,49.15,0.75
912,2021-01-07,LAZ,7747,2902,4845,7747,0,ITI,ITI4,12,Lazio,Lazio,5879082,2897141,49.28,0.13
913,2021-01-17,LAZ,4894,2028,2866,4682,212,ITI,ITI4,12,Lazio,Lazio,5879082,2902035,49.36,0.08
914,2021-04-29,LAZ,38558,17207,21351,25338,13220,ITI,ITI4,12,Lazio,Lazio,5879082,2940593,50.02,0.66
915,2021-01-26,LAZ,7958,3125,4833,724,7234,ITI,ITI4,12,Lazio,Lazio,5879082,2948551,50.15,0.14
916,2021-05-08,LAZ,45172,20612,24560,29814,15358,ITI,ITI4,12,Lazio,Lazio,5879082,2993723,50.92,0.77
917,2021-03-26,LAZ,28227,12253,15974,21384,6843,ITI,ITI4,12,Lazio,Lazio,5879082,3021950,51.4,0.48
918,2021-04-14,LAZ,29270,13261,16009,19149,10121,ITI,ITI4,12,Lazio,Lazio,5879082,3051220,51.9,0.5
919,2021-03-29,LAZ,23956,10756,13200,16923,7033,ITI,ITI4,12,Lazio,Lazio,5879082,3075176,52.31,0.41
920,2021-03-15,LAZ,19273,8331,10942,12534,6739,ITI,ITI4,12,Lazio,Lazio,5879082,3094449,52.63,0.33
921,2021-01-24,LAZ,5694,2229,3465,612,5082,ITI,ITI4,12,Lazio,Lazio,5879082,3100143,52.73,0.1
922,2021-05-18,LAZ,44135,20123,24012,34810,9325,ITI,ITI4,12,Lazio,Lazio,5879082,3144278,53.48,0.75
923,2021-05-27,LAZ,56173,25372,30801,43810,12363,ITI,ITI4,12,Lazio,Lazio,5879082,3200451,54.44,0.96
924,2021-03-05,LAZ,18792,7961,10831,14059,4733,ITI,ITI4,12,Lazio,Lazio,5879082,3219243,54.76,0.32
925,2021-02-16,LAZ,8354,4033,4321,7749,605,ITI,ITI4,12,Lazio,Lazio,5879082,3227597,54.9,0.14
926,2021-03-30,LAZ,25256,11584,13672,18108,7148,ITI,ITI4,12,Lazio,Lazio,5879082,3252853,55.33,0.43
927,2021-05-19,LAZ,46443,21207,25236,36635,9808,ITI,ITI4,12,Lazio,Lazio,5879082,3299296,56.12,0.79
928,2021-01-04,LAZ,7481,2908,4573,7481,0,ITI,ITI4,12,Lazio,Lazio,5879082,3306777,56.25,0.13
929,2021-02-08,LAZ,9739,4153,5586,4508,5231,ITI,ITI4,12,Lazio,Lazio,5879082,3316516,56.41,0.17
930,2021-05-20,LAZ,50663,24174,26489,37407,13256,ITI,ITI4,12,Lazio,Lazio,5879082,3367179,57.27,0.86
931,2021-02-09,LAZ,8797,3768,5029,4580,4217,ITI,ITI4,12,Lazio,Lazio,5879082,3375976,57.42,0.15
932,2021-02-23,LAZ,11087,4780,6307,10326,761,ITI,ITI4,12,Lazio,Lazio,5879082,3387063,57.61,0.19
933,2021-03-31,LAZ,26107,12046,14061,19014,7093,ITI,ITI4,12,Lazio,Lazio,5879082,3413170,58.06,0.44
934,2021-05-19,SAR,14853,7285,7568,11389,3464,ITG,ITG2,20,Sardegna,Sardegna,1639591,14853,0.91,0.91
935,2021-02-23,SAR,1519,1010,509,1285,234,ITG,ITG2,20,Sardegna,Sardegna,1639591,16372,1.0,0.09
936,2021-02-08,SAR,1470,533,937,856,614,ITG,ITG2,20,Sardegna,Sardegna,1639591,17842,1.09,0.09
937,2021-03-29,SAR,4425,1559,2866,3837,588,ITG,ITG2,20,Sardegna,Sardegna,1639591,22267,1.36,0.27
938,2021-04-23,SAR,12844,5734,7110,7383,5461,ITG,ITG2,20,Sardegna,Sardegna,1639591,35111,2.14,0.78
939,2021-05-10,SAR,9732,4336,5396,7195,2537,ITG,ITG2,20,Sardegna,Sardegna,1639591,44843,2.74,0.59
940,2021-01-27,SAR,1411,496,915,79,1332,ITG,ITG2,20,Sardegna,Sardegna,1639591,46254,2.82,0.09
941,2021-05-14,SAR,13885,6371,7514,10701,3184,ITG,ITG2,20,Sardegna,Sardegna,1639591,60139,3.67,0.85
942,2021-04-01,SAR,10101,4026,6075,7088,3013,ITG,ITG2,20,Sardegna,Sardegna,1639591,70240,4.28,0.62
943,2021-03-09,SAR,5152,2373,2779,4423,729,ITG,ITG2,20,Sardegna,Sardegna,1639591,75392,4.6,0.31
944,2021-05-05,SAR,10145,4640,5505,8135,2010,ITG,ITG2,20,Sardegna,Sardegna,1639591,85537,5.22,0.62
945,2021-03-02,SAR,2865,1459,1406,1712,1153,ITG,ITG2,20,Sardegna,Sardegna,1639591,88402,5.39,0.17
946,2021-04-28,SAR,9015,4273,4742,5316,3699,ITG,ITG2,20,Sardegna,Sardegna,1639591,97417,5.94,0.55
947,2021-01-18,SAR,904,326,578,780,124,ITG,ITG2,20,Sardegna,Sardegna,1639591,98321,6.0,0.06
948,2021-03-16,SAR,4374,1949,2425,3452,922,ITG,ITG2,20,Sardegna,Sardegna,1639591,102695,6.26,0.27
949,2021-04-21,SAR,12072,5557,6515,6540,5532,ITG,ITG2,20,Sardegna,Sardegna,1639591,114767,7.0,0.74
950,2021-01-11,SAR,1183,505,678,1183,0,ITG,ITG2,20,Sardegna,Sardegna,1639591,115950,7.07,0.07
951,2021-01-25,SAR,588,212,376,22,566,ITG,ITG2,20,Sardegna,Sardegna,1639591,116538,7.11,0.04
952,2021-03-28,SAR,4620,1815,2805,4541,79,ITG,ITG2,20,Sardegna,Sardegna,1639591,121158,7.39,0.28
953,2021-01-23,SAR,60,22,38,0,60,ITG,ITG2,20,Sardegna,Sardegna,1639591,121218,7.39,0.0
954,2021-02-22,SAR,1639,949,690,1411,228,ITG,ITG2,20,Sardegna,Sardegna,1639591,122857,7.49,0.1
955,2021-03-11,SAR,6036,2726,3310,4835,1201,ITG,ITG2,20,Sardegna,Sardegna,1639591,128893,7.86,0.37
956,2021-01-06,SAR,1615,549,1066,1615,0,ITG,ITG2,20,Sardegna,Sardegna,1639591,130508,7.96,0.1
957,2021-02-11,SAR,1315,490,825,1204,111,ITG,ITG2,20,Sardegna,Sardegna,1639591,131823,8.04,0.08
958,2021-05-24,SAR,13582,6503,7079,8420,5162,ITG,ITG2,20,Sardegna,Sardegna,1639591,145405,8.87,0.83
959,2021-05-29,SAR,17689,8495,9194,13292,4397,ITG,ITG2,20,Sardegna,Sardegna,1639591,163094,9.95,1.08
960,2021-01-08,SAR,3258,1184,2074,3258,0,ITG,ITG2,20,Sardegna,Sardegna,1639591,166352,10.15,0.2
961,2021-04-20,SAR,10992,4992,6000,7778,3214,ITG,ITG2,20,Sardegna,Sardegna,1639591,177344,10.82,0.67
962,2021-02-20,SAR,2041,855,1186,1707,334,ITG,ITG2,20,Sardegna,Sardegna,1639591,179385,10.94,0.12
963,2021-01-16,SAR,1492,525,967,1492,0,ITG,ITG2,20,Sardegna,Sardegna,1639591,180877,11.03,0.09
964,2021-05-07,SAR,14124,6456,7668,9624,4500,ITG,ITG2,20,Sardegna,Sardegna,1639591,195001,11.89,0.86
965,2021-03-25,SAR,8795,3704,5091,7490,1305,ITG,ITG2,20,Sardegna,Sardegna,1639591,203796,12.43,0.54
966,2021-05-21,SAR,20560,10036,10524,15064,5496,ITG,ITG2,20,Sardegna,Sardegna,1639591,224356,13.68,1.25
967,2021-03-18,SAR,7255,3070,4185,5652,1603,ITG,ITG2,20,Sardegna,Sardegna,1639591,231611,14.13,0.44
968,2021-02-03,SAR,1119,419,700,426,693,ITG,ITG2,20,Sardegna,Sardegna,1639591,232730,14.19,0.07
969,2021-02-25,SAR,2899,1255,1644,2294,605,ITG,ITG2,20,Sardegna,Sardegna,1639591,235629,14.37,0.18
970,2021-03-14,SAR,607,376,231,607,0,ITG,ITG2,20,Sardegna,Sardegna,1639591,236236,14.41,0.04
971,2021-04-30,SAR,11128,5297,5831,6919,4209,ITG,ITG2,20,Sardegna,Sardegna,1639591,247364,15.09,0.68
972,2021-05-17,SAR,12114,5688,6426,9224,2890,ITG,ITG2,20,Sardegna,Sardegna,1639591,259478,15.83,0.74
973,2021-02-06,SAR,1970,697,1273,569,1401,ITG,ITG2,20,Sardegna,Sardegna,1639591,261448,15.95,0.12
974,2021-05-02,SAR,5884,2669,3215,5303,581,ITG,ITG2,20,Sardegna,Sardegna,1639591,267332,16.3,0.36
975,2021-01-20,SAR,210,77,133,208,2,ITG,ITG2,20,Sardegna,Sardegna,1639591,267542,16.32,0.01
976,2021-01-04,SAR,592,217,375,592,0,ITG,ITG2,20,Sardegna,Sardegna,1639591,268134,16.35,0.04
977,2021-04-16,SAR,14441,6488,7953,9098,5343,ITG,ITG2,20,Sardegna,Sardegna,1639591,282575,17.23,0.88
978,2021-03-13,SAR,2755,1076,1679,2474,281,ITG,ITG2,20,Sardegna,Sardegna,1639591,285330,17.4,0.17
979,2021-03-30,SAR,8641,3462,5179,6367,2274,ITG,ITG2,20,Sardegna,Sardegna,1639591,293971,17.93,0.53
980,2021-04-09,SAR,12261,5436,6825,7909,4352,ITG,ITG2,20,Sardegna,Sardegna,1639591,306232,18.68,0.75
981,2021-04-11,SAR,5393,2442,2951,4273,1120,ITG,ITG2,20,Sardegna,Sardegna,1639591,311625,19.01,0.33
982,2021-02-04,SAR,2271,816,1455,916,1355,ITG,ITG2,20,Sardegna,Sardegna,1639591,313896,19.14,0.14
983,2021-04-02,SAR,8989,3548,5441,5745,3244,ITG,ITG2,20,Sardegna,Sardegna,1639591,322885,19.69,0.55
984,2021-04-04,SAR,1,0,1,0,1,ITG,ITG2,20,Sardegna,Sardegna,1639591,322886,19.69,0.0
985,2021-01-01,SAR,32,17,15,32,0,ITG,ITG2,20,Sardegna,Sardegna,1639591,322918,19.7,0.0
986,2021-02-27,SAR,1921,647,1274,1366,555,ITG,ITG2,20,Sardegna,Sardegna,1639591,324839,19.81,0.12
987,2021-05-16,SAR,8177,3812,4365,6017,2160,ITG,ITG2,20,Sardegna,Sardegna,1639591,333016,20.31,0.5
988,2021-04-15,SAR,11821,5525,6296,6865,4956,ITG,ITG2,20,Sardegna,Sardegna,1639591,344837,21.03,0.72
989,2021-01-05,SAR,1327,446,881,1327,0,ITG,ITG2,20,Sardegna,Sardegna,1639591,346164,21.11,0.08
990,2021-01-03,SAR,90,36,54,90,0,ITG,ITG2,20,Sardegna,Sardegna,1639591,346254,21.12,0.01
991,2021-03-31,SAR,10154,4050,6104,7707,2447,ITG,ITG2,20,Sardegna,Sardegna,1639591,356408,21.74,0.62
992,2021-03-23,SAR,6157,2640,3517,5079,1078,ITG,ITG2,20,Sardegna,Sardegna,1639591,362565,22.11,0.38
993,2021-05-12,SAR,10774,5032,5742,7695,3079,ITG,ITG2,20,Sardegna,Sardegna,1639591,373339,22.77,0.66
994,2020-12-28,SAR,65,25,40,65,0,ITG,ITG2,20,Sardegna,Sardegna,1639591,373404,22.77,0.0
995,2021-04-06,SAR,7446,3113,4333,5018,2428,ITG,ITG2,20,Sardegna,Sardegna,1639591,380850,23.23,0.45
996,2020-12-27,SAR,65,34,31,65,0,ITG,ITG2,20,Sardegna,Sardegna,1639591,380915,23.23,0.0
997,2021-02-01,SAR,1524,605,919,225,1299,ITG,ITG2,20,Sardegna,Sardegna,1639591,382439,23.33,0.09
998,2021-05-26,SAR,14258,7082,7176,9781,4477,ITG,ITG2,20,Sardegna,Sardegna,1639591,396697,24.19,0.87
999,2021-02-15,SAR,958,349,609,927,31,ITG,ITG2,20,Sardegna,Sardegna,1639591,397655,24.25,0.06
1000,2021-02-17,SAR,1407,577,830,1333,74,ITG,ITG2,20,Sardegna,Sardegna,1639591,399062,24.34,0.09
1001,2021-03-03,SAR,3859,2073,1786,2611,1248,ITG,ITG2,20,Sardegna,Sardegna,1639591,402921,24.57,0.24
1002,2020-12-29,SAR,57,32,25,57,0,ITG,ITG2,20,Sardegna,Sardegna,1639591,402978,24.58,0.0
1003,2021-04-22,SAR,10480,4641,5839,5561,4919,ITG,ITG2,20,Sardegna,Sardegna,1639591,413458,25.22,0.64
1004,2021-01-31,SAR,2121,750,1371,48,2073,ITG,ITG2,20,Sardegna,Sardegna,1639591,415579,25.35,0.13
1005,2021-02-14,SAR,539,263,276,537,2,ITG,ITG2,20,Sardegna,Sardegna,1639591,416118,25.38,0.03
1006,2021-04-05,SAR,2036,784,1252,2035,1,ITG,ITG2,20,Sardegna,Sardegna,1639591,418154,25.5,0.12
1007,2021-01-30,SAR,3863,1392,2471,362,3501,ITG,ITG2,20,Sardegna,Sardegna,1639591,422017,25.74,0.24
1008,2021-03-04,SAR,4002,1953,2049,2747,1255,ITG,ITG2,20,Sardegna,Sardegna,1639591,426019,25.98,0.24
1009,2021-03-21,SAR,4030,1809,2221,2590,1440,ITG,ITG2,20,Sardegna,Sardegna,1639591,430049,26.23,0.25
1010,2021-01-13,SAR,573,178,395,573,0,ITG,ITG2,20,Sardegna,Sardegna,1639591,430622,26.26,0.03
1011,2021-05-28,SAR,17306,8259,9047,13437,3869,ITG,ITG2,20,Sardegna,Sardegna,1639591,447928,27.32,1.06
1012,2021-04-13,SAR,7606,3593,4013,5781,1825,ITG,ITG2,20,Sardegna,Sardegna,1639591,455534,27.78,0.46
1013,2021-03-08,SAR,4008,1790,2218,2788,1220,ITG,ITG2,20,Sardegna,Sardegna,1639591,459542,28.03,0.24
1014,2021-05-04,SAR,9536,4385,5151,7684,1852,ITG,ITG2,20,Sardegna,Sardegna,1639591,469078,28.61,0.58
1015,2021-01-24,SAR,90,34,56,5,85,ITG,ITG2,20,Sardegna,Sardegna,1639591,469168,28.61,0.01
1016,2021-03-10,SAR,6011,2918,3093,5161,850,ITG,ITG2,20,Sardegna,Sardegna,1639591,475179,28.98,0.37
1017,2021-05-06,SAR,12942,6007,6935,9797,3145,ITG,ITG2,20,Sardegna,Sardegna,1639591,488121,29.77,0.79
1018,2021-03-01,SAR,2162,1055,1107,1503,659,ITG,ITG2,20,Sardegna,Sardegna,1639591,490283,29.9,0.13
1019,2021-05-13,SAR,11400,5281,6119,8426,2974,ITG,ITG2,20,Sardegna,Sardegna,1639591,501683,30.6,0.7
1020,2021-02-02,SAR,1482,655,827,241,1241,ITG,ITG2,20,Sardegna,Sardegna,1639591,503165,30.69,0.09
1021,2021-02-13,SAR,1456,565,891,1454,2,ITG,ITG2,20,Sardegna,Sardegna,1639591,504621,30.78,0.09
1022,2021-02-18,SAR,1878,732,1146,1814,64,ITG,ITG2,20,Sardegna,Sardegna,1639591,506499,30.89,0.11
1023,2021-05-31,SAR,11069,5190,5879,8234,2835,ITG,ITG2,20,Sardegna,Sardegna,1639591,517568,31.57,0.68
1024,2021-04-18,SAR,5127,2225,2902,2258,2869,ITG,ITG2,20,Sardegna,Sardegna,1639591,522695,31.88,0.31
1025,2021-02-10,SAR,1959,765,1194,1441,518,ITG,ITG2,20,Sardegna,Sardegna,1639591,524654,32.0,0.12
1026,2021-01-02,SAR,60,21,39,60,0,ITG,ITG2,20,Sardegna,Sardegna,1639591,524714,32.0,0.0
1027,2021-04-26,SAR,6820,3263,3557,5945,875,ITG,ITG2,20,Sardegna,Sardegna,1639591,531534,32.42,0.42
1028,2021-02-21,SAR,1589,710,879,1559,30,ITG,ITG2,20,Sardegna,Sardegna,1639591,533123,32.52,0.1
1029,2021-04-19,SAR,10181,4617,5564,8762,1419,ITG,ITG2,20,Sardegna,Sardegna,1639591,543304,33.14,0.62
1030,2021-03-07,SAR,1657,750,907,1117,540,ITG,ITG2,20,Sardegna,Sardegna,1639591,544961,33.24,0.1
1031,2021-05-18,SAR,13752,6640,7112,9291,4461,ITG,ITG2,20,Sardegna,Sardegna,1639591,558713,34.08,0.84
1032,2021-04-14,SAR,8250,3902,4348,7013,1237,ITG,ITG2,20,Sardegna,Sardegna,1639591,566963,34.58,0.5
1033,2021-05-01,SAR,9902,4759,5143,5445,4457,ITG,ITG2,20,Sardegna,Sardegna,1639591,576865,35.18,0.6
1034,2021-02-09,SAR,2287,837,1450,1290,997,ITG,ITG2,20,Sardegna,Sardegna,1639591,579152,35.32,0.14
1035,2021-04-29,SAR,11108,5106,6002,6755,4353,ITG,ITG2,20,Sardegna,Sardegna,1639591,590260,36.0,0.68
1036,2021-01-17,SAR,860,277,583,859,1,ITG,ITG2,20,Sardegna,Sardegna,1639591,591120,36.05,0.05
1037,2021-03-26,SAR,8091,3180,4911,6566,1525,ITG,ITG2,20,Sardegna,Sardegna,1639591,599211,36.55,0.49
1038,2021-03-17,SAR,6556,2849,3707,4949,1607,ITG,ITG2,20,Sardegna,Sardegna,1639591,605767,36.95,0.4
1039,2021-04-12,SAR,6990,3179,3811,5276,1714,ITG,ITG2,20,Sardegna,Sardegna,1639591,612757,37.37,0.43
1040,2021-02-28,SAR,368,169,199,142,226,ITG,ITG2,20,Sardegna,Sardegna,1639591,613125,37.39,0.02
1041,2021-06-01,SAR,9198,4336,4862,6199,2999,ITG,ITG2,20,Sardegna,Sardegna,1639591,622323,37.96,0.56
1042,2021-01-09,SAR,4026,1417,2609,4026,0,ITG,ITG2,20,Sardegna,Sardegna,1639591,626349,38.2,0.25
1043,2021-05-27,SAR,16262,8189,8073,11553,4709,ITG,ITG2,20,Sardegna,Sardegna,1639591,642611,39.19,0.99
1044,2021-02-16,SAR,700,289,411,673,27,ITG,ITG2,20,Sardegna,Sardegna,1639591,643311,39.24,0.04
1045,2021-04-07,SAR,13477,5985,7492,7829,5648,ITG,ITG2,20,Sardegna,Sardegna,1639591,656788,40.06,0.82
1046,2021-02-05,SAR,1897,749,1148,433,1464,ITG,ITG2,20,Sardegna,Sardegna,1639591,658685,40.17,0.12
1047,2021-04-03,SAR,4663,1802,2861,2696,1967,ITG,ITG2,20,Sardegna,Sardegna,1639591,663348,40.46,0.28
1048,2021-05-30,SAR,9726,4836,4890,7369,2357,ITG,ITG2,20,Sardegna,Sardegna,1639591,673074,41.05,0.59
1049,2021-02-19,SAR,1499,473,1026,1443,56,ITG,ITG2,20,Sardegna,Sardegna,1639591,674573,41.14,0.09
1050,2021-03-27,SAR,5718,2177,3541,5296,422,ITG,ITG2,20,Sardegna,Sardegna,1639591,680291,41.49,0.35
1051,2021-05-23,SAR,9964,4805,5159,7720,2244,ITG,ITG2,20,Sardegna,Sardegna,1639591,690255,42.1,0.61
1052,2021-02-12,SAR,2237,933,1304,2178,59,ITG,ITG2,20,Sardegna,Sardegna,1639591,692492,42.24,0.14
1053,2021-04-10,SAR,10489,4748,5741,8554,1935,ITG,ITG2,20,Sardegna,Sardegna,1639591,702981,42.88,0.64
1054,2021-01-07,SAR,3112,1077,2035,3112,0,ITG,ITG2,20,Sardegna,Sardegna,1639591,706093,43.07,0.19
1055,2021-01-26,SAR,1336,453,883,27,1309,ITG,ITG2,20,Sardegna,Sardegna,1639591,707429,43.15,0.08
1056,2021-01-22,SAR,83,47,36,55,28,ITG,ITG2,20,Sardegna,Sardegna,1639591,707512,43.15,0.01
1057,2021-04-17,SAR,10078,4500,5578,5481,4597,ITG,ITG2,20,Sardegna,Sardegna,1639591,717590,43.77,0.61
1058,2021-05-15,SAR,13754,6416,7338,10325,3429,ITG,ITG2,20,Sardegna,Sardegna,1639591,731344,44.61,0.84
1059,2021-05-08,SAR,13074,5959,7115,10788,2286,ITG,ITG2,20,Sardegna,Sardegna,1639591,744418,45.4,0.8
1060,2021-02-24,SAR,2412,1293,1119,2223,189,ITG,ITG2,20,Sardegna,Sardegna,1639591,746830,45.55,0.15
1061,2021-01-21,SAR,126,60,66,94,32,ITG,ITG2,20,Sardegna,Sardegna,1639591,746956,45.56,0.01
1062,2021-02-07,SAR,1117,395,722,228,889,ITG,ITG2,20,Sardegna,Sardegna,1639591,748073,45.63,0.07
1063,2021-05-03,SAR,8180,3817,4363,6584,1596,ITG,ITG2,20,Sardegna,Sardegna,1639591,756253,46.12,0.5
1064,2021-05-20,SAR,15852,7499,8353,11304,4548,ITG,ITG2,20,Sardegna,Sardegna,1639591,772105,47.09,0.97
1065,2021-01-10,SAR,2183,750,1433,2183,0,ITG,ITG2,20,Sardegna,Sardegna,1639591,774288,47.22,0.13
1066,2021-04-27,SAR,7606,3547,4059,5565,2041,ITG,ITG2,20,Sardegna,Sardegna,1639591,781894,47.69,0.46
1067,2021-03-15,SAR,2688,1219,1469,2315,373,ITG,ITG2,20,Sardegna,Sardegna,1639591,784582,47.85,0.16
1068,2021-05-22,SAR,24294,11624,12670,19364,4930,ITG,ITG2,20,Sardegna,Sardegna,1639591,808876,49.33,1.48
1069,2021-01-19,SAR,747,270,477,692,55,ITG,ITG2,20,Sardegna,Sardegna,1639591,809623,49.38,0.05
1070,2021-03-24,SAR,7287,2998,4289,5928,1359,ITG,ITG2,20,Sardegna,Sardegna,1639591,816910,49.82,0.44
1071,2020-12-31,SAR,32,16,16,32,0,ITG,ITG2,20,Sardegna,Sardegna,1639591,816942,49.83,0.0
1072,2021-03-12,SAR,6699,2796,3903,5342,1357,ITG,ITG2,20,Sardegna,Sardegna,1639591,823641,50.23,0.41
1073,2021-05-25,SAR,13669,6681,6988,8338,5331,ITG,ITG2,20,Sardegna,Sardegna,1639591,837310,51.07,0.83
1074,2021-03-22,SAR,3551,1363,2188,3038,513,ITG,ITG2,20,Sardegna,Sardegna,1639591,840861,51.28,0.22
1075,2021-04-08,SAR,13426,5924,7502,8307,5119,ITG,ITG2,20,Sardegna,Sardegna,1639591,854287,52.1,0.82
1076,2021-01-12,SAR,865,408,457,865,0,ITG,ITG2,20,Sardegna,Sardegna,1639591,855152,52.16,0.05
1077,2021-05-11,SAR,8648,3989,4659,6317,2331,ITG,ITG2,20,Sardegna,Sardegna,1639591,863800,52.68,0.53
1078,2021-02-26,SAR,2800,1108,1692,2494,306,ITG,ITG2,20,Sardegna,Sardegna,1639591,866600,52.85,0.17
1079,2021-03-06,SAR,2639,1079,1560,858,1781,ITG,ITG2,20,Sardegna,Sardegna,1639591,869239,53.02,0.16
1080,2021-04-25,SAR,4497,2269,2228,3718,779,ITG,ITG2,20,Sardegna,Sardegna,1639591,873736,53.29,0.27
1081,2021-01-15,SAR,1563,573,990,1563,0,ITG,ITG2,20,Sardegna,Sardegna,1639591,875299,53.39,0.1
1082,2021-05-09,SAR,6128,2874,3254,5202,926,ITG,ITG2,20,Sardegna,Sardegna,1639591,881427,53.76,0.37
1083,2021-03-20,SAR,5193,2073,3120,2916,2277,ITG,ITG2,20,Sardegna,Sardegna,1639591,886620,54.08,0.32
1084,2021-01-29,SAR,2955,1069,1886,48,2907,ITG,ITG2,20,Sardegna,Sardegna,1639591,889575,54.26,0.18
1085,2021-01-28,SAR,2970,1045,1925,69,2901,ITG,ITG2,20,Sardegna,Sardegna,1639591,892545,54.44,0.18
1086,2021-03-05,SAR,5036,2445,2591,2682,2354,ITG,ITG2,20,Sardegna,Sardegna,1639591,897581,54.74,0.31
1087,2021-03-19,SAR,7269,3049,4220,5054,2215,ITG,ITG2,20,Sardegna,Sardegna,1639591,904850,55.19,0.44
1088,2021-04-24,SAR,10367,4851,5516,8028,2339,ITG,ITG2,20,Sardegna,Sardegna,1639591,915217,55.82,0.63
1089,2021-01-14,SAR,1105,426,679,1105,0,ITG,ITG2,20,Sardegna,Sardegna,1639591,916322,55.89,0.07
1090,2021-02-07,PUG,1579,669,910,253,1326,ITF,ITF4,16,Puglia,Puglia,4029053,1579,0.04,0.04
1091,2021-01-21,PUG,2132,904,1228,1271,861,ITF,ITF4,16,Puglia,Puglia,4029053,3711,0.09,0.05
1092,2021-05-01,PUG,27465,12580,14885,16816,10649,ITF,ITF4,16,Puglia,Puglia,4029053,31176,0.77,0.68
1093,2021-01-02,PUG,2949,1301,1648,2949,0,ITF,ITF4,16,Puglia,Puglia,4029053,34125,0.85,0.07
1094,2021-04-12,PUG,29088,13700,15388,26263,2825,ITF,ITF4,16,Puglia,Puglia,4029053,63213,1.57,0.72
1095,2021-03-26,PUG,11538,5420,6118,6893,4645,ITF,ITF4,16,Puglia,Puglia,4029053,74751,1.86,0.29
1096,2021-03-28,PUG,3527,1650,1877,1202,2325,ITF,ITF4,16,Puglia,Puglia,4029053,78278,1.94,0.09
1097,2021-02-14,PUG,787,348,439,663,124,ITF,ITF4,16,Puglia,Puglia,4029053,79065,1.96,0.02
1098,2021-01-28,PUG,5472,2277,3195,471,5001,ITF,ITF4,16,Puglia,Puglia,4029053,84537,2.1,0.14
1099,2021-03-05,PUG,17308,6864,10444,15069,2239,ITF,ITF4,16,Puglia,Puglia,4029053,101845,2.53,0.43
1100,2021-02-26,PUG,13714,5027,8687,12680,1034,ITF,ITF4,16,Puglia,Puglia,4029053,115559,2.87,0.34
1101,2020-12-31,PUG,1634,782,852,1634,0,ITF,ITF4,16,Puglia,Puglia,4029053,117193,2.91,0.04
1102,2021-02-28,PUG,6045,1806,4239,5859,186,ITF,ITF4,16,Puglia,Puglia,4029053,123238,3.06,0.15
1103,2021-01-23,PUG,3040,1294,1746,886,2154,ITF,ITF4,16,Puglia,Puglia,4029053,126278,3.13,0.08
1104,2021-05-03,PUG,33084,14766,18318,22468,10616,ITF,ITF4,16,Puglia,Puglia,4029053,159362,3.96,0.82
1105,2021-03-07,PUG,4921,1943,2978,4350,571,ITF,ITF4,16,Puglia,Puglia,4029053,164283,4.08,0.12
1106,2021-04-02,PUG,12591,5765,6826,8072,4519,ITF,ITF4,16,Puglia,Puglia,4029053,176874,4.39,0.31
1107,2021-04-16,PUG,35834,16838,18996,32553,3281,ITF,ITF4,16,Puglia,Puglia,4029053,212708,5.28,0.89
1108,2021-02-18,PUG,4378,1846,2532,3774,604,ITF,ITF4,16,Puglia,Puglia,4029053,217086,5.39,0.11
1109,2021-02-11,PUG,3701,1402,2299,2423,1278,ITF,ITF4,16,Puglia,Puglia,4029053,220787,5.48,0.09
1110,2021-06-01,PUG,17533,8755,8778,11951,5582,ITF,ITF4,16,Puglia,Puglia,4029053,238320,5.92,0.44
1111,2021-05-15,PUG,42884,18687,24197,23291,19593,ITF,ITF4,16,Puglia,Puglia,4029053,281204,6.98,1.06
1112,2021-03-29,PUG,12904,6012,6892,6168,6736,ITF,ITF4,16,Puglia,Puglia,4029053,294108,7.3,0.32
1113,2021-03-12,PUG,13932,6109,7823,10007,3925,ITF,ITF4,16,Puglia,Puglia,4029053,308040,7.65,0.35
1114,2021-02-23,PUG,9349,4422,4927,8874,475,ITF,ITF4,16,Puglia,Puglia,4029053,317389,7.88,0.23
1115,2021-01-14,PUG,4069,1589,2480,4069,0,ITF,ITF4,16,Puglia,Puglia,4029053,321458,7.98,0.1
1116,2021-04-17,PUG,39825,18868,20957,36259,3566,ITF,ITF4,16,Puglia,Puglia,4029053,361283,8.97,0.99
1117,2021-04-26,PUG,26068,11940,14128,22837,3231,ITF,ITF4,16,Puglia,Puglia,4029053,387351,9.61,0.65
1118,2021-01-09,PUG,4885,2250,2635,4885,0,ITF,ITF4,16,Puglia,Puglia,4029053,392236,9.74,0.12
1119,2021-03-14,PUG,3319,1429,1890,2508,811,ITF,ITF4,16,Puglia,Puglia,4029053,395555,9.82,0.08
1120,2021-01-31,PUG,1812,827,985,74,1738,ITF,ITF4,16,Puglia,Puglia,4029053,397367,9.86,0.04
1121,2021-05-29,PUG,29070,13698,15372,20071,8999,ITF,ITF4,16,Puglia,Puglia,4029053,426437,10.58,0.72
1122,2021-04-09,PUG,21838,9390,12448,17217,4621,ITF,ITF4,16,Puglia,Puglia,4029053,448275,11.13,0.54
1123,2021-05-22,PUG,34004,15579,18425,23804,10200,ITF,ITF4,16,Puglia,Puglia,4029053,482279,11.97,0.84
1124,2021-02-25,PUG,11956,5052,6904,10792,1164,ITF,ITF4,16,Puglia,Puglia,4029053,494235,12.27,0.3
1125,2021-01-19,PUG,1221,452,769,1211,10,ITF,ITF4,16,Puglia,Puglia,4029053,495456,12.3,0.03
1126,2021-01-04,PUG,4507,2016,2491,4507,0,ITF,ITF4,16,Puglia,Puglia,4029053,499963,12.41,0.11
1127,2021-03-09,PUG,13291,5790,7501,11283,2008,ITF,ITF4,16,Puglia,Puglia,4029053,513254,12.74,0.33
1128,2021-04-14,PUG,31796,15013,16783,28490,3306,ITF,ITF4,16,Puglia,Puglia,4029053,545050,13.53,0.79
1129,2021-02-21,PUG,2175,472,1703,2114,61,ITF,ITF4,16,Puglia,Puglia,4029053,547225,13.58,0.05
1130,2021-03-10,PUG,14408,6249,8159,11290,3118,ITF,ITF4,16,Puglia,Puglia,4029053,561633,13.94,0.36
1131,2021-02-04,PUG,5926,2366,3560,1195,4731,ITF,ITF4,16,Puglia,Puglia,4029053,567559,14.09,0.15
1132,2021-05-17,PUG,32188,14745,17443,20555,11633,ITF,ITF4,16,Puglia,Puglia,4029053,599747,14.89,0.8
1133,2021-05-12,PUG,36153,16067,20086,23784,12369,ITF,ITF4,16,Puglia,Puglia,4029053,635900,15.78,0.9
1134,2021-05-05,PUG,38794,16953,21841,24667,14127,ITF,ITF4,16,Puglia,Puglia,4029053,674694,16.75,0.96
1135,2021-02-09,PUG,3840,1570,2270,2168,1672,ITF,ITF4,16,Puglia,Puglia,4029053,678534,16.84,0.1
1136,2021-05-20,PUG,32592,14497,18095,20616,11976,ITF,ITF4,16,Puglia,Puglia,4029053,711126,17.65,0.81
1137,2021-03-24,PUG,12976,5983,6993,5719,7257,ITF,ITF4,16,Puglia,Puglia,4029053,724102,17.97,0.32
1138,2021-01-26,PUG,5360,2397,2963,570,4790,ITF,ITF4,16,Puglia,Puglia,4029053,729462,18.11,0.13
1139,2021-05-06,PUG,39251,17134,22117,19613,19638,ITF,ITF4,16,Puglia,Puglia,4029053,768713,19.08,0.97
1140,2021-03-31,PUG,14050,6357,7693,8495,5555,ITF,ITF4,16,Puglia,Puglia,4029053,782763,19.43,0.35
1141,2021-02-02,PUG,4343,1845,2498,593,3750,ITF,ITF4,16,Puglia,Puglia,4029053,787106,19.54,0.11
1142,2021-05-13,PUG,38279,17025,21254,21247,17032,ITF,ITF4,16,Puglia,Puglia,4029053,825385,20.49,0.95
1143,2021-03-17,PUG,10345,4702,5643,4171,6174,ITF,ITF4,16,Puglia,Puglia,4029053,835730,20.74,0.26
1144,2021-03-13,PUG,10386,4103,6283,8654,1732,ITF,ITF4,16,Puglia,Puglia,4029053,846116,21.0,0.26
1145,2021-05-18,PUG,28198,12927,15271,15637,12561,ITF,ITF4,16,Puglia,Puglia,4029053,874314,21.7,0.7
1146,2021-02-05,PUG,5635,2273,3362,1333,4302,ITF,ITF4,16,Puglia,Puglia,4029053,879949,21.84,0.14
1147,2021-04-04,PUG,5942,2951,2991,5937,5,ITF,ITF4,16,Puglia,Puglia,4029053,885891,21.99,0.15
1148,2021-03-21,PUG,2692,1226,1466,588,2104,ITF,ITF4,16,Puglia,Puglia,4029053,888583,22.05,0.07
1149,2021-05-24,PUG,34762,16106,18656,24298,10464,ITF,ITF4,16,Puglia,Puglia,4029053,923345,22.92,0.86
1150,2021-01-30,PUG,5528,2515,3013,411,5117,ITF,ITF4,16,Puglia,Puglia,4029053,928873,23.05,0.14
1151,2021-05-10,PUG,37308,16452,20856,19462,17846,ITF,ITF4,16,Puglia,Puglia,4029053,966181,23.98,0.93
1152,2021-04-23,PUG,29297,13611,15686,24092,5205,ITF,ITF4,16,Puglia,Puglia,4029053,995478,24.71,0.73
1153,2021-03-04,PUG,15113,5903,9210,13715,1398,ITF,ITF4,16,Puglia,Puglia,4029053,1010591,25.08,0.38
1154,2021-02-15,PUG,3252,1268,1984,2632,620,ITF,ITF4,16,Puglia,Puglia,4029053,1013843,25.16,0.08
1155,2021-05-07,PUG,49367,22010,27357,26125,23242,ITF,ITF4,16,Puglia,Puglia,4029053,1063210,26.39,1.23
1156,2021-04-06,PUG,13579,6026,7553,6829,6750,ITF,ITF4,16,Puglia,Puglia,4029053,1076789,26.73,0.34
1157,2021-04-05,PUG,12686,6164,6522,12152,534,ITF,ITF4,16,Puglia,Puglia,4029053,1089475,27.04,0.31
1158,2021-03-19,PUG,7955,3651,4304,3410,4545,ITF,ITF4,16,Puglia,Puglia,4029053,1097430,27.24,0.2
1159,2021-05-25,PUG,33419,15195,18224,20412,13007,ITF,ITF4,16,Puglia,Puglia,4029053,1130849,28.07,0.83
1160,2021-05-08,PUG,53903,22799,31104,24289,29614,ITF,ITF4,16,Puglia,Puglia,4029053,1184752,29.41,1.34
1161,2021-04-10,PUG,30722,13029,17693,26499,4223,ITF,ITF4,16,Puglia,Puglia,4029053,1215474,30.17,0.76
1162,2021-04-19,PUG,27533,12774,14759,24487,3046,ITF,ITF4,16,Puglia,Puglia,4029053,1243007,30.85,0.68
1163,2021-04-24,PUG,29229,13304,15925,25286,3943,ITF,ITF4,16,Puglia,Puglia,4029053,1272236,31.58,0.73
1164,2021-01-07,PUG,5716,2457,3259,5716,0,ITF,ITF4,16,Puglia,Puglia,4029053,1277952,31.72,0.14
1165,2021-02-19,PUG,4730,2009,2721,4338,392,ITF,ITF4,16,Puglia,Puglia,4029053,1282682,31.84,0.12
1166,2021-03-16,PUG,9866,4684,5182,3509,6357,ITF,ITF4,16,Puglia,Puglia,4029053,1292548,32.08,0.24
1167,2021-04-28,PUG,19687,8815,10872,14937,4750,ITF,ITF4,16,Puglia,Puglia,4029053,1312235,32.57,0.49
1168,2021-01-16,PUG,2507,1033,1474,2507,0,ITF,ITF4,16,Puglia,Puglia,4029053,1314742,32.63,0.06
1169,2020-12-30,PUG,1,0,1,1,0,ITF,ITF4,16,Puglia,Puglia,4029053,1314743,32.63,0.0
1170,2021-01-24,PUG,1669,749,920,153,1516,ITF,ITF4,16,Puglia,Puglia,4029053,1316412,32.67,0.04
1171,2021-04-27,PUG,26524,12005,14519,20939,5585,ITF,ITF4,16,Puglia,Puglia,4029053,1342936,33.33,0.66
1172,2021-05-11,PUG,32223,14177,18046,13894,18329,ITF,ITF4,16,Puglia,Puglia,4029053,1375159,34.13,0.8
1173,2021-05-16,PUG,24354,10983,13371,12589,11765,ITF,ITF4,16,Puglia,Puglia,4029053,1399513,34.74,0.6
1174,2021-05-31,PUG,34197,16097,18100,21703,12494,ITF,ITF4,16,Puglia,Puglia,4029053,1433710,35.58,0.85
1175,2021-04-25,PUG,11195,5193,6002,10038,1157,ITF,ITF4,16,Puglia,Puglia,4029053,1444905,35.86,0.28
1176,2021-02-27,PUG,14212,4812,9400,12987,1225,ITF,ITF4,16,Puglia,Puglia,4029053,1459117,36.21,0.35
1177,2021-01-01,PUG,148,61,87,148,0,ITF,ITF4,16,Puglia,Puglia,4029053,1459265,36.22,0.0
1178,2021-04-11,PUG,16443,7240,9203,14787,1656,ITF,ITF4,16,Puglia,Puglia,4029053,1475708,36.63,0.41
1179,2021-03-06,PUG,15974,5967,10007,13887,2087,ITF,ITF4,16,Puglia,Puglia,4029053,1491682,37.02,0.4
1180,2021-01-08,PUG,5597,2347,3250,5597,0,ITF,ITF4,16,Puglia,Puglia,4029053,1497279,37.16,0.14
1181,2021-04-18,PUG,22532,10773,11759,21467,1065,ITF,ITF4,16,Puglia,Puglia,4029053,1519811,37.72,0.56
1182,2021-02-20,PUG,2969,1080,1889,2713,256,ITF,ITF4,16,Puglia,Puglia,4029053,1522780,37.79,0.07
1183,2021-01-15,PUG,4552,1866,2686,4552,0,ITF,ITF4,16,Puglia,Puglia,4029053,1527332,37.91,0.11
1184,2021-01-22,PUG,1409,578,831,991,418,ITF,ITF4,16,Puglia,Puglia,4029053,1528741,37.94,0.03
1185,2021-02-06,PUG,4546,1928,2618,1590,2956,ITF,ITF4,16,Puglia,Puglia,4029053,1533287,38.06,0.11
1186,2021-01-20,PUG,1545,540,1005,1537,8,ITF,ITF4,16,Puglia,Puglia,4029053,1534832,38.09,0.04
1187,2021-05-02,PUG,21249,9638,11611,14000,7249,ITF,ITF4,16,Puglia,Puglia,4029053,1556081,38.62,0.53
1188,2021-01-03,PUG,2007,943,1064,2007,0,ITF,ITF4,16,Puglia,Puglia,4029053,1558088,38.67,0.05
1189,2021-04-15,PUG,32371,15097,17274,28872,3499,ITF,ITF4,16,Puglia,Puglia,4029053,1590459,39.47,0.8
1190,2021-04-20,PUG,21055,9772,11283,17612,3443,ITF,ITF4,16,Puglia,Puglia,4029053,1611514,40.0,0.52
1191,2021-05-21,PUG,37754,17670,20084,28118,9636,ITF,ITF4,16,Puglia,Puglia,4029053,1649268,40.93,0.94
1192,2021-03-23,PUG,10412,5000,5412,3942,6470,ITF,ITF4,16,Puglia,Puglia,4029053,1659680,41.19,0.26
1193,2021-02-08,PUG,3992,1610,2382,1597,2395,ITF,ITF4,16,Puglia,Puglia,4029053,1663672,41.29,0.1
1194,2021-02-17,PUG,4272,1744,2528,3670,602,ITF,ITF4,16,Puglia,Puglia,4029053,1667944,41.4,0.11
1195,2021-05-30,PUG,20217,9672,10545,15319,4898,ITF,ITF4,16,Puglia,Puglia,4029053,1688161,41.9,0.5
1196,2021-01-06,PUG,3946,1669,2277,3946,0,ITF,ITF4,16,Puglia,Puglia,4029053,1692107,42.0,0.1
1197,2021-03-22,PUG,9349,4554,4795,3705,5644,ITF,ITF4,16,Puglia,Puglia,4029053,1701456,42.23,0.23
1198,2021-03-15,PUG,11785,5626,6159,5284,6501,ITF,ITF4,16,Puglia,Puglia,4029053,1713241,42.52,0.29
1199,2021-01-17,PUG,1308,590,718,1239,69,ITF,ITF4,16,Puglia,Puglia,4029053,1714549,42.55,0.03
1200,2021-05-04,PUG,34781,14670,20111,18389,16392,ITF,ITF4,16,Puglia,Puglia,4029053,1749330,43.42,0.86
1201,2021-02-13,PUG,3726,1455,2271,3031,695,ITF,ITF4,16,Puglia,Puglia,4029053,1753056,43.51,0.09
1202,2021-05-09,PUG,30465,12477,17988,14920,15545,ITF,ITF4,16,Puglia,Puglia,4029053,1783521,44.27,0.76
1203,2021-02-12,PUG,4164,1659,2505,3072,1092,ITF,ITF4,16,Puglia,Puglia,4029053,1787685,44.37,0.1
1204,2021-01-29,PUG,6195,2661,3534,436,5759,ITF,ITF4,16,Puglia,Puglia,4029053,1793880,44.52,0.15
1205,2021-03-20,PUG,8255,3734,4521,3666,4589,ITF,ITF4,16,Puglia,Puglia,4029053,1802135,44.73,0.2
1206,2021-03-11,PUG,14382,6195,8187,11274,3108,ITF,ITF4,16,Puglia,Puglia,4029053,1816517,45.09,0.36
1207,2021-02-24,PUG,10034,4703,5331,9445,589,ITF,ITF4,16,Puglia,Puglia,4029053,1826551,45.33,0.25
1208,2021-04-29,PUG,25920,11997,13923,19265,6655,ITF,ITF4,16,Puglia,Puglia,4029053,1852471,45.98,0.64
1209,2021-02-22,PUG,9629,4536,5093,9297,332,ITF,ITF4,16,Puglia,Puglia,4029053,1862100,46.22,0.24
1210,2021-03-30,PUG,11871,5494,6377,5976,5895,ITF,ITF4,16,Puglia,Puglia,4029053,1873971,46.51,0.29
1211,2021-02-01,PUG,3965,1659,2306,375,3590,ITF,ITF4,16,Puglia,Puglia,4029053,1877936,46.61,0.1
1212,2021-05-14,PUG,44560,20319,24241,28506,16054,ITF,ITF4,16,Puglia,Puglia,4029053,1922496,47.72,1.11
1213,2021-01-25,PUG,3824,1681,2143,423,3401,ITF,ITF4,16,Puglia,Puglia,4029053,1926320,47.81,0.09
1214,2021-04-08,PUG,17443,7569,9874,11270,6173,ITF,ITF4,16,Puglia,Puglia,4029053,1943763,48.24,0.43
1215,2021-04-01,PUG,13504,6158,7346,7161,6343,ITF,ITF4,16,Puglia,Puglia,4029053,1957267,48.58,0.34
1216,2021-02-03,PUG,5036,2005,3031,730,4306,ITF,ITF4,16,Puglia,Puglia,4029053,1962303,48.7,0.12
1217,2021-01-18,PUG,1845,770,1075,1496,349,ITF,ITF4,16,Puglia,Puglia,4029053,1964148,48.75,0.05
1218,2021-04-30,PUG,34619,15480,19139,22684,11935,ITF,ITF4,16,Puglia,Puglia,4029053,1998767,49.61,0.86
1219,2021-04-13,PUG,28615,13561,15054,25218,3397,ITF,ITF4,16,Puglia,Puglia,4029053,2027382,50.32,0.71
1220,2021-03-27,PUG,12138,5702,6436,6977,5161,ITF,ITF4,16,Puglia,Puglia,4029053,2039520,50.62,0.3
1221,2021-01-05,PUG,5104,2249,2855,5104,0,ITF,ITF4,16,Puglia,Puglia,4029053,2044624,50.75,0.13
1222,2021-04-03,PUG,10542,4634,5908,6988,3554,ITF,ITF4,16,Puglia,Puglia,4029053,2055166,51.01,0.26
1223,2021-05-19,PUG,25606,12140,13466,19316,6290,ITF,ITF4,16,Puglia,Puglia,4029053,2080772,51.64,0.64
1224,2021-03-25,PUG,10890,5292,5598,4656,6234,ITF,ITF4,16,Puglia,Puglia,4029053,2091662,51.91,0.27
1225,2021-02-10,PUG,3644,1436,2208,2134,1510,ITF,ITF4,16,Puglia,Puglia,4029053,2095306,52.0,0.09
1226,2021-05-23,PUG,17700,8281,9419,13900,3800,ITF,ITF4,16,Puglia,Puglia,4029053,2113006,52.44,0.44
1227,2021-05-28,PUG,41464,19313,22151,26725,14739,ITF,ITF4,16,Puglia,Puglia,4029053,2154470,53.47,1.03
1228,2021-03-08,PUG,14604,6086,8518,12205,2399,ITF,ITF4,16,Puglia,Puglia,4029053,2169074,53.84,0.36
1229,2021-03-18,PUG,9401,4254,5147,3284,6117,ITF,ITF4,16,Puglia,Puglia,4029053,2178475,54.07,0.23
1230,2021-05-26,PUG,37086,17420,19666,26058,11028,ITF,ITF4,16,Puglia,Puglia,4029053,2215561,54.99,0.92
1231,2021-01-27,PUG,4580,1931,2649,611,3969,ITF,ITF4,16,Puglia,Puglia,4029053,2220141,55.1,0.11
1232,2021-01-13,PUG,4541,1731,2810,4541,0,ITF,ITF4,16,Puglia,Puglia,4029053,2224682,55.22,0.11
1233,2021-03-01,PUG,15089,5861,9228,13719,1370,ITF,ITF4,16,Puglia,Puglia,4029053,2239771,55.59,0.37
1234,2021-01-10,PUG,2348,1061,1287,2348,0,ITF,ITF4,16,Puglia,Puglia,4029053,2242119,55.65,0.06
1235,2020-12-27,PUG,509,252,257,509,0,ITF,ITF4,16,Puglia,Puglia,4029053,2242628,55.66,0.01
1236,2021-01-12,PUG,4212,1772,2440,4212,0,ITF,ITF4,16,Puglia,Puglia,4029053,2246840,55.77,0.1
1237,2021-04-07,PUG,15325,6789,8536,8655,6670,ITF,ITF4,16,Puglia,Puglia,4029053,2262165,56.15,0.38
1238,2021-05-27,PUG,38519,17720,20799,22399,16120,ITF,ITF4,16,Puglia,Puglia,4029053,2300684,57.1,0.96
1239,2021-03-02,PUG,16342,6068,10274,15042,1300,ITF,ITF4,16,Puglia,Puglia,4029053,2317026,57.51,0.41
1240,2021-01-11,PUG,3753,1588,2165,3753,0,ITF,ITF4,16,Puglia,Puglia,4029053,2320779,57.6,0.09
1241,2021-04-21,PUG,23055,10636,12419,19322,3733,ITF,ITF4,16,Puglia,Puglia,4029053,2343834,58.17,0.57
1242,2021-02-16,PUG,3379,1452,1927,2735,644,ITF,ITF4,16,Puglia,Puglia,4029053,2347213,58.26,0.08
1243,2021-04-22,PUG,22895,10461,12434,18029,4866,ITF,ITF4,16,Puglia,Puglia,4029053,2370108,58.83,0.57
1244,2021-03-03,PUG,16669,6705,9964,14757,1912,ITF,ITF4,16,Puglia,Puglia,4029053,2386777,59.24,0.41
1245,2021-03-28,CAM,15552,7501,8051,13927,1625,ITF,ITF3,15,Campania,Campania,5801692,15552,0.27,0.27
1246,2021-05-31,CAM,40062,20075,19987,30060,10002,ITF,ITF3,15,Campania,Campania,5801692,55614,0.96,0.69
1247,2021-03-11,CAM,17584,8672,8912,10306,7278,ITF,ITF3,15,Campania,Campania,5801692,73198,1.26,0.3
1248,2021-05-16,CAM,51099,23191,27908,33567,17532,ITF,ITF3,15,Campania,Campania,5801692,124297,2.14,0.88
1249,2021-02-20,CAM,8573,3080,5493,8270,303,ITF,ITF3,15,Campania,Campania,5801692,132870,2.29,0.15
1250,2021-02-03,CAM,8903,4003,4900,878,8025,ITF,ITF3,15,Campania,Campania,5801692,141773,2.44,0.15
1251,2021-02-13,CAM,5508,2550,2958,5291,217,ITF,ITF3,15,Campania,Campania,5801692,147281,2.54,0.09
1252,2021-04-04,CAM,7959,4012,3947,6915,1044,ITF,ITF3,15,Campania,Campania,5801692,155240,2.68,0.14
1253,2021-01-27,CAM,7738,3820,3918,162,7576,ITF,ITF3,15,Campania,Campania,5801692,162978,2.81,0.13
1254,2021-03-18,CAM,12172,5378,6794,5984,6188,ITF,ITF3,15,Campania,Campania,5801692,175150,3.02,0.21
1255,2021-02-11,CAM,6278,2704,3574,6212,66,ITF,ITF3,15,Campania,Campania,5801692,181428,3.13,0.11
1256,2021-04-16,CAM,34301,16552,17749,23643,10658,ITF,ITF3,15,Campania,Campania,5801692,215729,3.72,0.59
1257,2021-01-06,CAM,7652,3749,3903,7652,0,ITF,ITF3,15,Campania,Campania,5801692,223381,3.85,0.13
1258,2021-02-18,CAM,9080,3812,5268,8372,708,ITF,ITF3,15,Campania,Campania,5801692,232461,4.01,0.16
1259,2021-04-25,CAM,30725,15172,15553,25333,5392,ITF,ITF3,15,Campania,Campania,5801692,263186,4.54,0.53
1260,2021-01-13,CAM,8020,3666,4354,8020,0,ITF,ITF3,15,Campania,Campania,5801692,271206,4.67,0.14
1261,2021-04-18,CAM,27214,13281,13933,18316,8898,ITF,ITF3,15,Campania,Campania,5801692,298420,5.14,0.47
1262,2021-01-08,CAM,10455,4968,5487,10455,0,ITF,ITF3,15,Campania,Campania,5801692,308875,5.32,0.18
1263,2021-01-30,CAM,10721,5079,5642,38,10683,ITF,ITF3,15,Campania,Campania,5801692,319596,5.51,0.18
1264,2021-01-23,CAM,3838,2028,1810,273,3565,ITF,ITF3,15,Campania,Campania,5801692,323434,5.57,0.07
1265,2021-04-08,CAM,28269,13639,14630,22433,5836,ITF,ITF3,15,Campania,Campania,5801692,351703,6.06,0.49
1266,2021-05-21,CAM,63378,29336,34042,43178,20200,ITF,ITF3,15,Campania,Campania,5801692,415081,7.15,1.09
1267,2021-04-01,CAM,24338,11687,12651,20205,4133,ITF,ITF3,15,Campania,Campania,5801692,439419,7.57,0.42
1268,2021-01-18,CAM,957,399,558,713,244,ITF,ITF3,15,Campania,Campania,5801692,440376,7.59,0.02
1269,2021-05-17,CAM,49217,21604,27613,24078,25139,ITF,ITF3,15,Campania,Campania,5801692,489593,8.44,0.85
1270,2021-04-30,CAM,42231,20132,22099,25783,16448,ITF,ITF3,15,Campania,Campania,5801692,531824,9.17,0.73
1271,2021-02-04,CAM,7943,3429,4514,1308,6635,ITF,ITF3,15,Campania,Campania,5801692,539767,9.3,0.14
1272,2021-01-01,CAM,919,506,413,919,0,ITF,ITF3,15,Campania,Campania,5801692,540686,9.32,0.02
1273,2021-04-13,CAM,26599,12682,13917,21069,5530,ITF,ITF3,15,Campania,Campania,5801692,567285,9.78,0.46
1274,2021-02-27,CAM,13950,4473,9477,12308,1642,ITF,ITF3,15,Campania,Campania,5801692,581235,10.02,0.24
1275,2021-05-02,CAM,43483,21537,21946,32132,11351,ITF,ITF3,15,Campania,Campania,5801692,624718,10.77,0.75
1276,2021-01-16,CAM,3369,1675,1694,3369,0,ITF,ITF3,15,Campania,Campania,5801692,628087,10.83,0.06
1277,2021-03-21,CAM,9983,4592,5391,7593,2390,ITF,ITF3,15,Campania,Campania,5801692,638070,11.0,0.17
1278,2021-02-10,CAM,6904,3413,3491,6728,176,ITF,ITF3,15,Campania,Campania,5801692,644974,11.12,0.12
1279,2021-05-28,CAM,71296,34159,37137,26731,44565,ITF,ITF3,15,Campania,Campania,5801692,716270,12.35,1.23
1280,2021-05-14,CAM,60792,27461,33331,36304,24488,ITF,ITF3,15,Campania,Campania,5801692,777062,13.39,1.05
1281,2021-01-04,CAM,5825,2962,2863,5825,0,ITF,ITF3,15,Campania,Campania,5801692,782887,13.49,0.1
1282,2021-03-09,CAM,13881,6637,7244,10096,3785,ITF,ITF3,15,Campania,Campania,5801692,796768,13.73,0.24
1283,2021-02-22,CAM,10680,3294,7386,10417,263,ITF,ITF3,15,Campania,Campania,5801692,807448,13.92,0.18
1284,2021-04-11,CAM,17522,8605,8917,15440,2082,ITF,ITF3,15,Campania,Campania,5801692,824970,14.22,0.3
1285,2021-04-28,CAM,36408,17618,18790,26658,9750,ITF,ITF3,15,Campania,Campania,5801692,861378,14.85,0.63
1286,2021-02-06,CAM,5340,2665,2675,2102,3238,ITF,ITF3,15,Campania,Campania,5801692,866718,14.94,0.09
1287,2021-03-25,CAM,19990,9335,10655,16487,3503,ITF,ITF3,15,Campania,Campania,5801692,886708,15.28,0.34
1288,2021-01-20,CAM,1257,650,607,1257,0,ITF,ITF3,15,Campania,Campania,5801692,887965,15.31,0.02
1289,2021-01-03,CAM,3837,2009,1828,3837,0,ITF,ITF3,15,Campania,Campania,5801692,891802,15.37,0.07
1290,2021-04-27,CAM,32118,15594,16524,24198,7920,ITF,ITF3,15,Campania,Campania,5801692,923920,15.93,0.55
1291,2021-03-22,CAM,12740,5921,6819,10700,2040,ITF,ITF3,15,Campania,Campania,5801692,936660,16.14,0.22
1292,2021-03-16,CAM,8086,3519,4567,3772,4314,ITF,ITF3,15,Campania,Campania,5801692,944746,16.28,0.14
1293,2021-01-25,CAM,5745,2927,2818,164,5581,ITF,ITF3,15,Campania,Campania,5801692,950491,16.38,0.1
1294,2021-03-23,CAM,15335,7055,8280,12822,2513,ITF,ITF3,15,Campania,Campania,5801692,965826,16.65,0.26
1295,2021-05-19,CAM,51009,22492,28517,34512,16497,ITF,ITF3,15,Campania,Campania,5801692,1016835,17.53,0.88
1296,2021-05-05,CAM,51124,24838,26286,44748,6376,ITF,ITF3,15,Campania,Campania,5801692,1067959,18.41,0.88
1297,2021-05-12,CAM,40794,19912,20882,31657,9137,ITF,ITF3,15,Campania,Campania,5801692,1108753,19.11,0.7
1298,2021-02-08,CAM,5113,2449,2664,4310,803,ITF,ITF3,15,Campania,Campania,5801692,1113866,19.2,0.09
1299,2021-02-01,CAM,3985,1813,2172,110,3875,ITF,ITF3,15,Campania,Campania,5801692,1117851,19.27,0.07
1300,2021-03-30,CAM,21729,10272,11457,18771,2958,ITF,ITF3,15,Campania,Campania,5801692,1139580,19.64,0.37
1301,2021-02-05,CAM,7260,3463,3797,2133,5127,ITF,ITF3,15,Campania,Campania,5801692,1146840,19.77,0.13
1302,2021-01-21,CAM,2092,1115,977,676,1416,ITF,ITF3,15,Campania,Campania,5801692,1148932,19.8,0.04
1303,2021-05-01,CAM,46319,22654,23665,30221,16098,ITF,ITF3,15,Campania,Campania,5801692,1195251,20.6,0.8
1304,2021-03-26,CAM,19458,8929,10529,15644,3814,ITF,ITF3,15,Campania,Campania,5801692,1214709,20.94,0.34
1305,2021-03-20,CAM,13882,6429,7453,10143,3739,ITF,ITF3,15,Campania,Campania,5801692,1228591,21.18,0.24
1306,2021-05-09,CAM,43169,20272,22897,32079,11090,ITF,ITF3,15,Campania,Campania,5801692,1271760,21.92,0.74
1307,2021-04-05,CAM,11638,5543,6095,9215,2423,ITF,ITF3,15,Campania,Campania,5801692,1283398,22.12,0.2
1308,2021-05-25,CAM,45950,21931,24019,22885,23065,ITF,ITF3,15,Campania,Campania,5801692,1329348,22.91,0.79
1309,2021-04-22,CAM,33941,16530,17411,21539,12402,ITF,ITF3,15,Campania,Campania,5801692,1363289,23.5,0.59
1310,2021-01-26,CAM,7340,3726,3614,351,6989,ITF,ITF3,15,Campania,Campania,5801692,1370629,23.62,0.13
1311,2021-05-24,CAM,31061,14890,16171,16173,14888,ITF,ITF3,15,Campania,Campania,5801692,1401690,24.16,0.54
1312,2021-04-23,CAM,32299,15508,16791,23162,9137,ITF,ITF3,15,Campania,Campania,5801692,1433989,24.72,0.56
1313,2021-03-04,CAM,14659,5352,9307,8766,5893,ITF,ITF3,15,Campania,Campania,5801692,1448648,24.97,0.25
1314,2021-05-07,CAM,59707,29179,30528,43765,15942,ITF,ITF3,15,Campania,Campania,5801692,1508355,26.0,1.03
1315,2021-01-15,CAM,4980,2381,2599,4980,0,ITF,ITF3,15,Campania,Campania,5801692,1513335,26.08,0.09
1316,2021-03-13,CAM,14250,6796,7454,8968,5282,ITF,ITF3,15,Campania,Campania,5801692,1527585,26.33,0.25
1317,2021-05-22,CAM,67835,32439,35396,46439,21396,ITF,ITF3,15,Campania,Campania,5801692,1595420,27.5,1.17
1318,2021-02-25,CAM,12425,4478,7947,11237,1188,ITF,ITF3,15,Campania,Campania,5801692,1607845,27.71,0.21
1319,2021-04-09,CAM,29844,13964,15880,23717,6127,ITF,ITF3,15,Campania,Campania,5801692,1637689,28.23,0.51
1320,2021-01-22,CAM,1524,776,748,673,851,ITF,ITF3,15,Campania,Campania,5801692,1639213,28.25,0.03
1321,2021-03-06,CAM,16308,6753,9555,10639,5669,ITF,ITF3,15,Campania,Campania,5801692,1655521,28.54,0.28
1322,2021-01-05,CAM,7237,3637,3600,7237,0,ITF,ITF3,15,Campania,Campania,5801692,1662758,28.66,0.12
1323,2021-02-17,CAM,7388,3210,4178,6328,1060,ITF,ITF3,15,Campania,Campania,5801692,1670146,28.79,0.13
1324,2021-03-14,CAM,8502,3721,4781,4363,4139,ITF,ITF3,15,Campania,Campania,5801692,1678648,28.93,0.15
1325,2021-04-26,CAM,33999,16635,17364,28377,5622,ITF,ITF3,15,Campania,Campania,5801692,1712647,29.52,0.59
1326,2021-04-17,CAM,36172,17506,18666,24666,11506,ITF,ITF3,15,Campania,Campania,5801692,1748819,30.14,0.62
1327,2021-05-30,CAM,49854,24289,25565,38809,11045,ITF,ITF3,15,Campania,Campania,5801692,1798673,31.0,0.86
1328,2021-02-19,CAM,9570,3559,6011,8920,650,ITF,ITF3,15,Campania,Campania,5801692,1808243,31.17,0.16
1329,2020-12-31,CAM,1490,811,679,1490,0,ITF,ITF3,15,Campania,Campania,5801692,1809733,31.19,0.03
1330,2021-02-26,CAM,13339,4230,9109,12004,1335,ITF,ITF3,15,Campania,Campania,5801692,1823072,31.42,0.23
1331,2021-04-24,CAM,36328,17519,18809,25082,11246,ITF,ITF3,15,Campania,Campania,5801692,1859400,32.05,0.63
1332,2021-04-10,CAM,28341,13486,14855,23428,4913,ITF,ITF3,15,Campania,Campania,5801692,1887741,32.54,0.49
1333,2021-01-07,CAM,8910,4166,4744,8910,0,ITF,ITF3,15,Campania,Campania,5801692,1896651,32.69,0.15
1334,2021-03-05,CAM,16483,6348,10135,9820,6663,ITF,ITF3,15,Campania,Campania,5801692,1913134,32.98,0.28
1335,2021-03-27,CAM,21279,10032,11247,17415,3864,ITF,ITF3,15,Campania,Campania,5801692,1934413,33.34,0.37
1336,2021-03-10,CAM,15253,7382,7871,8419,6834,ITF,ITF3,15,Campania,Campania,5801692,1949666,33.61,0.26
1337,2021-01-09,CAM,10567,5024,5543,10567,0,ITF,ITF3,15,Campania,Campania,5801692,1960233,33.79,0.18
1338,2021-03-08,CAM,14542,6717,7825,9766,4776,ITF,ITF3,15,Campania,Campania,5801692,1974775,34.04,0.25
1339,2021-01-24,CAM,4128,2123,2005,383,3745,ITF,ITF3,15,Campania,Campania,5801692,1978903,34.11,0.07
1340,2021-05-11,CAM,39834,19230,20604,30465,9369,ITF,ITF3,15,Campania,Campania,5801692,2018737,34.8,0.69
1341,2021-02-02,CAM,5723,2804,2919,444,5279,ITF,ITF3,15,Campania,Campania,5801692,2024460,34.89,0.1
1342,2021-04-07,CAM,24753,11780,12973,20031,4722,ITF,ITF3,15,Campania,Campania,5801692,2049213,35.32,0.43
1343,2021-04-02,CAM,21730,10411,11319,19409,2321,ITF,ITF3,15,Campania,Campania,5801692,2070943,35.7,0.37
1344,2021-02-24,CAM,11786,4149,7637,11098,688,ITF,ITF3,15,Campania,Campania,5801692,2082729,35.9,0.2
1345,2021-04-15,CAM,34337,16658,17679,24440,9897,ITF,ITF3,15,Campania,Campania,5801692,2117066,36.49,0.59
1346,2021-05-10,CAM,35396,16368,19028,25488,9908,ITF,ITF3,15,Campania,Campania,5801692,2152462,37.1,0.61
1347,2021-03-07,CAM,11911,5344,6567,8068,3843,ITF,ITF3,15,Campania,Campania,5801692,2164373,37.31,0.21
1348,2021-05-03,CAM,40745,19884,20861,28899,11846,ITF,ITF3,15,Campania,Campania,5801692,2205118,38.01,0.7
1349,2021-04-03,CAM,21115,10315,10800,18735,2380,ITF,ITF3,15,Campania,Campania,5801692,2226233,38.37,0.36
1350,2021-05-23,CAM,58717,28617,30100,37840,20877,ITF,ITF3,15,Campania,Campania,5801692,2284950,39.38,1.01
1351,2021-02-12,CAM,6529,2861,3668,6343,186,ITF,ITF3,15,Campania,Campania,5801692,2291479,39.5,0.11
1352,2021-01-29,CAM,10052,4812,5240,47,10005,ITF,ITF3,15,Campania,Campania,5801692,2301531,39.67,0.17
1353,2021-03-19,CAM,11037,4870,6167,7165,3872,ITF,ITF3,15,Campania,Campania,5801692,2312568,39.86,0.19
1354,2021-05-08,CAM,56343,27099,29244,40524,15819,ITF,ITF3,15,Campania,Campania,5801692,2368911,40.83,0.97
1355,2021-01-28,CAM,8832,4121,4711,134,8698,ITF,ITF3,15,Campania,Campania,5801692,2377743,40.98,0.15
1356,2021-05-29,CAM,64786,30745,34041,43924,20862,ITF,ITF3,15,Campania,Campania,5801692,2442529,42.1,1.12
1357,2021-05-18,CAM,52047,23142,28905,32506,19541,ITF,ITF3,15,Campania,Campania,5801692,2494576,43.0,0.9
1358,2021-04-29,CAM,41283,20007,21276,24818,16465,ITF,ITF3,15,Campania,Campania,5801692,2535859,43.71,0.71
1359,2021-01-19,CAM,1095,474,621,1092,3,ITF,ITF3,15,Campania,Campania,5801692,2536954,43.73,0.02
1360,2021-04-14,CAM,27639,13330,14309,19073,8566,ITF,ITF3,15,Campania,Campania,5801692,2564593,44.2,0.48
1361,2021-04-12,CAM,23301,10916,12385,20265,3036,ITF,ITF3,15,Campania,Campania,5801692,2587894,44.61,0.4
1362,2021-01-02,CAM,3673,1962,1711,3673,0,ITF,ITF3,15,Campania,Campania,5801692,2591567,44.67,0.06
1363,2021-02-07,CAM,2929,1382,1547,2158,771,ITF,ITF3,15,Campania,Campania,5801692,2594496,44.72,0.05
1364,2021-01-17,CAM,1155,551,604,702,453,ITF,ITF3,15,Campania,Campania,5801692,2595651,44.74,0.02
1365,2021-03-15,CAM,12932,6088,6844,8187,4745,ITF,ITF3,15,Campania,Campania,5801692,2608583,44.96,0.22
1366,2021-05-27,CAM,72301,34763,37538,26218,46083,ITF,ITF3,15,Campania,Campania,5801692,2680884,46.21,1.25
1367,2021-02-16,CAM,5440,2411,3029,4669,771,ITF,ITF3,15,Campania,Campania,5801692,2686324,46.3,0.09
1368,2021-03-24,CAM,17621,8082,9539,14664,2957,ITF,ITF3,15,Campania,Campania,5801692,2703945,46.61,0.3
1369,2021-05-20,CAM,60441,27824,32617,43070,17371,ITF,ITF3,15,Campania,Campania,5801692,2764386,47.65,1.04
1370,2021-02-09,CAM,4643,2202,2441,4391,252,ITF,ITF3,15,Campania,Campania,5801692,2769029,47.73,0.08
1371,2021-03-29,CAM,18947,9134,9813,17401,1546,ITF,ITF3,15,Campania,Campania,5801692,2787976,48.05,0.33
1372,2021-06-01,CAM,27088,13531,13557,19533,7555,ITF,ITF3,15,Campania,Campania,5801692,2815064,48.52,0.47
1373,2021-05-15,CAM,62601,29025,33576,43936,18665,ITF,ITF3,15,Campania,Campania,5801692,2877665,49.6,1.08
1374,2021-03-12,CAM,14247,7096,7151,8165,6082,ITF,ITF3,15,Campania,Campania,5801692,2891912,49.85,0.25
1375,2021-02-23,CAM,11003,3388,7615,10477,526,ITF,ITF3,15,Campania,Campania,5801692,2902915,50.04,0.19
1376,2021-05-04,CAM,48432,23330,25102,39544,8888,ITF,ITF3,15,Campania,Campania,5801692,2951347,50.87,0.83
1377,2021-05-13,CAM,55378,24808,30570,39388,15990,ITF,ITF3,15,Campania,Campania,5801692,3006725,51.82,0.95
1378,2021-01-31,CAM,8067,3711,4356,23,8044,ITF,ITF3,15,Campania,Campania,5801692,3014792,51.96,0.14
1379,2021-03-31,CAM,22685,10906,11779,19246,3439,ITF,ITF3,15,Campania,Campania,5801692,3037477,52.36,0.39
1380,2021-03-17,CAM,11588,5099,6489,5008,6580,ITF,ITF3,15,Campania,Campania,5801692,3049065,52.55,0.2
1381,2021-03-03,CAM,13921,5494,8427,7291,6630,ITF,ITF3,15,Campania,Campania,5801692,3062986,52.79,0.24
1382,2021-01-12,CAM,5214,2563,2651,5214,0,ITF,ITF3,15,Campania,Campania,5801692,3068200,52.88,0.09
1383,2021-05-06,CAM,57253,27890,29363,42813,14440,ITF,ITF3,15,Campania,Campania,5801692,3125453,53.87,0.99
1384,2021-02-28,CAM,10412,3206,7206,8512,1900,ITF,ITF3,15,Campania,Campania,5801692,3135865,54.05,0.18
1385,2021-02-14,CAM,3928,1923,2005,3894,34,ITF,ITF3,15,Campania,Campania,5801692,3139793,54.12,0.07
1386,2021-04-19,CAM,30730,14818,15912,19163,11567,ITF,ITF3,15,Campania,Campania,5801692,3170523,54.65,0.53
1387,2021-02-21,CAM,5834,2239,3595,5609,225,ITF,ITF3,15,Campania,Campania,5801692,3176357,54.75,0.1
1388,2021-01-14,CAM,7073,2977,4096,7073,0,ITF,ITF3,15,Campania,Campania,5801692,3183430,54.87,0.12
1389,2021-03-02,CAM,12756,4554,8202,8411,4345,ITF,ITF3,15,Campania,Campania,5801692,3196186,55.09,0.22
1390,2021-01-11,CAM,4072,1871,2201,4072,0,ITF,ITF3,15,Campania,Campania,5801692,3200258,55.16,0.07
1391,2021-05-26,CAM,52000,25383,26617,21129,30871,ITF,ITF3,15,Campania,Campania,5801692,3252258,56.06,0.9
1392,2021-04-06,CAM,24370,11419,12951,19848,4522,ITF,ITF3,15,Campania,Campania,5801692,3276628,56.48,0.42
1393,2020-12-27,CAM,720,422,298,720,0,ITF,ITF3,15,Campania,Campania,5801692,3277348,56.49,0.01
1394,2021-04-20,CAM,32010,15490,16520,20704,11306,ITF,ITF3,15,Campania,Campania,5801692,3309358,57.04,0.55
1395,2021-02-15,CAM,5470,2516,2954,5297,173,ITF,ITF3,15,Campania,Campania,5801692,3314828,57.14,0.09
1396,2021-03-01,CAM,12130,4247,7883,8017,4113,ITF,ITF3,15,Campania,Campania,5801692,3326958,57.34,0.21
1397,2021-01-10,CAM,8165,3736,4429,8165,0,ITF,ITF3,15,Campania,Campania,5801692,3335123,57.49,0.14
1398,2021-04-21,CAM,30220,14723,15497,17993,12227,ITF,ITF3,15,Campania,Campania,5801692,3365343,58.01,0.52
1399,2021-02-22,VDA,316,94,222,213,103,ITC,ITC2,2,Valle d'Aosta / Vallée d'Aoste,Valle d'Aosta,125666,316,0.25,0.25
1400,2021-01-19,VDA,256,77,179,256,0,ITC,ITC2,2,Valle d'Aosta / Vallée d'Aoste,Valle d'Aosta,125666,572,0.46,0.2
1401,2021-04-29,VDA,1291,634,657,757,534,ITC,ITC2,2,Valle d'Aosta / Vallée d'Aoste,Valle d'Aosta,125666,1863,1.48,1.03
1402,2021-04-14,VDA,941,430,511,717,224,ITC,ITC2,2,Valle d'Aosta / Vallée d'Aoste,Valle d'Aosta,125666,2804,2.23,0.75
1403,2021-04-20,VDA,932,430,502,738,194,ITC,ITC2,2,Valle d'Aosta / Vallée d'Aoste,Valle d'Aosta,125666,3736,2.97,0.74
1404,2021-02-15,VDA,264,136,128,229,35,ITC,ITC2,2,Valle d'Aosta / Vallée d'Aoste,Valle d'Aosta,125666,4000,3.18,0.21
1405,2021-02-14,VDA,48,16,32,1,47,ITC,ITC2,2,Valle d'Aosta / Vallée d'Aoste,Valle d'Aosta,125666,4048,3.22,0.04
1406,2021-02-03,VDA,351,114,237,14,337,ITC,ITC2,2,Valle d'Aosta / Vallée d'Aoste,Valle d'Aosta,125666,4399,3.5,0.28
1407,2021-04-01,VDA,776,394,382,764,12,ITC,ITC2,2,Valle d'Aosta / Vallée d'Aoste,Valle d'Aosta,125666,5175,4.12,0.62
1408,2021-02-24,VDA,183,82,101,164,19,ITC,ITC2,2,Valle d'Aosta / Vallée d'Aoste,Valle d'Aosta,125666,5358,4.26,0.15
1409,2021-04-08,VDA,584,282,302,441,143,ITC,ITC2,2,Valle d'Aosta / Vallée d'Aoste,Valle d'Aosta,125666,5942,4.73,0.46
1410,2021-03-08,VDA,482,231,251,237,245,ITC,ITC2,2,Valle d'Aosta / Vallée d'Aoste,Valle d'Aosta,125666,6424,5.11,0.38
1411,2021-05-11,VDA,645,325,320,494,151,ITC,ITC2,2,Valle d'Aosta / Vallée d'Aoste,Valle d'Aosta,125666,7069,5.63,0.51
1412,2021-04-27,VDA,978,423,555,686,292,ITC,ITC2,2,Valle d'Aosta / Vallée d'Aoste,Valle d'Aosta,125666,8047,6.4,0.78
1413,2021-03-31,VDA,555,302,253,529,26,ITC,ITC2,2,Valle d'Aosta / Vallée d'Aoste,Valle d'Aosta,125666,8602,6.85,0.44
1414,2021-05-27,VDA,1089,497,592,586,503,ITC,ITC2,2,Valle d'Aosta / Vallée d'Aoste,Valle d'Aosta,125666,9691,7.71,0.87
1415,2021-05-13,VDA,1139,556,583,540,599,ITC,ITC2,2,Valle d'Aosta / Vallée d'Aoste,Valle d'Aosta,125666,10830,8.62,0.91
1416,2021-02-02,VDA,272,70,202,2,270,ITC,ITC2,2,Valle d'Aosta / Vallée d'Aoste,Valle d'Aosta,125666,11102,8.83,0.22
1417,2021-05-20,VDA,807,363,444,367,440,ITC,ITC2,2,Valle d'Aosta / Vallée d'Aoste,Valle d'Aosta,125666,11909,9.48,0.64
1418,2021-04-15,VDA,810,377,433,671,139,ITC,ITC2,2,Valle d'Aosta / Vallée d'Aoste,Valle d'Aosta,125666,12719,10.12,0.64
1419,2021-03-29,VDA,493,233,260,453,40,ITC,ITC2,2,Valle d'Aosta / Vallée d'Aoste,Valle d'Aosta,125666,13212,10.51,0.39
1420,2021-03-12,VDA,531,175,356,305,226,ITC,ITC2,2,Valle d'Aosta / Vallée d'Aoste,Valle d'Aosta,125666,13743,10.94,0.42
1421,2021-06-01,VDA,579,306,273,229,350,ITC,ITC2,2,Valle d'Aosta / Vallée d'Aoste,Valle d'Aosta,125666,14322,11.4,0.46
1422,2021-05-30,VDA,865,429,436,694,171,ITC,ITC2,2,Valle d'Aosta / Vallée d'Aoste,Valle d'Aosta,125666,15187,12.09,0.69
1423,2021-02-17,VDA,327,144,183,227,100,ITC,ITC2,2,Valle d'Aosta / Vallée d'Aoste,Valle d'Aosta,125666,15514,12.35,0.26
1424,2021-05-21,VDA,917,433,484,531,386,ITC,ITC2,2,Valle d'Aosta / Vallée d'Aoste,Valle d'Aosta,125666,16431,13.08,0.73
1425,2021-04-17,VDA,638,407,231,636,2,ITC,ITC2,2,Valle d'Aosta / Vallée d'Aoste,Valle d'Aosta,125666,17069,13.58,0.51
1426,2021-01-05,VDA,150,54,96,150,0,ITC,ITC2,2,Valle d'Aosta / Vallée d'Aoste,Valle d'Aosta,125666,17219,13.7,0.12
1427,2021-01-14,VDA,237,69,168,237,0,ITC,ITC2,2,Valle d'Aosta / Vallée d'Aoste,Valle d'Aosta,125666,17456,13.89,0.19
1428,2021-05-04,VDA,1135,510,625,462,673,ITC,ITC2,2,Valle d'Aosta / Vallée d'Aoste,Valle d'Aosta,125666,18591,14.79,0.9
1429,2021-03-15,VDA,362,123,239,159,203,ITC,ITC2,2,Valle d'Aosta / Vallée d'Aoste,Valle d'Aosta,125666,18953,15.08,0.29
1430,2021-01-17,VDA,131,56,75,131,0,ITC,ITC2,2,Valle d'Aosta / Vallée d'Aoste,Valle d'Aosta,125666,19084,15.19,0.1
1431,2021-01-31,VDA,291,91,200,58,233,ITC,ITC2,2,Valle d'Aosta / Vallée d'Aoste,Valle d'Aosta,125666,19375,15.42,0.23
1432,2021-03-22,VDA,560,205,355,333,227,ITC,ITC2,2,Valle d'Aosta / Vallée d'Aoste,Valle d'Aosta,125666,19935,15.86,0.45
1433,2021-02-05,VDA,294,102,192,101,193,ITC,ITC2,2,Valle d'Aosta / Vallée d'Aoste,Valle d'Aosta,125666,20229,16.1,0.23
1434,2021-05-16,VDA,688,341,347,347,341,ITC,ITC2,2,Valle d'Aosta / Vallée d'Aoste,Valle d'Aosta,125666,20917,16.64,0.55
1435,2021-04-12,VDA,486,186,300,323,163,ITC,ITC2,2,Valle d'Aosta / Vallée d'Aoste,Valle d'Aosta,125666,21403,17.03,0.39
1436,2021-05-18,VDA,969,484,485,353,616,ITC,ITC2,2,Valle d'Aosta / Vallée d'Aoste,Valle d'Aosta,125666,22372,17.8,0.77
1437,2021-02-07,VDA,292,120,172,190,102,ITC,ITC2,2,Valle d'Aosta / Vallée d'Aoste,Valle d'Aosta,125666,22664,18.04,0.23
1438,2021-04-13,VDA,373,171,202,329,44,ITC,ITC2,2,Valle d'Aosta / Vallée d'Aoste,Valle d'Aosta,125666,23037,18.33,0.3
1439,2021-03-27,VDA,333,164,169,302,31,ITC,ITC2,2,Valle d'Aosta / Vallée d'Aoste,Valle d'Aosta,125666,23370,18.6,0.26
1440,2021-03-10,VDA,438,183,255,225,213,ITC,ITC2,2,Valle d'Aosta / Vallée d'Aoste,Valle d'Aosta,125666,23808,18.95,0.35
1441,2021-02-21,VDA,18,3,15,0,18,ITC,ITC2,2,Valle d'Aosta / Vallée d'Aoste,Valle d'Aosta,125666,23826,18.96,0.01
1442,2021-02-26,VDA,207,58,149,122,85,ITC,ITC2,2,Valle d'Aosta / Vallée d'Aoste,Valle d'Aosta,125666,24033,19.12,0.16
1443,2021-04-10,VDA,404,190,214,399,5,ITC,ITC2,2,Valle d'Aosta / Vallée d'Aoste,Valle d'Aosta,125666,24437,19.45,0.32
1444,2020-12-31,VDA,18,4,14,18,0,ITC,ITC2,2,Valle d'Aosta / Vallée d'Aoste,Valle d'Aosta,125666,24455,19.46,0.01
1445,2021-03-05,VDA,275,124,151,53,222,ITC,ITC2,2,Valle d'Aosta / Vallée d'Aoste,Valle d'Aosta,125666,24730,19.68,0.22
1446,2021-05-02,VDA,765,345,420,605,160,ITC,ITC2,2,Valle d'Aosta / Vallée d'Aoste,Valle d'Aosta,125666,25495,20.29,0.61
1447,2021-01-22,VDA,56,21,35,20,36,ITC,ITC2,2,Valle d'Aosta / Vallée d'Aoste,Valle d'Aosta,125666,25551,20.33,0.04
1448,2021-01-08,VDA,299,130,169,299,0,ITC,ITC2,2,Valle d'Aosta / Vallée d'Aoste,Valle d'Aosta,125666,25850,20.57,0.24
1449,2021-03-06,VDA,22,4,18,22,0,ITC,ITC2,2,Valle d'Aosta / Vallée d'Aoste,Valle d'Aosta,125666,25872,20.59,0.02
1450,2021-03-13,VDA,145,86,59,145,0,ITC,ITC2,2,Valle d'Aosta / Vallée d'Aoste,Valle d'Aosta,125666,26017,20.7,0.12
1451,2021-01-15,VDA,218,82,136,218,0,ITC,ITC2,2,Valle d'Aosta / Vallée d'Aoste,Valle d'Aosta,125666,26235,20.88,0.17
1452,2021-01-04,VDA,142,59,83,142,0,ITC,ITC2,2,Valle d'Aosta / Vallée d'Aoste,Valle d'Aosta,125666,26377,20.99,0.11
1453,2021-03-11,VDA,197,76,121,66,131,ITC,ITC2,2,Valle d'Aosta / Vallée d'Aoste,Valle d'Aosta,125666,26574,21.15,0.16
1454,2021-03-09,VDA,206,96,110,174,32,ITC,ITC2,2,Valle d'Aosta / Vallée d'Aoste,Valle d'Aosta,125666,26780,21.31,0.16
1455,2021-04-22,VDA,1067,449,618,684,383,ITC,ITC2,2,Valle d'Aosta / Vallée d'Aoste,Valle d'Aosta,125666,27847,22.16,0.85
1456,2021-03-17,VDA,433,185,248,273,160,ITC,ITC2,2,Valle d'Aosta / Vallée d'Aoste,Valle d'Aosta,125666,28280,22.5,0.34
1457,2021-03-03,VDA,255,118,137,187,68,ITC,ITC2,2,Valle d'Aosta / Vallée d'Aoste,Valle d'Aosta,125666,28535,22.71,0.2
1458,2021-01-26,VDA,139,48,91,0,139,ITC,ITC2,2,Valle d'Aosta / Vallée d'Aoste,Valle d'Aosta,125666,28674,22.82,0.11
1459,2021-01-12,VDA,302,72,230,302,0,ITC,ITC2,2,Valle d'Aosta / Vallée d'Aoste,Valle d'Aosta,125666,28976,23.06,0.24
1460,2021-01-28,VDA,290,123,167,56,234,ITC,ITC2,2,Valle d'Aosta / Vallée d'Aoste,Valle d'Aosta,125666,29266,23.29,0.23
1461,2021-05-07,VDA,564,245,319,533,31,ITC,ITC2,2,Valle d'Aosta / Vallée d'Aoste,Valle d'Aosta,125666,29830,23.74,0.45
1462,2021-04-23,VDA,921,443,478,538,383,ITC,ITC2,2,Valle d'Aosta / Vallée d'Aoste,Valle d'Aosta,125666,30751,24.47,0.73
1463,2021-04-06,VDA,741,381,360,629,112,ITC,ITC2,2,Valle d'Aosta / Vallée d'Aoste,Valle d'Aosta,125666,31492,25.06,0.59
1464,2021-03-04,VDA,291,139,152,42,249,ITC,ITC2,2,Valle d'Aosta / Vallée d'Aoste,Valle d'Aosta,125666,31783,25.29,0.23
1465,2021-01-27,VDA,151,71,80,79,72,ITC,ITC2,2,Valle d'Aosta / Vallée d'Aoste,Valle d'Aosta,125666,31934,25.41,0.12
1466,2021-01-10,VDA,220,71,149,220,0,ITC,ITC2,2,Valle d'Aosta / Vallée d'Aoste,Valle d'Aosta,125666,32154,25.59,0.18
1467,2020-12-27,VDA,20,9,11,20,0,ITC,ITC2,2,Valle d'Aosta / Vallée d'Aoste,Valle d'Aosta,125666,32174,25.6,0.02
1468,2021-03-01,VDA,181,66,115,147,34,ITC,ITC2,2,Valle d'Aosta / Vallée d'Aoste,Valle d'Aosta,125666,32355,25.75,0.14
1469,2021-05-25,VDA,1115,530,585,541,574,ITC,ITC2,2,Valle d'Aosta / Vallée d'Aoste,Valle d'Aosta,125666,33470,26.63,0.89
1470,2021-05-08,VDA,904,540,364,526,378,ITC,ITC2,2,Valle d'Aosta / Vallée d'Aoste,Valle d'Aosta,125666,34374,27.35,0.72
1471,2021-04-05,VDA,461,222,239,457,4,ITC,ITC2,2,Valle d'Aosta / Vallée d'Aoste,Valle d'Aosta,125666,34835,27.72,0.37
1472,2021-05-05,VDA,1038,566,472,456,582,ITC,ITC2,2,Valle d'Aosta / Vallée d'Aoste,Valle d'Aosta,125666,35873,28.55,0.83
1473,2021-01-25,VDA,147,65,82,0,147,ITC,ITC2,2,Valle d'Aosta / Vallée d'Aoste,Valle d'Aosta,125666,36020,28.66,0.12
1474,2021-05-14,VDA,960,442,518,291,669,ITC,ITC2,2,Valle d'Aosta / Vallée d'Aoste,Valle d'Aosta,125666,36980,29.43,0.76
1475,2021-05-28,VDA,975,414,561,563,412,ITC,ITC2,2,Valle d'Aosta / Vallée d'Aoste,Valle d'Aosta,125666,37955,30.2,0.78
1476,2021-02-10,VDA,248,77,171,141,107,ITC,ITC2,2,Valle d'Aosta / Vallée d'Aoste,Valle d'Aosta,125666,38203,30.4,0.2
1477,2021-03-25,VDA,389,154,235,379,10,ITC,ITC2,2,Valle d'Aosta / Vallée d'Aoste,Valle d'Aosta,125666,38592,30.71,0.31
1478,2021-01-07,VDA,275,111,164,275,0,ITC,ITC2,2,Valle d'Aosta / Vallée d'Aoste,Valle d'Aosta,125666,38867,30.93,0.22
1479,2021-02-19,VDA,292,102,190,268,24,ITC,ITC2,2,Valle d'Aosta / Vallée d'Aoste,Valle d'Aosta,125666,39159,31.16,0.23
1480,2021-04-24,VDA,722,400,322,555,167,ITC,ITC2,2,Valle d'Aosta / Vallée d'Aoste,Valle d'Aosta,125666,39881,31.74,0.57
1481,2021-04-19,VDA,751,325,426,542,209,ITC,ITC2,2,Valle d'Aosta / Vallée d'Aoste,Valle d'Aosta,125666,40632,32.33,0.6
1482,2021-02-11,VDA,231,107,124,222,9,ITC,ITC2,2,Valle d'Aosta / Vallée d'Aoste,Valle d'Aosta,125666,40863,32.52,0.18
1483,2021-04-16,VDA,599,261,338,597,2,ITC,ITC2,2,Valle d'Aosta / Vallée d'Aoste,Valle d'Aosta,125666,41462,32.99,0.48
1484,2021-04-02,VDA,873,344,529,648,225,ITC,ITC2,2,Valle d'Aosta / Vallée d'Aoste,Valle d'Aosta,125666,42335,33.69,0.69
1485,2021-02-18,VDA,349,153,196,261,88,ITC,ITC2,2,Valle d'Aosta / Vallée d'Aoste,Valle d'Aosta,125666,42684,33.97,0.28
1486,2021-03-24,VDA,515,230,285,258,257,ITC,ITC2,2,Valle d'Aosta / Vallée d'Aoste,Valle d'Aosta,125666,43199,34.38,0.41
1487,2021-05-06,VDA,1063,509,554,679,384,ITC,ITC2,2,Valle d'Aosta / Vallée d'Aoste,Valle d'Aosta,125666,44262,35.22,0.85
1488,2021-02-16,VDA,325,53,272,320,5,ITC,ITC2,2,Valle d'Aosta / Vallée d'Aoste,Valle d'Aosta,125666,44587,35.48,0.26
1489,2021-04-07,VDA,910,474,436,681,229,ITC,ITC2,2,Valle d'Aosta / Vallée d'Aoste,Valle d'Aosta,125666,45497,36.2,0.72
1490,2021-02-09,VDA,251,84,167,68,183,ITC,ITC2,2,Valle d'Aosta / Vallée d'Aoste,Valle d'Aosta,125666,45748,36.4,0.2
1491,2021-02-23,VDA,216,123,93,216,0,ITC,ITC2,2,Valle d'Aosta / Vallée d'Aoste,Valle d'Aosta,125666,45964,36.58,0.17
1492,2021-05-15,VDA,1065,614,451,380,685,ITC,ITC2,2,Valle d'Aosta / Vallée d'Aoste,Valle d'Aosta,125666,47029,37.42,0.85
1493,2021-04-28,VDA,1218,632,586,715,503,ITC,ITC2,2,Valle d'Aosta / Vallée d'Aoste,Valle d'Aosta,125666,48247,38.39,0.97
1494,2021-02-06,VDA,289,104,185,92,197,ITC,ITC2,2,Valle d'Aosta / Vallée d'Aoste,Valle d'Aosta,125666,48536,38.62,0.23
1495,2021-01-20,VDA,23,8,15,23,0,ITC,ITC2,2,Valle d'Aosta / Vallée d'Aoste,Valle d'Aosta,125666,48559,38.64,0.02
1496,2021-03-14,VDA,392,200,192,392,0,ITC,ITC2,2,Valle d'Aosta / Vallée d'Aoste,Valle d'Aosta,125666,48951,38.95,0.31
1497,2021-04-26,VDA,715,327,388,545,170,ITC,ITC2,2,Valle d'Aosta / Vallée d'Aoste,Valle d'Aosta,125666,49666,39.52,0.57
1498,2021-01-09,VDA,443,199,244,443,0,ITC,ITC2,2,Valle d'Aosta / Vallée d'Aoste,Valle d'Aosta,125666,50109,39.87,0.35
1499,2021-02-08,VDA,223,83,140,25,198,ITC,ITC2,2,Valle d'Aosta / Vallée d'Aoste,Valle d'Aosta,125666,50332,40.05,0.18
1500,2021-03-23,VDA,379,150,229,245,134,ITC,ITC2,2,Valle d'Aosta / Vallée d'Aoste,Valle d'Aosta,125666,50711,40.35,0.3
1501,2021-04-09,VDA,237,111,126,204,33,ITC,ITC2,2,Valle d'Aosta / Vallée d'Aoste,Valle d'Aosta,125666,50948,40.54,0.19
1502,2021-05-22,VDA,940,494,446,540,400,ITC,ITC2,2,Valle d'Aosta / Vallée d'Aoste,Valle d'Aosta,125666,51888,41.29,0.75
1503,2021-05-29,VDA,798,434,364,561,237,ITC,ITC2,2,Valle d'Aosta / Vallée d'Aoste,Valle d'Aosta,125666,52686,41.93,0.64
1504,2021-02-25,VDA,201,101,100,194,7,ITC,ITC2,2,Valle d'Aosta / Vallée d'Aoste,Valle d'Aosta,125666,52887,42.09,0.16
1505,2021-01-06,VDA,65,33,32,65,0,ITC,ITC2,2,Valle d'Aosta / Vallée d'Aoste,Valle d'Aosta,125666,52952,42.14,0.05
1506,2021-04-21,VDA,868,410,458,620,248,ITC,ITC2,2,Valle d'Aosta / Vallée d'Aoste,Valle d'Aosta,125666,53820,42.83,0.69
1507,2021-03-02,VDA,339,166,173,336,3,ITC,ITC2,2,Valle d'Aosta / Vallée d'Aoste,Valle d'Aosta,125666,54159,43.1,0.27
1508,2021-01-11,VDA,325,112,213,325,0,ITC,ITC2,2,Valle d'Aosta / Vallée d'Aoste,Valle d'Aosta,125666,54484,43.36,0.26
1509,2021-04-18,VDA,522,254,268,518,4,ITC,ITC2,2,Valle d'Aosta / Vallée d'Aoste,Valle d'Aosta,125666,55006,43.77,0.42
1510,2021-05-31,VDA,879,395,484,500,379,ITC,ITC2,2,Valle d'Aosta / Vallée d'Aoste,Valle d'Aosta,125666,55885,44.47,0.7
1511,2021-02-01,VDA,404,127,277,87,317,ITC,ITC2,2,Valle d'Aosta / Vallée d'Aoste,Valle d'Aosta,125666,56289,44.79,0.32
1512,2021-03-30,VDA,402,223,179,382,20,ITC,ITC2,2,Valle d'Aosta / Vallée d'Aoste,Valle d'Aosta,125666,56691,45.11,0.32
1513,2021-05-12,VDA,1138,549,589,468,670,ITC,ITC2,2,Valle d'Aosta / Vallée d'Aoste,Valle d'Aosta,125666,57829,46.02,0.91
1514,2021-05-01,VDA,940,563,377,456,484,ITC,ITC2,2,Valle d'Aosta / Vallée d'Aoste,Valle d'Aosta,125666,58769,46.77,0.75
1515,2021-01-02,VDA,6,5,1,6,0,ITC,ITC2,2,Valle d'Aosta / Vallée d'Aoste,Valle d'Aosta,125666,58775,46.77,0.0
1516,2021-03-26,VDA,498,204,294,491,7,ITC,ITC2,2,Valle d'Aosta / Vallée d'Aoste,Valle d'Aosta,125666,59273,47.17,0.4
1517,2021-01-21,VDA,33,12,21,33,0,ITC,ITC2,2,Valle d'Aosta / Vallée d'Aoste,Valle d'Aosta,125666,59306,47.19,0.03
1518,2021-03-28,VDA,522,212,310,521,1,ITC,ITC2,2,Valle d'Aosta / Vallée d'Aoste,Valle d'Aosta,125666,59828,47.61,0.42
1519,2021-02-20,VDA,251,210,41,241,10,ITC,ITC2,2,Valle d'Aosta / Vallée d'Aoste,Valle d'Aosta,125666,60079,47.81,0.2
1520,2021-02-28,VDA,260,86,174,77,183,ITC,ITC2,2,Valle d'Aosta / Vallée d'Aoste,Valle d'Aosta,125666,60339,48.02,0.21
1521,2021-05-03,VDA,839,400,439,488,351,ITC,ITC2,2,Valle d'Aosta / Vallée d'Aoste,Valle d'Aosta,125666,61178,48.68,0.67
1522,2021-03-07,VDA,64,30,34,11,53,ITC,ITC2,2,Valle d'Aosta / Vallée d'Aoste,Valle d'Aosta,125666,61242,48.73,0.05
1523,2021-01-30,VDA,439,202,237,14,425,ITC,ITC2,2,Valle d'Aosta / Vallée d'Aoste,Valle d'Aosta,125666,61681,49.08,0.35
1524,2021-05-17,VDA,809,417,392,375,434,ITC,ITC2,2,Valle d'Aosta / Vallée d'Aoste,Valle d'Aosta,125666,62490,49.73,0.64
1525,2021-02-04,VDA,294,86,208,8,286,ITC,ITC2,2,Valle d'Aosta / Vallée d'Aoste,Valle d'Aosta,125666,62784,49.96,0.23
1526,2021-04-30,VDA,831,355,476,485,346,ITC,ITC2,2,Valle d'Aosta / Vallée d'Aoste,Valle d'Aosta,125666,63615,50.62,0.66
1527,2021-01-16,VDA,236,80,156,236,0,ITC,ITC2,2,Valle d'Aosta / Vallée d'Aoste,Valle d'Aosta,125666,63851,50.81,0.19
1528,2021-05-19,VDA,993,498,495,418,575,ITC,ITC2,2,Valle d'Aosta / Vallée d'Aoste,Valle d'Aosta,125666,64844,51.6,0.79
1529,2021-03-16,VDA,180,37,143,118,62,ITC,ITC2,2,Valle d'Aosta / Vallée d'Aoste,Valle d'Aosta,125666,65024,51.74,0.14
1530,2021-04-25,VDA,849,408,441,710,139,ITC,ITC2,2,Valle d'Aosta / Vallée d'Aoste,Valle d'Aosta,125666,65873,52.42,0.68
1531,2021-02-27,VDA,231,85,146,124,107,ITC,ITC2,2,Valle d'Aosta / Vallée d'Aoste,Valle d'Aosta,125666,66104,52.6,0.18
1532,2021-03-19,VDA,322,85,237,286,36,ITC,ITC2,2,Valle d'Aosta / Vallée d'Aoste,Valle d'Aosta,125666,66426,52.86,0.26
1533,2021-01-13,VDA,337,110,227,337,0,ITC,ITC2,2,Valle d'Aosta / Vallée d'Aoste,Valle d'Aosta,125666,66763,53.13,0.27
1534,2021-03-18,VDA,136,43,93,99,37,ITC,ITC2,2,Valle d'Aosta / Vallée d'Aoste,Valle d'Aosta,125666,66899,53.24,0.11
1535,2021-05-26,VDA,1209,587,622,576,633,ITC,ITC2,2,Valle d'Aosta / Vallée d'Aoste,Valle d'Aosta,125666,68108,54.2,0.96
1536,2021-01-18,VDA,213,74,139,213,0,ITC,ITC2,2,Valle d'Aosta / Vallée d'Aoste,Valle d'Aosta,125666,68321,54.37,0.17
1537,2021-04-11,VDA,479,208,271,479,0,ITC,ITC2,2,Valle d'Aosta / Vallée d'Aoste,Valle d'Aosta,125666,68800,54.75,0.38
1538,2021-04-03,VDA,676,341,335,661,15,ITC,ITC2,2,Valle d'Aosta / Vallée d'Aoste,Valle d'Aosta,125666,69476,55.29,0.54
1539,2021-03-20,VDA,208,86,122,172,36,ITC,ITC2,2,Valle d'Aosta / Vallée d'Aoste,Valle d'Aosta,125666,69684,55.45,0.17
1540,2021-05-23,VDA,999,465,534,658,341,ITC,ITC2,2,Valle d'Aosta / Vallée d'Aoste,Valle d'Aosta,125666,70683,56.25,0.79
1541,2021-01-29,VDA,318,138,180,2,316,ITC,ITC2,2,Valle d'Aosta / Vallée d'Aoste,Valle d'Aosta,125666,71001,56.5,0.25
1542,2021-05-09,VDA,574,287,287,444,130,ITC,ITC2,2,Valle d'Aosta / Vallée d'Aoste,Valle d'Aosta,125666,71575,56.96,0.46
1543,2021-02-12,VDA,263,96,167,217,46,ITC,ITC2,2,Valle d'Aosta / Vallée d'Aoste,Valle d'Aosta,125666,71838,57.17,0.21
1544,2021-05-24,VDA,1135,516,619,688,447,ITC,ITC2,2,Valle d'Aosta / Vallée d'Aoste,Valle d'Aosta,125666,72973,58.07,0.9
1545,2021-05-10,VDA,782,381,401,547,235,ITC,ITC2,2,Valle d'Aosta / Vallée d'Aoste,Valle d'Aosta,125666,73755,58.69,0.62
1546,2021-03-21,VDA,355,165,190,355,0,ITC,ITC2,2,Valle d'Aosta / Vallée d'Aoste,Valle d'Aosta,125666,74110,58.97,0.28
1547,2021-04-04,VDA,572,253,319,571,1,ITC,ITC2,2,Valle d'Aosta / Vallée d'Aoste,Valle d'Aosta,125666,74682,59.43,0.46
1548,2021-02-13,VDA,216,196,20,215,1,ITC,ITC2,2,Valle d'Aosta / Vallée d'Aoste,Valle d'Aosta,125666,74898,59.6,0.17
1549,2021-01-22,ABR,118,57,61,118,0,ITF,ITF1,13,Abruzzo,Abruzzo,1304970,118,0.01,0.01
1550,2021-03-27,ABR,6121,2620,3501,3636,2485,ITF,ITF1,13,Abruzzo,Abruzzo,1304970,6239,0.48,0.47
1551,2021-03-12,ABR,6016,1986,4030,4434,1582,ITF,ITF1,13,Abruzzo,Abruzzo,1304970,12255,0.94,0.46
1552,2021-03-14,ABR,1883,731,1152,1216,667,ITF,ITF1,13,Abruzzo,Abruzzo,1304970,14138,1.08,0.14
1553,2021-04-08,ABR,7367,3329,4038,5065,2302,ITF,ITF1,13,Abruzzo,Abruzzo,1304970,21505,1.65,0.56
1554,2021-03-22,ABR,4281,1852,2429,2311,1970,ITF,ITF1,13,Abruzzo,Abruzzo,1304970,25786,1.98,0.33
1555,2021-05-11,ABR,10737,5097,5640,5909,4828,ITF,ITF1,13,Abruzzo,Abruzzo,1304970,36523,2.8,0.82
1556,2021-01-12,ABR,1804,666,1138,1804,0,ITF,ITF1,13,Abruzzo,Abruzzo,1304970,38327,2.94,0.14
1557,2021-05-25,ABR,11213,5195,6018,8091,3122,ITF,ITF1,13,Abruzzo,Abruzzo,1304970,49540,3.8,0.86
1558,2021-05-15,ABR,11421,5174,6247,6126,5295,ITF,ITF1,13,Abruzzo,Abruzzo,1304970,60961,4.67,0.88
1559,2021-02-03,ABR,2061,717,1344,419,1642,ITF,ITF1,13,Abruzzo,Abruzzo,1304970,63022,4.83,0.16
1560,2021-02-28,ABR,1704,510,1194,1702,2,ITF,ITF1,13,Abruzzo,Abruzzo,1304970,64726,4.96,0.13
1561,2021-06-01,ABR,6911,3119,3792,4486,2425,ITF,ITF1,13,Abruzzo,Abruzzo,1304970,71637,5.49,0.53
1562,2021-04-12,ABR,6223,2949,3274,5049,1174,ITF,ITF1,13,Abruzzo,Abruzzo,1304970,77860,5.97,0.48
1563,2021-05-30,ABR,8563,4067,4496,5349,3214,ITF,ITF1,13,Abruzzo,Abruzzo,1304970,86423,6.62,0.66
1564,2021-04-03,ABR,5085,2221,2864,3489,1596,ITF,ITF1,13,Abruzzo,Abruzzo,1304970,91508,7.01,0.39
1565,2021-02-12,ABR,1228,567,661,1039,189,ITF,ITF1,13,Abruzzo,Abruzzo,1304970,92736,7.11,0.09
1566,2021-05-23,ABR,9886,4701,5185,7191,2695,ITF,ITF1,13,Abruzzo,Abruzzo,1304970,102622,7.86,0.76
1567,2021-04-10,ABR,8772,4057,4715,6264,2508,ITF,ITF1,13,Abruzzo,Abruzzo,1304970,111394,8.54,0.67
1568,2021-04-17,ABR,7346,3398,3948,4293,3053,ITF,ITF1,13,Abruzzo,Abruzzo,1304970,118740,9.1,0.56
1569,2021-02-19,ABR,3300,1551,1749,3200,100,ITF,ITF1,13,Abruzzo,Abruzzo,1304970,122040,9.35,0.25
1570,2021-01-07,ABR,1603,552,1051,1603,0,ITF,ITF1,13,Abruzzo,Abruzzo,1304970,123643,9.47,0.12
1571,2021-05-16,ABR,9581,4140,5441,5765,3816,ITF,ITF1,13,Abruzzo,Abruzzo,1304970,133224,10.21,0.73
1572,2021-02-24,ABR,3305,1441,1864,3129,176,ITF,ITF1,13,Abruzzo,Abruzzo,1304970,136529,10.46,0.25
1573,2021-02-07,ABR,777,307,470,201,576,ITF,ITF1,13,Abruzzo,Abruzzo,1304970,137306,10.52,0.06
1574,2021-01-21,ABR,157,47,110,157,0,ITF,ITF1,13,Abruzzo,Abruzzo,1304970,137463,10.53,0.01
1575,2021-05-20,ABR,12548,5786,6762,7330,5218,ITF,ITF1,13,Abruzzo,Abruzzo,1304970,150011,11.5,0.96
1576,2021-01-10,ABR,1139,409,730,1139,0,ITF,ITF1,13,Abruzzo,Abruzzo,1304970,151150,11.58,0.09
1577,2021-01-15,ABR,379,149,230,379,0,ITF,ITF1,13,Abruzzo,Abruzzo,1304970,151529,11.61,0.03
1578,2021-04-27,ABR,9086,4371,4715,6618,2468,ITF,ITF1,13,Abruzzo,Abruzzo,1304970,160615,12.31,0.7
1579,2021-03-15,ABR,3627,1392,2235,1819,1808,ITF,ITF1,13,Abruzzo,Abruzzo,1304970,164242,12.59,0.28
1580,2021-03-24,ABR,6386,2785,3601,4134,2252,ITF,ITF1,13,Abruzzo,Abruzzo,1304970,170628,13.08,0.49
1581,2021-02-09,ABR,908,311,597,499,409,ITF,ITF1,13,Abruzzo,Abruzzo,1304970,171536,13.14,0.07
1582,2021-02-10,ABR,947,312,635,503,444,ITF,ITF1,13,Abruzzo,Abruzzo,1304970,172483,13.22,0.07
1583,2021-01-02,ABR,548,218,330,548,0,ITF,ITF1,13,Abruzzo,Abruzzo,1304970,173031,13.26,0.04
1584,2021-04-26,ABR,8563,4066,4497,7349,1214,ITF,ITF1,13,Abruzzo,Abruzzo,1304970,181594,13.92,0.66
1585,2021-04-19,ABR,6225,2856,3369,3854,2371,ITF,ITF1,13,Abruzzo,Abruzzo,1304970,187819,14.39,0.48
1586,2021-02-21,ABR,1218,550,668,1217,1,ITF,ITF1,13,Abruzzo,Abruzzo,1304970,189037,14.49,0.09
1587,2021-01-03,ABR,471,185,286,471,0,ITF,ITF1,13,Abruzzo,Abruzzo,1304970,189508,14.52,0.04
1588,2021-01-05,ABR,1614,604,1010,1614,0,ITF,ITF1,13,Abruzzo,Abruzzo,1304970,191122,14.65,0.12
1589,2021-04-15,ABR,7817,3678,4139,5977,1840,ITF,ITF1,13,Abruzzo,Abruzzo,1304970,198939,15.24,0.6
1590,2021-03-29,ABR,5624,2524,3100,2985,2639,ITF,ITF1,13,Abruzzo,Abruzzo,1304970,204563,15.68,0.43
1591,2021-02-22,ABR,2643,1173,1470,2613,30,ITF,ITF1,13,Abruzzo,Abruzzo,1304970,207206,15.88,0.2
1592,2021-02-05,ABR,1534,521,1013,788,746,ITF,ITF1,13,Abruzzo,Abruzzo,1304970,208740,16.0,0.12
1593,2021-05-18,ABR,12120,5663,6457,7737,4383,ITF,ITF1,13,Abruzzo,Abruzzo,1304970,220860,16.92,0.93
1594,2021-01-19,ABR,111,55,56,91,20,ITF,ITF1,13,Abruzzo,Abruzzo,1304970,220971,16.93,0.01
1595,2021-05-01,ABR,10746,5053,5693,5772,4974,ITF,ITF1,13,Abruzzo,Abruzzo,1304970,231717,17.76,0.82
1596,2021-05-04,ABR,10698,5033,5665,7081,3617,ITF,ITF1,13,Abruzzo,Abruzzo,1304970,242415,18.58,0.82
1597,2021-03-08,ABR,5122,1666,3456,4150,972,ITF,ITF1,13,Abruzzo,Abruzzo,1304970,247537,18.97,0.39
1598,2021-01-24,ABR,50,22,28,6,44,ITF,ITF1,13,Abruzzo,Abruzzo,1304970,247587,18.97,0.0
1599,2021-03-01,ABR,3477,1384,2093,2725,752,ITF,ITF1,13,Abruzzo,Abruzzo,1304970,251064,19.24,0.27
1600,2021-02-02,ABR,1778,672,1106,222,1556,ITF,ITF1,13,Abruzzo,Abruzzo,1304970,252842,19.38,0.14
1601,2021-05-13,ABR,11149,5042,6107,7188,3961,ITF,ITF1,13,Abruzzo,Abruzzo,1304970,263991,20.23,0.85
1602,2021-03-31,ABR,6649,2880,3769,4581,2068,ITF,ITF1,13,Abruzzo,Abruzzo,1304970,270640,20.74,0.51
1603,2021-03-10,ABR,4957,1645,3312,4002,955,ITF,ITF1,13,Abruzzo,Abruzzo,1304970,275597,21.12,0.38
1604,2021-01-26,ABR,1542,567,975,30,1512,ITF,ITF1,13,Abruzzo,Abruzzo,1304970,277139,21.24,0.12
1605,2021-05-06,ABR,13066,6125,6941,8008,5058,ITF,ITF1,13,Abruzzo,Abruzzo,1304970,290205,22.24,1.0
1606,2021-02-25,ABR,3042,1330,1712,2514,528,ITF,ITF1,13,Abruzzo,Abruzzo,1304970,293247,22.47,0.23
1607,2021-05-17,ABR,11025,5039,5986,6166,4859,ITF,ITF1,13,Abruzzo,Abruzzo,1304970,304272,23.32,0.84
1608,2021-02-06,ABR,1610,742,868,602,1008,ITF,ITF1,13,Abruzzo,Abruzzo,1304970,305882,23.44,0.12
1609,2021-04-30,ABR,12392,5803,6589,6702,5690,ITF,ITF1,13,Abruzzo,Abruzzo,1304970,318274,24.39,0.95
1610,2021-01-20,ABR,447,156,291,445,2,ITF,ITF1,13,Abruzzo,Abruzzo,1304970,318721,24.42,0.03
1611,2021-05-02,ABR,10423,5087,5336,5213,5210,ITF,ITF1,13,Abruzzo,Abruzzo,1304970,329144,25.22,0.8
1612,2021-03-20,ABR,4787,2197,2590,2618,2169,ITF,ITF1,13,Abruzzo,Abruzzo,1304970,333931,25.59,0.37
1613,2021-01-29,ABR,1387,449,938,74,1313,ITF,ITF1,13,Abruzzo,Abruzzo,1304970,335318,25.7,0.11
1614,2021-03-19,ABR,5794,2584,3210,2774,3020,ITF,ITF1,13,Abruzzo,Abruzzo,1304970,341112,26.14,0.44
1615,2021-03-05,ABR,5345,1956,3389,4648,697,ITF,ITF1,13,Abruzzo,Abruzzo,1304970,346457,26.55,0.41
1616,2021-05-08,ABR,10303,4877,5426,6468,3835,ITF,ITF1,13,Abruzzo,Abruzzo,1304970,356760,27.34,0.79
1617,2021-04-24,ABR,8710,3970,4740,7179,1531,ITF,ITF1,13,Abruzzo,Abruzzo,1304970,365470,28.01,0.67
1618,2021-01-14,ABR,530,189,341,530,0,ITF,ITF1,13,Abruzzo,Abruzzo,1304970,366000,28.05,0.04
1619,2021-01-30,ABR,1510,567,943,69,1441,ITF,ITF1,13,Abruzzo,Abruzzo,1304970,367510,28.16,0.12
1620,2021-03-21,ABR,2134,913,1221,843,1291,ITF,ITF1,13,Abruzzo,Abruzzo,1304970,369644,28.33,0.16
1621,2021-01-13,ABR,1253,440,813,1253,0,ITF,ITF1,13,Abruzzo,Abruzzo,1304970,370897,28.42,0.1
1622,2021-03-04,ABR,5935,2359,3576,5013,922,ITF,ITF1,13,Abruzzo,Abruzzo,1304970,376832,28.88,0.45
1623,2021-03-03,ABR,4621,1879,2742,3715,906,ITF,ITF1,13,Abruzzo,Abruzzo,1304970,381453,29.23,0.35
1624,2021-04-22,ABR,6662,3193,3469,4981,1681,ITF,ITF1,13,Abruzzo,Abruzzo,1304970,388115,29.74,0.51
1625,2021-02-17,ABR,2071,948,1123,1789,282,ITF,ITF1,13,Abruzzo,Abruzzo,1304970,390186,29.9,0.16
1626,2021-04-05,ABR,2693,1147,1546,1813,880,ITF,ITF1,13,Abruzzo,Abruzzo,1304970,392879,30.11,0.21
1627,2021-01-31,ABR,1501,487,1014,286,1215,ITF,ITF1,13,Abruzzo,Abruzzo,1304970,394380,30.22,0.12
1628,2021-04-09,ABR,8791,4139,4652,6252,2539,ITF,ITF1,13,Abruzzo,Abruzzo,1304970,403171,30.9,0.67
1629,2021-04-02,ABR,6684,3093,3591,5197,1487,ITF,ITF1,13,Abruzzo,Abruzzo,1304970,409855,31.41,0.51
1630,2021-02-04,ABR,1679,615,1064,609,1070,ITF,ITF1,13,Abruzzo,Abruzzo,1304970,411534,31.54,0.13
1631,2021-04-04,ABR,1630,767,863,1501,129,ITF,ITF1,13,Abruzzo,Abruzzo,1304970,413164,31.66,0.12
1632,2021-02-27,ABR,2811,1338,1473,2546,265,ITF,ITF1,13,Abruzzo,Abruzzo,1304970,415975,31.88,0.22
1633,2021-04-11,ABR,5330,2606,2724,4847,483,ITF,ITF1,13,Abruzzo,Abruzzo,1304970,421305,32.28,0.41
1634,2021-04-29,ABR,12669,5850,6819,9574,3095,ITF,ITF1,13,Abruzzo,Abruzzo,1304970,433974,33.26,0.97
1635,2021-01-17,ABR,187,59,128,180,7,ITF,ITF1,13,Abruzzo,Abruzzo,1304970,434161,33.27,0.01
1636,2021-03-17,ABR,4539,1873,2666,2799,1740,ITF,ITF1,13,Abruzzo,Abruzzo,1304970,438700,33.62,0.35
1637,2021-01-16,ABR,928,428,500,928,0,ITF,ITF1,13,Abruzzo,Abruzzo,1304970,439628,33.69,0.07
1638,2021-01-09,ABR,1483,565,918,1483,0,ITF,ITF1,13,Abruzzo,Abruzzo,1304970,441111,33.8,0.11
1639,2021-05-07,ABR,12192,5700,6492,7762,4430,ITF,ITF1,13,Abruzzo,Abruzzo,1304970,453303,34.74,0.93
1640,2021-03-25,ABR,5686,2561,3125,3070,2616,ITF,ITF1,13,Abruzzo,Abruzzo,1304970,458989,35.17,0.44
1641,2021-05-21,ABR,13004,6328,6676,8028,4976,ITF,ITF1,13,Abruzzo,Abruzzo,1304970,471993,36.17,1.0
1642,2021-03-18,ABR,3896,1651,2245,2065,1831,ITF,ITF1,13,Abruzzo,Abruzzo,1304970,475889,36.47,0.3
1643,2021-02-26,ABR,3914,1670,2244,2946,968,ITF,ITF1,13,Abruzzo,Abruzzo,1304970,479803,36.77,0.3
1644,2021-01-04,ABR,1401,575,826,1401,0,ITF,ITF1,13,Abruzzo,Abruzzo,1304970,481204,36.87,0.11
1645,2021-05-03,ABR,11110,5241,5869,7260,3850,ITF,ITF1,13,Abruzzo,Abruzzo,1304970,492314,37.73,0.85
1646,2021-04-16,ABR,7535,3488,4047,5618,1917,ITF,ITF1,13,Abruzzo,Abruzzo,1304970,499849,38.3,0.58
1647,2021-03-13,ABR,4126,1420,2706,3083,1043,ITF,ITF1,13,Abruzzo,Abruzzo,1304970,503975,38.62,0.32
1648,2021-03-30,ABR,5056,2197,2859,3232,1824,ITF,ITF1,13,Abruzzo,Abruzzo,1304970,509031,39.01,0.39
1649,2021-05-28,ABR,13971,6279,7692,7618,6353,ITF,ITF1,13,Abruzzo,Abruzzo,1304970,523002,40.08,1.07
1650,2021-02-18,ABR,2288,933,1355,2158,130,ITF,ITF1,13,Abruzzo,Abruzzo,1304970,525290,40.25,0.18
1651,2021-05-22,ABR,13069,6351,6718,8168,4901,ITF,ITF1,13,Abruzzo,Abruzzo,1304970,538359,41.25,1.0
1652,2021-05-31,ABR,11221,5045,6176,6910,4311,ITF,ITF1,13,Abruzzo,Abruzzo,1304970,549580,42.11,0.86
1653,2021-04-18,ABR,5811,2726,3085,4869,942,ITF,ITF1,13,Abruzzo,Abruzzo,1304970,555391,42.56,0.45
1654,2021-03-07,ABR,2520,629,1891,2520,0,ITF,ITF1,13,Abruzzo,Abruzzo,1304970,557911,42.75,0.19
1655,2021-01-27,ABR,1364,515,849,39,1325,ITF,ITF1,13,Abruzzo,Abruzzo,1304970,559275,42.86,0.1
1656,2021-01-28,ABR,1433,495,938,12,1421,ITF,ITF1,13,Abruzzo,Abruzzo,1304970,560708,42.97,0.11
1657,2021-05-09,ABR,9153,4089,5064,4283,4870,ITF,ITF1,13,Abruzzo,Abruzzo,1304970,569861,43.67,0.7
1658,2021-01-18,ABR,122,48,74,46,76,ITF,ITF1,13,Abruzzo,Abruzzo,1304970,569983,43.68,0.01
1659,2021-04-28,ABR,9510,4585,4925,7486,2024,ITF,ITF1,13,Abruzzo,Abruzzo,1304970,579493,44.41,0.73
1660,2021-05-12,ABR,9616,4586,5030,6046,3570,ITF,ITF1,13,Abruzzo,Abruzzo,1304970,589109,45.14,0.74
1661,2021-03-16,ABR,3484,1452,2032,1830,1654,ITF,ITF1,13,Abruzzo,Abruzzo,1304970,592593,45.41,0.27
1662,2021-05-05,ABR,11581,5546,6035,6451,5130,ITF,ITF1,13,Abruzzo,Abruzzo,1304970,604174,46.3,0.89
1663,2021-03-09,ABR,5168,1795,3373,4229,939,ITF,ITF1,13,Abruzzo,Abruzzo,1304970,609342,46.69,0.4
1664,2021-03-06,ABR,4176,1357,2819,3606,570,ITF,ITF1,13,Abruzzo,Abruzzo,1304970,613518,47.01,0.32
1665,2021-02-23,ABR,2782,1275,1507,2771,11,ITF,ITF1,13,Abruzzo,Abruzzo,1304970,616300,47.23,0.21
1666,2021-02-08,ABR,1197,396,801,487,710,ITF,ITF1,13,Abruzzo,Abruzzo,1304970,617497,47.32,0.09
1667,2021-05-19,ABR,10693,5109,5584,7654,3039,ITF,ITF1,13,Abruzzo,Abruzzo,1304970,628190,48.14,0.82
1668,2021-04-13,ABR,5879,2752,3127,4679,1200,ITF,ITF1,13,Abruzzo,Abruzzo,1304970,634069,48.59,0.45
1669,2021-03-28,ABR,2415,1017,1398,2044,371,ITF,ITF1,13,Abruzzo,Abruzzo,1304970,636484,48.77,0.19
1670,2021-04-14,ABR,6502,2896,3606,4423,2079,ITF,ITF1,13,Abruzzo,Abruzzo,1304970,642986,49.27,0.5
1671,2021-01-23,ABR,263,114,149,57,206,ITF,ITF1,13,Abruzzo,Abruzzo,1304970,643249,49.29,0.02
1672,2021-03-11,ABR,5453,2193,3260,4314,1139,ITF,ITF1,13,Abruzzo,Abruzzo,1304970,648702,49.71,0.42
1673,2021-01-06,ABR,1830,664,1166,1830,0,ITF,ITF1,13,Abruzzo,Abruzzo,1304970,650532,49.85,0.14
1674,2021-02-11,ABR,816,262,554,773,43,ITF,ITF1,13,Abruzzo,Abruzzo,1304970,651348,49.91,0.06
1675,2021-05-24,ABR,12184,5787,6397,8878,3306,ITF,ITF1,13,Abruzzo,Abruzzo,1304970,663532,50.85,0.93
1676,2021-05-29,ABR,10180,4412,5768,4544,5636,ITF,ITF1,13,Abruzzo,Abruzzo,1304970,673712,51.63,0.78
1677,2021-03-26,ABR,5305,2263,3042,3231,2074,ITF,ITF1,13,Abruzzo,Abruzzo,1304970,679017,52.03,0.41
1678,2021-04-20,ABR,5589,2689,2900,4179,1410,ITF,ITF1,13,Abruzzo,Abruzzo,1304970,684606,52.46,0.43
1679,2021-04-25,ABR,9067,4621,4446,8257,810,ITF,ITF1,13,Abruzzo,Abruzzo,1304970,693673,53.16,0.69
1680,2021-01-08,ABR,1525,507,1018,1525,0,ITF,ITF1,13,Abruzzo,Abruzzo,1304970,695198,53.27,0.12
1681,2021-02-01,ABR,1632,573,1059,271,1361,ITF,ITF1,13,Abruzzo,Abruzzo,1304970,696830,53.4,0.13
1682,2021-03-23,ABR,4782,2143,2639,2216,2566,ITF,ITF1,13,Abruzzo,Abruzzo,1304970,701612,53.76,0.37
1683,2021-01-25,ABR,1603,632,971,19,1584,ITF,ITF1,13,Abruzzo,Abruzzo,1304970,703215,53.89,0.12
1684,2021-05-10,ABR,10107,4784,5323,5456,4651,ITF,ITF1,13,Abruzzo,Abruzzo,1304970,713322,54.66,0.77
1685,2021-04-23,ABR,7369,3382,3987,5067,2302,ITF,ITF1,13,Abruzzo,Abruzzo,1304970,720691,55.23,0.56
1686,2021-02-13,ABR,849,383,466,437,412,ITF,ITF1,13,Abruzzo,Abruzzo,1304970,721540,55.29,0.07
1687,2021-05-14,ABR,10601,5076,5525,5443,5158,ITF,ITF1,13,Abruzzo,Abruzzo,1304970,732141,56.1,0.81
1688,2021-04-01,ABR,5521,2442,3079,3434,2087,ITF,ITF1,13,Abruzzo,Abruzzo,1304970,737662,56.53,0.42
1689,2021-02-20,ABR,4777,1842,2935,4701,76,ITF,ITF1,13,Abruzzo,Abruzzo,1304970,742439,56.89,0.37
1690,2020-12-27,ABR,37,19,18,37,0,ITF,ITF1,13,Abruzzo,Abruzzo,1304970,742476,56.9,0.0
1691,2021-05-27,ABR,12930,5877,7053,8241,4689,ITF,ITF1,13,Abruzzo,Abruzzo,1304970,755406,57.89,0.99
1692,2021-04-07,ABR,7129,3282,3847,4404,2725,ITF,ITF1,13,Abruzzo,Abruzzo,1304970,762535,58.43,0.55
1693,2021-02-16,ABR,1918,842,1076,1906,12,ITF,ITF1,13,Abruzzo,Abruzzo,1304970,764453,58.58,0.15
1694,2021-03-02,ABR,3963,1676,2287,3279,684,ITF,ITF1,13,Abruzzo,Abruzzo,1304970,768416,58.88,0.3
1695,2021-01-11,ABR,1551,557,994,1551,0,ITF,ITF1,13,Abruzzo,Abruzzo,1304970,769967,59.0,0.12
1696,2021-04-21,ABR,6384,3100,3284,4710,1674,ITF,ITF1,13,Abruzzo,Abruzzo,1304970,776351,59.49,0.49
1697,2021-04-06,ABR,7681,3581,4100,5362,2319,ITF,ITF1,13,Abruzzo,Abruzzo,1304970,784032,60.08,0.59
1698,2021-02-15,ABR,1794,831,963,1752,42,ITF,ITF1,13,Abruzzo,Abruzzo,1304970,785826,60.22,0.14
1699,2021-05-26,ABR,13308,5905,7403,8381,4927,ITF,ITF1,13,Abruzzo,Abruzzo,1304970,799134,61.24,1.02
1700,2021-04-23,PIE,27434,12597,14837,20672,6762,ITC,ITC1,1,Piemonte,Piemonte,4356406,27434,0.63,0.63
1701,2021-03-18,PIE,11756,4803,6953,4029,7727,ITC,ITC1,1,Piemonte,Piemonte,4356406,39190,0.9,0.27
1702,2021-03-03,PIE,12120,4644,7476,11301,819,ITC,ITC1,1,Piemonte,Piemonte,4356406,51310,1.18,0.28
1703,2021-03-28,PIE,16054,6899,9155,8433,7621,ITC,ITC1,1,Piemonte,Piemonte,4356406,67364,1.55,0.37
1704,2021-01-18,PIE,6166,2048,4118,5917,249,ITC,ITC1,1,Piemonte,Piemonte,4356406,73530,1.69,0.14
1705,2021-05-17,PIE,30612,14371,16241,17674,12938,ITC,ITC1,1,Piemonte,Piemonte,4356406,104142,2.39,0.7
1706,2021-05-31,PIE,28701,13798,14903,20403,8298,ITC,ITC1,1,Piemonte,Piemonte,4356406,132843,3.05,0.66
1707,2021-01-01,PIE,1038,395,643,1038,0,ITC,ITC1,1,Piemonte,Piemonte,4356406,133881,3.07,0.02
1708,2021-05-21,PIE,35827,16604,19223,20345,15482,ITC,ITC1,1,Piemonte,Piemonte,4356406,169708,3.9,0.82
1709,2020-12-28,PIE,1,1,0,1,0,ITC,ITC1,1,Piemonte,Piemonte,4356406,169709,3.9,0.0
1710,2021-01-15,PIE,9113,3011,6102,9113,0,ITC,ITC1,1,Piemonte,Piemonte,4356406,178822,4.1,0.21
1711,2021-04-18,PIE,22951,10817,12134,20197,2754,ITC,ITC1,1,Piemonte,Piemonte,4356406,201773,4.63,0.53
1712,2021-02-11,PIE,6764,2107,4657,3006,3758,ITC,ITC1,1,Piemonte,Piemonte,4356406,208537,4.79,0.16
1713,2021-04-09,PIE,25847,11387,14460,21338,4509,ITC,ITC1,1,Piemonte,Piemonte,4356406,234384,5.38,0.59
1714,2020-12-30,PIE,730,322,408,730,0,ITC,ITC1,1,Piemonte,Piemonte,4356406,235114,5.4,0.02
1715,2021-02-25,PIE,12218,5252,6966,11671,547,ITC,ITC1,1,Piemonte,Piemonte,4356406,247332,5.68,0.28
1716,2021-04-02,PIE,20130,8298,11832,11703,8427,ITC,ITC1,1,Piemonte,Piemonte,4356406,267462,6.14,0.46
1717,2021-05-29,PIE,32594,15137,17457,20472,12122,ITC,ITC1,1,Piemonte,Piemonte,4356406,300056,6.89,0.75
1718,2021-02-18,PIE,4790,2093,2697,4360,430,ITC,ITC1,1,Piemonte,Piemonte,4356406,304846,7.0,0.11
1719,2021-04-16,PIE,28386,13205,15181,23403,4983,ITC,ITC1,1,Piemonte,Piemonte,4356406,333232,7.65,0.65
1720,2021-01-13,PIE,10080,3223,6857,10080,0,ITC,ITC1,1,Piemonte,Piemonte,4356406,343312,7.88,0.23
1721,2021-03-02,PIE,11202,4506,6696,10386,816,ITC,ITC1,1,Piemonte,Piemonte,4356406,354514,8.14,0.26
1722,2021-01-27,PIE,4196,1453,2743,999,3197,ITC,ITC1,1,Piemonte,Piemonte,4356406,358710,8.23,0.1
1723,2021-02-13,PIE,4153,1334,2819,2931,1222,ITC,ITC1,1,Piemonte,Piemonte,4356406,362863,8.33,0.1
1724,2021-05-09,PIE,27049,12897,14152,13442,13607,ITC,ITC1,1,Piemonte,Piemonte,4356406,389912,8.95,0.62
1725,2021-05-26,PIE,32123,14654,17469,15561,16562,ITC,ITC1,1,Piemonte,Piemonte,4356406,422035,9.69,0.74
1726,2021-01-16,PIE,7771,2630,5141,7771,0,ITC,ITC1,1,Piemonte,Piemonte,4356406,429806,9.87,0.18
1727,2021-03-21,PIE,10723,4738,5985,4189,6534,ITC,ITC1,1,Piemonte,Piemonte,4356406,440529,10.11,0.25
1728,2021-03-30,PIE,16891,7033,9858,9020,7871,ITC,ITC1,1,Piemonte,Piemonte,4356406,457420,10.5,0.39
1729,2021-05-28,PIE,34539,16244,18295,18907,15632,ITC,ITC1,1,Piemonte,Piemonte,4356406,491959,11.29,0.79
1730,2021-01-25,PIE,6215,1938,4277,983,5232,ITC,ITC1,1,Piemonte,Piemonte,4356406,498174,11.44,0.14
1731,2021-05-02,PIE,25044,11262,13782,14299,10745,ITC,ITC1,1,Piemonte,Piemonte,4356406,523218,12.01,0.57
1732,2021-02-27,PIE,12691,4851,7840,12346,345,ITC,ITC1,1,Piemonte,Piemonte,4356406,535909,12.3,0.29
1733,2021-04-25,PIE,20223,9303,10920,17722,2501,ITC,ITC1,1,Piemonte,Piemonte,4356406,556132,12.77,0.46
1734,2021-03-13,PIE,13044,4720,8324,11600,1444,ITC,ITC1,1,Piemonte,Piemonte,4356406,569176,13.07,0.3
1735,2021-01-08,PIE,5531,1761,3770,5531,0,ITC,ITC1,1,Piemonte,Piemonte,4356406,574707,13.19,0.13
1736,2021-04-04,PIE,9254,4059,5195,6541,2713,ITC,ITC1,1,Piemonte,Piemonte,4356406,583961,13.4,0.21
1737,2021-04-21,PIE,25728,11825,13903,20395,5333,ITC,ITC1,1,Piemonte,Piemonte,4356406,609689,14.0,0.59
1738,2021-01-11,PIE,8744,2980,5764,8744,0,ITC,ITC1,1,Piemonte,Piemonte,4356406,618433,14.2,0.2
1739,2021-04-06,PIE,20239,8809,11430,15043,5196,ITC,ITC1,1,Piemonte,Piemonte,4356406,638672,14.66,0.46
1740,2020-12-27,PIE,913,369,544,913,0,ITC,ITC1,1,Piemonte,Piemonte,4356406,639585,14.68,0.02
1741,2021-05-24,PIE,28549,13078,15471,16974,11575,ITC,ITC1,1,Piemonte,Piemonte,4356406,668134,15.34,0.66
1742,2021-04-20,PIE,25453,11655,13798,19109,6344,ITC,ITC1,1,Piemonte,Piemonte,4356406,693587,15.92,0.58
1743,2021-05-07,PIE,32943,15548,17395,18900,14043,ITC,ITC1,1,Piemonte,Piemonte,4356406,726530,16.68,0.76
1744,2021-02-15,PIE,4432,1597,2835,3227,1205,ITC,ITC1,1,Piemonte,Piemonte,4356406,730962,16.78,0.1
1745,2021-03-04,PIE,14495,5734,8761,11547,2948,ITC,ITC1,1,Piemonte,Piemonte,4356406,745457,17.11,0.33
1746,2021-05-19,PIE,32864,15115,17749,21948,10916,ITC,ITC1,1,Piemonte,Piemonte,4356406,778321,17.87,0.75
1747,2021-03-14,PIE,8204,3335,4869,5308,2896,ITC,ITC1,1,Piemonte,Piemonte,4356406,786525,18.05,0.19
1748,2021-05-10,PIE,28664,13736,14928,15650,13014,ITC,ITC1,1,Piemonte,Piemonte,4356406,815189,18.71,0.66
1749,2021-01-30,PIE,5980,2136,3844,218,5762,ITC,ITC1,1,Piemonte,Piemonte,4356406,821169,18.85,0.14
1750,2021-03-16,PIE,10520,4268,6252,4463,6057,ITC,ITC1,1,Piemonte,Piemonte,4356406,831689,19.09,0.24
1751,2021-05-12,PIE,31692,15064,16628,18933,12759,ITC,ITC1,1,Piemonte,Piemonte,4356406,863381,19.82,0.73
1752,2021-02-08,PIE,6916,2355,4561,666,6250,ITC,ITC1,1,Piemonte,Piemonte,4356406,870297,19.98,0.16
1753,2021-02-01,PIE,8645,3055,5590,579,8066,ITC,ITC1,1,Piemonte,Piemonte,4356406,878942,20.18,0.2
1754,2021-03-20,PIE,11921,4898,7023,6023,5898,ITC,ITC1,1,Piemonte,Piemonte,4356406,890863,20.45,0.27
1755,2021-05-06,PIE,33217,15629,17588,19759,13458,ITC,ITC1,1,Piemonte,Piemonte,4356406,924080,21.21,0.76
1756,2021-05-23,PIE,28673,13122,15551,15748,12925,ITC,ITC1,1,Piemonte,Piemonte,4356406,952753,21.87,0.66
1757,2021-02-12,PIE,6891,2215,4676,3930,2961,ITC,ITC1,1,Piemonte,Piemonte,4356406,959644,22.03,0.16
1758,2021-01-26,PIE,6331,1879,4452,735,5596,ITC,ITC1,1,Piemonte,Piemonte,4356406,965975,22.17,0.15
1759,2021-05-08,PIE,34113,16182,17931,18487,15626,ITC,ITC1,1,Piemonte,Piemonte,4356406,1000088,22.96,0.78
1760,2021-01-28,PIE,5591,1809,3782,384,5207,ITC,ITC1,1,Piemonte,Piemonte,4356406,1005679,23.09,0.13
1761,2021-02-04,PIE,10203,3339,6864,588,9615,ITC,ITC1,1,Piemonte,Piemonte,4356406,1015882,23.32,0.23
1762,2021-04-30,PIE,31754,14261,17493,18428,13326,ITC,ITC1,1,Piemonte,Piemonte,4356406,1047636,24.05,0.73
1763,2021-03-11,PIE,13772,5075,8697,10675,3097,ITC,ITC1,1,Piemonte,Piemonte,4356406,1061408,24.36,0.32
1764,2021-03-25,PIE,17062,7203,9859,8423,8639,ITC,ITC1,1,Piemonte,Piemonte,4356406,1078470,24.76,0.39
1765,2021-01-20,PIE,6616,2089,4527,5899,717,ITC,ITC1,1,Piemonte,Piemonte,4356406,1085086,24.91,0.15
1766,2021-02-03,PIE,10199,3303,6896,611,9588,ITC,ITC1,1,Piemonte,Piemonte,4356406,1095285,25.14,0.23
1767,2021-02-05,PIE,9601,3138,6463,659,8942,ITC,ITC1,1,Piemonte,Piemonte,4356406,1104886,25.36,0.22
1768,2021-03-10,PIE,13634,5169,8465,11340,2294,ITC,ITC1,1,Piemonte,Piemonte,4356406,1118520,25.68,0.31
1769,2021-03-27,PIE,18384,7827,10557,9553,8831,ITC,ITC1,1,Piemonte,Piemonte,4356406,1136904,26.1,0.42
1770,2021-01-19,PIE,6466,2105,4361,6454,12,ITC,ITC1,1,Piemonte,Piemonte,4356406,1143370,26.25,0.15
1771,2021-04-14,PIE,27702,12558,15144,23181,4521,ITC,ITC1,1,Piemonte,Piemonte,4356406,1171072,26.88,0.64
1772,2021-04-11,PIE,20824,9317,11507,18663,2161,ITC,ITC1,1,Piemonte,Piemonte,4356406,1191896,27.36,0.48
1773,2021-01-04,PIE,5564,1679,3885,5564,0,ITC,ITC1,1,Piemonte,Piemonte,4356406,1197460,27.49,0.13
1774,2021-04-28,PIE,25986,11711,14275,15954,10032,ITC,ITC1,1,Piemonte,Piemonte,4356406,1223446,28.08,0.6
1775,2021-02-06,PIE,7995,2666,5329,400,7595,ITC,ITC1,1,Piemonte,Piemonte,4356406,1231441,28.27,0.18
1776,2021-02-23,PIE,9233,3713,5520,8653,580,ITC,ITC1,1,Piemonte,Piemonte,4356406,1240674,28.48,0.21
1777,2021-03-09,PIE,13964,5429,8535,11622,2342,ITC,ITC1,1,Piemonte,Piemonte,4356406,1254638,28.8,0.32
1778,2021-02-20,PIE,3833,1253,2580,3659,174,ITC,ITC1,1,Piemonte,Piemonte,4356406,1258471,28.89,0.09
1779,2021-05-14,PIE,33271,16190,17081,17913,15358,ITC,ITC1,1,Piemonte,Piemonte,4356406,1291742,29.65,0.76
1780,2021-04-17,PIE,30422,14130,16292,27109,3313,ITC,ITC1,1,Piemonte,Piemonte,4356406,1322164,30.35,0.7
1781,2021-02-10,PIE,7535,2371,5164,1316,6219,ITC,ITC1,1,Piemonte,Piemonte,4356406,1329699,30.52,0.17
1782,2021-04-08,PIE,25142,10929,14213,20412,4730,ITC,ITC1,1,Piemonte,Piemonte,4356406,1354841,31.1,0.58
1783,2021-04-10,PIE,30163,13416,16747,25884,4279,ITC,ITC1,1,Piemonte,Piemonte,4356406,1385004,31.79,0.69
1784,2021-04-15,PIE,29626,13569,16057,24150,5476,ITC,ITC1,1,Piemonte,Piemonte,4356406,1414630,32.47,0.68
1785,2021-01-05,PIE,5381,1603,3778,5381,0,ITC,ITC1,1,Piemonte,Piemonte,4356406,1420011,32.6,0.12
1786,2021-01-07,PIE,5387,1739,3648,5387,0,ITC,ITC1,1,Piemonte,Piemonte,4356406,1425398,32.72,0.12
1787,2021-03-05,PIE,15268,5961,9307,11451,3817,ITC,ITC1,1,Piemonte,Piemonte,4356406,1440666,33.07,0.35
1788,2021-03-23,PIE,13072,5447,7625,6828,6244,ITC,ITC1,1,Piemonte,Piemonte,4356406,1453738,33.37,0.3
1789,2021-01-23,PIE,4257,1325,2932,879,3378,ITC,ITC1,1,Piemonte,Piemonte,4356406,1457995,33.47,0.1
1790,2021-05-05,PIE,32121,15030,17091,19112,13009,ITC,ITC1,1,Piemonte,Piemonte,4356406,1490116,34.21,0.74
1791,2021-04-01,PIE,19329,8073,11256,11209,8120,ITC,ITC1,1,Piemonte,Piemonte,4356406,1509445,34.65,0.44
1792,2021-03-06,PIE,13994,5211,8783,11205,2789,ITC,ITC1,1,Piemonte,Piemonte,4356406,1523439,34.97,0.32
1793,2021-01-22,PIE,3867,1249,2618,2526,1341,ITC,ITC1,1,Piemonte,Piemonte,4356406,1527306,35.06,0.09
1794,2021-05-13,PIE,35377,17286,18091,20518,14859,ITC,ITC1,1,Piemonte,Piemonte,4356406,1562683,35.87,0.81
1795,2021-03-31,PIE,19106,8102,11004,10413,8693,ITC,ITC1,1,Piemonte,Piemonte,4356406,1581789,36.31,0.44
1796,2021-05-27,PIE,36885,17082,19803,19041,17844,ITC,ITC1,1,Piemonte,Piemonte,4356406,1618674,37.16,0.85
1797,2021-03-24,PIE,15505,6341,9164,6378,9127,ITC,ITC1,1,Piemonte,Piemonte,4356406,1634179,37.51,0.36
1798,2021-02-09,PIE,7392,2316,5076,722,6670,ITC,ITC1,1,Piemonte,Piemonte,4356406,1641571,37.68,0.17
1799,2021-01-06,PIE,3116,1111,2005,3116,0,ITC,ITC1,1,Piemonte,Piemonte,4356406,1644687,37.75,0.07
1800,2021-01-10,PIE,5214,2275,2939,5214,0,ITC,ITC1,1,Piemonte,Piemonte,4356406,1649901,37.87,0.12
1801,2021-04-22,PIE,27627,12711,14916,20931,6696,ITC,ITC1,1,Piemonte,Piemonte,4356406,1677528,38.51,0.63
1802,2021-03-19,PIE,11019,4511,6508,4414,6605,ITC,ITC1,1,Piemonte,Piemonte,4356406,1688547,38.76,0.25
1803,2021-04-05,PIE,14746,6233,8513,12189,2557,ITC,ITC1,1,Piemonte,Piemonte,4356406,1703293,39.1,0.34
1804,2021-02-19,PIE,5535,2175,3360,5034,501,ITC,ITC1,1,Piemonte,Piemonte,4356406,1708828,39.23,0.13
1805,2021-02-24,PIE,11409,4629,6780,10904,505,ITC,ITC1,1,Piemonte,Piemonte,4356406,1720237,39.49,0.26
1806,2021-05-03,PIE,26639,12157,14482,12507,14132,ITC,ITC1,1,Piemonte,Piemonte,4356406,1746876,40.1,0.61
1807,2021-04-24,PIE,27442,12418,15024,21803,5639,ITC,ITC1,1,Piemonte,Piemonte,4356406,1774318,40.73,0.63
1808,2021-02-02,PIE,10241,3509,6732,816,9425,ITC,ITC1,1,Piemonte,Piemonte,4356406,1784559,40.96,0.24
1809,2021-02-16,PIE,3967,1756,2211,3209,758,ITC,ITC1,1,Piemonte,Piemonte,4356406,1788526,41.06,0.09
1810,2021-05-20,PIE,38256,17695,20561,13544,24712,ITC,ITC1,1,Piemonte,Piemonte,4356406,1826782,41.93,0.88
1811,2021-04-07,PIE,23606,9995,13611,18142,5464,ITC,ITC1,1,Piemonte,Piemonte,4356406,1850388,42.48,0.54
1812,2021-05-01,PIE,28526,12993,15533,16728,11798,ITC,ITC1,1,Piemonte,Piemonte,4356406,1878914,43.13,0.65
1813,2021-01-21,PIE,6923,2318,4605,3427,3496,ITC,ITC1,1,Piemonte,Piemonte,4356406,1885837,43.29,0.16
1814,2021-05-15,PIE,33575,15661,17914,19960,13615,ITC,ITC1,1,Piemonte,Piemonte,4356406,1919412,44.06,0.77
1815,2021-03-12,PIE,13949,5184,8765,11014,2935,ITC,ITC1,1,Piemonte,Piemonte,4356406,1933361,44.38,0.32
1816,2021-03-08,PIE,13947,5294,8653,11233,2714,ITC,ITC1,1,Piemonte,Piemonte,4356406,1947308,44.7,0.32
1817,2021-05-04,PIE,28478,13072,15406,16395,12083,ITC,ITC1,1,Piemonte,Piemonte,4356406,1975786,45.35,0.65
1818,2021-01-24,PIE,3153,959,2194,434,2719,ITC,ITC1,1,Piemonte,Piemonte,4356406,1978939,45.43,0.07
1819,2021-03-22,PIE,11510,4880,6630,3904,7606,ITC,ITC1,1,Piemonte,Piemonte,4356406,1990449,45.69,0.26
1820,2021-04-27,PIE,22571,10203,12368,17436,5135,ITC,ITC1,1,Piemonte,Piemonte,4356406,2013020,46.21,0.52
1821,2021-01-17,PIE,3518,1168,2350,2870,648,ITC,ITC1,1,Piemonte,Piemonte,4356406,2016538,46.29,0.08
1822,2021-03-15,PIE,10658,4162,6496,5037,5621,ITC,ITC1,1,Piemonte,Piemonte,4356406,2027196,46.53,0.24
1823,2021-05-11,PIE,31971,15400,16571,18831,13140,ITC,ITC1,1,Piemonte,Piemonte,4356406,2059167,47.27,0.73
1824,2021-01-31,PIE,4113,1753,2360,112,4001,ITC,ITC1,1,Piemonte,Piemonte,4356406,2063280,47.36,0.09
1825,2021-02-07,PIE,3088,974,2114,445,2643,ITC,ITC1,1,Piemonte,Piemonte,4356406,2066368,47.43,0.07
1826,2020-12-31,PIE,3909,1334,2575,3909,0,ITC,ITC1,1,Piemonte,Piemonte,4356406,2070277,47.52,0.09
1827,2021-03-01,PIE,12041,4845,7196,11232,809,ITC,ITC1,1,Piemonte,Piemonte,4356406,2082318,47.8,0.28
1828,2021-05-25,PIE,30979,14356,16623,15940,15039,ITC,ITC1,1,Piemonte,Piemonte,4356406,2113297,48.51,0.71
1829,2021-04-19,PIE,22532,10762,11770,18168,4364,ITC,ITC1,1,Piemonte,Piemonte,4356406,2135829,49.03,0.52
1830,2021-01-09,PIE,6184,2185,3999,6184,0,ITC,ITC1,1,Piemonte,Piemonte,4356406,2142013,49.17,0.14
1831,2021-03-07,PIE,11976,4658,7318,11099,877,ITC,ITC1,1,Piemonte,Piemonte,4356406,2153989,49.44,0.27
1832,2021-04-03,PIE,19430,8156,11274,10883,8547,ITC,ITC1,1,Piemonte,Piemonte,4356406,2173419,49.89,0.45
1833,2021-01-12,PIE,10089,3415,6674,10089,0,ITC,ITC1,1,Piemonte,Piemonte,4356406,2183508,50.12,0.23
1834,2021-01-29,PIE,5943,1886,4057,455,5488,ITC,ITC1,1,Piemonte,Piemonte,4356406,2189451,50.26,0.14
1835,2021-02-28,PIE,10816,4060,6756,10576,240,ITC,ITC1,1,Piemonte,Piemonte,4356406,2200267,50.51,0.25
1836,2021-03-17,PIE,12518,5055,7463,5224,7294,ITC,ITC1,1,Piemonte,Piemonte,4356406,2212785,50.79,0.29
1837,2021-03-26,PIE,17748,6982,10766,8840,8908,ITC,ITC1,1,Piemonte,Piemonte,4356406,2230533,51.2,0.41
1838,2021-05-30,PIE,27684,13175,14509,18369,9315,ITC,ITC1,1,Piemonte,Piemonte,4356406,2258217,51.84,0.64
1839,2021-02-17,PIE,4793,2156,2637,3803,990,ITC,ITC1,1,Piemonte,Piemonte,4356406,2263010,51.95,0.11
1840,2021-04-26,PIE,19750,8731,11019,15351,4399,ITC,ITC1,1,Piemonte,Piemonte,4356406,2282760,52.4,0.45
1841,2021-02-26,PIE,12293,4933,7360,11556,737,ITC,ITC1,1,Piemonte,Piemonte,4356406,2295053,52.68,0.28
1842,2021-01-14,PIE,9766,3152,6614,9766,0,ITC,ITC1,1,Piemonte,Piemonte,4356406,2304819,52.91,0.22
1843,2021-02-14,PIE,1476,498,978,876,600,ITC,ITC1,1,Piemonte,Piemonte,4356406,2306295,52.94,0.03
1844,2021-04-29,PIE,48270,21837,26433,35668,12602,ITC,ITC1,1,Piemonte,Piemonte,4356406,2354565,54.05,1.11
1845,2021-05-16,PIE,28110,12762,15348,15054,13056,ITC,ITC1,1,Piemonte,Piemonte,4356406,2382675,54.69,0.65
1846,2021-05-22,PIE,33285,15035,18250,17176,16109,ITC,ITC1,1,Piemonte,Piemonte,4356406,2415960,55.46,0.76
1847,2021-02-22,PIE,8482,3472,5010,7892,590,ITC,ITC1,1,Piemonte,Piemonte,4356406,2424442,55.65,0.19
1848,2021-04-13,PIE,25929,11608,14321,22469,3460,ITC,ITC1,1,Piemonte,Piemonte,4356406,2450371,56.25,0.6
1849,2021-05-18,PIE,31762,14574,17188,19312,12450,ITC,ITC1,1,Piemonte,Piemonte,4356406,2482133,56.98,0.73
1850,2021-01-03,PIE,3063,967,2096,3063,0,ITC,ITC1,1,Piemonte,Piemonte,4356406,2485196,57.05,0.07
1851,2021-03-29,PIE,15161,6385,8776,8549,6612,ITC,ITC1,1,Piemonte,Piemonte,4356406,2500357,57.39,0.35
1852,2021-04-12,PIE,22923,10352,12571,19933,2990,ITC,ITC1,1,Piemonte,Piemonte,4356406,2523280,57.92,0.53
1853,2021-01-02,PIE,3545,1134,2411,3545,0,ITC,ITC1,1,Piemonte,Piemonte,4356406,2526825,58.0,0.08
1854,2021-06-01,PIE,23456,11746,11710,19746,3710,ITC,ITC1,1,Piemonte,Piemonte,4356406,2550281,58.54,0.54
1855,2021-02-21,PIE,5090,2083,3007,4988,102,ITC,ITC1,1,Piemonte,Piemonte,4356406,2555371,58.66,0.12
1856,2021-01-28,PAT,530,147,383,48,482,ITH,ITH2,4,Provincia Autonoma Trento,P.A. Trento,541380,530,0.1,0.1
1857,2021-04-23,PAT,3600,1749,1851,3546,54,ITH,ITH2,4,Provincia Autonoma Trento,P.A. Trento,541380,4130,0.76,0.66
1858,2021-03-18,PAT,2318,957,1361,1238,1080,ITH,ITH2,4,Provincia Autonoma Trento,P.A. Trento,541380,6448,1.19,0.43
1859,2021-01-13,PAT,421,123,298,421,0,ITH,ITH2,4,Provincia Autonoma Trento,P.A. Trento,541380,6869,1.27,0.08
1860,2021-05-17,PAT,4292,2121,2171,3942,350,ITH,ITH2,4,Provincia Autonoma Trento,P.A. Trento,541380,11161,2.06,0.79
1861,2021-04-14,PAT,3115,1464,1651,2379,736,ITH,ITH2,4,Provincia Autonoma Trento,P.A. Trento,541380,14276,2.64,0.58
1862,2021-03-28,PAT,748,292,456,746,2,ITH,ITH2,4,Provincia Autonoma Trento,P.A. Trento,541380,15024,2.78,0.14
1863,2021-01-18,PAT,643,154,489,588,55,ITH,ITH2,4,Provincia Autonoma Trento,P.A. Trento,541380,15667,2.89,0.12
1864,2021-05-14,PAT,5301,2535,2766,3931,1370,ITH,ITH2,4,Provincia Autonoma Trento,P.A. Trento,541380,20968,3.87,0.98
1865,2021-05-21,PAT,5023,2410,2613,3325,1698,ITH,ITH2,4,Provincia Autonoma Trento,P.A. Trento,541380,25991,4.8,0.93
1866,2021-05-31,PAT,4225,1965,2260,1462,2763,ITH,ITH2,4,Provincia Autonoma Trento,P.A. Trento,541380,30216,5.58,0.78
1867,2021-04-18,PAT,1855,845,1010,1846,9,ITH,ITH2,4,Provincia Autonoma Trento,P.A. Trento,541380,32071,5.92,0.34
1868,2021-03-06,PAT,783,277,506,632,151,ITH,ITH2,4,Provincia Autonoma Trento,P.A. Trento,541380,32854,6.07,0.14
1869,2021-01-01,PAT,213,50,163,213,0,ITH,ITH2,4,Provincia Autonoma Trento,P.A. Trento,541380,33067,6.11,0.04
1870,2021-04-09,PAT,2707,1144,1563,1508,1199,ITH,ITH2,4,Provincia Autonoma Trento,P.A. Trento,541380,35774,6.61,0.5
1871,2021-02-11,PAT,1132,365,767,796,336,ITH,ITH2,4,Provincia Autonoma Trento,P.A. Trento,541380,36906,6.82,0.21
1872,2021-02-25,PAT,1641,643,998,1200,441,ITH,ITH2,4,Provincia Autonoma Trento,P.A. Trento,541380,38547,7.12,0.3
1873,2020-12-30,PAT,7,3,4,7,0,ITH,ITH2,4,Provincia Autonoma Trento,P.A. Trento,541380,38554,7.12,0.0
1874,2021-05-22,PAT,3239,1589,1650,919,2320,ITH,ITH2,4,Provincia Autonoma Trento,P.A. Trento,541380,41793,7.72,0.6
1875,2021-05-29,PAT,2219,1156,1063,815,1404,ITH,ITH2,4,Provincia Autonoma Trento,P.A. Trento,541380,44012,8.13,0.41
1876,2021-04-02,PAT,2801,1146,1655,2126,675,ITH,ITH2,4,Provincia Autonoma Trento,P.A. Trento,541380,46813,8.65,0.52
1877,2021-04-16,PAT,2837,1344,1493,2692,145,ITH,ITH2,4,Provincia Autonoma Trento,P.A. Trento,541380,49650,9.17,0.52
1878,2021-02-18,PAT,1205,426,779,1143,62,ITH,ITH2,4,Provincia Autonoma Trento,P.A. Trento,541380,50855,9.39,0.22
1879,2021-01-06,PAT,42,13,29,42,0,ITH,ITH2,4,Provincia Autonoma Trento,P.A. Trento,541380,50897,9.4,0.01
1880,2021-03-02,PAT,1304,440,864,928,376,ITH,ITH2,4,Provincia Autonoma Trento,P.A. Trento,541380,52201,9.64,0.24
1881,2021-01-27,PAT,802,277,525,91,711,ITH,ITH2,4,Provincia Autonoma Trento,P.A. Trento,541380,53003,9.79,0.15
1882,2021-02-13,PAT,537,333,204,172,365,ITH,ITH2,4,Provincia Autonoma Trento,P.A. Trento,541380,53540,9.89,0.1
1883,2021-05-09,PAT,2322,1210,1112,1978,344,ITH,ITH2,4,Provincia Autonoma Trento,P.A. Trento,541380,55862,10.32,0.43
1884,2021-05-03,PAT,4235,2179,2056,4082,153,ITH,ITH2,4,Provincia Autonoma Trento,P.A. Trento,541380,60097,11.1,0.78
1885,2021-01-16,PAT,319,148,171,319,0,ITH,ITH2,4,Provincia Autonoma Trento,P.A. Trento,541380,60416,11.16,0.06
1886,2021-04-28,PAT,4241,1972,2269,4103,138,ITH,ITH2,4,Provincia Autonoma Trento,P.A. Trento,541380,64657,11.94,0.78
1887,2021-05-28,PAT,3348,1569,1779,1331,2017,ITH,ITH2,4,Provincia Autonoma Trento,P.A. Trento,541380,68005,12.56,0.62
1888,2021-01-25,PAT,817,215,602,23,794,ITH,ITH2,4,Provincia Autonoma Trento,P.A. Trento,541380,68822,12.71,0.15
1889,2021-03-25,PAT,2874,1103,1771,1824,1050,ITH,ITH2,4,Provincia Autonoma Trento,P.A. Trento,541380,71696,13.24,0.53
1890,2021-03-30,PAT,2387,973,1414,1750,637,ITH,ITH2,4,Provincia Autonoma Trento,P.A. Trento,541380,74083,13.68,0.44
1891,2021-02-20,PAT,407,245,162,123,284,ITH,ITH2,4,Provincia Autonoma Trento,P.A. Trento,541380,74490,13.76,0.08
1892,2021-01-08,PAT,1449,313,1136,1449,0,ITH,ITH2,4,Provincia Autonoma Trento,P.A. Trento,541380,75939,14.03,0.27
1893,2021-04-11,PAT,2340,1135,1205,2249,91,ITH,ITH2,4,Provincia Autonoma Trento,P.A. Trento,541380,78279,14.46,0.43
1894,2021-02-27,PAT,1029,457,572,608,421,ITH,ITH2,4,Provincia Autonoma Trento,P.A. Trento,541380,79308,14.65,0.19
1895,2021-04-25,PAT,1970,939,1031,1963,7,ITH,ITH2,4,Provincia Autonoma Trento,P.A. Trento,541380,81278,15.01,0.36
1896,2021-04-21,PAT,2893,1349,1544,2843,50,ITH,ITH2,4,Provincia Autonoma Trento,P.A. Trento,541380,84171,15.55,0.53
1897,2021-01-11,PAT,730,221,509,730,0,ITH,ITH2,4,Provincia Autonoma Trento,P.A. Trento,541380,84901,15.68,0.13
1898,2021-02-16,PAT,663,244,419,658,5,ITH,ITH2,4,Provincia Autonoma Trento,P.A. Trento,541380,85564,15.8,0.12
1899,2021-01-30,PAT,386,132,254,152,234,ITH,ITH2,4,Provincia Autonoma Trento,P.A. Trento,541380,85950,15.88,0.07
1900,2021-05-10,PAT,3205,1644,1561,2701,504,ITH,ITH2,4,Provincia Autonoma Trento,P.A. Trento,541380,89155,16.47,0.59
1901,2021-04-06,PAT,2258,949,1309,1493,765,ITH,ITH2,4,Provincia Autonoma Trento,P.A. Trento,541380,91413,16.89,0.42
1902,2021-03-21,PAT,129,69,60,129,0,ITH,ITH2,4,Provincia Autonoma Trento,P.A. Trento,541380,91542,16.91,0.02
1903,2021-05-24,PAT,4373,2007,2366,1341,3032,ITH,ITH2,4,Provincia Autonoma Trento,P.A. Trento,541380,95915,17.72,0.81
1904,2021-03-04,PAT,2358,793,1565,1580,778,ITH,ITH2,4,Provincia Autonoma Trento,P.A. Trento,541380,98273,18.15,0.44
1905,2021-05-07,PAT,5986,3079,2907,5148,838,ITH,ITH2,4,Provincia Autonoma Trento,P.A. Trento,541380,104259,19.26,1.11
1906,2021-04-20,PAT,2876,1375,1501,2839,37,ITH,ITH2,4,Provincia Autonoma Trento,P.A. Trento,541380,107135,19.79,0.53
1907,2021-03-09,PAT,1581,589,992,938,643,ITH,ITH2,4,Provincia Autonoma Trento,P.A. Trento,541380,108716,20.08,0.29
1908,2021-03-14,PAT,107,65,42,20,87,ITH,ITH2,4,Provincia Autonoma Trento,P.A. Trento,541380,108823,20.1,0.02
1909,2021-03-07,PAT,22,6,16,22,0,ITH,ITH2,4,Provincia Autonoma Trento,P.A. Trento,541380,108845,20.11,0.0
1910,2021-01-09,PAT,190,40,150,190,0,ITH,ITH2,4,Provincia Autonoma Trento,P.A. Trento,541380,109035,20.14,0.04
1911,2021-05-12,PAT,3297,1491,1806,2114,1183,ITH,ITH2,4,Provincia Autonoma Trento,P.A. Trento,541380,112332,20.75,0.61
1912,2021-03-16,PAT,1391,506,885,608,783,ITH,ITH2,4,Provincia Autonoma Trento,P.A. Trento,541380,113723,21.01,0.26
1913,2021-02-08,PAT,1151,318,833,342,809,ITH,ITH2,4,Provincia Autonoma Trento,P.A. Trento,541380,114874,21.22,0.21
1914,2021-02-01,PAT,1220,335,885,92,1128,ITH,ITH2,4,Provincia Autonoma Trento,P.A. Trento,541380,116094,21.44,0.23
1915,2021-02-12,PAT,1010,340,670,589,421,ITH,ITH2,4,Provincia Autonoma Trento,P.A. Trento,541380,117104,21.63,0.19
1916,2021-03-20,PAT,873,402,471,670,203,ITH,ITH2,4,Provincia Autonoma Trento,P.A. Trento,541380,117977,21.79,0.16
1917,2021-03-03,PAT,1656,622,1034,1139,517,ITH,ITH2,4,Provincia Autonoma Trento,P.A. Trento,541380,119633,22.1,0.31
1918,2021-05-08,PAT,3152,1721,1431,2734,418,ITH,ITH2,4,Provincia Autonoma Trento,P.A. Trento,541380,122785,22.68,0.58
1919,2021-03-26,PAT,3155,1226,1929,2556,599,ITH,ITH2,4,Provincia Autonoma Trento,P.A. Trento,541380,125940,23.26,0.58
1920,2021-02-04,PAT,974,304,670,421,553,ITH,ITH2,4,Provincia Autonoma Trento,P.A. Trento,541380,126914,23.44,0.18
1921,2021-01-20,PAT,291,73,218,279,12,ITH,ITH2,4,Provincia Autonoma Trento,P.A. Trento,541380,127205,23.5,0.05
1922,2021-04-30,PAT,4910,2396,2514,4765,145,ITH,ITH2,4,Provincia Autonoma Trento,P.A. Trento,541380,132115,24.4,0.91
1923,2021-03-11,PAT,2295,851,1444,1473,822,ITH,ITH2,4,Provincia Autonoma Trento,P.A. Trento,541380,134410,24.83,0.42
1924,2021-01-22,PAT,1668,433,1235,329,1339,ITH,ITH2,4,Provincia Autonoma Trento,P.A. Trento,541380,136078,25.14,0.31
1925,2021-02-05,PAT,802,272,530,283,519,ITH,ITH2,4,Provincia Autonoma Trento,P.A. Trento,541380,136880,25.28,0.15
1926,2021-01-05,PAT,709,232,477,709,0,ITH,ITH2,4,Provincia Autonoma Trento,P.A. Trento,541380,137589,25.41,0.13
1927,2021-03-27,PAT,1615,709,906,1362,253,ITH,ITH2,4,Provincia Autonoma Trento,P.A. Trento,541380,139204,25.71,0.3
1928,2021-01-19,PAT,405,77,328,405,0,ITH,ITH2,4,Provincia Autonoma Trento,P.A. Trento,541380,139609,25.79,0.07
1929,2021-02-06,PAT,574,298,276,433,141,ITH,ITH2,4,Provincia Autonoma Trento,P.A. Trento,541380,140183,25.89,0.11
1930,2021-02-23,PAT,1108,395,713,897,211,ITH,ITH2,4,Provincia Autonoma Trento,P.A. Trento,541380,141291,26.1,0.2
1931,2021-01-04,PAT,870,227,643,870,0,ITH,ITH2,4,Provincia Autonoma Trento,P.A. Trento,541380,142161,26.26,0.16
1932,2021-05-02,PAT,3512,1955,1557,3475,37,ITH,ITH2,4,Provincia Autonoma Trento,P.A. Trento,541380,145673,26.91,0.65
1933,2021-03-13,PAT,830,380,450,782,48,ITH,ITH2,4,Provincia Autonoma Trento,P.A. Trento,541380,146503,27.06,0.15
1934,2021-02-03,PAT,846,314,532,414,432,ITH,ITH2,4,Provincia Autonoma Trento,P.A. Trento,541380,147349,27.22,0.16
1935,2021-05-23,PAT,1953,993,960,447,1506,ITH,ITH2,4,Provincia Autonoma Trento,P.A. Trento,541380,149302,27.58,0.36
1936,2021-04-10,PAT,2796,1307,1489,2003,793,ITH,ITH2,4,Provincia Autonoma Trento,P.A. Trento,541380,152098,28.09,0.52
1937,2021-02-10,PAT,851,291,560,509,342,ITH,ITH2,4,Provincia Autonoma Trento,P.A. Trento,541380,152949,28.25,0.16
1938,2021-04-08,PAT,3114,1294,1820,1996,1118,ITH,ITH2,4,Provincia Autonoma Trento,P.A. Trento,541380,156063,28.83,0.58
1939,2020-12-31,PAT,1624,449,1175,1624,0,ITH,ITH2,4,Provincia Autonoma Trento,P.A. Trento,541380,157687,29.13,0.3
1940,2021-03-05,PAT,2244,703,1541,1678,566,ITH,ITH2,4,Provincia Autonoma Trento,P.A. Trento,541380,159931,29.54,0.41
1941,2021-01-07,PAT,1270,310,960,1270,0,ITH,ITH2,4,Provincia Autonoma Trento,P.A. Trento,541380,161201,29.78,0.23
1942,2021-01-23,PAT,577,334,243,388,189,ITH,ITH2,4,Provincia Autonoma Trento,P.A. Trento,541380,161778,29.88,0.11
1943,2021-05-05,PAT,4972,2575,2397,4689,283,ITH,ITH2,4,Provincia Autonoma Trento,P.A. Trento,541380,166750,30.8,0.92
1944,2021-04-01,PAT,2893,1227,1666,1800,1093,ITH,ITH2,4,Provincia Autonoma Trento,P.A. Trento,541380,169643,31.34,0.53
1945,2021-03-23,PAT,2444,943,1501,1704,740,ITH,ITH2,4,Provincia Autonoma Trento,P.A. Trento,541380,172087,31.79,0.45
1946,2021-01-15,PAT,595,132,463,595,0,ITH,ITH2,4,Provincia Autonoma Trento,P.A. Trento,541380,172682,31.9,0.11
1947,2021-03-24,PAT,2376,940,1436,1556,820,ITH,ITH2,4,Provincia Autonoma Trento,P.A. Trento,541380,175058,32.34,0.44
1948,2021-02-09,PAT,915,287,628,442,473,ITH,ITH2,4,Provincia Autonoma Trento,P.A. Trento,541380,175973,32.5,0.17
1949,2021-05-13,PAT,3405,1579,1826,2304,1101,ITH,ITH2,4,Provincia Autonoma Trento,P.A. Trento,541380,179378,33.13,0.63
1950,2021-03-31,PAT,2567,983,1584,1710,857,ITH,ITH2,4,Provincia Autonoma Trento,P.A. Trento,541380,181945,33.61,0.47
1951,2021-05-26,PAT,3902,1837,2065,1219,2683,ITH,ITH2,4,Provincia Autonoma Trento,P.A. Trento,541380,185847,34.33,0.72
1952,2021-01-10,PAT,84,19,65,84,0,ITH,ITH2,4,Provincia Autonoma Trento,P.A. Trento,541380,185931,34.34,0.02
1953,2021-04-22,PAT,3146,1468,1678,3102,44,ITH,ITH2,4,Provincia Autonoma Trento,P.A. Trento,541380,189077,34.93,0.58
1954,2021-03-10,PAT,2411,928,1483,1490,921,ITH,ITH2,4,Provincia Autonoma Trento,P.A. Trento,541380,191488,35.37,0.45
1955,2021-04-03,PAT,1138,471,667,971,167,ITH,ITH2,4,Provincia Autonoma Trento,P.A. Trento,541380,192626,35.58,0.21
1956,2021-04-24,PAT,3507,1682,1825,3494,13,ITH,ITH2,4,Provincia Autonoma Trento,P.A. Trento,541380,196133,36.23,0.65
1957,2021-02-28,PAT,242,121,121,242,0,ITH,ITH2,4,Provincia Autonoma Trento,P.A. Trento,541380,196375,36.27,0.04
1958,2021-02-19,PAT,928,358,570,869,59,ITH,ITH2,4,Provincia Autonoma Trento,P.A. Trento,541380,197303,36.44,0.17
1959,2021-05-20,PAT,4997,2353,2644,3373,1624,ITH,ITH2,4,Provincia Autonoma Trento,P.A. Trento,541380,202300,37.37,0.92
1960,2021-03-17,PAT,2067,790,1277,1199,868,ITH,ITH2,4,Provincia Autonoma Trento,P.A. Trento,541380,204367,37.75,0.38
1961,2021-02-02,PAT,907,240,667,190,717,ITH,ITH2,4,Provincia Autonoma Trento,P.A. Trento,541380,205274,37.92,0.17
1962,2021-03-12,PAT,2506,936,1570,1701,805,ITH,ITH2,4,Provincia Autonoma Trento,P.A. Trento,541380,207780,38.38,0.46
1963,2021-01-21,PAT,352,95,257,228,124,ITH,ITH2,4,Provincia Autonoma Trento,P.A. Trento,541380,208132,38.44,0.07
1964,2021-05-01,PAT,4837,2463,2374,4802,35,ITH,ITH2,4,Provincia Autonoma Trento,P.A. Trento,541380,212969,39.34,0.89
1965,2021-03-15,PAT,1410,545,865,946,464,ITH,ITH2,4,Provincia Autonoma Trento,P.A. Trento,541380,214379,39.6,0.26
1966,2021-01-17,PAT,251,195,56,251,0,ITH,ITH2,4,Provincia Autonoma Trento,P.A. Trento,541380,214630,39.64,0.05
1967,2021-05-11,PAT,3688,1744,1944,2845,843,ITH,ITH2,4,Provincia Autonoma Trento,P.A. Trento,541380,218318,40.33,0.68
1968,2021-04-27,PAT,3879,1865,2014,3812,67,ITH,ITH2,4,Provincia Autonoma Trento,P.A. Trento,541380,222197,41.04,0.72
1969,2021-05-04,PAT,4475,2422,2053,4385,90,ITH,ITH2,4,Provincia Autonoma Trento,P.A. Trento,541380,226672,41.87,0.83
1970,2021-03-08,PAT,1398,433,965,1045,353,ITH,ITH2,4,Provincia Autonoma Trento,P.A. Trento,541380,228070,42.13,0.26
1971,2021-03-22,PAT,2306,973,1333,1431,875,ITH,ITH2,4,Provincia Autonoma Trento,P.A. Trento,541380,230376,42.55,0.43
1972,2021-01-24,PAT,547,276,271,224,323,ITH,ITH2,4,Provincia Autonoma Trento,P.A. Trento,541380,230923,42.65,0.1
1973,2021-01-31,PAT,75,15,60,1,74,ITH,ITH2,4,Provincia Autonoma Trento,P.A. Trento,541380,230998,42.67,0.01
1974,2021-04-17,PAT,2203,1120,1083,2146,57,ITH,ITH2,4,Provincia Autonoma Trento,P.A. Trento,541380,233201,43.08,0.41
1975,2021-03-01,PAT,1237,454,783,942,295,ITH,ITH2,4,Provincia Autonoma Trento,P.A. Trento,541380,234438,43.3,0.23
1976,2020-12-27,PAT,103,40,63,103,0,ITH,ITH2,4,Provincia Autonoma Trento,P.A. Trento,541380,234541,43.32,0.02
1977,2021-05-25,PAT,4746,2260,2486,1855,2891,ITH,ITH2,4,Provincia Autonoma Trento,P.A. Trento,541380,239287,44.2,0.88
1978,2021-02-14,PAT,246,186,60,11,235,ITH,ITH2,4,Provincia Autonoma Trento,P.A. Trento,541380,239533,44.24,0.05
1979,2021-05-27,PAT,4102,1926,2176,1232,2870,ITH,ITH2,4,Provincia Autonoma Trento,P.A. Trento,541380,243635,45.0,0.76
1980,2021-04-19,PAT,2622,1235,1387,2600,22,ITH,ITH2,4,Provincia Autonoma Trento,P.A. Trento,541380,246257,45.49,0.48
1981,2021-02-15,PAT,533,187,346,419,114,ITH,ITH2,4,Provincia Autonoma Trento,P.A. Trento,541380,246790,45.59,0.1
1982,2021-01-29,PAT,1353,331,1022,55,1298,ITH,ITH2,4,Provincia Autonoma Trento,P.A. Trento,541380,248143,45.84,0.25
1983,2021-04-07,PAT,2599,1012,1587,1658,941,ITH,ITH2,4,Provincia Autonoma Trento,P.A. Trento,541380,250742,46.32,0.48
1984,2021-01-12,PAT,505,158,347,505,0,ITH,ITH2,4,Provincia Autonoma Trento,P.A. Trento,541380,251247,46.41,0.09
1985,2021-05-15,PAT,1567,815,752,679,888,ITH,ITH2,4,Provincia Autonoma Trento,P.A. Trento,541380,252814,46.7,0.29
1986,2021-02-17,PAT,1110,425,685,1020,90,ITH,ITH2,4,Provincia Autonoma Trento,P.A. Trento,541380,253924,46.9,0.21
1987,2021-05-30,PAT,1769,871,898,927,842,ITH,ITH2,4,Provincia Autonoma Trento,P.A. Trento,541380,255693,47.23,0.33
1988,2021-02-26,PAT,1218,435,783,923,295,ITH,ITH2,4,Provincia Autonoma Trento,P.A. Trento,541380,256911,47.45,0.22
1989,2021-01-14,PAT,700,203,497,700,0,ITH,ITH2,4,Provincia Autonoma Trento,P.A. Trento,541380,257611,47.58,0.13
1990,2021-04-26,PAT,2648,1246,1402,2554,94,ITH,ITH2,4,Provincia Autonoma Trento,P.A. Trento,541380,260259,48.07,0.49
1991,2021-01-26,PAT,542,154,388,27,515,ITH,ITH2,4,Provincia Autonoma Trento,P.A. Trento,541380,260801,48.17,0.1
1992,2021-04-29,PAT,4621,2232,2389,4412,209,ITH,ITH2,4,Provincia Autonoma Trento,P.A. Trento,541380,265422,49.03,0.85
1993,2021-05-16,PAT,1321,729,592,1083,238,ITH,ITH2,4,Provincia Autonoma Trento,P.A. Trento,541380,266743,49.27,0.24
1994,2021-04-15,PAT,3182,1437,1745,3028,154,ITH,ITH2,4,Provincia Autonoma Trento,P.A. Trento,541380,269925,49.86,0.59
1995,2021-02-24,PAT,1318,523,795,922,396,ITH,ITH2,4,Provincia Autonoma Trento,P.A. Trento,541380,271243,50.1,0.24
1996,2021-05-06,PAT,5505,2726,2779,4726,779,ITH,ITH2,4,Provincia Autonoma Trento,P.A. Trento,541380,276748,51.12,1.02
1997,2021-03-19,PAT,2423,915,1508,1571,852,ITH,ITH2,4,Provincia Autonoma Trento,P.A. Trento,541380,279171,51.57,0.45
1998,2021-04-05,PAT,35,17,18,33,2,ITH,ITH2,4,Provincia Autonoma Trento,P.A. Trento,541380,279206,51.57,0.01
1999,2021-04-13,PAT,2553,1058,1495,2046,507,ITH,ITH2,4,Provincia Autonoma Trento,P.A. Trento,541380,281759,52.04,0.47
2000,2021-05-19,PAT,5088,2451,2637,3839,1249,ITH,ITH2,4,Provincia Autonoma Trento,P.A. Trento,541380,286847,52.98,0.94
2001,2021-01-03,PAT,492,160,332,492,0,ITH,ITH2,4,Provincia Autonoma Trento,P.A. Trento,541380,287339,53.08,0.09
2002,2021-02-22,PAT,745,259,486,661,84,ITH,ITH2,4,Provincia Autonoma Trento,P.A. Trento,541380,288084,53.21,0.14
2003,2021-05-18,PAT,4245,2008,2237,3403,842,ITH,ITH2,4,Provincia Autonoma Trento,P.A. Trento,541380,292329,54.0,0.78
2004,2021-01-02,PAT,502,143,359,502,0,ITH,ITH2,4,Provincia Autonoma Trento,P.A. Trento,541380,292831,54.09,0.09
2005,2021-03-29,PAT,2461,958,1503,1726,735,ITH,ITH2,4,Provincia Autonoma Trento,P.A. Trento,541380,295292,54.54,0.45
2006,2021-04-12,PAT,3087,1408,1679,2591,496,ITH,ITH2,4,Provincia Autonoma Trento,P.A. Trento,541380,298379,55.11,0.57
2007,2021-02-21,PAT,155,92,63,43,112,ITH,ITH2,4,Provincia Autonoma Trento,P.A. Trento,541380,298534,55.14,0.03
2008,2021-06-01,PAT,2888,1348,1540,682,2206,ITH,ITH2,4,Provincia Autonoma Trento,P.A. Trento,541380,301422,55.68,0.53
2009,2021-03-23,SIC,21065,10076,10989,15411,5654,ITG,ITG1,19,Sicilia,Sicilia,4999891,21065,0.42,0.42
2010,2020-12-28,SIC,211,126,85,211,0,ITG,ITG1,19,Sicilia,Sicilia,4999891,21276,0.43,0.0
2011,2021-03-25,SIC,20635,9556,11079,15096,5539,ITG,ITG1,19,Sicilia,Sicilia,4999891,41911,0.84,0.41
2012,2021-05-28,SIC,51089,22804,28285,24795,26294,ITG,ITG1,19,Sicilia,Sicilia,4999891,93000,1.86,1.02
2013,2021-02-25,SIC,10121,5247,4874,8955,1166,ITG,ITG1,19,Sicilia,Sicilia,4999891,103121,2.06,0.2
2014,2021-03-14,SIC,8782,3929,4853,4947,3835,ITG,ITG1,19,Sicilia,Sicilia,4999891,111903,2.24,0.18
2015,2021-02-11,SIC,5321,2097,3224,4859,462,ITG,ITG1,19,Sicilia,Sicilia,4999891,117224,2.34,0.11
2016,2021-04-16,SIC,28740,14421,14319,20364,8376,ITG,ITG1,19,Sicilia,Sicilia,4999891,145964,2.92,0.57
2017,2021-05-21,SIC,45869,21588,24281,24406,21463,ITG,ITG1,19,Sicilia,Sicilia,4999891,191833,3.84,0.92
2018,2021-04-20,SIC,19270,9079,10191,13931,5339,ITG,ITG1,19,Sicilia,Sicilia,4999891,211103,4.22,0.39
2019,2021-02-15,SIC,3927,1818,2109,3362,565,ITG,ITG1,19,Sicilia,Sicilia,4999891,215030,4.3,0.08
2020,2021-04-30,SIC,35213,16456,18757,24009,11204,ITG,ITG1,19,Sicilia,Sicilia,4999891,250243,5.0,0.7
2021,2021-03-04,SIC,15184,6544,8640,10986,4198,ITG,ITG1,19,Sicilia,Sicilia,4999891,265427,5.31,0.3
2022,2021-05-07,SIC,36659,17315,19344,25030,11629,ITG,ITG1,19,Sicilia,Sicilia,4999891,302086,6.04,0.73
2023,2021-01-13,SIC,5269,2494,2775,5269,0,ITG,ITG1,19,Sicilia,Sicilia,4999891,307355,6.15,0.11
2024,2021-03-18,SIC,15603,7783,7820,9865,5738,ITG,ITG1,19,Sicilia,Sicilia,4999891,322958,6.46,0.31
2025,2021-03-02,SIC,14869,6360,8509,12060,2809,ITG,ITG1,19,Sicilia,Sicilia,4999891,337827,6.76,0.3
2026,2021-01-04,SIC,8406,4193,4213,8406,0,ITG,ITG1,19,Sicilia,Sicilia,4999891,346233,6.92,0.17
2027,2021-01-18,SIC,1650,670,980,1495,155,ITG,ITG1,19,Sicilia,Sicilia,4999891,347883,6.96,0.03
2028,2021-04-28,SIC,29350,13767,15583,20268,9082,ITG,ITG1,19,Sicilia,Sicilia,4999891,377233,7.54,0.59
2029,2021-02-23,SIC,8909,4670,4239,8446,463,ITG,ITG1,19,Sicilia,Sicilia,4999891,386142,7.72,0.18
2030,2021-03-09,SIC,13147,5587,7560,10774,2373,ITG,ITG1,19,Sicilia,Sicilia,4999891,399289,7.99,0.26
2031,2021-01-11,SIC,5917,2597,3320,5917,0,ITG,ITG1,19,Sicilia,Sicilia,4999891,405206,8.1,0.12
2032,2021-05-12,SIC,36856,17349,19507,21913,14943,ITG,ITG1,19,Sicilia,Sicilia,4999891,442062,8.84,0.74
2033,2021-04-08,SIC,16797,8288,8509,8313,8484,ITG,ITG1,19,Sicilia,Sicilia,4999891,458859,9.18,0.34
2034,2021-02-20,SIC,7242,3726,3516,7000,242,ITG,ITG1,19,Sicilia,Sicilia,4999891,466101,9.32,0.14
2035,2021-02-03,SIC,6095,2854,3241,752,5343,ITG,ITG1,19,Sicilia,Sicilia,4999891,472196,9.44,0.12
2036,2021-03-28,SIC,10892,5126,5766,6881,4011,ITG,ITG1,19,Sicilia,Sicilia,4999891,483088,9.66,0.22
2037,2021-04-06,SIC,17831,8538,9293,13505,4326,ITG,ITG1,19,Sicilia,Sicilia,4999891,500919,10.02,0.36
2038,2021-02-22,SIC,8013,4146,3867,7522,491,ITG,ITG1,19,Sicilia,Sicilia,4999891,508932,10.18,0.16
2039,2021-04-23,SIC,28885,13844,15041,22938,5947,ITG,ITG1,19,Sicilia,Sicilia,4999891,537817,10.76,0.58
2040,2021-03-11,SIC,15449,6517,8932,12884,2565,ITG,ITG1,19,Sicilia,Sicilia,4999891,553266,11.07,0.31
2041,2021-01-27,SIC,7528,3838,3690,183,7345,ITG,ITG1,19,Sicilia,Sicilia,4999891,560794,11.22,0.15
2042,2021-01-20,SIC,837,427,410,574,263,ITG,ITG1,19,Sicilia,Sicilia,4999891,561631,11.23,0.02
2043,2021-04-11,SIC,15336,7575,7761,8307,7029,ITG,ITG1,19,Sicilia,Sicilia,4999891,576967,11.54,0.31
2044,2020-12-30,SIC,176,102,74,176,0,ITG,ITG1,19,Sicilia,Sicilia,4999891,577143,11.54,0.0
2045,2021-01-16,SIC,2781,1198,1583,2781,0,ITG,ITG1,19,Sicilia,Sicilia,4999891,579924,11.6,0.06
2046,2021-04-09,SIC,20539,10004,10535,11389,9150,ITG,ITG1,19,Sicilia,Sicilia,4999891,600463,12.01,0.41
2047,2021-03-06,SIC,12919,5167,7752,10016,2903,ITG,ITG1,19,Sicilia,Sicilia,4999891,613382,12.27,0.26
2048,2021-05-31,SIC,37692,16811,20881,21450,16242,ITG,ITG1,19,Sicilia,Sicilia,4999891,651074,13.02,0.75
2049,2021-02-18,SIC,5473,3152,2321,5044,429,ITG,ITG1,19,Sicilia,Sicilia,4999891,656547,13.13,0.11
2050,2021-04-27,SIC,26383,12713,13670,15590,10793,ITG,ITG1,19,Sicilia,Sicilia,4999891,682930,13.66,0.53
2051,2021-05-14,SIC,52242,24468,27774,36395,15847,ITG,ITG1,19,Sicilia,Sicilia,4999891,735172,14.7,1.04
2052,2021-02-13,SIC,3097,1164,1933,2841,256,ITG,ITG1,19,Sicilia,Sicilia,4999891,738269,14.77,0.06
2053,2021-05-24,SIC,35520,17107,18413,15710,19810,ITG,ITG1,19,Sicilia,Sicilia,4999891,773789,15.48,0.71
2054,2021-05-17,SIC,32096,15458,16638,19345,12751,ITG,ITG1,19,Sicilia,Sicilia,4999891,805885,16.12,0.64
2055,2021-03-21,SIC,15207,7330,7877,11236,3971,ITG,ITG1,19,Sicilia,Sicilia,4999891,821092,16.42,0.3
2056,2021-02-06,SIC,5016,2190,2826,1463,3553,ITG,ITG1,19,Sicilia,Sicilia,4999891,826108,16.52,0.1
2057,2021-02-04,SIC,6932,3187,3745,1455,5477,ITG,ITG1,19,Sicilia,Sicilia,4999891,833040,16.66,0.14
2058,2021-01-01,SIC,815,437,378,815,0,ITG,ITG1,19,Sicilia,Sicilia,4999891,833855,16.68,0.02
2059,2021-05-16,SIC,33110,16124,16986,21784,11326,ITG,ITG1,19,Sicilia,Sicilia,4999891,866965,17.34,0.66
2060,2021-05-02,SIC,24655,11445,13210,18054,6601,ITG,ITG1,19,Sicilia,Sicilia,4999891,891620,17.83,0.49
2061,2021-03-20,SIC,18813,9030,9783,13488,5325,ITG,ITG1,19,Sicilia,Sicilia,4999891,910433,18.21,0.38
2062,2021-05-09,SIC,28135,13161,14974,19864,8271,ITG,ITG1,19,Sicilia,Sicilia,4999891,938568,18.77,0.56
2063,2021-03-08,SIC,13536,5826,7710,10729,2807,ITG,ITG1,19,Sicilia,Sicilia,4999891,952104,19.04,0.27
2064,2021-05-13,SIC,47388,22236,25152,30787,16601,ITG,ITG1,19,Sicilia,Sicilia,4999891,999492,19.99,0.95
2065,2021-01-31,SIC,4110,1959,2151,113,3997,ITG,ITG1,19,Sicilia,Sicilia,4999891,1003602,20.07,0.08
2066,2021-05-11,SIC,32429,15424,17005,19887,12542,ITG,ITG1,19,Sicilia,Sicilia,4999891,1036031,20.72,0.65
2067,2021-02-17,SIC,5415,3279,2136,4747,668,ITG,ITG1,19,Sicilia,Sicilia,4999891,1041446,20.83,0.11
2068,2021-02-02,SIC,5534,2620,2914,629,4905,ITG,ITG1,19,Sicilia,Sicilia,4999891,1046980,20.94,0.11
2069,2021-01-25,SIC,7514,3697,3817,308,7206,ITG,ITG1,19,Sicilia,Sicilia,4999891,1054494,21.09,0.15
2070,2021-05-05,SIC,26303,12174,14129,16708,9595,ITG,ITG1,19,Sicilia,Sicilia,4999891,1080797,21.62,0.53
2071,2021-05-19,SIC,42701,20585,22116,28400,14301,ITG,ITG1,19,Sicilia,Sicilia,4999891,1123498,22.47,0.85
2072,2021-03-16,SIC,9780,4363,5417,3662,6118,ITG,ITG1,19,Sicilia,Sicilia,4999891,1133278,22.67,0.2
2073,2021-02-08,SIC,4086,1760,2326,2129,1957,ITG,ITG1,19,Sicilia,Sicilia,4999891,1137364,22.75,0.08
2074,2021-03-30,SIC,14595,6759,7836,9770,4825,ITG,ITG1,19,Sicilia,Sicilia,4999891,1151959,23.04,0.29
2075,2021-05-04,SIC,26851,12472,14379,17641,9210,ITG,ITG1,19,Sicilia,Sicilia,4999891,1178810,23.58,0.54
2076,2021-02-28,SIC,7165,3063,4102,6535,630,ITG,ITG1,19,Sicilia,Sicilia,4999891,1185975,23.72,0.14
2077,2021-01-23,SIC,4332,2234,2098,216,4116,ITG,ITG1,19,Sicilia,Sicilia,4999891,1190307,23.81,0.09
2078,2021-01-06,SIC,6486,3412,3074,6486,0,ITG,ITG1,19,Sicilia,Sicilia,4999891,1196793,23.94,0.13
2079,2021-04-02,SIC,14011,6596,7415,9224,4787,ITG,ITG1,19,Sicilia,Sicilia,4999891,1210804,24.22,0.28
2080,2021-02-10,SIC,4420,1813,2607,3999,421,ITG,ITG1,19,Sicilia,Sicilia,4999891,1215224,24.31,0.09
2081,2021-04-01,SIC,14399,6674,7725,9684,4715,ITG,ITG1,19,Sicilia,Sicilia,4999891,1229623,24.59,0.29
2082,2021-05-26,SIC,44225,20624,23601,23785,20440,ITG,ITG1,19,Sicilia,Sicilia,4999891,1273848,25.48,0.88
2083,2021-01-03,SIC,4705,2461,2244,4705,0,ITG,ITG1,19,Sicilia,Sicilia,4999891,1278553,25.57,0.09
2084,2021-04-13,SIC,19915,9688,10227,11080,8835,ITG,ITG1,19,Sicilia,Sicilia,4999891,1298468,25.97,0.4
2085,2021-01-10,SIC,3622,1616,2006,3622,0,ITG,ITG1,19,Sicilia,Sicilia,4999891,1302090,26.04,0.07
2086,2021-01-05,SIC,10539,5163,5376,10539,0,ITG,ITG1,19,Sicilia,Sicilia,4999891,1312629,26.25,0.21
2087,2021-04-15,SIC,21356,10387,10969,11799,9557,ITG,ITG1,19,Sicilia,Sicilia,4999891,1333985,26.68,0.43
2088,2021-04-22,SIC,27166,12821,14345,20576,6590,ITG,ITG1,19,Sicilia,Sicilia,4999891,1361151,27.22,0.54
2089,2021-03-10,SIC,13937,5955,7982,11552,2385,ITG,ITG1,19,Sicilia,Sicilia,4999891,1375088,27.5,0.28
2090,2021-01-12,SIC,4547,2236,2311,4547,0,ITG,ITG1,19,Sicilia,Sicilia,4999891,1379635,27.59,0.09
2091,2021-01-30,SIC,7837,3569,4268,172,7665,ITG,ITG1,19,Sicilia,Sicilia,4999891,1387472,27.75,0.16
2092,2021-04-04,SIC,6825,3325,3500,5533,1292,ITG,ITG1,19,Sicilia,Sicilia,4999891,1394297,27.89,0.14
2093,2020-12-27,SIC,92,55,37,92,0,ITG,ITG1,19,Sicilia,Sicilia,4999891,1394389,27.89,0.0
2094,2021-03-01,SIC,12959,6119,6840,11304,1655,ITG,ITG1,19,Sicilia,Sicilia,4999891,1407348,28.15,0.26
2095,2021-02-07,SIC,2338,991,1347,674,1664,ITG,ITG1,19,Sicilia,Sicilia,4999891,1409686,28.19,0.05
2096,2021-05-25,SIC,33145,15009,18136,13979,19166,ITG,ITG1,19,Sicilia,Sicilia,4999891,1442831,28.86,0.66
2097,2021-04-12,SIC,18959,9204,9755,11619,7340,ITG,ITG1,19,Sicilia,Sicilia,4999891,1461790,29.24,0.38
2098,2021-05-27,SIC,47182,21543,25639,24909,22273,ITG,ITG1,19,Sicilia,Sicilia,4999891,1508972,30.18,0.94
2099,2021-04-14,SIC,20291,9798,10493,11507,8784,ITG,ITG1,19,Sicilia,Sicilia,4999891,1529263,30.59,0.41
2100,2021-04-21,SIC,22687,10885,11802,16459,6228,ITG,ITG1,19,Sicilia,Sicilia,4999891,1551950,31.04,0.45
2101,2021-04-07,SIC,15528,7632,7896,8364,7164,ITG,ITG1,19,Sicilia,Sicilia,4999891,1567478,31.35,0.31
2102,2021-04-25,SIC,21351,10184,11167,16373,4978,ITG,ITG1,19,Sicilia,Sicilia,4999891,1588829,31.78,0.43
2103,2021-03-22,SIC,16818,7916,8902,11275,5543,ITG,ITG1,19,Sicilia,Sicilia,4999891,1605647,32.11,0.34
2104,2021-01-17,SIC,1302,589,713,1245,57,ITG,ITG1,19,Sicilia,Sicilia,4999891,1606949,32.14,0.03
2105,2021-03-05,SIC,15877,6838,9039,11560,4317,ITG,ITG1,19,Sicilia,Sicilia,4999891,1622826,32.46,0.32
2106,2021-02-16,SIC,4371,2283,2088,3906,465,ITG,ITG1,19,Sicilia,Sicilia,4999891,1627197,32.54,0.09
2107,2020-12-31,SIC,880,470,410,880,0,ITG,ITG1,19,Sicilia,Sicilia,4999891,1628077,32.56,0.02
2108,2021-01-09,SIC,7328,3425,3903,7328,0,ITG,ITG1,19,Sicilia,Sicilia,4999891,1635405,32.71,0.15
2109,2021-05-03,SIC,23471,10825,12646,13587,9884,ITG,ITG1,19,Sicilia,Sicilia,4999891,1658876,33.18,0.47
2110,2021-01-19,SIC,1302,539,763,1096,206,ITG,ITG1,19,Sicilia,Sicilia,4999891,1660178,33.2,0.03
2111,2021-03-03,SIC,14666,6522,8144,11578,3088,ITG,ITG1,19,Sicilia,Sicilia,4999891,1674844,33.5,0.29
2112,2021-05-01,SIC,24476,11327,13149,19318,5158,ITG,ITG1,19,Sicilia,Sicilia,4999891,1699320,33.99,0.49
2113,2021-05-10,SIC,28304,13595,14709,16187,12117,ITG,ITG1,19,Sicilia,Sicilia,4999891,1727624,34.55,0.57
2114,2021-01-28,SIC,9313,4394,4919,398,8915,ITG,ITG1,19,Sicilia,Sicilia,4999891,1736937,34.74,0.19
2115,2021-05-18,SIC,36149,17312,18837,23568,12581,ITG,ITG1,19,Sicilia,Sicilia,4999891,1773086,35.46,0.72
2116,2021-03-29,SIC,15018,7038,7980,10502,4516,ITG,ITG1,19,Sicilia,Sicilia,4999891,1788104,35.76,0.3
2117,2021-06-01,SIC,24541,11087,13454,14832,9709,ITG,ITG1,19,Sicilia,Sicilia,4999891,1812645,36.25,0.49
2118,2021-04-05,SIC,8024,3959,4065,6584,1440,ITG,ITG1,19,Sicilia,Sicilia,4999891,1820669,36.41,0.16
2119,2021-02-14,SIC,1058,403,655,918,140,ITG,ITG1,19,Sicilia,Sicilia,4999891,1821727,36.44,0.02
2120,2021-01-02,SIC,4885,2541,2344,4885,0,ITG,ITG1,19,Sicilia,Sicilia,4999891,1826612,36.53,0.1
2121,2021-03-17,SIC,15172,7463,7709,9260,5912,ITG,ITG1,19,Sicilia,Sicilia,4999891,1841784,36.84,0.3
2122,2021-05-06,SIC,29090,13786,15304,18460,10630,ITG,ITG1,19,Sicilia,Sicilia,4999891,1870874,37.42,0.58
2123,2021-03-31,SIC,14606,6750,7856,9578,5028,ITG,ITG1,19,Sicilia,Sicilia,4999891,1885480,37.71,0.29
2124,2021-02-09,SIC,4411,1823,2588,3356,1055,ITG,ITG1,19,Sicilia,Sicilia,4999891,1889891,37.8,0.09
2125,2021-05-20,SIC,43528,20782,22746,27645,15883,ITG,ITG1,19,Sicilia,Sicilia,4999891,1933419,38.67,0.87
2126,2021-02-05,SIC,7103,3158,3945,2128,4975,ITG,ITG1,19,Sicilia,Sicilia,4999891,1940522,38.81,0.14
2127,2021-04-03,SIC,16363,7781,8582,13527,2836,ITG,ITG1,19,Sicilia,Sicilia,4999891,1956885,39.14,0.33
2128,2021-03-27,SIC,15751,7437,8314,10838,4913,ITG,ITG1,19,Sicilia,Sicilia,4999891,1972636,39.45,0.32
2129,2021-01-29,SIC,9354,4317,5037,425,8929,ITG,ITG1,19,Sicilia,Sicilia,4999891,1981990,39.64,0.19
2130,2021-02-12,SIC,4674,1847,2827,4406,268,ITG,ITG1,19,Sicilia,Sicilia,4999891,1986664,39.73,0.09
2131,2021-05-23,SIC,34135,16613,17522,20109,14026,ITG,ITG1,19,Sicilia,Sicilia,4999891,2020799,40.42,0.68
2132,2021-02-19,SIC,5131,2732,2399,4564,567,ITG,ITG1,19,Sicilia,Sicilia,4999891,2025930,40.52,0.1
2133,2021-05-30,SIC,35542,16085,19457,17478,18064,ITG,ITG1,19,Sicilia,Sicilia,4999891,2061472,41.23,0.71
2134,2021-04-24,SIC,31354,14804,16550,23614,7740,ITG,ITG1,19,Sicilia,Sicilia,4999891,2092826,41.86,0.63
2135,2021-04-26,SIC,21937,10377,11560,13799,8138,ITG,ITG1,19,Sicilia,Sicilia,4999891,2114763,42.3,0.44
2136,2021-01-14,SIC,5263,2521,2742,5263,0,ITG,ITG1,19,Sicilia,Sicilia,4999891,2120026,42.4,0.11
2137,2021-05-15,SIC,57074,26664,30410,41704,15370,ITG,ITG1,19,Sicilia,Sicilia,4999891,2177100,43.54,1.14
2138,2021-03-19,SIC,16519,8114,8405,10788,5731,ITG,ITG1,19,Sicilia,Sicilia,4999891,2193619,43.87,0.33
2139,2021-03-12,SIC,13119,5615,7504,10902,2217,ITG,ITG1,19,Sicilia,Sicilia,4999891,2206738,44.14,0.26
2140,2021-01-15,SIC,5088,2236,2852,5088,0,ITG,ITG1,19,Sicilia,Sicilia,4999891,2211826,44.24,0.1
2141,2021-02-01,SIC,6071,2681,3390,298,5773,ITG,ITG1,19,Sicilia,Sicilia,4999891,2217897,44.36,0.12
2142,2020-12-29,SIC,239,148,91,239,0,ITG,ITG1,19,Sicilia,Sicilia,4999891,2218136,44.36,0.0
2143,2021-04-10,SIC,20662,10083,10579,11620,9042,ITG,ITG1,19,Sicilia,Sicilia,4999891,2238798,44.78,0.41
2144,2021-03-07,SIC,9265,3455,5810,8182,1083,ITG,ITG1,19,Sicilia,Sicilia,4999891,2248063,44.96,0.19
2145,2021-04-29,SIC,31687,14765,16922,22328,9359,ITG,ITG1,19,Sicilia,Sicilia,4999891,2279750,45.6,0.63
2146,2021-02-24,SIC,9562,4851,4711,8972,590,ITG,ITG1,19,Sicilia,Sicilia,4999891,2289312,45.79,0.19
2147,2021-01-21,SIC,1389,681,708,500,889,ITG,ITG1,19,Sicilia,Sicilia,4999891,2290701,45.82,0.03
2148,2021-03-26,SIC,18036,8377,9659,12505,5531,ITG,ITG1,19,Sicilia,Sicilia,4999891,2308737,46.18,0.36
2149,2021-05-08,SIC,35762,17079,18683,25435,10327,ITG,ITG1,19,Sicilia,Sicilia,4999891,2344499,46.89,0.72
2150,2021-01-26,SIC,9482,4667,4815,260,9222,ITG,ITG1,19,Sicilia,Sicilia,4999891,2353981,47.08,0.19
2151,2021-02-21,SIC,5169,2501,2668,5063,106,ITG,ITG1,19,Sicilia,Sicilia,4999891,2359150,47.18,0.1
2152,2021-01-24,SIC,4310,2254,2056,141,4169,ITG,ITG1,19,Sicilia,Sicilia,4999891,2363460,47.27,0.09
2153,2021-03-15,SIC,10817,4716,6101,5752,5065,ITG,ITG1,19,Sicilia,Sicilia,4999891,2374277,47.49,0.22
2154,2021-05-22,SIC,48211,22881,25330,28722,19489,ITG,ITG1,19,Sicilia,Sicilia,4999891,2422488,48.45,0.96
2155,2021-04-19,SIC,18476,8736,9740,12769,5707,ITG,ITG1,19,Sicilia,Sicilia,4999891,2440964,48.82,0.37
2156,2021-03-24,SIC,21145,9908,11237,15308,5837,ITG,ITG1,19,Sicilia,Sicilia,4999891,2462109,49.24,0.42
2157,2021-05-29,SIC,47145,21433,25712,23925,23220,ITG,ITG1,19,Sicilia,Sicilia,4999891,2509254,50.19,0.94
2158,2021-02-27,SIC,12425,5556,6869,11221,1204,ITG,ITG1,19,Sicilia,Sicilia,4999891,2521679,50.43,0.25
2159,2021-01-22,SIC,1254,634,620,243,1011,ITG,ITG1,19,Sicilia,Sicilia,4999891,2522933,50.46,0.03
2160,2021-01-08,SIC,8335,3868,4467,8335,0,ITG,ITG1,19,Sicilia,Sicilia,4999891,2531268,50.63,0.17
2161,2021-04-18,SIC,19723,9862,9861,15357,4366,ITG,ITG1,19,Sicilia,Sicilia,4999891,2550991,51.02,0.39
2162,2021-03-13,SIC,12423,5480,6943,7840,4583,ITG,ITG1,19,Sicilia,Sicilia,4999891,2563414,51.27,0.25
2163,2021-04-17,SIC,26189,13226,12963,19037,7152,ITG,ITG1,19,Sicilia,Sicilia,4999891,2589603,51.79,0.52
2164,2021-02-26,SIC,12208,5967,6241,10524,1684,ITG,ITG1,19,Sicilia,Sicilia,4999891,2601811,52.04,0.24
2165,2021-01-07,SIC,9190,4250,4940,9190,0,ITG,ITG1,19,Sicilia,Sicilia,4999891,2611001,52.22,0.18
2166,2021-01-12,PAB,1709,459,1250,1709,0,ITH,ITH1,4,Provincia Autonoma Bolzano / Bozen,P.A. Bolzano,533050,1709,0.32,0.32
2167,2021-04-07,PAB,1777,802,975,1238,539,ITH,ITH1,4,Provincia Autonoma Bolzano / Bozen,P.A. Bolzano,533050,3486,0.65,0.33
2168,2021-03-02,PAB,695,200,495,693,2,ITH,ITH1,4,Provincia Autonoma Bolzano / Bozen,P.A. Bolzano,533050,4181,0.78,0.13
2169,2021-05-18,PAB,3304,1728,1576,2140,1164,ITH,ITH1,4,Provincia Autonoma Bolzano / Bozen,P.A. Bolzano,533050,7485,1.4,0.62
2170,2021-05-01,PAB,2104,1067,1037,1944,160,ITH,ITH1,4,Provincia Autonoma Bolzano / Bozen,P.A. Bolzano,533050,9589,1.8,0.39
2171,2021-03-12,PAB,1664,734,930,1251,413,ITH,ITH1,4,Provincia Autonoma Bolzano / Bozen,P.A. Bolzano,533050,11253,2.11,0.31
2172,2021-03-29,PAB,1171,499,672,412,759,ITH,ITH1,4,Provincia Autonoma Bolzano / Bozen,P.A. Bolzano,533050,12424,2.33,0.22
2173,2021-04-28,PAB,2464,1302,1162,2459,5,ITH,ITH1,4,Provincia Autonoma Bolzano / Bozen,P.A. Bolzano,533050,14888,2.79,0.46
2174,2021-01-24,PAB,12,10,2,0,12,ITH,ITH1,4,Provincia Autonoma Bolzano / Bozen,P.A. Bolzano,533050,14900,2.8,0.0
2175,2021-05-15,PAB,6995,3683,3312,6700,295,ITH,ITH1,4,Provincia Autonoma Bolzano / Bozen,P.A. Bolzano,533050,21895,4.11,1.31
2176,2021-04-02,PAB,2077,837,1240,720,1357,ITH,ITH1,4,Provincia Autonoma Bolzano / Bozen,P.A. Bolzano,533050,23972,4.5,0.39
2177,2021-05-22,PAB,6821,3552,3269,4654,2167,ITH,ITH1,4,Provincia Autonoma Bolzano / Bozen,P.A. Bolzano,533050,30793,5.78,1.28
2178,2021-01-26,PAB,810,291,519,1,809,ITH,ITH1,4,Provincia Autonoma Bolzano / Bozen,P.A. Bolzano,533050,31603,5.93,0.15
2179,2021-03-24,PAB,2041,978,1063,2028,13,ITH,ITH1,4,Provincia Autonoma Bolzano / Bozen,P.A. Bolzano,533050,33644,6.31,0.38
2180,2021-03-10,PAB,1261,524,737,1118,143,ITH,ITH1,4,Provincia Autonoma Bolzano / Bozen,P.A. Bolzano,533050,34905,6.55,0.24
2181,2021-05-06,PAB,5181,2747,2434,2612,2569,ITH,ITH1,4,Provincia Autonoma Bolzano / Bozen,P.A. Bolzano,533050,40086,7.52,0.97
2182,2021-03-17,PAB,581,213,368,580,1,ITH,ITH1,4,Provincia Autonoma Bolzano / Bozen,P.A. Bolzano,533050,40667,7.63,0.11
2183,2021-05-13,PAB,2980,1347,1633,1050,1930,ITH,ITH1,4,Provincia Autonoma Bolzano / Bozen,P.A. Bolzano,533050,43647,8.19,0.56
2184,2021-04-29,PAB,2630,1351,1279,1936,694,ITH,ITH1,4,Provincia Autonoma Bolzano / Bozen,P.A. Bolzano,533050,46277,8.68,0.49
2185,2021-01-19,PAB,853,371,482,723,130,ITH,ITH1,4,Provincia Autonoma Bolzano / Bozen,P.A. Bolzano,533050,47130,8.84,0.16
2186,2021-02-09,PAB,317,126,191,1,316,ITH,ITH1,4,Provincia Autonoma Bolzano / Bozen,P.A. Bolzano,533050,47447,8.9,0.06
2187,2021-02-02,PAB,1745,506,1239,8,1737,ITH,ITH1,4,Provincia Autonoma Bolzano / Bozen,P.A. Bolzano,533050,49192,9.23,0.33
2188,2021-05-27,PAB,6049,3178,2871,4045,2004,ITH,ITH1,4,Provincia Autonoma Bolzano / Bozen,P.A. Bolzano,533050,55241,10.36,1.13
2189,2021-02-14,PAB,297,130,167,297,0,ITH,ITH1,4,Provincia Autonoma Bolzano / Bozen,P.A. Bolzano,533050,55538,10.42,0.06
2190,2021-03-03,PAB,1179,393,786,1166,13,ITH,ITH1,4,Provincia Autonoma Bolzano / Bozen,P.A. Bolzano,533050,56717,10.64,0.22
2191,2021-05-10,PAB,3018,1300,1718,1413,1605,ITH,ITH1,4,Provincia Autonoma Bolzano / Bozen,P.A. Bolzano,533050,59735,11.21,0.57
2192,2021-01-28,PAB,871,308,563,10,861,ITH,ITH1,4,Provincia Autonoma Bolzano / Bozen,P.A. Bolzano,533050,60606,11.37,0.16
2193,2021-02-12,PAB,730,217,513,482,248,ITH,ITH1,4,Provincia Autonoma Bolzano / Bozen,P.A. Bolzano,533050,61336,11.51,0.14
2194,2020-12-31,PAB,912,518,394,912,0,ITH,ITH1,4,Provincia Autonoma Bolzano / Bozen,P.A. Bolzano,533050,62248,11.68,0.17
2195,2021-04-17,PAB,5232,2598,2634,5188,44,ITH,ITH1,4,Provincia Autonoma Bolzano / Bozen,P.A. Bolzano,533050,67480,12.66,0.98
2196,2021-04-12,PAB,2105,946,1159,2098,7,ITH,ITH1,4,Provincia Autonoma Bolzano / Bozen,P.A. Bolzano,533050,69585,13.05,0.39
2197,2021-04-21,PAB,3012,1468,1544,2164,848,ITH,ITH1,4,Provincia Autonoma Bolzano / Bozen,P.A. Bolzano,533050,72597,13.62,0.57
2198,2021-01-09,PAB,612,326,286,612,0,ITH,ITH1,4,Provincia Autonoma Bolzano / Bozen,P.A. Bolzano,533050,73209,13.73,0.11
2199,2021-02-04,PAB,1958,593,1365,8,1950,ITH,ITH1,4,Provincia Autonoma Bolzano / Bozen,P.A. Bolzano,533050,75167,14.1,0.37
2200,2021-05-29,PAB,7124,3763,3361,3991,3133,ITH,ITH1,4,Provincia Autonoma Bolzano / Bozen,P.A. Bolzano,533050,82291,15.44,1.34
2201,2021-03-26,PAB,1644,721,923,511,1133,ITH,ITH1,4,Provincia Autonoma Bolzano / Bozen,P.A. Bolzano,533050,83935,15.75,0.31
2202,2021-04-09,PAB,2926,1292,1634,2196,730,ITH,ITH1,4,Provincia Autonoma Bolzano / Bozen,P.A. Bolzano,533050,86861,16.3,0.55
2203,2021-02-11,PAB,1093,431,662,239,854,ITH,ITH1,4,Provincia Autonoma Bolzano / Bozen,P.A. Bolzano,533050,87954,16.5,0.21
2204,2021-04-24,PAB,5104,2449,2655,4619,485,ITH,ITH1,4,Provincia Autonoma Bolzano / Bozen,P.A. Bolzano,533050,93058,17.46,0.96
2205,2021-04-05,PAB,301,144,157,23,278,ITH,ITH1,4,Provincia Autonoma Bolzano / Bozen,P.A. Bolzano,533050,93359,17.51,0.06
2206,2021-03-21,PAB,768,285,483,14,754,ITH,ITH1,4,Provincia Autonoma Bolzano / Bozen,P.A. Bolzano,533050,94127,17.66,0.14
2207,2021-01-14,PAB,1946,575,1371,1946,0,ITH,ITH1,4,Provincia Autonoma Bolzano / Bozen,P.A. Bolzano,533050,96073,18.02,0.37
2208,2021-03-19,PAB,1906,773,1133,799,1107,ITH,ITH1,4,Provincia Autonoma Bolzano / Bozen,P.A. Bolzano,533050,97979,18.38,0.36
2209,2021-03-22,PAB,1133,514,619,1129,4,ITH,ITH1,4,Provincia Autonoma Bolzano / Bozen,P.A. Bolzano,533050,99112,18.59,0.21
2210,2021-03-05,PAB,1839,625,1214,1397,442,ITH,ITH1,4,Provincia Autonoma Bolzano / Bozen,P.A. Bolzano,533050,100951,18.94,0.34
2211,2021-05-25,PAB,3809,1968,1841,2935,874,ITH,ITH1,4,Provincia Autonoma Bolzano / Bozen,P.A. Bolzano,533050,104760,19.65,0.71
2212,2021-05-08,PAB,4426,2381,2045,3762,664,ITH,ITH1,4,Provincia Autonoma Bolzano / Bozen,P.A. Bolzano,533050,109186,20.48,0.83
2213,2021-02-16,PAB,530,205,325,530,0,ITH,ITH1,4,Provincia Autonoma Bolzano / Bozen,P.A. Bolzano,533050,109716,20.58,0.1
2214,2021-02-26,PAB,1526,551,975,1496,30,ITH,ITH1,4,Provincia Autonoma Bolzano / Bozen,P.A. Bolzano,533050,111242,20.87,0.29
2215,2021-06-01,PAB,2239,1506,733,1009,1230,ITH,ITH1,4,Provincia Autonoma Bolzano / Bozen,P.A. Bolzano,533050,113481,21.29,0.42
2216,2021-02-19,PAB,2252,512,1740,2241,11,ITH,ITH1,4,Provincia Autonoma Bolzano / Bozen,P.A. Bolzano,533050,115733,21.71,0.42
2217,2021-01-16,PAB,2840,1265,1575,2840,0,ITH,ITH1,4,Provincia Autonoma Bolzano / Bozen,P.A. Bolzano,533050,118573,22.24,0.53
2218,2021-04-26,PAB,1543,771,772,1538,5,ITH,ITH1,4,Provincia Autonoma Bolzano / Bozen,P.A. Bolzano,533050,120116,22.53,0.29
2219,2021-03-04,PAB,1711,1001,710,1482,229,ITH,ITH1,4,Provincia Autonoma Bolzano / Bozen,P.A. Bolzano,533050,121827,22.85,0.32
2220,2021-05-26,PAB,4798,2422,2376,2846,1952,ITH,ITH1,4,Provincia Autonoma Bolzano / Bozen,P.A. Bolzano,533050,126625,23.75,0.9
2221,2021-02-15,PAB,72,42,30,26,46,ITH,ITH1,4,Provincia Autonoma Bolzano / Bozen,P.A. Bolzano,533050,126697,23.77,0.01
2222,2021-04-22,PAB,2923,1500,1423,1981,942,ITH,ITH1,4,Provincia Autonoma Bolzano / Bozen,P.A. Bolzano,533050,129620,24.32,0.55
2223,2021-05-28,PAB,5622,2853,2769,3774,1848,ITH,ITH1,4,Provincia Autonoma Bolzano / Bozen,P.A. Bolzano,533050,135242,25.37,1.05
2224,2021-02-17,PAB,156,51,105,139,17,ITH,ITH1,4,Provincia Autonoma Bolzano / Bozen,P.A. Bolzano,533050,135398,25.4,0.03
2225,2021-05-20,PAB,4687,2309,2378,3231,1456,ITH,ITH1,4,Provincia Autonoma Bolzano / Bozen,P.A. Bolzano,533050,140085,26.28,0.88
2226,2021-03-31,PAB,1832,694,1138,821,1011,ITH,ITH1,4,Provincia Autonoma Bolzano / Bozen,P.A. Bolzano,533050,141917,26.62,0.34
2227,2021-01-05,PAB,830,286,544,830,0,ITH,ITH1,4,Provincia Autonoma Bolzano / Bozen,P.A. Bolzano,533050,142747,26.78,0.16
2228,2021-02-23,PAB,769,324,445,763,6,ITH,ITH1,4,Provincia Autonoma Bolzano / Bozen,P.A. Bolzano,533050,143516,26.92,0.14
2229,2021-04-14,PAB,3593,1645,1948,3502,91,ITH,ITH1,4,Provincia Autonoma Bolzano / Bozen,P.A. Bolzano,533050,147109,27.6,0.67
2230,2021-01-04,PAB,508,201,307,508,0,ITH,ITH1,4,Provincia Autonoma Bolzano / Bozen,P.A. Bolzano,533050,147617,27.69,0.1
2231,2021-01-20,PAB,617,252,365,409,208,ITH,ITH1,4,Provincia Autonoma Bolzano / Bozen,P.A. Bolzano,533050,148234,27.81,0.12
2232,2021-01-06,PAB,59,18,41,59,0,ITH,ITH1,4,Provincia Autonoma Bolzano / Bozen,P.A. Bolzano,533050,148293,27.82,0.01
2233,2021-03-11,PAB,1681,823,858,1143,538,ITH,ITH1,4,Provincia Autonoma Bolzano / Bozen,P.A. Bolzano,533050,149974,28.14,0.32
2234,2021-05-19,PAB,3570,1816,1754,1807,1763,ITH,ITH1,4,Provincia Autonoma Bolzano / Bozen,P.A. Bolzano,533050,153544,28.8,0.67
2235,2021-01-03,PAB,41,16,25,41,0,ITH,ITH1,4,Provincia Autonoma Bolzano / Bozen,P.A. Bolzano,533050,153585,28.81,0.01
2236,2021-02-22,PAB,526,143,383,514,12,ITH,ITH1,4,Provincia Autonoma Bolzano / Bozen,P.A. Bolzano,533050,154111,28.91,0.1
2237,2021-02-07,PAB,2361,1057,1304,14,2347,ITH,ITH1,4,Provincia Autonoma Bolzano / Bozen,P.A. Bolzano,533050,156472,29.35,0.44
2238,2021-01-21,PAB,953,442,511,139,814,ITH,ITH1,4,Provincia Autonoma Bolzano / Bozen,P.A. Bolzano,533050,157425,29.53,0.18
2239,2021-01-18,PAB,1772,687,1085,1767,5,ITH,ITH1,4,Provincia Autonoma Bolzano / Bozen,P.A. Bolzano,533050,159197,29.87,0.33
2240,2021-05-07,PAB,4181,2055,2126,3663,518,ITH,ITH1,4,Provincia Autonoma Bolzano / Bozen,P.A. Bolzano,533050,163378,30.65,0.78
2241,2021-05-05,PAB,4154,1945,2209,2038,2116,ITH,ITH1,4,Provincia Autonoma Bolzano / Bozen,P.A. Bolzano,533050,167532,31.43,0.78
2242,2021-01-25,PAB,487,183,304,3,484,ITH,ITH1,4,Provincia Autonoma Bolzano / Bozen,P.A. Bolzano,533050,168019,31.52,0.09
2243,2021-03-23,PAB,1552,759,793,1551,1,ITH,ITH1,4,Provincia Autonoma Bolzano / Bozen,P.A. Bolzano,533050,169571,31.81,0.29
2244,2021-04-01,PAB,2786,1407,1379,2642,144,ITH,ITH1,4,Provincia Autonoma Bolzano / Bozen,P.A. Bolzano,533050,172357,32.33,0.52
2245,2021-04-10,PAB,5390,2664,2726,4802,588,ITH,ITH1,4,Provincia Autonoma Bolzano / Bozen,P.A. Bolzano,533050,177747,33.35,1.01
2246,2021-04-19,PAB,1871,858,1013,1689,182,ITH,ITH1,4,Provincia Autonoma Bolzano / Bozen,P.A. Bolzano,533050,179618,33.7,0.35
2247,2021-01-07,PAB,917,327,590,917,0,ITH,ITH1,4,Provincia Autonoma Bolzano / Bozen,P.A. Bolzano,533050,180535,33.87,0.17
2248,2021-03-07,PAB,114,13,101,9,105,ITH,ITH1,4,Provincia Autonoma Bolzano / Bozen,P.A. Bolzano,533050,180649,33.89,0.02
2249,2021-01-02,PAB,91,48,43,91,0,ITH,ITH1,4,Provincia Autonoma Bolzano / Bozen,P.A. Bolzano,533050,180740,33.91,0.02
2250,2021-02-18,PAB,1839,457,1382,1832,7,ITH,ITH1,4,Provincia Autonoma Bolzano / Bozen,P.A. Bolzano,533050,182579,34.25,0.34
2251,2020-12-30,PAB,388,182,206,388,0,ITH,ITH1,4,Provincia Autonoma Bolzano / Bozen,P.A. Bolzano,533050,182967,34.32,0.07
2252,2021-03-15,PAB,1192,451,741,710,482,ITH,ITH1,4,Provincia Autonoma Bolzano / Bozen,P.A. Bolzano,533050,184159,34.55,0.22
2253,2021-04-27,PAB,2226,1013,1213,1150,1076,ITH,ITH1,4,Provincia Autonoma Bolzano / Bozen,P.A. Bolzano,533050,186385,34.97,0.42
2254,2021-01-10,PAB,2,2,0,2,0,ITH,ITH1,4,Provincia Autonoma Bolzano / Bozen,P.A. Bolzano,533050,186387,34.97,0.0
2255,2021-03-08,PAB,1200,526,674,1173,27,ITH,ITH1,4,Provincia Autonoma Bolzano / Bozen,P.A. Bolzano,533050,187587,35.19,0.23
2256,2021-04-23,PAB,4542,2151,2391,3251,1291,ITH,ITH1,4,Provincia Autonoma Bolzano / Bozen,P.A. Bolzano,533050,192129,36.04,0.85
2257,2021-01-11,PAB,1570,513,1057,1570,0,ITH,ITH1,4,Provincia Autonoma Bolzano / Bozen,P.A. Bolzano,533050,193699,36.34,0.29
2258,2021-04-06,PAB,2249,1117,1132,2146,103,ITH,ITH1,4,Provincia Autonoma Bolzano / Bozen,P.A. Bolzano,533050,195948,36.76,0.42
2259,2021-03-18,PAB,1302,531,771,226,1076,ITH,ITH1,4,Provincia Autonoma Bolzano / Bozen,P.A. Bolzano,533050,197250,37.0,0.24
2260,2021-05-12,PAB,3776,2048,1728,3623,153,ITH,ITH1,4,Provincia Autonoma Bolzano / Bozen,P.A. Bolzano,533050,201026,37.71,0.71
2261,2021-03-09,PAB,1194,543,651,1192,2,ITH,ITH1,4,Provincia Autonoma Bolzano / Bozen,P.A. Bolzano,533050,202220,37.94,0.22
2262,2021-02-03,PAB,1503,478,1025,5,1498,ITH,ITH1,4,Provincia Autonoma Bolzano / Bozen,P.A. Bolzano,533050,203723,38.22,0.28
2263,2021-05-21,PAB,6834,3730,3104,5057,1777,ITH,ITH1,4,Provincia Autonoma Bolzano / Bozen,P.A. Bolzano,533050,210557,39.5,1.28
2264,2021-03-01,PAB,922,221,701,921,1,ITH,ITH1,4,Provincia Autonoma Bolzano / Bozen,P.A. Bolzano,533050,211479,39.67,0.17
2265,2021-01-17,PAB,2328,1044,1284,2317,11,ITH,ITH1,4,Provincia Autonoma Bolzano / Bozen,P.A. Bolzano,533050,213807,40.11,0.44
2266,2021-04-20,PAB,1560,783,777,1559,1,ITH,ITH1,4,Provincia Autonoma Bolzano / Bozen,P.A. Bolzano,533050,215367,40.4,0.29
2267,2021-05-04,PAB,3447,1843,1604,2410,1037,ITH,ITH1,4,Provincia Autonoma Bolzano / Bozen,P.A. Bolzano,533050,218814,41.05,0.65
2268,2021-02-24,PAB,1367,406,961,1355,12,ITH,ITH1,4,Provincia Autonoma Bolzano / Bozen,P.A. Bolzano,533050,220181,41.31,0.26
2269,2021-04-15,PAB,4399,2307,2092,4136,263,ITH,ITH1,4,Provincia Autonoma Bolzano / Bozen,P.A. Bolzano,533050,224580,42.13,0.83
2270,2021-05-31,PAB,2983,1461,1522,2116,867,ITH,ITH1,4,Provincia Autonoma Bolzano / Bozen,P.A. Bolzano,533050,227563,42.69,0.56
2271,2021-01-01,PAB,6,5,1,6,0,ITH,ITH1,4,Provincia Autonoma Bolzano / Bozen,P.A. Bolzano,533050,227569,42.69,0.0
2272,2021-02-27,PAB,2458,759,1699,2448,10,ITH,ITH1,4,Provincia Autonoma Bolzano / Bozen,P.A. Bolzano,533050,230027,43.15,0.46
2273,2021-02-13,PAB,318,79,239,312,6,ITH,ITH1,4,Provincia Autonoma Bolzano / Bozen,P.A. Bolzano,533050,230345,43.21,0.06
2274,2021-04-11,PAB,2720,1291,1429,2543,177,ITH,ITH1,4,Provincia Autonoma Bolzano / Bozen,P.A. Bolzano,533050,233065,43.72,0.51
2275,2021-05-24,PAB,1442,761,681,1109,333,ITH,ITH1,4,Provincia Autonoma Bolzano / Bozen,P.A. Bolzano,533050,234507,43.99,0.27
2276,2021-02-20,PAB,1802,540,1262,1784,18,ITH,ITH1,4,Provincia Autonoma Bolzano / Bozen,P.A. Bolzano,533050,236309,44.33,0.34
2277,2021-04-18,PAB,3110,1607,1503,2100,1010,ITH,ITH1,4,Provincia Autonoma Bolzano / Bozen,P.A. Bolzano,533050,239419,44.91,0.58
2278,2021-01-15,PAB,3282,1228,2054,3282,0,ITH,ITH1,4,Provincia Autonoma Bolzano / Bozen,P.A. Bolzano,533050,242701,45.53,0.62
2279,2021-03-25,PAB,2141,1059,1082,1698,443,ITH,ITH1,4,Provincia Autonoma Bolzano / Bozen,P.A. Bolzano,533050,244842,45.93,0.4
2280,2021-01-27,PAB,84,28,56,1,83,ITH,ITH1,4,Provincia Autonoma Bolzano / Bozen,P.A. Bolzano,533050,244926,45.95,0.02
2281,2021-05-11,PAB,2842,1334,1508,1320,1522,ITH,ITH1,4,Provincia Autonoma Bolzano / Bozen,P.A. Bolzano,533050,247768,46.48,0.53
2282,2021-01-29,PAB,1497,510,987,24,1473,ITH,ITH1,4,Provincia Autonoma Bolzano / Bozen,P.A. Bolzano,533050,249265,46.76,0.28
2283,2021-05-09,PAB,4234,2405,1829,3081,1153,ITH,ITH1,4,Provincia Autonoma Bolzano / Bozen,P.A. Bolzano,533050,253499,47.56,0.79
2284,2021-03-06,PAB,3969,2079,1890,3758,211,ITH,ITH1,4,Provincia Autonoma Bolzano / Bozen,P.A. Bolzano,533050,257468,48.3,0.74
2285,2021-05-30,PAB,4758,2514,2244,752,4006,ITH,ITH1,4,Provincia Autonoma Bolzano / Bozen,P.A. Bolzano,533050,262226,49.19,0.89
2286,2021-04-03,PAB,831,364,467,22,809,ITH,ITH1,4,Provincia Autonoma Bolzano / Bozen,P.A. Bolzano,533050,263057,49.35,0.16
2287,2021-04-25,PAB,3071,1496,1575,2400,671,ITH,ITH1,4,Provincia Autonoma Bolzano / Bozen,P.A. Bolzano,533050,266128,49.93,0.58
2288,2021-01-13,PAB,1691,557,1134,1691,0,ITH,ITH1,4,Provincia Autonoma Bolzano / Bozen,P.A. Bolzano,533050,267819,50.24,0.32
2289,2021-01-30,PAB,498,245,253,4,494,ITH,ITH1,4,Provincia Autonoma Bolzano / Bozen,P.A. Bolzano,533050,268317,50.34,0.09
2290,2021-04-08,PAB,2754,1336,1418,2551,203,ITH,ITH1,4,Provincia Autonoma Bolzano / Bozen,P.A. Bolzano,533050,271071,50.85,0.52
2291,2020-12-27,PAB,144,65,79,144,0,ITH,ITH1,4,Provincia Autonoma Bolzano / Bozen,P.A. Bolzano,533050,271215,50.88,0.03
2292,2021-05-14,PAB,5087,2290,2797,3071,2016,ITH,ITH1,4,Provincia Autonoma Bolzano / Bozen,P.A. Bolzano,533050,276302,51.83,0.95
2293,2021-03-16,PAB,1290,532,758,124,1166,ITH,ITH1,4,Provincia Autonoma Bolzano / Bozen,P.A. Bolzano,533050,277592,52.08,0.24
2294,2021-02-01,PAB,1452,440,1012,12,1440,ITH,ITH1,4,Provincia Autonoma Bolzano / Bozen,P.A. Bolzano,533050,279044,52.35,0.27
2295,2021-05-23,PAB,4332,2302,2030,4324,8,ITH,ITH1,4,Provincia Autonoma Bolzano / Bozen,P.A. Bolzano,533050,283376,53.16,0.81
2296,2021-02-10,PAB,1635,604,1031,26,1609,ITH,ITH1,4,Provincia Autonoma Bolzano / Bozen,P.A. Bolzano,533050,285011,53.47,0.31
2297,2021-01-08,PAB,1521,479,1042,1521,0,ITH,ITH1,4,Provincia Autonoma Bolzano / Bozen,P.A. Bolzano,533050,286532,53.75,0.29
2298,2021-04-30,PAB,3337,1592,1745,1562,1775,ITH,ITH1,4,Provincia Autonoma Bolzano / Bozen,P.A. Bolzano,533050,289869,54.38,0.63
2299,2021-03-30,PAB,1298,532,766,218,1080,ITH,ITH1,4,Provincia Autonoma Bolzano / Bozen,P.A. Bolzano,533050,291167,54.62,0.24
2300,2021-04-16,PAB,2949,1418,1531,2438,511,ITH,ITH1,4,Provincia Autonoma Bolzano / Bozen,P.A. Bolzano,533050,294116,55.18,0.55
2301,2021-02-25,PAB,1498,549,949,1497,1,ITH,ITH1,4,Provincia Autonoma Bolzano / Bozen,P.A. Bolzano,533050,295614,55.46,0.28
2302,2021-02-08,PAB,2,1,1,1,1,ITH,ITH1,4,Provincia Autonoma Bolzano / Bozen,P.A. Bolzano,533050,295616,55.46,0.0
2303,2021-04-13,PAB,2391,1130,1261,2384,7,ITH,ITH1,4,Provincia Autonoma Bolzano / Bozen,P.A. Bolzano,533050,298007,55.91,0.45
2304,2021-03-20,PAB,1757,848,909,1132,625,ITH,ITH1,4,Provincia Autonoma Bolzano / Bozen,P.A. Bolzano,533050,299764,56.24,0.33
2305,2021-05-16,PAB,2024,931,1093,1330,694,ITH,ITH1,4,Provincia Autonoma Bolzano / Bozen,P.A. Bolzano,533050,301788,56.62,0.38
2306,2021-01-23,PAB,197,117,80,0,197,ITH,ITH1,4,Provincia Autonoma Bolzano / Bozen,P.A. Bolzano,533050,301985,56.65,0.04
2307,2021-05-03,PAB,1829,846,983,417,1412,ITH,ITH1,4,Provincia Autonoma Bolzano / Bozen,P.A. Bolzano,533050,303814,57.0,0.34
2308,2021-05-17,PAB,3109,1499,1610,2425,684,ITH,ITH1,4,Provincia Autonoma Bolzano / Bozen,P.A. Bolzano,533050,306923,57.58,0.58
2309,2021-03-14,PAB,758,336,422,25,733,ITH,ITH1,4,Provincia Autonoma Bolzano / Bozen,P.A. Bolzano,533050,307681,57.72,0.14
2310,2021-02-06,PAB,2626,1171,1455,19,2607,ITH,ITH1,4,Provincia Autonoma Bolzano / Bozen,P.A. Bolzano,533050,310307,58.21,0.49
2311,2021-03-28,PAB,569,212,357,11,558,ITH,ITH1,4,Provincia Autonoma Bolzano / Bozen,P.A. Bolzano,533050,310876,58.32,0.11
2312,2021-03-27,PAB,3049,1553,1496,1543,1506,ITH,ITH1,4,Provincia Autonoma Bolzano / Bozen,P.A. Bolzano,533050,313925,58.89,0.57
2313,2021-03-13,PAB,2885,1459,1426,2784,101,ITH,ITH1,4,Provincia Autonoma Bolzano / Bozen,P.A. Bolzano,533050,316810,59.43,0.54
2314,2021-02-05,PAB,3195,1181,2014,8,3187,ITH,ITH1,4,Provincia Autonoma Bolzano / Bozen,P.A. Bolzano,533050,320005,60.03,0.6
2315,2021-05-02,PAB,2457,1288,1169,1536,921,ITH,ITH1,4,Provincia Autonoma Bolzano / Bozen,P.A. Bolzano,533050,322462,60.49,0.46
2316,2021-01-22,PAB,248,143,105,124,124,ITH,ITH1,4,Provincia Autonoma Bolzano / Bozen,P.A. Bolzano,533050,322710,60.54,0.05
2317,2021-04-15,BAS,3386,1659,1727,2632,754,ITF,ITF5,17,Basilicata,Basilicata,559084,3386,0.61,0.61
2318,2021-01-03,BAS,901,344,557,901,0,ITF,ITF5,17,Basilicata,Basilicata,559084,4287,0.77,0.16
2319,2021-03-29,BAS,2435,881,1554,2149,286,ITF,ITF5,17,Basilicata,Basilicata,559084,6722,1.2,0.44
2320,2021-01-05,BAS,946,409,537,946,0,ITF,ITF5,17,Basilicata,Basilicata,559084,7668,1.37,0.17
2321,2021-04-08,BAS,764,348,416,754,10,ITF,ITF5,17,Basilicata,Basilicata,559084,8432,1.51,0.14
2322,2021-05-28,BAS,3609,1804,1805,949,2660,ITF,ITF5,17,Basilicata,Basilicata,559084,12041,2.15,0.65
2323,2021-05-11,BAS,2654,1353,1301,1621,1033,ITF,ITF5,17,Basilicata,Basilicata,559084,14695,2.63,0.47
2324,2021-03-22,BAS,1175,531,644,628,547,ITF,ITF5,17,Basilicata,Basilicata,559084,15870,2.84,0.21
2325,2021-05-25,BAS,4191,2107,2084,873,3318,ITF,ITF5,17,Basilicata,Basilicata,559084,20061,3.59,0.75
2326,2021-05-04,BAS,4139,1992,2147,3616,523,ITF,ITF5,17,Basilicata,Basilicata,559084,24200,4.33,0.74
2327,2021-03-08,BAS,1455,710,745,843,612,ITF,ITF5,17,Basilicata,Basilicata,559084,25655,4.59,0.26
2328,2021-04-13,BAS,2115,1053,1062,1295,820,ITF,ITF5,17,Basilicata,Basilicata,559084,27770,4.97,0.38
2329,2021-03-01,BAS,547,284,263,381,166,ITF,ITF5,17,Basilicata,Basilicata,559084,28317,5.06,0.1
2330,2021-01-24,BAS,837,300,537,58,779,ITF,ITF5,17,Basilicata,Basilicata,559084,29154,5.21,0.15
2331,2021-05-13,BAS,5983,2967,3016,3386,2597,ITF,ITF5,17,Basilicata,Basilicata,559084,35137,6.28,1.07
2332,2021-03-25,BAS,1879,601,1278,1533,346,ITF,ITF5,17,Basilicata,Basilicata,559084,37016,6.62,0.34
2333,2021-05-21,BAS,4579,2324,2255,1498,3081,ITF,ITF5,17,Basilicata,Basilicata,559084,41595,7.44,0.82
2334,2021-02-03,BAS,666,300,366,32,634,ITF,ITF5,17,Basilicata,Basilicata,559084,42261,7.56,0.12
2335,2021-06-01,BAS,4268,1992,2276,2012,2256,ITF,ITF5,17,Basilicata,Basilicata,559084,46529,8.32,0.76
2336,2021-04-12,BAS,2190,1056,1134,1698,492,ITF,ITF5,17,Basilicata,Basilicata,559084,48719,8.71,0.39
2337,2021-02-24,BAS,1803,743,1060,1734,69,ITF,ITF5,17,Basilicata,Basilicata,559084,50522,9.04,0.32
2338,2021-03-13,BAS,1796,889,907,751,1045,ITF,ITF5,17,Basilicata,Basilicata,559084,52318,9.36,0.32
2339,2021-02-07,BAS,373,159,214,49,324,ITF,ITF5,17,Basilicata,Basilicata,559084,52691,9.42,0.07
2340,2021-05-20,BAS,5856,2965,2891,2891,2965,ITF,ITF5,17,Basilicata,Basilicata,559084,58547,10.47,1.05
2341,2021-01-10,BAS,77,24,53,77,0,ITF,ITF5,17,Basilicata,Basilicata,559084,58624,10.49,0.01
2342,2021-03-15,BAS,2352,983,1369,521,1831,ITF,ITF5,17,Basilicata,Basilicata,559084,60976,10.91,0.42
2343,2021-04-27,BAS,4725,2242,2483,4400,325,ITF,ITF5,17,Basilicata,Basilicata,559084,65701,11.75,0.85
2344,2021-01-19,BAS,199,84,115,199,0,ITF,ITF5,17,Basilicata,Basilicata,559084,65900,11.79,0.04
2345,2021-03-24,BAS,1753,688,1065,1358,395,ITF,ITF5,17,Basilicata,Basilicata,559084,67653,12.1,0.31
2346,2021-01-27,BAS,411,175,236,113,298,ITF,ITF5,17,Basilicata,Basilicata,559084,68064,12.17,0.07
2347,2021-02-10,BAS,547,237,310,495,52,ITF,ITF5,17,Basilicata,Basilicata,559084,68611,12.27,0.1
2348,2021-04-01,BAS,2810,1134,1676,2091,719,ITF,ITF5,17,Basilicata,Basilicata,559084,71421,12.77,0.5
2349,2021-04-19,BAS,4163,1910,2253,2526,1637,ITF,ITF5,17,Basilicata,Basilicata,559084,75584,13.52,0.74
2350,2021-01-22,BAS,67,24,43,67,0,ITF,ITF5,17,Basilicata,Basilicata,559084,75651,13.53,0.01
2351,2021-05-02,BAS,4179,2000,2179,3551,628,ITF,ITF5,17,Basilicata,Basilicata,559084,79830,14.28,0.75
2352,2021-04-17,BAS,3461,1655,1806,2199,1262,ITF,ITF5,17,Basilicata,Basilicata,559084,83291,14.9,0.62
2353,2021-02-22,BAS,1790,773,1017,1737,53,ITF,ITF5,17,Basilicata,Basilicata,559084,85081,15.22,0.32
2354,2021-05-18,BAS,5897,2856,3041,3403,2494,ITF,ITF5,17,Basilicata,Basilicata,559084,90978,16.27,1.05
2355,2021-05-01,BAS,4703,2135,2568,3952,751,ITF,ITF5,17,Basilicata,Basilicata,559084,95681,17.11,0.84
2356,2021-02-26,BAS,2149,904,1245,2069,80,ITF,ITF5,17,Basilicata,Basilicata,559084,97830,17.5,0.38
2357,2021-05-08,BAS,4833,2398,2435,3427,1406,ITF,ITF5,17,Basilicata,Basilicata,559084,102663,18.36,0.86
2358,2021-05-15,BAS,6527,3341,3186,3955,2572,ITF,ITF5,17,Basilicata,Basilicata,559084,109190,19.53,1.17
2359,2021-05-30,BAS,2773,1421,1352,923,1850,ITF,ITF5,17,Basilicata,Basilicata,559084,111963,20.03,0.5
2360,2021-04-03,BAS,1807,749,1058,1472,335,ITF,ITF5,17,Basilicata,Basilicata,559084,113770,20.35,0.32
2361,2021-02-05,BAS,984,443,541,64,920,ITF,ITF5,17,Basilicata,Basilicata,559084,114754,20.53,0.18
2362,2021-05-16,BAS,4969,2466,2503,2858,2111,ITF,ITF5,17,Basilicata,Basilicata,559084,119723,21.41,0.89
2363,2021-05-23,BAS,4768,2423,2345,1713,3055,ITF,ITF5,17,Basilicata,Basilicata,559084,124491,22.27,0.85
2364,2021-03-27,BAS,2232,852,1380,1817,415,ITF,ITF5,17,Basilicata,Basilicata,559084,126723,22.67,0.4
2365,2021-01-07,BAS,640,319,321,640,0,ITF,ITF5,17,Basilicata,Basilicata,559084,127363,22.78,0.11
2366,2021-02-19,BAS,1622,737,885,1560,62,ITF,ITF5,17,Basilicata,Basilicata,559084,128985,23.07,0.29
2367,2021-02-12,BAS,775,332,443,744,31,ITF,ITF5,17,Basilicata,Basilicata,559084,129760,23.21,0.14
2368,2021-04-10,BAS,1032,378,654,950,82,ITF,ITF5,17,Basilicata,Basilicata,559084,130792,23.39,0.18
2369,2021-03-31,BAS,3095,1258,1837,2313,782,ITF,ITF5,17,Basilicata,Basilicata,559084,133887,23.95,0.55
2370,2021-02-23,BAS,1901,771,1130,1763,138,ITF,ITF5,17,Basilicata,Basilicata,559084,135788,24.29,0.34
2371,2021-02-08,BAS,557,193,364,151,406,ITF,ITF5,17,Basilicata,Basilicata,559084,136345,24.39,0.1
2372,2021-05-19,BAS,2870,1498,1372,1194,1676,ITF,ITF5,17,Basilicata,Basilicata,559084,139215,24.9,0.51
2373,2020-12-27,BAS,106,41,65,106,0,ITF,ITF5,17,Basilicata,Basilicata,559084,139321,24.92,0.02
2374,2021-02-15,BAS,622,232,390,580,42,ITF,ITF5,17,Basilicata,Basilicata,559084,139943,25.03,0.11
2375,2021-05-27,BAS,3601,1855,1746,1076,2525,ITF,ITF5,17,Basilicata,Basilicata,559084,143544,25.67,0.64
2376,2021-01-12,BAS,217,88,129,217,0,ITF,ITF5,17,Basilicata,Basilicata,559084,143761,25.71,0.04
2377,2021-03-21,BAS,1046,481,565,352,694,ITF,ITF5,17,Basilicata,Basilicata,559084,144807,25.9,0.19
2378,2021-05-29,BAS,3012,1511,1501,831,2181,ITF,ITF5,17,Basilicata,Basilicata,559084,147819,26.44,0.54
2379,2021-01-13,BAS,916,387,529,916,0,ITF,ITF5,17,Basilicata,Basilicata,559084,148735,26.6,0.16
2380,2021-01-30,BAS,704,227,477,128,576,ITF,ITF5,17,Basilicata,Basilicata,559084,149439,26.73,0.13
2381,2021-04-22,BAS,5035,2345,2690,3433,1602,ITF,ITF5,17,Basilicata,Basilicata,559084,154474,27.63,0.9
2382,2021-02-17,BAS,1135,493,642,1059,76,ITF,ITF5,17,Basilicata,Basilicata,559084,155609,27.83,0.2
2383,2021-04-05,BAS,723,233,490,421,302,ITF,ITF5,17,Basilicata,Basilicata,559084,156332,27.96,0.13
2384,2021-03-03,BAS,1744,814,930,1186,558,ITF,ITF5,17,Basilicata,Basilicata,559084,158076,28.27,0.31
2385,2021-02-14,BAS,151,48,103,151,0,ITF,ITF5,17,Basilicata,Basilicata,559084,158227,28.3,0.03
2386,2021-01-31,BAS,77,24,53,0,77,ITF,ITF5,17,Basilicata,Basilicata,559084,158304,28.31,0.01
2387,2021-03-10,BAS,1676,839,837,837,839,ITF,ITF5,17,Basilicata,Basilicata,559084,159980,28.61,0.3
2388,2021-01-26,BAS,797,352,445,101,696,ITF,ITF5,17,Basilicata,Basilicata,559084,160777,28.76,0.14
2389,2021-05-06,BAS,5054,2435,2619,3485,1569,ITF,ITF5,17,Basilicata,Basilicata,559084,165831,29.66,0.9
2390,2021-02-02,BAS,367,143,224,175,192,ITF,ITF5,17,Basilicata,Basilicata,559084,166198,29.73,0.07
2391,2021-04-20,BAS,4033,1920,2113,2202,1831,ITF,ITF5,17,Basilicata,Basilicata,559084,170231,30.45,0.72
2392,2021-01-08,BAS,554,219,335,554,0,ITF,ITF5,17,Basilicata,Basilicata,559084,170785,30.55,0.1
2393,2021-01-17,BAS,328,133,195,327,1,ITF,ITF5,17,Basilicata,Basilicata,559084,171113,30.61,0.06
2394,2021-04-29,BAS,4830,2384,2446,4409,421,ITF,ITF5,17,Basilicata,Basilicata,559084,175943,31.47,0.86
2395,2021-03-17,BAS,1452,609,843,27,1425,ITF,ITF5,17,Basilicata,Basilicata,559084,177395,31.73,0.26
2396,2021-02-28,BAS,804,343,461,775,29,ITF,ITF5,17,Basilicata,Basilicata,559084,178199,31.87,0.14
2397,2021-01-16,BAS,721,304,417,721,0,ITF,ITF5,17,Basilicata,Basilicata,559084,178920,32.0,0.13
2398,2021-01-09,BAS,557,160,397,557,0,ITF,ITF5,17,Basilicata,Basilicata,559084,179477,32.1,0.1
2399,2021-05-07,BAS,4649,2284,2365,3294,1355,ITF,ITF5,17,Basilicata,Basilicata,559084,184126,32.93,0.83
2400,2021-04-28,BAS,4704,2158,2546,4263,441,ITF,ITF5,17,Basilicata,Basilicata,559084,188830,33.77,0.84
2401,2021-03-02,BAS,794,383,411,659,135,ITF,ITF5,17,Basilicata,Basilicata,559084,189624,33.92,0.14
2402,2021-04-21,BAS,3921,1835,2086,2271,1650,ITF,ITF5,17,Basilicata,Basilicata,559084,193545,34.62,0.7
2403,2021-01-18,BAS,463,157,306,364,99,ITF,ITF5,17,Basilicata,Basilicata,559084,194008,34.7,0.08
2404,2021-03-16,BAS,1903,801,1102,228,1675,ITF,ITF5,17,Basilicata,Basilicata,559084,195911,35.04,0.34
2405,2021-05-05,BAS,4333,2048,2285,3443,890,ITF,ITF5,17,Basilicata,Basilicata,559084,200244,35.82,0.78
2406,2021-03-09,BAS,1393,708,685,789,604,ITF,ITF5,17,Basilicata,Basilicata,559084,201637,36.07,0.25
2407,2021-01-25,BAS,1023,429,594,74,949,ITF,ITF5,17,Basilicata,Basilicata,559084,202660,36.25,0.18
2408,2021-01-21,BAS,30,10,20,30,0,ITF,ITF5,17,Basilicata,Basilicata,559084,202690,36.25,0.01
2409,2021-01-04,BAS,607,271,336,607,0,ITF,ITF5,17,Basilicata,Basilicata,559084,203297,36.36,0.11
2410,2021-05-03,BAS,4513,2043,2470,3686,827,ITF,ITF5,17,Basilicata,Basilicata,559084,207810,37.17,0.81
2411,2021-03-04,BAS,1879,892,987,1084,795,ITF,ITF5,17,Basilicata,Basilicata,559084,209689,37.51,0.34
2412,2021-05-22,BAS,5556,2761,2795,2005,3551,ITF,ITF5,17,Basilicata,Basilicata,559084,215245,38.5,0.99
2413,2021-02-13,BAS,799,313,486,738,61,ITF,ITF5,17,Basilicata,Basilicata,559084,216044,38.64,0.14
2414,2021-04-18,BAS,3720,1847,1873,2353,1367,ITF,ITF5,17,Basilicata,Basilicata,559084,219764,39.31,0.67
2415,2021-05-31,BAS,4061,1934,2127,1696,2365,ITF,ITF5,17,Basilicata,Basilicata,559084,223825,40.03,0.73
2416,2021-02-18,BAS,1070,401,669,855,215,ITF,ITF5,17,Basilicata,Basilicata,559084,224895,40.23,0.19
2417,2021-01-02,BAS,949,380,569,949,0,ITF,ITF5,17,Basilicata,Basilicata,559084,225844,40.4,0.17
2418,2021-04-26,BAS,4464,2164,2300,4244,220,ITF,ITF5,17,Basilicata,Basilicata,559084,230308,41.19,0.8
2419,2021-02-21,BAS,284,113,171,284,0,ITF,ITF5,17,Basilicata,Basilicata,559084,230592,41.24,0.05
2420,2021-03-07,BAS,887,309,578,849,38,ITF,ITF5,17,Basilicata,Basilicata,559084,231479,41.4,0.16
2421,2021-05-14,BAS,5906,2797,3109,3374,2532,ITF,ITF5,17,Basilicata,Basilicata,559084,237385,42.46,1.06
2422,2021-02-16,BAS,905,377,528,807,98,ITF,ITF5,17,Basilicata,Basilicata,559084,238290,42.62,0.16
2423,2021-04-07,BAS,1218,549,669,1181,37,ITF,ITF5,17,Basilicata,Basilicata,559084,239508,42.84,0.22
2424,2021-05-12,BAS,4722,2324,2398,2839,1883,ITF,ITF5,17,Basilicata,Basilicata,559084,244230,43.68,0.84
2425,2021-04-06,BAS,1266,461,805,1082,184,ITF,ITF5,17,Basilicata,Basilicata,559084,245496,43.91,0.23
2426,2021-03-23,BAS,1584,608,976,1409,175,ITF,ITF5,17,Basilicata,Basilicata,559084,247080,44.19,0.28
2427,2021-03-14,BAS,1008,477,531,539,469,ITF,ITF5,17,Basilicata,Basilicata,559084,248088,44.37,0.18
2428,2021-03-12,BAS,1901,978,923,802,1099,ITF,ITF5,17,Basilicata,Basilicata,559084,249989,44.71,0.34
2429,2021-05-17,BAS,5542,2735,2807,3409,2133,ITF,ITF5,17,Basilicata,Basilicata,559084,255531,45.71,0.99
2430,2021-02-25,BAS,1787,736,1051,1741,46,ITF,ITF5,17,Basilicata,Basilicata,559084,257318,46.02,0.32
2431,2021-02-06,BAS,902,367,535,146,756,ITF,ITF5,17,Basilicata,Basilicata,559084,258220,46.19,0.16
2432,2021-04-30,BAS,5284,2373,2911,4121,1163,ITF,ITF5,17,Basilicata,Basilicata,559084,263504,47.13,0.95
2433,2021-01-20,BAS,84,22,62,84,0,ITF,ITF5,17,Basilicata,Basilicata,559084,263588,47.15,0.02
2434,2021-04-02,BAS,2318,1046,1272,1714,604,ITF,ITF5,17,Basilicata,Basilicata,559084,265906,47.56,0.41
2435,2021-02-04,BAS,1096,442,654,63,1033,ITF,ITF5,17,Basilicata,Basilicata,559084,267002,47.76,0.2
2436,2021-04-09,BAS,1152,350,802,1089,63,ITF,ITF5,17,Basilicata,Basilicata,559084,268154,47.96,0.21
2437,2021-02-27,BAS,1992,860,1132,1828,164,ITF,ITF5,17,Basilicata,Basilicata,559084,270146,48.32,0.36
2438,2021-04-11,BAS,867,339,528,805,62,ITF,ITF5,17,Basilicata,Basilicata,559084,271013,48.47,0.16
2439,2021-04-04,BAS,610,225,385,197,413,ITF,ITF5,17,Basilicata,Basilicata,559084,271623,48.58,0.11
2440,2021-04-14,BAS,2054,998,1056,1380,674,ITF,ITF5,17,Basilicata,Basilicata,559084,273677,48.95,0.37
2441,2021-01-23,BAS,719,303,416,33,686,ITF,ITF5,17,Basilicata,Basilicata,559084,274396,49.08,0.13
2442,2021-02-09,BAS,491,213,278,316,175,ITF,ITF5,17,Basilicata,Basilicata,559084,274887,49.17,0.09
2443,2021-03-28,BAS,2139,741,1398,2122,17,ITF,ITF5,17,Basilicata,Basilicata,559084,277026,49.55,0.38
2444,2021-03-11,BAS,1790,924,866,831,959,ITF,ITF5,17,Basilicata,Basilicata,559084,278816,49.87,0.32
2445,2021-02-01,BAS,242,91,151,46,196,ITF,ITF5,17,Basilicata,Basilicata,559084,279058,49.91,0.04
2446,2021-05-26,BAS,4471,2247,2224,1707,2764,ITF,ITF5,17,Basilicata,Basilicata,559084,283529,50.71,0.8
2447,2021-02-11,BAS,951,401,550,868,83,ITF,ITF5,17,Basilicata,Basilicata,559084,284480,50.88,0.17
2448,2021-03-26,BAS,1957,703,1254,1696,261,ITF,ITF5,17,Basilicata,Basilicata,559084,286437,51.23,0.35
2449,2021-05-24,BAS,4825,2340,2485,1103,3722,ITF,ITF5,17,Basilicata,Basilicata,559084,291262,52.1,0.86
2450,2021-02-20,BAS,1161,531,630,1043,118,ITF,ITF5,17,Basilicata,Basilicata,559084,292423,52.3,0.21
2451,2021-03-18,BAS,1349,563,786,25,1324,ITF,ITF5,17,Basilicata,Basilicata,559084,293772,52.55,0.24
2452,2021-05-10,BAS,4807,2384,2423,2767,2040,ITF,ITF5,17,Basilicata,Basilicata,559084,298579,53.41,0.86
2453,2021-04-23,BAS,4538,2187,2351,3538,1000,ITF,ITF5,17,Basilicata,Basilicata,559084,303117,54.22,0.81
2454,2021-01-06,BAS,294,129,165,294,0,ITF,ITF5,17,Basilicata,Basilicata,559084,303411,54.27,0.05
2455,2021-03-30,BAS,2739,1156,1583,2394,345,ITF,ITF5,17,Basilicata,Basilicata,559084,306150,54.76,0.49
2456,2021-04-16,BAS,3319,1632,1687,2421,898,ITF,ITF5,17,Basilicata,Basilicata,559084,309469,55.35,0.59
2457,2021-01-11,BAS,183,66,117,183,0,ITF,ITF5,17,Basilicata,Basilicata,559084,309652,55.39,0.03
2458,2021-01-15,BAS,813,350,463,813,0,ITF,ITF5,17,Basilicata,Basilicata,559084,310465,55.53,0.15
2459,2021-03-20,BAS,1287,567,720,275,1012,ITF,ITF5,17,Basilicata,Basilicata,559084,311752,55.76,0.23
2460,2021-03-06,BAS,1354,536,818,758,596,ITF,ITF5,17,Basilicata,Basilicata,559084,313106,56.0,0.24
2461,2021-05-09,BAS,4687,2342,2345,2992,1695,ITF,ITF5,17,Basilicata,Basilicata,559084,317793,56.84,0.84
2462,2021-01-29,BAS,615,230,385,63,552,ITF,ITF5,17,Basilicata,Basilicata,559084,318408,56.95,0.11
2463,2021-03-05,BAS,1855,857,998,1109,746,ITF,ITF5,17,Basilicata,Basilicata,559084,320263,57.28,0.33
2464,2021-04-24,BAS,4544,2197,2347,3532,1012,ITF,ITF5,17,Basilicata,Basilicata,559084,324807,58.1,0.81
2465,2021-03-19,BAS,2290,992,1298,262,2028,ITF,ITF5,17,Basilicata,Basilicata,559084,327097,58.51,0.41
2466,2021-01-28,BAS,903,401,502,119,784,ITF,ITF5,17,Basilicata,Basilicata,559084,328000,58.67,0.16
2467,2021-01-14,BAS,969,413,556,969,0,ITF,ITF5,17,Basilicata,Basilicata,559084,328969,58.84,0.17
2468,2021-04-25,BAS,2985,1458,1527,2932,53,ITF,ITF5,17,Basilicata,Basilicata,559084,331954,59.37,0.53
2469,2021-01-17,MOL,78,38,40,48,30,ITF,ITF2,14,Molise,Molise,305617,78,0.03,0.03
2470,2021-04-10,MOL,2635,1259,1376,2483,152,ITF,ITF2,14,Molise,Molise,305617,2713,0.89,0.86
2471,2021-02-05,MOL,593,269,324,55,538,ITF,ITF2,14,Molise,Molise,305617,3306,1.08,0.19
2472,2021-04-12,MOL,1299,557,742,1048,251,ITF,ITF2,14,Molise,Molise,305617,4605,1.51,0.43
2473,2021-03-07,MOL,1132,501,631,1130,2,ITF,ITF2,14,Molise,Molise,305617,5737,1.88,0.37
2474,2021-02-12,MOL,330,149,181,208,122,ITF,ITF2,14,Molise,Molise,305617,6067,1.99,0.11
2475,2021-03-15,MOL,832,338,494,587,245,ITF,ITF2,14,Molise,Molise,305617,6899,2.26,0.27
2476,2021-03-02,MOL,667,383,284,509,158,ITF,ITF2,14,Molise,Molise,305617,7566,2.48,0.22
2477,2021-05-08,MOL,2972,1453,1519,1728,1244,ITF,ITF2,14,Molise,Molise,305617,10538,3.45,0.97
2478,2021-04-21,MOL,1862,788,1074,967,895,ITF,ITF2,14,Molise,Molise,305617,12400,4.06,0.61
2479,2021-02-07,MOL,66,32,34,19,47,ITF,ITF2,14,Molise,Molise,305617,12466,4.08,0.02
2480,2021-05-18,MOL,1645,877,768,990,655,ITF,ITF2,14,Molise,Molise,305617,14111,4.62,0.54
2481,2021-03-22,MOL,1146,439,707,903,243,ITF,ITF2,14,Molise,Molise,305617,15257,4.99,0.37
2482,2021-05-25,MOL,1960,885,1075,1330,630,ITF,ITF2,14,Molise,Molise,305617,17217,5.63,0.64
2483,2021-05-01,MOL,2641,1266,1375,420,2221,ITF,ITF2,14,Molise,Molise,305617,19858,6.5,0.86
2484,2021-03-05,MOL,1219,649,570,1015,204,ITF,ITF2,14,Molise,Molise,305617,21077,6.9,0.4
2485,2021-04-17,MOL,3051,1500,1551,1565,1486,ITF,ITF2,14,Molise,Molise,305617,24128,7.89,1.0
2486,2021-02-26,MOL,563,260,303,490,73,ITF,ITF2,14,Molise,Molise,305617,24691,8.08,0.18
2487,2021-03-19,MOL,1184,482,702,757,427,ITF,ITF2,14,Molise,Molise,305617,25875,8.47,0.39
2488,2021-01-14,MOL,646,239,407,646,0,ITF,ITF2,14,Molise,Molise,305617,26521,8.68,0.21
2489,2021-05-10,MOL,2889,1285,1604,2516,373,ITF,ITF2,14,Molise,Molise,305617,29410,9.62,0.95
2490,2021-05-03,MOL,2484,1164,1320,2321,163,ITF,ITF2,14,Molise,Molise,305617,31894,10.44,0.81
2491,2021-03-10,MOL,1737,720,1017,1687,50,ITF,ITF2,14,Molise,Molise,305617,33631,11.0,0.57
2492,2021-05-13,MOL,3037,1409,1628,2580,457,ITF,ITF2,14,Molise,Molise,305617,36668,12.0,0.99
2493,2021-02-21,MOL,573,227,346,571,2,ITF,ITF2,14,Molise,Molise,305617,37241,12.19,0.19
2494,2021-02-04,MOL,758,295,463,77,681,ITF,ITF2,14,Molise,Molise,305617,37999,12.43,0.25
2495,2021-04-26,MOL,1157,521,636,826,331,ITF,ITF2,14,Molise,Molise,305617,39156,12.81,0.38
2496,2021-03-29,MOL,2033,835,1198,1547,486,ITF,ITF2,14,Molise,Molise,305617,41189,13.48,0.67
2497,2021-02-23,MOL,582,223,359,363,219,ITF,ITF2,14,Molise,Molise,305617,41771,13.67,0.19
2498,2021-04-07,MOL,1688,847,841,1413,275,ITF,ITF2,14,Molise,Molise,305617,43459,14.22,0.55
2499,2021-04-24,MOL,2540,1197,1343,699,1841,ITF,ITF2,14,Molise,Molise,305617,45999,15.05,0.83
2500,2021-01-21,MOL,6,2,4,6,0,ITF,ITF2,14,Molise,Molise,305617,46005,15.05,0.0
2501,2021-01-28,MOL,613,217,396,17,596,ITF,ITF2,14,Molise,Molise,305617,46618,15.25,0.2
2502,2021-03-12,MOL,1459,637,822,1423,36,ITF,ITF2,14,Molise,Molise,305617,48077,15.73,0.48
2503,2021-03-24,MOL,1631,658,973,1229,402,ITF,ITF2,14,Molise,Molise,305617,49708,16.26,0.53
2504,2021-01-19,MOL,173,63,110,162,11,ITF,ITF2,14,Molise,Molise,305617,49881,16.32,0.06
2505,2021-04-29,MOL,2237,1144,1093,890,1347,ITF,ITF2,14,Molise,Molise,305617,52118,17.05,0.73
2506,2021-03-26,MOL,2575,1045,1530,1933,642,ITF,ITF2,14,Molise,Molise,305617,54693,17.9,0.84
2507,2021-02-19,MOL,169,93,76,167,2,ITF,ITF2,14,Molise,Molise,305617,54862,17.95,0.06
2508,2021-06-01,MOL,2214,1139,1075,2153,61,ITF,ITF2,14,Molise,Molise,305617,57076,18.68,0.72
2509,2021-04-28,MOL,1683,913,770,466,1217,ITF,ITF2,14,Molise,Molise,305617,58759,19.23,0.55
2510,2021-05-15,MOL,2979,1398,1581,2595,384,ITF,ITF2,14,Molise,Molise,305617,61738,20.2,0.97
2511,2021-02-02,MOL,539,176,363,216,323,ITF,ITF2,14,Molise,Molise,305617,62277,20.38,0.18
2512,2021-01-16,MOL,420,166,254,420,0,ITF,ITF2,14,Molise,Molise,305617,62697,20.51,0.14
2513,2021-05-20,MOL,2572,1325,1247,2397,175,ITF,ITF2,14,Molise,Molise,305617,65269,21.36,0.84
2514,2021-01-04,MOL,314,131,183,314,0,ITF,ITF2,14,Molise,Molise,305617,65583,21.46,0.1
2515,2021-04-14,MOL,1806,767,1039,1145,661,ITF,ITF2,14,Molise,Molise,305617,67389,22.05,0.59
2516,2021-02-16,MOL,156,70,86,150,6,ITF,ITF2,14,Molise,Molise,305617,67545,22.1,0.05
2517,2021-05-27,MOL,2825,1342,1483,1991,834,ITF,ITF2,14,Molise,Molise,305617,70370,23.03,0.92
2518,2021-05-29,MOL,2289,1194,1095,1935,354,ITF,ITF2,14,Molise,Molise,305617,72659,23.77,0.75
2519,2021-02-09,MOL,359,170,189,197,162,ITF,ITF2,14,Molise,Molise,305617,73018,23.89,0.12
2520,2021-01-12,MOL,336,114,222,336,0,ITF,ITF2,14,Molise,Molise,305617,73354,24.0,0.11
2521,2021-02-24,MOL,666,278,388,333,333,ITF,ITF2,14,Molise,Molise,305617,74020,24.22,0.22
2522,2021-03-03,MOL,672,316,356,590,82,ITF,ITF2,14,Molise,Molise,305617,74692,24.44,0.22
2523,2021-01-05,MOL,449,180,269,449,0,ITF,ITF2,14,Molise,Molise,305617,75141,24.59,0.15
2524,2021-02-20,MOL,1018,441,577,998,20,ITF,ITF2,14,Molise,Molise,305617,76159,24.92,0.33
2525,2021-05-31,MOL,2234,1067,1167,1916,318,ITF,ITF2,14,Molise,Molise,305617,78393,25.65,0.73
2526,2021-04-27,MOL,1593,767,826,465,1128,ITF,ITF2,14,Molise,Molise,305617,79986,26.17,0.52
2527,2021-05-16,MOL,1246,570,676,1064,182,ITF,ITF2,14,Molise,Molise,305617,81232,26.58,0.41
2528,2021-01-09,MOL,450,152,298,450,0,ITF,ITF2,14,Molise,Molise,305617,81682,26.73,0.15
2529,2021-04-19,MOL,1827,842,985,1049,778,ITF,ITF2,14,Molise,Molise,305617,83509,27.32,0.6
2530,2021-02-28,MOL,829,331,498,787,42,ITF,ITF2,14,Molise,Molise,305617,84338,27.6,0.27
2531,2021-02-27,MOL,1366,568,798,1347,19,ITF,ITF2,14,Molise,Molise,305617,85704,28.04,0.45
2532,2021-05-22,MOL,1307,706,601,1225,82,ITF,ITF2,14,Molise,Molise,305617,87011,28.47,0.43
2533,2021-05-05,MOL,2413,1042,1371,2272,141,ITF,ITF2,14,Molise,Molise,305617,89424,29.26,0.79
2534,2021-05-04,MOL,2704,1181,1523,2576,128,ITF,ITF2,14,Molise,Molise,305617,92128,30.14,0.88
2535,2021-01-10,MOL,270,72,198,270,0,ITF,ITF2,14,Molise,Molise,305617,92398,30.23,0.09
2536,2021-03-01,MOL,661,274,387,447,214,ITF,ITF2,14,Molise,Molise,305617,93059,30.45,0.22
2537,2021-01-07,MOL,598,209,389,598,0,ITF,ITF2,14,Molise,Molise,305617,93657,30.65,0.2
2538,2021-04-02,MOL,1453,708,745,676,777,ITF,ITF2,14,Molise,Molise,305617,95110,31.12,0.48
2539,2021-02-11,MOL,293,133,160,257,36,ITF,ITF2,14,Molise,Molise,305617,95403,31.22,0.1
2540,2021-04-25,MOL,792,395,397,559,233,ITF,ITF2,14,Molise,Molise,305617,96195,31.48,0.26
2541,2021-03-13,MOL,1189,594,595,200,989,ITF,ITF2,14,Molise,Molise,305617,97384,31.86,0.39
2542,2021-01-15,MOL,538,242,296,538,0,ITF,ITF2,14,Molise,Molise,305617,97922,32.04,0.18
2543,2021-04-05,MOL,391,189,202,292,99,ITF,ITF2,14,Molise,Molise,305617,98313,32.17,0.13
2544,2021-01-31,MOL,268,70,198,6,262,ITF,ITF2,14,Molise,Molise,305617,98581,32.26,0.09
2545,2021-03-31,MOL,2193,919,1274,1374,819,ITF,ITF2,14,Molise,Molise,305617,100774,32.97,0.72
2546,2021-05-26,MOL,1528,684,844,783,745,ITF,ITF2,14,Molise,Molise,305617,102302,33.47,0.5
2547,2021-05-12,MOL,2847,1291,1556,2751,96,ITF,ITF2,14,Molise,Molise,305617,105149,34.41,0.93
2548,2021-02-08,MOL,334,141,193,216,118,ITF,ITF2,14,Molise,Molise,305617,105483,34.51,0.11
2549,2021-03-23,MOL,1642,694,948,1435,207,ITF,ITF2,14,Molise,Molise,305617,107125,35.05,0.54
2550,2021-02-22,MOL,265,129,136,250,15,ITF,ITF2,14,Molise,Molise,305617,107390,35.14,0.09
2551,2021-05-17,MOL,2228,1092,1136,1732,496,ITF,ITF2,14,Molise,Molise,305617,109618,35.87,0.73
2552,2021-03-21,MOL,1246,542,704,479,767,ITF,ITF2,14,Molise,Molise,305617,110864,36.28,0.41
2553,2021-03-14,MOL,595,239,356,17,578,ITF,ITF2,14,Molise,Molise,305617,111459,36.47,0.19
2554,2021-03-28,MOL,1626,747,879,524,1102,ITF,ITF2,14,Molise,Molise,305617,113085,37.0,0.53
2555,2021-01-30,MOL,461,158,303,12,449,ITF,ITF2,14,Molise,Molise,305617,113546,37.15,0.15
2556,2021-02-06,MOL,429,179,250,29,400,ITF,ITF2,14,Molise,Molise,305617,113975,37.29,0.14
2557,2021-04-09,MOL,2318,1248,1070,2127,191,ITF,ITF2,14,Molise,Molise,305617,116293,38.05,0.76
2558,2021-01-18,MOL,114,48,66,114,0,ITF,ITF2,14,Molise,Molise,305617,116407,38.09,0.04
2559,2021-04-13,MOL,1630,718,912,1043,587,ITF,ITF2,14,Molise,Molise,305617,118037,38.62,0.53
2560,2021-03-27,MOL,2743,1273,1470,1310,1433,ITF,ITF2,14,Molise,Molise,305617,120780,39.52,0.9
2561,2021-05-30,MOL,1822,903,919,1538,284,ITF,ITF2,14,Molise,Molise,305617,122602,40.12,0.6
2562,2021-03-04,MOL,850,417,433,526,324,ITF,ITF2,14,Molise,Molise,305617,123452,40.39,0.28
2563,2021-01-20,MOL,18,8,10,18,0,ITF,ITF2,14,Molise,Molise,305617,123470,40.4,0.01
2564,2021-01-29,MOL,421,136,285,6,415,ITF,ITF2,14,Molise,Molise,305617,123891,40.54,0.14
2565,2021-05-11,MOL,3205,1413,1792,2955,250,ITF,ITF2,14,Molise,Molise,305617,127096,41.59,1.05
2566,2021-03-30,MOL,2003,857,1146,1491,512,ITF,ITF2,14,Molise,Molise,305617,129099,42.24,0.66
2567,2021-02-01,MOL,562,201,361,14,548,ITF,ITF2,14,Molise,Molise,305617,129661,42.43,0.18
2568,2021-04-06,MOL,1494,701,793,1151,343,ITF,ITF2,14,Molise,Molise,305617,131155,42.91,0.49
2569,2021-05-19,MOL,2335,1205,1130,1912,423,ITF,ITF2,14,Molise,Molise,305617,133490,43.68,0.76
2570,2021-02-15,MOL,144,70,74,141,3,ITF,ITF2,14,Molise,Molise,305617,133634,43.73,0.05
2571,2021-02-13,MOL,132,80,52,132,0,ITF,ITF2,14,Molise,Molise,305617,133766,43.77,0.04
2572,2021-05-24,MOL,1951,847,1104,1285,666,ITF,ITF2,14,Molise,Molise,305617,135717,44.41,0.64
2573,2021-04-18,MOL,1083,483,600,149,934,ITF,ITF2,14,Molise,Molise,305617,136800,44.76,0.35
2574,2021-04-04,MOL,253,141,112,238,15,ITF,ITF2,14,Molise,Molise,305617,137053,44.84,0.08
2575,2021-01-08,MOL,429,141,288,429,0,ITF,ITF2,14,Molise,Molise,305617,137482,44.99,0.14
2576,2021-04-08,MOL,1766,903,863,1564,202,ITF,ITF2,14,Molise,Molise,305617,139248,45.56,0.58
2577,2021-04-22,MOL,1844,863,981,1065,779,ITF,ITF2,14,Molise,Molise,305617,141092,46.17,0.6
2578,2021-02-17,MOL,72,32,40,57,15,ITF,ITF2,14,Molise,Molise,305617,141164,46.19,0.02
2579,2021-05-28,MOL,2465,1288,1177,1956,509,ITF,ITF2,14,Molise,Molise,305617,143629,47.0,0.81
2580,2021-03-20,MOL,2321,968,1353,1000,1321,ITF,ITF2,14,Molise,Molise,305617,145950,47.76,0.76
2581,2021-02-18,MOL,319,74,245,306,13,ITF,ITF2,14,Molise,Molise,305617,146269,47.86,0.1
2582,2021-03-09,MOL,1329,579,750,1177,152,ITF,ITF2,14,Molise,Molise,305617,147598,48.3,0.43
2583,2021-05-14,MOL,2644,1215,1429,1926,718,ITF,ITF2,14,Molise,Molise,305617,150242,49.16,0.87
2584,2021-02-03,MOL,731,249,482,338,393,ITF,ITF2,14,Molise,Molise,305617,150973,49.4,0.24
2585,2021-03-11,MOL,1463,636,827,1457,6,ITF,ITF2,14,Molise,Molise,305617,152436,49.88,0.48
2586,2021-01-06,MOL,689,260,429,689,0,ITF,ITF2,14,Molise,Molise,305617,153125,50.1,0.23
2587,2021-04-16,MOL,2430,1033,1397,1198,1232,ITF,ITF2,14,Molise,Molise,305617,155555,50.9,0.8
2588,2021-01-13,MOL,474,160,314,474,0,ITF,ITF2,14,Molise,Molise,305617,156029,51.05,0.16
2589,2021-04-23,MOL,2049,882,1167,1390,659,ITF,ITF2,14,Molise,Molise,305617,158078,51.72,0.67
2590,2021-04-11,MOL,1196,591,605,1182,14,ITF,ITF2,14,Molise,Molise,305617,159274,52.12,0.39
2591,2021-03-25,MOL,1806,730,1076,1309,497,ITF,ITF2,14,Molise,Molise,305617,161080,52.71,0.59
2592,2021-03-08,MOL,1379,522,857,1239,140,ITF,ITF2,14,Molise,Molise,305617,162459,53.16,0.45
2593,2021-04-30,MOL,2935,1554,1381,829,2106,ITF,ITF2,14,Molise,Molise,305617,165394,54.12,0.96
2594,2021-02-25,MOL,541,239,302,473,68,ITF,ITF2,14,Molise,Molise,305617,165935,54.3,0.18
2595,2021-05-09,MOL,2051,932,1119,1955,96,ITF,ITF2,14,Molise,Molise,305617,167986,54.97,0.67
2596,2021-04-15,MOL,1923,793,1130,1079,844,ITF,ITF2,14,Molise,Molise,305617,169909,55.6,0.63
2597,2020-12-27,MOL,50,20,30,50,0,ITF,ITF2,14,Molise,Molise,305617,169959,55.61,0.02
2598,2021-03-16,MOL,614,230,384,267,347,ITF,ITF2,14,Molise,Molise,305617,170573,55.81,0.2
2599,2021-01-11,MOL,557,194,363,557,0,ITF,ITF2,14,Molise,Molise,305617,171130,55.99,0.18
2600,2021-01-25,MOL,319,130,189,3,316,ITF,ITF2,14,Molise,Molise,305617,171449,56.1,0.1
2601,2021-04-20,MOL,2318,1025,1293,1220,1098,ITF,ITF2,14,Molise,Molise,305617,173767,56.86,0.76
2602,2021-05-23,MOL,1698,863,835,1693,5,ITF,ITF2,14,Molise,Molise,305617,175465,57.41,0.56
2603,2021-04-03,MOL,1770,850,920,1735,35,ITF,ITF2,14,Molise,Molise,305617,177235,57.99,0.58
2604,2021-01-22,MOL,126,35,91,126,0,ITF,ITF2,14,Molise,Molise,305617,177361,58.03,0.04
2605,2021-03-06,MOL,1728,807,921,1569,159,ITF,ITF2,14,Molise,Molise,305617,179089,58.6,0.57
2606,2021-05-02,MOL,1890,930,960,587,1303,ITF,ITF2,14,Molise,Molise,305617,180979,59.22,0.62
2607,2021-01-26,MOL,450,184,266,8,442,ITF,ITF2,14,Molise,Molise,305617,181429,59.36,0.15
2608,2021-05-06,MOL,2679,1214,1465,2081,598,ITF,ITF2,14,Molise,Molise,305617,184108,60.24,0.88
2609,2021-03-17,MOL,908,385,523,576,332,ITF,ITF2,14,Molise,Molise,305617,185016,60.54,0.3
2610,2021-05-07,MOL,2641,1226,1415,2044,597,ITF,ITF2,14,Molise,Molise,305617,187657,61.4,0.86
2611,2021-03-18,MOL,1156,476,680,692,464,ITF,ITF2,14,Molise,Molise,305617,188813,61.78,0.38
2612,2021-02-10,MOL,150,78,72,130,20,ITF,ITF2,14,Molise,Molise,305617,188963,61.83,0.05
2613,2021-05-21,MOL,2018,1011,1007,1707,311,ITF,ITF2,14,Molise,Molise,305617,190981,62.49,0.66
2614,2021-01-27,MOL,674,251,423,8,666,ITF,ITF2,14,Molise,Molise,305617,191655,62.71,0.22
2615,2021-04-01,MOL,1469,667,802,743,726,ITF,ITF2,14,Molise,Molise,305617,193124,63.19,0.48
2616,2021-04-23,EMR,29551,13807,15744,14672,14879,ITH,ITH5,8,Emilia-Romagna,Emilia-Romagna,4459477,29551,0.66,0.66
2617,2021-01-13,EMR,9074,2940,6134,9074,0,ITH,ITH5,8,Emilia-Romagna,Emilia-Romagna,4459477,38625,0.87,0.2
2618,2021-01-11,EMR,9349,3273,6076,9349,0,ITH,ITH5,8,Emilia-Romagna,Emilia-Romagna,4459477,47974,1.08,0.21
2619,2021-03-30,EMR,23286,10292,12994,18249,5037,ITH,ITH5,8,Emilia-Romagna,Emilia-Romagna,4459477,71260,1.6,0.52
2620,2021-01-04,EMR,7310,2526,4784,7310,0,ITH,ITH5,8,Emilia-Romagna,Emilia-Romagna,4459477,78570,1.76,0.16
2621,2021-05-19,EMR,33503,14887,18616,18476,15027,ITH,ITH5,8,Emilia-Romagna,Emilia-Romagna,4459477,112073,2.51,0.75
2622,2021-03-13,EMR,16077,6308,9769,10764,5313,ITH,ITH5,8,Emilia-Romagna,Emilia-Romagna,4459477,128150,2.87,0.36
2623,2021-01-03,EMR,2762,943,1819,2762,0,ITH,ITH5,8,Emilia-Romagna,Emilia-Romagna,4459477,130912,2.94,0.06
2624,2021-05-02,EMR,25451,11593,13858,13464,11987,ITH,ITH5,8,Emilia-Romagna,Emilia-Romagna,4459477,156363,3.51,0.57
2625,2021-05-16,EMR,25807,12152,13655,18703,7104,ITH,ITH5,8,Emilia-Romagna,Emilia-Romagna,4459477,182170,4.09,0.58
2626,2021-02-18,EMR,7039,2892,4147,6456,583,ITH,ITH5,8,Emilia-Romagna,Emilia-Romagna,4459477,189209,4.24,0.16
2627,2021-05-12,EMR,38160,17946,20214,28556,9604,ITH,ITH5,8,Emilia-Romagna,Emilia-Romagna,4459477,227369,5.1,0.86
2628,2021-03-16,EMR,12241,5026,7215,4933,7308,ITH,ITH5,8,Emilia-Romagna,Emilia-Romagna,4459477,239610,5.37,0.27
2629,2021-01-25,EMR,6456,2145,4311,207,6249,ITH,ITH5,8,Emilia-Romagna,Emilia-Romagna,4459477,246066,5.52,0.14
2630,2021-03-09,EMR,14704,5984,8720,10748,3956,ITH,ITH5,8,Emilia-Romagna,Emilia-Romagna,4459477,260770,5.85,0.33
2631,2021-05-23,EMR,25397,11820,13577,13851,11546,ITH,ITH5,8,Emilia-Romagna,Emilia-Romagna,4459477,286167,6.42,0.57
2632,2021-05-07,EMR,35106,16862,18244,23303,11803,ITH,ITH5,8,Emilia-Romagna,Emilia-Romagna,4459477,321273,7.2,0.79
2633,2021-03-25,EMR,21390,9347,12043,14402,6988,ITH,ITH5,8,Emilia-Romagna,Emilia-Romagna,4459477,342663,7.68,0.48
2634,2021-05-21,EMR,37697,16816,20881,20944,16753,ITH,ITH5,8,Emilia-Romagna,Emilia-Romagna,4459477,380360,8.53,0.85
2635,2021-02-10,EMR,4019,1383,2636,2764,1255,ITH,ITH5,8,Emilia-Romagna,Emilia-Romagna,4459477,384379,8.62,0.09
2636,2021-04-08,EMR,30824,14130,16694,25524,5300,ITH,ITH5,8,Emilia-Romagna,Emilia-Romagna,4459477,415203,9.31,0.69
2637,2021-03-04,EMR,16434,5345,11089,13422,3012,ITH,ITH5,8,Emilia-Romagna,Emilia-Romagna,4459477,431637,9.68,0.37
2638,2021-05-24,EMR,29578,13492,16086,18369,11209,ITH,ITH5,8,Emilia-Romagna,Emilia-Romagna,4459477,461215,10.34,0.66
2639,2021-01-29,EMR,10414,3497,6917,290,10124,ITH,ITH5,8,Emilia-Romagna,Emilia-Romagna,4459477,471629,10.58,0.23
2640,2021-02-15,EMR,2903,850,2053,2778,125,ITH,ITH5,8,Emilia-Romagna,Emilia-Romagna,4459477,474532,10.64,0.07
2641,2021-04-18,EMR,17494,8392,9102,12568,4926,ITH,ITH5,8,Emilia-Romagna,Emilia-Romagna,4459477,492026,11.03,0.39
2642,2021-01-10,EMR,7168,2683,4485,7168,0,ITH,ITH5,8,Emilia-Romagna,Emilia-Romagna,4459477,499194,11.19,0.16
2643,2021-03-06,EMR,20636,5884,14752,17906,2730,ITH,ITH5,8,Emilia-Romagna,Emilia-Romagna,4459477,519830,11.66,0.46
2644,2021-02-01,EMR,10320,3610,6710,362,9958,ITH,ITH5,8,Emilia-Romagna,Emilia-Romagna,4459477,530150,11.89,0.23
2645,2021-01-18,EMR,3127,879,2248,2449,678,ITH,ITH5,8,Emilia-Romagna,Emilia-Romagna,4459477,533277,11.96,0.07
2646,2021-03-23,EMR,18698,8069,10629,12011,6687,ITH,ITH5,8,Emilia-Romagna,Emilia-Romagna,4459477,551975,12.38,0.42
2647,2021-05-05,EMR,29367,13656,15711,18130,11237,ITH,ITH5,8,Emilia-Romagna,Emilia-Romagna,4459477,581342,13.04,0.66
2648,2021-01-30,EMR,10077,3519,6558,141,9936,ITH,ITH5,8,Emilia-Romagna,Emilia-Romagna,4459477,591419,13.26,0.23
2649,2021-04-04,EMR,9885,4718,5167,7616,2269,ITH,ITH5,8,Emilia-Romagna,Emilia-Romagna,4459477,601304,13.48,0.22
2650,2021-03-20,EMR,16086,6831,9255,9122,6964,ITH,ITH5,8,Emilia-Romagna,Emilia-Romagna,4459477,617390,13.84,0.36
2651,2021-04-06,EMR,24621,11114,13507,19884,4737,ITH,ITH5,8,Emilia-Romagna,Emilia-Romagna,4459477,642011,14.4,0.55
2652,2020-12-27,EMR,970,372,598,970,0,ITH,ITH5,8,Emilia-Romagna,Emilia-Romagna,4459477,642981,14.42,0.02
2653,2021-05-26,EMR,32810,14522,18288,10158,22652,ITH,ITH5,8,Emilia-Romagna,Emilia-Romagna,4459477,675791,15.15,0.74
2654,2021-02-13,EMR,3627,1085,2542,3029,598,ITH,ITH5,8,Emilia-Romagna,Emilia-Romagna,4459477,679418,15.24,0.08
2655,2021-05-09,EMR,25488,12190,13298,18525,6963,ITH,ITH5,8,Emilia-Romagna,Emilia-Romagna,4459477,704906,15.81,0.57
2656,2021-01-27,EMR,8362,2947,5415,463,7899,ITH,ITH5,8,Emilia-Romagna,Emilia-Romagna,4459477,713268,15.99,0.19
2657,2021-05-31,EMR,29107,13343,15764,18038,11069,ITH,ITH5,8,Emilia-Romagna,Emilia-Romagna,4459477,742375,16.65,0.65
2658,2021-02-20,EMR,5317,2094,3223,5054,263,ITH,ITH5,8,Emilia-Romagna,Emilia-Romagna,4459477,747692,16.77,0.12
2659,2021-01-15,EMR,7746,2403,5343,7746,0,ITH,ITH5,8,Emilia-Romagna,Emilia-Romagna,4459477,755438,16.94,0.17
2660,2021-03-01,EMR,10092,3578,6514,7836,2256,ITH,ITH5,8,Emilia-Romagna,Emilia-Romagna,4459477,765530,17.17,0.23
2661,2021-05-04,EMR,28568,13380,15188,14915,13653,ITH,ITH5,8,Emilia-Romagna,Emilia-Romagna,4459477,794098,17.81,0.64
2662,2021-02-27,EMR,10967,3999,6968,9229,1738,ITH,ITH5,8,Emilia-Romagna,Emilia-Romagna,4459477,805065,18.05,0.25
2663,2021-04-25,EMR,22324,10222,12102,14816,7508,ITH,ITH5,8,Emilia-Romagna,Emilia-Romagna,4459477,827389,18.55,0.5
2664,2021-04-27,EMR,32044,14830,17214,19583,12461,ITH,ITH5,8,Emilia-Romagna,Emilia-Romagna,4459477,859433,19.27,0.72
2665,2021-01-23,EMR,2447,870,1577,443,2004,ITH,ITH5,8,Emilia-Romagna,Emilia-Romagna,4459477,861880,19.33,0.05
2666,2021-03-05,EMR,17684,5752,11932,14234,3450,ITH,ITH5,8,Emilia-Romagna,Emilia-Romagna,4459477,879564,19.72,0.4
2667,2021-03-03,EMR,15829,5250,10579,13353,2476,ITH,ITH5,8,Emilia-Romagna,Emilia-Romagna,4459477,895393,20.08,0.35
2668,2021-05-27,EMR,36425,15971,20454,8716,27709,ITH,ITH5,8,Emilia-Romagna,Emilia-Romagna,4459477,931818,20.9,0.82
2669,2021-02-16,EMR,5768,2444,3324,5237,531,ITH,ITH5,8,Emilia-Romagna,Emilia-Romagna,4459477,937586,21.02,0.13
2670,2021-04-21,EMR,23919,10952,12967,14184,9735,ITH,ITH5,8,Emilia-Romagna,Emilia-Romagna,4459477,961505,21.56,0.54
2671,2021-05-08,EMR,31664,14822,16842,20253,11411,ITH,ITH5,8,Emilia-Romagna,Emilia-Romagna,4459477,993169,22.27,0.71
2672,2021-01-28,EMR,10250,3339,6911,349,9901,ITH,ITH5,8,Emilia-Romagna,Emilia-Romagna,4459477,1003419,22.5,0.23
2673,2021-04-16,EMR,28857,13565,15292,20023,8834,ITH,ITH5,8,Emilia-Romagna,Emilia-Romagna,4459477,1032276,23.15,0.65
2674,2021-01-06,EMR,8285,2954,5331,8285,0,ITH,ITH5,8,Emilia-Romagna,Emilia-Romagna,4459477,1040561,23.33,0.19
2675,2021-04-30,EMR,36524,16743,19781,21739,14785,ITH,ITH5,8,Emilia-Romagna,Emilia-Romagna,4459477,1077085,24.15,0.82
2676,2021-02-25,EMR,9228,3497,5731,8274,954,ITH,ITH5,8,Emilia-Romagna,Emilia-Romagna,4459477,1086313,24.36,0.21
2677,2021-03-11,EMR,17257,7136,10121,11407,5850,ITH,ITH5,8,Emilia-Romagna,Emilia-Romagna,4459477,1103570,24.75,0.39
2678,2021-01-20,EMR,1325,270,1055,1324,1,ITH,ITH5,8,Emilia-Romagna,Emilia-Romagna,4459477,1104895,24.78,0.03
2679,2021-04-15,EMR,29017,13807,15210,19347,9670,ITH,ITH5,8,Emilia-Romagna,Emilia-Romagna,4459477,1133912,25.43,0.65
2680,2021-01-21,EMR,2164,729,1435,819,1345,ITH,ITH5,8,Emilia-Romagna,Emilia-Romagna,4459477,1136076,25.48,0.05
2681,2021-03-27,EMR,21601,9045,12556,14695,6906,ITH,ITH5,8,Emilia-Romagna,Emilia-Romagna,4459477,1157677,25.96,0.48
2682,2021-04-13,EMR,23644,11086,12558,19343,4301,ITH,ITH5,8,Emilia-Romagna,Emilia-Romagna,4459477,1181321,26.49,0.53
2683,2021-01-22,EMR,1829,477,1352,1088,741,ITH,ITH5,8,Emilia-Romagna,Emilia-Romagna,4459477,1183150,26.53,0.04
2684,2021-02-08,EMR,5227,1532,3695,2315,2912,ITH,ITH5,8,Emilia-Romagna,Emilia-Romagna,4459477,1188377,26.65,0.12
2685,2021-02-22,EMR,7481,3091,4390,7209,272,ITH,ITH5,8,Emilia-Romagna,Emilia-Romagna,4459477,1195858,26.82,0.17
2686,2021-05-06,EMR,35456,16385,19071,22414,13042,ITH,ITH5,8,Emilia-Romagna,Emilia-Romagna,4459477,1231314,27.61,0.8
2687,2021-01-26,EMR,8334,3000,5334,215,8119,ITH,ITH5,8,Emilia-Romagna,Emilia-Romagna,4459477,1239648,27.8,0.19
2688,2021-03-24,EMR,21079,9302,11777,13697,7382,ITH,ITH5,8,Emilia-Romagna,Emilia-Romagna,4459477,1260727,28.27,0.47
2689,2021-04-02,EMR,23304,10493,12811,18842,4462,ITH,ITH5,8,Emilia-Romagna,Emilia-Romagna,4459477,1284031,28.79,0.52
2690,2021-05-29,EMR,37073,16182,20891,16730,20343,ITH,ITH5,8,Emilia-Romagna,Emilia-Romagna,4459477,1321104,29.62,0.83
2691,2021-04-11,EMR,15259,6926,8333,12214,3045,ITH,ITH5,8,Emilia-Romagna,Emilia-Romagna,4459477,1336363,29.97,0.34
2692,2021-02-11,EMR,4250,1416,2834,3410,840,ITH,ITH5,8,Emilia-Romagna,Emilia-Romagna,4459477,1340613,30.06,0.1
2693,2021-03-08,EMR,12177,5063,7114,9502,2675,ITH,ITH5,8,Emilia-Romagna,Emilia-Romagna,4459477,1352790,30.34,0.27
2694,2021-04-20,EMR,22593,10392,12201,14242,8351,ITH,ITH5,8,Emilia-Romagna,Emilia-Romagna,4459477,1375383,30.84,0.51
2695,2021-01-08,EMR,10865,3580,7285,10865,0,ITH,ITH5,8,Emilia-Romagna,Emilia-Romagna,4459477,1386248,31.09,0.24
2696,2021-01-07,EMR,10271,3406,6865,10271,0,ITH,ITH5,8,Emilia-Romagna,Emilia-Romagna,4459477,1396519,31.32,0.23
2697,2021-04-03,EMR,19936,8766,11170,16196,3740,ITH,ITH5,8,Emilia-Romagna,Emilia-Romagna,4459477,1416455,31.76,0.45
2698,2021-02-19,EMR,7327,3010,4317,6813,514,ITH,ITH5,8,Emilia-Romagna,Emilia-Romagna,4459477,1423782,31.93,0.16
2699,2020-12-31,EMR,2213,779,1434,2213,0,ITH,ITH5,8,Emilia-Romagna,Emilia-Romagna,4459477,1425995,31.98,0.05
2700,2021-04-28,EMR,33661,15551,18110,20775,12886,ITH,ITH5,8,Emilia-Romagna,Emilia-Romagna,4459477,1459656,32.73,0.75
2701,2021-03-18,EMR,13673,5806,7867,5673,8000,ITH,ITH5,8,Emilia-Romagna,Emilia-Romagna,4459477,1473329,33.04,0.31
2702,2021-05-14,EMR,36988,17039,19949,27426,9562,ITH,ITH5,8,Emilia-Romagna,Emilia-Romagna,4459477,1510317,33.87,0.83
2703,2021-02-03,EMR,9355,2995,6360,984,8371,ITH,ITH5,8,Emilia-Romagna,Emilia-Romagna,4459477,1519672,34.08,0.21
2704,2021-04-01,EMR,23880,10732,13148,19339,4541,ITH,ITH5,8,Emilia-Romagna,Emilia-Romagna,4459477,1543552,34.61,0.54
2705,2021-02-17,EMR,6538,2764,3774,5766,772,ITH,ITH5,8,Emilia-Romagna,Emilia-Romagna,4459477,1550090,34.76,0.15
2706,2021-05-28,EMR,40534,18617,21917,17768,22766,ITH,ITH5,8,Emilia-Romagna,Emilia-Romagna,4459477,1590624,35.67,0.91
2707,2021-01-12,EMR,9475,3124,6351,9475,0,ITH,ITH5,8,Emilia-Romagna,Emilia-Romagna,4459477,1600099,35.88,0.21
2708,2021-04-24,EMR,28573,13213,15360,14360,14213,ITH,ITH5,8,Emilia-Romagna,Emilia-Romagna,4459477,1628672,36.52,0.64
2709,2021-05-11,EMR,35223,16516,18707,27968,7255,ITH,ITH5,8,Emilia-Romagna,Emilia-Romagna,4459477,1663895,37.31,0.79
2710,2021-03-21,EMR,11920,5273,6647,7316,4604,ITH,ITH5,8,Emilia-Romagna,Emilia-Romagna,4459477,1675815,37.58,0.27
2711,2021-04-07,EMR,25804,11735,14069,19793,6011,ITH,ITH5,8,Emilia-Romagna,Emilia-Romagna,4459477,1701619,38.16,0.58
2712,2021-02-23,EMR,8215,3219,4996,7829,386,ITH,ITH5,8,Emilia-Romagna,Emilia-Romagna,4459477,1709834,38.34,0.18
2713,2021-03-12,EMR,18116,7552,10564,11399,6717,ITH,ITH5,8,Emilia-Romagna,Emilia-Romagna,4459477,1727950,38.75,0.41
2714,2021-05-13,EMR,35505,16347,19158,27740,7765,ITH,ITH5,8,Emilia-Romagna,Emilia-Romagna,4459477,1763455,39.54,0.8
2715,2021-03-15,EMR,13268,6091,7177,6769,6499,ITH,ITH5,8,Emilia-Romagna,Emilia-Romagna,4459477,1776723,39.84,0.3
2716,2021-02-09,EMR,4153,1248,2905,2307,1846,ITH,ITH5,8,Emilia-Romagna,Emilia-Romagna,4459477,1780876,39.93,0.09
2717,2021-02-04,EMR,9938,3207,6731,1250,8688,ITH,ITH5,8,Emilia-Romagna,Emilia-Romagna,4459477,1790814,40.16,0.22
2718,2021-05-22,EMR,32818,14070,18748,16852,15966,ITH,ITH5,8,Emilia-Romagna,Emilia-Romagna,4459477,1823632,40.89,0.74
2719,2021-04-09,EMR,25505,11567,13938,19814,5691,ITH,ITH5,8,Emilia-Romagna,Emilia-Romagna,4459477,1849137,41.47,0.57
2720,2021-02-12,EMR,5321,1679,3642,3918,1403,ITH,ITH5,8,Emilia-Romagna,Emilia-Romagna,4459477,1854458,41.58,0.12
2721,2021-04-10,EMR,20906,9291,11615,16763,4143,ITH,ITH5,8,Emilia-Romagna,Emilia-Romagna,4459477,1875364,42.05,0.47
2722,2021-04-17,EMR,27027,12931,14096,17731,9296,ITH,ITH5,8,Emilia-Romagna,Emilia-Romagna,4459477,1902391,42.66,0.61
2723,2021-05-30,EMR,26785,12644,14141,13227,13558,ITH,ITH5,8,Emilia-Romagna,Emilia-Romagna,4459477,1929176,43.26,0.6
2724,2021-02-26,EMR,7866,2996,4870,6821,1045,ITH,ITH5,8,Emilia-Romagna,Emilia-Romagna,4459477,1937042,43.44,0.18
2725,2021-03-10,EMR,18727,7683,11044,13084,5643,ITH,ITH5,8,Emilia-Romagna,Emilia-Romagna,4459477,1955769,43.86,0.42
2726,2021-02-24,EMR,9327,3558,5769,8443,884,ITH,ITH5,8,Emilia-Romagna,Emilia-Romagna,4459477,1965096,44.07,0.21
2727,2021-01-05,EMR,9362,3170,6192,9362,0,ITH,ITH5,8,Emilia-Romagna,Emilia-Romagna,4459477,1974458,44.28,0.21
2728,2021-04-29,EMR,44897,21106,23791,27355,17542,ITH,ITH5,8,Emilia-Romagna,Emilia-Romagna,4459477,2019355,45.28,1.01
2729,2021-01-19,EMR,2045,505,1540,2028,17,ITH,ITH5,8,Emilia-Romagna,Emilia-Romagna,4459477,2021400,45.33,0.05
2730,2021-06-01,EMR,15878,7641,8237,9808,6070,ITH,ITH5,8,Emilia-Romagna,Emilia-Romagna,4459477,2037278,45.68,0.36
2731,2021-04-12,EMR,19217,8993,10224,14775,4442,ITH,ITH5,8,Emilia-Romagna,Emilia-Romagna,4459477,2056495,46.12,0.43
2732,2021-04-19,EMR,20882,9788,11094,14610,6272,ITH,ITH5,8,Emilia-Romagna,Emilia-Romagna,4459477,2077377,46.58,0.47
2733,2021-01-09,EMR,9984,3450,6534,9984,0,ITH,ITH5,8,Emilia-Romagna,Emilia-Romagna,4459477,2087361,46.81,0.22
2734,2021-03-07,EMR,6861,2640,4221,5344,1517,ITH,ITH5,8,Emilia-Romagna,Emilia-Romagna,4459477,2094222,46.96,0.15
2735,2021-05-03,EMR,28454,13444,15010,17578,10876,ITH,ITH5,8,Emilia-Romagna,Emilia-Romagna,4459477,2122676,47.6,0.64
2736,2021-02-28,EMR,6823,2527,4296,4977,1846,ITH,ITH5,8,Emilia-Romagna,Emilia-Romagna,4459477,2129499,47.75,0.15
2737,2021-04-26,EMR,27856,12912,14944,18550,9306,ITH,ITH5,8,Emilia-Romagna,Emilia-Romagna,4459477,2157355,48.38,0.62
2738,2021-01-16,EMR,5626,1718,3908,5626,0,ITH,ITH5,8,Emilia-Romagna,Emilia-Romagna,4459477,2162981,48.5,0.13
2739,2021-03-14,EMR,8696,3744,4952,4899,3797,ITH,ITH5,8,Emilia-Romagna,Emilia-Romagna,4459477,2171677,48.7,0.2
2740,2021-03-31,EMR,25131,10949,14182,19675,5456,ITH,ITH5,8,Emilia-Romagna,Emilia-Romagna,4459477,2196808,49.26,0.56
2741,2021-03-26,EMR,23415,9899,13516,16981,6434,ITH,ITH5,8,Emilia-Romagna,Emilia-Romagna,4459477,2220223,49.79,0.53
2742,2021-03-22,EMR,17464,7652,9812,10599,6865,ITH,ITH5,8,Emilia-Romagna,Emilia-Romagna,4459477,2237687,50.18,0.39
2743,2021-05-25,EMR,24764,11043,13721,11580,13184,ITH,ITH5,8,Emilia-Romagna,Emilia-Romagna,4459477,2262451,50.73,0.56
2744,2021-02-14,EMR,1401,378,1023,1281,120,ITH,ITH5,8,Emilia-Romagna,Emilia-Romagna,4459477,2263852,50.76,0.03
2745,2021-05-10,EMR,33586,15993,17593,26358,7228,ITH,ITH5,8,Emilia-Romagna,Emilia-Romagna,4459477,2297438,51.52,0.75
2746,2021-01-24,EMR,2443,885,1558,298,2145,ITH,ITH5,8,Emilia-Romagna,Emilia-Romagna,4459477,2299881,51.57,0.05
2747,2021-01-17,EMR,2890,887,2003,2644,246,ITH,ITH5,8,Emilia-Romagna,Emilia-Romagna,4459477,2302771,51.64,0.06
2748,2021-04-22,EMR,29026,13433,15593,14952,14074,ITH,ITH5,8,Emilia-Romagna,Emilia-Romagna,4459477,2331797,52.29,0.65
2749,2021-04-05,EMR,14860,6809,8051,11969,2891,ITH,ITH5,8,Emilia-Romagna,Emilia-Romagna,4459477,2346657,52.62,0.33
2750,2021-01-31,EMR,7696,2762,4934,241,7455,ITH,ITH5,8,Emilia-Romagna,Emilia-Romagna,4459477,2354353,52.79,0.17
2751,2021-03-02,EMR,11859,3906,7953,9830,2029,ITH,ITH5,8,Emilia-Romagna,Emilia-Romagna,4459477,2366212,53.06,0.27
2752,2021-03-19,EMR,15843,6915,8928,7876,7967,ITH,ITH5,8,Emilia-Romagna,Emilia-Romagna,4459477,2382055,53.42,0.36
2753,2021-05-20,EMR,39816,18124,21692,18742,21074,ITH,ITH5,8,Emilia-Romagna,Emilia-Romagna,4459477,2421871,54.31,0.89
2754,2021-03-17,EMR,13720,5693,8027,5875,7845,ITH,ITH5,8,Emilia-Romagna,Emilia-Romagna,4459477,2435591,54.62,0.31
2755,2021-05-15,EMR,33134,14949,18185,22781,10353,ITH,ITH5,8,Emilia-Romagna,Emilia-Romagna,4459477,2468725,55.36,0.74
2756,2021-02-02,EMR,9484,3053,6431,527,8957,ITH,ITH5,8,Emilia-Romagna,Emilia-Romagna,4459477,2478209,55.57,0.21
2757,2021-05-01,EMR,28380,12764,15616,15611,12769,ITH,ITH5,8,Emilia-Romagna,Emilia-Romagna,4459477,2506589,56.21,0.64
2758,2021-02-05,EMR,9316,2966,6350,1637,7679,ITH,ITH5,8,Emilia-Romagna,Emilia-Romagna,4459477,2515905,56.42,0.21
2759,2021-04-14,EMR,27006,12825,14181,20902,6104,ITH,ITH5,8,Emilia-Romagna,Emilia-Romagna,4459477,2542911,57.02,0.61
2760,2021-01-14,EMR,8128,2593,5535,8128,0,ITH,ITH5,8,Emilia-Romagna,Emilia-Romagna,4459477,2551039,57.2,0.18
2761,2021-03-28,EMR,13456,6001,7455,9592,3864,ITH,ITH5,8,Emilia-Romagna,Emilia-Romagna,4459477,2564495,57.51,0.3
2762,2021-02-06,EMR,7600,2406,5194,2131,5469,ITH,ITH5,8,Emilia-Romagna,Emilia-Romagna,4459477,2572095,57.68,0.17
2763,2021-05-18,EMR,28975,13205,15770,18517,10458,ITH,ITH5,8,Emilia-Romagna,Emilia-Romagna,4459477,2601070,58.33,0.65
2764,2021-02-07,EMR,4793,1537,3256,1732,3061,ITH,ITH5,8,Emilia-Romagna,Emilia-Romagna,4459477,2605863,58.43,0.11
2765,2021-03-29,EMR,21202,9443,11759,16551,4651,ITH,ITH5,8,Emilia-Romagna,Emilia-Romagna,4459477,2627065,58.91,0.48
2766,2021-02-21,EMR,4450,1708,2742,4010,440,ITH,ITH5,8,Emilia-Romagna,Emilia-Romagna,4459477,2631515,59.01,0.1
2767,2021-01-02,EMR,2372,913,1459,2372,0,ITH,ITH5,8,Emilia-Romagna,Emilia-Romagna,4459477,2633887,59.06,0.05
2768,2021-05-17,EMR,32297,15367,16930,22860,9437,ITH,ITH5,8,Emilia-Romagna,Emilia-Romagna,4459477,2666184,59.79,0.72
2769,2021-01-18,UMB,614,219,395,529,85,ITI,ITI2,10,Umbria,Umbria,882015,614,0.07,0.07
2770,2021-03-08,UMB,3672,1801,1871,2309,1363,ITI,ITI2,10,Umbria,Umbria,882015,4286,0.49,0.42
2771,2021-03-25,UMB,3904,1699,2205,2840,1064,ITI,ITI2,10,Umbria,Umbria,882015,8190,0.93,0.44
2772,2021-05-13,UMB,5896,2655,3241,3823,2073,ITI,ITI2,10,Umbria,Umbria,882015,14086,1.6,0.67
2773,2021-01-27,UMB,840,330,510,13,827,ITI,ITI2,10,Umbria,Umbria,882015,14926,1.69,0.1
2774,2021-01-10,UMB,1070,277,793,1070,0,ITI,ITI2,10,Umbria,Umbria,882015,15996,1.81,0.12
2775,2021-04-01,UMB,4374,1836,2538,2366,2008,ITI,ITI2,10,Umbria,Umbria,882015,20370,2.31,0.5
2776,2021-03-15,UMB,4596,1930,2666,2828,1768,ITI,ITI2,10,Umbria,Umbria,882015,24966,2.83,0.52
2777,2021-02-10,UMB,715,349,366,700,15,ITI,ITI2,10,Umbria,Umbria,882015,25681,2.91,0.08
2778,2021-03-23,UMB,3797,1685,2112,2168,1629,ITI,ITI2,10,Umbria,Umbria,882015,29478,3.34,0.43
2779,2021-02-08,UMB,637,203,434,88,549,ITI,ITI2,10,Umbria,Umbria,882015,30115,3.41,0.07
2780,2021-05-19,UMB,9390,4197,5193,5651,3739,ITI,ITI2,10,Umbria,Umbria,882015,39505,4.48,1.06
2781,2021-05-26,UMB,9608,4545,5063,8378,1230,ITI,ITI2,10,Umbria,Umbria,882015,49113,5.57,1.09
2782,2021-05-28,UMB,9464,4352,5112,7250,2214,ITI,ITI2,10,Umbria,Umbria,882015,58577,6.64,1.07
2783,2021-04-15,UMB,7628,3483,4145,5742,1886,ITI,ITI2,10,Umbria,Umbria,882015,66205,7.51,0.86
2784,2021-02-17,UMB,1618,748,870,1267,351,ITI,ITI2,10,Umbria,Umbria,882015,67823,7.69,0.18
2785,2021-04-13,UMB,7676,3398,4278,6007,1669,ITI,ITI2,10,Umbria,Umbria,882015,75499,8.56,0.87
2786,2021-02-15,UMB,1368,692,676,1367,1,ITI,ITI2,10,Umbria,Umbria,882015,76867,8.71,0.16
2787,2021-01-03,UMB,270,112,158,270,0,ITI,ITI2,10,Umbria,Umbria,882015,77137,8.75,0.03
2788,2021-04-23,UMB,6607,2786,3821,3488,3119,ITI,ITI2,10,Umbria,Umbria,882015,83744,9.49,0.75
2789,2021-03-11,UMB,3565,1697,1868,2559,1006,ITI,ITI2,10,Umbria,Umbria,882015,87309,9.9,0.4
2790,2021-01-06,UMB,846,325,521,846,0,ITI,ITI2,10,Umbria,Umbria,882015,88155,9.99,0.1
2791,2021-01-20,UMB,613,222,391,613,0,ITI,ITI2,10,Umbria,Umbria,882015,88768,10.06,0.07
2792,2021-05-31,UMB,5744,2802,2942,4896,848,ITI,ITI2,10,Umbria,Umbria,882015,94512,10.72,0.65
2793,2021-05-14,UMB,5238,2435,2803,3433,1805,ITI,ITI2,10,Umbria,Umbria,882015,99750,11.31,0.59
2794,2021-02-01,UMB,1285,342,943,48,1237,ITI,ITI2,10,Umbria,Umbria,882015,101035,11.46,0.15
2795,2021-02-18,UMB,1496,582,914,1030,466,ITI,ITI2,10,Umbria,Umbria,882015,102531,11.62,0.17
2796,2021-04-27,UMB,5664,2403,3261,3088,2576,ITI,ITI2,10,Umbria,Umbria,882015,108195,12.27,0.64
2797,2021-01-30,UMB,1590,490,1100,44,1546,ITI,ITI2,10,Umbria,Umbria,882015,109785,12.45,0.18
2798,2021-05-12,UMB,6467,3011,3456,4324,2143,ITI,ITI2,10,Umbria,Umbria,882015,116252,13.18,0.73
2799,2021-03-30,UMB,3948,1705,2243,2416,1532,ITI,ITI2,10,Umbria,Umbria,882015,120200,13.63,0.45
2800,2020-12-27,UMB,86,45,41,86,0,ITI,ITI2,10,Umbria,Umbria,882015,120286,13.64,0.01
2801,2021-04-08,UMB,5832,2465,3367,4037,1795,ITI,ITI2,10,Umbria,Umbria,882015,126118,14.3,0.66
2802,2021-02-25,UMB,1336,497,839,1284,52,ITI,ITI2,10,Umbria,Umbria,882015,127454,14.45,0.15
2803,2021-01-13,UMB,450,139,311,450,0,ITI,ITI2,10,Umbria,Umbria,882015,127904,14.5,0.05
2804,2021-04-16,UMB,8100,3742,4358,6263,1837,ITI,ITI2,10,Umbria,Umbria,882015,136004,15.42,0.92
2805,2021-04-30,UMB,6232,2962,3270,2843,3389,ITI,ITI2,10,Umbria,Umbria,882015,142236,16.13,0.71
2806,2021-03-04,UMB,4485,1853,2632,3657,828,ITI,ITI2,10,Umbria,Umbria,882015,146721,16.63,0.51
2807,2021-05-11,UMB,6223,2826,3397,4024,2199,ITI,ITI2,10,Umbria,Umbria,882015,152944,17.34,0.71
2808,2021-01-01,UMB,274,105,169,274,0,ITI,ITI2,10,Umbria,Umbria,882015,153218,17.37,0.03
2809,2021-04-11,UMB,3102,1503,1599,3053,49,ITI,ITI2,10,Umbria,Umbria,882015,156320,17.72,0.35
2810,2021-05-30,UMB,5971,2992,2979,5780,191,ITI,ITI2,10,Umbria,Umbria,882015,162291,18.4,0.68
2811,2021-03-27,UMB,4253,1512,2741,3913,340,ITI,ITI2,10,Umbria,Umbria,882015,166544,18.88,0.48
2812,2021-02-20,UMB,282,100,182,258,24,ITI,ITI2,10,Umbria,Umbria,882015,166826,18.91,0.03
2813,2021-03-09,UMB,4051,1971,2080,2760,1291,ITI,ITI2,10,Umbria,Umbria,882015,170877,19.37,0.46
2814,2021-05-16,UMB,5317,2534,2783,5265,52,ITI,ITI2,10,Umbria,Umbria,882015,176194,19.98,0.6
2815,2021-02-03,UMB,725,174,551,67,658,ITI,ITI2,10,Umbria,Umbria,882015,176919,20.06,0.08
2816,2021-02-06,UMB,396,138,258,34,362,ITI,ITI2,10,Umbria,Umbria,882015,177315,20.1,0.04
2817,2021-04-25,UMB,4364,1685,2679,4282,82,ITI,ITI2,10,Umbria,Umbria,882015,181679,20.6,0.49
2818,2021-03-06,UMB,4267,1110,3157,4124,143,ITI,ITI2,10,Umbria,Umbria,882015,185946,21.08,0.48
2819,2021-01-22,UMB,276,105,171,32,244,ITI,ITI2,10,Umbria,Umbria,882015,186222,21.11,0.03
2820,2021-05-02,UMB,3787,1868,1919,1333,2454,ITI,ITI2,10,Umbria,Umbria,882015,190009,21.54,0.43
2821,2021-03-20,UMB,2298,833,1465,2273,25,ITI,ITI2,10,Umbria,Umbria,882015,192307,21.8,0.26
2822,2021-03-13,UMB,1731,524,1207,1486,245,ITI,ITI2,10,Umbria,Umbria,882015,194038,22.0,0.2
2823,2021-01-15,UMB,701,215,486,701,0,ITI,ITI2,10,Umbria,Umbria,882015,194739,22.08,0.08
2824,2021-01-29,UMB,1232,348,884,79,1153,ITI,ITI2,10,Umbria,Umbria,882015,195971,22.22,0.14
2825,2021-03-10,UMB,4013,1927,2086,2757,1256,ITI,ITI2,10,Umbria,Umbria,882015,199984,22.67,0.45
2826,2021-02-02,UMB,944,274,670,32,912,ITI,ITI2,10,Umbria,Umbria,882015,200928,22.78,0.11
2827,2021-04-28,UMB,5346,2317,3029,2964,2382,ITI,ITI2,10,Umbria,Umbria,882015,206274,23.39,0.61
2828,2021-01-11,UMB,1315,346,969,1315,0,ITI,ITI2,10,Umbria,Umbria,882015,207589,23.54,0.15
2829,2021-05-05,UMB,7173,3284,3889,3877,3296,ITI,ITI2,10,Umbria,Umbria,882015,214762,24.35,0.81
2830,2021-01-25,UMB,648,323,325,5,643,ITI,ITI2,10,Umbria,Umbria,882015,215410,24.42,0.07
2831,2021-03-16,UMB,3538,1454,2084,1911,1627,ITI,ITI2,10,Umbria,Umbria,882015,218948,24.82,0.4
2832,2021-03-17,UMB,3331,1313,2018,1859,1472,ITI,ITI2,10,Umbria,Umbria,882015,222279,25.2,0.38
2833,2021-01-24,UMB,258,106,152,1,257,ITI,ITI2,10,Umbria,Umbria,882015,222537,25.23,0.03
2834,2021-05-22,UMB,6909,2712,4197,2640,4269,ITI,ITI2,10,Umbria,Umbria,882015,229446,26.01,0.78
2835,2021-05-07,UMB,10097,4692,5405,6898,3199,ITI,ITI2,10,Umbria,Umbria,882015,239543,27.16,1.14
2836,2021-03-18,UMB,2942,1164,1778,1704,1238,ITI,ITI2,10,Umbria,Umbria,882015,242485,27.49,0.33
2837,2021-04-20,UMB,5439,2356,3083,3492,1947,ITI,ITI2,10,Umbria,Umbria,882015,247924,28.11,0.62
2838,2021-05-21,UMB,8919,3635,5284,4116,4803,ITI,ITI2,10,Umbria,Umbria,882015,256843,29.12,1.01
2839,2021-05-04,UMB,5531,2543,2988,2410,3121,ITI,ITI2,10,Umbria,Umbria,882015,262374,29.75,0.63
2840,2021-03-01,UMB,1503,774,729,1389,114,ITI,ITI2,10,Umbria,Umbria,882015,263877,29.92,0.17
2841,2021-04-22,UMB,5427,2230,3197,2766,2661,ITI,ITI2,10,Umbria,Umbria,882015,269304,30.53,0.62
2842,2021-01-05,UMB,854,429,425,854,0,ITI,ITI2,10,Umbria,Umbria,882015,270158,30.63,0.1
2843,2021-01-12,UMB,838,248,590,838,0,ITI,ITI2,10,Umbria,Umbria,882015,270996,30.72,0.1
2844,2021-04-06,UMB,5290,2169,3121,2901,2389,ITI,ITI2,10,Umbria,Umbria,882015,276286,31.32,0.6
2845,2021-03-28,UMB,1096,442,654,1072,24,ITI,ITI2,10,Umbria,Umbria,882015,277382,31.45,0.12
2846,2021-02-22,UMB,1859,778,1081,1773,86,ITI,ITI2,10,Umbria,Umbria,882015,279241,31.66,0.21
2847,2021-03-29,UMB,3844,1692,2152,2365,1479,ITI,ITI2,10,Umbria,Umbria,882015,283085,32.1,0.44
2848,2021-01-31,UMB,1058,276,782,25,1033,ITI,ITI2,10,Umbria,Umbria,882015,284143,32.22,0.12
2849,2021-05-18,UMB,7721,3341,4380,3883,3838,ITI,ITI2,10,Umbria,Umbria,882015,291864,33.09,0.88
2850,2021-04-05,UMB,4250,1728,2522,2195,2055,ITI,ITI2,10,Umbria,Umbria,882015,296114,33.57,0.48
2851,2021-05-20,UMB,9825,4582,5243,6188,3637,ITI,ITI2,10,Umbria,Umbria,882015,305939,34.69,1.11
2852,2021-03-31,UMB,3903,1733,2170,2216,1687,ITI,ITI2,10,Umbria,Umbria,882015,309842,35.13,0.44
2853,2021-02-16,UMB,1308,655,653,1299,9,ITI,ITI2,10,Umbria,Umbria,882015,311150,35.28,0.15
2854,2021-05-27,UMB,9930,4828,5102,8647,1283,ITI,ITI2,10,Umbria,Umbria,882015,321080,36.4,1.13
2855,2021-01-04,UMB,810,398,412,810,0,ITI,ITI2,10,Umbria,Umbria,882015,321890,36.49,0.09
2856,2021-04-14,UMB,8150,3673,4477,6171,1979,ITI,ITI2,10,Umbria,Umbria,882015,330040,37.42,0.92
2857,2021-04-07,UMB,5568,2289,3279,3562,2006,ITI,ITI2,10,Umbria,Umbria,882015,335608,38.05,0.63
2858,2021-02-05,UMB,780,234,546,18,762,ITI,ITI2,10,Umbria,Umbria,882015,336388,38.14,0.09
2859,2021-01-19,UMB,103,23,80,103,0,ITI,ITI2,10,Umbria,Umbria,882015,336491,38.15,0.01
2860,2021-03-24,UMB,4073,1760,2313,2750,1323,ITI,ITI2,10,Umbria,Umbria,882015,340564,38.61,0.46
2861,2021-04-10,UMB,7467,3512,3955,7332,135,ITI,ITI2,10,Umbria,Umbria,882015,348031,39.46,0.85
2862,2021-01-02,UMB,304,111,193,304,0,ITI,ITI2,10,Umbria,Umbria,882015,348335,39.49,0.03
2863,2021-03-07,UMB,845,180,665,838,7,ITI,ITI2,10,Umbria,Umbria,882015,349180,39.59,0.1
2864,2021-04-02,UMB,4308,1746,2562,3551,757,ITI,ITI2,10,Umbria,Umbria,882015,353488,40.08,0.49
2865,2021-04-19,UMB,5015,2216,2799,2966,2049,ITI,ITI2,10,Umbria,Umbria,882015,358503,40.65,0.57
2866,2021-03-05,UMB,4592,1379,3213,3936,656,ITI,ITI2,10,Umbria,Umbria,882015,363095,41.17,0.52
2867,2021-02-24,UMB,1520,565,955,1505,15,ITI,ITI2,10,Umbria,Umbria,882015,364615,41.34,0.17
2868,2021-05-08,UMB,8100,3730,4370,4904,3196,ITI,ITI2,10,Umbria,Umbria,882015,372715,42.26,0.92
2869,2021-05-03,UMB,5091,2271,2820,2204,2887,ITI,ITI2,10,Umbria,Umbria,882015,377806,42.83,0.58
2870,2021-01-21,UMB,610,202,408,341,269,ITI,ITI2,10,Umbria,Umbria,882015,378416,42.9,0.07
2871,2021-05-25,UMB,8753,4258,4495,7735,1018,ITI,ITI2,10,Umbria,Umbria,882015,387169,43.9,0.99
2872,2021-03-22,UMB,3559,1654,1905,2313,1246,ITI,ITI2,10,Umbria,Umbria,882015,390728,44.3,0.4
2873,2021-02-07,UMB,54,17,37,1,53,ITI,ITI2,10,Umbria,Umbria,882015,390782,44.31,0.01
2874,2021-01-26,UMB,816,390,426,18,798,ITI,ITI2,10,Umbria,Umbria,882015,391598,44.4,0.09
2875,2021-05-06,UMB,9453,4310,5143,6146,3307,ITI,ITI2,10,Umbria,Umbria,882015,401051,45.47,1.07
2876,2021-04-21,UMB,5310,2308,3002,3084,2226,ITI,ITI2,10,Umbria,Umbria,882015,406361,46.07,0.6
2877,2021-03-02,UMB,3642,1346,2296,3638,4,ITI,ITI2,10,Umbria,Umbria,882015,410003,46.48,0.41
2878,2021-05-09,UMB,5765,2757,3008,5374,391,ITI,ITI2,10,Umbria,Umbria,882015,415768,47.14,0.65
2879,2021-02-19,UMB,743,293,450,526,217,ITI,ITI2,10,Umbria,Umbria,882015,416511,47.22,0.08
2880,2021-06-01,UMB,3333,1566,1767,3212,121,ITI,ITI2,10,Umbria,Umbria,882015,419844,47.6,0.38
2881,2021-01-16,UMB,221,73,148,221,0,ITI,ITI2,10,Umbria,Umbria,882015,420065,47.63,0.03
2882,2021-04-26,UMB,5374,2328,3046,3122,2252,ITI,ITI2,10,Umbria,Umbria,882015,425439,48.23,0.61
2883,2021-04-09,UMB,6791,3162,3629,6572,219,ITI,ITI2,10,Umbria,Umbria,882015,432230,49.0,0.77
2884,2021-02-04,UMB,733,226,507,25,708,ITI,ITI2,10,Umbria,Umbria,882015,432963,49.09,0.08
2885,2021-05-15,UMB,4977,1872,3105,1812,3165,ITI,ITI2,10,Umbria,Umbria,882015,437940,49.65,0.56
2886,2021-04-17,UMB,6665,3059,3606,5325,1340,ITI,ITI2,10,Umbria,Umbria,882015,444605,50.41,0.76
2887,2021-04-24,UMB,4562,1963,2599,3384,1178,ITI,ITI2,10,Umbria,Umbria,882015,449167,50.93,0.52
2888,2021-03-14,UMB,66,48,18,66,0,ITI,ITI2,10,Umbria,Umbria,882015,449233,50.93,0.01
2889,2021-03-12,UMB,2653,1040,1613,2157,496,ITI,ITI2,10,Umbria,Umbria,882015,451886,51.23,0.3
2890,2021-03-21,UMB,665,330,335,665,0,ITI,ITI2,10,Umbria,Umbria,882015,452551,51.31,0.08
2891,2021-05-17,UMB,6360,3058,3302,4187,2173,ITI,ITI2,10,Umbria,Umbria,882015,458911,52.03,0.72
2892,2021-01-14,UMB,752,201,551,752,0,ITI,ITI2,10,Umbria,Umbria,882015,459663,52.12,0.09
2893,2021-03-19,UMB,1743,565,1178,1087,656,ITI,ITI2,10,Umbria,Umbria,882015,461406,52.31,0.2
2894,2021-04-12,UMB,7086,3076,4010,5369,1717,ITI,ITI2,10,Umbria,Umbria,882015,468492,53.12,0.8
2895,2021-04-29,UMB,5209,2245,2964,2883,2326,ITI,ITI2,10,Umbria,Umbria,882015,473701,53.71,0.59
2896,2021-01-17,UMB,54,17,37,54,0,ITI,ITI2,10,Umbria,Umbria,882015,473755,53.71,0.01
2897,2020-12-31,UMB,322,127,195,322,0,ITI,ITI2,10,Umbria,Umbria,882015,474077,53.75,0.04
2898,2021-03-26,UMB,4570,1682,2888,4398,172,ITI,ITI2,10,Umbria,Umbria,882015,478647,54.27,0.52
2899,2021-05-01,UMB,5373,2640,2733,2146,3227,ITI,ITI2,10,Umbria,Umbria,882015,484020,54.88,0.61
2900,2021-03-03,UMB,4438,1773,2665,3727,711,ITI,ITI2,10,Umbria,Umbria,882015,488458,55.38,0.5
2901,2021-05-10,UMB,5982,2799,3183,3830,2152,ITI,ITI2,10,Umbria,Umbria,882015,494440,56.06,0.68
2902,2021-01-28,UMB,1247,394,853,19,1228,ITI,ITI2,10,Umbria,Umbria,882015,495687,56.2,0.14
2903,2021-01-23,UMB,280,100,180,2,278,ITI,ITI2,10,Umbria,Umbria,882015,495967,56.23,0.03
2904,2021-02-11,UMB,842,349,493,837,5,ITI,ITI2,10,Umbria,Umbria,882015,496809,56.33,0.1
2905,2021-01-09,UMB,1745,499,1246,1745,0,ITI,ITI2,10,Umbria,Umbria,882015,498554,56.52,0.2
2906,2021-05-29,UMB,7823,3593,4230,6268,1555,ITI,ITI2,10,Umbria,Umbria,882015,506377,57.41,0.89
2907,2021-02-23,UMB,1693,658,1035,1651,42,ITI,ITI2,10,Umbria,Umbria,882015,508070,57.6,0.19
2908,2021-02-13,UMB,115,28,87,112,3,ITI,ITI2,10,Umbria,Umbria,882015,508185,57.62,0.01
2909,2021-05-24,UMB,9015,4480,4535,8169,846,ITI,ITI2,10,Umbria,Umbria,882015,517200,58.64,1.02
2910,2021-04-18,UMB,1530,680,850,600,930,ITI,ITI2,10,Umbria,Umbria,882015,518730,58.81,0.17
2911,2021-04-04,UMB,59,20,39,23,36,ITI,ITI2,10,Umbria,Umbria,882015,518789,58.82,0.01
2912,2021-02-27,UMB,1658,354,1304,1642,16,ITI,ITI2,10,Umbria,Umbria,882015,520447,59.01,0.19
2913,2021-04-03,UMB,2111,716,1395,1058,1053,ITI,ITI2,10,Umbria,Umbria,882015,522558,59.25,0.24
2914,2021-01-08,UMB,1190,345,845,1190,0,ITI,ITI2,10,Umbria,Umbria,882015,523748,59.38,0.13
2915,2021-05-23,UMB,5068,1855,3213,652,4416,ITI,ITI2,10,Umbria,Umbria,882015,528816,59.96,0.57
2916,2021-01-07,UMB,1300,387,913,1300,0,ITI,ITI2,10,Umbria,Umbria,882015,530116,60.1,0.15
2917,2021-02-12,UMB,671,224,447,665,6,ITI,ITI2,10,Umbria,Umbria,882015,530787,60.18,0.08
2918,2021-02-26,UMB,660,253,407,652,8,ITI,ITI2,10,Umbria,Umbria,882015,531447,60.25,0.07
2919,2021-05-08,MAR,12270,5477,6793,5022,7248,ITI,ITI3,11,Marche,Marche,1525271,12270,0.8,0.8
2920,2021-04-02,MAR,6875,2973,3902,6135,740,ITI,ITI3,11,Marche,Marche,1525271,19145,1.26,0.45
2921,2021-01-28,MAR,2086,725,1361,165,1921,ITI,ITI3,11,Marche,Marche,1525271,21231,1.39,0.14
2922,2021-04-04,MAR,3824,1792,2032,2655,1169,ITI,ITI3,11,Marche,Marche,1525271,25055,1.64,0.25
2923,2021-03-24,MAR,7032,2983,4049,3364,3668,ITI,ITI3,11,Marche,Marche,1525271,32087,2.1,0.46
2924,2021-03-10,MAR,5669,2402,3267,4532,1137,ITI,ITI3,11,Marche,Marche,1525271,37756,2.48,0.37
2925,2021-02-21,MAR,376,141,235,375,1,ITI,ITI3,11,Marche,Marche,1525271,38132,2.5,0.02
2926,2021-01-19,MAR,228,83,145,142,86,ITI,ITI3,11,Marche,Marche,1525271,38360,2.51,0.01
2927,2021-05-13,MAR,12601,5694,6907,7102,5499,ITI,ITI3,11,Marche,Marche,1525271,50961,3.34,0.83
2928,2021-01-02,MAR,453,139,314,453,0,ITI,ITI3,11,Marche,Marche,1525271,51414,3.37,0.03
2929,2021-03-07,MAR,5182,2108,3074,4428,754,ITI,ITI3,11,Marche,Marche,1525271,56596,3.71,0.34
2930,2021-05-31,MAR,11784,5945,5839,8855,2929,ITI,ITI3,11,Marche,Marche,1525271,68380,4.48,0.77
2931,2021-02-18,MAR,2101,745,1356,1815,286,ITI,ITI3,11,Marche,Marche,1525271,70481,4.62,0.14
2932,2021-05-29,MAR,12789,6195,6594,8261,4528,ITI,ITI3,11,Marche,Marche,1525271,83270,5.46,0.84
2933,2021-02-25,MAR,3510,1434,2076,3331,179,ITI,ITI3,11,Marche,Marche,1525271,86780,5.69,0.23
2934,2021-04-23,MAR,11159,5140,6019,8104,3055,ITI,ITI3,11,Marche,Marche,1525271,97939,6.42,0.73
2935,2021-04-26,MAR,8980,3983,4997,5958,3022,ITI,ITI3,11,Marche,Marche,1525271,106919,7.01,0.59
2936,2021-01-23,MAR,557,190,367,123,434,ITI,ITI3,11,Marche,Marche,1525271,107476,7.05,0.04
2937,2021-03-28,MAR,4126,1739,2387,2435,1691,ITI,ITI3,11,Marche,Marche,1525271,111602,7.32,0.27
2938,2021-05-10,MAR,9447,4336,5111,4895,4552,ITI,ITI3,11,Marche,Marche,1525271,121049,7.94,0.62
2939,2021-03-14,MAR,2501,1032,1469,1908,593,ITI,ITI3,11,Marche,Marche,1525271,123550,8.1,0.16
2940,2021-01-21,MAR,899,255,644,585,314,ITI,ITI3,11,Marche,Marche,1525271,124449,8.16,0.06
2941,2021-05-01,MAR,9318,3924,5394,3576,5742,ITI,ITI3,11,Marche,Marche,1525271,133767,8.77,0.61
2942,2021-03-05,MAR,6171,2856,3315,4703,1468,ITI,ITI3,11,Marche,Marche,1525271,139938,9.17,0.4
2943,2021-01-07,MAR,1807,636,1171,1807,0,ITI,ITI3,11,Marche,Marche,1525271,141745,9.29,0.12
2944,2021-03-12,MAR,4640,1972,2668,3402,1238,ITI,ITI3,11,Marche,Marche,1525271,146385,9.6,0.3
2945,2021-01-14,MAR,2010,692,1318,2010,0,ITI,ITI3,11,Marche,Marche,1525271,148395,9.73,0.13
2946,2021-04-24,MAR,12026,5304,6722,7560,4466,ITI,ITI3,11,Marche,Marche,1525271,160421,10.52,0.79
2947,2021-02-26,MAR,3630,1499,2131,3154,476,ITI,ITI3,11,Marche,Marche,1525271,164051,10.76,0.24
2948,2021-04-05,MAR,5688,2355,3333,4419,1269,ITI,ITI3,11,Marche,Marche,1525271,169739,11.13,0.37
2949,2021-03-19,MAR,3835,1597,2238,339,3496,ITI,ITI3,11,Marche,Marche,1525271,173574,11.38,0.25
2950,2021-03-02,MAR,4953,1941,3012,4387,566,ITI,ITI3,11,Marche,Marche,1525271,178527,11.7,0.32
2951,2021-05-22,MAR,11933,5718,6215,7485,4448,ITI,ITI3,11,Marche,Marche,1525271,190460,12.49,0.78
2952,2021-05-05,MAR,11646,5299,6347,5217,6429,ITI,ITI3,11,Marche,Marche,1525271,202106,13.25,0.76
2953,2021-05-20,MAR,12365,5814,6551,7666,4699,ITI,ITI3,11,Marche,Marche,1525271,214471,14.06,0.81
2954,2021-02-07,MAR,1868,734,1134,344,1524,ITI,ITI3,11,Marche,Marche,1525271,216339,14.18,0.12
2955,2021-04-07,MAR,7810,3435,4375,7475,335,ITI,ITI3,11,Marche,Marche,1525271,224149,14.7,0.51
2956,2021-04-16,MAR,10082,4702,5380,9557,525,ITI,ITI3,11,Marche,Marche,1525271,234231,15.36,0.66
2957,2021-01-04,MAR,1505,567,938,1505,0,ITI,ITI3,11,Marche,Marche,1525271,235736,15.46,0.1
2958,2020-12-30,MAR,17,5,12,17,0,ITI,ITI3,11,Marche,Marche,1525271,235753,15.46,0.0
2959,2021-01-12,MAR,1227,413,814,1227,0,ITI,ITI3,11,Marche,Marche,1525271,236980,15.54,0.08
2960,2021-05-03,MAR,10196,4605,5591,4789,5407,ITI,ITI3,11,Marche,Marche,1525271,247176,16.21,0.67
2961,2021-01-30,MAR,1905,668,1237,29,1876,ITI,ITI3,11,Marche,Marche,1525271,249081,16.33,0.12
2962,2021-03-21,MAR,4505,1873,2632,1629,2876,ITI,ITI3,11,Marche,Marche,1525271,253586,16.63,0.3
2963,2021-01-26,MAR,2017,746,1271,92,1925,ITI,ITI3,11,Marche,Marche,1525271,255603,16.76,0.13
2964,2021-04-19,MAR,9603,4498,5105,8022,1581,ITI,ITI3,11,Marche,Marche,1525271,265206,17.39,0.63
2965,2021-02-14,MAR,738,301,437,738,0,ITI,ITI3,11,Marche,Marche,1525271,265944,17.44,0.05
2966,2021-01-09,MAR,1709,605,1104,1709,0,ITI,ITI3,11,Marche,Marche,1525271,267653,17.55,0.11
2967,2021-03-16,MAR,3471,1485,1986,290,3181,ITI,ITI3,11,Marche,Marche,1525271,271124,17.78,0.23
2968,2021-01-11,MAR,1176,411,765,1176,0,ITI,ITI3,11,Marche,Marche,1525271,272300,17.85,0.08
2969,2021-04-21,MAR,10781,4967,5814,9587,1194,ITI,ITI3,11,Marche,Marche,1525271,283081,18.56,0.71
2970,2021-03-17,MAR,3428,1494,1934,107,3321,ITI,ITI3,11,Marche,Marche,1525271,286509,18.78,0.22
2971,2021-02-28,MAR,2836,1251,1585,2830,6,ITI,ITI3,11,Marche,Marche,1525271,289345,18.97,0.19
2972,2021-05-24,MAR,10797,5112,5685,8123,2674,ITI,ITI3,11,Marche,Marche,1525271,300142,19.68,0.71
2973,2021-02-11,MAR,1987,657,1330,1598,389,ITI,ITI3,11,Marche,Marche,1525271,302129,19.81,0.13
2974,2021-05-27,MAR,13731,6818,6913,9430,4301,ITI,ITI3,11,Marche,Marche,1525271,315860,20.71,0.9
2975,2021-03-31,MAR,7374,3086,4288,4350,3024,ITI,ITI3,11,Marche,Marche,1525271,323234,21.19,0.48
2976,2021-03-29,MAR,5860,2567,3293,3435,2425,ITI,ITI3,11,Marche,Marche,1525271,329094,21.58,0.38
2977,2021-02-16,MAR,1287,475,812,1257,30,ITI,ITI3,11,Marche,Marche,1525271,330381,21.66,0.08
2978,2021-02-23,MAR,3267,1397,1870,3211,56,ITI,ITI3,11,Marche,Marche,1525271,333648,21.87,0.21
2979,2021-05-12,MAR,10423,4685,5738,4922,5501,ITI,ITI3,11,Marche,Marche,1525271,344071,22.56,0.68
2980,2021-02-27,MAR,3356,1435,1921,3147,209,ITI,ITI3,11,Marche,Marche,1525271,347427,22.78,0.22
2981,2021-03-18,MAR,3389,1475,1914,162,3227,ITI,ITI3,11,Marche,Marche,1525271,350816,23.0,0.22
2982,2021-05-23,MAR,9208,4282,4926,7537,1671,ITI,ITI3,11,Marche,Marche,1525271,360024,23.6,0.6
2983,2021-02-12,MAR,1582,618,964,1430,152,ITI,ITI3,11,Marche,Marche,1525271,361606,23.71,0.1
2984,2021-02-10,MAR,1439,452,987,1080,359,ITI,ITI3,11,Marche,Marche,1525271,363045,23.8,0.09
2985,2021-05-15,MAR,13966,6376,7590,8076,5890,ITI,ITI3,11,Marche,Marche,1525271,377011,24.72,0.92
2986,2021-02-19,MAR,1962,712,1250,1827,135,ITI,ITI3,11,Marche,Marche,1525271,378973,24.85,0.13
2987,2020-12-31,MAR,385,180,205,385,0,ITI,ITI3,11,Marche,Marche,1525271,379358,24.87,0.03
2988,2021-02-04,MAR,2341,809,1532,112,2229,ITI,ITI3,11,Marche,Marche,1525271,381699,25.02,0.15
2989,2021-03-26,MAR,6331,2606,3725,3523,2808,ITI,ITI3,11,Marche,Marche,1525271,388030,25.44,0.42
2990,2021-05-17,MAR,11853,5568,6285,7690,4163,ITI,ITI3,11,Marche,Marche,1525271,399883,26.22,0.78
2991,2021-04-30,MAR,13940,6100,7840,5398,8542,ITI,ITI3,11,Marche,Marche,1525271,413823,27.13,0.91
2992,2021-03-11,MAR,6593,2785,3808,5223,1370,ITI,ITI3,11,Marche,Marche,1525271,420416,27.56,0.43
2993,2021-05-14,MAR,13492,6217,7275,6720,6772,ITI,ITI3,11,Marche,Marche,1525271,433908,28.45,0.88
2994,2021-06-01,MAR,7791,4030,3761,6332,1459,ITI,ITI3,11,Marche,Marche,1525271,441699,28.96,0.51
2995,2021-02-02,MAR,1191,397,794,72,1119,ITI,ITI3,11,Marche,Marche,1525271,442890,29.04,0.08
2996,2021-04-12,MAR,8567,3772,4795,8083,484,ITI,ITI3,11,Marche,Marche,1525271,451457,29.6,0.56
2997,2021-01-16,MAR,2005,723,1282,2005,0,ITI,ITI3,11,Marche,Marche,1525271,453462,29.73,0.13
2998,2021-01-15,MAR,1771,500,1271,1771,0,ITI,ITI3,11,Marche,Marche,1525271,455233,29.85,0.12
2999,2021-04-25,MAR,8600,3994,4606,7025,1575,ITI,ITI3,11,Marche,Marche,1525271,463833,30.41,0.56
3000,2021-01-13,MAR,2105,746,1359,2105,0,ITI,ITI3,11,Marche,Marche,1525271,465938,30.55,0.14
3001,2021-05-02,MAR,8899,3936,4963,3161,5738,ITI,ITI3,11,Marche,Marche,1525271,474837,31.13,0.58
3002,2021-01-31,MAR,1920,770,1150,105,1815,ITI,ITI3,11,Marche,Marche,1525271,476757,31.26,0.13
3003,2021-02-09,MAR,124,42,82,46,78,ITI,ITI3,11,Marche,Marche,1525271,476881,31.27,0.01
3004,2021-04-14,MAR,10215,4564,5651,9843,372,ITI,ITI3,11,Marche,Marche,1525271,487096,31.94,0.67
3005,2021-04-09,MAR,9560,4189,5371,9360,200,ITI,ITI3,11,Marche,Marche,1525271,496656,32.56,0.63
3006,2021-01-06,MAR,2181,792,1389,2181,0,ITI,ITI3,11,Marche,Marche,1525271,498837,32.7,0.14
3007,2021-05-21,MAR,12951,6113,6838,6695,6256,ITI,ITI3,11,Marche,Marche,1525271,511788,33.55,0.85
3008,2021-04-01,MAR,7577,3182,4395,4161,3416,ITI,ITI3,11,Marche,Marche,1525271,519365,34.05,0.5
3009,2021-04-22,MAR,10795,4930,5865,9217,1578,ITI,ITI3,11,Marche,Marche,1525271,530160,34.76,0.71
3010,2021-03-03,MAR,6643,3046,3597,5761,882,ITI,ITI3,11,Marche,Marche,1525271,536803,35.19,0.44
3011,2021-01-05,MAR,1562,586,976,1562,0,ITI,ITI3,11,Marche,Marche,1525271,538365,35.3,0.1
3012,2021-04-17,MAR,11701,5316,6385,10628,1073,ITI,ITI3,11,Marche,Marche,1525271,550066,36.06,0.77
3013,2021-02-13,MAR,1063,453,610,1011,52,ITI,ITI3,11,Marche,Marche,1525271,551129,36.13,0.07
3014,2021-01-27,MAR,2118,780,1338,122,1996,ITI,ITI3,11,Marche,Marche,1525271,553247,36.27,0.14
3015,2021-04-18,MAR,8820,4131,4689,7899,921,ITI,ITI3,11,Marche,Marche,1525271,562067,36.85,0.58
3016,2021-01-10,MAR,1737,699,1038,1737,0,ITI,ITI3,11,Marche,Marche,1525271,563804,36.96,0.11
3017,2021-03-04,MAR,6487,2869,3618,5094,1393,ITI,ITI3,11,Marche,Marche,1525271,570291,37.39,0.43
3018,2021-03-13,MAR,5768,2656,3112,1811,3957,ITI,ITI3,11,Marche,Marche,1525271,576059,37.77,0.38
3019,2021-01-29,MAR,1991,730,1261,167,1824,ITI,ITI3,11,Marche,Marche,1525271,578050,37.9,0.13
3020,2021-05-11,MAR,10622,4832,5790,5678,4944,ITI,ITI3,11,Marche,Marche,1525271,588672,38.59,0.7
3021,2021-02-06,MAR,2460,900,1560,522,1938,ITI,ITI3,11,Marche,Marche,1525271,591132,38.76,0.16
3022,2021-05-28,MAR,13960,6736,7224,9098,4862,ITI,ITI3,11,Marche,Marche,1525271,605092,39.67,0.92
3023,2021-02-24,MAR,3486,1515,1971,3408,78,ITI,ITI3,11,Marche,Marche,1525271,608578,39.9,0.23
3024,2021-04-08,MAR,7522,3285,4237,7195,327,ITI,ITI3,11,Marche,Marche,1525271,616100,40.39,0.49
3025,2021-04-15,MAR,10376,4674,5702,9811,565,ITI,ITI3,11,Marche,Marche,1525271,626476,41.07,0.68
3026,2021-03-27,MAR,7379,3073,4306,5021,2358,ITI,ITI3,11,Marche,Marche,1525271,633855,41.56,0.48
3027,2021-04-10,MAR,10917,4620,6297,10603,314,ITI,ITI3,11,Marche,Marche,1525271,644772,42.27,0.72
3028,2021-02-05,MAR,2155,653,1502,440,1715,ITI,ITI3,11,Marche,Marche,1525271,646927,42.41,0.14
3029,2021-05-16,MAR,10898,4957,5941,6670,4228,ITI,ITI3,11,Marche,Marche,1525271,657825,43.13,0.71
3030,2021-05-30,MAR,9744,4695,5049,6752,2992,ITI,ITI3,11,Marche,Marche,1525271,667569,43.77,0.64
3031,2021-02-15,MAR,967,412,555,954,13,ITI,ITI3,11,Marche,Marche,1525271,668536,43.83,0.06
3032,2021-05-26,MAR,11805,5916,5889,8620,3185,ITI,ITI3,11,Marche,Marche,1525271,680341,44.6,0.77
3033,2021-03-30,MAR,7418,3044,4374,4603,2815,ITI,ITI3,11,Marche,Marche,1525271,687759,45.09,0.49
3034,2021-02-01,MAR,1362,479,883,98,1264,ITI,ITI3,11,Marche,Marche,1525271,689121,45.18,0.09
3035,2021-04-06,MAR,8879,3693,5186,8066,813,ITI,ITI3,11,Marche,Marche,1525271,698000,45.76,0.58
3036,2021-03-23,MAR,5789,2529,3260,2262,3527,ITI,ITI3,11,Marche,Marche,1525271,703789,46.14,0.38
3037,2021-02-08,MAR,833,258,575,371,462,ITI,ITI3,11,Marche,Marche,1525271,704622,46.2,0.05
3038,2021-05-19,MAR,11471,5272,6199,8562,2909,ITI,ITI3,11,Marche,Marche,1525271,716093,46.95,0.75
3039,2020-12-27,MAR,200,97,103,200,0,ITI,ITI3,11,Marche,Marche,1525271,716293,46.96,0.01
3040,2021-03-20,MAR,4135,1740,2395,1049,3086,ITI,ITI3,11,Marche,Marche,1525271,720428,47.23,0.27
3041,2021-01-22,MAR,487,167,320,194,293,ITI,ITI3,11,Marche,Marche,1525271,720915,47.26,0.03
3042,2021-05-06,MAR,12655,5820,6835,5582,7073,ITI,ITI3,11,Marche,Marche,1525271,733570,48.09,0.83
3043,2021-05-25,MAR,11646,5744,5902,8717,2929,ITI,ITI3,11,Marche,Marche,1525271,745216,48.86,0.76
3044,2021-03-22,MAR,5655,2376,3279,2527,3128,ITI,ITI3,11,Marche,Marche,1525271,750871,49.23,0.37
3045,2021-01-24,MAR,880,339,541,5,875,ITI,ITI3,11,Marche,Marche,1525271,751751,49.29,0.06
3046,2021-05-04,MAR,10845,4789,6056,4950,5895,ITI,ITI3,11,Marche,Marche,1525271,762596,50.0,0.71
3047,2021-05-07,MAR,12838,5805,7033,3660,9178,ITI,ITI3,11,Marche,Marche,1525271,775434,50.84,0.84
3048,2021-04-20,MAR,10698,4996,5702,9281,1417,ITI,ITI3,11,Marche,Marche,1525271,786132,51.54,0.7
3049,2021-01-25,MAR,1598,561,1037,97,1501,ITI,ITI3,11,Marche,Marche,1525271,787730,51.65,0.1
3050,2021-01-08,MAR,1576,588,988,1576,0,ITI,ITI3,11,Marche,Marche,1525271,789306,51.75,0.1
3051,2021-04-03,MAR,7573,3204,4369,6903,670,ITI,ITI3,11,Marche,Marche,1525271,796879,52.25,0.5
3052,2021-05-09,MAR,8770,3986,4784,3639,5131,ITI,ITI3,11,Marche,Marche,1525271,805649,52.82,0.57
3053,2021-03-06,MAR,5702,2625,3077,4435,1267,ITI,ITI3,11,Marche,Marche,1525271,811351,53.19,0.37
3054,2021-05-18,MAR,11061,5257,5804,7657,3404,ITI,ITI3,11,Marche,Marche,1525271,822412,53.92,0.73
3055,2021-03-01,MAR,3724,1487,2237,3476,248,ITI,ITI3,11,Marche,Marche,1525271,826136,54.16,0.24
3056,2021-02-17,MAR,1785,662,1123,1668,117,ITI,ITI3,11,Marche,Marche,1525271,827921,54.28,0.12
3057,2021-04-11,MAR,7116,3115,4001,6830,286,ITI,ITI3,11,Marche,Marche,1525271,835037,54.75,0.47
3058,2021-03-25,MAR,6656,2772,3884,3247,3409,ITI,ITI3,11,Marche,Marche,1525271,841693,55.18,0.44
3059,2021-02-20,MAR,4121,1705,2416,4010,111,ITI,ITI3,11,Marche,Marche,1525271,845814,55.45,0.27
3060,2021-01-20,MAR,403,100,303,384,19,ITI,ITI3,11,Marche,Marche,1525271,846217,55.48,0.03
3061,2021-02-03,MAR,2124,741,1383,119,2005,ITI,ITI3,11,Marche,Marche,1525271,848341,55.62,0.14
3062,2021-04-29,MAR,13246,6061,7185,7149,6097,ITI,ITI3,11,Marche,Marche,1525271,861587,56.49,0.87
3063,2021-03-15,MAR,4402,2027,2375,1312,3090,ITI,ITI3,11,Marche,Marche,1525271,865989,56.78,0.29
3064,2021-01-18,MAR,673,230,443,547,126,ITI,ITI3,11,Marche,Marche,1525271,866662,56.82,0.04
3065,2021-04-28,MAR,10734,4890,5844,6003,4731,ITI,ITI3,11,Marche,Marche,1525271,877396,57.52,0.7
3066,2021-03-09,MAR,5429,2291,3138,4549,880,ITI,ITI3,11,Marche,Marche,1525271,882825,57.88,0.36
3067,2021-04-13,MAR,9838,4259,5579,9605,233,ITI,ITI3,11,Marche,Marche,1525271,892663,58.52,0.65
3068,2021-02-22,MAR,3413,1499,1914,3338,75,ITI,ITI3,11,Marche,Marche,1525271,896076,58.75,0.22
3069,2021-01-03,MAR,897,349,548,897,0,ITI,ITI3,11,Marche,Marche,1525271,896973,58.81,0.06
3070,2021-03-08,MAR,6264,2744,3520,5262,1002,ITI,ITI3,11,Marche,Marche,1525271,903237,59.22,0.41
3071,2021-04-27,MAR,9400,4309,5091,5413,3987,ITI,ITI3,11,Marche,Marche,1525271,912637,59.83,0.62
3072,2021-01-17,MAR,1607,687,920,1550,57,ITI,ITI3,11,Marche,Marche,1525271,914244,59.94,0.11
3073,2021-04-23,FVG,7455,3375,4080,3599,3856,ITH,ITH4,6,Friuli-Venezia Giulia,Friuli Venezia Giulia,1215220,7455,0.61,0.61
3074,2021-03-18,FVG,3371,1421,1950,1690,1681,ITH,ITH4,6,Friuli-Venezia Giulia,Friuli Venezia Giulia,1215220,10826,0.89,0.28
3075,2021-03-20,FVG,3340,1351,1989,1249,2091,ITH,ITH4,6,Friuli-Venezia Giulia,Friuli Venezia Giulia,1215220,14166,1.17,0.27
3076,2021-01-13,FVG,2650,834,1816,2650,0,ITH,ITH4,6,Friuli-Venezia Giulia,Friuli Venezia Giulia,1215220,16816,1.38,0.22
3077,2021-01-04,FVG,1507,558,949,1507,0,ITH,ITH4,6,Friuli-Venezia Giulia,Friuli Venezia Giulia,1215220,18323,1.51,0.12
3078,2021-02-06,FVG,1154,338,816,22,1132,ITH,ITH4,6,Friuli-Venezia Giulia,Friuli Venezia Giulia,1215220,19477,1.6,0.09
3079,2021-02-23,FVG,2617,1252,1365,2437,180,ITH,ITH4,6,Friuli-Venezia Giulia,Friuli Venezia Giulia,1215220,22094,1.82,0.22
3080,2021-03-09,FVG,3855,1589,2266,1108,2747,ITH,ITH4,6,Friuli-Venezia Giulia,Friuli Venezia Giulia,1215220,25949,2.14,0.32
3081,2021-03-13,FVG,2935,1120,1815,1664,1271,ITH,ITH4,6,Friuli-Venezia Giulia,Friuli Venezia Giulia,1215220,28884,2.38,0.24
3082,2021-05-02,FVG,6838,3210,3628,3939,2899,ITH,ITH4,6,Friuli-Venezia Giulia,Friuli Venezia Giulia,1215220,35722,2.94,0.56
3083,2021-04-08,FVG,7207,3014,4193,5287,1920,ITH,ITH4,6,Friuli-Venezia Giulia,Friuli Venezia Giulia,1215220,42929,3.53,0.59
3084,2021-05-21,FVG,11011,4898,6113,8136,2875,ITH,ITH4,6,Friuli-Venezia Giulia,Friuli Venezia Giulia,1215220,53940,4.44,0.91
3085,2021-02-10,FVG,1352,496,856,1266,86,ITH,ITH4,6,Friuli-Venezia Giulia,Friuli Venezia Giulia,1215220,55292,4.55,0.11
3086,2021-05-14,FVG,10555,5228,5327,8083,2472,ITH,ITH4,6,Friuli-Venezia Giulia,Friuli Venezia Giulia,1215220,65847,5.42,0.87
3087,2021-02-03,FVG,2647,791,1856,23,2624,ITH,ITH4,6,Friuli-Venezia Giulia,Friuli Venezia Giulia,1215220,68494,5.64,0.22
3088,2021-04-11,FVG,3433,1520,1913,2527,906,ITH,ITH4,6,Friuli-Venezia Giulia,Friuli Venezia Giulia,1215220,71927,5.92,0.28
3089,2021-02-27,FVG,3528,1200,2328,3527,1,ITH,ITH4,6,Friuli-Venezia Giulia,Friuli Venezia Giulia,1215220,75455,6.21,0.29
3090,2021-04-25,FVG,2363,990,1373,2352,11,ITH,ITH4,6,Friuli-Venezia Giulia,Friuli Venezia Giulia,1215220,77818,6.4,0.19
3091,2021-01-08,FVG,2322,747,1575,2322,0,ITH,ITH4,6,Friuli-Venezia Giulia,Friuli Venezia Giulia,1215220,80140,6.59,0.19
3092,2021-02-20,FVG,2068,933,1135,1924,144,ITH,ITH4,6,Friuli-Venezia Giulia,Friuli Venezia Giulia,1215220,82208,6.76,0.17
3093,2021-02-18,FVG,3218,1492,1726,2811,407,ITH,ITH4,6,Friuli-Venezia Giulia,Friuli Venezia Giulia,1215220,85426,7.03,0.26
3094,2021-04-02,FVG,6566,2915,3651,4733,1833,ITH,ITH4,6,Friuli-Venezia Giulia,Friuli Venezia Giulia,1215220,91992,7.57,0.54
3095,2021-04-16,FVG,6910,2995,3915,4987,1923,ITH,ITH4,6,Friuli-Venezia Giulia,Friuli Venezia Giulia,1215220,98902,8.14,0.57
3096,2021-01-06,FVG,710,264,446,710,0,ITH,ITH4,6,Friuli-Venezia Giulia,Friuli Venezia Giulia,1215220,99612,8.2,0.06
3097,2021-02-11,FVG,1930,664,1266,1738,192,ITH,ITH4,6,Friuli-Venezia Giulia,Friuli Venezia Giulia,1215220,101542,8.36,0.16
3098,2021-04-09,FVG,7762,3528,4234,6518,1244,ITH,ITH4,6,Friuli-Venezia Giulia,Friuli Venezia Giulia,1215220,109304,8.99,0.64
3099,2020-12-30,FVG,626,244,382,626,0,ITH,ITH4,6,Friuli-Venezia Giulia,Friuli Venezia Giulia,1215220,109930,9.05,0.05
3100,2021-02-25,FVG,3160,1651,1509,3135,25,ITH,ITH4,6,Friuli-Venezia Giulia,Friuli Venezia Giulia,1215220,113090,9.31,0.26
3101,2021-05-24,FVG,10957,5252,5705,7496,3461,ITH,ITH4,6,Friuli-Venezia Giulia,Friuli Venezia Giulia,1215220,124047,10.21,0.9
3102,2021-03-04,FVG,3445,1595,1850,2787,658,ITH,ITH4,6,Friuli-Venezia Giulia,Friuli Venezia Giulia,1215220,127492,10.49,0.28
3103,2021-03-21,FVG,2602,937,1665,2193,409,ITH,ITH4,6,Friuli-Venezia Giulia,Friuli Venezia Giulia,1215220,130094,10.71,0.21
3104,2021-05-07,FVG,10537,4815,5722,7070,3467,ITH,ITH4,6,Friuli-Venezia Giulia,Friuli Venezia Giulia,1215220,140631,11.57,0.87
3105,2021-02-15,FVG,2453,911,1542,2201,252,ITH,ITH4,6,Friuli-Venezia Giulia,Friuli Venezia Giulia,1215220,143084,11.77,0.2
3106,2021-01-23,FVG,816,324,492,4,812,ITH,ITH4,6,Friuli-Venezia Giulia,Friuli Venezia Giulia,1215220,143900,11.84,0.07
3107,2021-05-05,FVG,9707,4230,5477,6266,3441,ITH,ITH4,6,Friuli-Venezia Giulia,Friuli Venezia Giulia,1215220,153607,12.64,0.8
3108,2021-03-23,FVG,3753,1558,2195,1613,2140,ITH,ITH4,6,Friuli-Venezia Giulia,Friuli Venezia Giulia,1215220,157360,12.95,0.31
3109,2021-04-01,FVG,6315,2993,3322,5300,1015,ITH,ITH4,6,Friuli-Venezia Giulia,Friuli Venezia Giulia,1215220,163675,13.47,0.52
3110,2021-05-31,FVG,7938,3855,4083,6156,1782,ITH,ITH4,6,Friuli-Venezia Giulia,Friuli Venezia Giulia,1215220,171613,14.12,0.65
3111,2021-01-15,FVG,2021,605,1416,2021,0,ITH,ITH4,6,Friuli-Venezia Giulia,Friuli Venezia Giulia,1215220,173634,14.29,0.17
3112,2021-04-18,FVG,6037,2799,3238,5630,407,ITH,ITH4,6,Friuli-Venezia Giulia,Friuli Venezia Giulia,1215220,179671,14.79,0.5
3113,2021-01-22,FVG,90,30,60,0,90,ITH,ITH4,6,Friuli-Venezia Giulia,Friuli Venezia Giulia,1215220,179761,14.79,0.01
3114,2021-03-06,FVG,3499,1196,2303,3174,325,ITH,ITH4,6,Friuli-Venezia Giulia,Friuli Venezia Giulia,1215220,183260,15.08,0.29
3115,2021-01-30,FVG,2275,745,1530,270,2005,ITH,ITH4,6,Friuli-Venezia Giulia,Friuli Venezia Giulia,1215220,185535,15.27,0.19
3116,2021-04-21,FVG,7702,3439,4263,4022,3680,ITH,ITH4,6,Friuli-Venezia Giulia,Friuli Venezia Giulia,1215220,193237,15.9,0.63
3117,2021-01-11,FVG,1882,608,1274,1882,0,ITH,ITH4,6,Friuli-Venezia Giulia,Friuli Venezia Giulia,1215220,195119,16.06,0.15
3118,2021-03-01,FVG,2957,1041,1916,2905,52,ITH,ITH4,6,Friuli-Venezia Giulia,Friuli Venezia Giulia,1215220,198076,16.3,0.24
3119,2021-04-06,FVG,6276,2771,3505,5126,1150,ITH,ITH4,6,Friuli-Venezia Giulia,Friuli Venezia Giulia,1215220,204352,16.82,0.52
3120,2021-02-13,FVG,566,179,387,560,6,ITH,ITH4,6,Friuli-Venezia Giulia,Friuli Venezia Giulia,1215220,204918,16.86,0.05
3121,2021-03-02,FVG,4219,1519,2700,2720,1499,ITH,ITH4,6,Friuli-Venezia Giulia,Friuli Venezia Giulia,1215220,209137,17.21,0.35
3122,2021-01-27,FVG,1272,425,847,450,822,ITH,ITH4,6,Friuli-Venezia Giulia,Friuli Venezia Giulia,1215220,210409,17.31,0.1
3123,2021-05-09,FVG,7338,3295,4043,3484,3854,ITH,ITH4,6,Friuli-Venezia Giulia,Friuli Venezia Giulia,1215220,217747,17.92,0.6
3124,2021-05-26,FVG,12656,6283,6373,9413,3243,ITH,ITH4,6,Friuli-Venezia Giulia,Friuli Venezia Giulia,1215220,230403,18.96,1.04
3125,2021-03-16,FVG,3153,1287,1866,1073,2080,ITH,ITH4,6,Friuli-Venezia Giulia,Friuli Venezia Giulia,1215220,233556,19.22,0.26
3126,2021-05-12,FVG,10669,4937,5732,9314,1355,ITH,ITH4,6,Friuli-Venezia Giulia,Friuli Venezia Giulia,1215220,244225,20.1,0.88
3127,2021-05-19,FVG,11693,5737,5956,9467,2226,ITH,ITH4,6,Friuli-Venezia Giulia,Friuli Venezia Giulia,1215220,255918,21.06,0.96
3128,2021-03-14,FVG,1395,547,848,1143,252,ITH,ITH4,6,Friuli-Venezia Giulia,Friuli Venezia Giulia,1215220,257313,21.17,0.11
3129,2021-02-01,FVG,2097,688,1409,16,2081,ITH,ITH4,6,Friuli-Venezia Giulia,Friuli Venezia Giulia,1215220,259410,21.35,0.17
3130,2021-02-08,FVG,2357,694,1663,92,2265,ITH,ITH4,6,Friuli-Venezia Giulia,Friuli Venezia Giulia,1215220,261767,21.54,0.19
3131,2021-04-27,FVG,8077,3703,4374,3619,4458,ITH,ITH4,6,Friuli-Venezia Giulia,Friuli Venezia Giulia,1215220,269844,22.21,0.66
3132,2021-02-12,FVG,1193,428,765,1146,47,ITH,ITH4,6,Friuli-Venezia Giulia,Friuli Venezia Giulia,1215220,271037,22.3,0.1
3133,2021-03-03,FVG,3639,1627,2012,2365,1274,ITH,ITH4,6,Friuli-Venezia Giulia,Friuli Venezia Giulia,1215220,274676,22.6,0.3
3134,2021-01-28,FVG,2239,794,1445,354,1885,ITH,ITH4,6,Friuli-Venezia Giulia,Friuli Venezia Giulia,1215220,276915,22.79,0.18
3135,2021-05-08,FVG,10248,4631,5617,5470,4778,ITH,ITH4,6,Friuli-Venezia Giulia,Friuli Venezia Giulia,1215220,287163,23.63,0.84
3136,2021-02-04,FVG,2725,808,1917,35,2690,ITH,ITH4,6,Friuli-Venezia Giulia,Friuli Venezia Giulia,1215220,289888,23.85,0.22
3137,2021-04-30,FVG,7304,3217,4087,3691,3613,ITH,ITH4,6,Friuli-Venezia Giulia,Friuli Venezia Giulia,1215220,297192,24.46,0.6
3138,2021-03-11,FVG,3355,1413,1942,1605,1750,ITH,ITH4,6,Friuli-Venezia Giulia,Friuli Venezia Giulia,1215220,300547,24.73,0.28
3139,2021-01-20,FVG,748,320,428,13,735,ITH,ITH4,6,Friuli-Venezia Giulia,Friuli Venezia Giulia,1215220,301295,24.79,0.06
3140,2021-05-16,FVG,9939,4759,5180,8545,1394,ITH,ITH4,6,Friuli-Venezia Giulia,Friuli Venezia Giulia,1215220,311234,25.61,0.82
3141,2021-02-24,FVG,2520,1084,1436,2502,18,ITH,ITH4,6,Friuli-Venezia Giulia,Friuli Venezia Giulia,1215220,313754,25.82,0.21
3142,2021-04-15,FVG,6487,2859,3628,5216,1271,ITH,ITH4,6,Friuli-Venezia Giulia,Friuli Venezia Giulia,1215220,320241,26.35,0.53
3143,2021-04-29,FVG,6683,2932,3751,4162,2521,ITH,ITH4,6,Friuli-Venezia Giulia,Friuli Venezia Giulia,1215220,326924,26.9,0.55
3144,2021-03-28,FVG,4810,2274,2536,4670,140,ITH,ITH4,6,Friuli-Venezia Giulia,Friuli Venezia Giulia,1215220,331734,27.3,0.4
3145,2021-01-18,FVG,1961,606,1355,1867,94,ITH,ITH4,6,Friuli-Venezia Giulia,Friuli Venezia Giulia,1215220,333695,27.46,0.16
3146,2021-05-17,FVG,8767,4073,4694,6290,2477,ITH,ITH4,6,Friuli-Venezia Giulia,Friuli Venezia Giulia,1215220,342462,28.18,0.72
3147,2021-04-17,FVG,7447,3232,4215,5965,1482,ITH,ITH4,6,Friuli-Venezia Giulia,Friuli Venezia Giulia,1215220,349909,28.79,0.61
3148,2021-04-10,FVG,4985,2164,2821,3760,1225,ITH,ITH4,6,Friuli-Venezia Giulia,Friuli Venezia Giulia,1215220,354894,29.2,0.41
3149,2021-05-23,FVG,10249,4843,5406,6110,4139,ITH,ITH4,6,Friuli-Venezia Giulia,Friuli Venezia Giulia,1215220,365143,30.05,0.84
3150,2021-01-07,FVG,2090,717,1373,2090,0,ITH,ITH4,6,Friuli-Venezia Giulia,Friuli Venezia Giulia,1215220,367233,30.22,0.17
3151,2021-03-05,FVG,3736,1478,2258,2663,1073,ITH,ITH4,6,Friuli-Venezia Giulia,Friuli Venezia Giulia,1215220,370969,30.53,0.31
3152,2020-12-31,FVG,1053,384,669,1053,0,ITH,ITH4,6,Friuli-Venezia Giulia,Friuli Venezia Giulia,1215220,372022,30.61,0.09
3153,2021-04-28,FVG,7246,3194,4052,3782,3464,ITH,ITH4,6,Friuli-Venezia Giulia,Friuli Venezia Giulia,1215220,379268,31.21,0.6
3154,2021-01-25,FVG,1582,567,1015,194,1388,ITH,ITH4,6,Friuli-Venezia Giulia,Friuli Venezia Giulia,1215220,380850,31.34,0.13
3155,2021-01-16,FVG,1230,360,870,1230,0,ITH,ITH4,6,Friuli-Venezia Giulia,Friuli Venezia Giulia,1215220,382080,31.44,0.1
3156,2021-03-25,FVG,5309,2261,3048,3176,2133,ITH,ITH4,6,Friuli-Venezia Giulia,Friuli Venezia Giulia,1215220,387389,31.88,0.44
3157,2021-03-30,FVG,7094,3142,3952,6172,922,ITH,ITH4,6,Friuli-Venezia Giulia,Friuli Venezia Giulia,1215220,394483,32.46,0.58
3158,2021-05-28,FVG,9651,4453,5198,5813,3838,ITH,ITH4,6,Friuli-Venezia Giulia,Friuli Venezia Giulia,1215220,404134,33.26,0.79
3159,2021-05-06,FVG,11863,5512,6351,7910,3953,ITH,ITH4,6,Friuli-Venezia Giulia,Friuli Venezia Giulia,1215220,415997,34.23,0.98
3160,2021-03-17,FVG,3231,1265,1966,743,2488,ITH,ITH4,6,Friuli-Venezia Giulia,Friuli Venezia Giulia,1215220,419228,34.5,0.27
3161,2021-02-16,FVG,2516,1135,1381,2400,116,ITH,ITH4,6,Friuli-Venezia Giulia,Friuli Venezia Giulia,1215220,421744,34.71,0.21
3162,2021-05-20,FVG,12364,6069,6295,9949,2415,ITH,ITH4,6,Friuli-Venezia Giulia,Friuli Venezia Giulia,1215220,434108,35.72,1.02
3163,2021-05-29,FVG,11856,5765,6091,6956,4900,ITH,ITH4,6,Friuli-Venezia Giulia,Friuli Venezia Giulia,1215220,445964,36.7,0.98
3164,2021-04-20,FVG,7106,3059,4047,3203,3903,ITH,ITH4,6,Friuli-Venezia Giulia,Friuli Venezia Giulia,1215220,453070,37.28,0.58
3165,2021-01-12,FVG,2260,713,1547,2260,0,ITH,ITH4,6,Friuli-Venezia Giulia,Friuli Venezia Giulia,1215220,455330,37.47,0.19
3166,2021-01-29,FVG,2414,814,1600,264,2150,ITH,ITH4,6,Friuli-Venezia Giulia,Friuli Venezia Giulia,1215220,457744,37.67,0.2
3167,2021-04-03,FVG,3982,1968,2014,2654,1328,ITH,ITH4,6,Friuli-Venezia Giulia,Friuli Venezia Giulia,1215220,461726,38.0,0.33
3168,2021-04-07,FVG,7494,3321,4173,6713,781,ITH,ITH4,6,Friuli-Venezia Giulia,Friuli Venezia Giulia,1215220,469220,38.61,0.62
3169,2021-02-26,FVG,3734,2092,1642,3586,148,ITH,ITH4,6,Friuli-Venezia Giulia,Friuli Venezia Giulia,1215220,472954,38.92,0.31
3170,2021-02-17,FVG,2353,999,1354,1873,480,ITH,ITH4,6,Friuli-Venezia Giulia,Friuli Venezia Giulia,1215220,475307,39.11,0.19
3171,2021-05-30,FVG,11034,4977,6057,7457,3577,ITH,ITH4,6,Friuli-Venezia Giulia,Friuli Venezia Giulia,1215220,486341,40.02,0.91
3172,2021-01-14,FVG,2584,789,1795,2584,0,ITH,ITH4,6,Friuli-Venezia Giulia,Friuli Venezia Giulia,1215220,488925,40.23,0.21
3173,2021-05-13,FVG,10994,5282,5712,8995,1999,ITH,ITH4,6,Friuli-Venezia Giulia,Friuli Venezia Giulia,1215220,499919,41.14,0.9
3174,2021-03-24,FVG,3766,1530,2236,2286,1480,ITH,ITH4,6,Friuli-Venezia Giulia,Friuli Venezia Giulia,1215220,503685,41.45,0.31
3175,2021-01-26,FVG,1977,647,1330,217,1760,ITH,ITH4,6,Friuli-Venezia Giulia,Friuli Venezia Giulia,1215220,505662,41.61,0.16
3176,2021-02-09,FVG,1842,555,1287,1556,286,ITH,ITH4,6,Friuli-Venezia Giulia,Friuli Venezia Giulia,1215220,507504,41.76,0.15
3177,2021-05-15,FVG,12590,6069,6521,7913,4677,ITH,ITH4,6,Friuli-Venezia Giulia,Friuli Venezia Giulia,1215220,520094,42.8,1.04
3178,2021-05-01,FVG,7185,3244,3941,6142,1043,ITH,ITH4,6,Friuli-Venezia Giulia,Friuli Venezia Giulia,1215220,527279,43.39,0.59
3179,2021-01-21,FVG,896,345,551,1,895,ITH,ITH4,6,Friuli-Venezia Giulia,Friuli Venezia Giulia,1215220,528175,43.46,0.07
3180,2021-03-26,FVG,5801,2425,3376,3789,2012,ITH,ITH4,6,Friuli-Venezia Giulia,Friuli Venezia Giulia,1215220,533976,43.94,0.48
3181,2021-03-12,FVG,3938,1544,2394,2557,1381,ITH,ITH4,6,Friuli-Venezia Giulia,Friuli Venezia Giulia,1215220,537914,44.26,0.32
3182,2021-05-04,FVG,9502,4284,5218,6150,3352,ITH,ITH4,6,Friuli-Venezia Giulia,Friuli Venezia Giulia,1215220,547416,45.05,0.78
3183,2021-01-24,FVG,305,119,186,1,304,ITH,ITH4,6,Friuli-Venezia Giulia,Friuli Venezia Giulia,1215220,547721,45.07,0.03
3184,2021-03-08,FVG,4063,1593,2470,1978,2085,ITH,ITH4,6,Friuli-Venezia Giulia,Friuli Venezia Giulia,1215220,551784,45.41,0.33
3185,2021-03-22,FVG,3541,1343,2198,1586,1955,ITH,ITH4,6,Friuli-Venezia Giulia,Friuli Venezia Giulia,1215220,555325,45.7,0.29
3186,2021-01-17,FVG,1716,523,1193,1716,0,ITH,ITH4,6,Friuli-Venezia Giulia,Friuli Venezia Giulia,1215220,557041,45.84,0.14
3187,2021-03-15,FVG,3765,1636,2129,1446,2319,ITH,ITH4,6,Friuli-Venezia Giulia,Friuli Venezia Giulia,1215220,560806,46.15,0.31
3188,2021-05-11,FVG,8910,4267,4643,7122,1788,ITH,ITH4,6,Friuli-Venezia Giulia,Friuli Venezia Giulia,1215220,569716,46.88,0.73
3189,2021-01-31,FVG,2715,836,1879,385,2330,ITH,ITH4,6,Friuli-Venezia Giulia,Friuli Venezia Giulia,1215220,572431,47.11,0.22
3190,2020-12-27,FVG,262,149,113,262,0,ITH,ITH4,6,Friuli-Venezia Giulia,Friuli Venezia Giulia,1215220,572693,47.13,0.02
3191,2021-05-25,FVG,12372,6037,6335,9204,3168,ITH,ITH4,6,Friuli-Venezia Giulia,Friuli Venezia Giulia,1215220,585065,48.14,1.02
3192,2021-05-27,FVG,12158,5746,6412,7152,5006,ITH,ITH4,6,Friuli-Venezia Giulia,Friuli Venezia Giulia,1215220,597223,49.15,1.0
3193,2021-04-19,FVG,6705,3131,3574,3293,3412,ITH,ITH4,6,Friuli-Venezia Giulia,Friuli Venezia Giulia,1215220,603928,49.7,0.55
3194,2021-01-09,FVG,2513,841,1672,2513,0,ITH,ITH4,6,Friuli-Venezia Giulia,Friuli Venezia Giulia,1215220,606441,49.9,0.21
3195,2021-03-07,FVG,2547,932,1615,2546,1,ITH,ITH4,6,Friuli-Venezia Giulia,Friuli Venezia Giulia,1215220,608988,50.11,0.21
3196,2021-01-10,FVG,2939,918,2021,2939,0,ITH,ITH4,6,Friuli-Venezia Giulia,Friuli Venezia Giulia,1215220,611927,50.36,0.24
3197,2021-04-05,FVG,2868,1425,1443,2853,15,ITH,ITH4,6,Friuli-Venezia Giulia,Friuli Venezia Giulia,1215220,614795,50.59,0.24
3198,2021-04-22,FVG,6755,3073,3682,3079,3676,ITH,ITH4,6,Friuli-Venezia Giulia,Friuli Venezia Giulia,1215220,621550,51.15,0.56
3199,2021-03-19,FVG,3234,1339,1895,1301,1933,ITH,ITH4,6,Friuli-Venezia Giulia,Friuli Venezia Giulia,1215220,624784,51.41,0.27
3200,2021-02-19,FVG,3251,1289,1962,2824,427,ITH,ITH4,6,Friuli-Venezia Giulia,Friuli Venezia Giulia,1215220,628035,51.68,0.27
3201,2021-04-24,FVG,6674,2945,3729,5432,1242,ITH,ITH4,6,Friuli-Venezia Giulia,Friuli Venezia Giulia,1215220,634709,52.23,0.55
3202,2021-05-03,FVG,7178,3270,3908,3404,3774,ITH,ITH4,6,Friuli-Venezia Giulia,Friuli Venezia Giulia,1215220,641887,52.82,0.59
3203,2021-02-28,FVG,2685,1002,1683,2292,393,ITH,ITH4,6,Friuli-Venezia Giulia,Friuli Venezia Giulia,1215220,644572,53.04,0.22
3204,2021-05-10,FVG,7911,3514,4397,6372,1539,ITH,ITH4,6,Friuli-Venezia Giulia,Friuli Venezia Giulia,1215220,652483,53.69,0.65
3205,2021-02-02,FVG,2467,806,1661,217,2250,ITH,ITH4,6,Friuli-Venezia Giulia,Friuli Venezia Giulia,1215220,654950,53.9,0.2
3206,2021-03-10,FVG,3358,1493,1865,1566,1792,ITH,ITH4,6,Friuli-Venezia Giulia,Friuli Venezia Giulia,1215220,658308,54.17,0.28
3207,2021-03-27,FVG,4985,2560,2425,3574,1411,ITH,ITH4,6,Friuli-Venezia Giulia,Friuli Venezia Giulia,1215220,663293,54.58,0.41
3208,2021-01-05,FVG,1678,551,1127,1678,0,ITH,ITH4,6,Friuli-Venezia Giulia,Friuli Venezia Giulia,1215220,664971,54.72,0.14
3209,2021-02-05,FVG,2614,785,1829,90,2524,ITH,ITH4,6,Friuli-Venezia Giulia,Friuli Venezia Giulia,1215220,667585,54.94,0.22
3210,2021-04-14,FVG,7216,3119,4097,5504,1712,ITH,ITH4,6,Friuli-Venezia Giulia,Friuli Venezia Giulia,1215220,674801,55.53,0.59
3211,2021-01-19,FVG,6,2,4,6,0,ITH,ITH4,6,Friuli-Venezia Giulia,Friuli Venezia Giulia,1215220,674807,55.53,0.0
3212,2021-03-31,FVG,8030,3500,4530,7185,845,ITH,ITH4,6,Friuli-Venezia Giulia,Friuli Venezia Giulia,1215220,682837,56.19,0.66
3213,2021-05-22,FVG,11470,5150,6320,7263,4207,ITH,ITH4,6,Friuli-Venezia Giulia,Friuli Venezia Giulia,1215220,694307,57.13,0.94
3214,2021-04-26,FVG,5444,2445,2999,3796,1648,ITH,ITH4,6,Friuli-Venezia Giulia,Friuli Venezia Giulia,1215220,699751,57.58,0.45
3215,2021-04-13,FVG,7362,3289,4073,5758,1604,ITH,ITH4,6,Friuli-Venezia Giulia,Friuli Venezia Giulia,1215220,707113,58.19,0.61
3216,2021-01-03,FVG,312,122,190,312,0,ITH,ITH4,6,Friuli-Venezia Giulia,Friuli Venezia Giulia,1215220,707425,58.21,0.03
3217,2021-02-22,FVG,2485,1193,1292,2067,418,ITH,ITH4,6,Friuli-Venezia Giulia,Friuli Venezia Giulia,1215220,709910,58.42,0.2
3218,2021-02-07,FVG,1561,483,1078,386,1175,ITH,ITH4,6,Friuli-Venezia Giulia,Friuli Venezia Giulia,1215220,711471,58.55,0.13
3219,2021-05-18,FVG,10555,5266,5289,8539,2016,ITH,ITH4,6,Friuli-Venezia Giulia,Friuli Venezia Giulia,1215220,722026,59.42,0.87
3220,2021-03-29,FVG,6873,3000,3873,5294,1579,ITH,ITH4,6,Friuli-Venezia Giulia,Friuli Venezia Giulia,1215220,728899,59.98,0.57
3221,2021-02-21,FVG,801,281,520,423,378,ITH,ITH4,6,Friuli-Venezia Giulia,Friuli Venezia Giulia,1215220,729700,60.05,0.07
3222,2021-01-02,FVG,1216,470,746,1216,0,ITH,ITH4,6,Friuli-Venezia Giulia,Friuli Venezia Giulia,1215220,730916,60.15,0.1
3223,2021-04-12,FVG,7253,3181,4072,6122,1131,ITH,ITH4,6,Friuli-Venezia Giulia,Friuli Venezia Giulia,1215220,738169,60.74,0.6
