,data,area,Vaccinazioni giornaliere,sesso_maschile,sesso_femminile,prima_dose,seconda_dose,pregressa_infezione,codice_NUTS1,codice_NUTS2,codice_regione_ISTAT,nome_area,Regione,popolazione,Totale vaccinazioni,Totale vaccinazioni ogni cento ab,Vaccinazioni giornaliere ogni cento ab
0,2021-02-12,PAB,730,217,513,482,248,0,ITH,ITH1,4,Provincia Autonoma Bolzano / Bozen,P.A. Bolzano,533050,730,0.14,0.14
1,2021-04-10,PAB,5416,2673,2743,4825,590,1,ITH,ITH1,4,Provincia Autonoma Bolzano / Bozen,P.A. Bolzano,533050,6146,1.15,1.02
2,2020-12-31,PAB,929,528,401,929,0,0,ITH,ITH1,4,Provincia Autonoma Bolzano / Bozen,P.A. Bolzano,533050,7075,1.33,0.17
3,2021-04-19,PAB,1876,860,1016,1694,182,0,ITH,ITH1,4,Provincia Autonoma Bolzano / Bozen,P.A. Bolzano,533050,8951,1.68,0.35
4,2021-06-15,PAB,2045,1184,861,481,1534,30,ITH,ITH1,4,Provincia Autonoma Bolzano / Bozen,P.A. Bolzano,533050,10996,2.06,0.38
5,2021-07-28,PAB,1439,785,654,879,497,63,ITH,ITH1,4,Provincia Autonoma Bolzano / Bozen,P.A. Bolzano,533050,12435,2.33,0.27
6,2021-07-16,PAB,4513,2449,2064,1072,3319,122,ITH,ITH1,4,Provincia Autonoma Bolzano / Bozen,P.A. Bolzano,533050,16948,3.18,0.85
7,2021-04-24,PAB,5119,2458,2661,4628,488,3,ITH,ITH1,4,Provincia Autonoma Bolzano / Bozen,P.A. Bolzano,533050,22067,4.14,0.96
8,2021-08-02,PAB,2133,1278,855,1167,875,91,ITH,ITH1,4,Provincia Autonoma Bolzano / Bozen,P.A. Bolzano,533050,24200,4.54,0.4
9,2021-07-14,PAB,873,453,420,478,361,34,ITH,ITH1,4,Provincia Autonoma Bolzano / Bozen,P.A. Bolzano,533050,25073,4.7,0.16
10,2021-04-05,PAB,304,147,157,24,280,0,ITH,ITH1,4,Provincia Autonoma Bolzano / Bozen,P.A. Bolzano,533050,25377,4.76,0.06
11,2021-06-27,PAB,4429,2315,2114,590,3810,29,ITH,ITH1,4,Provincia Autonoma Bolzano / Bozen,P.A. Bolzano,533050,29806,5.59,0.83
12,2021-01-12,PAB,1712,461,1251,1712,0,0,ITH,ITH1,4,Provincia Autonoma Bolzano / Bozen,P.A. Bolzano,533050,31518,5.91,0.32
13,2021-06-06,PAB,4553,2189,2364,812,3693,48,ITH,ITH1,4,Provincia Autonoma Bolzano / Bozen,P.A. Bolzano,533050,36071,6.77,0.85
14,2021-02-26,PAB,1528,551,977,1498,30,0,ITH,ITH1,4,Provincia Autonoma Bolzano / Bozen,P.A. Bolzano,533050,37599,7.05,0.29
15,2021-09-09,PAB,1685,852,833,722,963,0,ITH,ITH1,4,Provincia Autonoma Bolzano / Bozen,P.A. Bolzano,533050,39284,7.37,0.32
16,2021-06-01,PAB,3677,2385,1292,2062,1479,136,ITH,ITH1,4,Provincia Autonoma Bolzano / Bozen,P.A. Bolzano,533050,42961,8.06,0.69
17,2021-08-23,PAB,2128,1202,926,799,1326,3,ITH,ITH1,4,Provincia Autonoma Bolzano / Bozen,P.A. Bolzano,533050,45089,8.46,0.4
18,2021-06-20,PAB,5250,2854,2396,620,4604,26,ITH,ITH1,4,Provincia Autonoma Bolzano / Bozen,P.A. Bolzano,533050,50339,9.44,0.98
19,2021-02-07,PAB,2680,1186,1494,330,2350,0,ITH,ITH1,4,Provincia Autonoma Bolzano / Bozen,P.A. Bolzano,533050,53019,9.95,0.5
20,2021-05-18,PAB,3364,1765,1599,2091,1191,82,ITH,ITH1,4,Provincia Autonoma Bolzano / Bozen,P.A. Bolzano,533050,56383,10.58,0.63
21,2021-03-22,PAB,1159,527,632,1124,17,18,ITH,ITH1,4,Provincia Autonoma Bolzano / Bozen,P.A. Bolzano,533050,57542,10.79,0.22
22,2021-01-26,PAB,810,291,519,1,809,0,ITH,ITH1,4,Provincia Autonoma Bolzano / Bozen,P.A. Bolzano,533050,58352,10.95,0.15
23,2021-07-02,PAB,3202,1658,1544,855,2171,176,ITH,ITH1,4,Provincia Autonoma Bolzano / Bozen,P.A. Bolzano,533050,61554,11.55,0.6
24,2021-03-24,PAB,2068,1003,1065,2049,13,6,ITH,ITH1,4,Provincia Autonoma Bolzano / Bozen,P.A. Bolzano,533050,63622,11.94,0.39
25,2021-03-10,PAB,1277,537,740,1133,144,0,ITH,ITH1,4,Provincia Autonoma Bolzano / Bozen,P.A. Bolzano,533050,64899,12.18,0.24
26,2021-05-20,PAB,4975,2502,2473,3346,1480,149,ITH,ITH1,4,Provincia Autonoma Bolzano / Bozen,P.A. Bolzano,533050,69874,13.11,0.93
27,2021-08-11,PAB,1203,604,599,714,487,2,ITH,ITH1,4,Provincia Autonoma Bolzano / Bozen,P.A. Bolzano,533050,71077,13.33,0.23
28,2021-08-28,PAB,3269,1838,1431,1026,2213,30,ITH,ITH1,4,Provincia Autonoma Bolzano / Bozen,P.A. Bolzano,533050,74346,13.95,0.61
29,2021-09-11,PAB,792,416,376,295,497,0,ITH,ITH1,4,Provincia Autonoma Bolzano / Bozen,P.A. Bolzano,533050,75138,14.1,0.15
30,2021-07-09,PAB,5227,2612,2615,917,4168,142,ITH,ITH1,4,Provincia Autonoma Bolzano / Bozen,P.A. Bolzano,533050,80365,15.08,0.98
31,2021-04-17,PAB,5255,2609,2646,5210,44,1,ITH,ITH1,4,Provincia Autonoma Bolzano / Bozen,P.A. Bolzano,533050,85620,16.06,0.99
32,2021-01-07,PAB,921,329,592,921,0,0,ITH,ITH1,4,Provincia Autonoma Bolzano / Bozen,P.A. Bolzano,533050,86541,16.24,0.17
33,2021-07-21,PAB,3220,1882,1338,536,2644,40,ITH,ITH1,4,Provincia Autonoma Bolzano / Bozen,P.A. Bolzano,533050,89761,16.84,0.6
34,2021-04-12,PAB,2110,948,1162,2104,6,0,ITH,ITH1,4,Provincia Autonoma Bolzano / Bozen,P.A. Bolzano,533050,91871,17.23,0.4
35,2021-06-29,PAB,1894,1021,873,247,1627,20,ITH,ITH1,4,Provincia Autonoma Bolzano / Bozen,P.A. Bolzano,533050,93765,17.59,0.36
36,2021-02-19,PAB,2252,512,1740,2241,11,0,ITH,ITH1,4,Provincia Autonoma Bolzano / Bozen,P.A. Bolzano,533050,96017,18.01,0.42
37,2021-08-04,PAB,3811,2017,1794,2719,978,114,ITH,ITH1,4,Provincia Autonoma Bolzano / Bozen,P.A. Bolzano,533050,99828,18.73,0.71
38,2021-06-08,PAB,4267,2185,2082,893,3346,28,ITH,ITH1,4,Provincia Autonoma Bolzano / Bozen,P.A. Bolzano,533050,104095,19.53,0.8
39,2021-01-24,PAB,12,10,2,0,12,0,ITH,ITH1,4,Provincia Autonoma Bolzano / Bozen,P.A. Bolzano,533050,104107,19.53,0.0
40,2021-07-04,PAB,4424,2132,2292,160,4236,28,ITH,ITH1,4,Provincia Autonoma Bolzano / Bozen,P.A. Bolzano,533050,108531,20.36,0.83
41,2021-08-30,PAB,2141,1126,1015,824,1293,24,ITH,ITH1,4,Provincia Autonoma Bolzano / Bozen,P.A. Bolzano,533050,110672,20.76,0.4
42,2021-08-09,PAB,1541,861,680,1121,413,7,ITH,ITH1,4,Provincia Autonoma Bolzano / Bozen,P.A. Bolzano,533050,112213,21.05,0.29
43,2021-05-01,PAB,2105,1067,1038,1815,160,130,ITH,ITH1,4,Provincia Autonoma Bolzano / Bozen,P.A. Bolzano,533050,114318,21.45,0.39
44,2021-03-12,PAB,1668,736,932,1252,413,3,ITH,ITH1,4,Provincia Autonoma Bolzano / Bozen,P.A. Bolzano,533050,115986,21.76,0.31
45,2021-03-29,PAB,1173,500,673,411,761,1,ITH,ITH1,4,Provincia Autonoma Bolzano / Bozen,P.A. Bolzano,533050,117159,21.98,0.22
46,2021-05-06,PAB,5191,2752,2439,2375,2571,245,ITH,ITH1,4,Provincia Autonoma Bolzano / Bozen,P.A. Bolzano,533050,122350,22.95,0.97
47,2021-03-17,PAB,582,213,369,581,1,0,ITH,ITH1,4,Provincia Autonoma Bolzano / Bozen,P.A. Bolzano,533050,122932,23.06,0.11
48,2021-08-21,PAB,1705,917,788,626,1075,4,ITH,ITH1,4,Provincia Autonoma Bolzano / Bozen,P.A. Bolzano,533050,124637,23.38,0.32
49,2021-05-13,PAB,3005,1360,1645,1023,1934,48,ITH,ITH1,4,Provincia Autonoma Bolzano / Bozen,P.A. Bolzano,533050,127642,23.95,0.56
50,2021-04-29,PAB,2643,1358,1285,1943,699,1,ITH,ITH1,4,Provincia Autonoma Bolzano / Bozen,P.A. Bolzano,533050,130285,24.44,0.5
51,2021-09-04,PAB,1359,715,644,578,748,33,ITH,ITH1,4,Provincia Autonoma Bolzano / Bozen,P.A. Bolzano,533050,131644,24.7,0.25
52,2021-03-05,PAB,1843,627,1216,1397,443,3,ITH,ITH1,4,Provincia Autonoma Bolzano / Bozen,P.A. Bolzano,533050,133487,25.04,0.35
53,2021-05-27,PAB,6211,3276,2935,3914,2014,283,ITH,ITH1,4,Provincia Autonoma Bolzano / Bozen,P.A. Bolzano,533050,139698,26.21,1.17
54,2021-06-13,PAB,3689,2055,1634,453,3197,39,ITH,ITH1,4,Provincia Autonoma Bolzano / Bozen,P.A. Bolzano,533050,143387,26.9,0.69
55,2021-05-25,PAB,3898,2024,1874,2910,888,100,ITH,ITH1,4,Provincia Autonoma Bolzano / Bozen,P.A. Bolzano,533050,147285,27.63,0.73
56,2021-02-14,PAB,299,131,168,297,2,0,ITH,ITH1,4,Provincia Autonoma Bolzano / Bozen,P.A. Bolzano,533050,147584,27.69,0.06
57,2021-08-16,PAB,1965,1115,850,876,1085,4,ITH,ITH1,4,Provincia Autonoma Bolzano / Bozen,P.A. Bolzano,533050,149549,28.06,0.37
58,2021-05-08,PAB,4430,2383,2047,3574,664,192,ITH,ITH1,4,Provincia Autonoma Bolzano / Bozen,P.A. Bolzano,533050,153979,28.89,0.83
59,2021-03-31,PAB,1836,696,1140,822,1014,0,ITH,ITH1,4,Provincia Autonoma Bolzano / Bozen,P.A. Bolzano,533050,155815,29.23,0.34
60,2021-07-23,PAB,4359,2377,1982,1707,2391,261,ITH,ITH1,4,Provincia Autonoma Bolzano / Bozen,P.A. Bolzano,533050,160174,30.05,0.82
61,2021-01-05,PAB,830,286,544,829,0,1,ITH,ITH1,4,Provincia Autonoma Bolzano / Bozen,P.A. Bolzano,533050,161004,30.2,0.16
62,2021-01-23,PAB,197,117,80,0,197,0,ITH,ITH1,4,Provincia Autonoma Bolzano / Bozen,P.A. Bolzano,533050,161201,30.24,0.04
63,2021-03-07,PAB,440,150,290,19,420,1,ITH,ITH1,4,Provincia Autonoma Bolzano / Bozen,P.A. Bolzano,533050,161641,30.32,0.08
64,2021-07-30,PAB,5303,2844,2459,3404,1543,356,ITH,ITH1,4,Provincia Autonoma Bolzano / Bozen,P.A. Bolzano,533050,166944,31.32,0.99
65,2021-04-21,PAB,3017,1470,1547,2168,848,1,ITH,ITH1,4,Provincia Autonoma Bolzano / Bozen,P.A. Bolzano,533050,169961,31.88,0.57
66,2021-06-24,PAB,3946,2042,1904,1570,2204,172,ITH,ITH1,4,Provincia Autonoma Bolzano / Bozen,P.A. Bolzano,533050,173907,32.62,0.74
67,2021-01-09,PAB,612,326,286,612,0,0,ITH,ITH1,4,Provincia Autonoma Bolzano / Bozen,P.A. Bolzano,533050,174519,32.74,0.11
68,2021-03-21,PAB,769,286,483,15,754,0,ITH,ITH1,4,Provincia Autonoma Bolzano / Bozen,P.A. Bolzano,533050,175288,32.88,0.14
69,2021-06-12,PAB,5079,2754,2325,1674,3289,116,ITH,ITH1,4,Provincia Autonoma Bolzano / Bozen,P.A. Bolzano,533050,180367,33.84,0.95
70,2021-01-14,PAB,1953,578,1375,1953,0,0,ITH,ITH1,4,Provincia Autonoma Bolzano / Bozen,P.A. Bolzano,533050,182320,34.2,0.37
71,2021-04-07,PAB,1803,825,978,1262,541,0,ITH,ITH1,4,Provincia Autonoma Bolzano / Bozen,P.A. Bolzano,533050,184123,34.54,0.34
72,2021-03-02,PAB,696,200,496,694,2,0,ITH,ITH1,4,Provincia Autonoma Bolzano / Bozen,P.A. Bolzano,533050,184819,34.67,0.13
73,2021-03-19,PAB,1921,777,1144,800,1120,1,ITH,ITH1,4,Provincia Autonoma Bolzano / Bozen,P.A. Bolzano,533050,186740,35.03,0.36
74,2021-08-06,PAB,3642,1918,1724,1202,2430,10,ITH,ITH1,4,Provincia Autonoma Bolzano / Bozen,P.A. Bolzano,533050,190382,35.72,0.68
75,2021-04-28,PAB,2469,1307,1162,2459,5,5,ITH,ITH1,4,Provincia Autonoma Bolzano / Bozen,P.A. Bolzano,533050,192851,36.18,0.46
76,2021-08-08,PAB,1876,1024,852,1007,856,13,ITH,ITH1,4,Provincia Autonoma Bolzano / Bozen,P.A. Bolzano,533050,194727,36.53,0.35
77,2021-01-21,PAB,969,452,517,140,829,0,ITH,ITH1,4,Provincia Autonoma Bolzano / Bozen,P.A. Bolzano,533050,195696,36.71,0.18
78,2021-07-25,PAB,1892,1127,765,666,1146,80,ITH,ITH1,4,Provincia Autonoma Bolzano / Bozen,P.A. Bolzano,533050,197588,37.07,0.35
79,2021-05-15,PAB,7021,3697,3324,6339,294,388,ITH,ITH1,4,Provincia Autonoma Bolzano / Bozen,P.A. Bolzano,533050,204609,38.38,1.32
80,2021-02-04,PAB,1968,598,1370,8,1960,0,ITH,ITH1,4,Provincia Autonoma Bolzano / Bozen,P.A. Bolzano,533050,206577,38.75,0.37
81,2021-07-11,PAB,6075,3094,2981,1087,4879,109,ITH,ITH1,4,Provincia Autonoma Bolzano / Bozen,P.A. Bolzano,533050,212652,39.89,1.14
82,2021-04-02,PAB,2090,841,1249,701,1357,32,ITH,ITH1,4,Provincia Autonoma Bolzano / Bozen,P.A. Bolzano,533050,214742,40.29,0.39
83,2021-09-06,PAB,1128,582,546,575,534,19,ITH,ITH1,4,Provincia Autonoma Bolzano / Bozen,P.A. Bolzano,533050,215870,40.5,0.21
84,2021-05-29,PAB,7341,3908,3433,4045,3144,152,ITH,ITH1,4,Provincia Autonoma Bolzano / Bozen,P.A. Bolzano,533050,223211,41.87,1.38
85,2021-03-26,PAB,1663,737,926,525,1136,2,ITH,ITH1,4,Provincia Autonoma Bolzano / Bozen,P.A. Bolzano,533050,224874,42.19,0.31
86,2021-04-09,PAB,2942,1303,1639,2211,730,1,ITH,ITH1,4,Provincia Autonoma Bolzano / Bozen,P.A. Bolzano,533050,227816,42.74,0.55
87,2021-05-22,PAB,6844,3572,3272,4479,2169,196,ITH,ITH1,4,Provincia Autonoma Bolzano / Bozen,P.A. Bolzano,533050,234660,44.02,1.28
88,2021-02-11,PAB,1096,433,663,239,857,0,ITH,ITH1,4,Provincia Autonoma Bolzano / Bozen,P.A. Bolzano,533050,235756,44.23,0.21
89,2021-07-18,PAB,1871,1033,838,650,1150,71,ITH,ITH1,4,Provincia Autonoma Bolzano / Bozen,P.A. Bolzano,533050,237627,44.58,0.35
90,2021-06-17,PAB,1773,982,791,623,1078,72,ITH,ITH1,4,Provincia Autonoma Bolzano / Bozen,P.A. Bolzano,533050,239400,44.91,0.33
91,2021-01-02,PAB,91,48,43,91,0,0,ITH,ITH1,4,Provincia Autonoma Bolzano / Bozen,P.A. Bolzano,533050,239491,44.93,0.02
92,2021-03-03,PAB,1181,395,786,1168,13,0,ITH,ITH1,4,Provincia Autonoma Bolzano / Bozen,P.A. Bolzano,533050,240672,45.15,0.22
93,2021-08-20,PAB,3929,2071,1858,947,2972,10,ITH,ITH1,4,Provincia Autonoma Bolzano / Bozen,P.A. Bolzano,533050,244601,45.89,0.74
94,2021-05-10,PAB,3029,1306,1723,1338,1611,80,ITH,ITH1,4,Provincia Autonoma Bolzano / Bozen,P.A. Bolzano,533050,247630,46.46,0.57
95,2021-08-01,PAB,1319,760,559,710,551,58,ITH,ITH1,4,Provincia Autonoma Bolzano / Bozen,P.A. Bolzano,533050,248949,46.7,0.25
96,2021-08-18,PAB,881,461,420,380,498,3,ITH,ITH1,4,Provincia Autonoma Bolzano / Bozen,P.A. Bolzano,533050,249830,46.87,0.17
97,2021-02-16,PAB,530,205,325,530,0,0,ITH,ITH1,4,Provincia Autonoma Bolzano / Bozen,P.A. Bolzano,533050,250360,46.97,0.1
98,2021-01-28,PAB,872,309,563,9,863,0,ITH,ITH1,4,Provincia Autonoma Bolzano / Bozen,P.A. Bolzano,533050,251232,47.13,0.16
99,2021-08-25,PAB,2745,1458,1287,789,1916,40,ITH,ITH1,4,Provincia Autonoma Bolzano / Bozen,P.A. Bolzano,533050,253977,47.65,0.51
100,2021-05-03,PAB,1838,851,987,398,1419,21,ITH,ITH1,4,Provincia Autonoma Bolzano / Bozen,P.A. Bolzano,533050,255815,47.99,0.34
101,2021-02-23,PAB,769,324,445,763,6,0,ITH,ITH1,4,Provincia Autonoma Bolzano / Bozen,P.A. Bolzano,533050,256584,48.14,0.14
102,2021-05-17,PAB,3154,1525,1629,2288,697,169,ITH,ITH1,4,Provincia Autonoma Bolzano / Bozen,P.A. Bolzano,533050,259738,48.73,0.59
103,2021-06-03,PAB,4890,2663,2227,3691,972,227,ITH,ITH1,4,Provincia Autonoma Bolzano / Bozen,P.A. Bolzano,533050,264628,49.64,0.92
104,2021-09-13,PAB,1167,642,525,715,452,0,ITH,ITH1,4,Provincia Autonoma Bolzano / Bozen,P.A. Bolzano,533050,265795,49.86,0.22
105,2021-06-05,PAB,6087,3035,3052,4700,1097,290,ITH,ITH1,4,Provincia Autonoma Bolzano / Bozen,P.A. Bolzano,533050,271882,51.0,1.14
106,2021-01-16,PAB,2841,1265,1576,2841,0,0,ITH,ITH1,4,Provincia Autonoma Bolzano / Bozen,P.A. Bolzano,533050,274723,51.54,0.53
107,2021-06-10,PAB,4498,2334,2164,1308,3098,92,ITH,ITH1,4,Provincia Autonoma Bolzano / Bozen,P.A. Bolzano,533050,279221,52.38,0.84
108,2021-08-13,PAB,2913,1558,1355,1600,1302,11,ITH,ITH1,4,Provincia Autonoma Bolzano / Bozen,P.A. Bolzano,533050,282134,52.93,0.55
109,2021-07-01,PAB,4640,2305,2335,1311,3167,162,ITH,ITH1,4,Provincia Autonoma Bolzano / Bozen,P.A. Bolzano,533050,286774,53.8,0.87
110,2021-03-04,PAB,1723,1011,712,1490,229,4,ITH,ITH1,4,Provincia Autonoma Bolzano / Bozen,P.A. Bolzano,533050,288497,54.12,0.32
111,2021-09-05,PAB,1082,573,509,644,423,15,ITH,ITH1,4,Provincia Autonoma Bolzano / Bozen,P.A. Bolzano,533050,289579,54.32,0.2
112,2021-09-03,PAB,3228,1708,1520,1067,2112,49,ITH,ITH1,4,Provincia Autonoma Bolzano / Bozen,P.A. Bolzano,533050,292807,54.93,0.61
113,2021-05-26,PAB,5019,2537,2482,2870,1978,171,ITH,ITH1,4,Provincia Autonoma Bolzano / Bozen,P.A. Bolzano,533050,297826,55.87,0.94
114,2021-08-17,PAB,1250,690,560,855,391,4,ITH,ITH1,4,Provincia Autonoma Bolzano / Bozen,P.A. Bolzano,533050,299076,56.11,0.23
115,2021-02-18,PAB,1838,457,1381,1830,7,1,ITH,ITH1,4,Provincia Autonoma Bolzano / Bozen,P.A. Bolzano,533050,300914,56.45,0.34
116,2021-06-26,PAB,4548,2331,2217,1365,3077,106,ITH,ITH1,4,Provincia Autonoma Bolzano / Bozen,P.A. Bolzano,533050,305462,57.3,0.85
117,2021-03-18,PAB,1302,531,771,226,1076,0,ITH,ITH1,4,Provincia Autonoma Bolzano / Bozen,P.A. Bolzano,533050,306764,57.55,0.24
118,2021-08-22,PAB,993,546,447,306,685,2,ITH,ITH1,4,Provincia Autonoma Bolzano / Bozen,P.A. Bolzano,533050,307757,57.74,0.19
119,2021-05-14,PAB,5146,2323,2823,2906,2044,196,ITH,ITH1,4,Provincia Autonoma Bolzano / Bozen,P.A. Bolzano,533050,312903,58.7,0.97
120,2021-03-16,PAB,1290,532,758,124,1166,0,ITH,ITH1,4,Provincia Autonoma Bolzano / Bozen,P.A. Bolzano,533050,314193,58.94,0.24
121,2021-05-12,PAB,3805,2063,1742,3422,154,229,ITH,ITH1,4,Provincia Autonoma Bolzano / Bozen,P.A. Bolzano,533050,317998,59.66,0.71
122,2021-02-01,PAB,1467,448,1019,14,1453,0,ITH,ITH1,4,Provincia Autonoma Bolzano / Bozen,P.A. Bolzano,533050,319465,59.93,0.28
123,2021-04-25,PAB,3078,1501,1577,2405,672,1,ITH,ITH1,4,Provincia Autonoma Bolzano / Bozen,P.A. Bolzano,533050,322543,60.51,0.58
124,2021-08-03,PAB,2951,1586,1365,1982,839,130,ITH,ITH1,4,Provincia Autonoma Bolzano / Bozen,P.A. Bolzano,533050,325494,61.06,0.55
125,2021-07-06,PAB,1724,926,798,691,983,50,ITH,ITH1,4,Provincia Autonoma Bolzano / Bozen,P.A. Bolzano,533050,327218,61.39,0.32
126,2021-06-22,PAB,2471,1423,1048,319,2126,26,ITH,ITH1,4,Provincia Autonoma Bolzano / Bozen,P.A. Bolzano,533050,329689,61.85,0.46
127,2021-03-14,PAB,758,336,422,25,733,0,ITH,ITH1,4,Provincia Autonoma Bolzano / Bozen,P.A. Bolzano,533050,330447,61.99,0.14
128,2021-04-14,PAB,3603,1650,1953,3507,95,1,ITH,ITH1,4,Provincia Autonoma Bolzano / Bozen,P.A. Bolzano,533050,334050,62.67,0.68
129,2021-01-04,PAB,510,201,309,510,0,0,ITH,ITH1,4,Provincia Autonoma Bolzano / Bozen,P.A. Bolzano,533050,334560,62.76,0.1
130,2021-02-06,PAB,2634,1177,1457,19,2615,0,ITH,ITH1,4,Provincia Autonoma Bolzano / Bozen,P.A. Bolzano,533050,337194,63.26,0.49
131,2021-06-21,PAB,3168,1615,1553,260,2868,40,ITH,ITH1,4,Provincia Autonoma Bolzano / Bozen,P.A. Bolzano,533050,340362,63.85,0.59
132,2021-09-12,PAB,90,58,32,54,36,0,ITH,ITH1,4,Provincia Autonoma Bolzano / Bozen,P.A. Bolzano,533050,340452,63.87,0.02
133,2021-08-27,PAB,2733,1419,1314,925,1729,79,ITH,ITH1,4,Provincia Autonoma Bolzano / Bozen,P.A. Bolzano,533050,343185,64.38,0.51
134,2021-04-30,PAB,3348,1599,1749,1567,1778,3,ITH,ITH1,4,Provincia Autonoma Bolzano / Bozen,P.A. Bolzano,533050,346533,65.01,0.63
135,2021-01-20,PAB,619,254,365,410,209,0,ITH,ITH1,4,Provincia Autonoma Bolzano / Bozen,P.A. Bolzano,533050,347152,65.13,0.12
136,2021-07-22,PAB,3736,1941,1795,1735,1789,212,ITH,ITH1,4,Provincia Autonoma Bolzano / Bozen,P.A. Bolzano,533050,350888,65.83,0.7
137,2021-01-06,PAB,59,18,41,59,0,0,ITH,ITH1,4,Provincia Autonoma Bolzano / Bozen,P.A. Bolzano,533050,350947,65.84,0.01
138,2021-03-30,PAB,1302,532,770,220,1082,0,ITH,ITH1,4,Provincia Autonoma Bolzano / Bozen,P.A. Bolzano,533050,352249,66.08,0.24
139,2021-04-16,PAB,2958,1424,1534,2445,512,1,ITH,ITH1,4,Provincia Autonoma Bolzano / Bozen,P.A. Bolzano,533050,355207,66.64,0.55
140,2021-07-08,PAB,5512,2783,2729,550,4887,75,ITH,ITH1,4,Provincia Autonoma Bolzano / Bozen,P.A. Bolzano,533050,360719,67.67,1.03
141,2021-06-19,PAB,5666,3018,2648,555,5039,72,ITH,ITH1,4,Provincia Autonoma Bolzano / Bozen,P.A. Bolzano,533050,366385,68.73,1.06
142,2021-03-11,PAB,1691,830,861,1144,538,9,ITH,ITH1,4,Provincia Autonoma Bolzano / Bozen,P.A. Bolzano,533050,368076,69.05,0.32
143,2021-02-25,PAB,1498,549,949,1497,1,0,ITH,ITH1,4,Provincia Autonoma Bolzano / Bozen,P.A. Bolzano,533050,369574,69.33,0.28
144,2021-06-02,PAB,1468,824,644,978,459,31,ITH,ITH1,4,Provincia Autonoma Bolzano / Bozen,P.A. Bolzano,533050,371042,69.61,0.28
145,2021-02-08,PAB,2,1,1,1,1,0,ITH,ITH1,4,Provincia Autonoma Bolzano / Bozen,P.A. Bolzano,533050,371044,69.61,0.0
146,2021-01-13,PAB,1727,569,1158,1727,0,0,ITH,ITH1,4,Provincia Autonoma Bolzano / Bozen,P.A. Bolzano,533050,372771,69.93,0.32
147,2021-01-30,PAB,498,245,253,4,494,0,ITH,ITH1,4,Provincia Autonoma Bolzano / Bozen,P.A. Bolzano,533050,373269,70.03,0.09
148,2021-04-23,PAB,4554,2157,2397,3258,1293,3,ITH,ITH1,4,Provincia Autonoma Bolzano / Bozen,P.A. Bolzano,533050,377823,70.88,0.85
149,2021-01-11,PAB,1594,522,1072,1594,0,0,ITH,ITH1,4,Provincia Autonoma Bolzano / Bozen,P.A. Bolzano,533050,379417,71.18,0.3
150,2021-06-14,PAB,2984,1617,1367,577,2361,46,ITH,ITH1,4,Provincia Autonoma Bolzano / Bozen,P.A. Bolzano,533050,382401,71.74,0.56
151,2021-04-26,PAB,1550,776,774,1544,5,1,ITH,ITH1,4,Provincia Autonoma Bolzano / Bozen,P.A. Bolzano,533050,383951,72.03,0.29
152,2021-07-10,PAB,5814,3002,2812,952,4750,112,ITH,ITH1,4,Provincia Autonoma Bolzano / Bozen,P.A. Bolzano,533050,389765,73.12,1.09
153,2021-01-18,PAB,1777,689,1088,1772,5,0,ITH,ITH1,4,Provincia Autonoma Bolzano / Bozen,P.A. Bolzano,533050,391542,73.45,0.33
154,2021-07-29,PAB,1340,717,623,718,570,52,ITH,ITH1,4,Provincia Autonoma Bolzano / Bozen,P.A. Bolzano,533050,392882,73.7,0.25
155,2020-12-30,PAB,389,183,206,389,0,0,ITH,ITH1,4,Provincia Autonoma Bolzano / Bozen,P.A. Bolzano,533050,393271,73.78,0.07
156,2021-09-10,PAB,1634,865,769,783,851,0,ITH,ITH1,4,Provincia Autonoma Bolzano / Bozen,P.A. Bolzano,533050,394905,74.08,0.31
157,2021-06-09,PAB,3870,1919,1951,1266,2498,106,ITH,ITH1,4,Provincia Autonoma Bolzano / Bozen,P.A. Bolzano,533050,398775,74.81,0.73
158,2021-03-01,PAB,925,224,701,923,1,1,ITH,ITH1,4,Provincia Autonoma Bolzano / Bozen,P.A. Bolzano,533050,399700,74.98,0.17
159,2021-08-05,PAB,3471,1888,1583,1801,1580,90,ITH,ITH1,4,Provincia Autonoma Bolzano / Bozen,P.A. Bolzano,533050,403171,75.63,0.65
160,2021-03-15,PAB,1194,452,742,711,482,1,ITH,ITH1,4,Provincia Autonoma Bolzano / Bozen,P.A. Bolzano,533050,404365,75.86,0.22
161,2021-04-27,PAB,2235,1015,1220,1156,1079,0,ITH,ITH1,4,Provincia Autonoma Bolzano / Bozen,P.A. Bolzano,533050,406600,76.28,0.42
162,2021-01-17,PAB,2329,1044,1285,2318,11,0,ITH,ITH1,4,Provincia Autonoma Bolzano / Bozen,P.A. Bolzano,533050,408929,76.71,0.44
163,2021-06-23,PAB,1153,595,558,333,768,52,ITH,ITH1,4,Provincia Autonoma Bolzano / Bozen,P.A. Bolzano,533050,410082,76.93,0.22
164,2021-08-29,PAB,868,479,389,358,498,12,ITH,ITH1,4,Provincia Autonoma Bolzano / Bozen,P.A. Bolzano,533050,410950,77.09,0.16
165,2021-03-09,PAB,1194,543,651,1192,2,0,ITH,ITH1,4,Provincia Autonoma Bolzano / Bozen,P.A. Bolzano,533050,412144,77.32,0.22
166,2021-05-23,PAB,4343,2305,2038,4141,8,194,ITH,ITH1,4,Provincia Autonoma Bolzano / Bozen,P.A. Bolzano,533050,416487,78.13,0.81
167,2021-07-19,PAB,2782,1395,1387,625,2047,110,ITH,ITH1,4,Provincia Autonoma Bolzano / Bozen,P.A. Bolzano,533050,419269,78.65,0.52
168,2021-02-03,PAB,1507,480,1027,5,1502,0,ITH,ITH1,4,Provincia Autonoma Bolzano / Bozen,P.A. Bolzano,533050,420776,78.94,0.28
169,2021-02-10,PAB,1637,605,1032,27,1610,0,ITH,ITH1,4,Provincia Autonoma Bolzano / Bozen,P.A. Bolzano,533050,422413,79.24,0.31
170,2021-08-31,PAB,2029,1095,934,751,1260,18,ITH,ITH1,4,Provincia Autonoma Bolzano / Bozen,P.A. Bolzano,533050,424442,79.63,0.38
171,2021-03-28,PAB,569,212,357,11,558,0,ITH,ITH1,4,Provincia Autonoma Bolzano / Bozen,P.A. Bolzano,533050,425011,79.73,0.11
172,2021-08-10,PAB,1851,1016,835,1560,281,10,ITH,ITH1,4,Provincia Autonoma Bolzano / Bozen,P.A. Bolzano,533050,426862,80.08,0.35
173,2021-05-19,PAB,3887,1997,1890,1964,1789,134,ITH,ITH1,4,Provincia Autonoma Bolzano / Bozen,P.A. Bolzano,533050,430749,80.81,0.73
174,2021-01-03,PAB,41,16,25,41,0,0,ITH,ITH1,4,Provincia Autonoma Bolzano / Bozen,P.A. Bolzano,533050,430790,80.82,0.01
175,2021-09-14,PAB,649,339,310,367,282,0,ITH,ITH1,4,Provincia Autonoma Bolzano / Bozen,P.A. Bolzano,533050,431439,80.94,0.12
176,2021-04-13,PAB,2400,1134,1266,2393,7,0,ITH,ITH1,4,Provincia Autonoma Bolzano / Bozen,P.A. Bolzano,533050,433839,81.39,0.45
177,2021-07-15,PAB,4397,2320,2077,1511,2703,183,ITH,ITH1,4,Provincia Autonoma Bolzano / Bozen,P.A. Bolzano,533050,438236,82.21,0.82
178,2021-04-06,PAB,2254,1120,1134,2151,102,1,ITH,ITH1,4,Provincia Autonoma Bolzano / Bozen,P.A. Bolzano,533050,440490,82.64,0.42
179,2021-07-17,PAB,3147,1801,1346,706,2352,89,ITH,ITH1,4,Provincia Autonoma Bolzano / Bozen,P.A. Bolzano,533050,443637,83.23,0.59
180,2021-04-08,PAB,2797,1361,1436,2588,204,5,ITH,ITH1,4,Provincia Autonoma Bolzano / Bozen,P.A. Bolzano,533050,446434,83.75,0.52
181,2021-04-20,PAB,1565,785,780,1562,3,0,ITH,ITH1,4,Provincia Autonoma Bolzano / Bozen,P.A. Bolzano,533050,447999,84.04,0.29
182,2021-01-10,PAB,2,2,0,2,0,0,ITH,ITH1,4,Provincia Autonoma Bolzano / Bozen,P.A. Bolzano,533050,448001,84.04,0.0
183,2021-06-16,PAB,3823,2028,1795,11,3807,5,ITH,ITH1,4,Provincia Autonoma Bolzano / Bozen,P.A. Bolzano,533050,451824,84.76,0.72
184,2021-03-08,PAB,1213,535,678,1185,27,1,ITH,ITH1,4,Provincia Autonoma Bolzano / Bozen,P.A. Bolzano,533050,453037,84.99,0.23
185,2021-08-12,PAB,3365,1724,1641,649,2711,5,ITH,ITH1,4,Provincia Autonoma Bolzano / Bozen,P.A. Bolzano,533050,456402,85.62,0.63
186,2021-05-04,PAB,3453,1845,1608,2270,1038,145,ITH,ITH1,4,Provincia Autonoma Bolzano / Bozen,P.A. Bolzano,533050,459855,86.27,0.65
187,2021-05-21,PAB,7396,4065,3331,5230,1879,287,ITH,ITH1,4,Provincia Autonoma Bolzano / Bozen,P.A. Bolzano,533050,467251,87.66,1.39
188,2021-08-24,PAB,1969,1028,941,565,1396,8,ITH,ITH1,4,Provincia Autonoma Bolzano / Bozen,P.A. Bolzano,533050,469220,88.03,0.37
189,2021-05-16,PAB,2029,935,1094,1285,694,50,ITH,ITH1,4,Provincia Autonoma Bolzano / Bozen,P.A. Bolzano,533050,471249,88.41,0.38
190,2020-12-27,PAB,144,65,79,144,0,0,ITH,ITH1,4,Provincia Autonoma Bolzano / Bozen,P.A. Bolzano,533050,471393,88.43,0.03
191,2021-06-30,PAB,3064,1565,1499,399,2608,57,ITH,ITH1,4,Provincia Autonoma Bolzano / Bozen,P.A. Bolzano,533050,474457,89.01,0.57
192,2021-06-11,PAB,5841,3006,2835,2140,3486,215,ITH,ITH1,4,Provincia Autonoma Bolzano / Bozen,P.A. Bolzano,533050,480298,90.1,1.1
193,2021-09-02,PAB,1207,626,581,714,467,26,ITH,ITH1,4,Provincia Autonoma Bolzano / Bozen,P.A. Bolzano,533050,481505,90.33,0.23
194,2021-03-20,PAB,1760,851,909,1130,625,5,ITH,ITH1,4,Provincia Autonoma Bolzano / Bozen,P.A. Bolzano,533050,483265,90.66,0.33
195,2021-02-15,PAB,72,42,30,26,46,0,ITH,ITH1,4,Provincia Autonoma Bolzano / Bozen,P.A. Bolzano,533050,483337,90.67,0.01
196,2021-08-19,PAB,1750,966,784,1129,614,7,ITH,ITH1,4,Provincia Autonoma Bolzano / Bozen,P.A. Bolzano,533050,485087,91.0,0.33
197,2021-05-11,PAB,2854,1338,1516,1262,1523,69,ITH,ITH1,4,Provincia Autonoma Bolzano / Bozen,P.A. Bolzano,533050,487941,91.54,0.54
198,2021-07-31,PAB,3168,1720,1448,2109,924,135,ITH,ITH1,4,Provincia Autonoma Bolzano / Bozen,P.A. Bolzano,533050,491109,92.13,0.59
199,2021-01-29,PAB,1515,518,997,24,1491,0,ITH,ITH1,4,Provincia Autonoma Bolzano / Bozen,P.A. Bolzano,533050,492624,92.42,0.28
200,2021-04-22,PAB,2939,1512,1427,1993,942,4,ITH,ITH1,4,Provincia Autonoma Bolzano / Bozen,P.A. Bolzano,533050,495563,92.97,0.55
201,2021-05-09,PAB,4243,2410,1833,2935,1150,158,ITH,ITH1,4,Provincia Autonoma Bolzano / Bozen,P.A. Bolzano,533050,499806,93.76,0.8
202,2021-03-06,PAB,3976,2082,1894,3763,211,2,ITH,ITH1,4,Provincia Autonoma Bolzano / Bozen,P.A. Bolzano,533050,503782,94.51,0.75
203,2021-05-28,PAB,7467,3942,3525,5370,1895,202,ITH,ITH1,4,Provincia Autonoma Bolzano / Bozen,P.A. Bolzano,533050,511249,95.91,1.4
204,2021-02-17,PAB,156,51,105,139,17,0,ITH,ITH1,4,Provincia Autonoma Bolzano / Bozen,P.A. Bolzano,533050,511405,95.94,0.03
205,2021-06-04,PAB,6722,3389,3333,4951,1537,234,ITH,ITH1,4,Provincia Autonoma Bolzano / Bozen,P.A. Bolzano,533050,518127,97.2,1.26
206,2021-02-24,PAB,1368,407,961,1356,12,0,ITH,ITH1,4,Provincia Autonoma Bolzano / Bozen,P.A. Bolzano,533050,519495,97.46,0.26
207,2021-03-27,PAB,3053,1554,1499,1544,1508,1,ITH,ITH1,4,Provincia Autonoma Bolzano / Bozen,P.A. Bolzano,533050,522548,98.03,0.57
208,2021-03-13,PAB,2886,1460,1426,2785,101,0,ITH,ITH1,4,Provincia Autonoma Bolzano / Bozen,P.A. Bolzano,533050,525434,98.57,0.54
209,2021-07-26,PAB,1629,940,689,1126,411,92,ITH,ITH1,4,Provincia Autonoma Bolzano / Bozen,P.A. Bolzano,533050,527063,98.88,0.31
210,2021-02-22,PAB,526,143,383,514,12,0,ITH,ITH1,4,Provincia Autonoma Bolzano / Bozen,P.A. Bolzano,533050,527589,98.98,0.1
211,2021-08-26,PAB,2240,1134,1106,830,1359,51,ITH,ITH1,4,Provincia Autonoma Bolzano / Bozen,P.A. Bolzano,533050,529829,99.4,0.42
212,2021-07-07,PAB,1994,1034,960,601,1336,57,ITH,ITH1,4,Provincia Autonoma Bolzano / Bozen,P.A. Bolzano,533050,531823,99.77,0.37
213,2021-08-15,PAB,616,333,283,282,334,0,ITH,ITH1,4,Provincia Autonoma Bolzano / Bozen,P.A. Bolzano,533050,532439,99.89,0.12
214,2021-05-07,PAB,4200,2063,2137,3398,528,274,ITH,ITH1,4,Provincia Autonoma Bolzano / Bozen,P.A. Bolzano,533050,536639,100.67,0.79
215,2021-07-03,PAB,5639,2793,2846,968,4566,105,ITH,ITH1,4,Provincia Autonoma Bolzano / Bozen,P.A. Bolzano,533050,542278,101.73,1.06
216,2021-05-05,PAB,4161,1948,2213,1827,2118,216,ITH,ITH1,4,Provincia Autonoma Bolzano / Bozen,P.A. Bolzano,533050,546439,102.51,0.78
217,2021-01-25,PAB,493,187,306,3,490,0,ITH,ITH1,4,Provincia Autonoma Bolzano / Bozen,P.A. Bolzano,533050,546932,102.6,0.09
218,2021-06-28,PAB,4614,2308,2306,217,4373,24,ITH,ITH1,4,Provincia Autonoma Bolzano / Bozen,P.A. Bolzano,533050,551546,103.47,0.87
219,2021-02-05,PAB,3206,1189,2017,8,3198,0,ITH,ITH1,4,Provincia Autonoma Bolzano / Bozen,P.A. Bolzano,533050,554752,104.07,0.6
220,2021-04-15,PAB,4410,2314,2096,4141,266,3,ITH,ITH1,4,Provincia Autonoma Bolzano / Bozen,P.A. Bolzano,533050,559162,104.9,0.83
221,2021-07-24,PAB,4831,2848,1983,1384,3330,117,ITH,ITH1,4,Provincia Autonoma Bolzano / Bozen,P.A. Bolzano,533050,563993,105.8,0.91
222,2021-05-02,PAB,2453,1284,1169,1431,915,107,ITH,ITH1,4,Provincia Autonoma Bolzano / Bozen,P.A. Bolzano,533050,566446,106.27,0.46
223,2021-01-22,PAB,248,143,105,124,124,0,ITH,ITH1,4,Provincia Autonoma Bolzano / Bozen,P.A. Bolzano,533050,566694,106.31,0.05
224,2021-03-23,PAB,1557,761,796,1544,1,12,ITH,ITH1,4,Provincia Autonoma Bolzano / Bozen,P.A. Bolzano,533050,568251,106.6,0.29
225,2021-04-01,PAB,2791,1409,1382,2644,146,1,ITH,ITH1,4,Provincia Autonoma Bolzano / Bozen,P.A. Bolzano,533050,571042,107.13,0.52
226,2021-07-05,PAB,2936,1406,1530,824,1984,128,ITH,ITH1,4,Provincia Autonoma Bolzano / Bozen,P.A. Bolzano,533050,573978,107.68,0.55
227,2021-05-30,PAB,4793,2531,2262,733,4030,30,ITH,ITH1,4,Provincia Autonoma Bolzano / Bozen,P.A. Bolzano,533050,578771,108.58,0.9
228,2021-07-12,PAB,3534,1755,1779,252,3243,39,ITH,ITH1,4,Provincia Autonoma Bolzano / Bozen,P.A. Bolzano,533050,582305,109.24,0.66
229,2021-04-03,PAB,833,366,467,22,811,0,ITH,ITH1,4,Provincia Autonoma Bolzano / Bozen,P.A. Bolzano,533050,583138,109.4,0.16
230,2021-09-07,PAB,1279,698,581,238,1041,0,ITH,ITH1,4,Provincia Autonoma Bolzano / Bozen,P.A. Bolzano,533050,584417,109.64,0.24
231,2021-03-25,PAB,2173,1080,1093,1724,445,4,ITH,ITH1,4,Provincia Autonoma Bolzano / Bozen,P.A. Bolzano,533050,586590,110.04,0.41
232,2021-01-27,PAB,85,29,56,2,83,0,ITH,ITH1,4,Provincia Autonoma Bolzano / Bozen,P.A. Bolzano,533050,586675,110.06,0.02
233,2021-01-19,PAB,853,371,482,723,130,0,ITH,ITH1,4,Provincia Autonoma Bolzano / Bozen,P.A. Bolzano,533050,587528,110.22,0.16
234,2021-06-25,PAB,4179,2308,1871,1025,3014,140,ITH,ITH1,4,Provincia Autonoma Bolzano / Bozen,P.A. Bolzano,533050,591707,111.0,0.78
235,2021-02-09,PAB,317,126,191,1,316,0,ITH,ITH1,4,Provincia Autonoma Bolzano / Bozen,P.A. Bolzano,533050,592024,111.06,0.06
236,2021-09-08,PAB,517,274,243,256,261,0,ITH,ITH1,4,Provincia Autonoma Bolzano / Bozen,P.A. Bolzano,533050,592541,111.16,0.1
237,2021-07-13,PAB,3384,1732,1652,1320,1930,134,ITH,ITH1,4,Provincia Autonoma Bolzano / Bozen,P.A. Bolzano,533050,595925,111.8,0.63
238,2021-02-02,PAB,1752,509,1243,8,1744,0,ITH,ITH1,4,Provincia Autonoma Bolzano / Bozen,P.A. Bolzano,533050,597677,112.12,0.33
239,2021-07-20,PAB,3134,1730,1404,1402,1524,208,ITH,ITH1,4,Provincia Autonoma Bolzano / Bozen,P.A. Bolzano,533050,600811,112.71,0.59
240,2021-09-15,PAB,207,115,92,55,152,0,ITH,ITH1,4,Provincia Autonoma Bolzano / Bozen,P.A. Bolzano,533050,601018,112.75,0.04
241,2021-09-01,PAB,1058,503,555,596,450,12,ITH,ITH1,4,Provincia Autonoma Bolzano / Bozen,P.A. Bolzano,533050,602076,112.95,0.2
242,2021-05-31,PAB,3068,1514,1554,2087,868,113,ITH,ITH1,4,Provincia Autonoma Bolzano / Bozen,P.A. Bolzano,533050,605144,113.52,0.58
243,2021-01-01,PAB,6,5,1,6,0,0,ITH,ITH1,4,Provincia Autonoma Bolzano / Bozen,P.A. Bolzano,533050,605150,113.53,0.0
244,2021-06-07,PAB,2987,1554,1433,2523,324,140,ITH,ITH1,4,Provincia Autonoma Bolzano / Bozen,P.A. Bolzano,533050,608137,114.09,0.56
245,2021-02-27,PAB,2458,759,1699,2448,10,0,ITH,ITH1,4,Provincia Autonoma Bolzano / Bozen,P.A. Bolzano,533050,610595,114.55,0.46
246,2021-02-13,PAB,318,79,239,312,6,0,ITH,ITH1,4,Provincia Autonoma Bolzano / Bozen,P.A. Bolzano,533050,610913,114.61,0.06
247,2021-04-11,PAB,2734,1301,1433,2555,178,1,ITH,ITH1,4,Provincia Autonoma Bolzano / Bozen,P.A. Bolzano,533050,613647,115.12,0.51
248,2021-05-24,PAB,1459,769,690,1061,335,63,ITH,ITH1,4,Provincia Autonoma Bolzano / Bozen,P.A. Bolzano,533050,615106,115.39,0.27
249,2021-02-20,PAB,1802,540,1262,1784,18,0,ITH,ITH1,4,Provincia Autonoma Bolzano / Bozen,P.A. Bolzano,533050,616908,115.73,0.34
250,2021-07-27,PAB,3158,1886,1272,909,2181,68,ITH,ITH1,4,Provincia Autonoma Bolzano / Bozen,P.A. Bolzano,533050,620066,116.32,0.59
251,2021-04-18,PAB,3116,1611,1505,2104,1011,1,ITH,ITH1,4,Provincia Autonoma Bolzano / Bozen,P.A. Bolzano,533050,623182,116.91,0.58
252,2021-01-15,PAB,3293,1234,2059,3293,0,0,ITH,ITH1,4,Provincia Autonoma Bolzano / Bozen,P.A. Bolzano,533050,626475,117.53,0.62
253,2021-08-14,PAB,2061,1120,941,786,1272,3,ITH,ITH1,4,Provincia Autonoma Bolzano / Bozen,P.A. Bolzano,533050,628536,117.91,0.39
254,2021-06-18,PAB,4544,2351,2193,1466,2912,166,ITH,ITH1,4,Provincia Autonoma Bolzano / Bozen,P.A. Bolzano,533050,633080,118.77,0.85
255,2021-01-08,PAB,1537,484,1053,1537,0,0,ITH,ITH1,4,Provincia Autonoma Bolzano / Bozen,P.A. Bolzano,533050,634617,119.05,0.29
256,2021-08-07,PAB,2378,1354,1024,1693,665,20,ITH,ITH1,4,Provincia Autonoma Bolzano / Bozen,P.A. Bolzano,533050,636995,119.5,0.45
257,2021-03-23,PIE,13230,5580,7650,6650,6254,326,ITC,ITC1,1,Piemonte,Piemonte,4356406,13230,0.3,0.3
258,2021-01-16,PIE,7786,2630,5156,7779,0,7,ITC,ITC1,1,Piemonte,Piemonte,4356406,21016,0.48,0.18
259,2021-07-15,PIE,42630,22023,20607,4111,38057,462,ITC,ITC1,1,Piemonte,Piemonte,4356406,63646,1.46,0.98
260,2021-08-01,PIE,27280,14449,12831,8476,18289,515,ITC,ITC1,1,Piemonte,Piemonte,4356406,90926,2.09,0.63
261,2021-04-23,PIE,27488,12624,14864,20001,6770,717,ITC,ITC1,1,Piemonte,Piemonte,4356406,118414,2.72,0.63
262,2021-08-27,PIE,17404,9291,8113,7485,9264,655,ITC,ITC1,1,Piemonte,Piemonte,4356406,135818,3.12,0.4
263,2021-05-19,PIE,33229,15347,17882,21481,11146,602,ITC,ITC1,1,Piemonte,Piemonte,4356406,169047,3.88,0.76
264,2021-03-14,PIE,8221,3343,4878,5176,2903,142,ITC,ITC1,1,Piemonte,Piemonte,4356406,177268,4.07,0.19
265,2021-05-10,PIE,29095,14039,15056,15313,13140,642,ITC,ITC1,1,Piemonte,Piemonte,4356406,206363,4.74,0.67
266,2021-01-30,PIE,6008,2149,3859,218,5789,1,ITC,ITC1,1,Piemonte,Piemonte,4356406,212371,4.87,0.14
267,2021-06-24,PIE,39326,19734,19592,18365,20353,608,ITC,ITC1,1,Piemonte,Piemonte,4356406,251697,5.78,0.9
268,2021-03-16,PIE,10548,4284,6264,4378,6076,94,ITC,ITC1,1,Piemonte,Piemonte,4356406,262245,6.02,0.24
269,2021-08-20,PIE,16602,8915,7687,10339,5550,713,ITC,ITC1,1,Piemonte,Piemonte,4356406,278847,6.4,0.38
270,2021-09-15,PIE,7701,3933,3768,2538,4771,392,ITC,ITC1,1,Piemonte,Piemonte,4356406,286548,6.58,0.18
271,2021-06-07,PIE,34992,17900,17092,29559,4808,625,ITC,ITC1,1,Piemonte,Piemonte,4356406,321540,7.38,0.8
272,2021-08-03,PIE,30214,15809,14405,9333,20388,493,ITC,ITC1,1,Piemonte,Piemonte,4356406,351754,8.07,0.69
273,2021-07-06,PIE,38341,19403,18938,8652,29131,558,ITC,ITC1,1,Piemonte,Piemonte,4356406,390095,8.95,0.88
274,2021-03-28,PIE,16095,6907,9188,8131,7624,340,ITC,ITC1,1,Piemonte,Piemonte,4356406,406190,9.32,0.37
275,2021-07-20,PIE,39112,20578,18534,5757,32785,570,ITC,ITC1,1,Piemonte,Piemonte,4356406,445302,10.22,0.9
276,2021-04-11,PIE,20860,9330,11530,18236,2152,472,ITC,ITC1,1,Piemonte,Piemonte,4356406,466162,10.7,0.48
277,2021-01-04,PIE,5585,1690,3895,5584,0,1,ITC,ITC1,1,Piemonte,Piemonte,4356406,471747,10.83,0.13
278,2021-04-28,PIE,26122,11779,14343,15497,10072,553,ITC,ITC1,1,Piemonte,Piemonte,4356406,497869,11.43,0.6
279,2021-08-15,PIE,6579,3631,2948,5036,1270,273,ITC,ITC1,1,Piemonte,Piemonte,4356406,504448,11.58,0.15
280,2021-09-01,PIE,18669,9652,9017,6714,11254,701,ITC,ITC1,1,Piemonte,Piemonte,4356406,523117,12.01,0.43
281,2021-05-24,PIE,29034,13443,15591,16654,11991,389,ITC,ITC1,1,Piemonte,Piemonte,4356406,552151,12.67,0.67
282,2021-03-02,PIE,11344,4621,6723,10334,815,195,ITC,ITC1,1,Piemonte,Piemonte,4356406,563495,12.93,0.26
283,2021-02-11,PIE,6779,2110,4669,2992,3768,19,ITC,ITC1,1,Piemonte,Piemonte,4356406,570274,13.09,0.16
284,2021-04-09,PIE,25927,11413,14514,20840,4508,579,ITC,ITC1,1,Piemonte,Piemonte,4356406,596201,13.69,0.6
285,2020-12-30,PIE,742,327,415,742,0,0,ITC,ITC1,1,Piemonte,Piemonte,4356406,596943,13.7,0.02
286,2021-06-05,PIE,37039,18963,18076,31921,4464,654,ITC,ITC1,1,Piemonte,Piemonte,4356406,633982,14.55,0.85
287,2021-02-25,PIE,12296,5309,6987,11562,547,187,ITC,ITC1,1,Piemonte,Piemonte,4356406,646278,14.84,0.28
288,2021-09-10,PIE,17220,9005,8215,5104,11419,697,ITC,ITC1,1,Piemonte,Piemonte,4356406,663498,15.23,0.4
289,2021-06-19,PIE,40148,20360,19788,22905,16685,558,ITC,ITC1,1,Piemonte,Piemonte,4356406,703646,16.15,0.92
290,2021-02-04,PIE,10259,3363,6896,583,9674,2,ITC,ITC1,1,Piemonte,Piemonte,4356406,713905,16.39,0.24
291,2021-07-08,PIE,41051,20991,20060,7461,33011,579,ITC,ITC1,1,Piemonte,Piemonte,4356406,754956,17.33,0.94
292,2021-01-23,PIE,4265,1328,2937,878,3385,2,ITC,ITC1,1,Piemonte,Piemonte,4356406,759221,17.43,0.1
293,2021-03-21,PIE,10748,4747,6001,4032,6542,174,ITC,ITC1,1,Piemonte,Piemonte,4356406,769969,17.67,0.25
294,2021-08-13,PIE,20019,10668,9351,12074,7237,708,ITC,ITC1,1,Piemonte,Piemonte,4356406,789988,18.13,0.46
295,2021-05-05,PIE,34735,16274,18461,20349,13683,703,ITC,ITC1,1,Piemonte,Piemonte,4356406,824723,18.93,0.8
296,2021-07-01,PIE,42019,21022,20997,19825,21154,1040,ITC,ITC1,1,Piemonte,Piemonte,4356406,866742,19.9,0.96
297,2021-06-26,PIE,41295,21013,20282,21978,18599,718,ITC,ITC1,1,Piemonte,Piemonte,4356406,908037,20.84,0.95
298,2021-07-13,PIE,38911,20073,18838,3677,34897,337,ITC,ITC1,1,Piemonte,Piemonte,4356406,946948,21.74,0.89
299,2021-04-04,PIE,9268,4060,5208,6398,2713,157,ITC,ITC1,1,Piemonte,Piemonte,4356406,956216,21.95,0.21
300,2021-04-21,PIE,25825,11860,13965,19786,5365,674,ITC,ITC1,1,Piemonte,Piemonte,4356406,982041,22.54,0.59
301,2021-01-11,PIE,8788,3000,5788,8782,0,6,ITC,ITC1,1,Piemonte,Piemonte,4356406,990829,22.74,0.2
302,2021-05-12,PIE,31981,15222,16759,18391,12959,631,ITC,ITC1,1,Piemonte,Piemonte,4356406,1022810,23.48,0.73
303,2021-08-22,PIE,9613,5249,4364,5134,4099,380,ITC,ITC1,1,Piemonte,Piemonte,4356406,1032423,23.7,0.22
304,2020-12-28,PIE,1,1,0,1,0,0,ITC,ITC1,1,Piemonte,Piemonte,4356406,1032424,23.7,0.0
305,2021-09-08,PIE,15630,8082,7548,6130,8733,767,ITC,ITC1,1,Piemonte,Piemonte,4356406,1048054,24.06,0.36
306,2021-07-27,PIE,33823,17661,16162,8263,24995,565,ITC,ITC1,1,Piemonte,Piemonte,4356406,1081877,24.83,0.78
307,2021-05-02,PIE,25163,11292,13871,14013,10752,398,ITC,ITC1,1,Piemonte,Piemonte,4356406,1107040,25.41,0.58
308,2021-01-18,PIE,6180,2051,4129,5925,251,4,ITC,ITC1,1,Piemonte,Piemonte,4356406,1113220,25.55,0.14
309,2021-05-17,PIE,31021,14650,16371,17384,13217,420,ITC,ITC1,1,Piemonte,Piemonte,4356406,1144241,26.27,0.71
310,2021-02-06,PIE,8014,2668,5346,396,7616,2,ITC,ITC1,1,Piemonte,Piemonte,4356406,1152255,26.45,0.18
311,2021-02-23,PIE,9284,3742,5542,8517,590,177,ITC,ITC1,1,Piemonte,Piemonte,4356406,1161539,26.66,0.21
312,2021-05-31,PIE,29170,14083,15087,20171,8588,411,ITC,ITC1,1,Piemonte,Piemonte,4356406,1190709,27.33,0.67
313,2021-06-17,PIE,41245,20702,20543,24243,16373,629,ITC,ITC1,1,Piemonte,Piemonte,4356406,1231954,28.28,0.95
314,2021-04-02,PIE,20178,8332,11846,11339,8434,405,ITC,ITC1,1,Piemonte,Piemonte,4356406,1252132,28.74,0.46
315,2021-05-29,PIE,32866,15257,17609,20310,12193,363,ITC,ITC1,1,Piemonte,Piemonte,4356406,1284998,29.5,0.75
316,2021-02-18,PIE,4821,2115,2706,4304,429,88,ITC,ITC1,1,Piemonte,Piemonte,4356406,1289819,29.61,0.11
317,2021-07-25,PIE,28791,15266,13525,6598,21697,496,ITC,ITC1,1,Piemonte,Piemonte,4356406,1318610,30.27,0.66
318,2021-04-16,PIE,28488,13240,15248,22695,5019,774,ITC,ITC1,1,Piemonte,Piemonte,4356406,1347098,30.92,0.65
319,2021-09-03,PIE,18369,9698,8671,6410,11300,659,ITC,ITC1,1,Piemonte,Piemonte,4356406,1365467,31.34,0.42
320,2021-06-12,PIE,42732,22516,20216,39291,2630,811,ITC,ITC1,1,Piemonte,Piemonte,4356406,1408199,32.32,0.98
321,2021-08-08,PIE,20303,10840,9463,9019,10935,349,ITC,ITC1,1,Piemonte,Piemonte,4356406,1428502,32.79,0.47
322,2021-04-30,PIE,31999,14392,17607,17961,13348,690,ITC,ITC1,1,Piemonte,Piemonte,4356406,1460501,33.53,0.73
323,2021-09-07,PIE,18363,9669,8694,6138,11541,684,ITC,ITC1,1,Piemonte,Piemonte,4356406,1478864,33.95,0.42
324,2021-07-03,PIE,40155,20151,20004,15351,24050,754,ITC,ITC1,1,Piemonte,Piemonte,4356406,1519019,34.87,0.92
325,2021-06-28,PIE,38505,19120,19385,15148,22753,604,ITC,ITC1,1,Piemonte,Piemonte,4356406,1557524,35.75,0.88
326,2021-04-06,PIE,20816,9078,11738,15141,5217,458,ITC,ITC1,1,Piemonte,Piemonte,4356406,1578340,36.23,0.48
327,2020-12-27,PIE,915,370,545,915,0,0,ITC,ITC1,1,Piemonte,Piemonte,4356406,1579255,36.25,0.02
328,2021-02-08,PIE,6933,2356,4577,664,6264,5,ITC,ITC1,1,Piemonte,Piemonte,4356406,1586188,36.41,0.16
329,2021-08-29,PIE,15135,8115,7020,5035,9669,431,ITC,ITC1,1,Piemonte,Piemonte,4356406,1601323,36.76,0.35
330,2021-05-21,PIE,36298,16864,19434,20091,15682,525,ITC,ITC1,1,Piemonte,Piemonte,4356406,1637621,37.59,0.83
331,2021-07-17,PIE,42053,22136,19917,4957,36598,498,ITC,ITC1,1,Piemonte,Piemonte,4356406,1679674,38.56,0.97
332,2021-03-09,PIE,14341,5741,8600,11751,2354,236,ITC,ITC1,1,Piemonte,Piemonte,4356406,1694015,38.89,0.33
333,2021-08-24,PIE,15238,8132,7106,7871,6729,638,ITC,ITC1,1,Piemonte,Piemonte,4356406,1709253,39.24,0.35
334,2021-01-01,PIE,1041,396,645,1040,0,1,ITC,ITC1,1,Piemonte,Piemonte,4356406,1710294,39.26,0.02
335,2021-09-12,PIE,10463,5543,4920,3528,6463,472,ITC,ITC1,1,Piemonte,Piemonte,4356406,1720757,39.5,0.24
336,2021-02-27,PIE,12733,4861,7872,12154,337,242,ITC,ITC1,1,Piemonte,Piemonte,4356406,1733490,39.79,0.29
337,2021-04-25,PIE,20275,9328,10947,17296,2510,469,ITC,ITC1,1,Piemonte,Piemonte,4356406,1753765,40.26,0.47
338,2021-01-15,PIE,9132,3014,6118,9126,0,6,ITC,ITC1,1,Piemonte,Piemonte,4356406,1762897,40.47,0.21
339,2021-06-21,PIE,38529,19263,19266,17173,20786,570,ITC,ITC1,1,Piemonte,Piemonte,4356406,1801426,41.35,0.88
340,2021-03-13,PIE,13055,4727,8328,11349,1432,274,ITC,ITC1,1,Piemonte,Piemonte,4356406,1814481,41.65,0.3
341,2021-04-18,PIE,22973,10819,12154,19634,2756,583,ITC,ITC1,1,Piemonte,Piemonte,4356406,1837454,42.18,0.53
342,2021-01-08,PIE,5549,1767,3782,5547,0,2,ITC,ITC1,1,Piemonte,Piemonte,4356406,1843003,42.31,0.13
343,2021-06-14,PIE,38096,19617,18479,30278,7098,720,ITC,ITC1,1,Piemonte,Piemonte,4356406,1881099,43.18,0.87
344,2021-03-30,PIE,17018,7128,9890,8745,7875,398,ITC,ITC1,1,Piemonte,Piemonte,4356406,1898117,43.57,0.39
345,2021-07-10,PIE,41280,20935,20345,6732,34000,548,ITC,ITC1,1,Piemonte,Piemonte,4356406,1939397,44.52,0.95
346,2021-04-01,PIE,19452,8164,11288,10984,8142,326,ITC,ITC1,1,Piemonte,Piemonte,4356406,1958849,44.96,0.45
347,2021-09-05,PIE,13030,6903,6127,4461,8096,473,ITC,ITC1,1,Piemonte,Piemonte,4356406,1971879,45.26,0.3
348,2021-05-28,PIE,35135,16637,18498,18693,16026,416,ITC,ITC1,1,Piemonte,Piemonte,4356406,2007014,46.07,0.81
349,2021-01-25,PIE,6233,1947,4286,977,5254,2,ITC,ITC1,1,Piemonte,Piemonte,4356406,2013247,46.21,0.14
350,2021-07-12,PIE,39255,20243,19012,4564,34214,477,ITC,ITC1,1,Piemonte,Piemonte,4356406,2052502,47.11,0.9
351,2021-07-29,PIE,36709,19077,17632,9378,26672,659,ITC,ITC1,1,Piemonte,Piemonte,4356406,2089211,47.96,0.84
352,2021-04-20,PIE,25550,11694,13856,18558,6362,630,ITC,ITC1,1,Piemonte,Piemonte,4356406,2114761,48.54,0.59
353,2021-05-07,PIE,33173,15697,17476,18386,14155,632,ITC,ITC1,1,Piemonte,Piemonte,4356406,2147934,49.31,0.76
354,2021-01-27,PIE,4208,1456,2752,995,3211,2,ITC,ITC1,1,Piemonte,Piemonte,4356406,2152142,49.4,0.1
355,2021-02-13,PIE,4172,1344,2828,2931,1225,16,ITC,ITC1,1,Piemonte,Piemonte,4356406,2156314,49.5,0.1
356,2021-07-31,PIE,35792,19025,16767,10756,24640,396,ITC,ITC1,1,Piemonte,Piemonte,4356406,2192106,50.32,0.82
357,2021-08-17,PIE,18084,9693,8391,11698,5601,785,ITC,ITC1,1,Piemonte,Piemonte,4356406,2210190,50.73,0.42
358,2021-05-09,PIE,27181,12942,14239,13162,13623,396,ITC,ITC1,1,Piemonte,Piemonte,4356406,2237371,51.36,0.62
359,2021-05-26,PIE,34245,15783,18462,15361,18520,364,ITC,ITC1,1,Piemonte,Piemonte,4356406,2271616,52.14,0.79
360,2021-02-15,PIE,4447,1603,2844,3214,1210,23,ITC,ITC1,1,Piemonte,Piemonte,4356406,2276063,52.25,0.1
361,2021-03-04,PIE,14757,5947,8810,11583,2950,224,ITC,ITC1,1,Piemonte,Piemonte,4356406,2290820,52.59,0.34
362,2021-06-02,PIE,26779,13108,13671,21682,4648,449,ITC,ITC1,1,Piemonte,Piemonte,4356406,2317599,53.2,0.61
363,2021-02-22,PIE,8508,3476,5032,7808,595,105,ITC,ITC1,1,Piemonte,Piemonte,4356406,2326107,53.4,0.2
364,2021-03-11,PIE,14044,5320,8724,10690,3103,251,ITC,ITC1,1,Piemonte,Piemonte,4356406,2340151,53.72,0.32
365,2021-03-25,PIE,17177,7287,9890,8097,8637,443,ITC,ITC1,1,Piemonte,Piemonte,4356406,2357328,54.11,0.39
366,2021-07-05,PIE,35643,17835,17808,11706,23242,695,ITC,ITC1,1,Piemonte,Piemonte,4356406,2392971,54.93,0.82
367,2021-02-20,PIE,3849,1264,2585,3572,174,103,ITC,ITC1,1,Piemonte,Piemonte,4356406,2396820,55.02,0.09
368,2021-07-24,PIE,34921,18369,16552,7917,26397,607,ITC,ITC1,1,Piemonte,Piemonte,4356406,2431741,55.82,0.8
369,2021-02-01,PIE,8699,3072,5627,579,8119,1,ITC,ITC1,1,Piemonte,Piemonte,4356406,2440440,56.02,0.2
370,2021-05-14,PIE,33501,16315,17186,17370,15455,676,ITC,ITC1,1,Piemonte,Piemonte,4356406,2473941,56.79,0.77
371,2021-08-31,PIE,19019,10028,8991,6820,11643,556,ITC,ITC1,1,Piemonte,Piemonte,4356406,2492960,57.23,0.44
372,2021-06-09,PIE,38761,20417,18344,35207,2751,803,ITC,ITC1,1,Piemonte,Piemonte,4356406,2531721,58.11,0.89
373,2021-03-18,PIE,11786,4818,6968,3842,7749,195,ITC,ITC1,1,Piemonte,Piemonte,4356406,2543507,58.39,0.27
374,2021-03-03,PIE,12391,4871,7520,11375,821,195,ITC,ITC1,1,Piemonte,Piemonte,4356406,2555898,58.67,0.28
375,2021-03-20,PIE,11951,4905,7046,5783,5916,252,ITC,ITC1,1,Piemonte,Piemonte,4356406,2567849,58.94,0.27
376,2021-03-06,PIE,14045,5234,8811,11065,2800,180,ITC,ITC1,1,Piemonte,Piemonte,4356406,2581894,59.27,0.32
377,2021-08-10,PIE,22064,11687,10377,12515,8892,657,ITC,ITC1,1,Piemonte,Piemonte,4356406,2603958,59.77,0.51
378,2021-01-22,PIE,3888,1256,2632,2542,1345,1,ITC,ITC1,1,Piemonte,Piemonte,4356406,2607846,59.86,0.09
379,2021-08-21,PIE,13331,7127,6204,7714,5088,529,ITC,ITC1,1,Piemonte,Piemonte,4356406,2621177,60.17,0.31
380,2021-05-30,PIE,27832,13235,14597,18055,9399,378,ITC,ITC1,1,Piemonte,Piemonte,4356406,2649009,60.81,0.64
381,2021-02-19,PIE,5562,2187,3375,4933,504,125,ITC,ITC1,1,Piemonte,Piemonte,4356406,2654571,60.93,0.13
382,2021-06-04,PIE,37707,19720,17987,34107,2970,630,ITC,ITC1,1,Piemonte,Piemonte,4356406,2692278,61.8,0.87
383,2021-02-24,PIE,11416,4618,6798,10759,505,152,ITC,ITC1,1,Piemonte,Piemonte,4356406,2703694,62.06,0.26
384,2021-06-25,PIE,45625,22729,22896,20293,24599,733,ITC,ITC1,1,Piemonte,Piemonte,4356406,2749319,63.11,1.05
385,2021-04-03,PIE,19527,8229,11298,10635,8578,314,ITC,ITC1,1,Piemonte,Piemonte,4356406,2768846,63.56,0.45
386,2021-01-10,PIE,5246,2288,2958,5243,0,3,ITC,ITC1,1,Piemonte,Piemonte,4356406,2774092,63.68,0.12
387,2021-07-14,PIE,39083,20098,18985,3602,35054,427,ITC,ITC1,1,Piemonte,Piemonte,4356406,2813175,64.58,0.9
388,2021-07-22,PIE,41669,21934,19735,7019,34051,599,ITC,ITC1,1,Piemonte,Piemonte,4356406,2854844,65.53,0.96
389,2021-04-13,PIE,26786,12046,14740,22624,3465,697,ITC,ITC1,1,Piemonte,Piemonte,4356406,2881630,66.15,0.61
390,2021-01-20,PIE,6639,2095,4544,5909,723,7,ITC,ITC1,1,Piemonte,Piemonte,4356406,2888269,66.3,0.15
391,2021-02-03,PIE,10227,3312,6915,609,9616,2,ITC,ITC1,1,Piemonte,Piemonte,4356406,2898496,66.53,0.23
392,2021-08-09,PIE,24762,12914,11848,12039,11996,727,ITC,ITC1,1,Piemonte,Piemonte,4356406,2923258,67.1,0.57
393,2021-08-26,PIE,16894,9146,7748,8111,8029,754,ITC,ITC1,1,Piemonte,Piemonte,4356406,2940152,67.49,0.39
394,2021-05-18,PIE,32251,14879,17372,19113,12689,449,ITC,ITC1,1,Piemonte,Piemonte,4356406,2972403,68.23,0.74
395,2021-09-09,PIE,15928,8271,7657,6066,9100,762,ITC,ITC1,1,Piemonte,Piemonte,4356406,2988331,68.6,0.37
396,2021-08-07,PIE,29789,15946,13843,12642,16647,500,ITC,ITC1,1,Piemonte,Piemonte,4356406,3018120,69.28,0.68
397,2021-04-29,PIE,48614,22025,26589,34746,12648,1220,ITC,ITC1,1,Piemonte,Piemonte,4356406,3066734,70.4,1.12
398,2021-05-16,PIE,28231,12811,15420,14763,13092,376,ITC,ITC1,1,Piemonte,Piemonte,4356406,3094965,71.04,0.65
399,2021-02-05,PIE,9637,3147,6490,656,8979,2,ITC,ITC1,1,Piemonte,Piemonte,4356406,3104602,71.27,0.22
400,2021-06-18,PIE,40733,20364,20369,25799,14242,692,ITC,ITC1,1,Piemonte,Piemonte,4356406,3145335,72.2,0.94
401,2021-03-10,PIE,13958,5454,8504,11392,2295,271,ITC,ITC1,1,Piemonte,Piemonte,4356406,3159293,72.52,0.32
402,2021-03-27,PIE,18432,7841,10591,9142,8835,455,ITC,ITC1,1,Piemonte,Piemonte,4356406,3177725,72.94,0.42
403,2021-04-22,PIE,27700,12755,14945,20206,6698,796,ITC,ITC1,1,Piemonte,Piemonte,4356406,3205425,73.58,0.64
404,2021-01-12,PIE,10109,3422,6687,10103,0,6,ITC,ITC1,1,Piemonte,Piemonte,4356406,3215534,73.81,0.23
405,2021-01-29,PIE,5961,1894,4067,454,5507,0,ITC,ITC1,1,Piemonte,Piemonte,4356406,3221495,73.95,0.14
406,2021-08-14,PIE,15126,8145,6981,9799,4762,565,ITC,ITC1,1,Piemonte,Piemonte,4356406,3236621,74.3,0.35
407,2021-05-06,PIE,33492,15817,17675,19318,13566,608,ITC,ITC1,1,Piemonte,Piemonte,4356406,3270113,75.06,0.77
408,2021-05-23,PIE,28831,13174,15657,15492,13019,320,ITC,ITC1,1,Piemonte,Piemonte,4356406,3298944,75.73,0.66
409,2021-02-12,PIE,6923,2227,4696,3924,2974,25,ITC,ITC1,1,Piemonte,Piemonte,4356406,3305867,75.89,0.16
410,2021-03-01,PIE,12189,4967,7222,11196,813,180,ITC,ITC1,1,Piemonte,Piemonte,4356406,3318056,76.16,0.28
411,2021-09-02,PIE,16863,8785,8078,6145,10074,644,ITC,ITC1,1,Piemonte,Piemonte,4356406,3334919,76.55,0.39
412,2021-05-25,PIE,31942,14801,17141,15645,15901,396,ITC,ITC1,1,Piemonte,Piemonte,4356406,3366861,77.29,0.73
413,2021-06-11,PIE,43694,23116,20578,40026,2843,825,ITC,ITC1,1,Piemonte,Piemonte,4356406,3410555,78.29,1.0
414,2021-07-26,PIE,32840,17086,15754,8314,23893,633,ITC,ITC1,1,Piemonte,Piemonte,4356406,3443395,79.04,0.75
415,2021-04-17,PIE,30527,14175,16352,26487,3315,725,ITC,ITC1,1,Piemonte,Piemonte,4356406,3473922,79.74,0.7
416,2021-06-13,PIE,38214,20169,18045,33300,4137,777,ITC,ITC1,1,Piemonte,Piemonte,4356406,3512136,80.62,0.88
417,2021-07-02,PIE,43850,22061,21789,17386,25591,873,ITC,ITC1,1,Piemonte,Piemonte,4356406,3555986,81.63,1.01
418,2021-08-28,PIE,17490,9210,8280,7295,9563,632,ITC,ITC1,1,Piemonte,Piemonte,4356406,3573476,82.03,0.4
419,2021-05-13,PIE,35793,17586,18207,19913,15153,727,ITC,ITC1,1,Piemonte,Piemonte,4356406,3609269,82.85,0.82
420,2021-02-02,PIE,10291,3524,6767,814,9476,1,ITC,ITC1,1,Piemonte,Piemonte,4356406,3619560,83.09,0.24
421,2021-07-09,PIE,40498,20664,19834,5767,34191,540,ITC,ITC1,1,Piemonte,Piemonte,4356406,3660058,84.02,0.93
422,2021-03-31,PIE,19155,8134,11021,10112,8699,344,ITC,ITC1,1,Piemonte,Piemonte,4356406,3679213,84.46,0.44
423,2021-09-04,PIE,18580,9714,8866,6346,11520,714,ITC,ITC1,1,Piemonte,Piemonte,4356406,3697793,84.88,0.43
424,2021-05-27,PIE,37531,17449,20082,18870,18208,453,ITC,ITC1,1,Piemonte,Piemonte,4356406,3735324,85.74,0.86
425,2021-02-16,PIE,3989,1767,2222,3175,765,49,ITC,ITC1,1,Piemonte,Piemonte,4356406,3739313,85.83,0.09
426,2021-09-14,PIE,15763,8227,7536,5149,9903,711,ITC,ITC1,1,Piemonte,Piemonte,4356406,3755076,86.2,0.36
427,2021-06-06,PIE,35175,18375,16800,32127,2491,557,ITC,ITC1,1,Piemonte,Piemonte,4356406,3790251,87.0,0.81
428,2021-08-02,PIE,30029,15861,14168,9412,20067,550,ITC,ITC1,1,Piemonte,Piemonte,4356406,3820280,87.69,0.69
429,2021-02-17,PIE,4818,2171,2647,3765,991,62,ITC,ITC1,1,Piemonte,Piemonte,4356406,3825098,87.8,0.11
430,2021-06-08,PIE,37771,19538,18233,34197,2857,717,ITC,ITC1,1,Piemonte,Piemonte,4356406,3862869,88.67,0.87
431,2021-08-04,PIE,29334,15511,13823,8966,19855,513,ITC,ITC1,1,Piemonte,Piemonte,4356406,3892203,89.34,0.67
432,2021-04-26,PIE,19844,8768,11076,14928,4402,514,ITC,ITC1,1,Piemonte,Piemonte,4356406,3912047,89.8,0.46
433,2021-01-03,PIE,3069,973,2096,3068,0,1,ITC,ITC1,1,Piemonte,Piemonte,4356406,3915116,89.87,0.07
434,2021-07-07,PIE,38068,18918,19150,9710,27762,596,ITC,ITC1,1,Piemonte,Piemonte,4356406,3953184,90.74,0.87
435,2021-03-29,PIE,15272,6485,8787,8388,6615,269,ITC,ITC1,1,Piemonte,Piemonte,4356406,3968456,91.09,0.35
436,2021-07-21,PIE,38069,20195,17874,6556,30984,529,ITC,ITC1,1,Piemonte,Piemonte,4356406,4006525,91.97,0.87
437,2021-04-12,PIE,22980,10374,12606,19459,2995,526,ITC,ITC1,1,Piemonte,Piemonte,4356406,4029505,92.5,0.53
438,2021-01-19,PIE,6479,2110,4369,6461,9,9,ITC,ITC1,1,Piemonte,Piemonte,4356406,4035984,92.64,0.15
439,2021-07-23,PIE,38176,20129,18047,8035,29505,636,ITC,ITC1,1,Piemonte,Piemonte,4356406,4074160,93.52,0.88
440,2021-04-14,PIE,28384,12851,15533,23075,4585,724,ITC,ITC1,1,Piemonte,Piemonte,4356406,4102544,94.17,0.65
441,2021-08-06,PIE,30494,16125,14369,13298,16505,691,ITC,ITC1,1,Piemonte,Piemonte,4356406,4133038,94.87,0.7
442,2021-02-28,PIE,10845,4066,6779,10424,241,180,ITC,ITC1,1,Piemonte,Piemonte,4356406,4143883,95.12,0.25
443,2021-03-17,PIE,12539,5066,7473,5042,7308,189,ITC,ITC1,1,Piemonte,Piemonte,4356406,4156422,95.41,0.29
444,2021-06-10,PIE,40614,21229,19385,37132,2593,889,ITC,ITC1,1,Piemonte,Piemonte,4356406,4197036,96.34,0.93
445,2021-06-27,PIE,37597,18629,18968,15215,21771,611,ITC,ITC1,1,Piemonte,Piemonte,4356406,4234633,97.2,0.86
446,2021-03-24,PIE,15629,6418,9211,6124,9140,365,ITC,ITC1,1,Piemonte,Piemonte,4356406,4250262,97.56,0.36
447,2021-05-20,PIE,38728,17992,20736,13373,24993,362,ITC,ITC1,1,Piemonte,Piemonte,4356406,4288990,98.45,0.89
448,2021-02-09,PIE,7414,2321,5093,719,6693,2,ITC,ITC1,1,Piemonte,Piemonte,4356406,4296404,98.62,0.17
449,2021-07-16,PIE,42154,22018,20136,3610,38124,420,ITC,ITC1,1,Piemonte,Piemonte,4356406,4338558,99.59,0.97
450,2021-04-07,PIE,23720,10047,13673,17717,5463,540,ITC,ITC1,1,Piemonte,Piemonte,4356406,4362278,100.13,0.54
451,2021-08-11,PIE,23453,12615,10838,13442,9360,651,ITC,ITC1,1,Piemonte,Piemonte,4356406,4385731,100.67,0.54
452,2021-05-03,PIE,26725,12221,14504,12049,14229,447,ITC,ITC1,1,Piemonte,Piemonte,4356406,4412456,101.29,0.61
453,2021-02-26,PIE,12323,4943,7380,11369,743,211,ITC,ITC1,1,Piemonte,Piemonte,4356406,4424779,101.57,0.28
454,2021-04-24,PIE,27577,12467,15110,21339,5667,571,ITC,ITC1,1,Piemonte,Piemonte,4356406,4452356,102.2,0.63
455,2021-01-14,PIE,9802,3160,6642,9796,0,6,ITC,ITC1,1,Piemonte,Piemonte,4356406,4462158,102.43,0.23
456,2021-03-19,PIE,11048,4525,6523,4226,6612,210,ITC,ITC1,1,Piemonte,Piemonte,4356406,4473206,102.68,0.25
457,2021-04-05,PIE,14776,6249,8527,11961,2562,253,ITC,ITC1,1,Piemonte,Piemonte,4356406,4487982,103.02,0.34
458,2021-06-29,PIE,40674,20315,20359,19230,20731,713,ITC,ITC1,1,Piemonte,Piemonte,4356406,4528656,103.95,0.93
459,2021-08-18,PIE,18125,9786,8339,11616,5767,742,ITC,ITC1,1,Piemonte,Piemonte,4356406,4546781,104.37,0.42
460,2021-04-19,PIE,22591,10784,11807,17667,4358,566,ITC,ITC1,1,Piemonte,Piemonte,4356406,4569372,104.89,0.52
461,2021-01-09,PIE,6205,2197,4008,6203,0,2,ITC,ITC1,1,Piemonte,Piemonte,4356406,4575577,105.03,0.14
462,2021-01-26,PIE,6363,1897,4466,737,5625,1,ITC,ITC1,1,Piemonte,Piemonte,4356406,4581940,105.18,0.15
463,2021-07-30,PIE,35865,18727,17138,9558,25781,526,ITC,ITC1,1,Piemonte,Piemonte,4356406,4617805,106.0,0.82
464,2021-08-16,PIE,19257,10227,9030,11589,6811,857,ITC,ITC1,1,Piemonte,Piemonte,4356406,4637062,106.44,0.44
465,2021-05-08,PIE,34383,16306,18077,18178,15672,533,ITC,ITC1,1,Piemonte,Piemonte,4356406,4671445,107.23,0.79
466,2021-01-28,PIE,5613,1815,3798,380,5233,0,ITC,ITC1,1,Piemonte,Piemonte,4356406,4677058,107.36,0.13
467,2021-01-02,PIE,3553,1134,2419,3552,0,1,ITC,ITC1,1,Piemonte,Piemonte,4356406,4680611,107.44,0.08
468,2021-05-01,PIE,28626,13034,15592,16349,11823,454,ITC,ITC1,1,Piemonte,Piemonte,4356406,4709237,108.1,0.66
469,2021-01-21,PIE,6889,2317,4572,3377,3506,6,ITC,ITC1,1,Piemonte,Piemonte,4356406,4716126,108.26,0.16
470,2021-08-23,PIE,18373,9879,8494,8848,8935,590,ITC,ITC1,1,Piemonte,Piemonte,4356406,4734499,108.68,0.42
471,2021-05-15,PIE,33850,15783,18067,19425,13745,680,ITC,ITC1,1,Piemonte,Piemonte,4356406,4768349,109.46,0.78
472,2021-06-01,PIE,29633,14883,14750,24510,4687,436,ITC,ITC1,1,Piemonte,Piemonte,4356406,4797982,110.14,0.68
473,2021-08-25,PIE,16438,8863,7575,8277,7436,725,ITC,ITC1,1,Piemonte,Piemonte,4356406,4814420,110.51,0.38
474,2021-09-11,PIE,17450,9165,8285,5406,11311,733,ITC,ITC1,1,Piemonte,Piemonte,4356406,4831870,110.91,0.4
475,2021-06-03,PIE,34831,18032,16799,29779,4501,551,ITC,ITC1,1,Piemonte,Piemonte,4356406,4866701,111.71,0.8
476,2021-02-10,PIE,7568,2381,5187,1302,6251,15,ITC,ITC1,1,Piemonte,Piemonte,4356406,4874269,111.89,0.17
477,2021-04-08,PIE,25363,11039,14324,20065,4730,568,ITC,ITC1,1,Piemonte,Piemonte,4356406,4899632,112.47,0.58
478,2021-07-19,PIE,39663,20639,19024,4502,34740,421,ITC,ITC1,1,Piemonte,Piemonte,4356406,4939295,113.38,0.91
479,2021-04-10,PIE,30215,13434,16781,25285,4269,661,ITC,ITC1,1,Piemonte,Piemonte,4356406,4969510,114.07,0.69
480,2021-02-21,PIE,5104,2090,3014,4950,104,50,ITC,ITC1,1,Piemonte,Piemonte,4356406,4974614,114.19,0.12
481,2021-06-20,PIE,34143,17118,17025,18792,14783,568,ITC,ITC1,1,Piemonte,Piemonte,4356406,5008757,114.97,0.78
482,2021-03-12,PIE,14236,5412,8824,10995,2949,292,ITC,ITC1,1,Piemonte,Piemonte,4356406,5022993,115.3,0.33
483,2021-07-04,PIE,33865,17067,16798,11244,21987,634,ITC,ITC1,1,Piemonte,Piemonte,4356406,5056858,116.08,0.78
484,2021-03-26,PIE,17959,7141,10818,8539,8889,531,ITC,ITC1,1,Piemonte,Piemonte,4356406,5074817,116.49,0.41
485,2021-02-14,PIE,1483,501,982,871,605,7,ITC,ITC1,1,Piemonte,Piemonte,4356406,5076300,116.52,0.03
486,2021-04-15,PIE,29668,13596,16072,23420,5553,695,ITC,ITC1,1,Piemonte,Piemonte,4356406,5105968,117.21,0.68
487,2021-01-05,PIE,5406,1617,3789,5399,0,7,ITC,ITC1,1,Piemonte,Piemonte,4356406,5111374,117.33,0.12
488,2021-06-22,PIE,40721,20134,20587,17812,22339,570,ITC,ITC1,1,Piemonte,Piemonte,4356406,5152095,118.26,0.93
489,2021-01-07,PIE,5403,1740,3663,5401,0,2,ITC,ITC1,1,Piemonte,Piemonte,4356406,5157498,118.39,0.12
490,2021-03-05,PIE,15678,6312,9366,11559,3838,281,ITC,ITC1,1,Piemonte,Piemonte,4356406,5173176,118.75,0.36
491,2021-07-28,PIE,34844,18106,16738,9177,25057,610,ITC,ITC1,1,Piemonte,Piemonte,4356406,5208020,119.55,0.8
492,2021-06-15,PIE,39036,20103,18933,26550,11789,697,ITC,ITC1,1,Piemonte,Piemonte,4356406,5247056,120.44,0.9
493,2021-03-07,PIE,12008,4674,7334,10877,877,254,ITC,ITC1,1,Piemonte,Piemonte,4356406,5259064,120.72,0.28
494,2020-12-31,PIE,3896,1329,2567,3896,0,0,ITC,ITC1,1,Piemonte,Piemonte,4356406,5262960,120.81,0.09
495,2021-01-13,PIE,10118,3240,6878,10109,0,9,ITC,ITC1,1,Piemonte,Piemonte,4356406,5273078,121.04,0.23
496,2021-06-16,PIE,40497,20282,20215,23574,16286,637,ITC,ITC1,1,Piemonte,Piemonte,4356406,5313575,121.97,0.93
497,2021-08-12,PIE,22059,11834,10225,13471,7828,760,ITC,ITC1,1,Piemonte,Piemonte,4356406,5335634,122.48,0.51
498,2021-01-06,PIE,3119,1106,2013,3118,0,1,ITC,ITC1,1,Piemonte,Piemonte,4356406,5338753,122.55,0.07
499,2021-08-05,PIE,30358,16100,14258,11243,18555,560,ITC,ITC1,1,Piemonte,Piemonte,4356406,5369111,123.25,0.7
500,2021-06-23,PIE,39832,19787,20045,16422,22902,508,ITC,ITC1,1,Piemonte,Piemonte,4356406,5408943,124.16,0.91
501,2021-08-19,PIE,15890,8550,7340,10563,4596,731,ITC,ITC1,1,Piemonte,Piemonte,4356406,5424833,124.53,0.36
502,2021-03-08,PIE,14311,5606,8705,11351,2717,243,ITC,ITC1,1,Piemonte,Piemonte,4356406,5439144,124.85,0.33
503,2021-05-04,PIE,31653,14630,17023,17308,13749,596,ITC,ITC1,1,Piemonte,Piemonte,4356406,5470797,125.58,0.73
504,2021-01-24,PIE,3161,964,2197,435,2724,2,ITC,ITC1,1,Piemonte,Piemonte,4356406,5473958,125.65,0.07
505,2021-06-30,PIE,41360,20215,21145,18497,21978,885,ITC,ITC1,1,Piemonte,Piemonte,4356406,5515318,126.6,0.95
506,2021-03-22,PIE,11546,4899,6647,3720,7609,217,ITC,ITC1,1,Piemonte,Piemonte,4356406,5526864,126.87,0.27
507,2021-04-27,PIE,22668,10238,12430,16844,5166,658,ITC,ITC1,1,Piemonte,Piemonte,4356406,5549532,127.39,0.52
508,2021-01-17,PIE,3531,1169,2362,2879,650,2,ITC,ITC1,1,Piemonte,Piemonte,4356406,5553063,127.47,0.08
509,2021-03-15,PIE,10707,4201,6506,4936,5615,156,ITC,ITC1,1,Piemonte,Piemonte,4356406,5563770,127.71,0.25
510,2021-05-11,PIE,32339,15587,16752,18432,13262,645,ITC,ITC1,1,Piemonte,Piemonte,4356406,5596109,128.46,0.74
511,2021-01-31,PIE,4155,1768,2387,115,4040,0,ITC,ITC1,1,Piemonte,Piemonte,4356406,5600264,128.55,0.1
512,2021-07-18,PIE,32937,17272,15665,3251,29350,336,ITC,ITC1,1,Piemonte,Piemonte,4356406,5633201,129.31,0.76
513,2021-09-13,PIE,16567,8569,7998,5467,10316,784,ITC,ITC1,1,Piemonte,Piemonte,4356406,5649768,129.69,0.38
514,2021-02-07,PIE,3102,977,2125,446,2655,1,ITC,ITC1,1,Piemonte,Piemonte,4356406,5652870,129.76,0.07
515,2021-07-11,PIE,33227,16934,16293,4531,28373,323,ITC,ITC1,1,Piemonte,Piemonte,4356406,5686097,130.52,0.76
516,2021-09-06,PIE,18222,9536,8686,6113,11415,694,ITC,ITC1,1,Piemonte,Piemonte,4356406,5704319,130.94,0.42
517,2021-08-30,PIE,20922,10935,9987,7226,13025,671,ITC,ITC1,1,Piemonte,Piemonte,4356406,5725241,131.42,0.48
518,2021-05-22,PIE,33590,15169,18421,16926,16251,413,ITC,ITC1,1,Piemonte,Piemonte,4356406,5758831,132.19,0.77
519,2021-07-14,MOL,3442,1683,1759,211,3214,17,ITF,ITF2,14,Molise,Molise,305617,3442,1.13,1.13
520,2021-04-05,MOL,392,190,202,293,99,0,ITF,ITF2,14,Molise,Molise,305617,3834,1.25,0.13
521,2021-03-24,MOL,1657,662,995,1221,402,34,ITF,ITF2,14,Molise,Molise,305617,5491,1.8,0.54
522,2021-07-02,MOL,2711,1316,1395,137,2564,10,ITF,ITF2,14,Molise,Molise,305617,8202,2.68,0.89
523,2021-07-04,MOL,2162,1091,1071,585,1554,23,ITF,ITF2,14,Molise,Molise,305617,10364,3.39,0.71
524,2021-02-07,MOL,67,32,35,20,47,0,ITF,ITF2,14,Molise,Molise,305617,10431,3.41,0.02
525,2021-05-18,MOL,1675,893,782,1004,658,13,ITF,ITF2,14,Molise,Molise,305617,12106,3.96,0.55
526,2021-03-22,MOL,1172,450,722,897,245,30,ITF,ITF2,14,Molise,Molise,305617,13278,4.34,0.38
527,2021-07-23,MOL,2935,1527,1408,875,2000,60,ITF,ITF2,14,Molise,Molise,305617,16213,5.31,0.96
528,2021-09-04,MOL,1638,903,735,686,931,21,ITF,ITF2,14,Molise,Molise,305617,17851,5.84,0.54
529,2021-08-28,MOL,1730,963,767,647,1067,16,ITF,ITF2,14,Molise,Molise,305617,19581,6.41,0.57
530,2021-05-01,MOL,2674,1283,1391,407,2233,34,ITF,ITF2,14,Molise,Molise,305617,22255,7.28,0.87
531,2021-03-05,MOL,1232,656,576,1009,209,14,ITF,ITF2,14,Molise,Molise,305617,23487,7.69,0.4
532,2021-08-09,MOL,3443,1781,1662,1632,1760,51,ITF,ITF2,14,Molise,Molise,305617,26930,8.81,1.13
533,2021-06-13,MOL,2940,1563,1377,2565,329,46,ITF,ITF2,14,Molise,Molise,305617,29870,9.77,0.96
534,2021-04-17,MOL,3103,1528,1575,1555,1503,45,ITF,ITF2,14,Molise,Molise,305617,32973,10.79,1.02
535,2021-06-27,MOL,2389,1129,1260,1141,1237,11,ITF,ITF2,14,Molise,Molise,305617,35362,11.57,0.78
536,2021-01-07,MOL,602,210,392,602,0,0,ITF,ITF2,14,Molise,Molise,305617,35964,11.77,0.2
537,2021-02-12,MOL,337,152,185,212,124,1,ITF,ITF2,14,Molise,Molise,305617,36301,11.88,0.11
538,2021-08-23,MOL,1723,933,790,270,1440,13,ITF,ITF2,14,Molise,Molise,305617,38024,12.44,0.56
539,2021-02-19,MOL,171,95,76,169,2,0,ITF,ITF2,14,Molise,Molise,305617,38195,12.5,0.06
540,2021-03-10,MOL,1751,725,1026,1678,50,23,ITF,ITF2,14,Molise,Molise,305617,39946,13.07,0.57
541,2021-06-01,MOL,2641,1342,1299,2483,111,47,ITF,ITF2,14,Molise,Molise,305617,42587,13.93,0.86
542,2021-08-11,MOL,2024,1058,966,1144,816,64,ITF,ITF2,14,Molise,Molise,305617,44611,14.6,0.66
543,2021-01-12,MOL,337,114,223,337,0,0,ITF,ITF2,14,Molise,Molise,305617,44948,14.71,0.11
544,2021-01-26,MOL,450,184,266,8,442,0,ITF,ITF2,14,Molise,Molise,305617,45398,14.85,0.15
545,2021-05-06,MOL,2750,1244,1506,2061,611,78,ITF,ITF2,14,Molise,Molise,305617,48148,15.75,0.9
546,2021-07-28,MOL,2460,1306,1154,1152,1273,35,ITF,ITF2,14,Molise,Molise,305617,50608,16.56,0.8
547,2021-03-29,MOL,2070,846,1224,1524,489,57,ITF,ITF2,14,Molise,Molise,305617,52678,17.24,0.68
548,2021-01-31,MOL,268,70,198,6,262,0,ITF,ITF2,14,Molise,Molise,305617,52946,17.32,0.09
549,2021-09-11,MOL,1226,689,537,179,1035,12,ITF,ITF2,14,Molise,Molise,305617,54172,17.73,0.4
550,2021-07-16,MOL,3104,1571,1533,399,2675,30,ITF,ITF2,14,Molise,Molise,305617,57276,18.74,1.02
551,2021-07-09,MOL,3450,1659,1791,168,3264,18,ITF,ITF2,14,Molise,Molise,305617,60726,19.87,1.13
552,2021-01-17,MOL,78,38,40,48,30,0,ITF,ITF2,14,Molise,Molise,305617,60804,19.9,0.03
553,2021-04-10,MOL,2686,1279,1407,2467,154,65,ITF,ITF2,14,Molise,Molise,305617,63490,20.77,0.88
554,2021-02-05,MOL,598,270,328,55,543,0,ITF,ITF2,14,Molise,Molise,305617,64088,20.97,0.2
555,2021-01-19,MOL,174,63,111,163,11,0,ITF,ITF2,14,Molise,Molise,305617,64262,21.03,0.06
556,2021-04-29,MOL,2265,1162,1103,884,1355,26,ITF,ITF2,14,Molise,Molise,305617,66527,21.77,0.74
557,2021-04-12,MOL,1311,563,748,1041,252,18,ITF,ITF2,14,Molise,Molise,305617,67838,22.2,0.43
558,2021-07-21,MOL,2135,1071,1064,795,1294,46,ITF,ITF2,14,Molise,Molise,305617,69973,22.9,0.7
559,2021-05-20,MOL,2750,1417,1333,2423,190,137,ITF,ITF2,14,Molise,Molise,305617,72723,23.8,0.9
560,2021-05-25,MOL,1985,894,1091,1309,635,41,ITF,ITF2,14,Molise,Molise,305617,74708,24.44,0.65
561,2021-06-20,MOL,424,174,250,48,372,4,ITF,ITF2,14,Molise,Molise,305617,75132,24.58,0.14
562,2021-04-24,MOL,2581,1217,1364,703,1850,28,ITF,ITF2,14,Molise,Molise,305617,77713,25.43,0.84
563,2021-02-26,MOL,566,261,305,492,73,1,ITF,ITF2,14,Molise,Molise,305617,78279,25.61,0.19
564,2021-08-02,MOL,2727,1422,1305,1204,1475,48,ITF,ITF2,14,Molise,Molise,305617,81006,26.51,0.89
565,2021-06-06,MOL,2123,1092,1031,1764,328,31,ITF,ITF2,14,Molise,Molise,305617,83129,27.2,0.69
566,2021-03-19,MOL,1209,489,720,747,430,32,ITF,ITF2,14,Molise,Molise,305617,84338,27.6,0.4
567,2021-08-16,MOL,1786,926,860,829,941,16,ITF,ITF2,14,Molise,Molise,305617,86124,28.18,0.58
568,2021-03-15,MOL,854,349,505,576,245,33,ITF,ITF2,14,Molise,Molise,305617,86978,28.46,0.28
569,2021-02-24,MOL,672,281,391,326,338,8,ITF,ITF2,14,Molise,Molise,305617,87650,28.68,0.22
570,2021-09-09,MOL,1200,624,576,416,769,15,ITF,ITF2,14,Molise,Molise,305617,88850,29.07,0.39
571,2021-05-13,MOL,3111,1445,1666,2556,461,94,ITF,ITF2,14,Molise,Molise,305617,91961,30.09,1.02
572,2021-08-21,MOL,2169,1220,949,1100,1017,52,ITF,ITF2,14,Molise,Molise,305617,94130,30.8,0.71
573,2021-08-04,MOL,2526,1308,1218,964,1543,19,ITF,ITF2,14,Molise,Molise,305617,96656,31.63,0.83
574,2021-03-17,MOL,977,407,570,526,333,118,ITF,ITF2,14,Molise,Molise,305617,97633,31.95,0.32
575,2021-06-25,MOL,3461,1704,1757,1479,1921,61,ITF,ITF2,14,Molise,Molise,305617,101094,33.08,1.13
576,2021-06-08,MOL,2906,1603,1303,2202,701,3,ITF,ITF2,14,Molise,Molise,305617,104000,34.03,0.95
577,2021-03-31,MOL,2271,938,1333,1321,820,130,ITF,ITF2,14,Molise,Molise,305617,106271,34.77,0.74
578,2021-03-07,MOL,1133,501,632,1128,2,3,ITF,ITF2,14,Molise,Molise,305617,107404,35.14,0.37
579,2021-06-15,MOL,2255,1062,1193,778,1459,18,ITF,ITF2,14,Molise,Molise,305617,109659,35.88,0.74
580,2021-01-04,MOL,315,132,183,315,0,0,ITF,ITF2,14,Molise,Molise,305617,109974,35.98,0.1
581,2021-04-14,MOL,1827,775,1052,1139,669,19,ITF,ITF2,14,Molise,Molise,305617,111801,36.58,0.6
582,2021-02-16,MOL,159,73,86,152,6,1,ITF,ITF2,14,Molise,Molise,305617,111960,36.63,0.05
583,2021-05-27,MOL,2870,1367,1503,1984,844,42,ITF,ITF2,14,Molise,Molise,305617,114830,37.57,0.94
584,2021-07-25,MOL,2024,1067,957,357,1651,16,ITF,ITF2,14,Molise,Molise,305617,116854,38.24,0.66
585,2021-05-29,MOL,2387,1242,1145,1948,394,45,ITF,ITF2,14,Molise,Molise,305617,119241,39.02,0.78
586,2021-09-06,MOL,1187,628,559,355,826,6,ITF,ITF2,14,Molise,Molise,305617,120428,39.4,0.39
587,2021-08-30,MOL,1693,911,782,228,1446,19,ITF,ITF2,14,Molise,Molise,305617,122121,39.96,0.55
588,2021-06-24,MOL,3361,1564,1797,442,2881,38,ITF,ITF2,14,Molise,Molise,305617,125482,41.06,1.1
589,2021-03-02,MOL,674,387,287,508,159,7,ITF,ITF2,14,Molise,Molise,305617,126156,41.28,0.22
590,2021-06-10,MOL,2631,1211,1420,1282,1301,48,ITF,ITF2,14,Molise,Molise,305617,128787,42.14,0.86
591,2021-04-02,MOL,1487,727,760,669,784,34,ITF,ITF2,14,Molise,Molise,305617,130274,42.63,0.49
592,2021-01-21,MOL,6,2,4,6,0,0,ITF,ITF2,14,Molise,Molise,305617,130280,42.63,0.0
593,2021-08-20,MOL,2460,1295,1165,505,1935,20,ITF,ITF2,14,Molise,Molise,305617,132740,43.43,0.8
594,2021-01-28,MOL,617,218,399,19,598,0,ITF,ITF2,14,Molise,Molise,305617,133357,43.64,0.2
595,2021-03-12,MOL,1470,641,829,1410,36,24,ITF,ITF2,14,Molise,Molise,305617,134827,44.12,0.48
596,2021-01-14,MOL,652,240,412,652,0,0,ITF,ITF2,14,Molise,Molise,305617,135479,44.33,0.21
597,2021-02-23,MOL,586,223,363,362,221,3,ITF,ITF2,14,Molise,Molise,305617,136065,44.52,0.19
598,2021-06-03,MOL,3335,1589,1746,2726,560,49,ITF,ITF2,14,Molise,Molise,305617,139400,45.61,1.09
599,2021-04-07,MOL,1740,882,858,1376,276,88,ITF,ITF2,14,Molise,Molise,305617,141140,46.18,0.57
600,2021-06-05,MOL,3044,1537,1507,2827,177,40,ITF,ITF2,14,Molise,Molise,305617,144184,47.18,1.0
601,2021-09-13,MOL,408,228,180,123,279,6,ITF,ITF2,14,Molise,Molise,305617,144592,47.31,0.13
602,2021-07-18,MOL,1779,895,884,126,1643,10,ITF,ITF2,14,Molise,Molise,305617,146371,47.89,0.58
603,2021-04-28,MOL,1724,944,780,491,1221,12,ITF,ITF2,14,Molise,Molise,305617,148095,48.46,0.56
604,2021-08-06,MOL,2338,1236,1102,1088,1207,43,ITF,ITF2,14,Molise,Molise,305617,150433,49.22,0.77
605,2021-02-21,MOL,577,228,349,575,2,0,ITF,ITF2,14,Molise,Molise,305617,151010,49.41,0.19
606,2021-02-04,MOL,762,296,466,78,684,0,ITF,ITF2,14,Molise,Molise,305617,151772,49.66,0.25
607,2021-05-15,MOL,3038,1428,1610,2559,390,89,ITF,ITF2,14,Molise,Molise,305617,154810,50.65,0.99
608,2021-02-02,MOL,540,176,364,216,323,1,ITF,ITF2,14,Molise,Molise,305617,155350,50.83,0.18
609,2021-01-16,MOL,426,169,257,426,0,0,ITF,ITF2,14,Molise,Molise,305617,155776,50.97,0.14
610,2021-04-26,MOL,1174,528,646,816,332,26,ITF,ITF2,14,Molise,Molise,305617,156950,51.36,0.38
611,2021-04-09,MOL,2369,1272,1097,2118,192,59,ITF,ITF2,14,Molise,Molise,305617,159319,52.13,0.78
612,2021-09-01,MOL,1848,976,872,395,1433,20,ITF,ITF2,14,Molise,Molise,305617,161167,52.73,0.6
613,2021-01-09,MOL,457,154,303,457,0,0,ITF,ITF2,14,Molise,Molise,305617,161624,52.88,0.15
614,2021-04-19,MOL,1900,864,1036,992,784,124,ITF,ITF2,14,Molise,Molise,305617,163524,53.51,0.62
615,2021-07-11,MOL,2465,1200,1265,181,2280,4,ITF,ITF2,14,Molise,Molise,305617,165989,54.31,0.81
616,2021-08-13,MOL,1538,801,737,1122,384,32,ITF,ITF2,14,Molise,Molise,305617,167527,54.82,0.5
617,2021-05-08,MOL,3041,1479,1562,1719,1259,63,ITF,ITF2,14,Molise,Molise,305617,170568,55.81,1.0
618,2021-04-21,MOL,1892,798,1094,971,910,11,ITF,ITF2,14,Molise,Molise,305617,172460,56.43,0.62
619,2021-07-30,MOL,2700,1399,1301,1443,1196,61,ITF,ITF2,14,Molise,Molise,305617,175160,57.31,0.88
620,2021-02-11,MOL,297,133,164,260,37,0,ITF,ITF2,14,Molise,Molise,305617,175457,57.41,0.1
621,2021-05-22,MOL,2313,1198,1115,2198,91,24,ITF,ITF2,14,Molise,Molise,305617,177770,58.17,0.76
622,2021-02-09,MOL,361,171,190,198,163,0,ITF,ITF2,14,Molise,Molise,305617,178131,58.29,0.12
623,2021-08-01,MOL,966,530,436,759,175,32,ITF,ITF2,14,Molise,Molise,305617,179097,58.6,0.32
624,2021-06-17,MOL,2326,1026,1300,922,1373,31,ITF,ITF2,14,Molise,Molise,305617,181423,59.36,0.76
625,2021-09-08,MOL,974,515,459,251,719,4,ITF,ITF2,14,Molise,Molise,305617,182397,59.68,0.32
626,2021-03-26,MOL,2638,1062,1576,1907,646,85,ITF,ITF2,14,Molise,Molise,305617,185035,60.54,0.86
627,2021-02-18,MOL,324,74,250,307,13,4,ITF,ITF2,14,Molise,Molise,305617,185359,60.65,0.11
628,2021-05-26,MOL,1646,751,895,828,771,47,ITF,ITF2,14,Molise,Molise,305617,187005,61.19,0.54
629,2021-03-30,MOL,2034,873,1161,1485,514,35,ITF,ITF2,14,Molise,Molise,305617,189039,61.85,0.67
630,2021-09-03,MOL,1682,877,805,357,1302,23,ITF,ITF2,14,Molise,Molise,305617,190721,62.41,0.55
631,2021-02-01,MOL,563,201,362,14,549,0,ITF,ITF2,14,Molise,Molise,305617,191284,62.59,0.18
632,2021-07-08,MOL,3448,1661,1787,108,3317,23,ITF,ITF2,14,Molise,Molise,305617,194732,63.72,1.13
633,2021-05-12,MOL,2926,1328,1598,2716,100,110,ITF,ITF2,14,Molise,Molise,305617,197658,64.68,0.96
634,2021-03-04,MOL,858,422,436,517,325,16,ITF,ITF2,14,Molise,Molise,305617,198516,64.96,0.28
635,2021-06-12,MOL,5963,3066,2897,5668,203,92,ITF,ITF2,14,Molise,Molise,305617,204479,66.91,1.95
636,2021-08-17,MOL,1668,878,790,341,1310,17,ITF,ITF2,14,Molise,Molise,305617,206147,67.45,0.55
637,2021-01-18,MOL,117,48,69,117,0,0,ITF,ITF2,14,Molise,Molise,305617,206264,67.49,0.04
638,2021-04-11,MOL,1220,603,617,1175,14,31,ITF,ITF2,14,Molise,Molise,305617,207484,67.89,0.4
639,2021-07-20,MOL,2199,1110,1089,1029,1120,50,ITF,ITF2,14,Molise,Molise,305617,209683,68.61,0.72
640,2021-07-03,MOL,2766,1392,1374,580,2164,22,ITF,ITF2,14,Molise,Molise,305617,212449,69.51,0.91
641,2021-08-08,MOL,893,467,426,648,229,16,ITF,ITF2,14,Molise,Molise,305617,213342,69.81,0.29
642,2021-07-22,MOL,2268,1125,1143,846,1362,60,ITF,ITF2,14,Molise,Molise,305617,215610,70.55,0.74
643,2021-07-13,MOL,2831,1436,1395,323,2490,18,ITF,ITF2,14,Molise,Molise,305617,218441,71.48,0.93
644,2021-02-28,MOL,839,337,502,794,43,2,ITF,ITF2,14,Molise,Molise,305617,219280,71.75,0.27
645,2021-02-27,MOL,1375,572,803,1349,20,6,ITF,ITF2,14,Molise,Molise,305617,220655,72.2,0.45
646,2021-06-07,MOL,1989,875,1114,1138,824,27,ITF,ITF2,14,Molise,Molise,305617,222644,72.85,0.65
647,2021-09-15,MOL,287,146,141,121,158,8,ITF,ITF2,14,Molise,Molise,305617,222931,72.94,0.09
648,2021-02-13,MOL,132,80,52,132,0,0,ITF,ITF2,14,Molise,Molise,305617,223063,72.99,0.04
649,2021-08-29,MOL,1432,781,651,111,1312,9,ITF,ITF2,14,Molise,Molise,305617,224495,73.46,0.47
650,2021-05-24,MOL,1991,866,1125,1282,676,33,ITF,ITF2,14,Molise,Molise,305617,226486,74.11,0.65
651,2021-05-07,MOL,2697,1257,1440,2031,602,64,ITF,ITF2,14,Molise,Molise,305617,229183,74.99,0.88
652,2021-03-16,MOL,618,230,388,266,348,4,ITF,ITF2,14,Molise,Molise,305617,229801,75.19,0.2
653,2021-01-11,MOL,562,194,368,562,0,0,ITF,ITF2,14,Molise,Molise,305617,230363,75.38,0.18
654,2021-07-29,MOL,2475,1271,1204,1601,822,52,ITF,ITF2,14,Molise,Molise,305617,232838,76.19,0.81
655,2021-03-09,MOL,1342,585,757,1155,154,33,ITF,ITF2,14,Molise,Molise,305617,234180,76.63,0.44
656,2021-02-20,MOL,1022,444,578,1002,20,0,ITF,ITF2,14,Molise,Molise,305617,235202,76.96,0.33
657,2021-05-31,MOL,2391,1164,1227,1915,428,48,ITF,ITF2,14,Molise,Molise,305617,237593,77.74,0.78
658,2021-05-14,MOL,2691,1242,1449,1901,724,66,ITF,ITF2,14,Molise,Molise,305617,240284,78.62,0.88
659,2021-08-22,MOL,389,202,187,3,386,0,ITF,ITF2,14,Molise,Molise,305617,240673,78.75,0.13
660,2021-06-02,MOL,2863,1376,1487,2728,100,35,ITF,ITF2,14,Molise,Molise,305617,243536,79.69,0.94
661,2021-09-10,MOL,1004,528,476,384,606,14,ITF,ITF2,14,Molise,Molise,305617,244540,80.02,0.33
662,2021-08-03,MOL,2218,1154,1064,1226,956,36,ITF,ITF2,14,Molise,Molise,305617,246758,80.74,0.73
663,2021-03-11,MOL,1477,641,836,1454,6,17,ITF,ITF2,14,Molise,Molise,305617,248235,81.22,0.48
664,2021-01-06,MOL,695,263,432,695,0,0,ITF,ITF2,14,Molise,Molise,305617,248930,81.45,0.23
665,2021-04-16,MOL,2464,1049,1415,1187,1238,39,ITF,ITF2,14,Molise,Molise,305617,251394,82.26,0.81
666,2021-04-06,MOL,1528,714,814,1142,346,40,ITF,ITF2,14,Molise,Molise,305617,252922,82.76,0.5
667,2021-02-08,MOL,336,141,195,216,120,0,ITF,ITF2,14,Molise,Molise,305617,253258,82.87,0.11
668,2021-07-15,MOL,3229,1624,1605,214,3000,15,ITF,ITF2,14,Molise,Molise,305617,256487,83.92,1.06
669,2021-05-19,MOL,2405,1228,1177,1908,431,66,ITF,ITF2,14,Molise,Molise,305617,258892,84.71,0.79
670,2021-03-23,MOL,1686,711,975,1428,211,47,ITF,ITF2,14,Molise,Molise,305617,260578,85.26,0.55
671,2021-08-27,MOL,2118,1090,1028,414,1682,22,ITF,ITF2,14,Molise,Molise,305617,262696,85.96,0.69
672,2021-07-01,MOL,2683,1306,1377,275,2391,17,ITF,ITF2,14,Molise,Molise,305617,265379,86.83,0.88
673,2021-07-26,MOL,2456,1265,1191,1264,1125,67,ITF,ITF2,14,Molise,Molise,305617,267835,87.64,0.8
674,2021-02-15,MOL,145,70,75,142,3,0,ITF,ITF2,14,Molise,Molise,305617,267980,87.68,0.05
675,2021-06-14,MOL,1653,822,831,549,1087,17,ITF,ITF2,14,Molise,Molise,305617,269633,88.23,0.54
676,2021-01-20,MOL,18,8,10,18,0,0,ITF,ITF2,14,Molise,Molise,305617,269651,88.23,0.01
677,2021-04-30,MOL,2970,1575,1395,825,2122,23,ITF,ITF2,14,Molise,Molise,305617,272621,89.2,0.97
678,2021-02-25,MOL,543,239,304,471,69,3,ITF,ITF2,14,Molise,Molise,305617,273164,89.38,0.18
679,2021-08-10,MOL,1927,1047,880,688,1207,32,ITF,ITF2,14,Molise,Molise,305617,275091,90.01,0.63
680,2021-08-12,MOL,1465,761,704,1026,400,39,ITF,ITF2,14,Molise,Molise,305617,276556,90.49,0.48
681,2021-01-29,MOL,425,137,288,6,419,0,ITF,ITF2,14,Molise,Molise,305617,276981,90.63,0.14
682,2021-05-09,MOL,2083,951,1132,1938,98,47,ITF,ITF2,14,Molise,Molise,305617,279064,91.31,0.68
683,2021-04-18,MOL,1092,486,606,143,939,10,ITF,ITF2,14,Molise,Molise,305617,280156,91.67,0.36
684,2021-07-27,MOL,1961,1084,877,1336,555,70,ITF,ITF2,14,Molise,Molise,305617,282117,92.31,0.64
685,2021-07-10,MOL,3744,1789,1955,326,3404,14,ITF,ITF2,14,Molise,Molise,305617,285861,93.54,1.23
686,2021-04-04,MOL,258,142,116,231,15,12,ITF,ITF2,14,Molise,Molise,305617,286119,93.62,0.08
687,2021-03-18,MOL,1220,495,725,637,465,118,ITF,ITF2,14,Molise,Molise,305617,287339,94.02,0.4
688,2021-06-26,MOL,3141,1545,1596,530,2596,15,ITF,ITF2,14,Molise,Molise,305617,290480,95.05,1.03
689,2021-01-25,MOL,319,130,189,3,316,0,ITF,ITF2,14,Molise,Molise,305617,290799,95.15,0.1
690,2021-05-05,MOL,2498,1070,1428,2306,145,47,ITF,ITF2,14,Molise,Molise,305617,293297,95.97,0.82
691,2021-05-04,MOL,2753,1200,1553,2562,132,59,ITF,ITF2,14,Molise,Molise,305617,296050,96.87,0.9
692,2021-01-10,MOL,270,72,198,270,0,0,ITF,ITF2,14,Molise,Molise,305617,296320,96.96,0.09
693,2021-04-20,MOL,2342,1038,1304,1215,1112,15,ITF,ITF2,14,Molise,Molise,305617,298662,97.72,0.77
694,2021-06-09,MOL,1838,925,913,872,935,31,ITF,ITF2,14,Molise,Molise,305617,300500,98.33,0.6
695,2021-05-23,MOL,1796,904,892,1752,10,34,ITF,ITF2,14,Molise,Molise,305617,302296,98.91,0.59
696,2021-08-31,MOL,1745,954,791,313,1422,10,ITF,ITF2,14,Molise,Molise,305617,304041,99.48,0.57
697,2021-03-25,MOL,1837,741,1096,1291,498,48,ITF,ITF2,14,Molise,Molise,305617,305878,100.09,0.6
698,2021-03-08,MOL,1401,529,872,1216,140,45,ITF,ITF2,14,Molise,Molise,305617,307279,100.54,0.46
699,2021-06-16,MOL,2135,1054,1081,1169,946,20,ITF,ITF2,14,Molise,Molise,305617,309414,101.24,0.7
700,2021-04-13,MOL,1643,722,921,1040,589,14,ITF,ITF2,14,Molise,Molise,305617,311057,101.78,0.54
701,2021-03-27,MOL,2766,1284,1482,1303,1434,29,ITF,ITF2,14,Molise,Molise,305617,313823,102.69,0.91
702,2021-07-05,MOL,2748,1288,1460,42,2704,2,ITF,ITF2,14,Molise,Molise,305617,316571,103.58,0.9
703,2021-09-14,MOL,535,290,245,167,363,5,ITF,ITF2,14,Molise,Molise,305617,317106,103.76,0.18
704,2021-02-22,MOL,267,129,138,250,15,2,ITF,ITF2,14,Molise,Molise,305617,317373,103.85,0.09
705,2020-12-27,MOL,50,20,30,50,0,0,ITF,ITF2,14,Molise,Molise,305617,317423,103.86,0.02
706,2021-07-07,MOL,2969,1374,1595,58,2907,4,ITF,ITF2,14,Molise,Molise,305617,320392,104.83,0.97
707,2021-05-11,MOL,3277,1447,1830,2927,254,96,ITF,ITF2,14,Molise,Molise,305617,323669,105.91,1.07
708,2021-08-19,MOL,2284,1147,1137,609,1648,27,ITF,ITF2,14,Molise,Molise,305617,325953,106.65,0.75
709,2021-01-22,MOL,128,36,92,128,0,0,ITF,ITF2,14,Molise,Molise,305617,326081,106.7,0.04
710,2021-05-02,MOL,1922,950,972,584,1318,20,ITF,ITF2,14,Molise,Molise,305617,328003,107.32,0.63
711,2021-06-18,MOL,2794,1264,1530,1303,1462,29,ITF,ITF2,14,Molise,Molise,305617,330797,108.24,0.91
712,2021-05-30,MOL,1890,947,943,1567,287,36,ITF,ITF2,14,Molise,Molise,305617,332687,108.86,0.62
713,2021-09-07,MOL,921,498,423,346,563,12,ITF,ITF2,14,Molise,Molise,305617,333608,109.16,0.3
714,2021-07-19,MOL,2818,1378,1440,519,2268,31,ITF,ITF2,14,Molise,Molise,305617,336426,110.08,0.92
715,2021-02-03,MOL,748,255,493,347,401,0,ITF,ITF2,14,Molise,Molise,305617,337174,110.33,0.24
716,2021-04-27,MOL,1628,782,846,447,1138,43,ITF,ITF2,14,Molise,Molise,305617,338802,110.86,0.53
717,2021-08-05,MOL,2297,1159,1138,1621,625,51,ITF,ITF2,14,Molise,Molise,305617,341099,111.61,0.75
718,2021-05-16,MOL,1285,585,700,1065,185,35,ITF,ITF2,14,Molise,Molise,305617,342384,112.03,0.42
719,2021-08-24,MOL,1711,925,786,261,1425,25,ITF,ITF2,14,Molise,Molise,305617,344095,112.59,0.56
720,2021-08-07,MOL,1940,1073,867,1060,852,28,ITF,ITF2,14,Molise,Molise,305617,346035,113.23,0.63
721,2021-02-10,MOL,152,80,72,132,20,0,ITF,ITF2,14,Molise,Molise,305617,346187,113.27,0.05
722,2021-05-21,MOL,2293,1158,1135,1812,330,151,ITF,ITF2,14,Molise,Molise,305617,348480,114.03,0.75
723,2021-01-27,MOL,675,251,424,8,667,0,ITF,ITF2,14,Molise,Molise,305617,349155,114.25,0.22
724,2021-08-14,MOL,1622,875,747,705,896,21,ITF,ITF2,14,Molise,Molise,305617,350777,114.78,0.53
725,2021-03-01,MOL,668,275,393,433,215,20,ITF,ITF2,14,Molise,Molise,305617,351445,115.0,0.22
726,2021-04-03,MOL,1804,867,937,1728,37,39,ITF,ITF2,14,Molise,Molise,305617,353249,115.59,0.59
727,2021-07-12,MOL,2695,1332,1363,362,2312,21,ITF,ITF2,14,Molise,Molise,305617,355944,116.47,0.88
728,2021-03-06,MOL,1730,809,921,1559,160,11,ITF,ITF2,14,Molise,Molise,305617,357674,117.03,0.57
729,2021-06-21,MOL,2941,1366,1575,1654,1239,48,ITF,ITF2,14,Molise,Molise,305617,360615,118.0,0.96
730,2021-04-25,MOL,800,401,399,559,233,8,ITF,ITF2,14,Molise,Molise,305617,361415,118.26,0.26
731,2021-01-13,MOL,481,163,318,481,0,0,ITF,ITF2,14,Molise,Molise,305617,361896,118.41,0.16
732,2021-06-19,MOL,2375,1178,1197,1303,1026,46,ITF,ITF2,14,Molise,Molise,305617,364271,119.19,0.78
733,2021-04-23,MOL,2084,903,1181,1382,671,31,ITF,ITF2,14,Molise,Molise,305617,366355,119.87,0.68
734,2021-01-08,MOL,433,142,291,433,0,0,ITF,ITF2,14,Molise,Molise,305617,366788,120.02,0.14
735,2021-09-02,MOL,1527,790,737,306,1195,26,ITF,ITF2,14,Molise,Molise,305617,368315,120.52,0.5
736,2021-04-01,MOL,1499,677,822,742,730,27,ITF,ITF2,14,Molise,Molise,305617,369814,121.01,0.49
737,2021-08-26,MOL,1725,935,790,307,1411,7,ITF,ITF2,14,Molise,Molise,305617,371539,121.57,0.56
738,2021-06-30,MOL,2987,1419,1568,880,2023,84,ITF,ITF2,14,Molise,Molise,305617,374526,122.55,0.98
739,2021-03-13,MOL,1194,598,596,184,991,19,ITF,ITF2,14,Molise,Molise,305617,375720,122.94,0.39
740,2021-01-15,MOL,548,245,303,548,0,0,ITF,ITF2,14,Molise,Molise,305617,376268,123.12,0.18
741,2021-06-23,MOL,2817,1298,1519,223,2584,10,ITF,ITF2,14,Molise,Molise,305617,379085,124.04,0.92
742,2021-03-20,MOL,2352,986,1366,1011,1323,18,ITF,ITF2,14,Molise,Molise,305617,381437,124.81,0.77
743,2021-06-28,MOL,2935,1368,1567,1015,1896,24,ITF,ITF2,14,Molise,Molise,305617,384372,125.77,0.96
744,2021-03-03,MOL,677,320,357,588,83,6,ITF,ITF2,14,Molise,Molise,305617,385049,125.99,0.22
745,2021-01-05,MOL,451,180,271,451,0,0,ITF,ITF2,14,Molise,Molise,305617,385500,126.14,0.15
746,2021-07-06,MOL,3072,1433,1639,38,3029,5,ITF,ITF2,14,Molise,Molise,305617,388572,127.14,1.01
747,2021-05-10,MOL,2958,1308,1650,2516,376,66,ITF,ITF2,14,Molise,Molise,305617,391530,128.11,0.97
748,2021-06-29,MOL,2510,1168,1342,386,2093,31,ITF,ITF2,14,Molise,Molise,305617,394040,128.93,0.82
749,2021-05-03,MOL,2554,1213,1341,2319,164,71,ITF,ITF2,14,Molise,Molise,305617,396594,129.77,0.84
750,2021-05-17,MOL,2266,1108,1158,1718,498,50,ITF,ITF2,14,Molise,Molise,305617,398860,130.51,0.74
751,2021-03-21,MOL,1254,546,708,481,770,3,ITF,ITF2,14,Molise,Molise,305617,400114,130.92,0.41
752,2021-08-25,MOL,1504,809,695,342,1152,10,ITF,ITF2,14,Molise,Molise,305617,401618,131.41,0.49
753,2021-03-14,MOL,601,242,359,18,583,0,ITF,ITF2,14,Molise,Molise,305617,402219,131.61,0.2
754,2021-08-18,MOL,1347,706,641,344,981,22,ITF,ITF2,14,Molise,Molise,305617,403566,132.05,0.44
755,2021-06-22,MOL,2984,1378,1606,676,2288,20,ITF,ITF2,14,Molise,Molise,305617,406550,133.03,0.98
756,2021-03-28,MOL,1640,757,883,523,1103,14,ITF,ITF2,14,Molise,Molise,305617,408190,133.56,0.54
757,2021-01-30,MOL,465,161,304,12,453,0,ITF,ITF2,14,Molise,Molise,305617,408655,133.71,0.15
758,2021-09-05,MOL,7,6,1,7,0,0,ITF,ITF2,14,Molise,Molise,305617,408662,133.72,0.0
759,2021-02-06,MOL,431,179,252,30,401,0,ITF,ITF2,14,Molise,Molise,305617,409093,133.86,0.14
760,2021-06-04,MOL,3116,1533,1583,2614,459,43,ITF,ITF2,14,Molise,Molise,305617,412209,134.88,1.02
761,2021-04-08,MOL,1806,928,878,1555,203,48,ITF,ITF2,14,Molise,Molise,305617,414015,135.47,0.59
762,2021-09-12,MOL,389,211,178,343,33,13,ITF,ITF2,14,Molise,Molise,305617,414404,135.6,0.13
763,2021-07-17,MOL,2878,1533,1345,303,2552,23,ITF,ITF2,14,Molise,Molise,305617,417282,136.54,0.94
764,2021-04-22,MOL,1861,871,990,1062,781,18,ITF,ITF2,14,Molise,Molise,305617,419143,137.15,0.61
765,2021-07-31,MOL,2012,1122,890,764,1202,46,ITF,ITF2,14,Molise,Molise,305617,421155,137.8,0.66
766,2021-02-17,MOL,72,32,40,50,15,7,ITF,ITF2,14,Molise,Molise,305617,421227,137.83,0.02
767,2021-07-24,MOL,3159,1698,1461,738,2391,30,ITF,ITF2,14,Molise,Molise,305617,424386,138.86,1.03
768,2021-05-28,MOL,2684,1377,1307,2062,549,73,ITF,ITF2,14,Molise,Molise,305617,427070,139.74,0.88
769,2021-06-11,MOL,3490,1679,1811,1997,1440,53,ITF,ITF2,14,Molise,Molise,305617,430560,140.88,1.14
770,2021-04-15,MOL,1956,805,1151,1096,851,9,ITF,ITF2,14,Molise,Molise,305617,432516,141.52,0.64
771,2021-09-15,CAM,7624,3706,3918,2775,4486,363,ITF,ITF3,15,Campania,Campania,5801692,7624,0.13,0.13
772,2021-06-07,CAM,57604,27731,29873,52527,4053,1024,ITF,ITF3,15,Campania,Campania,5801692,65228,1.12,0.99
773,2021-02-25,CAM,12444,4487,7957,10938,1208,298,ITF,ITF3,15,Campania,Campania,5801692,77672,1.34,0.21
774,2021-04-09,CAM,29954,14086,15868,23155,6139,660,ITF,ITF3,15,Campania,Campania,5801692,107626,1.86,0.52
775,2021-06-05,CAM,77651,37595,40056,70561,6039,1051,ITF,ITF3,15,Campania,Campania,5801692,185277,3.19,1.34
776,2021-03-28,CAM,15565,7510,8055,13562,1625,378,ITF,ITF3,15,Campania,Campania,5801692,200842,3.46,0.27
777,2021-01-04,CAM,5828,2962,2866,5727,0,101,ITF,ITF3,15,Campania,Campania,5801692,206670,3.56,0.1
778,2021-09-10,CAM,18457,9431,9026,8307,9261,889,ITF,ITF3,15,Campania,Campania,5801692,225127,3.88,0.32
779,2021-06-19,CAM,62408,29712,32696,24074,37769,565,ITF,ITF3,15,Campania,Campania,5801692,287535,4.96,1.08
780,2021-08-03,CAM,31997,16222,15775,14465,16656,876,ITF,ITF3,15,Campania,Campania,5801692,319532,5.51,0.55
781,2021-02-11,CAM,6294,2717,3577,5913,77,304,ITF,ITF3,15,Campania,Campania,5801692,325826,5.62,0.11
782,2021-01-30,CAM,10733,5083,5650,43,10688,2,ITF,ITF3,15,Campania,Campania,5801692,336559,5.8,0.18
783,2021-07-03,CAM,67283,32498,34785,8127,58714,442,ITF,ITF3,15,Campania,Campania,5801692,403842,6.96,1.16
784,2021-08-29,CAM,10260,5574,4686,3714,6277,269,ITF,ITF3,15,Campania,Campania,5801692,414102,7.14,0.18
785,2021-01-16,CAM,3372,1677,1695,3261,0,111,ITF,ITF3,15,Campania,Campania,5801692,417474,7.2,0.06
786,2021-05-24,CAM,31363,15157,16206,15853,15159,351,ITF,ITF3,15,Campania,Campania,5801692,448837,7.74,0.54
787,2021-02-13,CAM,5508,2549,2959,5106,217,185,ITF,ITF3,15,Campania,Campania,5801692,454345,7.83,0.09
788,2021-08-01,CAM,16085,8415,7670,6884,8834,367,ITF,ITF3,15,Campania,Campania,5801692,470430,8.11,0.28
789,2021-04-23,CAM,32360,15538,16822,22421,9161,778,ITF,ITF3,15,Campania,Campania,5801692,502790,8.67,0.56
790,2021-08-15,CAM,1122,639,483,215,899,8,ITF,ITF3,15,Campania,Campania,5801692,503912,8.69,0.02
791,2021-04-11,CAM,17529,8610,8919,15028,2089,412,ITF,ITF3,15,Campania,Campania,5801692,521441,8.99,0.3
792,2021-04-28,CAM,36425,17631,18794,25822,9762,841,ITF,ITF3,15,Campania,Campania,5801692,557866,9.62,0.63
793,2021-01-18,CAM,959,399,560,683,244,32,ITF,ITF3,15,Campania,Campania,5801692,558825,9.63,0.02
794,2021-07-20,CAM,40105,19783,20322,6131,33335,639,ITF,ITF3,15,Campania,Campania,5801692,598930,10.32,0.69
795,2021-06-24,CAM,66122,31869,34253,13281,52311,530,ITF,ITF3,15,Campania,Campania,5801692,665052,11.46,1.14
796,2021-03-16,CAM,8090,3519,4571,3695,4317,78,ITF,ITF3,15,Campania,Campania,5801692,673142,11.6,0.14
797,2021-08-20,CAM,17414,9328,8086,7431,9423,560,ITF,ITF3,15,Campania,Campania,5801692,690556,11.9,0.3
798,2021-01-25,CAM,5760,2929,2831,174,5586,0,ITF,ITF3,15,Campania,Campania,5801692,696316,12.0,0.1
799,2021-07-01,CAM,61546,29873,31673,19707,41033,806,ITF,ITF3,15,Campania,Campania,5801692,757862,13.06,1.06
800,2021-03-23,CAM,15748,7449,8299,12850,2515,383,ITF,ITF3,15,Campania,Campania,5801692,773610,13.33,0.27
801,2021-08-27,CAM,24403,13015,11388,7832,15886,685,ITF,ITF3,15,Campania,Campania,5801692,798013,13.75,0.42
802,2021-03-02,CAM,12763,4561,8202,8181,4345,237,ITF,ITF3,15,Campania,Campania,5801692,810776,13.97,0.22
803,2021-07-15,CAM,66740,32059,34681,8692,57088,960,ITF,ITF3,15,Campania,Campania,5801692,877516,15.13,1.15
804,2021-06-14,CAM,37132,17921,19211,18694,18024,414,ITF,ITF3,15,Campania,Campania,5801692,914648,15.77,0.64
805,2021-08-10,CAM,21641,11192,10449,13586,6951,1104,ITF,ITF3,15,Campania,Campania,5801692,936289,16.14,0.37
806,2021-03-09,CAM,14145,6878,7267,9899,3799,447,ITF,ITF3,15,Campania,Campania,5801692,950434,16.38,0.24
807,2021-05-31,CAM,40825,20716,20109,29841,10401,583,ITF,ITF3,15,Campania,Campania,5801692,991259,17.09,0.7
808,2021-07-27,CAM,49167,24450,24717,12603,35730,834,ITF,ITF3,15,Campania,Campania,5801692,1040426,17.93,0.85
809,2021-09-08,CAM,19131,9651,9480,8697,9618,816,ITF,ITF3,15,Campania,Campania,5801692,1059557,18.26,0.33
810,2021-04-16,CAM,34452,16638,17814,23045,10670,737,ITF,ITF3,15,Campania,Campania,5801692,1094009,18.86,0.59
811,2021-01-06,CAM,7652,3751,3901,7508,0,144,ITF,ITF3,15,Campania,Campania,5801692,1101661,18.99,0.13
812,2021-02-18,CAM,9110,3833,5277,8147,727,236,ITF,ITF3,15,Campania,Campania,5801692,1110771,19.15,0.16
813,2021-08-22,CAM,6811,3877,2934,2534,4128,149,ITF,ITF3,15,Campania,Campania,5801692,1117582,19.26,0.12
814,2021-01-23,CAM,3843,2032,1811,267,3570,6,ITF,ITF3,15,Campania,Campania,5801692,1121425,19.33,0.07
815,2021-03-21,CAM,10079,4679,5400,7483,2391,205,ITF,ITF3,15,Campania,Campania,5801692,1131504,19.5,0.17
816,2021-02-10,CAM,6940,3439,3501,6484,206,250,ITF,ITF3,15,Campania,Campania,5801692,1138444,19.62,0.12
817,2021-07-17,CAM,55273,27562,27711,3352,51549,372,ITF,ITF3,15,Campania,Campania,5801692,1193717,20.58,0.95
818,2021-06-26,CAM,62953,30696,32257,14502,47863,588,ITF,ITF3,15,Campania,Campania,5801692,1256670,21.66,1.09
819,2021-07-13,CAM,53698,25798,27900,4672,48506,520,ITF,ITF3,15,Campania,Campania,5801692,1310368,22.59,0.93
820,2021-04-04,CAM,7965,4016,3949,6675,1046,244,ITF,ITF3,15,Campania,Campania,5801692,1318333,22.72,0.14
821,2021-06-12,CAM,64001,31546,32455,55595,7216,1190,ITF,ITF3,15,Campania,Campania,5801692,1382334,23.83,1.1
822,2021-03-04,CAM,14709,5395,9314,8522,5897,290,ITF,ITF3,15,Campania,Campania,5801692,1397043,24.08,0.25
823,2021-05-19,CAM,51310,22660,28650,33756,16759,795,ITF,ITF3,15,Campania,Campania,5801692,1448353,24.96,0.88
824,2021-05-05,CAM,51190,24869,26321,43149,6398,1643,ITF,ITF3,15,Campania,Campania,5801692,1499543,25.85,0.88
825,2021-05-17,CAM,49511,21756,27755,23601,25399,511,ITF,ITF3,15,Campania,Campania,5801692,1549054,26.7,0.85
826,2021-02-06,CAM,5343,2666,2677,2002,3241,100,ITF,ITF3,15,Campania,Campania,5801692,1554397,26.79,0.09
827,2021-07-22,CAM,61855,30553,31302,6485,54794,576,ITF,ITF3,15,Campania,Campania,5801692,1616252,27.86,1.07
828,2021-08-08,CAM,7574,4041,3533,4646,2666,262,ITF,ITF3,15,Campania,Campania,5801692,1623826,27.99,0.13
829,2021-04-30,CAM,42331,20199,22132,24943,16509,879,ITF,ITF3,15,Campania,Campania,5801692,1666157,28.72,0.73
830,2021-02-04,CAM,7946,3430,4516,1249,6638,59,ITF,ITF3,15,Campania,Campania,5801692,1674103,28.86,0.14
831,2021-01-11,CAM,4081,1879,2202,3970,0,111,ITF,ITF3,15,Campania,Campania,5801692,1678184,28.93,0.07
832,2021-09-03,CAM,26491,13636,12855,10801,14771,919,ITF,ITF3,15,Campania,Campania,5801692,1704675,29.38,0.46
833,2021-05-26,CAM,52747,25880,26867,21111,31160,476,ITF,ITF3,15,Campania,Campania,5801692,1757422,30.29,0.91
834,2021-02-27,CAM,13959,4472,9487,11965,1653,341,ITF,ITF3,15,Campania,Campania,5801692,1771381,30.53,0.24
835,2021-06-16,CAM,31653,15012,16641,20362,10775,516,ITF,ITF3,15,Campania,Campania,5801692,1803034,31.08,0.55
836,2021-08-12,CAM,18927,9998,8929,12400,5718,809,ITF,ITF3,15,Campania,Campania,5801692,1821961,31.4,0.33
837,2021-05-02,CAM,43495,21552,21943,31174,11377,944,ITF,ITF3,15,Campania,Campania,5801692,1865456,32.15,0.75
838,2021-01-22,CAM,1534,783,751,666,854,14,ITF,ITF3,15,Campania,Campania,5801692,1866990,32.18,0.03
839,2021-08-26,CAM,24534,12758,11776,8180,15528,826,ITF,ITF3,15,Campania,Campania,5801692,1891524,32.6,0.42
840,2021-09-12,CAM,7820,4063,3757,4683,2676,461,ITF,ITF3,15,Campania,Campania,5801692,1899344,32.74,0.13
841,2021-06-02,CAM,42946,20185,22761,37622,4732,592,ITF,ITF3,15,Campania,Campania,5801692,1942290,33.48,0.74
842,2021-02-22,CAM,10698,3298,7400,10149,279,270,ITF,ITF3,15,Campania,Campania,5801692,1952988,33.66,0.18
843,2021-03-11,CAM,18027,9076,8951,10274,7293,460,ITF,ITF3,15,Campania,Campania,5801692,1971015,33.97,0.31
844,2021-08-24,CAM,22609,11705,10904,8664,13188,757,ITF,ITF3,15,Campania,Campania,5801692,1993624,34.36,0.39
845,2021-05-16,CAM,51161,23229,27932,32760,17587,814,ITF,ITF3,15,Campania,Campania,5801692,2044785,35.24,0.88
846,2021-04-25,CAM,30745,15179,15566,24522,5408,815,ITF,ITF3,15,Campania,Campania,5801692,2075530,35.77,0.53
847,2021-01-13,CAM,8031,3676,4355,7786,0,245,ITF,ITF3,15,Campania,Campania,5801692,2083561,35.91,0.14
848,2021-07-31,CAM,30728,16215,14513,10438,19599,691,ITF,ITF3,15,Campania,Campania,5801692,2114289,36.44,0.53
849,2021-05-07,CAM,59791,29215,30576,42302,15969,1520,ITF,ITF3,15,Campania,Campania,5801692,2174080,37.47,1.03
850,2021-01-27,CAM,7755,3824,3931,168,7582,5,ITF,ITF3,15,Campania,Campania,5801692,2181835,37.61,0.13
851,2021-04-08,CAM,28523,13841,14682,22032,5848,643,ITF,ITF3,15,Campania,Campania,5801692,2210358,38.1,0.49
852,2021-06-04,CAM,74590,35845,38745,64415,9136,1039,ITF,ITF3,15,Campania,Campania,5801692,2284948,39.38,1.29
853,2021-05-21,CAM,63875,29653,34222,42140,20705,1030,ITF,ITF3,15,Campania,Campania,5801692,2348823,40.49,1.1
854,2021-04-01,CAM,24696,12024,12672,20032,4137,527,ITF,ITF3,15,Campania,Campania,5801692,2373519,40.91,0.43
855,2021-09-05,CAM,8208,4272,3936,5165,2583,460,ITF,ITF3,15,Campania,Campania,5801692,2381727,41.05,0.14
856,2021-05-28,CAM,73081,35333,37748,26267,46182,632,ITF,ITF3,15,Campania,Campania,5801692,2454808,42.31,1.26
857,2021-05-14,CAM,61045,27583,33462,34657,24738,1650,ITF,ITF3,15,Campania,Campania,5801692,2515853,43.36,1.05
858,2021-07-10,CAM,66914,32669,34245,2699,63964,251,ITF,ITF3,15,Campania,Campania,5801692,2582767,44.52,1.15
859,2021-03-06,CAM,16376,6819,9557,10364,5672,340,ITF,ITF3,15,Campania,Campania,5801692,2599143,44.8,0.28
860,2021-08-19,CAM,22020,11638,10382,9579,11774,667,ITF,ITF3,15,Campania,Campania,5801692,2621163,45.18,0.38
861,2021-01-01,CAM,919,506,413,899,0,20,ITF,ITF3,15,Campania,Campania,5801692,2622082,45.2,0.02
862,2021-03-25,CAM,20330,9658,10672,16324,3507,499,ITF,ITF3,15,Campania,Campania,5801692,2642412,45.55,0.35
863,2021-07-24,CAM,47998,24873,23125,6611,40889,498,ITF,ITF3,15,Campania,Campania,5801692,2690410,46.37,0.83
864,2021-01-20,CAM,1264,654,610,1233,0,31,ITF,ITF3,15,Campania,Campania,5801692,2691674,46.39,0.02
865,2021-04-13,CAM,26617,12690,13927,20528,5539,550,ITF,ITF3,15,Campania,Campania,5801692,2718291,46.85,0.46
866,2021-01-03,CAM,3836,2009,1827,3787,0,49,ITF,ITF3,15,Campania,Campania,5801692,2722127,46.92,0.07
867,2021-04-06,CAM,24529,11569,12960,19457,4526,546,ITF,ITF3,15,Campania,Campania,5801692,2746656,47.34,0.42
868,2021-07-12,CAM,56703,27375,29328,3701,52605,397,ITF,ITF3,15,Campania,Campania,5801692,2803359,48.32,0.98
869,2020-12-27,CAM,720,422,298,716,0,4,ITF,ITF3,15,Campania,Campania,5801692,2804079,48.33,0.01
870,2021-07-29,CAM,48510,24349,24161,13431,34140,939,ITF,ITF3,15,Campania,Campania,5801692,2852589,49.17,0.84
871,2021-04-20,CAM,32183,15557,16626,20232,11339,612,ITF,ITF3,15,Campania,Campania,5801692,2884772,49.72,0.55
872,2021-06-28,CAM,46536,22742,23794,20378,25414,744,ITF,ITF3,15,Campania,Campania,5801692,2931308,50.53,0.8
873,2021-03-20,CAM,13991,6532,7459,9972,3739,280,ITF,ITF3,15,Campania,Campania,5801692,2945299,50.77,0.24
874,2021-03-18,CAM,12180,5383,6797,5786,6193,201,ITF,ITF3,15,Campania,Campania,5801692,2957479,50.98,0.21
875,2021-04-18,CAM,27222,13287,13935,17767,8903,552,ITF,ITF3,15,Campania,Campania,5801692,2984701,51.45,0.47
876,2021-01-08,CAM,10459,4970,5489,10197,0,262,ITF,ITF3,15,Campania,Campania,5801692,2995160,51.63,0.18
877,2021-04-27,CAM,32169,15632,16537,23418,7930,821,ITF,ITF3,15,Campania,Campania,5801692,3027329,52.18,0.55
878,2021-06-23,CAM,46777,22095,24682,10577,35803,397,ITF,ITF3,15,Campania,Campania,5801692,3074106,52.99,0.81
879,2021-08-05,CAM,35175,18032,17143,17281,16832,1062,ITF,ITF3,15,Campania,Campania,5801692,3109281,53.59,0.61
880,2021-01-15,CAM,5000,2394,2606,4840,0,160,ITF,ITF3,15,Campania,Campania,5801692,3114281,53.68,0.09
881,2021-06-21,CAM,46924,22687,24237,11199,35295,430,ITF,ITF3,15,Campania,Campania,5801692,3161205,54.49,0.81
882,2021-03-13,CAM,14526,7044,7482,8945,5283,298,ITF,ITF3,15,Campania,Campania,5801692,3175731,54.74,0.25
883,2021-02-20,CAM,8573,3080,5493,8087,303,183,ITF,ITF3,15,Campania,Campania,5801692,3184304,54.89,0.15
884,2021-02-03,CAM,8910,4006,4904,843,8031,36,ITF,ITF3,15,Campania,Campania,5801692,3193214,55.04,0.15
885,2021-05-18,CAM,52278,23284,28994,31806,19730,742,ITF,ITF3,15,Campania,Campania,5801692,3245492,55.94,0.9
886,2021-08-09,CAM,25085,13084,12001,13671,10465,949,ITF,ITF3,15,Campania,Campania,5801692,3270577,56.37,0.43
887,2021-02-05,CAM,7268,3464,3804,2023,5130,115,ITF,ITF3,15,Campania,Campania,5801692,3277845,56.5,0.13
888,2021-08-07,CAM,17198,9179,8019,11203,5290,705,ITF,ITF3,15,Campania,Campania,5801692,3295043,56.79,0.3
889,2021-04-29,CAM,41555,20181,21374,23965,16748,842,ITF,ITF3,15,Campania,Campania,5801692,3336598,57.51,0.72
890,2021-01-19,CAM,1110,485,625,1055,5,50,ITF,ITF3,15,Campania,Campania,5801692,3337708,57.53,0.02
891,2021-02-24,CAM,11810,4158,7652,10807,715,288,ITF,ITF3,15,Campania,Campania,5801692,3349518,57.73,0.2
892,2021-01-05,CAM,7237,3637,3600,7074,0,163,ITF,ITF3,15,Campania,Campania,5801692,3356755,57.86,0.12
893,2021-03-08,CAM,14694,6852,7842,9432,4781,481,ITF,ITF3,15,Campania,Campania,5801692,3371449,58.11,0.25
894,2021-05-04,CAM,48482,23344,25138,38211,8907,1364,ITF,ITF3,15,Campania,Campania,5801692,3419931,58.95,0.84
895,2021-01-24,CAM,4123,2120,2003,361,3745,17,ITF,ITF3,15,Campania,Campania,5801692,3424054,59.02,0.07
896,2021-08-21,CAM,9801,5398,4403,4079,5342,380,ITF,ITF3,15,Campania,Campania,5801692,3433855,59.19,0.17
897,2021-05-13,CAM,55457,24834,30623,37698,16025,1734,ITF,ITF3,15,Campania,Campania,5801692,3489312,60.14,0.96
898,2021-07-09,CAM,61510,29781,31729,4306,56844,360,ITF,ITF3,15,Campania,Campania,5801692,3550822,61.2,1.06
899,2021-07-05,CAM,63324,30528,32796,12623,49899,802,ITF,ITF3,15,Campania,Campania,5801692,3614146,62.29,1.09
900,2021-09-09,CAM,18396,9413,8983,8213,9374,809,ITF,ITF3,15,Campania,Campania,5801692,3632542,62.61,0.32
901,2021-08-31,CAM,27774,13966,13808,10820,15976,978,ITF,ITF3,15,Campania,Campania,5801692,3660316,63.09,0.48
902,2021-02-15,CAM,5472,2516,2956,5149,175,148,ITF,ITF3,15,Campania,Campania,5801692,3665788,63.18,0.09
903,2021-06-09,CAM,53065,26052,27013,41410,10917,738,ITF,ITF3,15,Campania,Campania,5801692,3718853,64.1,0.91
904,2021-03-01,CAM,12134,4249,7885,7739,4113,282,ITF,ITF3,15,Campania,Campania,5801692,3730987,64.31,0.21
905,2021-08-17,CAM,22281,12044,10237,7294,14442,545,ITF,ITF3,15,Campania,Campania,5801692,3753268,64.69,0.38
906,2021-05-09,CAM,43215,20293,22922,30869,11107,1239,ITF,ITF3,15,Campania,Campania,5801692,3796483,65.44,0.74
907,2021-01-10,CAM,8165,3736,4429,7963,0,202,ITF,ITF3,15,Campania,Campania,5801692,3804648,65.58,0.14
908,2021-04-03,CAM,21120,10316,10804,18230,2383,507,ITF,ITF3,15,Campania,Campania,5801692,3825768,65.94,0.36
909,2021-08-16,CAM,12466,6694,5772,6211,5724,531,ITF,ITF3,15,Campania,Campania,5801692,3838234,66.16,0.21
910,2021-07-14,CAM,51120,24586,26534,4255,46502,363,ITF,ITF3,15,Campania,Campania,5801692,3889354,67.04,0.88
911,2021-04-05,CAM,11641,5541,6100,8894,2424,323,ITF,ITF3,15,Campania,Campania,5801692,3900995,67.24,0.2
912,2021-03-17,CAM,11598,5102,6496,4846,6591,161,ITF,ITF3,15,Campania,Campania,5801692,3912593,67.44,0.2
913,2021-06-11,CAM,70847,34426,36421,63453,6058,1336,ITF,ITF3,15,Campania,Campania,5801692,3983440,68.66,1.22
914,2021-03-03,CAM,13924,5496,8428,7065,6632,227,ITF,ITF3,15,Campania,Campania,5801692,3997364,68.9,0.24
915,2021-06-25,CAM,65519,31805,33714,13604,51347,568,ITF,ITF3,15,Campania,Campania,5801692,4062883,70.03,1.13
916,2021-09-02,CAM,25520,13187,12333,10162,14454,904,ITF,ITF3,15,Campania,Campania,5801692,4088403,70.47,0.44
917,2021-05-25,CAM,46576,22432,24144,22550,23459,567,ITF,ITF3,15,Campania,Campania,5801692,4134979,71.27,0.8
918,2021-04-22,CAM,34121,16637,17484,20877,12546,698,ITF,ITF3,15,Campania,Campania,5801692,4169100,71.86,0.59
919,2021-07-07,CAM,52316,24824,27492,7106,44645,565,ITF,ITF3,15,Campania,Campania,5801692,4221416,72.76,0.9
920,2021-03-29,CAM,19412,9580,9832,17415,1551,446,ITF,ITF3,15,Campania,Campania,5801692,4240828,73.1,0.33
921,2021-06-20,CAM,47615,22749,24866,14190,32997,428,ITF,ITF3,15,Campania,Campania,5801692,4288443,73.92,0.82
922,2021-03-27,CAM,21518,10243,11275,17202,3869,447,ITF,ITF3,15,Campania,Campania,5801692,4309961,74.29,0.37
923,2021-06-01,CAM,42310,20990,21320,31443,10551,316,ITF,ITF3,15,Campania,Campania,5801692,4352271,75.02,0.73
924,2021-07-21,CAM,50181,24428,25753,8354,40889,938,ITF,ITF3,15,Campania,Campania,5801692,4402452,75.88,0.86
925,2021-03-22,CAM,13189,6354,6835,10810,2045,334,ITF,ITF3,15,Campania,Campania,5801692,4415641,76.11,0.23
926,2021-02-07,CAM,2929,1382,1547,2066,771,92,ITF,ITF3,15,Campania,Campania,5801692,4418570,76.16,0.05
927,2021-06-30,CAM,47673,22778,24895,18213,28659,801,ITF,ITF3,15,Campania,Campania,5801692,4466243,76.98,0.82
928,2021-09-04,CAM,18061,9828,8233,8642,8441,978,ITF,ITF3,15,Campania,Campania,5801692,4484304,77.29,0.31
929,2021-02-17,CAM,7419,3229,4190,6211,1073,135,ITF,ITF3,15,Campania,Campania,5801692,4491723,77.42,0.13
930,2021-04-15,CAM,34355,16667,17688,23760,9908,687,ITF,ITF3,15,Campania,Campania,5801692,4526078,78.01,0.59
931,2021-07-28,CAM,49457,24550,24907,13732,34780,945,ITF,ITF3,15,Campania,Campania,5801692,4575535,78.87,0.85
932,2021-06-22,CAM,52454,25014,27440,13069,39004,381,ITF,ITF3,15,Campania,Campania,5801692,4627989,79.77,0.9
933,2021-03-14,CAM,8617,3826,4791,4355,4142,120,ITF,ITF3,15,Campania,Campania,5801692,4636606,79.92,0.15
934,2021-05-10,CAM,35483,16396,19087,24826,9932,725,ITF,ITF3,15,Campania,Campania,5801692,4672089,80.53,0.61
935,2021-06-08,CAM,53117,25878,27239,45246,7081,790,ITF,ITF3,15,Campania,Campania,5801692,4725206,81.45,0.92
936,2021-08-04,CAM,29839,15308,14531,15769,13101,969,ITF,ITF3,15,Campania,Campania,5801692,4755045,81.96,0.51
937,2021-01-31,CAM,8069,3712,4357,21,8047,1,ITF,ITF3,15,Campania,Campania,5801692,4763114,82.1,0.14
938,2021-05-11,CAM,39891,19253,20638,29518,9407,966,ITF,ITF3,15,Campania,Campania,5801692,4803005,82.79,0.69
939,2021-07-11,CAM,40868,19670,21198,1001,39775,92,ITF,ITF3,15,Campania,Campania,5801692,4843873,83.49,0.7
940,2021-02-02,CAM,5734,2811,2923,415,5288,31,ITF,ITF3,15,Campania,Campania,5801692,4849607,83.59,0.1
941,2021-03-31,CAM,23207,11381,11826,19304,3444,459,ITF,ITF3,15,Campania,Campania,5801692,4872814,83.99,0.4
942,2021-07-18,CAM,31387,15807,15580,3780,27168,439,ITF,ITF3,15,Campania,Campania,5801692,4904201,84.53,0.54
943,2021-09-13,CAM,18283,9029,9254,8269,9245,769,ITF,ITF3,15,Campania,Campania,5801692,4922484,84.85,0.32
944,2021-05-23,CAM,58765,28649,30116,37207,20906,652,ITF,ITF3,15,Campania,Campania,5801692,4981249,85.86,1.01
945,2021-02-12,CAM,6563,2876,3687,6085,218,260,ITF,ITF3,15,Campania,Campania,5801692,4987812,85.97,0.11
946,2021-01-29,CAM,10086,4822,5264,67,10015,4,ITF,ITF3,15,Campania,Campania,5801692,4997898,86.15,0.17
947,2021-06-27,CAM,43561,21452,22109,13980,29073,508,ITF,ITF3,15,Campania,Campania,5801692,5041459,86.9,0.75
948,2021-01-12,CAM,5221,2569,2652,5082,0,139,ITF,ITF3,15,Campania,Campania,5801692,5046680,86.99,0.09
949,2021-08-14,CAM,4918,2804,2114,2050,2706,162,ITF,ITF3,15,Campania,Campania,5801692,5051598,87.07,0.08
950,2021-05-06,CAM,57627,28142,29485,41153,14779,1695,ITF,ITF3,15,Campania,Campania,5801692,5109225,88.06,0.99
951,2021-09-01,CAM,27218,13718,13500,10235,16120,863,ITF,ITF3,15,Campania,Campania,5801692,5136443,88.53,0.47
952,2021-08-18,CAM,19593,10345,9248,7733,11293,567,ITF,ITF3,15,Campania,Campania,5801692,5156036,88.87,0.34
953,2021-06-18,CAM,65899,31406,34493,34807,30312,780,ITF,ITF3,15,Campania,Campania,5801692,5221935,90.01,1.14
954,2021-03-10,CAM,15639,7739,7900,8419,6853,367,ITF,ITF3,15,Campania,Campania,5801692,5237574,90.28,0.27
955,2021-08-06,CAM,31226,16258,14968,17529,12643,1054,ITF,ITF3,15,Campania,Campania,5801692,5268800,90.81,0.54
956,2021-08-23,CAM,23718,12360,11358,9515,13350,853,ITF,ITF3,15,Campania,Campania,5801692,5292518,91.22,0.41
957,2021-05-15,CAM,62822,29086,33736,41936,18878,2008,ITF,ITF3,15,Campania,Campania,5801692,5355340,92.31,1.08
958,2021-04-26,CAM,34060,16654,17406,27513,5630,917,ITF,ITF3,15,Campania,Campania,5801692,5389400,92.89,0.59
959,2021-03-07,CAM,11975,5407,6568,7765,3844,366,ITF,ITF3,15,Campania,Campania,5801692,5401375,93.1,0.21
960,2021-08-11,CAM,21052,11096,9956,12039,8144,869,ITF,ITF3,15,Campania,Campania,5801692,5422427,93.46,0.36
961,2021-05-03,CAM,40761,19894,20867,27831,11873,1057,ITF,ITF3,15,Campania,Campania,5801692,5463188,94.17,0.7
962,2021-06-29,CAM,49361,24017,25344,19665,29149,547,ITF,ITF3,15,Campania,Campania,5801692,5512549,95.02,0.85
963,2021-04-07,CAM,24977,11990,12987,19643,4726,608,ITF,ITF3,15,Campania,Campania,5801692,5537526,95.45,0.43
964,2021-07-16,CAM,61067,29875,31192,6514,53921,632,ITF,ITF3,15,Campania,Campania,5801692,5598593,96.5,1.05
965,2021-04-02,CAM,21869,10527,11342,19037,2324,508,ITF,ITF3,15,Campania,Campania,5801692,5620462,96.88,0.38
966,2021-03-12,CAM,14583,7414,7169,8130,6088,365,ITF,ITF3,15,Campania,Campania,5801692,5635045,97.13,0.25
967,2021-09-11,CAM,11881,6427,5454,6221,4950,710,ITF,ITF3,15,Campania,Campania,5801692,5646926,97.33,0.2
968,2021-06-03,CAM,72657,35244,37413,60840,10682,1135,ITF,ITF3,15,Campania,Campania,5801692,5719583,98.58,1.25
969,2021-02-23,CAM,11017,3397,7620,10152,542,323,ITF,ITF3,15,Campania,Campania,5801692,5730600,98.77,0.19
970,2021-08-25,CAM,22834,12019,10815,8693,13422,719,ITF,ITF3,15,Campania,Campania,5801692,5753434,99.17,0.39
971,2021-01-21,CAM,2106,1125,981,678,1421,7,ITF,ITF3,15,Campania,Campania,5801692,5755540,99.2,0.04
972,2021-07-23,CAM,61839,30810,31029,8343,52868,628,ITF,ITF3,15,Campania,Campania,5801692,5817379,100.27,1.07
973,2021-04-14,CAM,27665,13339,14326,18620,8591,454,ITF,ITF3,15,Campania,Campania,5801692,5845044,100.75,0.48
974,2021-05-01,CAM,46355,22667,23688,29239,16116,1000,ITF,ITF3,15,Campania,Campania,5801692,5891399,101.55,0.8
975,2021-07-06,CAM,56710,27080,29630,15808,40114,788,ITF,ITF3,15,Campania,Campania,5801692,5948109,102.52,0.98
976,2021-04-12,CAM,23311,10921,12390,19731,3038,542,ITF,ITF3,15,Campania,Campania,5801692,5971420,102.93,0.4
977,2021-01-02,CAM,3672,1963,1709,3614,0,58,ITF,ITF3,15,Campania,Campania,5801692,5975092,102.99,0.06
978,2021-06-17,CAM,60216,28866,31350,32691,26800,725,ITF,ITF3,15,Campania,Campania,5801692,6035308,104.03,1.04
979,2021-07-04,CAM,48824,23766,25058,6159,42321,344,ITF,ITF3,15,Campania,Campania,5801692,6084132,104.87,0.84
980,2021-03-26,CAM,19872,9328,10544,15595,3818,459,ITF,ITF3,15,Campania,Campania,5801692,6104004,105.21,0.34
981,2021-03-19,CAM,11153,4979,6174,7070,3877,206,ITF,ITF3,15,Campania,Campania,5801692,6115157,105.4,0.19
982,2021-06-10,CAM,76018,36714,39304,67617,7109,1292,ITF,ITF3,15,Campania,Campania,5801692,6191175,106.71,1.31
983,2021-02-28,CAM,10412,3208,7204,8274,1901,237,ITF,ITF3,15,Campania,Campania,5801692,6201587,106.89,0.18
984,2021-02-14,CAM,3929,1923,2006,3842,34,53,ITF,ITF3,15,Campania,Campania,5801692,6205516,106.96,0.07
985,2021-01-26,CAM,7350,3733,3617,335,6994,21,ITF,ITF3,15,Campania,Campania,5801692,6212866,107.09,0.13
986,2021-04-19,CAM,30787,14835,15952,18639,11592,556,ITF,ITF3,15,Campania,Campania,5801692,6243653,107.62,0.53
987,2021-01-09,CAM,10564,5022,5542,10301,0,263,ITF,ITF3,15,Campania,Campania,5801692,6254217,107.8,0.18
988,2021-06-15,CAM,18688,9096,9592,10983,7422,283,ITF,ITF3,15,Campania,Campania,5801692,6272905,108.12,0.32
989,2021-01-17,CAM,1155,551,604,682,453,20,ITF,ITF3,15,Campania,Campania,5801692,6274060,108.14,0.02
990,2021-03-15,CAM,13357,6500,6857,8305,4748,304,ITF,ITF3,15,Campania,Campania,5801692,6287417,108.37,0.23
991,2021-07-02,CAM,55894,27013,28881,14340,40964,590,ITF,ITF3,15,Campania,Campania,5801692,6343311,109.34,0.96
992,2021-08-28,CAM,17708,9615,8093,5361,11842,505,ITF,ITF3,15,Campania,Campania,5801692,6361019,109.64,0.31
993,2021-02-21,CAM,5840,2242,3598,5487,228,125,ITF,ITF3,15,Campania,Campania,5801692,6366859,109.74,0.1
994,2021-05-08,CAM,56453,27149,29304,39000,15849,1604,ITF,ITF3,15,Campania,Campania,5801692,6423312,110.71,0.97
995,2021-01-28,CAM,8851,4130,4721,140,8703,8,ITF,ITF3,15,Campania,Campania,5801692,6432163,110.87,0.15
996,2021-07-30,CAM,44829,22822,22007,14319,29502,1008,ITF,ITF3,15,Campania,Campania,5801692,6476992,111.64,0.77
997,2021-04-21,CAM,30350,14773,15577,17544,12232,574,ITF,ITF3,15,Campania,Campania,5801692,6507342,112.16,0.52
998,2021-05-27,CAM,73050,35400,37650,25816,46660,574,ITF,ITF3,15,Campania,Campania,5801692,6580392,113.42,1.26
999,2021-02-16,CAM,5471,2431,3040,4499,787,185,ITF,ITF3,15,Campania,Campania,5801692,6585863,113.52,0.09
1000,2021-05-22,CAM,68133,32557,35576,45597,21660,876,ITF,ITF3,15,Campania,Campania,5801692,6653996,114.69,1.17
1001,2021-08-30,CAM,29108,15014,14094,9742,18547,819,ITF,ITF3,15,Campania,Campania,5801692,6683104,115.19,0.5
1002,2021-03-24,CAM,17923,8370,9553,14572,2958,393,ITF,ITF3,15,Campania,Campania,5801692,6701027,115.5,0.31
1003,2021-05-20,CAM,61060,28279,32781,42255,17818,987,ITF,ITF3,15,Campania,Campania,5801692,6762087,116.55,1.05
1004,2021-02-09,CAM,4654,2209,2445,4228,263,163,ITF,ITF3,15,Campania,Campania,5801692,6766741,116.63,0.08
1005,2021-09-06,CAM,22767,11628,11139,10664,11056,1047,ITF,ITF3,15,Campania,Campania,5801692,6789508,117.03,0.39
1006,2021-05-29,CAM,67881,32283,35598,43056,23965,860,ITF,ITF3,15,Campania,Campania,5801692,6857389,118.2,1.17
1007,2021-07-25,CAM,23226,11805,11421,4215,18740,271,ITF,ITF3,15,Campania,Campania,5801692,6880615,118.6,0.4
1008,2021-05-12,CAM,40939,19980,20959,30497,9172,1270,ITF,ITF3,15,Campania,Campania,5801692,6921554,119.3,0.71
1009,2021-07-08,CAM,61130,29426,31704,5609,55159,362,ITF,ITF3,15,Campania,Campania,5801692,6982684,120.36,1.05
1010,2021-09-07,CAM,20544,10391,10153,9507,10187,850,ITF,ITF3,15,Campania,Campania,5801692,7003228,120.71,0.35
1011,2021-02-08,CAM,5128,2459,2669,4163,815,150,ITF,ITF3,15,Campania,Campania,5801692,7008356,120.8,0.09
1012,2021-09-14,CAM,15768,7767,8001,6718,8360,690,ITF,ITF3,15,Campania,Campania,5801692,7024124,121.07,0.27
1013,2021-02-01,CAM,3988,1814,2174,104,3876,8,ITF,ITF3,15,Campania,Campania,5801692,7028112,121.14,0.07
1014,2021-03-30,CAM,22061,10584,11477,18540,2959,562,ITF,ITF3,15,Campania,Campania,5801692,7050173,121.52,0.38
1015,2021-04-17,CAM,36203,17517,18686,23930,11518,755,ITF,ITF3,15,Campania,Campania,5801692,7086376,122.14,0.62
1016,2021-06-13,CAM,43428,21243,22185,37868,4731,829,ITF,ITF3,15,Campania,Campania,5801692,7129804,122.89,0.75
1017,2021-05-30,CAM,52171,25453,26718,37949,13329,893,ITF,ITF3,15,Campania,Campania,5801692,7181975,123.79,0.9
1018,2021-02-19,CAM,9588,3569,6019,8682,662,244,ITF,ITF3,15,Campania,Campania,5801692,7191563,123.96,0.17
1019,2021-07-26,CAM,48864,24319,24545,10221,37942,701,ITF,ITF3,15,Campania,Campania,5801692,7240427,124.8,0.84
1020,2020-12-31,CAM,1490,811,679,1470,0,20,ITF,ITF3,15,Campania,Campania,5801692,7241917,124.82,0.03
1021,2021-06-06,CAM,63232,31449,31783,61554,651,1027,ITF,ITF3,15,Campania,Campania,5801692,7305149,125.91,1.09
1022,2021-02-26,CAM,13366,4236,9130,11684,1368,314,ITF,ITF3,15,Campania,Campania,5801692,7318515,126.14,0.23
1023,2021-08-02,CAM,41767,21212,20555,13051,28012,704,ITF,ITF3,15,Campania,Campania,5801692,7360282,126.86,0.72
1024,2021-04-24,CAM,36388,17539,18849,24303,11250,835,ITF,ITF3,15,Campania,Campania,5801692,7396670,127.49,0.63
1025,2021-07-19,CAM,43998,21545,22453,5151,38375,472,ITF,ITF3,15,Campania,Campania,5801692,7440668,128.25,0.76
1026,2021-04-10,CAM,28366,13500,14866,22758,4917,691,ITF,ITF3,15,Campania,Campania,5801692,7469034,128.74,0.49
1027,2021-01-07,CAM,8910,4167,4743,8735,0,175,ITF,ITF3,15,Campania,Campania,5801692,7477944,128.89,0.15
1028,2021-03-05,CAM,16826,6670,10156,9826,6672,328,ITF,ITF3,15,Campania,Campania,5801692,7494770,129.18,0.29
1029,2021-08-13,CAM,16869,9152,7717,9714,6605,550,ITF,ITF3,15,Campania,Campania,5801692,7511639,129.47,0.29
1030,2021-01-14,CAM,7082,2983,4099,6816,0,266,ITF,ITF3,15,Campania,Campania,5801692,7518721,129.6,0.12
1031,2021-04-19,PUG,27771,12903,14868,24378,3052,341,ITF,ITF4,16,Puglia,Puglia,4029053,27771,0.69,0.69
1032,2021-07-28,PUG,45413,22965,22448,14729,29797,887,ITF,ITF4,16,Puglia,Puglia,4029053,73184,1.82,1.13
1033,2021-04-24,PUG,29470,13427,16043,25175,3957,338,ITF,ITF4,16,Puglia,Puglia,4029053,102654,2.55,0.73
1034,2021-02-07,PUG,1585,669,916,253,1332,0,ITF,ITF4,16,Puglia,Puglia,4029053,104239,2.59,0.04
1035,2021-01-21,PUG,2132,905,1227,1268,862,2,ITF,ITF4,16,Puglia,Puglia,4029053,106371,2.64,0.05
1036,2021-05-01,PUG,27730,12698,15032,16733,10716,281,ITF,ITF4,16,Puglia,Puglia,4029053,134101,3.33,0.69
1037,2021-08-09,PUG,28014,14443,13571,11320,15831,863,ITF,ITF4,16,Puglia,Puglia,4029053,162115,4.02,0.7
1038,2021-01-02,PUG,2958,1306,1652,2958,0,0,ITF,ITF4,16,Puglia,Puglia,4029053,165073,4.1,0.07
1039,2021-03-05,PUG,17750,7201,10549,15203,2319,228,ITF,ITF4,16,Puglia,Puglia,4029053,182823,4.54,0.44
1040,2021-02-26,PUG,13807,5071,8736,12527,1080,200,ITF,ITF4,16,Puglia,Puglia,4029053,196630,4.88,0.34
1041,2020-12-31,PUG,1638,785,853,1638,0,0,ITF,ITF4,16,Puglia,Puglia,4029053,198268,4.92,0.04
1042,2021-08-11,PUG,23951,12316,11635,12137,10800,1014,ITF,ITF4,16,Puglia,Puglia,4029053,222219,5.52,0.59
1043,2021-06-15,PUG,42764,20904,21860,22392,19778,594,ITF,ITF4,16,Puglia,Puglia,4029053,264983,6.58,1.06
1044,2021-09-06,PUG,21637,11322,10315,7188,13526,923,ITF,ITF4,16,Puglia,Puglia,4029053,286620,7.11,0.54
1045,2021-07-11,PUG,12196,5765,6431,2576,9522,98,ITF,ITF4,16,Puglia,Puglia,4029053,298816,7.42,0.3
1046,2021-08-23,PUG,30328,15685,14643,10643,18793,892,ITF,ITF4,16,Puglia,Puglia,4029053,329144,8.17,0.75
1047,2021-04-05,PUG,12786,6210,6576,12111,534,141,ITF,ITF4,16,Puglia,Puglia,4029053,341930,8.49,0.32
1048,2021-03-19,PUG,7999,3672,4327,3368,4595,36,ITF,ITF4,16,Puglia,Puglia,4029053,349929,8.69,0.2
1049,2021-06-27,PUG,18583,9232,9351,9954,8362,267,ITF,ITF4,16,Puglia,Puglia,4029053,368512,9.15,0.46
1050,2021-02-21,PUG,2178,475,1703,2064,63,51,ITF,ITF4,16,Puglia,Puglia,4029053,370690,9.2,0.05
1051,2021-06-01,PUG,35066,17563,17503,21652,13016,398,ITF,ITF4,16,Puglia,Puglia,4029053,405756,10.07,0.87
1052,2021-05-15,PUG,43736,19045,24691,22840,20182,714,ITF,ITF4,16,Puglia,Puglia,4029053,449492,11.16,1.09
1053,2021-06-03,PUG,50733,24607,26126,30558,19447,728,ITF,ITF4,16,Puglia,Puglia,4029053,500225,12.42,1.26
1054,2021-09-11,PUG,4433,2411,2022,1114,3126,193,ITF,ITF4,16,Puglia,Puglia,4029053,504658,12.53,0.11
1055,2021-03-10,PUG,14871,6651,8220,11569,3140,162,ITF,ITF4,16,Puglia,Puglia,4029053,519529,12.89,0.37
1056,2021-02-09,PUG,3856,1576,2280,2159,1677,20,ITF,ITF4,16,Puglia,Puglia,4029053,523385,12.99,0.1
1057,2021-05-20,PUG,33745,15314,18431,20767,12462,516,ITF,ITF4,16,Puglia,Puglia,4029053,557130,13.83,0.84
1058,2021-03-24,PUG,13630,6541,7089,6049,7460,121,ITF,ITF4,16,Puglia,Puglia,4029053,570760,14.17,0.34
1059,2021-08-28,PUG,5722,3133,2589,2013,3521,188,ITF,ITF4,16,Puglia,Puglia,4029053,576482,14.31,0.14
1060,2021-01-26,PUG,5382,2409,2973,563,4818,1,ITF,ITF4,16,Puglia,Puglia,4029053,581864,14.44,0.13
1061,2021-07-02,PUG,47495,22579,24916,17370,29197,928,ITF,ITF4,16,Puglia,Puglia,4029053,629359,15.62,1.18
1062,2021-01-12,PUG,4223,1774,2449,4222,0,1,ITF,ITF4,16,Puglia,Puglia,4029053,633582,15.73,0.1
1063,2021-04-07,PUG,15753,7153,8600,8841,6713,199,ITF,ITF4,16,Puglia,Puglia,4029053,649335,16.12,0.39
1064,2021-07-16,PUG,46623,22628,23995,12945,32864,814,ITF,ITF4,16,Puglia,Puglia,4029053,695958,17.27,1.16
1065,2021-01-14,PUG,4085,1597,2488,4084,0,1,ITF,ITF4,16,Puglia,Puglia,4029053,700043,17.37,0.1
1066,2021-01-07,PUG,5737,2470,3267,5737,0,0,ITF,ITF4,16,Puglia,Puglia,4029053,705780,17.52,0.14
1067,2021-04-17,PUG,40106,19008,21098,36084,3592,430,ITF,ITF4,16,Puglia,Puglia,4029053,745886,18.51,1.0
1068,2021-02-19,PUG,4762,2030,2732,4314,393,55,ITF,ITF4,16,Puglia,Puglia,4029053,750648,18.63,0.12
1069,2021-06-22,PUG,42589,20662,21927,19069,22948,572,ITF,ITF4,16,Puglia,Puglia,4029053,793237,19.69,1.06
1070,2021-04-26,PUG,26368,12085,14283,22732,3242,394,ITF,ITF4,16,Puglia,Puglia,4029053,819605,20.34,0.65
1071,2021-08-04,PUG,35338,18010,17328,12472,21809,1057,ITF,ITF4,16,Puglia,Puglia,4029053,854943,21.22,0.88
1072,2021-04-12,PUG,29503,13876,15627,26159,3026,318,ITF,ITF4,16,Puglia,Puglia,4029053,884446,21.95,0.73
1073,2021-07-21,PUG,45089,22224,22865,11879,32362,848,ITF,ITF4,16,Puglia,Puglia,4029053,929535,23.07,1.12
1074,2021-07-04,PUG,19958,9708,10250,7935,11738,285,ITF,ITF4,16,Puglia,Puglia,4029053,949493,23.57,0.5
1075,2021-07-23,PUG,43399,21958,21441,13661,28762,976,ITF,ITF4,16,Puglia,Puglia,4029053,992892,24.64,1.08
1076,2021-01-19,PUG,1221,452,769,1210,10,1,ITF,ITF4,16,Puglia,Puglia,4029053,994113,24.67,0.03
1077,2021-06-08,PUG,39419,19196,20223,20959,17897,563,ITF,ITF4,16,Puglia,Puglia,4029053,1033532,25.65,0.98
1078,2021-06-13,PUG,21894,10966,10928,16382,5226,286,ITF,ITF4,16,Puglia,Puglia,4029053,1055426,26.2,0.54
1079,2021-02-28,PUG,6081,1812,4269,5812,191,78,ITF,ITF4,16,Puglia,Puglia,4029053,1061507,26.35,0.15
1080,2021-08-30,PUG,28520,14843,13677,11532,15959,1029,ITF,ITF4,16,Puglia,Puglia,4029053,1090027,27.05,0.71
1081,2021-01-31,PUG,1827,835,992,73,1754,0,ITF,ITF4,16,Puglia,Puglia,4029053,1091854,27.1,0.05
1082,2021-05-29,PUG,30725,14485,16240,20619,9559,547,ITF,ITF4,16,Puglia,Puglia,4029053,1122579,27.86,0.76
1083,2021-04-02,PUG,12872,6014,6858,8190,4531,151,ITF,ITF4,16,Puglia,Puglia,4029053,1135451,28.18,0.32
1084,2021-02-14,PUG,790,348,442,658,127,5,ITF,ITF4,16,Puglia,Puglia,4029053,1136241,28.2,0.02
1085,2021-05-25,PUG,34865,16277,18588,20585,13693,587,ITF,ITF4,16,Puglia,Puglia,4029053,1171106,29.07,0.87
1086,2021-05-08,PUG,54495,23070,31425,23944,29956,595,ITF,ITF4,16,Puglia,Puglia,4029053,1225601,30.42,1.35
1087,2021-08-16,PUG,12080,6407,5673,7071,4373,636,ITF,ITF4,16,Puglia,Puglia,4029053,1237681,30.72,0.3
1088,2021-05-06,PUG,39798,17409,22389,19303,19934,561,ITF,ITF4,16,Puglia,Puglia,4029053,1277479,31.71,0.99
1089,2021-03-31,PUG,14588,6839,7749,8842,5592,154,ITF,ITF4,16,Puglia,Puglia,4029053,1292067,32.07,0.36
1090,2021-03-29,PUG,13590,6633,6957,6616,6772,202,ITF,ITF4,16,Puglia,Puglia,4029053,1305657,32.41,0.34
1091,2021-03-12,PUG,14331,6465,7866,10237,3950,144,ITF,ITF4,16,Puglia,Puglia,4029053,1319988,32.76,0.36
1092,2021-06-20,PUG,21634,10871,10763,14067,7241,326,ITF,ITF4,16,Puglia,Puglia,4029053,1341622,33.3,0.54
1093,2021-07-30,PUG,36468,18735,17733,13173,22419,876,ITF,ITF4,16,Puglia,Puglia,4029053,1378090,34.2,0.91
1094,2021-05-27,PUG,41041,19401,21640,22902,17464,675,ITF,ITF4,16,Puglia,Puglia,4029053,1419131,35.22,1.02
1095,2021-09-04,PUG,5526,2993,2533,1648,3698,180,ITF,ITF4,16,Puglia,Puglia,4029053,1424657,35.36,0.14
1096,2021-08-18,PUG,20186,10682,9504,10700,8562,924,ITF,ITF4,16,Puglia,Puglia,4029053,1444843,35.86,0.5
1097,2021-03-16,PUG,9895,4697,5198,3453,6383,59,ITF,ITF4,16,Puglia,Puglia,4029053,1454738,36.11,0.25
1098,2021-06-24,PUG,53097,25688,27409,23611,28700,786,ITF,ITF4,16,Puglia,Puglia,4029053,1507835,37.42,1.32
1099,2021-04-28,PUG,19896,8923,10973,14837,4796,263,ITF,ITF4,16,Puglia,Puglia,4029053,1527731,37.92,0.49
1100,2021-08-06,PUG,30418,15842,14576,9173,20490,755,ITF,ITF4,16,Puglia,Puglia,4029053,1558149,38.67,0.75
1101,2021-01-09,PUG,4899,2252,2647,4895,0,4,ITF,ITF4,16,Puglia,Puglia,4029053,1563048,38.79,0.12
1102,2021-07-08,PUG,41650,19317,22333,5421,35769,460,ITF,ITF4,16,Puglia,Puglia,4029053,1604698,39.83,1.03
1103,2021-01-04,PUG,4514,2017,2497,4512,0,2,ITF,ITF4,16,Puglia,Puglia,4029053,1609212,39.94,0.11
1104,2021-05-12,PUG,36678,16354,20324,23538,12552,588,ITF,ITF4,16,Puglia,Puglia,4029053,1645890,40.85,0.91
1105,2021-08-20,PUG,17937,9319,8618,8224,8967,746,ITF,ITF4,16,Puglia,Puglia,4029053,1663827,41.3,0.45
1106,2021-01-23,PUG,3044,1295,1749,880,2162,2,ITF,ITF4,16,Puglia,Puglia,4029053,1666871,41.37,0.08
1107,2021-05-03,PUG,33441,14948,18493,22173,10699,569,ITF,ITF4,16,Puglia,Puglia,4029053,1700312,42.2,0.83
1108,2021-03-07,PUG,4996,2007,2989,4370,578,48,ITF,ITF4,16,Puglia,Puglia,4029053,1705308,42.33,0.12
1109,2021-09-03,PUG,21392,11050,10342,8439,11759,1194,ITF,ITF4,16,Puglia,Puglia,4029053,1726700,42.86,0.53
1110,2021-06-12,PUG,34681,17281,17400,25090,8996,595,ITF,ITF4,16,Puglia,Puglia,4029053,1761381,43.72,0.86
1111,2021-04-16,PUG,36163,16994,19169,32442,3292,429,ITF,ITF4,16,Puglia,Puglia,4029053,1797544,44.61,0.9
1112,2021-02-18,PUG,4390,1850,2540,3719,610,61,ITF,ITF4,16,Puglia,Puglia,4029053,1801934,44.72,0.11
1113,2021-07-25,PUG,14326,7409,6917,4275,9845,206,ITF,ITF4,16,Puglia,Puglia,4029053,1816260,45.08,0.36
1114,2021-04-09,PUG,22188,9562,12626,17091,4709,388,ITF,ITF4,16,Puglia,Puglia,4029053,1838448,45.63,0.55
1115,2021-09-13,PUG,19405,10168,9237,5241,13431,733,ITF,ITF4,16,Puglia,Puglia,4029053,1857853,46.11,0.48
1116,2021-02-11,PUG,3700,1401,2299,2392,1280,28,ITF,ITF4,16,Puglia,Puglia,4029053,1861553,46.2,0.09
1117,2021-07-18,PUG,18850,9653,9197,6198,12314,338,ITF,ITF4,16,Puglia,Puglia,4029053,1880403,46.67,0.47
1118,2021-05-22,PUG,34798,15927,18871,23661,10592,545,ITF,ITF4,16,Puglia,Puglia,4029053,1915201,47.53,0.86
1119,2021-02-25,PUG,12004,5074,6930,10683,1184,137,ITF,ITF4,16,Puglia,Puglia,4029053,1927205,47.83,0.3
1120,2021-07-01,PUG,48571,22743,25828,11455,36482,634,ITF,ITF4,16,Puglia,Puglia,4029053,1975776,49.04,1.21
1121,2021-03-14,PUG,3384,1466,1918,2473,868,43,ITF,ITF4,16,Puglia,Puglia,4029053,1979160,49.12,0.08
1122,2021-01-16,PUG,2510,1035,1475,2509,0,1,ITF,ITF4,16,Puglia,Puglia,4029053,1981670,49.18,0.06
1123,2021-02-04,PUG,5942,2367,3575,1132,4806,4,ITF,ITF4,16,Puglia,Puglia,4029053,1987612,49.33,0.15
1124,2021-05-17,PUG,32994,15295,17699,20470,12022,502,ITF,ITF4,16,Puglia,Puglia,4029053,2020606,50.15,0.82
1125,2021-08-25,PUG,25698,13495,12203,10306,14447,945,ITF,ITF4,16,Puglia,Puglia,4029053,2046304,50.79,0.64
1126,2021-08-08,PUG,5124,2602,2522,1657,3418,49,ITF,ITF4,16,Puglia,Puglia,4029053,2051428,50.92,0.13
1127,2021-08-27,PUG,23873,12509,11364,9958,12969,946,ITF,ITF4,16,Puglia,Puglia,4029053,2075301,51.51,0.59
1128,2021-02-23,PUG,9403,4435,4968,8813,497,93,ITF,ITF4,16,Puglia,Puglia,4029053,2084704,51.74,0.23
1129,2021-03-02,PUG,16438,6111,10327,14875,1311,252,ITF,ITF4,16,Puglia,Puglia,4029053,2101142,52.15,0.41
1130,2021-06-10,PUG,47286,23251,24035,29419,17148,719,ITF,ITF4,16,Puglia,Puglia,4029053,2148428,53.32,1.17
1131,2021-04-04,PUG,6002,2979,3023,5914,7,81,ITF,ITF4,16,Puglia,Puglia,4029053,2154430,53.47,0.15
1132,2021-07-13,PUG,48862,23039,25823,7776,40501,585,ITF,ITF4,16,Puglia,Puglia,4029053,2203292,54.69,1.21
1133,2021-03-21,PUG,2697,1227,1470,577,2108,12,ITF,ITF4,16,Puglia,Puglia,4029053,2205989,54.75,0.07
1134,2021-06-29,PUG,46781,22436,24345,15363,30725,693,ITF,ITF4,16,Puglia,Puglia,4029053,2252770,55.91,1.16
1135,2021-01-28,PUG,5490,2286,3204,441,5049,0,ITF,ITF4,16,Puglia,Puglia,4029053,2258260,56.05,0.14
1136,2021-08-15,PUG,57,34,23,56,1,0,ITF,ITF4,16,Puglia,Puglia,4029053,2258317,56.05,0.0
1137,2021-04-23,PUG,29644,13779,15865,23931,5297,416,ITF,ITF4,16,Puglia,Puglia,4029053,2287961,56.79,0.74
1138,2021-05-05,PUG,39377,17288,22089,24507,14274,596,ITF,ITF4,16,Puglia,Puglia,4029053,2327338,57.76,0.98
1139,2021-08-13,PUG,13794,7332,6462,7291,5911,592,ITF,ITF4,16,Puglia,Puglia,4029053,2341132,58.11,0.34
1140,2021-06-17,PUG,42985,21004,21981,21406,21017,562,ITF,ITF4,16,Puglia,Puglia,4029053,2384117,59.17,1.07
1141,2021-03-26,PUG,12046,5866,6180,7224,4681,141,ITF,ITF4,16,Puglia,Puglia,4029053,2396163,59.47,0.3
1142,2021-03-09,PUG,13703,6125,7578,11497,2022,184,ITF,ITF4,16,Puglia,Puglia,4029053,2409866,59.81,0.34
1143,2021-04-14,PUG,32090,15137,16953,28482,3304,304,ITF,ITF4,16,Puglia,Puglia,4029053,2441956,60.61,0.8
1144,2021-03-28,PUG,3551,1659,1892,1178,2337,36,ITF,ITF4,16,Puglia,Puglia,4029053,2445507,60.7,0.09
1145,2021-07-06,PUG,42456,19549,22907,6101,35938,417,ITF,ITF4,16,Puglia,Puglia,4029053,2487963,61.75,1.05
1146,2021-06-19,PUG,34842,17475,17367,22229,11957,656,ITF,ITF4,16,Puglia,Puglia,4029053,2522805,62.62,0.86
1147,2021-06-21,PUG,41992,20474,21518,21478,19877,637,ITF,ITF4,16,Puglia,Puglia,4029053,2564797,63.66,1.04
1148,2021-09-12,PUG,1223,650,573,401,771,51,ITF,ITF4,16,Puglia,Puglia,4029053,2566020,63.69,0.03
1149,2021-06-05,PUG,42705,20916,21789,29215,12770,720,ITF,ITF4,16,Puglia,Puglia,4029053,2608725,64.75,1.06
1150,2021-08-05,PUG,34510,17389,17121,9542,24098,870,ITF,ITF4,16,Puglia,Puglia,4029053,2643235,65.6,0.86
1151,2021-01-06,PUG,3966,1680,2286,3965,0,1,ITF,ITF4,16,Puglia,Puglia,4029053,2647201,65.7,0.1
1152,2021-05-21,PUG,39275,18657,20618,28282,10200,793,ITF,ITF4,16,Puglia,Puglia,4029053,2686476,66.68,0.97
1153,2021-08-31,PUG,24844,12792,12052,8299,15695,850,ITF,ITF4,16,Puglia,Puglia,4029053,2711320,67.29,0.62
1154,2021-01-18,PUG,1848,772,1076,1496,351,1,ITF,ITF4,16,Puglia,Puglia,4029053,2713168,67.34,0.05
1155,2021-02-06,PUG,4558,1936,2622,1579,2964,15,ITF,ITF4,16,Puglia,Puglia,4029053,2717726,67.45,0.11
1156,2021-01-20,PUG,1547,541,1006,1537,8,2,ITF,ITF4,16,Puglia,Puglia,4029053,2719273,67.49,0.04
1157,2021-04-30,PUG,35069,15715,19354,22482,12017,570,ITF,ITF4,16,Puglia,Puglia,4029053,2754342,68.36,0.87
1158,2021-04-13,PUG,28801,13660,15141,24944,3541,316,ITF,ITF4,16,Puglia,Puglia,4029053,2783143,69.08,0.71
1159,2021-07-22,PUG,47674,23641,24033,8483,38505,686,ITF,ITF4,16,Puglia,Puglia,4029053,2830817,70.26,1.18
1160,2021-01-11,PUG,3760,1592,2168,3759,0,1,ITF,ITF4,16,Puglia,Puglia,4029053,2834577,70.35,0.09
1161,2021-04-21,PUG,23175,10701,12474,19127,3746,302,ITF,ITF4,16,Puglia,Puglia,4029053,2857752,70.93,0.58
1162,2021-05-24,PUG,36250,17100,19150,24515,11123,612,ITF,ITF4,16,Puglia,Puglia,4029053,2894002,71.83,0.9
1163,2021-09-01,PUG,24816,12881,11935,9859,13896,1061,ITF,ITF4,16,Puglia,Puglia,4029053,2918818,72.44,0.62
1164,2021-02-16,PUG,3393,1456,1937,2713,649,31,ITF,ITF4,16,Puglia,Puglia,4029053,2922211,72.53,0.08
1165,2021-01-30,PUG,5543,2516,3027,380,5162,1,ITF,ITF4,16,Puglia,Puglia,4029053,2927754,72.67,0.14
1166,2021-05-10,PUG,37942,16768,21174,19303,18115,524,ITF,ITF4,16,Puglia,Puglia,4029053,2965696,73.61,0.94
1167,2021-08-17,PUG,19972,10363,9609,9291,9979,702,ITF,ITF4,16,Puglia,Puglia,4029053,2985668,74.1,0.5
1168,2021-02-13,PUG,3733,1461,2272,3021,696,16,ITF,ITF4,16,Puglia,Puglia,4029053,2989401,74.2,0.09
1169,2021-08-01,PUG,12437,6515,5922,4327,7990,120,ITF,ITF4,16,Puglia,Puglia,4029053,3001838,74.5,0.31
1170,2021-03-18,PUG,9631,4377,5254,3346,6219,66,ITF,ITF4,16,Puglia,Puglia,4029053,3011469,74.74,0.24
1171,2021-06-26,PUG,32484,16364,16120,15896,16017,571,ITF,ITF4,16,Puglia,Puglia,4029053,3043953,75.55,0.81
1172,2021-03-04,PUG,15401,6117,9284,13725,1440,236,ITF,ITF4,16,Puglia,Puglia,4029053,3059354,75.93,0.38
1173,2021-06-09,PUG,42041,20817,21224,29990,11340,711,ITF,ITF4,16,Puglia,Puglia,4029053,3101395,76.98,1.04
1174,2021-02-15,PUG,3270,1273,1997,2602,623,45,ITF,ITF4,16,Puglia,Puglia,4029053,3104665,77.06,0.08
1175,2021-05-26,PUG,38764,18625,20139,26259,11848,657,ITF,ITF4,16,Puglia,Puglia,4029053,3143429,78.02,0.96
1176,2021-01-27,PUG,4607,1946,2661,618,3989,0,ITF,ITF4,16,Puglia,Puglia,4029053,3148036,78.13,0.11
1177,2021-05-07,PUG,50285,22437,27848,25964,23711,610,ITF,ITF4,16,Puglia,Puglia,4029053,3198321,79.38,1.25
1178,2021-07-29,PUG,43080,21782,21298,12291,29997,792,ITF,ITF4,16,Puglia,Puglia,4029053,3241401,80.45,1.07
1179,2021-01-13,PUG,4556,1734,2822,4555,0,1,ITF,ITF4,16,Puglia,Puglia,4029053,3245957,80.56,0.11
1180,2021-07-05,PUG,38995,18300,20695,7229,31212,554,ITF,ITF4,16,Puglia,Puglia,4029053,3284952,81.53,0.97
1181,2021-05-02,PUG,21367,9681,11686,13906,7280,181,ITF,ITF4,16,Puglia,Puglia,4029053,3306319,82.06,0.53
1182,2021-08-10,PUG,27388,14280,13108,14153,12081,1154,ITF,ITF4,16,Puglia,Puglia,4029053,3333707,82.74,0.68
1183,2021-07-24,PUG,26782,13897,12885,8005,18304,473,ITF,ITF4,16,Puglia,Puglia,4029053,3360489,83.41,0.66
1184,2021-08-24,PUG,25109,12852,12257,9303,14978,828,ITF,ITF4,16,Puglia,Puglia,4029053,3385598,84.03,0.62
1185,2021-03-11,PUG,14874,6608,8266,11471,3195,208,ITF,ITF4,16,Puglia,Puglia,4029053,3400472,84.4,0.37
1186,2021-06-02,PUG,27119,13259,13860,21918,4845,356,ITF,ITF4,16,Puglia,Puglia,4029053,3427591,85.07,0.67
1187,2021-09-10,PUG,19292,10059,9233,6133,12109,1050,ITF,ITF4,16,Puglia,Puglia,4029053,3446883,85.55,0.48
1188,2021-03-30,PUG,12458,5974,6484,6200,6102,156,ITF,ITF4,16,Puglia,Puglia,4029053,3459341,85.86,0.31
1189,2021-02-01,PUG,3980,1667,2313,353,3626,1,ITF,ITF4,16,Puglia,Puglia,4029053,3463321,85.96,0.1
1190,2021-07-17,PUG,30867,15498,15369,9535,20703,629,ITF,ITF4,16,Puglia,Puglia,4029053,3494188,86.72,0.77
1191,2021-05-14,PUG,45121,20619,24502,28015,16244,862,ITF,ITF4,16,Puglia,Puglia,4029053,3539309,87.84,1.12
1192,2021-08-22,PUG,1479,770,709,530,924,25,ITF,ITF4,16,Puglia,Puglia,4029053,3540788,87.88,0.04
1193,2021-08-12,PUG,19496,10370,9126,11031,7563,902,ITF,ITF4,16,Puglia,Puglia,4029053,3560284,88.37,0.48
1194,2021-06-16,PUG,42200,20765,21435,26928,14541,731,ITF,ITF4,16,Puglia,Puglia,4029053,3602484,89.41,1.05
1195,2020-12-30,PUG,1,0,1,1,0,0,ITF,ITF4,16,Puglia,Puglia,4029053,3602485,89.41,0.0
1196,2021-03-22,PUG,9994,5144,4850,4251,5671,72,ITF,ITF4,16,Puglia,Puglia,4029053,3612479,89.66,0.25
1197,2021-01-24,PUG,1674,754,920,151,1523,0,ITF,ITF4,16,Puglia,Puglia,4029053,3614153,89.7,0.04
1198,2021-06-30,PUG,47967,23265,24702,18843,28266,858,ITF,ITF4,16,Puglia,Puglia,4029053,3662120,90.89,1.19
1199,2021-03-15,PUG,12363,6160,6203,5740,6518,105,ITF,ITF4,16,Puglia,Puglia,4029053,3674483,91.2,0.31
1200,2021-08-19,PUG,17868,9310,8558,8757,8388,723,ITF,ITF4,16,Puglia,Puglia,4029053,3692351,91.64,0.44
1201,2021-01-17,PUG,1312,593,719,1242,70,0,ITF,ITF4,16,Puglia,Puglia,4029053,3693663,91.68,0.03
1202,2021-06-23,PUG,29470,14399,15071,16949,11911,610,ITF,ITF4,16,Puglia,Puglia,4029053,3723133,92.41,0.73
1203,2021-04-27,PUG,26743,12103,14640,20786,5628,329,ITF,ITF4,16,Puglia,Puglia,4029053,3749876,93.07,0.66
1204,2021-05-19,PUG,26510,12814,13696,19570,6502,438,ITF,ITF4,16,Puglia,Puglia,4029053,3776386,93.73,0.66
1205,2021-03-23,PUG,11162,5666,5496,4529,6536,97,ITF,ITF4,16,Puglia,Puglia,4029053,3787548,94.01,0.28
1206,2021-09-05,PUG,3203,1751,1452,962,2119,122,ITF,ITF4,16,Puglia,Puglia,4029053,3790751,94.09,0.08
1207,2021-03-25,PUG,11787,6044,5743,5259,6425,103,ITF,ITF4,16,Puglia,Puglia,4029053,3802538,94.38,0.29
1208,2021-08-29,PUG,1289,665,624,422,839,28,ITF,ITF4,16,Puglia,Puglia,4029053,3803827,94.41,0.03
1209,2021-07-03,PUG,33336,16704,16632,13469,19362,505,ITF,ITF4,16,Puglia,Puglia,4029053,3837163,95.24,0.83
1210,2021-02-08,PUG,4011,1622,2389,1583,2413,15,ITF,ITF4,16,Puglia,Puglia,4029053,3841174,95.34,0.1
1211,2021-02-10,PUG,3660,1444,2216,2127,1513,20,ITF,ITF4,16,Puglia,Puglia,4029053,3844834,95.43,0.09
1212,2021-05-23,PUG,17989,8413,9576,13887,3841,261,ITF,ITF4,16,Puglia,Puglia,4029053,3862823,95.87,0.45
1213,2021-06-28,PUG,48763,23649,25114,21664,26301,798,ITF,ITF4,16,Puglia,Puglia,4029053,3911586,97.08,1.21
1214,2021-05-09,PUG,30867,12669,18198,14796,15693,378,ITF,ITF4,16,Puglia,Puglia,4029053,3942453,97.85,0.77
1215,2021-04-06,PUG,13873,6266,7607,6926,6773,174,ITF,ITF4,16,Puglia,Puglia,4029053,3956326,98.19,0.34
1216,2021-07-15,PUG,44953,21759,23194,8895,35379,679,ITF,ITF4,16,Puglia,Puglia,4029053,4001279,99.31,1.12
1217,2021-07-14,PUG,46307,22209,24098,13378,32093,836,ITF,ITF4,16,Puglia,Puglia,4029053,4047586,100.46,1.15
1218,2021-08-02,PUG,39810,20182,19628,14232,24357,1221,ITF,ITF4,16,Puglia,Puglia,4029053,4087396,101.45,0.99
1219,2021-03-01,PUG,15143,5885,9258,13603,1386,154,ITF,ITF4,16,Puglia,Puglia,4029053,4102539,101.82,0.38
1220,2021-06-18,PUG,47918,23584,24334,28887,18104,927,ITF,ITF4,16,Puglia,Puglia,4029053,4150457,103.01,1.19
1221,2021-09-09,PUG,18354,9529,8825,5141,12430,783,ITF,ITF4,16,Puglia,Puglia,4029053,4168811,103.47,0.46
1222,2021-01-03,PUG,2010,944,1066,2009,0,1,ITF,ITF4,16,Puglia,Puglia,4029053,4170821,103.52,0.05
1223,2021-05-11,PUG,32764,14483,18281,13708,18565,491,ITF,ITF4,16,Puglia,Puglia,4029053,4203585,104.33,0.81
1224,2021-05-04,PUG,35242,14908,20334,18247,16573,422,ITF,ITF4,16,Puglia,Puglia,4029053,4238827,105.21,0.87
1225,2021-03-08,PUG,15023,6448,8575,12444,2417,162,ITF,ITF4,16,Puglia,Puglia,4029053,4253850,105.58,0.37
1226,2021-02-17,PUG,4298,1756,2542,3618,640,40,ITF,ITF4,16,Puglia,Puglia,4029053,4258148,105.69,0.11
1227,2021-05-28,PUG,44166,20906,23260,27441,15921,804,ITF,ITF4,16,Puglia,Puglia,4029053,4302314,106.78,1.1
1228,2021-07-26,PUG,48039,23979,24060,17128,29990,921,ITF,ITF4,16,Puglia,Puglia,4029053,4350353,107.97,1.19
1229,2021-05-30,PUG,21065,10080,10985,15731,5077,257,ITF,ITF4,16,Puglia,Puglia,4029053,4371418,108.5,0.52
1230,2021-09-07,PUG,22558,11831,10727,6911,14832,815,ITF,ITF4,16,Puglia,Puglia,4029053,4393976,109.06,0.56
1231,2021-03-27,PUG,12189,5727,6462,6886,5191,112,ITF,ITF4,16,Puglia,Puglia,4029053,4406165,109.36,0.3
1232,2021-01-05,PUG,5119,2257,2862,5116,0,3,ITF,ITF4,16,Puglia,Puglia,4029053,4411284,109.49,0.13
1233,2021-04-15,PUG,32802,15308,17494,28616,3785,401,ITF,ITF4,16,Puglia,Puglia,4029053,4444086,110.3,0.81
1234,2021-07-07,PUG,38806,18575,20231,6087,32208,511,ITF,ITF4,16,Puglia,Puglia,4029053,4482892,111.26,0.96
1235,2021-03-13,PUG,10489,4141,6348,8573,1817,99,ITF,ITF4,16,Puglia,Puglia,4029053,4493381,111.52,0.26
1236,2021-02-24,PUG,10072,4719,5353,9377,597,98,ITF,ITF4,16,Puglia,Puglia,4029053,4503453,111.77,0.25
1237,2021-06-04,PUG,52917,25611,27306,34230,17861,826,ITF,ITF4,16,Puglia,Puglia,4029053,4556370,113.09,1.31
1238,2021-05-18,PUG,28999,13489,15510,15781,12917,301,ITF,ITF4,16,Puglia,Puglia,4029053,4585369,113.81,0.72
1239,2021-08-26,PUG,20261,10457,9804,8657,10724,880,ITF,ITF4,16,Puglia,Puglia,4029053,4605630,114.31,0.5
1240,2021-04-29,PUG,26338,12180,14158,19197,6710,431,ITF,ITF4,16,Puglia,Puglia,4029053,4631968,114.96,0.65
1241,2021-08-07,PUG,10120,5341,4779,3563,6259,298,ITF,ITF4,16,Puglia,Puglia,4029053,4642088,115.22,0.25
1242,2021-02-22,PUG,9659,4540,5119,9232,336,91,ITF,ITF4,16,Puglia,Puglia,4029053,4651747,115.46,0.24
1243,2021-04-22,PUG,23075,10558,12517,17741,4948,386,ITF,ITF4,16,Puglia,Puglia,4029053,4674822,116.03,0.57
1244,2021-07-31,PUG,20041,10650,9391,7910,11652,479,ITF,ITF4,16,Puglia,Puglia,4029053,4694863,116.53,0.5
1245,2021-02-12,PUG,4215,1672,2543,3098,1094,23,ITF,ITF4,16,Puglia,Puglia,4029053,4699078,116.63,0.1
1246,2021-01-29,PUG,6218,2673,3545,219,5999,0,ITF,ITF4,16,Puglia,Puglia,4029053,4705296,116.78,0.15
1247,2021-09-02,PUG,23186,12055,11131,7439,14873,874,ITF,ITF4,16,Puglia,Puglia,4029053,4728482,117.36,0.58
1248,2021-01-10,PUG,2351,1062,1289,2351,0,0,ITF,ITF4,16,Puglia,Puglia,4029053,4730833,117.42,0.06
1249,2021-04-20,PUG,21236,9862,11374,17475,3491,270,ITF,ITF4,16,Puglia,Puglia,4029053,4752069,117.95,0.53
1250,2020-12-27,PUG,510,252,258,510,0,0,ITF,ITF4,16,Puglia,Puglia,4029053,4752579,117.96,0.01
1251,2021-01-25,PUG,3839,1686,2153,425,3413,1,ITF,ITF4,16,Puglia,Puglia,4029053,4756418,118.05,0.1
1252,2021-07-10,PUG,22426,11046,11380,4460,17669,297,ITF,ITF4,16,Puglia,Puglia,4029053,4778844,118.61,0.56
1253,2021-03-20,PUG,8448,3895,4553,3769,4631,48,ITF,ITF4,16,Puglia,Puglia,4029053,4787292,118.82,0.21
1254,2021-03-03,PUG,16834,6830,10004,14739,1940,155,ITF,ITF4,16,Puglia,Puglia,4029053,4804126,119.24,0.42
1255,2021-06-11,PUG,48077,23517,24560,33038,14127,912,ITF,ITF4,16,Puglia,Puglia,4029053,4852203,120.43,1.19
1256,2021-04-03,PUG,10587,4661,5926,6816,3577,194,ITF,ITF4,16,Puglia,Puglia,4029053,4862790,120.69,0.26
1257,2021-02-05,PUG,5654,2278,3376,1311,4338,5,ITF,ITF4,16,Puglia,Puglia,4029053,4868444,120.83,0.14
1258,2021-05-16,PUG,24658,11124,13534,12472,11960,226,ITF,ITF4,16,Puglia,Puglia,4029053,4893102,121.45,0.61
1259,2021-04-08,PUG,17538,7618,9920,11122,6202,214,ITF,ITF4,16,Puglia,Puglia,4029053,4910640,121.88,0.44
1260,2021-06-06,PUG,30780,15502,15278,25386,5073,321,ITF,ITF4,16,Puglia,Puglia,4029053,4941420,122.64,0.76
1261,2021-04-10,PUG,30966,13134,17832,26110,4465,391,ITF,ITF4,16,Puglia,Puglia,4029053,4972386,123.41,0.77
1262,2021-09-14,PUG,20206,10553,9653,3980,15562,664,ITF,ITF4,16,Puglia,Puglia,4029053,4992592,123.91,0.5
1263,2021-07-19,PUG,49586,24365,25221,10943,37879,764,ITF,ITF4,16,Puglia,Puglia,4029053,5042178,125.15,1.23
1264,2021-04-01,PUG,13990,6577,7413,7383,6385,222,ITF,ITF4,16,Puglia,Puglia,4029053,5056168,125.49,0.35
1265,2021-02-03,PUG,5056,2008,3048,705,4350,1,ITF,ITF4,16,Puglia,Puglia,4029053,5061224,125.62,0.13
1266,2021-07-12,PUG,45847,21651,24196,12735,32357,755,ITF,ITF4,16,Puglia,Puglia,4029053,5107071,126.76,1.14
1267,2021-02-02,PUG,4365,1857,2508,574,3790,1,ITF,ITF4,16,Puglia,Puglia,4029053,5111436,126.86,0.11
1268,2021-07-09,PUG,37181,17912,19269,6393,30109,679,ITF,ITF4,16,Puglia,Puglia,4029053,5148617,127.79,0.92
1269,2021-05-13,PUG,38904,17341,21563,21013,17323,568,ITF,ITF4,16,Puglia,Puglia,4029053,5187521,128.75,0.97
1270,2021-03-17,PUG,10358,4707,5651,4103,6192,63,ITF,ITF4,16,Puglia,Puglia,4029053,5197879,129.01,0.26
1271,2021-09-15,PUG,5746,2960,2786,1477,3990,279,ITF,ITF4,16,Puglia,Puglia,4029053,5203625,129.15,0.14
1272,2021-07-20,PUG,47067,23093,23974,8208,38353,506,ITF,ITF4,16,Puglia,Puglia,4029053,5250692,130.32,1.17
1273,2021-09-08,PUG,18676,9795,8881,5954,11964,758,ITF,ITF4,16,Puglia,Puglia,4029053,5269368,130.78,0.46
1274,2021-07-27,PUG,48691,24231,24460,13349,34534,808,ITF,ITF4,16,Puglia,Puglia,4029053,5318059,131.99,1.21
1275,2021-05-31,PUG,37994,18325,19669,23172,14266,556,ITF,ITF4,16,Puglia,Puglia,4029053,5356053,132.94,0.94
1276,2021-04-25,PUG,11328,5244,6084,10051,1143,134,ITF,ITF4,16,Puglia,Puglia,4029053,5367381,133.22,0.28
1277,2021-02-27,PUG,14251,4827,9424,12828,1237,186,ITF,ITF4,16,Puglia,Puglia,4029053,5381632,133.57,0.35
1278,2021-08-03,PUG,36491,18515,17976,9216,26509,766,ITF,ITF4,16,Puglia,Puglia,4029053,5418123,134.48,0.91
1279,2021-01-01,PUG,150,61,89,150,0,0,ITF,ITF4,16,Puglia,Puglia,4029053,5418273,134.48,0.0
1280,2021-06-07,PUG,44487,21717,22770,30392,13328,767,ITF,ITF4,16,Puglia,Puglia,4029053,5462760,135.58,1.1
1281,2021-04-11,PUG,16493,7270,9223,14657,1650,186,ITF,ITF4,16,Puglia,Puglia,4029053,5479253,135.99,0.41
1282,2021-03-06,PUG,16192,6142,10050,13890,2129,173,ITF,ITF4,16,Puglia,Puglia,4029053,5495445,136.4,0.4
1283,2021-01-08,PUG,5699,2399,3300,5697,0,2,ITF,ITF4,16,Puglia,Puglia,4029053,5501144,136.54,0.14
1284,2021-06-14,PUG,42156,20626,21530,28866,12497,793,ITF,ITF4,16,Puglia,Puglia,4029053,5543300,137.58,1.05
1285,2021-04-18,PUG,22693,10860,11833,21435,1058,200,ITF,ITF4,16,Puglia,Puglia,4029053,5565993,138.15,0.56
1286,2021-02-20,PUG,2978,1080,1898,2688,257,33,ITF,ITF4,16,Puglia,Puglia,4029053,5568971,138.22,0.07
1287,2021-08-14,PUG,1093,563,530,501,573,19,ITF,ITF4,16,Puglia,Puglia,4029053,5570064,138.25,0.03
1288,2021-01-15,PUG,4558,1866,2692,4553,0,5,ITF,ITF4,16,Puglia,Puglia,4029053,5574622,138.36,0.11
1289,2021-01-22,PUG,1414,579,835,992,421,1,ITF,ITF4,16,Puglia,Puglia,4029053,5576036,138.4,0.04
1290,2021-08-21,PUG,4307,2306,2001,1974,2098,235,ITF,ITF4,16,Puglia,Puglia,4029053,5580343,138.5,0.11
1291,2021-06-25,PUG,50970,25098,25872,23850,26219,901,ITF,ITF4,16,Puglia,Puglia,4029053,5631313,139.77,1.27
1292,2021-04-06,UMB,5294,2167,3127,2865,2392,37,ITI,ITI2,10,Umbria,Umbria,882015,5294,0.6,0.6
1293,2021-03-28,UMB,1096,441,655,1041,24,31,ITI,ITI2,10,Umbria,Umbria,882015,6390,0.72,0.12
1294,2021-01-30,UMB,1575,486,1089,43,1532,0,ITI,ITI2,10,Umbria,Umbria,882015,7965,0.9,0.18
1295,2021-07-15,UMB,10577,5178,5399,568,9910,99,ITI,ITI2,10,Umbria,Umbria,882015,18542,2.1,1.2
1296,2021-07-03,UMB,6481,3248,3233,2832,3497,152,ITI,ITI2,10,Umbria,Umbria,882015,25023,2.84,0.73
1297,2021-07-20,UMB,8269,4108,4161,1096,7089,84,ITI,ITI2,10,Umbria,Umbria,882015,33292,3.77,0.94
1298,2021-09-05,UMB,3390,1798,1592,259,3117,14,ITI,ITI2,10,Umbria,Umbria,882015,36682,4.16,0.38
1299,2021-03-23,UMB,3828,1714,2114,2159,1632,37,ITI,ITI2,10,Umbria,Umbria,882015,40510,4.59,0.43
1300,2021-08-27,UMB,4601,2419,2182,1499,3000,102,ITI,ITI2,10,Umbria,Umbria,882015,45111,5.11,0.52
1301,2021-07-01,UMB,9747,4819,4928,3303,6290,154,ITI,ITI2,10,Umbria,Umbria,882015,54858,6.22,1.11
1302,2021-02-08,UMB,637,203,434,88,549,0,ITI,ITI2,10,Umbria,Umbria,882015,55495,6.29,0.07
1303,2021-05-19,UMB,9432,4219,5213,5600,3745,87,ITI,ITI2,10,Umbria,Umbria,882015,64927,7.36,1.07
1304,2021-04-23,UMB,6659,2821,3838,3301,3159,199,ITI,ITI2,10,Umbria,Umbria,882015,71586,8.12,0.75
1305,2021-02-25,UMB,1334,496,838,1274,52,8,ITI,ITI2,10,Umbria,Umbria,882015,72920,8.27,0.15
1306,2021-03-11,UMB,3687,1799,1888,2668,1008,11,ITI,ITI2,10,Umbria,Umbria,882015,76607,8.69,0.42
1307,2021-01-13,UMB,451,139,312,451,0,0,ITI,ITI2,10,Umbria,Umbria,882015,77058,8.74,0.05
1308,2021-06-19,UMB,4589,2206,2383,2463,2033,93,ITI,ITI2,10,Umbria,Umbria,882015,81647,9.26,0.52
1309,2021-01-06,UMB,847,326,521,847,0,0,ITI,ITI2,10,Umbria,Umbria,882015,82494,9.35,0.1
1310,2021-06-12,UMB,7723,3689,4034,5962,1580,181,ITI,ITI2,10,Umbria,Umbria,882015,90217,10.23,0.88
1311,2021-08-15,UMB,4393,2387,2006,2868,1382,143,ITI,ITI2,10,Umbria,Umbria,882015,94610,10.73,0.5
1312,2021-07-29,UMB,8203,4228,3975,2144,5940,119,ITI,ITI2,10,Umbria,Umbria,882015,102813,11.66,0.93
1313,2021-05-07,UMB,10134,4716,5418,6656,3192,286,ITI,ITI2,10,Umbria,Umbria,882015,112947,12.81,1.15
1314,2021-08-29,UMB,1947,1004,943,684,1254,9,ITI,ITI2,10,Umbria,Umbria,882015,114894,13.03,0.22
1315,2021-06-02,UMB,3926,1886,2040,3805,42,79,ITI,ITI2,10,Umbria,Umbria,882015,118820,13.47,0.45
1316,2021-09-10,UMB,4539,2484,2055,722,3773,44,ITI,ITI2,10,Umbria,Umbria,882015,123359,13.99,0.51
1317,2021-02-20,UMB,283,101,182,259,24,0,ITI,ITI2,10,Umbria,Umbria,882015,123642,14.02,0.03
1318,2021-03-09,UMB,4093,2003,2090,2796,1288,9,ITI,ITI2,10,Umbria,Umbria,882015,127735,14.48,0.46
1319,2021-08-10,UMB,7402,3935,3467,4003,3256,143,ITI,ITI2,10,Umbria,Umbria,882015,135137,15.32,0.84
1320,2021-06-14,UMB,5387,2750,2637,3253,2015,119,ITI,ITI2,10,Umbria,Umbria,882015,140524,15.93,0.61
1321,2021-02-13,UMB,114,27,87,111,3,0,ITI,ITI2,10,Umbria,Umbria,882015,140638,15.95,0.01
1322,2021-05-24,UMB,9078,4521,4557,8030,882,166,ITI,ITI2,10,Umbria,Umbria,882015,149716,16.97,1.03
1323,2021-04-18,UMB,1532,681,851,578,931,23,ITI,ITI2,10,Umbria,Umbria,882015,151248,17.15,0.17
1324,2021-01-11,UMB,1337,364,973,1337,0,0,ITI,ITI2,10,Umbria,Umbria,882015,152585,17.3,0.15
1325,2021-07-27,UMB,8146,4092,4054,2694,5335,117,ITI,ITI2,10,Umbria,Umbria,882015,160731,18.22,0.92
1326,2021-05-05,UMB,7224,3306,3918,3834,3306,84,ITI,ITI2,10,Umbria,Umbria,882015,167955,19.04,0.82
1327,2021-01-25,UMB,649,322,327,5,644,0,ITI,ITI2,10,Umbria,Umbria,882015,168604,19.12,0.07
1328,2021-07-08,UMB,9577,4634,4943,180,9350,47,ITI,ITI2,10,Umbria,Umbria,882015,178181,20.2,1.09
1329,2021-05-12,UMB,6528,3038,3490,4209,2149,170,ITI,ITI2,10,Umbria,Umbria,882015,184709,20.94,0.74
1330,2021-03-30,UMB,3990,1737,2253,2406,1545,39,ITI,ITI2,10,Umbria,Umbria,882015,188699,21.39,0.45
1331,2021-07-22,UMB,10076,4924,5152,1653,8317,106,ITI,ITI2,10,Umbria,Umbria,882015,198775,22.54,1.14
1332,2021-01-01,UMB,273,104,169,273,0,0,ITI,ITI2,10,Umbria,Umbria,882015,199048,22.57,0.03
1333,2021-04-11,UMB,3101,1506,1595,3035,49,17,ITI,ITI2,10,Umbria,Umbria,882015,202149,22.92,0.35
1334,2021-01-18,UMB,619,221,398,531,88,0,ITI,ITI2,10,Umbria,Umbria,882015,202768,22.99,0.07
1335,2021-02-06,UMB,437,163,274,34,403,0,ITI,ITI2,10,Umbria,Umbria,882015,203205,23.04,0.05
1336,2021-05-26,UMB,9665,4573,5092,8220,1253,192,ITI,ITI2,10,Umbria,Umbria,882015,212870,24.13,1.1
1337,2021-09-03,UMB,4234,2193,2041,1320,2854,60,ITI,ITI2,10,Umbria,Umbria,882015,217104,24.61,0.48
1338,2021-04-16,UMB,8101,3744,4357,6084,1838,179,ITI,ITI2,10,Umbria,Umbria,882015,225205,25.53,0.92
1339,2021-04-30,UMB,6258,2971,3287,2735,3401,122,ITI,ITI2,10,Umbria,Umbria,882015,231463,26.24,0.71
1340,2021-03-04,UMB,4486,1856,2630,3644,827,15,ITI,ITI2,10,Umbria,Umbria,882015,235949,26.75,0.51
1341,2021-08-08,UMB,5066,2712,2354,3557,1414,95,ITI,ITI2,10,Umbria,Umbria,882015,241015,27.33,0.57
1342,2021-01-20,UMB,603,221,382,603,0,0,ITI,ITI2,10,Umbria,Umbria,882015,241618,27.39,0.07
1343,2021-03-18,UMB,2987,1179,1808,1713,1266,8,ITI,ITI2,10,Umbria,Umbria,882015,244605,27.73,0.34
1344,2021-06-26,UMB,9381,4758,4623,5581,3639,161,ITI,ITI2,10,Umbria,Umbria,882015,253986,28.8,1.06
1345,2021-07-10,UMB,7690,3810,3880,66,7610,14,ITI,ITI2,10,Umbria,Umbria,882015,261676,29.67,0.87
1346,2021-04-25,UMB,4362,1687,2675,3868,83,411,ITI,ITI2,10,Umbria,Umbria,882015,266038,30.16,0.49
1347,2021-08-03,UMB,9207,4761,4446,3505,5519,183,ITI,ITI2,10,Umbria,Umbria,882015,275245,31.21,1.04
1348,2021-08-22,UMB,1470,773,697,479,977,14,ITI,ITI2,10,Umbria,Umbria,882015,276715,31.37,0.17
1349,2021-05-31,UMB,5824,2848,2976,4854,885,85,ITI,ITI2,10,Umbria,Umbria,882015,282539,32.03,0.66
1350,2021-05-14,UMB,5347,2526,2821,3353,1819,175,ITI,ITI2,10,Umbria,Umbria,882015,287886,32.64,0.61
1351,2021-02-01,UMB,1285,342,943,48,1237,0,ITI,ITI2,10,Umbria,Umbria,882015,289171,32.79,0.15
1352,2021-04-04,UMB,57,20,37,22,35,0,ITI,ITI2,10,Umbria,Umbria,882015,289228,32.79,0.01
1353,2021-06-07,UMB,6959,3436,3523,6085,696,178,ITI,ITI2,10,Umbria,Umbria,882015,296187,33.58,0.79
1354,2021-09-15,UMB,2218,1121,1097,601,1568,49,ITI,ITI2,10,Umbria,Umbria,882015,298405,33.83,0.25
1355,2021-03-16,UMB,3538,1454,2084,1909,1627,2,ITI,ITI2,10,Umbria,Umbria,882015,301943,34.23,0.4
1356,2021-02-27,UMB,1658,354,1304,1642,16,0,ITI,ITI2,10,Umbria,Umbria,882015,303601,34.42,0.19
1357,2020-12-27,UMB,88,47,41,88,0,0,ITI,ITI2,10,Umbria,Umbria,882015,303689,34.43,0.01
1358,2021-02-22,UMB,1891,807,1084,1805,86,0,ITI,ITI2,10,Umbria,Umbria,882015,305580,34.65,0.21
1359,2021-06-11,UMB,7010,3519,3491,6002,772,236,ITI,ITI2,10,Umbria,Umbria,882015,312590,35.44,0.79
1360,2021-09-07,UMB,4814,2490,2324,1023,3715,76,ITI,ITI2,10,Umbria,Umbria,882015,317404,35.99,0.55
1361,2021-05-30,UMB,5982,2999,2983,5662,202,118,ITI,ITI2,10,Umbria,Umbria,882015,323386,36.66,0.68
1362,2021-03-08,UMB,3701,1825,1876,2327,1361,13,ITI,ITI2,10,Umbria,Umbria,882015,327087,37.08,0.42
1363,2021-06-16,UMB,6326,3095,3231,3072,3100,154,ITI,ITI2,10,Umbria,Umbria,882015,333413,37.8,0.72
1364,2021-03-25,UMB,3937,1728,2209,2826,1064,47,ITI,ITI2,10,Umbria,Umbria,882015,337350,38.25,0.45
1365,2021-07-26,UMB,9092,4804,4288,3873,5092,127,ITI,ITI2,10,Umbria,Umbria,882015,346442,39.28,1.03
1366,2021-05-28,UMB,9600,4440,5160,7116,2300,184,ITI,ITI2,10,Umbria,Umbria,882015,356042,40.37,1.09
1367,2021-04-15,UMB,7665,3505,4160,5702,1889,74,ITI,ITI2,10,Umbria,Umbria,882015,363707,41.24,0.87
1368,2021-02-17,UMB,1619,748,871,1266,352,1,ITI,ITI2,10,Umbria,Umbria,882015,365326,41.42,0.18
1369,2021-07-24,UMB,8698,4368,4330,1346,7284,68,ITI,ITI2,10,Umbria,Umbria,882015,374024,42.41,0.99
1370,2021-04-20,UMB,5451,2365,3086,3429,1947,75,ITI,ITI2,10,Umbria,Umbria,882015,379475,43.02,0.62
1371,2021-01-27,UMB,842,330,512,13,829,0,ITI,ITI2,10,Umbria,Umbria,882015,380317,43.12,0.1
1372,2021-01-10,UMB,1067,274,793,1067,0,0,ITI,ITI2,10,Umbria,Umbria,882015,381384,43.24,0.12
1373,2021-05-21,UMB,8981,3672,5309,4066,4830,85,ITI,ITI2,10,Umbria,Umbria,882015,390365,44.26,1.02
1374,2021-05-04,UMB,5544,2547,2997,2355,3127,62,ITI,ITI2,10,Umbria,Umbria,882015,395909,44.89,0.63
1375,2021-04-01,UMB,4474,1911,2563,2326,2110,38,ITI,ITI2,10,Umbria,Umbria,882015,400383,45.39,0.51
1376,2021-08-12,UMB,7355,3902,3453,4590,2546,219,ITI,ITI2,10,Umbria,Umbria,882015,407738,46.23,0.83
1377,2021-06-30,UMB,10552,5326,5226,3675,6726,151,ITI,ITI2,10,Umbria,Umbria,882015,418290,47.42,1.2
1378,2021-09-02,UMB,4360,2268,2092,959,3360,41,ITI,ITI2,10,Umbria,Umbria,882015,422650,47.92,0.49
1379,2021-07-07,UMB,9499,4502,4997,88,9380,31,ITI,ITI2,10,Umbria,Umbria,882015,432149,49.0,1.08
1380,2021-05-11,UMB,6260,2842,3418,3925,2193,142,ITI,ITI2,10,Umbria,Umbria,882015,438409,49.71,0.71
1381,2021-08-19,UMB,5725,3037,2688,3935,1611,179,ITI,ITI2,10,Umbria,Umbria,882015,444134,50.35,0.65
1382,2021-08-26,UMB,4059,2151,1908,1791,2158,110,ITI,ITI2,10,Umbria,Umbria,882015,448193,50.81,0.46
1383,2021-09-14,UMB,2805,1436,1369,415,2365,25,ITI,ITI2,10,Umbria,Umbria,882015,450998,51.13,0.32
1384,2021-04-08,UMB,5904,2525,3379,4024,1807,73,ITI,ITI2,10,Umbria,Umbria,882015,456902,51.8,0.67
1385,2021-09-12,UMB,3054,1654,1400,462,2577,15,ITI,ITI2,10,Umbria,Umbria,882015,459956,52.15,0.35
1386,2021-07-17,UMB,7674,3857,3817,1287,6239,148,ITI,ITI2,10,Umbria,Umbria,882015,467630,53.02,0.87
1387,2021-06-04,UMB,8928,4413,4515,7541,1205,182,ITI,ITI2,10,Umbria,Umbria,882015,476558,54.03,1.01
1388,2021-02-18,UMB,1497,583,914,1029,467,1,ITI,ITI2,10,Umbria,Umbria,882015,478055,54.2,0.17
1389,2021-08-07,UMB,7234,3802,3432,2542,4620,72,ITI,ITI2,10,Umbria,Umbria,882015,485289,55.02,0.82
1390,2021-05-16,UMB,5227,2493,2734,5087,50,90,ITI,ITI2,10,Umbria,Umbria,882015,490516,55.61,0.59
1391,2021-08-24,UMB,4435,2247,2188,1872,2474,89,ITI,ITI2,10,Umbria,Umbria,882015,494951,56.12,0.5
1392,2021-08-05,UMB,9702,5076,4626,3840,5697,165,ITI,ITI2,10,Umbria,Umbria,882015,504653,57.22,1.1
1393,2021-07-19,UMB,7670,3842,3828,1526,6043,101,ITI,ITI2,10,Umbria,Umbria,882015,512323,58.09,0.87
1394,2021-04-27,UMB,5668,2401,3267,3054,2579,35,ITI,ITI2,10,Umbria,Umbria,882015,517991,58.73,0.64
1395,2021-02-03,UMB,727,174,553,67,660,0,ITI,ITI2,10,Umbria,Umbria,882015,518718,58.81,0.08
1396,2021-04-03,UMB,2099,712,1387,1034,1054,11,ITI,ITI2,10,Umbria,Umbria,882015,520817,59.05,0.24
1397,2021-07-12,UMB,4632,2242,2390,105,4515,12,ITI,ITI2,10,Umbria,Umbria,882015,525449,59.57,0.53
1398,2021-01-08,UMB,1193,344,849,1193,0,0,ITI,ITI2,10,Umbria,Umbria,882015,526642,59.71,0.14
1399,2021-03-01,UMB,1505,775,730,1385,114,6,ITI,ITI2,10,Umbria,Umbria,882015,528147,59.88,0.17
1400,2021-06-09,UMB,8162,3951,4211,7136,725,301,ITI,ITI2,10,Umbria,Umbria,882015,536309,60.8,0.93
1401,2021-06-23,UMB,11360,5806,5554,7679,3412,269,ITI,ITI2,10,Umbria,Umbria,882015,547669,62.09,1.29
1402,2021-03-15,UMB,4599,1941,2658,2826,1769,4,ITI,ITI2,10,Umbria,Umbria,882015,552268,62.61,0.52
1403,2021-02-10,UMB,715,350,365,700,15,0,ITI,ITI2,10,Umbria,Umbria,882015,552983,62.7,0.08
1404,2021-04-13,UMB,7683,3402,4281,5924,1669,90,ITI,ITI2,10,Umbria,Umbria,882015,560666,63.57,0.87
1405,2021-02-15,UMB,1367,692,675,1364,1,2,ITI,ITI2,10,Umbria,Umbria,882015,562033,63.72,0.15
1406,2021-01-03,UMB,270,112,158,270,0,0,ITI,ITI2,10,Umbria,Umbria,882015,562303,63.75,0.03
1407,2021-07-31,UMB,4334,2262,2072,1478,2809,47,ITI,ITI2,10,Umbria,Umbria,882015,566637,64.24,0.49
1408,2021-04-22,UMB,5458,2251,3207,2702,2674,82,ITI,ITI2,10,Umbria,Umbria,882015,572095,64.86,0.62
1409,2021-03-27,UMB,4253,1515,2738,3857,340,56,ITI,ITI2,10,Umbria,Umbria,882015,576348,65.34,0.48
1410,2021-06-18,UMB,4814,2374,2440,1569,3166,79,ITI,ITI2,10,Umbria,Umbria,882015,581162,65.89,0.55
1411,2021-07-05,UMB,8422,4083,4339,152,8256,14,ITI,ITI2,10,Umbria,Umbria,882015,589584,66.85,0.95
1412,2021-05-13,UMB,5944,2671,3273,3730,2085,129,ITI,ITI2,10,Umbria,Umbria,882015,595528,67.52,0.67
1413,2021-08-21,UMB,2790,1465,1325,1610,1115,65,ITI,ITI2,10,Umbria,Umbria,882015,598318,67.84,0.32
1414,2021-02-19,UMB,743,293,450,525,217,1,ITI,ITI2,10,Umbria,Umbria,882015,599061,67.92,0.08
1415,2021-08-04,UMB,10672,5541,5131,3311,7195,166,ITI,ITI2,10,Umbria,Umbria,882015,609733,69.13,1.21
1416,2021-03-29,UMB,3639,1605,2034,2153,1424,62,ITI,ITI2,10,Umbria,Umbria,882015,613372,69.54,0.41
1417,2021-01-31,UMB,1061,276,785,25,1036,0,ITI,ITI2,10,Umbria,Umbria,882015,614433,69.66,0.12
1418,2021-05-25,UMB,8827,4304,4523,7588,1066,173,ITI,ITI2,10,Umbria,Umbria,882015,623260,70.66,1.0
1419,2021-06-13,UMB,6767,3558,3209,6392,230,145,ITI,ITI2,10,Umbria,Umbria,882015,630027,71.43,0.77
1420,2021-05-01,UMB,5379,2642,2737,2100,3233,46,ITI,ITI2,10,Umbria,Umbria,882015,635406,72.04,0.61
1421,2021-03-05,UMB,4624,1403,3221,3950,659,15,ITI,ITI2,10,Umbria,Umbria,882015,640030,72.56,0.52
1422,2021-08-09,UMB,6696,3547,3149,3503,3033,160,ITI,ITI2,10,Umbria,Umbria,882015,646726,73.32,0.76
1423,2021-03-03,UMB,4433,1772,2661,3719,711,3,ITI,ITI2,10,Umbria,Umbria,882015,651159,73.83,0.5
1424,2021-02-05,UMB,783,234,549,18,765,0,ITI,ITI2,10,Umbria,Umbria,882015,651942,73.92,0.09
1425,2021-07-21,UMB,9856,4914,4942,1233,8536,87,ITI,ITI2,10,Umbria,Umbria,882015,661798,75.03,1.12
1426,2021-07-04,UMB,3411,1741,1670,2342,971,98,ITI,ITI2,10,Umbria,Umbria,882015,665209,75.42,0.39
1427,2021-04-12,UMB,7093,3081,4012,5316,1717,60,ITI,ITI2,10,Umbria,Umbria,882015,672302,76.22,0.8
1428,2021-01-19,UMB,102,23,79,102,0,0,ITI,ITI2,10,Umbria,Umbria,882015,672404,76.23,0.01
1429,2021-05-23,UMB,5074,1857,3217,637,4421,16,ITI,ITI2,10,Umbria,Umbria,882015,677478,76.81,0.58
1430,2021-08-31,UMB,4135,2137,1998,1223,2842,70,ITI,ITI2,10,Umbria,Umbria,882015,681613,77.28,0.47
1431,2021-08-14,UMB,5853,3233,2620,2917,2786,150,ITI,ITI2,10,Umbria,Umbria,882015,687466,77.94,0.66
1432,2021-03-17,UMB,3331,1313,2018,1855,1474,2,ITI,ITI2,10,Umbria,Umbria,882015,690797,78.32,0.38
1433,2021-01-07,UMB,1301,388,913,1301,0,0,ITI,ITI2,10,Umbria,Umbria,882015,692098,78.47,0.15
1434,2021-06-25,UMB,10241,5318,4923,5252,4785,204,ITI,ITI2,10,Umbria,Umbria,882015,702339,79.63,1.16
1435,2021-01-24,UMB,258,106,152,1,257,0,ITI,ITI2,10,Umbria,Umbria,882015,702597,79.66,0.03
1436,2021-08-16,UMB,3520,1743,1777,1977,1474,69,ITI,ITI2,10,Umbria,Umbria,882015,706117,80.06,0.4
1437,2021-08-30,UMB,1952,952,1000,1498,372,82,ITI,ITI2,10,Umbria,Umbria,882015,708069,80.28,0.22
1438,2021-06-08,UMB,7421,3659,3762,6655,557,209,ITI,ITI2,10,Umbria,Umbria,882015,715490,81.12,0.84
1439,2021-06-27,UMB,7480,3738,3742,1730,5672,78,ITI,ITI2,10,Umbria,Umbria,882015,722970,81.97,0.85
1440,2021-04-29,UMB,5240,2261,2979,2806,2343,91,ITI,ITI2,10,Umbria,Umbria,882015,728210,82.56,0.59
1441,2021-03-24,UMB,4108,1794,2314,2746,1323,39,ITI,ITI2,10,Umbria,Umbria,882015,732318,83.03,0.47
1442,2021-07-02,UMB,8757,4330,4427,2967,5609,181,ITI,ITI2,10,Umbria,Umbria,882015,741075,84.02,0.99
1443,2021-04-10,UMB,7405,3482,3923,7184,86,135,ITI,ITI2,10,Umbria,Umbria,882015,748480,84.86,0.84
1444,2021-01-17,UMB,55,17,38,55,0,0,ITI,ITI2,10,Umbria,Umbria,882015,748535,84.87,0.01
1445,2020-12-31,UMB,322,127,195,322,0,0,ITI,ITI2,10,Umbria,Umbria,882015,748857,84.9,0.04
1446,2021-08-23,UMB,5290,2820,2470,1543,3662,85,ITI,ITI2,10,Umbria,Umbria,882015,754147,85.5,0.6
1447,2021-09-09,UMB,5452,2836,2616,1037,4363,52,ITI,ITI2,10,Umbria,Umbria,882015,759599,86.12,0.62
1448,2021-06-01,UMB,4389,2090,2299,4161,156,72,ITI,ITI2,10,Umbria,Umbria,882015,763988,86.62,0.5
1449,2021-03-10,UMB,4032,1943,2089,2760,1257,15,ITI,ITI2,10,Umbria,Umbria,882015,768020,87.08,0.46
1450,2021-04-17,UMB,6696,3077,3619,5186,1343,167,ITI,ITI2,10,Umbria,Umbria,882015,774716,87.83,0.76
1451,2021-05-18,UMB,7768,3364,4404,3837,3841,90,ITI,ITI2,10,Umbria,Umbria,882015,782484,88.72,0.88
1452,2021-03-22,UMB,3562,1657,1905,2306,1246,10,ITI,ITI2,10,Umbria,Umbria,882015,786046,89.12,0.4
1453,2021-04-05,UMB,4251,1729,2522,2182,2057,12,ITI,ITI2,10,Umbria,Umbria,882015,790297,89.6,0.48
1454,2021-02-07,UMB,55,17,38,1,54,0,ITI,ITI2,10,Umbria,Umbria,882015,790352,89.61,0.01
1455,2021-07-14,UMB,6208,3011,3197,1634,4264,310,ITI,ITI2,10,Umbria,Umbria,882015,796560,90.31,0.7
1456,2021-08-01,UMB,3026,1533,1493,1330,1650,46,ITI,ITI2,10,Umbria,Umbria,882015,799586,90.65,0.34
1457,2021-07-18,UMB,7853,4063,3790,273,7553,27,ITI,ITI2,10,Umbria,Umbria,882015,807439,91.54,0.89
1458,2021-06-05,UMB,8232,3777,4455,5416,2655,161,ITI,ITI2,10,Umbria,Umbria,882015,815671,92.48,0.93
1459,2021-08-11,UMB,7622,4086,3536,3719,3717,186,ITI,ITI2,10,Umbria,Umbria,882015,823293,93.34,0.86
1460,2021-06-06,UMB,7610,3906,3704,6790,694,126,ITI,ITI2,10,Umbria,Umbria,882015,830903,94.21,0.86
1461,2021-02-24,UMB,1521,564,957,1506,15,0,ITI,ITI2,10,Umbria,Umbria,882015,832424,94.38,0.17
1462,2021-08-18,UMB,4706,2462,2244,3440,1147,119,ITI,ITI2,10,Umbria,Umbria,882015,837130,94.91,0.53
1463,2021-07-06,UMB,8600,4093,4507,149,8428,23,ITI,ITI2,10,Umbria,Umbria,882015,845730,95.89,0.98
1464,2021-05-10,UMB,6012,2814,3198,3743,2152,117,ITI,ITI2,10,Umbria,Umbria,882015,851742,96.57,0.68
1465,2021-05-08,UMB,8162,3749,4413,4806,3250,106,ITI,ITI2,10,Umbria,Umbria,882015,859904,97.49,0.93
1466,2021-01-28,UMB,1248,394,854,18,1230,0,ITI,ITI2,10,Umbria,Umbria,882015,861152,97.63,0.14
1467,2021-01-26,UMB,816,390,426,17,799,0,ITI,ITI2,10,Umbria,Umbria,882015,861968,97.73,0.09
1468,2021-02-12,UMB,674,224,450,668,6,0,ITI,ITI2,10,Umbria,Umbria,882015,862642,97.8,0.08
1469,2021-02-26,UMB,660,253,407,650,8,2,ITI,ITI2,10,Umbria,Umbria,882015,863302,97.88,0.07
1470,2021-05-06,UMB,9474,4326,5148,6028,3316,130,ITI,ITI2,10,Umbria,Umbria,882015,872776,98.95,1.07
1471,2021-07-28,UMB,8243,4337,3906,2974,5156,113,ITI,ITI2,10,Umbria,Umbria,882015,881019,99.89,0.93
1472,2021-06-15,UMB,5992,3017,2975,3798,2075,119,ITI,ITI2,10,Umbria,Umbria,882015,887011,100.57,0.68
1473,2021-06-17,UMB,6979,3545,3434,4751,2082,146,ITI,ITI2,10,Umbria,Umbria,882015,893990,101.36,0.79
1474,2021-03-26,UMB,4602,1721,2881,4345,173,84,ITI,ITI2,10,Umbria,Umbria,882015,898592,101.88,0.52
1475,2021-01-02,UMB,304,111,193,304,0,0,ITI,ITI2,10,Umbria,Umbria,882015,898896,101.91,0.03
1476,2021-09-13,UMB,2452,1235,1217,316,2113,23,ITI,ITI2,10,Umbria,Umbria,882015,901348,102.19,0.28
1477,2021-05-03,UMB,5091,2273,2818,2099,2888,104,ITI,ITI2,10,Umbria,Umbria,882015,906439,102.77,0.58
1478,2021-01-23,UMB,280,100,180,2,278,0,ITI,ITI2,10,Umbria,Umbria,882015,906719,102.8,0.03
1479,2021-01-21,UMB,609,203,406,339,269,1,ITI,ITI2,10,Umbria,Umbria,882015,907328,102.87,0.07
1480,2021-08-20,UMB,4346,2314,2032,2920,1280,146,ITI,ITI2,10,Umbria,Umbria,882015,911674,103.36,0.49
1481,2021-03-07,UMB,846,180,666,838,7,1,ITI,ITI2,10,Umbria,Umbria,882015,912520,103.46,0.1
1482,2021-09-08,UMB,4616,2472,2144,987,3557,72,ITI,ITI2,10,Umbria,Umbria,882015,917136,103.98,0.52
1483,2021-05-29,UMB,7862,3614,4248,6177,1571,114,ITI,ITI2,10,Umbria,Umbria,882015,924998,104.87,0.89
1484,2021-01-16,UMB,204,61,143,203,0,1,ITI,ITI2,10,Umbria,Umbria,882015,925202,104.9,0.02
1485,2021-02-02,UMB,945,272,673,32,913,0,ITI,ITI2,10,Umbria,Umbria,882015,926147,105.0,0.11
1486,2021-04-26,UMB,5402,2342,3060,3105,2255,42,ITI,ITI2,10,Umbria,Umbria,882015,931549,105.62,0.61
1487,2021-04-09,UMB,6750,3130,3620,6412,216,122,ITI,ITI2,10,Umbria,Umbria,882015,938299,106.38,0.77
1488,2021-04-28,UMB,5394,2332,3062,2939,2398,57,ITI,ITI2,10,Umbria,Umbria,882015,943693,106.99,0.61
1489,2021-08-06,UMB,8240,4309,3931,3330,4822,88,ITI,ITI2,10,Umbria,Umbria,882015,951933,107.93,0.93
1490,2021-02-04,UMB,736,226,510,26,710,0,ITI,ITI2,10,Umbria,Umbria,882015,952669,108.01,0.08
1491,2021-05-15,UMB,4998,1886,3112,1766,3168,64,ITI,ITI2,10,Umbria,Umbria,882015,957667,108.58,0.57
1492,2021-02-21,UMB,1,0,1,1,0,0,ITI,ITI2,10,Umbria,Umbria,882015,957668,108.58,0.0
1493,2021-09-01,UMB,4598,2369,2229,1136,3403,59,ITI,ITI2,10,Umbria,Umbria,882015,962266,109.1,0.52
1494,2021-06-10,UMB,7568,3769,3799,6464,790,314,ITI,ITI2,10,Umbria,Umbria,882015,969834,109.96,0.86
1495,2021-08-13,UMB,6972,3869,3103,4244,2526,202,ITI,ITI2,10,Umbria,Umbria,882015,976806,110.75,0.79
1496,2021-02-11,UMB,839,348,491,834,5,0,ITI,ITI2,10,Umbria,Umbria,882015,977645,110.84,0.1
1497,2021-05-22,UMB,6985,2762,4223,2603,4333,49,ITI,ITI2,10,Umbria,Umbria,882015,984630,111.63,0.79
1498,2021-07-11,UMB,5875,2967,2908,89,5785,1,ITI,ITI2,10,Umbria,Umbria,882015,990505,112.3,0.67
1499,2021-04-02,UMB,4349,1782,2567,3548,756,45,ITI,ITI2,10,Umbria,Umbria,882015,994854,112.79,0.49
1500,2021-01-09,UMB,1718,495,1223,1718,0,0,ITI,ITI2,10,Umbria,Umbria,882015,996572,112.99,0.19
1501,2021-09-06,UMB,4576,2385,2191,893,3645,38,ITI,ITI2,10,Umbria,Umbria,882015,1001148,113.51,0.52
1502,2021-07-25,UMB,7310,3852,3458,1167,6099,44,ITI,ITI2,10,Umbria,Umbria,882015,1008458,114.34,0.83
1503,2021-01-05,UMB,855,430,425,855,0,0,ITI,ITI2,10,Umbria,Umbria,882015,1009313,114.43,0.1
1504,2021-08-02,UMB,5537,2897,2640,259,5256,22,ITI,ITI2,10,Umbria,Umbria,882015,1014850,115.06,0.63
1505,2021-06-20,UMB,6225,3007,3218,1577,4605,43,ITI,ITI2,10,Umbria,Umbria,882015,1021075,115.77,0.71
1506,2021-04-24,UMB,4566,1962,2604,3277,1183,106,ITI,ITI2,10,Umbria,Umbria,882015,1025641,116.28,0.52
1507,2021-01-12,UMB,838,247,591,838,0,0,ITI,ITI2,10,Umbria,Umbria,882015,1026479,116.38,0.1
1508,2021-07-13,UMB,4235,2006,2229,78,4149,8,ITI,ITI2,10,Umbria,Umbria,882015,1030714,116.86,0.48
1509,2021-04-21,UMB,5332,2320,3012,3061,2232,39,ITI,ITI2,10,Umbria,Umbria,882015,1036046,117.46,0.6
1510,2021-07-30,UMB,6219,3243,2976,3185,2913,121,ITI,ITI2,10,Umbria,Umbria,882015,1042265,118.17,0.71
1511,2021-03-02,UMB,3646,1346,2300,3637,6,3,ITI,ITI2,10,Umbria,Umbria,882015,1045911,118.58,0.41
1512,2021-06-24,UMB,10267,5168,5099,6025,4013,229,ITI,ITI2,10,Umbria,Umbria,882015,1056178,119.75,1.16
1513,2021-04-19,UMB,5038,2228,2810,2932,2048,58,ITI,ITI2,10,Umbria,Umbria,882015,1061216,120.32,0.57
1514,2021-03-14,UMB,66,48,18,66,0,0,ITI,ITI2,10,Umbria,Umbria,882015,1061282,120.32,0.01
1515,2021-06-22,UMB,8091,4105,3986,5146,2800,145,ITI,ITI2,10,Umbria,Umbria,882015,1069373,121.24,0.92
1516,2021-03-12,UMB,2695,1082,1613,2191,496,8,ITI,ITI2,10,Umbria,Umbria,882015,1072068,121.55,0.31
1517,2021-03-21,UMB,676,338,338,673,0,3,ITI,ITI2,10,Umbria,Umbria,882015,1072744,121.62,0.08
1518,2021-08-25,UMB,4289,2232,2057,1542,2666,81,ITI,ITI2,10,Umbria,Umbria,882015,1077033,122.11,0.49
1519,2021-06-29,UMB,9975,5083,4892,4112,5703,160,ITI,ITI2,10,Umbria,Umbria,882015,1087008,123.24,1.13
1520,2021-05-17,UMB,6379,3068,3311,4113,2180,86,ITI,ITI2,10,Umbria,Umbria,882015,1093387,123.96,0.72
1521,2021-01-14,UMB,725,192,533,725,0,0,ITI,ITI2,10,Umbria,Umbria,882015,1094112,124.05,0.08
1522,2021-03-19,UMB,1744,566,1178,1083,656,5,ITI,ITI2,10,Umbria,Umbria,882015,1095856,124.24,0.2
1523,2021-08-17,UMB,3665,1908,1757,2489,1088,88,ITI,ITI2,10,Umbria,Umbria,882015,1099521,124.66,0.42
1524,2021-06-21,UMB,7552,3953,3599,5068,2338,146,ITI,ITI2,10,Umbria,Umbria,882015,1107073,125.52,0.86
1525,2021-03-06,UMB,4308,1149,3159,4136,138,34,ITI,ITI2,10,Umbria,Umbria,882015,1111381,126.0,0.49
1526,2021-01-22,UMB,276,105,171,32,244,0,ITI,ITI2,10,Umbria,Umbria,882015,1111657,126.04,0.03
1527,2021-06-28,UMB,9831,4844,4987,3712,5990,129,ITI,ITI2,10,Umbria,Umbria,882015,1121488,127.15,1.11
1528,2021-05-02,UMB,3782,1867,1915,1298,2455,29,ITI,ITI2,10,Umbria,Umbria,882015,1125270,127.58,0.43
1529,2021-03-20,UMB,2320,845,1475,2290,25,5,ITI,ITI2,10,Umbria,Umbria,882015,1127590,127.84,0.26
1530,2021-03-13,UMB,1735,524,1211,1486,249,0,ITI,ITI2,10,Umbria,Umbria,882015,1129325,128.04,0.2
1531,2021-01-15,UMB,698,213,485,698,0,0,ITI,ITI2,10,Umbria,Umbria,882015,1130023,128.12,0.08
1532,2021-01-29,UMB,1240,350,890,79,1161,0,ITI,ITI2,10,Umbria,Umbria,882015,1131263,128.26,0.14
1533,2021-05-09,UMB,5764,2756,3008,5253,391,120,ITI,ITI2,10,Umbria,Umbria,882015,1137027,128.91,0.65
1534,2021-09-04,UMB,3435,1776,1659,1099,2274,62,ITI,ITI2,10,Umbria,Umbria,882015,1140462,129.3,0.39
1535,2021-07-09,UMB,9569,4631,4938,128,9417,24,ITI,ITI2,10,Umbria,Umbria,882015,1150031,130.39,1.08
1536,2021-07-23,UMB,10666,5453,5213,1333,9227,106,ITI,ITI2,10,Umbria,Umbria,882015,1160697,131.6,1.21
1537,2021-08-28,UMB,2770,1429,1341,1357,1342,71,ITI,ITI2,10,Umbria,Umbria,882015,1163467,131.91,0.31
1538,2021-07-16,UMB,9630,4899,4731,665,8886,79,ITI,ITI2,10,Umbria,Umbria,882015,1173097,133.0,1.09
1539,2021-05-20,UMB,9873,4610,5263,6105,3658,110,ITI,ITI2,10,Umbria,Umbria,882015,1182970,134.12,1.12
1540,2021-09-11,UMB,3382,1869,1513,641,2698,43,ITI,ITI2,10,Umbria,Umbria,882015,1186352,134.5,0.38
1541,2021-03-31,UMB,3900,1730,2170,2183,1685,32,ITI,ITI2,10,Umbria,Umbria,882015,1190252,134.95,0.44
1542,2021-02-16,UMB,1308,655,653,1299,9,0,ITI,ITI2,10,Umbria,Umbria,882015,1191560,135.1,0.15
1543,2021-05-27,UMB,9982,4871,5111,8475,1325,182,ITI,ITI2,10,Umbria,Umbria,882015,1201542,136.23,1.13
1544,2021-01-04,UMB,810,397,413,810,0,0,ITI,ITI2,10,Umbria,Umbria,882015,1202352,136.32,0.09
1545,2021-04-14,UMB,8159,3682,4477,6100,1980,79,ITI,ITI2,10,Umbria,Umbria,882015,1210511,137.24,0.93
1546,2021-06-03,UMB,9051,4474,4577,8584,290,177,ITI,ITI2,10,Umbria,Umbria,882015,1219562,138.27,1.03
1547,2021-04-07,UMB,5627,2305,3322,3534,2006,87,ITI,ITI2,10,Umbria,Umbria,882015,1225189,138.91,0.64
1548,2021-02-23,UMB,1691,657,1034,1648,42,1,ITI,ITI2,10,Umbria,Umbria,882015,1226880,139.1,0.19
1549,2021-05-20,MAR,12685,5961,6724,7537,4897,251,ITI,ITI3,11,Marche,Marche,1525271,12685,0.83,0.83
1550,2021-02-07,MAR,1872,735,1137,331,1529,12,ITI,ITI3,11,Marche,Marche,1525271,14557,0.95,0.12
1551,2021-07-23,MAR,15542,8279,7263,2527,12790,225,ITI,ITI3,11,Marche,Marche,1525271,30099,1.97,1.02
1552,2021-01-26,MAR,2021,747,1274,69,1943,9,ITI,ITI3,11,Marche,Marche,1525271,32120,2.11,0.13
1553,2021-07-11,MAR,10401,5221,5180,1605,8658,138,ITI,ITI3,11,Marche,Marche,1525271,42521,2.79,0.68
1554,2021-04-19,MAR,9609,4503,5106,7897,1588,124,ITI,ITI3,11,Marche,Marche,1525271,52130,3.42,0.63
1555,2021-07-28,MAR,14198,7369,6829,3249,10717,232,ITI,ITI3,11,Marche,Marche,1525271,66328,4.35,0.93
1556,2021-09-06,MAR,6374,3388,2986,1770,4391,213,ITI,ITI3,11,Marche,Marche,1525271,72702,4.77,0.42
1557,2021-05-27,MAR,13733,6818,6915,9180,4301,252,ITI,ITI3,11,Marche,Marche,1525271,86435,5.67,0.9
1558,2021-03-31,MAR,7378,3090,4288,4262,3025,91,ITI,ITI3,11,Marche,Marche,1525271,93813,6.15,0.48
1559,2021-09-04,MAR,5448,2975,2473,1640,3624,184,ITI,ITI3,11,Marche,Marche,1525271,99261,6.51,0.36
1560,2021-08-11,MAR,7573,4101,3472,3171,4165,237,ITI,ITI3,11,Marche,Marche,1525271,106834,7.0,0.5
1561,2021-06-15,MAR,13197,6572,6625,9827,3052,318,ITI,ITI3,11,Marche,Marche,1525271,120031,7.87,0.87
1562,2021-01-12,MAR,1237,418,819,1224,0,13,ITI,ITI3,11,Marche,Marche,1525271,121268,7.95,0.08
1563,2021-06-22,MAR,13220,6483,6737,6476,6461,283,ITI,ITI3,11,Marche,Marche,1525271,134488,8.82,0.87
1564,2021-03-24,MAR,7098,3019,4079,3309,3716,73,ITI,ITI3,11,Marche,Marche,1525271,141586,9.28,0.47
1565,2021-06-01,MAR,12055,6157,5898,9679,2090,286,ITI,ITI3,11,Marche,Marche,1525271,153641,10.07,0.79
1566,2021-03-10,MAR,5713,2442,3271,4479,1180,54,ITI,ITI3,11,Marche,Marche,1525271,159354,10.45,0.37
1567,2021-02-21,MAR,376,141,235,363,1,12,ITI,ITI3,11,Marche,Marche,1525271,159730,10.47,0.02
1568,2021-04-05,MAR,5703,2367,3336,4352,1269,82,ITI,ITI3,11,Marche,Marche,1525271,165433,10.85,0.37
1569,2021-06-27,MAR,9949,4819,5130,4486,5292,171,ITI,ITI3,11,Marche,Marche,1525271,175382,11.5,0.65
1570,2021-03-19,MAR,3881,1621,2260,325,3544,12,ITI,ITI3,11,Marche,Marche,1525271,179263,11.75,0.25
1571,2021-01-21,MAR,922,262,660,577,328,17,ITI,ITI3,11,Marche,Marche,1525271,180185,11.81,0.06
1572,2021-05-01,MAR,9328,3927,5401,3500,5751,77,ITI,ITI3,11,Marche,Marche,1525271,189513,12.42,0.61
1573,2021-08-06,MAR,11704,6353,5351,4143,7279,282,ITI,ITI3,11,Marche,Marche,1525271,201217,13.19,0.77
1574,2021-05-15,MAR,14118,6441,7677,7826,6044,248,ITI,ITI3,11,Marche,Marche,1525271,215335,14.12,0.93
1575,2021-08-23,MAR,6196,3341,2855,2278,3650,268,ITI,ITI3,11,Marche,Marche,1525271,221531,14.52,0.41
1576,2021-02-19,MAR,2003,740,1263,1827,135,41,ITI,ITI3,11,Marche,Marche,1525271,223534,14.66,0.13
1577,2021-07-18,MAR,12125,6310,5815,1333,10674,118,ITI,ITI3,11,Marche,Marche,1525271,235659,15.45,0.79
1578,2021-01-31,MAR,1921,772,1149,93,1824,4,ITI,ITI3,11,Marche,Marche,1525271,237580,15.58,0.13
1579,2021-04-07,MAR,8874,3932,4942,8357,369,148,ITI,ITI3,11,Marche,Marche,1525271,246454,16.16,0.58
1580,2021-02-09,MAR,125,42,83,46,79,0,ITI,ITI3,11,Marche,Marche,1525271,246579,16.17,0.01
1581,2021-07-16,MAR,15838,8239,7599,1844,13736,258,ITI,ITI3,11,Marche,Marche,1525271,262417,17.2,1.04
1582,2021-06-12,MAR,13781,7315,6466,12104,1346,331,ITI,ITI3,11,Marche,Marche,1525271,276198,18.11,0.9
1583,2021-02-14,MAR,738,301,437,726,0,12,ITI,ITI3,11,Marche,Marche,1525271,276936,18.16,0.05
1584,2021-08-16,MAR,5165,2781,2384,2983,2022,160,ITI,ITI3,11,Marche,Marche,1525271,282101,18.5,0.34
1585,2021-05-08,MAR,12293,5486,6807,4850,7265,178,ITI,ITI3,11,Marche,Marche,1525271,294394,19.3,0.81
1586,2021-07-30,MAR,14714,7863,6851,4867,9559,288,ITI,ITI3,11,Marche,Marche,1525271,309108,20.27,0.96
1587,2021-07-09,MAR,14903,7502,7401,2557,12132,214,ITI,ITI3,11,Marche,Marche,1525271,324011,21.24,0.98
1588,2021-09-13,MAR,8072,4281,3791,2051,5778,243,ITI,ITI3,11,Marche,Marche,1525271,332083,21.77,0.53
1589,2021-03-29,MAR,5898,2584,3314,3391,2458,49,ITI,ITI3,11,Marche,Marche,1525271,337981,22.16,0.39
1590,2021-06-03,MAR,14639,7484,7155,12082,2252,305,ITI,ITI3,11,Marche,Marche,1525271,352620,23.12,0.96
1591,2021-04-26,MAR,9177,4063,5114,6019,3028,130,ITI,ITI3,11,Marche,Marche,1525271,361797,23.72,0.6
1592,2021-08-18,MAR,6422,3422,3000,3215,2872,335,ITI,ITI3,11,Marche,Marche,1525271,368219,24.14,0.42
1593,2021-08-04,MAR,12002,6380,5622,4059,7701,242,ITI,ITI3,11,Marche,Marche,1525271,380221,24.93,0.79
1594,2021-01-19,MAR,233,87,146,140,90,3,ITI,ITI3,11,Marche,Marche,1525271,380454,24.94,0.02
1595,2021-02-02,MAR,1193,398,795,70,1123,0,ITI,ITI3,11,Marche,Marche,1525271,381647,25.02,0.08
1596,2021-05-13,MAR,12614,5699,6915,6823,5508,283,ITI,ITI3,11,Marche,Marche,1525271,394261,25.85,0.83
1597,2021-04-12,MAR,8572,3774,4798,7931,482,159,ITI,ITI3,11,Marche,Marche,1525271,402833,26.41,0.56
1598,2021-01-02,MAR,458,143,315,456,0,2,ITI,ITI3,11,Marche,Marche,1525271,403291,26.44,0.03
1599,2021-03-05,MAR,6226,2874,3352,4691,1469,66,ITI,ITI3,11,Marche,Marche,1525271,409517,26.85,0.41
1600,2021-01-07,MAR,1821,642,1179,1804,0,17,ITI,ITI3,11,Marche,Marche,1525271,411338,26.97,0.12
1601,2021-03-12,MAR,4681,1999,2682,3346,1280,55,ITI,ITI3,11,Marche,Marche,1525271,416019,27.28,0.31
1602,2021-01-14,MAR,2019,696,1323,1995,0,24,ITI,ITI3,11,Marche,Marche,1525271,418038,27.41,0.13
1603,2021-06-20,MAR,11161,5547,5614,5990,4989,182,ITI,ITI3,11,Marche,Marche,1525271,429199,28.14,0.73
1604,2021-03-17,MAR,3477,1525,1952,105,3370,2,ITI,ITI3,11,Marche,Marche,1525271,432676,28.37,0.23
1605,2021-08-30,MAR,5677,2841,2836,2358,3049,270,ITI,ITI3,11,Marche,Marche,1525271,438353,28.74,0.37
1606,2021-02-28,MAR,2836,1251,1585,2822,6,8,ITI,ITI3,11,Marche,Marche,1525271,441189,28.93,0.19
1607,2021-06-08,MAR,14099,7094,7005,11195,2611,293,ITI,ITI3,11,Marche,Marche,1525271,455288,29.85,0.92
1608,2021-07-04,MAR,10896,5445,5451,3204,7531,161,ITI,ITI3,11,Marche,Marche,1525271,466184,30.56,0.71
1609,2021-09-11,MAR,3663,1897,1766,1370,2124,169,ITI,ITI3,11,Marche,Marche,1525271,469847,30.8,0.24
1610,2020-12-31,MAR,392,184,208,390,0,2,ITI,ITI3,11,Marche,Marche,1525271,470239,30.83,0.03
1611,2021-04-16,MAR,10086,4705,5381,9349,526,211,ITI,ITI3,11,Marche,Marche,1525271,480325,31.49,0.66
1612,2021-07-25,MAR,9351,4933,4418,1004,8249,98,ITI,ITI3,11,Marche,Marche,1525271,489676,32.1,0.61
1613,2021-01-04,MAR,1529,574,955,1516,0,13,ITI,ITI3,11,Marche,Marche,1525271,491205,32.2,0.1
1614,2021-04-14,MAR,10220,4565,5655,9651,369,200,ITI,ITI3,11,Marche,Marche,1525271,501425,32.87,0.67
1615,2021-01-09,MAR,1720,608,1112,1700,0,20,ITI,ITI3,11,Marche,Marche,1525271,503145,32.99,0.11
1616,2021-04-02,MAR,6894,2988,3906,6042,739,113,ITI,ITI3,11,Marche,Marche,1525271,510039,33.44,0.45
1617,2021-03-16,MAR,3522,1523,1999,285,3231,6,ITI,ITI3,11,Marche,Marche,1525271,513561,33.67,0.23
1618,2021-06-24,MAR,13846,6680,7166,6188,7387,271,ITI,ITI3,11,Marche,Marche,1525271,527407,34.58,0.91
1619,2021-02-18,MAR,2146,787,1359,1806,288,52,ITI,ITI3,11,Marche,Marche,1525271,529553,34.72,0.14
1620,2021-05-29,MAR,12875,6239,6636,8117,4540,218,ITI,ITI3,11,Marche,Marche,1525271,542428,35.56,0.84
1621,2021-09-15,MAR,3622,1985,1637,634,2921,67,ITI,ITI3,11,Marche,Marche,1525271,546050,35.8,0.24
1622,2021-02-16,MAR,1287,475,812,1225,30,32,ITI,ITI3,11,Marche,Marche,1525271,547337,35.88,0.08
1623,2021-08-25,MAR,5584,2990,2594,2724,2539,321,ITI,ITI3,11,Marche,Marche,1525271,552921,36.25,0.37
1624,2021-03-07,MAR,5180,2107,3073,4377,754,49,ITI,ITI3,11,Marche,Marche,1525271,558101,36.59,0.34
1625,2021-08-08,MAR,5638,3020,2618,1682,3845,111,ITI,ITI3,11,Marche,Marche,1525271,563739,36.96,0.37
1626,2021-07-06,MAR,13966,6923,7043,3144,10598,224,ITI,ITI3,11,Marche,Marche,1525271,577705,37.88,0.92
1627,2021-07-20,MAR,14400,7436,6964,1771,12454,175,ITI,ITI3,11,Marche,Marche,1525271,592105,38.82,0.94
1628,2021-01-23,MAR,557,190,367,118,436,3,ITI,ITI3,11,Marche,Marche,1525271,592662,38.86,0.04
1629,2021-06-29,MAR,13372,6599,6773,4927,8215,230,ITI,ITI3,11,Marche,Marche,1525271,606034,39.73,0.88
1630,2021-05-03,MAR,10410,4690,5720,4857,5414,139,ITI,ITI3,11,Marche,Marche,1525271,616444,40.42,0.68
1631,2021-03-28,MAR,4128,1741,2387,2397,1693,38,ITI,ITI3,11,Marche,Marche,1525271,620572,40.69,0.27
1632,2021-01-30,MAR,1905,668,1237,24,1881,0,ITI,ITI3,11,Marche,Marche,1525271,622477,40.81,0.12
1633,2021-05-10,MAR,9464,4345,5119,4751,4564,149,ITI,ITI3,11,Marche,Marche,1525271,631941,41.43,0.62
1634,2021-03-14,MAR,2499,1032,1467,1896,592,11,ITI,ITI3,11,Marche,Marche,1525271,634440,41.6,0.16
1635,2021-03-21,MAR,4506,1873,2633,1612,2877,17,ITI,ITI3,11,Marche,Marche,1525271,638946,41.89,0.3
1636,2021-02-06,MAR,2463,902,1561,512,1942,9,ITI,ITI3,11,Marche,Marche,1525271,641409,42.05,0.16
1637,2020-12-30,MAR,17,5,12,17,0,0,ITI,ITI3,11,Marche,Marche,1525271,641426,42.05,0.0
1638,2021-04-09,MAR,9571,4191,5380,9149,200,222,ITI,ITI3,11,Marche,Marche,1525271,650997,42.68,0.63
1639,2021-07-27,MAR,14371,7538,6833,3033,11112,226,ITI,ITI3,11,Marche,Marche,1525271,665368,43.62,0.94
1640,2021-01-06,MAR,2215,804,1411,2196,0,19,ITI,ITI3,11,Marche,Marche,1525271,667583,43.77,0.15
1641,2021-03-02,MAR,5002,1967,3035,4370,566,66,ITI,ITI3,11,Marche,Marche,1525271,672585,44.1,0.33
1642,2021-06-10,MAR,14933,7696,7237,12577,2013,343,ITI,ITI3,11,Marche,Marche,1525271,687518,45.08,0.98
1643,2021-09-01,MAR,6204,3279,2925,2019,3952,233,ITI,ITI3,11,Marche,Marche,1525271,693722,45.48,0.41
1644,2021-08-15,MAR,226,113,113,206,13,7,ITI,ITI3,11,Marche,Marche,1525271,693948,45.5,0.01
1645,2021-05-24,MAR,11000,5193,5807,7957,2866,177,ITI,ITI3,11,Marche,Marche,1525271,704948,46.22,0.72
1646,2021-05-22,MAR,11941,5720,6221,7321,4449,171,ITI,ITI3,11,Marche,Marche,1525271,716889,47.0,0.78
1647,2021-02-11,MAR,1988,657,1331,1557,390,41,ITI,ITI3,11,Marche,Marche,1525271,718877,47.13,0.13
1648,2021-05-05,MAR,11696,5321,6375,5101,6433,162,ITI,ITI3,11,Marche,Marche,1525271,730573,47.9,0.77
1649,2021-08-13,MAR,6751,3759,2992,3388,3151,212,ITI,ITI3,11,Marche,Marche,1525271,737324,48.34,0.44
1650,2021-02-04,MAR,2389,844,1545,107,2277,5,ITI,ITI3,11,Marche,Marche,1525271,739713,48.5,0.16
1651,2021-01-18,MAR,696,237,459,536,149,11,ITI,ITI3,11,Marche,Marche,1525271,740409,48.54,0.05
1652,2021-04-28,MAR,10938,4983,5955,6018,4745,175,ITI,ITI3,11,Marche,Marche,1525271,751347,49.26,0.72
1653,2021-01-16,MAR,2040,735,1305,1989,0,51,ITI,ITI3,11,Marche,Marche,1525271,753387,49.39,0.13
1654,2021-06-19,MAR,14697,7404,7293,7749,6683,265,ITI,ITI3,11,Marche,Marche,1525271,768084,50.36,0.96
1655,2021-05-31,MAR,11782,5944,5838,8599,2931,252,ITI,ITI3,11,Marche,Marche,1525271,779866,51.13,0.77
1656,2021-05-17,MAR,12049,5650,6399,7465,4355,229,ITI,ITI3,11,Marche,Marche,1525271,791915,51.92,0.79
1657,2021-02-25,MAR,3561,1465,2096,3317,181,63,ITI,ITI3,11,Marche,Marche,1525271,795476,52.15,0.23
1658,2021-08-01,MAR,7497,4049,3448,1835,5577,85,ITI,ITI3,11,Marche,Marche,1525271,802973,52.64,0.49
1659,2021-06-05,MAR,13943,7010,6933,11519,2058,366,ITI,ITI3,11,Marche,Marche,1525271,816916,53.56,0.91
1660,2021-04-23,MAR,11318,5222,6096,8097,3055,166,ITI,ITI3,11,Marche,Marche,1525271,828234,54.3,0.74
1661,2021-01-11,MAR,1183,413,770,1165,0,18,ITI,ITI3,11,Marche,Marche,1525271,829417,54.38,0.08
1662,2021-04-21,MAR,10790,4969,5821,9426,1196,168,ITI,ITI3,11,Marche,Marche,1525271,840207,55.09,0.71
1663,2021-01-28,MAR,2091,726,1365,158,1932,1,ITI,ITI3,11,Marche,Marche,1525271,842298,55.22,0.14
1664,2021-04-04,MAR,3835,1797,2038,2614,1169,52,ITI,ITI3,11,Marche,Marche,1525271,846133,55.47,0.25
1665,2021-07-13,MAR,14853,7278,7575,1456,13268,129,ITI,ITI3,11,Marche,Marche,1525271,860986,56.45,0.97
1666,2021-08-31,MAR,4829,2561,2268,2013,2586,230,ITI,ITI3,11,Marche,Marche,1525271,865815,56.76,0.32
1667,2021-06-09,MAR,14279,7417,6862,12108,1869,302,ITI,ITI3,11,Marche,Marche,1525271,880094,57.7,0.94
1668,2021-06-07,MAR,13322,6589,6733,10569,2450,303,ITI,ITI3,11,Marche,Marche,1525271,893416,58.57,0.87
1669,2021-02-27,MAR,3401,1457,1944,3158,209,34,ITI,ITI3,11,Marche,Marche,1525271,896817,58.8,0.22
1670,2021-07-17,MAR,15140,7792,7348,1384,13544,212,ITI,ITI3,11,Marche,Marche,1525271,911957,59.79,0.99
1671,2021-05-21,MAR,13909,6594,7315,7225,6472,212,ITI,ITI3,11,Marche,Marche,1525271,925866,60.7,0.91
1672,2021-09-12,MAR,254,129,125,173,47,34,ITI,ITI3,11,Marche,Marche,1525271,926120,60.72,0.02
1673,2021-08-29,MAR,453,255,198,245,182,26,ITI,ITI3,11,Marche,Marche,1525271,926573,60.75,0.03
1674,2021-03-04,MAR,6540,2895,3645,5080,1395,65,ITI,ITI3,11,Marche,Marche,1525271,933113,61.18,0.43
1675,2021-03-13,MAR,5808,2681,3127,1764,4003,41,ITI,ITI3,11,Marche,Marche,1525271,938921,61.56,0.38
1676,2021-08-17,MAR,7595,4040,3555,3085,4286,224,ITI,ITI3,11,Marche,Marche,1525271,946516,62.06,0.5
1677,2021-06-21,MAR,12607,6184,6423,5479,6881,247,ITI,ITI3,11,Marche,Marche,1525271,959123,62.88,0.83
1678,2021-05-09,MAR,8866,4022,4844,3559,5230,77,ITI,ITI3,11,Marche,Marche,1525271,967989,63.46,0.58
1679,2021-05-07,MAR,12838,5803,7035,3550,9186,102,ITI,ITI3,11,Marche,Marche,1525271,980827,64.31,0.84
1680,2021-02-13,MAR,1093,462,631,987,82,24,ITI,ITI3,11,Marche,Marche,1525271,981920,64.38,0.07
1681,2021-03-26,MAR,6393,2626,3767,3475,2860,58,ITI,ITI3,11,Marche,Marche,1525271,988313,64.8,0.42
1682,2021-06-17,MAR,15206,7566,7640,8797,6111,298,ITI,ITI3,11,Marche,Marche,1525271,1003519,65.79,1.0
1683,2021-03-09,MAR,5430,2293,3137,4457,881,92,ITI,ITI3,11,Marche,Marche,1525271,1008949,66.15,0.36
1684,2021-07-22,MAR,15746,8048,7698,2017,13487,242,ITI,ITI3,11,Marche,Marche,1525271,1024695,67.18,1.03
1685,2021-04-13,MAR,9839,4261,5578,9394,234,211,ITI,ITI3,11,Marche,Marche,1525271,1034534,67.83,0.65
1686,2021-07-05,MAR,13167,6510,6657,2918,10077,172,ITI,ITI3,11,Marche,Marche,1525271,1047701,68.69,0.86
1687,2021-06-16,MAR,13755,6912,6843,9126,4365,264,ITI,ITI3,11,Marche,Marche,1525271,1061456,69.59,0.9
1688,2021-06-02,MAR,11903,5939,5964,11028,679,196,ITI,ITI3,11,Marche,Marche,1525271,1073359,70.37,0.78
1689,2021-09-08,MAR,7230,3781,3449,2063,4909,258,ITI,ITI3,11,Marche,Marche,1525271,1080589,70.85,0.47
1690,2021-04-30,MAR,14166,6204,7962,5395,8573,198,ITI,ITI3,11,Marche,Marche,1525271,1094755,71.77,0.93
1691,2021-04-11,MAR,7117,3116,4001,6681,287,149,ITI,ITI3,11,Marche,Marche,1525271,1101872,72.24,0.47
1692,2021-03-11,MAR,6636,2824,3812,5144,1413,79,ITI,ITI3,11,Marche,Marche,1525271,1108508,72.68,0.44
1693,2021-03-25,MAR,6703,2794,3909,3186,3456,61,ITI,ITI3,11,Marche,Marche,1525271,1115211,73.12,0.44
1694,2021-07-03,MAR,13843,6991,6852,4136,9395,312,ITI,ITI3,11,Marche,Marche,1525271,1129054,74.02,0.91
1695,2021-02-20,MAR,4163,1732,2431,4042,111,10,ITI,ITI3,11,Marche,Marche,1525271,1133217,74.3,0.27
1696,2021-08-22,MAR,110,61,49,76,26,8,ITI,ITI3,11,Marche,Marche,1525271,1133327,74.3,0.01
1697,2021-01-27,MAR,2119,778,1341,113,2004,2,ITI,ITI3,11,Marche,Marche,1525271,1135446,74.44,0.14
1698,2021-04-20,MAR,10756,5030,5726,9147,1472,137,ITI,ITI3,11,Marche,Marche,1525271,1146202,75.15,0.71
1699,2021-07-29,MAR,14846,7880,6966,4580,9955,311,ITI,ITI3,11,Marche,Marche,1525271,1161048,76.12,0.97
1700,2021-01-25,MAR,1597,559,1038,90,1507,0,ITI,ITI3,11,Marche,Marche,1525271,1162645,76.23,0.1
1701,2021-01-08,MAR,1583,592,991,1568,0,15,ITI,ITI3,11,Marche,Marche,1525271,1164228,76.33,0.1
1702,2021-04-18,MAR,8824,4131,4693,7728,921,175,ITI,ITI3,11,Marche,Marche,1525271,1173052,76.91,0.58
1703,2021-03-18,MAR,3440,1507,1933,149,3279,12,ITI,ITI3,11,Marche,Marche,1525271,1176492,77.13,0.23
1704,2021-06-26,MAR,13577,6906,6671,5688,7672,217,ITI,ITI3,11,Marche,Marche,1525271,1190069,78.02,0.89
1705,2021-05-23,MAR,9210,4284,4926,7414,1672,124,ITI,ITI3,11,Marche,Marche,1525271,1199279,78.63,0.6
1706,2021-02-23,MAR,3314,1432,1882,3243,56,15,ITI,ITI3,11,Marche,Marche,1525271,1202593,78.84,0.22
1707,2021-01-15,MAR,1773,500,1273,1755,0,18,ITI,ITI3,11,Marche,Marche,1525271,1204366,78.96,0.12
1708,2021-04-25,MAR,8602,3996,4606,6891,1578,133,ITI,ITI3,11,Marche,Marche,1525271,1212968,79.52,0.56
1709,2021-08-03,MAR,10877,5736,5141,4030,6581,266,ITI,ITI3,11,Marche,Marche,1525271,1223845,80.24,0.71
1710,2021-08-12,MAR,8018,4330,3688,3889,3768,361,ITI,ITI3,11,Marche,Marche,1525271,1231863,80.76,0.53
1711,2021-05-28,MAR,13963,6741,7222,8801,4864,298,ITI,ITI3,11,Marche,Marche,1525271,1245826,81.68,0.92
1712,2021-04-01,MAR,7580,3187,4393,4064,3419,97,ITI,ITI3,11,Marche,Marche,1525271,1253406,82.18,0.5
1713,2021-09-05,MAR,195,100,95,132,37,26,ITI,ITI3,11,Marche,Marche,1525271,1253601,82.19,0.01
1714,2021-07-24,MAR,13278,7119,6159,2943,10077,258,ITI,ITI3,11,Marche,Marche,1525271,1266879,83.06,0.87
1715,2021-07-10,MAR,14161,7233,6928,1656,12302,203,ITI,ITI3,11,Marche,Marche,1525271,1281040,83.99,0.93
1716,2021-04-22,MAR,10798,4931,5867,9078,1579,141,ITI,ITI3,11,Marche,Marche,1525271,1291838,84.7,0.71
1717,2021-02-24,MAR,3534,1547,1987,3424,78,32,ITI,ITI3,11,Marche,Marche,1525271,1295372,84.93,0.23
1718,2021-06-04,MAR,14339,7290,7049,11589,2440,310,ITI,ITI3,11,Marche,Marche,1525271,1309711,85.87,0.94
1719,2021-04-08,MAR,9490,4157,5333,8959,370,161,ITI,ITI3,11,Marche,Marche,1525271,1319201,86.49,0.62
1720,2021-03-06,MAR,5739,2642,3097,4419,1268,52,ITI,ITI3,11,Marche,Marche,1525271,1324940,86.87,0.38
1721,2021-06-14,MAR,12839,6487,6352,9256,3310,273,ITI,ITI3,11,Marche,Marche,1525271,1337779,87.71,0.84
1722,2021-08-28,MAR,3145,1696,1449,1201,1800,144,ITI,ITI3,11,Marche,Marche,1525271,1340924,87.91,0.21
1723,2021-01-29,MAR,1994,731,1263,154,1835,5,ITI,ITI3,11,Marche,Marche,1525271,1342918,88.04,0.13
1724,2021-05-18,MAR,11273,5348,5925,7487,3605,181,ITI,ITI3,11,Marche,Marche,1525271,1354191,88.78,0.74
1725,2021-08-26,MAR,5681,3027,2654,2775,2546,360,ITI,ITI3,11,Marche,Marche,1525271,1359872,89.16,0.37
1726,2021-09-10,MAR,7566,4075,3491,2070,5194,302,ITI,ITI3,11,Marche,Marche,1525271,1367438,89.65,0.5
1727,2021-02-22,MAR,3461,1532,1929,3351,75,35,ITI,ITI3,11,Marche,Marche,1525271,1370899,89.88,0.23
1728,2021-08-24,MAR,6440,3401,3039,3299,2759,382,ITI,ITI3,11,Marche,Marche,1525271,1377339,90.3,0.42
1729,2021-08-05,MAR,11905,6393,5512,4078,7560,267,ITI,ITI3,11,Marche,Marche,1525271,1389244,91.08,0.78
1730,2021-01-20,MAR,406,100,306,384,20,2,ITI,ITI3,11,Marche,Marche,1525271,1389650,91.11,0.03
1731,2021-02-03,MAR,2129,743,1386,97,2011,21,ITI,ITI3,11,Marche,Marche,1525271,1391779,91.25,0.14
1732,2021-05-14,MAR,13638,6294,7344,6505,6915,218,ITI,ITI3,11,Marche,Marche,1525271,1405417,92.14,0.89
1733,2021-07-02,MAR,14553,7178,7375,4674,9648,231,ITI,ITI3,11,Marche,Marche,1525271,1419970,93.1,0.95
1734,2021-06-18,MAR,15347,7648,7699,8294,6753,300,ITI,ITI3,11,Marche,Marche,1525271,1435317,94.1,1.01
1735,2021-09-09,MAR,6467,3469,2998,1915,4313,239,ITI,ITI3,11,Marche,Marche,1525271,1441784,94.53,0.42
1736,2021-07-31,MAR,13203,7250,5953,5142,7731,330,ITI,ITI3,11,Marche,Marche,1525271,1454987,95.39,0.87
1737,2021-07-14,MAR,13852,6818,7034,1785,11875,192,ITI,ITI3,11,Marche,Marche,1525271,1468839,96.3,0.91
1738,2021-03-03,MAR,6701,3076,3625,5717,885,99,ITI,ITI3,11,Marche,Marche,1525271,1475540,96.74,0.44
1739,2021-01-05,MAR,1589,594,995,1570,0,19,ITI,ITI3,11,Marche,Marche,1525271,1477129,96.84,0.1
1740,2021-04-15,MAR,10379,4676,5703,9572,563,244,ITI,ITI3,11,Marche,Marche,1525271,1487508,97.52,0.68
1741,2021-02-17,MAR,1828,701,1127,1642,118,68,ITI,ITI3,11,Marche,Marche,1525271,1489336,97.64,0.12
1742,2021-08-21,MAR,2977,1664,1313,1492,1311,174,ITI,ITI3,11,Marche,Marche,1525271,1492313,97.84,0.2
1743,2021-05-11,MAR,10625,4832,5793,5490,4943,192,ITI,ITI3,11,Marche,Marche,1525271,1502938,98.54,0.7
1744,2021-03-15,MAR,4452,2061,2391,1291,3140,21,ITI,ITI3,11,Marche,Marche,1525271,1507390,98.83,0.29
1745,2021-01-10,MAR,1746,702,1044,1732,0,14,ITI,ITI3,11,Marche,Marche,1525271,1509136,98.94,0.11
1746,2021-07-12,MAR,13725,6806,6919,1229,12378,118,ITI,ITI3,11,Marche,Marche,1525271,1522861,99.84,0.9
1747,2021-04-03,MAR,7577,3204,4373,6736,667,174,ITI,ITI3,11,Marche,Marche,1525271,1530438,100.34,0.5
1748,2021-06-25,MAR,14346,7172,7174,6419,7637,290,ITI,ITI3,11,Marche,Marche,1525271,1544784,101.28,0.94
1749,2021-05-06,MAR,12661,5824,6837,5356,7076,229,ITI,ITI3,11,Marche,Marche,1525271,1557445,102.11,0.83
1750,2021-02-12,MAR,1581,618,963,1404,151,26,ITI,ITI3,11,Marche,Marche,1525271,1559026,102.21,0.1
1751,2021-08-14,MAR,2402,1379,1023,1035,1318,49,ITI,ITI3,11,Marche,Marche,1525271,1561428,102.37,0.16
1752,2021-02-10,MAR,1441,452,989,1040,359,42,ITI,ITI3,11,Marche,Marche,1525271,1562869,102.47,0.09
1753,2021-06-11,MAR,14003,7156,6847,11374,2324,305,ITI,ITI3,11,Marche,Marche,1525271,1576872,103.38,0.92
1754,2021-05-25,MAR,11770,5798,5972,8498,3052,220,ITI,ITI3,11,Marche,Marche,1525271,1588642,104.15,0.77
1755,2021-09-02,MAR,6387,3402,2985,2129,4044,214,ITI,ITI3,11,Marche,Marche,1525271,1595029,104.57,0.42
1756,2021-03-01,MAR,3772,1520,2252,3503,248,21,ITI,ITI3,11,Marche,Marche,1525271,1598801,104.82,0.25
1757,2021-03-27,MAR,7429,3098,4331,4958,2396,75,ITI,ITI3,11,Marche,Marche,1525271,1606230,105.31,0.49
1758,2021-04-10,MAR,10931,4625,6306,10369,314,248,ITI,ITI3,11,Marche,Marche,1525271,1617161,106.02,0.72
1759,2021-01-03,MAR,912,358,554,902,0,10,ITI,ITI3,11,Marche,Marche,1525271,1618073,106.08,0.06
1760,2021-07-19,MAR,14678,7531,7147,1925,12538,215,ITI,ITI3,11,Marche,Marche,1525271,1632751,107.05,0.96
1761,2021-03-08,MAR,6301,2762,3539,5187,1002,112,ITI,ITI3,11,Marche,Marche,1525271,1639052,107.46,0.41
1762,2021-08-07,MAR,9454,5194,4260,3474,5742,238,ITI,ITI3,11,Marche,Marche,1525271,1648506,108.08,0.62
1763,2021-07-21,MAR,14920,7617,7303,2064,12643,213,ITI,ITI3,11,Marche,Marche,1525271,1663426,109.06,0.98
1764,2021-04-29,MAR,13452,6159,7293,7161,6107,184,ITI,ITI3,11,Marche,Marche,1525271,1676878,109.94,0.88
1765,2021-08-19,MAR,6273,3347,2926,3490,2454,329,ITI,ITI3,11,Marche,Marche,1525271,1683151,110.35,0.41
1766,2021-06-23,MAR,13892,6818,7074,6626,7010,256,ITI,ITI3,11,Marche,Marche,1525271,1697043,111.26,0.91
1767,2021-01-13,MAR,2114,747,1367,2073,0,41,ITI,ITI3,11,Marche,Marche,1525271,1699157,111.4,0.14
1768,2021-05-02,MAR,8905,3940,4965,3078,5742,85,ITI,ITI3,11,Marche,Marche,1525271,1708062,111.98,0.58
1769,2021-08-10,MAR,9202,4815,4387,3335,5592,275,ITI,ITI3,11,Marche,Marche,1525271,1717264,112.59,0.6
1770,2021-06-28,MAR,12363,6026,6337,4615,7511,237,ITI,ITI3,11,Marche,Marche,1525271,1729627,113.4,0.81
1771,2021-02-05,MAR,2158,655,1503,438,1719,1,ITI,ITI3,11,Marche,Marche,1525271,1731785,113.54,0.14
1772,2021-05-16,MAR,10901,4959,5942,6547,4231,123,ITI,ITI3,11,Marche,Marche,1525271,1742686,114.25,0.71
1773,2021-05-30,MAR,9736,4691,5045,6546,2993,197,ITI,ITI3,11,Marche,Marche,1525271,1752422,114.89,0.64
1774,2021-09-07,MAR,6134,3221,2913,1739,4192,203,ITI,ITI3,11,Marche,Marche,1525271,1758556,115.29,0.4
1775,2021-04-27,MAR,9595,4390,5205,5506,3991,98,ITI,ITI3,11,Marche,Marche,1525271,1768151,115.92,0.63
1776,2021-01-17,MAR,1626,696,930,1555,65,6,ITI,ITI3,11,Marche,Marche,1525271,1769777,116.03,0.11
1777,2021-03-22,MAR,5704,2413,3291,2478,3179,47,ITI,ITI3,11,Marche,Marche,1525271,1775481,116.4,0.37
1778,2021-01-24,MAR,882,340,542,3,879,0,ITI,ITI3,11,Marche,Marche,1525271,1776363,116.46,0.06
1779,2021-06-30,MAR,13649,6663,6986,4451,8986,212,ITI,ITI3,11,Marche,Marche,1525271,1790012,117.36,0.89
1780,2021-05-04,MAR,10974,4840,6134,4926,5905,143,ITI,ITI3,11,Marche,Marche,1525271,1800986,118.08,0.72
1781,2021-03-20,MAR,4178,1759,2419,1034,3129,15,ITI,ITI3,11,Marche,Marche,1525271,1805164,118.35,0.27
1782,2021-01-22,MAR,489,168,321,193,294,2,ITI,ITI3,11,Marche,Marche,1525271,1805653,118.38,0.03
1783,2021-07-07,MAR,14259,7068,7191,2933,11083,243,ITI,ITI3,11,Marche,Marche,1525271,1819912,119.32,0.93
1784,2021-04-24,MAR,12173,5366,6807,7558,4467,148,ITI,ITI3,11,Marche,Marche,1525271,1832085,120.12,0.8
1785,2021-02-26,MAR,3681,1523,2158,3096,480,105,ITI,ITI3,11,Marche,Marche,1525271,1835766,120.36,0.24
1786,2021-05-12,MAR,10431,4692,5739,4730,5505,196,ITI,ITI3,11,Marche,Marche,1525271,1846197,121.04,0.68
1787,2021-08-20,MAR,4963,2693,2270,2952,1687,324,ITI,ITI3,11,Marche,Marche,1525271,1851160,121.37,0.33
1788,2021-09-03,MAR,6437,3384,3053,2190,3967,280,ITI,ITI3,11,Marche,Marche,1525271,1857597,121.79,0.42
1789,2021-07-08,MAR,15040,7539,7501,2787,12027,226,ITI,ITI3,11,Marche,Marche,1525271,1872637,122.77,0.99
1790,2021-08-27,MAR,5714,3049,2665,2800,2513,401,ITI,ITI3,11,Marche,Marche,1525271,1878351,123.15,0.37
1791,2021-07-01,MAR,14697,7368,7329,4658,9761,278,ITI,ITI3,11,Marche,Marche,1525271,1893048,124.11,0.96
1792,2021-02-15,MAR,967,412,555,939,13,15,ITI,ITI3,11,Marche,Marche,1525271,1894015,124.18,0.06
1793,2021-05-26,MAR,11889,5952,5937,8448,3227,214,ITI,ITI3,11,Marche,Marche,1525271,1905904,124.96,0.78
1794,2021-03-30,MAR,7487,3080,4407,4576,2834,77,ITI,ITI3,11,Marche,Marche,1525271,1913391,125.45,0.49
1795,2021-02-01,MAR,1363,479,884,93,1267,3,ITI,ITI3,11,Marche,Marche,1525271,1914754,125.54,0.09
1796,2021-04-06,MAR,8876,3693,5183,7928,810,138,ITI,ITI3,11,Marche,Marche,1525271,1923630,126.12,0.58
1797,2021-03-23,MAR,5838,2556,3282,2223,3576,39,ITI,ITI3,11,Marche,Marche,1525271,1929468,126.5,0.38
1798,2021-02-08,MAR,834,259,575,366,463,5,ITI,ITI3,11,Marche,Marche,1525271,1930302,126.55,0.05
1799,2021-07-15,MAR,16013,8289,7724,1751,14033,229,ITI,ITI3,11,Marche,Marche,1525271,1946315,127.6,1.05
1800,2021-05-19,MAR,11667,5364,6303,8366,3102,199,ITI,ITI3,11,Marche,Marche,1525271,1957982,128.37,0.76
1801,2021-09-14,MAR,6377,3432,2945,1469,4739,169,ITI,ITI3,11,Marche,Marche,1525271,1964359,128.79,0.42
1802,2021-04-17,MAR,11705,5317,6388,10393,1073,239,ITI,ITI3,11,Marche,Marche,1525271,1976064,129.55,0.77
1803,2021-07-26,MAR,11031,5737,5294,2109,8715,207,ITI,ITI3,11,Marche,Marche,1525271,1987095,130.28,0.72
1804,2021-08-09,MAR,9096,4829,4267,4053,4770,273,ITI,ITI3,11,Marche,Marche,1525271,1996191,130.87,0.6
1805,2021-06-13,MAR,10752,5566,5186,9203,1299,250,ITI,ITI3,11,Marche,Marche,1525271,2006943,131.58,0.7
1806,2020-12-27,MAR,210,100,110,208,0,2,ITI,ITI3,11,Marche,Marche,1525271,2007153,131.59,0.01
1807,2021-08-02,MAR,11727,6210,5517,4601,6868,258,ITI,ITI3,11,Marche,Marche,1525271,2018880,132.36,0.77
1808,2021-06-06,MAR,12454,6138,6316,10638,1579,237,ITI,ITI3,11,Marche,Marche,1525271,2031334,133.18,0.82
1809,2021-01-10,ABR,1271,539,732,1267,0,4,ITF,ITF1,13,Abruzzo,Abruzzo,1304970,1271,0.1,0.1
1810,2021-04-29,ABR,12685,5854,6831,9270,3099,316,ITF,ITF1,13,Abruzzo,Abruzzo,1304970,13956,1.07,0.97
1811,2021-08-07,ABR,6498,3619,2879,1840,4560,98,ITF,ITF1,13,Abruzzo,Abruzzo,1304970,20454,1.57,0.5
1812,2021-06-25,ABR,11061,5479,5582,4904,6014,143,ITF,ITF1,13,Abruzzo,Abruzzo,1304970,31515,2.41,0.85
1813,2021-01-15,ABR,385,155,230,371,0,14,ITF,ITF1,13,Abruzzo,Abruzzo,1304970,31900,2.44,0.03
1814,2021-01-22,ABR,118,57,61,118,0,0,ITF,ITF1,13,Abruzzo,Abruzzo,1304970,32018,2.45,0.01
1815,2021-01-03,ABR,501,212,289,499,0,2,ITF,ITF1,13,Abruzzo,Abruzzo,1304970,32519,2.49,0.04
1816,2021-08-21,ABR,3841,2098,1743,1729,1990,122,ITF,ITF1,13,Abruzzo,Abruzzo,1304970,36360,2.79,0.29
1817,2021-05-04,ABR,10857,5095,5762,7038,3628,191,ITF,ITF1,13,Abruzzo,Abruzzo,1304970,47217,3.62,0.83
1818,2021-03-08,ABR,5155,1694,3461,4083,976,96,ITF,ITF1,13,Abruzzo,Abruzzo,1304970,52372,4.01,0.4
1819,2021-01-24,ABR,50,22,28,6,44,0,ITF,ITF1,13,Abruzzo,Abruzzo,1304970,52422,4.02,0.0
1820,2021-09-09,ABR,6996,3668,3328,1341,5526,129,ITF,ITF1,13,Abruzzo,Abruzzo,1304970,59418,4.55,0.54
1821,2021-02-10,ABR,948,313,635,492,446,10,ITF,ITF1,13,Abruzzo,Abruzzo,1304970,60366,4.63,0.07
1822,2021-03-03,ABR,4642,1900,2742,3717,906,19,ITF,ITF1,13,Abruzzo,Abruzzo,1304970,65008,4.98,0.36
1823,2021-07-14,ABR,13722,6798,6924,2435,11135,152,ITF,ITF1,13,Abruzzo,Abruzzo,1304970,78730,6.03,1.05
1824,2021-04-08,ABR,7394,3334,4060,4933,2331,130,ITF,ITF1,13,Abruzzo,Abruzzo,1304970,86124,6.6,0.57
1825,2021-04-22,ABR,6738,3252,3486,4828,1734,176,ITF,ITF1,13,Abruzzo,Abruzzo,1304970,92862,7.12,0.52
1826,2021-07-31,ABR,11743,6342,5401,3477,8063,203,ITF,ITF1,13,Abruzzo,Abruzzo,1304970,104605,8.02,0.9
1827,2021-02-22,ABR,2641,1174,1467,2584,30,27,ITF,ITF1,13,Abruzzo,Abruzzo,1304970,107246,8.22,0.2
1828,2021-02-05,ABR,1535,521,1014,772,747,16,ITF,ITF1,13,Abruzzo,Abruzzo,1304970,108781,8.34,0.12
1829,2021-05-16,ABR,9577,4134,5443,5645,3812,120,ITF,ITF1,13,Abruzzo,Abruzzo,1304970,118358,9.07,0.73
1830,2021-06-04,ABR,15650,7396,8254,10757,4704,189,ITF,ITF1,13,Abruzzo,Abruzzo,1304970,134008,10.27,1.2
1831,2021-05-18,ABR,12112,5660,6452,7561,4380,171,ITF,ITF1,13,Abruzzo,Abruzzo,1304970,146120,11.2,0.93
1832,2021-02-24,ABR,3306,1442,1864,3112,177,17,ITF,ITF1,13,Abruzzo,Abruzzo,1304970,149426,11.45,0.25
1833,2021-08-09,ABR,10706,5550,5156,3098,7414,194,ITF,ITF1,13,Abruzzo,Abruzzo,1304970,160132,12.27,0.82
1834,2021-08-26,ABR,5802,3037,2765,2015,3636,151,ITF,ITF1,13,Abruzzo,Abruzzo,1304970,165934,12.72,0.44
1835,2021-05-30,ABR,8661,4110,4551,5326,3256,79,ITF,ITF1,13,Abruzzo,Abruzzo,1304970,174595,13.38,0.66
1836,2021-04-03,ABR,5164,2259,2905,3485,1598,81,ITF,ITF1,13,Abruzzo,Abruzzo,1304970,179759,13.77,0.4
1837,2021-09-07,ABR,5352,2814,2538,1471,3772,109,ITF,ITF1,13,Abruzzo,Abruzzo,1304970,185111,14.19,0.41
1838,2021-07-26,ABR,14261,7461,6800,3867,10195,199,ITF,ITF1,13,Abruzzo,Abruzzo,1304970,199372,15.28,1.09
1839,2021-07-12,ABR,15081,7460,7621,2360,12604,117,ITF,ITF1,13,Abruzzo,Abruzzo,1304970,214453,16.43,1.16
1840,2020-12-27,ABR,47,24,23,47,0,0,ITF,ITF1,13,Abruzzo,Abruzzo,1304970,214500,16.44,0.0
1841,2021-03-20,ABR,4796,2201,2595,2564,2172,60,ITF,ITF1,13,Abruzzo,Abruzzo,1304970,219296,16.8,0.37
1842,2021-06-13,ABR,9845,4925,4920,7846,1834,165,ITF,ITF1,13,Abruzzo,Abruzzo,1304970,229141,17.56,0.75
1843,2021-04-27,ABR,9084,4366,4718,6504,2466,114,ITF,ITF1,13,Abruzzo,Abruzzo,1304970,238225,18.26,0.7
1844,2021-07-02,ABR,11835,5947,5888,4828,6822,185,ITF,ITF1,13,Abruzzo,Abruzzo,1304970,250060,19.16,0.91
1845,2021-03-15,ABR,3681,1445,2236,1840,1809,32,ITF,ITF1,13,Abruzzo,Abruzzo,1304970,253741,19.44,0.28
1846,2021-01-17,ABR,193,64,129,185,7,1,ITF,ITF1,13,Abruzzo,Abruzzo,1304970,253934,19.46,0.01
1847,2021-06-23,ABR,11016,5285,5731,5578,5291,147,ITF,ITF1,13,Abruzzo,Abruzzo,1304970,264950,20.3,0.84
1848,2021-03-27,ABR,6127,2622,3505,3563,2492,72,ITF,ITF1,13,Abruzzo,Abruzzo,1304970,271077,20.77,0.47
1849,2021-01-05,ABR,1735,721,1014,1730,0,5,ITF,ITF1,13,Abruzzo,Abruzzo,1304970,272812,20.91,0.13
1850,2021-04-15,ABR,7832,3687,4145,5826,1843,163,ITF,ITF1,13,Abruzzo,Abruzzo,1304970,280644,21.51,0.6
1851,2021-07-07,ABR,12064,5906,6158,4026,7797,241,ITF,ITF1,13,Abruzzo,Abruzzo,1304970,292708,22.43,0.92
1852,2021-03-01,ABR,3477,1384,2093,2702,751,24,ITF,ITF1,13,Abruzzo,Abruzzo,1304970,296185,22.7,0.27
1853,2021-08-14,ABR,128,69,59,101,25,2,ITF,ITF1,13,Abruzzo,Abruzzo,1304970,296313,22.71,0.01
1854,2021-06-18,ABR,10193,5005,5188,6550,3494,149,ITF,ITF1,13,Abruzzo,Abruzzo,1304970,306506,23.49,0.78
1855,2021-07-21,ABR,11078,5718,5360,2425,8518,135,ITF,ITF1,13,Abruzzo,Abruzzo,1304970,317584,24.34,0.85
1856,2021-02-03,ABR,2062,717,1345,411,1643,8,ITF,ITF1,13,Abruzzo,Abruzzo,1304970,319646,24.49,0.16
1857,2021-03-22,ABR,4347,1911,2436,2309,1971,67,ITF,ITF1,13,Abruzzo,Abruzzo,1304970,323993,24.83,0.33
1858,2021-06-30,ABR,11169,5430,5739,4493,6509,167,ITF,ITF1,13,Abruzzo,Abruzzo,1304970,335162,25.68,0.86
1859,2021-02-17,ABR,2071,948,1123,1780,282,9,ITF,ITF1,13,Abruzzo,Abruzzo,1304970,337233,25.84,0.16
1860,2021-09-02,ABR,6102,3191,2911,1860,4112,130,ITF,ITF1,13,Abruzzo,Abruzzo,1304970,343335,26.31,0.47
1861,2021-06-11,ABR,11784,5855,5929,8832,2766,186,ITF,ITF1,13,Abruzzo,Abruzzo,1304970,355119,27.21,0.9
1862,2021-08-19,ABR,6722,3609,3113,3255,3275,192,ITF,ITF1,13,Abruzzo,Abruzzo,1304970,361841,27.73,0.52
1863,2021-02-12,ABR,1228,567,661,1026,189,13,ITF,ITF1,13,Abruzzo,Abruzzo,1304970,363069,27.82,0.09
1864,2021-07-19,ABR,11778,5983,5795,2663,8943,172,ITF,ITF1,13,Abruzzo,Abruzzo,1304970,374847,28.72,0.9
1865,2021-05-23,ABR,9881,4693,5188,7068,2692,121,ITF,ITF1,13,Abruzzo,Abruzzo,1304970,384728,29.48,0.76
1866,2021-06-06,ABR,11151,5311,5840,8776,2241,134,ITF,ITF1,13,Abruzzo,Abruzzo,1304970,395879,30.34,0.85
1867,2021-04-10,ABR,8778,4060,4718,6122,2510,146,ITF,ITF1,13,Abruzzo,Abruzzo,1304970,404657,31.01,0.67
1868,2021-08-28,ABR,2304,1333,971,700,1555,49,ITF,ITF1,13,Abruzzo,Abruzzo,1304970,406961,31.19,0.18
1869,2021-09-14,ABR,3912,2104,1808,802,3039,71,ITF,ITF1,13,Abruzzo,Abruzzo,1304970,410873,31.49,0.3
1870,2021-01-29,ABR,1387,449,938,71,1315,1,ITF,ITF1,13,Abruzzo,Abruzzo,1304970,412260,31.59,0.11
1871,2021-08-02,ABR,13856,7154,6702,3544,10053,259,ITF,ITF1,13,Abruzzo,Abruzzo,1304970,426116,32.65,1.06
1872,2021-03-17,ABR,4544,1875,2669,2781,1740,23,ITF,ITF1,13,Abruzzo,Abruzzo,1304970,430660,33.0,0.35
1873,2021-09-06,ABR,6220,3246,2974,2204,3868,148,ITF,ITF1,13,Abruzzo,Abruzzo,1304970,436880,33.48,0.48
1874,2021-07-09,ABR,13611,6794,6817,2885,10587,139,ITF,ITF1,13,Abruzzo,Abruzzo,1304970,450491,34.52,1.04
1875,2021-09-13,ABR,4593,2483,2110,1056,3458,79,ITF,ITF1,13,Abruzzo,Abruzzo,1304970,455084,34.87,0.35
1876,2021-06-22,ABR,10411,4878,5533,5385,4846,180,ITF,ITF1,13,Abruzzo,Abruzzo,1304970,465495,35.67,0.8
1877,2021-02-02,ABR,1764,668,1096,218,1542,4,ITF,ITF1,13,Abruzzo,Abruzzo,1304970,467259,35.81,0.14
1878,2021-05-13,ABR,11151,5044,6107,6953,3964,234,ITF,ITF1,13,Abruzzo,Abruzzo,1304970,478410,36.66,0.85
1879,2021-03-31,ABR,6724,2948,3776,4559,2070,95,ITF,ITF1,13,Abruzzo,Abruzzo,1304970,485134,37.18,0.52
1880,2021-05-15,ABR,11445,5184,6261,5938,5327,180,ITF,ITF1,13,Abruzzo,Abruzzo,1304970,496579,38.05,0.88
1881,2021-08-23,ABR,5922,3111,2811,1658,4120,144,ITF,ITF1,13,Abruzzo,Abruzzo,1304970,502501,38.51,0.45
1882,2021-07-11,ABR,9887,4976,4911,2364,7388,135,ITF,ITF1,13,Abruzzo,Abruzzo,1304970,512388,39.26,0.76
1883,2021-05-11,ABR,10764,5120,5644,5730,4856,178,ITF,ITF1,13,Abruzzo,Abruzzo,1304970,523152,40.09,0.82
1884,2021-08-18,ABR,7382,3919,3463,3085,4106,191,ITF,ITF1,13,Abruzzo,Abruzzo,1304970,530534,40.65,0.57
1885,2021-04-05,ABR,2692,1147,1545,1729,880,83,ITF,ITF1,13,Abruzzo,Abruzzo,1304970,533226,40.86,0.21
1886,2021-02-28,ABR,1703,509,1194,1665,2,36,ITF,ITF1,13,Abruzzo,Abruzzo,1304970,534929,40.99,0.13
1887,2021-08-04,ABR,10882,5629,5253,4301,6338,243,ITF,ITF1,13,Abruzzo,Abruzzo,1304970,545811,41.83,0.83
1888,2021-01-02,ABR,559,226,333,558,0,1,ITF,ITF1,13,Abruzzo,Abruzzo,1304970,546370,41.87,0.04
1889,2021-06-08,ABR,12870,6622,6248,10430,2197,243,ITF,ITF1,13,Abruzzo,Abruzzo,1304970,559240,42.85,0.99
1890,2021-04-26,ABR,8563,4066,4497,7135,1214,214,ITF,ITF1,13,Abruzzo,Abruzzo,1304970,567803,43.51,0.66
1891,2021-06-01,ABR,11001,4879,6122,6513,4367,121,ITF,ITF1,13,Abruzzo,Abruzzo,1304970,578804,44.35,0.84
1892,2021-04-19,ABR,6236,2865,3371,3788,2375,73,ITF,ITF1,13,Abruzzo,Abruzzo,1304970,585040,44.83,0.48
1893,2021-02-21,ABR,1218,550,668,1192,1,25,ITF,ITF1,13,Abruzzo,Abruzzo,1304970,586258,44.93,0.09
1894,2021-07-28,ABR,13274,6955,6319,3435,9671,168,ITF,ITF1,13,Abruzzo,Abruzzo,1304970,599532,45.94,1.02
1895,2021-06-15,ABR,11330,5562,5768,8681,2440,209,ITF,ITF1,13,Abruzzo,Abruzzo,1304970,610862,46.81,0.87
1896,2021-04-12,ABR,6239,2957,3282,4983,1173,83,ITF,ITF1,13,Abruzzo,Abruzzo,1304970,617101,47.29,0.48
1897,2021-03-24,ABR,6388,2786,3602,3993,2252,143,ITF,ITF1,13,Abruzzo,Abruzzo,1304970,623489,47.78,0.49
1898,2021-02-09,ABR,924,325,599,512,411,1,ITF,ITF1,13,Abruzzo,Abruzzo,1304970,624413,47.85,0.07
1899,2021-07-04,ABR,8370,4215,4155,3329,4915,126,ITF,ITF1,13,Abruzzo,Abruzzo,1304970,632783,48.49,0.64
1900,2021-08-30,ABR,7415,4055,3360,1944,5341,130,ITF,ITF1,13,Abruzzo,Abruzzo,1304970,640198,49.06,0.57
1901,2021-01-19,ABR,112,56,56,90,21,1,ITF,ITF1,13,Abruzzo,Abruzzo,1304970,640310,49.07,0.01
1902,2021-02-07,ABR,780,307,473,199,580,1,ITF,ITF1,13,Abruzzo,Abruzzo,1304970,641090,49.13,0.06
1903,2021-07-23,ABR,12574,6464,6110,2850,9563,161,ITF,ITF1,13,Abruzzo,Abruzzo,1304970,653664,50.09,0.96
1904,2021-01-21,ABR,157,47,110,157,0,0,ITF,ITF1,13,Abruzzo,Abruzzo,1304970,653821,50.1,0.01
1905,2021-05-01,ABR,10752,5053,5699,5631,4984,137,ITF,ITF1,13,Abruzzo,Abruzzo,1304970,664573,50.93,0.82
1906,2021-05-20,ABR,12807,5926,6881,7411,5268,128,ITF,ITF1,13,Abruzzo,Abruzzo,1304970,677380,51.91,0.98
1907,2021-08-11,ABR,8277,4416,3861,2615,5504,158,ITF,ITF1,13,Abruzzo,Abruzzo,1304970,685657,52.54,0.63
1908,2021-05-27,ABR,13322,6104,7218,8314,4831,177,ITF,ITF1,13,Abruzzo,Abruzzo,1304970,698979,53.56,1.02
1909,2021-09-04,ABR,2139,1136,1003,740,1338,61,ITF,ITF1,13,Abruzzo,Abruzzo,1304970,701118,53.73,0.16
1910,2021-03-19,ABR,5798,2586,3212,2730,3025,43,ITF,ITF1,13,Abruzzo,Abruzzo,1304970,706916,54.17,0.44
1911,2021-03-05,ABR,5346,1957,3389,4590,697,59,ITF,ITF1,13,Abruzzo,Abruzzo,1304970,712262,54.58,0.41
1912,2021-06-27,ABR,8366,4299,4067,5018,3208,140,ITF,ITF1,13,Abruzzo,Abruzzo,1304970,720628,55.22,0.64
1913,2021-01-12,ABR,1901,761,1140,1887,0,14,ITF,ITF1,13,Abruzzo,Abruzzo,1304970,722529,55.37,0.15
1914,2021-05-25,ABR,11422,5325,6097,8085,3139,198,ITF,ITF1,13,Abruzzo,Abruzzo,1304970,733951,56.24,0.88
1915,2021-01-31,ABR,1524,495,1029,286,1237,1,ITF,ITF1,13,Abruzzo,Abruzzo,1304970,735475,56.36,0.12
1916,2021-03-10,ABR,5051,1687,3364,4027,957,67,ITF,ITF1,13,Abruzzo,Abruzzo,1304970,740526,56.75,0.39
1917,2021-01-26,ABR,1550,568,982,31,1519,0,ITF,ITF1,13,Abruzzo,Abruzzo,1304970,742076,56.87,0.12
1918,2021-05-06,ABR,13005,6087,6918,7796,5049,160,ITF,ITF1,13,Abruzzo,Abruzzo,1304970,755081,57.86,1.0
1919,2021-09-11,ABR,2385,1331,1054,1047,1231,107,ITF,ITF1,13,Abruzzo,Abruzzo,1304970,757466,58.04,0.18
1920,2021-03-29,ABR,5710,2600,3110,3020,2640,50,ITF,ITF1,13,Abruzzo,Abruzzo,1304970,763176,58.48,0.44
1921,2021-06-03,ABR,13197,6285,6912,9243,3779,175,ITF,ITF1,13,Abruzzo,Abruzzo,1304970,776373,59.49,1.01
1922,2021-03-12,ABR,6043,1993,4050,4353,1611,79,ITF,ITF1,13,Abruzzo,Abruzzo,1304970,782416,59.96,0.46
1923,2021-06-20,ABR,8445,4237,4208,5410,2932,103,ITF,ITF1,13,Abruzzo,Abruzzo,1304970,790861,60.6,0.65
1924,2021-03-14,ABR,1883,732,1151,1201,669,13,ITF,ITF1,13,Abruzzo,Abruzzo,1304970,792744,60.75,0.14
1925,2021-02-25,ABR,3055,1343,1712,2506,530,19,ITF,ITF1,13,Abruzzo,Abruzzo,1304970,795799,60.98,0.23
1926,2021-06-05,ABR,14617,6866,7751,10363,4051,203,ITF,ITF1,13,Abruzzo,Abruzzo,1304970,810416,62.1,1.12
1927,2021-01-16,ABR,939,431,508,931,0,8,ITF,ITF1,13,Abruzzo,Abruzzo,1304970,811355,62.17,0.07
1928,2021-09-01,ABR,6848,3641,3207,1566,5180,102,ITF,ITF1,13,Abruzzo,Abruzzo,1304970,818203,62.7,0.52
1929,2021-02-11,ABR,815,262,553,770,43,2,ITF,ITF1,13,Abruzzo,Abruzzo,1304970,819018,62.76,0.06
1930,2021-05-24,ABR,12222,5839,6383,8725,3341,156,ITF,ITF1,13,Abruzzo,Abruzzo,1304970,831240,63.7,0.94
1931,2021-06-19,ABR,10558,5202,5356,6483,3901,174,ITF,ITF1,13,Abruzzo,Abruzzo,1304970,841798,64.51,0.81
1932,2021-03-28,ABR,2431,1018,1413,1994,386,51,ITF,ITF1,13,Abruzzo,Abruzzo,1304970,844229,64.69,0.19
1933,2021-07-06,ABR,10463,5199,5264,4298,5990,175,ITF,ITF1,13,Abruzzo,Abruzzo,1304970,854692,65.5,0.8
1934,2021-04-14,ABR,6599,2952,3647,4340,2124,135,ITF,ITF1,13,Abruzzo,Abruzzo,1304970,861291,66.0,0.51
1935,2021-04-07,ABR,7569,3495,4074,4514,2919,136,ITF,ITF1,13,Abruzzo,Abruzzo,1304970,868860,66.58,0.58
1936,2021-07-16,ABR,16150,8239,7911,2466,13567,117,ITF,ITF1,13,Abruzzo,Abruzzo,1304970,885010,67.82,1.24
1937,2021-05-08,ABR,10289,4869,5420,6306,3836,147,ITF,ITF1,13,Abruzzo,Abruzzo,1304970,895299,68.61,0.79
1938,2021-04-24,ABR,8731,3975,4756,6937,1532,262,ITF,ITF1,13,Abruzzo,Abruzzo,1304970,904030,69.28,0.67
1939,2021-08-16,ABR,6095,3206,2889,2258,3690,147,ITF,ITF1,13,Abruzzo,Abruzzo,1304970,910125,69.74,0.47
1940,2021-01-14,ABR,568,227,341,566,0,2,ITF,ITF1,13,Abruzzo,Abruzzo,1304970,910693,69.79,0.04
1941,2021-02-16,ABR,1916,842,1074,1891,12,13,ITF,ITF1,13,Abruzzo,Abruzzo,1304970,912609,69.93,0.15
1942,2021-03-02,ABR,3967,1676,2291,3264,686,17,ITF,ITF1,13,Abruzzo,Abruzzo,1304970,916576,70.24,0.3
1943,2021-06-10,ABR,12711,6319,6392,10308,2164,239,ITF,ITF1,13,Abruzzo,Abruzzo,1304970,929287,71.21,0.97
1944,2021-05-10,ABR,10112,4785,5327,5340,4653,119,ITF,ITF1,13,Abruzzo,Abruzzo,1304970,939399,71.99,0.77
1945,2021-04-23,ABR,7415,3401,4014,4937,2308,170,ITF,ITF1,13,Abruzzo,Abruzzo,1304970,946814,72.55,0.57
1946,2021-01-30,ABR,1514,570,944,62,1451,1,ITF,ITF1,13,Abruzzo,Abruzzo,1304970,948328,72.67,0.12
1947,2021-08-01,ABR,7571,4057,3514,2004,5465,102,ITF,ITF1,13,Abruzzo,Abruzzo,1304970,955899,73.25,0.58
1948,2021-06-29,ABR,11431,5640,5791,5246,5997,188,ITF,ITF1,13,Abruzzo,Abruzzo,1304970,967330,74.13,0.88
1949,2021-03-21,ABR,2134,914,1220,839,1291,4,ITF,ITF1,13,Abruzzo,Abruzzo,1304970,969464,74.29,0.16
1950,2021-06-12,ABR,11423,5916,5507,9890,1351,182,ITF,ITF1,13,Abruzzo,Abruzzo,1304970,980887,75.17,0.88
1951,2021-01-04,ABR,1515,685,830,1509,0,6,ITF,ITF1,13,Abruzzo,Abruzzo,1304970,982402,75.28,0.12
1952,2021-01-23,ABR,265,116,149,51,208,6,ITF,ITF1,13,Abruzzo,Abruzzo,1304970,982667,75.3,0.02
1953,2021-05-03,ABR,11153,5260,5893,7128,3837,188,ITF,ITF1,13,Abruzzo,Abruzzo,1304970,993820,76.16,0.85
1954,2021-07-25,ABR,9864,5217,4647,2170,7571,123,ITF,ITF1,13,Abruzzo,Abruzzo,1304970,1003684,76.91,0.76
1955,2021-07-08,ABR,13498,6684,6814,3410,9922,166,ITF,ITF1,13,Abruzzo,Abruzzo,1304970,1017182,77.95,1.03
1956,2021-04-16,ABR,7546,3492,4054,5497,1917,132,ITF,ITF1,13,Abruzzo,Abruzzo,1304970,1024728,78.53,0.58
1957,2021-08-08,ABR,4451,2429,2022,1887,2474,90,ITF,ITF1,13,Abruzzo,Abruzzo,1304970,1029179,78.87,0.34
1958,2021-05-17,ABR,11039,5040,5999,6017,4857,165,ITF,ITF1,13,Abruzzo,Abruzzo,1304970,1040218,79.71,0.85
1959,2021-08-25,ABR,7127,3795,3332,2372,4586,169,ITF,ITF1,13,Abruzzo,Abruzzo,1304970,1047345,80.26,0.55
1960,2021-08-27,ABR,7970,4201,3769,2467,5343,160,ITF,ITF1,13,Abruzzo,Abruzzo,1304970,1055315,80.87,0.61
1961,2021-02-23,ABR,2779,1273,1506,2753,11,15,ITF,ITF1,13,Abruzzo,Abruzzo,1304970,1058094,81.08,0.21
1962,2021-02-06,ABR,1613,745,868,595,1011,7,ITF,ITF1,13,Abruzzo,Abruzzo,1304970,1059707,81.21,0.12
1963,2021-04-09,ABR,8993,4261,4732,6245,2603,145,ITF,ITF1,13,Abruzzo,Abruzzo,1304970,1068700,81.89,0.69
1964,2021-07-18,ABR,12205,6311,5894,1996,10086,123,ITF,ITF1,13,Abruzzo,Abruzzo,1304970,1080905,82.83,0.94
1965,2021-04-02,ABR,6697,3105,3592,5113,1489,95,ITF,ITF1,13,Abruzzo,Abruzzo,1304970,1087602,83.34,0.51
1966,2021-02-04,ABR,1686,617,1069,601,1073,12,ITF,ITF1,13,Abruzzo,Abruzzo,1304970,1089288,83.47,0.13
1967,2021-07-20,ABR,12589,6388,6201,3222,9178,189,ITF,ITF1,13,Abruzzo,Abruzzo,1304970,1101877,84.44,0.96
1968,2021-03-07,ABR,2521,630,1891,2483,0,38,ITF,ITF1,13,Abruzzo,Abruzzo,1304970,1104398,84.63,0.19
1969,2021-01-09,ABR,1613,693,920,1601,0,12,ITF,ITF1,13,Abruzzo,Abruzzo,1304970,1106011,84.75,0.12
1970,2021-05-07,ABR,12219,5718,6501,7642,4425,152,ITF,ITF1,13,Abruzzo,Abruzzo,1304970,1118230,85.69,0.94
1971,2021-03-25,ABR,5801,2666,3135,3063,2625,113,ITF,ITF1,13,Abruzzo,Abruzzo,1304970,1124031,86.13,0.44
1972,2021-08-29,ABR,1468,877,591,523,931,14,ITF,ITF1,13,Abruzzo,Abruzzo,1304970,1125499,86.25,0.11
1973,2021-01-27,ABR,1367,515,852,32,1335,0,ITF,ITF1,13,Abruzzo,Abruzzo,1304970,1126866,86.35,0.1
1974,2021-07-03,ABR,10194,5149,5045,3500,6546,148,ITF,ITF1,13,Abruzzo,Abruzzo,1304970,1137060,87.13,0.78
1975,2021-02-18,ABR,2293,934,1359,2143,133,17,ITF,ITF1,13,Abruzzo,Abruzzo,1304970,1139353,87.31,0.18
1976,2021-05-29,ABR,10318,4430,5888,4454,5772,92,ITF,ITF1,13,Abruzzo,Abruzzo,1304970,1149671,88.1,0.79
1977,2021-05-22,ABR,13161,6393,6768,8131,4918,112,ITF,ITF1,13,Abruzzo,Abruzzo,1304970,1162832,89.11,1.01
1978,2021-03-26,ABR,5362,2314,3048,3174,2080,108,ITF,ITF1,13,Abruzzo,Abruzzo,1304970,1168194,89.52,0.41
1979,2021-09-08,ABR,4425,2351,2074,1589,2733,103,ITF,ITF1,13,Abruzzo,Abruzzo,1304970,1172619,89.86,0.34
1980,2021-07-27,ABR,15142,7907,7235,3337,11628,177,ITF,ITF1,13,Abruzzo,Abruzzo,1304970,1187761,91.02,1.16
1981,2021-05-31,ABR,11339,5115,6224,6769,4444,126,ITF,ITF1,13,Abruzzo,Abruzzo,1304970,1199100,91.89,0.87
1982,2021-04-20,ABR,5638,2714,2924,4104,1456,78,ITF,ITF1,13,Abruzzo,Abruzzo,1304970,1204738,92.32,0.43
1983,2021-07-29,ABR,15183,7975,7208,3926,11045,212,ITF,ITF1,13,Abruzzo,Abruzzo,1304970,1219921,93.48,1.16
1984,2021-04-25,ABR,9072,4625,4447,8052,810,210,ITF,ITF1,13,Abruzzo,Abruzzo,1304970,1228993,94.18,0.7
1985,2021-09-03,ABR,5937,3185,2752,1826,3980,131,ITF,ITF1,13,Abruzzo,Abruzzo,1304970,1234930,94.63,0.45
1986,2021-01-28,ABR,1435,495,940,11,1424,0,ITF,ITF1,13,Abruzzo,Abruzzo,1304970,1236365,94.74,0.11
1987,2021-01-11,ABR,1690,690,1000,1686,0,4,ITF,ITF1,13,Abruzzo,Abruzzo,1304970,1238055,94.87,0.13
1988,2021-04-21,ABR,6393,3104,3289,4633,1673,87,ITF,ITF1,13,Abruzzo,Abruzzo,1304970,1244448,95.36,0.49
1989,2021-01-13,ABR,1305,483,822,1297,0,8,ITF,ITF1,13,Abruzzo,Abruzzo,1304970,1245753,95.46,0.1
1990,2021-03-11,ABR,5493,2216,3277,4264,1140,89,ITF,ITF1,13,Abruzzo,Abruzzo,1304970,1251246,95.88,0.42
1991,2021-06-02,ABR,9773,4750,5023,6835,2819,119,ITF,ITF1,13,Abruzzo,Abruzzo,1304970,1261019,96.63,0.75
1992,2021-09-10,ABR,4939,2640,2299,1512,3324,103,ITF,ITF1,13,Abruzzo,Abruzzo,1304970,1265958,97.01,0.38
1993,2021-09-12,ABR,1610,866,744,759,785,66,ITF,ITF1,13,Abruzzo,Abruzzo,1304970,1267568,97.13,0.12
1994,2021-03-13,ABR,4123,1420,2703,3017,1043,63,ITF,ITF1,13,Abruzzo,Abruzzo,1304970,1271691,97.45,0.32
1995,2021-06-21,ABR,11057,5389,5668,4939,5990,128,ITF,ITF1,13,Abruzzo,Abruzzo,1304970,1282748,98.3,0.85
1996,2021-05-21,ABR,13019,6329,6690,7864,4979,176,ITF,ITF1,13,Abruzzo,Abruzzo,1304970,1295767,99.29,1.0
1997,2021-03-18,ABR,3900,1652,2248,2038,1835,27,ITF,ITF1,13,Abruzzo,Abruzzo,1304970,1299667,99.59,0.3
1998,2021-08-22,ABR,1832,948,884,537,1243,52,ITF,ITF1,13,Abruzzo,Abruzzo,1304970,1301499,99.73,0.14
1999,2021-06-26,ABR,10052,5019,5033,5688,4201,163,ITF,ITF1,13,Abruzzo,Abruzzo,1304970,1311551,100.5,0.77
2000,2021-07-10,ABR,13122,6632,6490,3010,9947,165,ITF,ITF1,13,Abruzzo,Abruzzo,1304970,1324673,101.51,1.01
2001,2021-08-05,ABR,13901,7161,6740,4714,8914,273,ITF,ITF1,13,Abruzzo,Abruzzo,1304970,1338574,102.58,1.07
2002,2021-01-08,ABR,1659,638,1021,1650,0,9,ITF,ITF1,13,Abruzzo,Abruzzo,1304970,1340233,102.7,0.13
2003,2021-04-18,ABR,5819,2728,3091,4726,944,149,ITF,ITF1,13,Abruzzo,Abruzzo,1304970,1346052,103.15,0.45
2004,2021-02-20,ABR,4778,1844,2934,4658,76,44,ITF,ITF1,13,Abruzzo,Abruzzo,1304970,1350830,103.51,0.37
2005,2021-03-30,ABR,5128,2262,2866,3141,1825,162,ITF,ITF1,13,Abruzzo,Abruzzo,1304970,1355958,103.91,0.39
2006,2021-01-06,ABR,1991,819,1172,1981,0,10,ITF,ITF1,13,Abruzzo,Abruzzo,1304970,1357949,104.06,0.15
2007,2021-02-08,ABR,1196,396,800,486,710,0,ITF,ITF1,13,Abruzzo,Abruzzo,1304970,1359145,104.15,0.09
2008,2021-05-19,ABR,10729,5126,5603,7566,3037,126,ITF,ITF1,13,Abruzzo,Abruzzo,1304970,1369874,104.97,0.82
2009,2021-04-30,ABR,12512,5870,6642,6511,5728,273,ITF,ITF1,13,Abruzzo,Abruzzo,1304970,1382386,105.93,0.96
2010,2021-04-13,ABR,5894,2756,3138,4557,1238,99,ITF,ITF1,13,Abruzzo,Abruzzo,1304970,1388280,106.38,0.45
2011,2021-01-20,ABR,449,157,292,427,2,20,ITF,ITF1,13,Abruzzo,Abruzzo,1304970,1388729,106.42,0.03
2012,2021-07-05,ABR,10910,5349,5561,4040,6676,194,ITF,ITF1,13,Abruzzo,Abruzzo,1304970,1399639,107.25,0.84
2013,2021-07-22,ABR,14488,7413,7075,3516,10762,210,ITF,ITF1,13,Abruzzo,Abruzzo,1304970,1414127,108.36,1.11
2014,2021-07-24,ABR,12633,6842,5791,3809,8586,238,ITF,ITF1,13,Abruzzo,Abruzzo,1304970,1426760,109.33,0.97
2015,2021-05-02,ABR,10465,5115,5350,5087,5233,145,ITF,ITF1,13,Abruzzo,Abruzzo,1304970,1437225,110.13,0.8
2016,2021-08-10,ABR,9270,4964,4306,3397,5661,212,ITF,ITF1,13,Abruzzo,Abruzzo,1304970,1446495,110.85,0.71
2017,2021-07-15,ABR,15946,8089,7857,3129,12641,176,ITF,ITF1,13,Abruzzo,Abruzzo,1304970,1462441,112.07,1.22
2018,2021-06-28,ABR,10053,4836,5217,5309,4574,170,ITF,ITF1,13,Abruzzo,Abruzzo,1304970,1472494,112.84,0.77
2019,2021-04-06,ABR,7678,3578,4100,5227,2320,131,ITF,ITF1,13,Abruzzo,Abruzzo,1304970,1480172,113.43,0.59
2020,2021-08-03,ABR,12721,6574,6147,3645,8907,169,ITF,ITF1,13,Abruzzo,Abruzzo,1304970,1492893,114.4,0.97
2021,2021-08-17,ABR,6585,3470,3115,2825,3542,218,ITF,ITF1,13,Abruzzo,Abruzzo,1304970,1499478,114.91,0.5
2022,2021-02-13,ABR,870,395,475,442,424,4,ITF,ITF1,13,Abruzzo,Abruzzo,1304970,1500348,114.97,0.07
2023,2021-07-17,ABR,14095,7384,6711,2646,11270,179,ITF,ITF1,13,Abruzzo,Abruzzo,1304970,1514443,116.05,1.08
2024,2021-03-04,ABR,5943,2360,3583,4973,928,42,ITF,ITF1,13,Abruzzo,Abruzzo,1304970,1520386,116.51,0.46
2025,2021-05-28,ABR,14026,6311,7715,7491,6366,169,ITF,ITF1,13,Abruzzo,Abruzzo,1304970,1534412,117.58,1.07
2026,2021-09-05,ABR,1428,781,647,437,963,28,ITF,ITF1,13,Abruzzo,Abruzzo,1304970,1535840,117.69,0.11
2027,2021-05-14,ABR,10595,5071,5524,5281,5152,162,ITF,ITF1,13,Abruzzo,Abruzzo,1304970,1546435,118.5,0.81
2028,2021-04-01,ABR,5629,2520,3109,3429,2120,80,ITF,ITF1,13,Abruzzo,Abruzzo,1304970,1552064,118.93,0.43
2029,2021-09-15,ABR,3551,1872,1679,744,2736,71,ITF,ITF1,13,Abruzzo,Abruzzo,1304970,1555615,119.21,0.27
2030,2021-04-04,ABR,1633,769,864,1458,129,46,ITF,ITF1,13,Abruzzo,Abruzzo,1304970,1557248,119.33,0.13
2031,2021-07-13,ABR,15524,7752,7772,2824,12523,177,ITF,ITF1,13,Abruzzo,Abruzzo,1304970,1572772,120.52,1.19
2032,2021-05-09,ABR,9159,4091,5068,4171,4874,114,ITF,ITF1,13,Abruzzo,Abruzzo,1304970,1581931,121.22,0.7
2033,2021-02-15,ABR,1794,832,962,1735,42,17,ITF,ITF1,13,Abruzzo,Abruzzo,1304970,1583725,121.36,0.14
2034,2021-05-26,ABR,13553,6045,7508,8398,4996,159,ITF,ITF1,13,Abruzzo,Abruzzo,1304970,1597278,122.4,1.04
2035,2021-06-14,ABR,10986,5432,5554,7428,3383,175,ITF,ITF1,13,Abruzzo,Abruzzo,1304970,1608264,123.24,0.84
2036,2021-08-12,ABR,8771,4627,4144,3180,5411,180,ITF,ITF1,13,Abruzzo,Abruzzo,1304970,1617035,123.91,0.67
2037,2021-06-16,ABR,10895,5452,5443,7989,2689,217,ITF,ITF1,13,Abruzzo,Abruzzo,1304970,1627930,124.75,0.83
2038,2021-02-27,ABR,2813,1338,1475,2513,267,33,ITF,ITF1,13,Abruzzo,Abruzzo,1304970,1630743,124.96,0.22
2039,2021-06-07,ABR,11102,5290,5812,9071,1845,186,ITF,ITF1,13,Abruzzo,Abruzzo,1304970,1641845,125.81,0.85
2040,2021-04-11,ABR,5380,2628,2752,4835,487,58,ITF,ITF1,13,Abruzzo,Abruzzo,1304970,1647225,126.23,0.41
2041,2021-06-09,ABR,11574,6093,5481,9703,1686,185,ITF,ITF1,13,Abruzzo,Abruzzo,1304970,1658799,127.11,0.89
2042,2021-03-06,ABR,4183,1361,2822,3571,571,41,ITF,ITF1,13,Abruzzo,Abruzzo,1304970,1662982,127.43,0.32
2043,2021-04-17,ABR,7358,3402,3956,4209,3052,97,ITF,ITF1,13,Abruzzo,Abruzzo,1304970,1670340,128.0,0.56
2044,2021-02-19,ABR,3301,1552,1749,3162,100,39,ITF,ITF1,13,Abruzzo,Abruzzo,1304970,1673641,128.25,0.25
2045,2021-01-07,ABR,1712,657,1055,1705,0,7,ITF,ITF1,13,Abruzzo,Abruzzo,1304970,1675353,128.38,0.13
2046,2021-07-30,ABR,12088,6436,5652,3793,8069,226,ITF,ITF1,13,Abruzzo,Abruzzo,1304970,1687441,129.31,0.93
2047,2021-02-26,ABR,3924,1679,2245,2929,969,26,ITF,ITF1,13,Abruzzo,Abruzzo,1304970,1691365,129.61,0.3
2048,2021-01-18,ABR,154,71,83,53,101,0,ITF,ITF1,13,Abruzzo,Abruzzo,1304970,1691519,129.62,0.01
2049,2021-06-24,ABR,10871,5411,5460,5721,4979,171,ITF,ITF1,13,Abruzzo,Abruzzo,1304970,1702390,130.45,0.83
2050,2021-04-28,ABR,9517,4591,4926,7307,2025,185,ITF,ITF1,13,Abruzzo,Abruzzo,1304970,1711907,131.18,0.73
2051,2021-05-12,ABR,9631,4603,5028,5871,3582,178,ITF,ITF1,13,Abruzzo,Abruzzo,1304970,1721538,131.92,0.74
2052,2021-03-16,ABR,3486,1453,2033,1804,1654,28,ITF,ITF1,13,Abruzzo,Abruzzo,1304970,1725024,132.19,0.27
2053,2021-08-20,ABR,6046,3165,2881,2032,3882,132,ITF,ITF1,13,Abruzzo,Abruzzo,1304970,1731070,132.65,0.46
2054,2021-08-06,ABR,10673,5706,4967,3683,6747,243,ITF,ITF1,13,Abruzzo,Abruzzo,1304970,1741743,133.47,0.82
2055,2021-05-05,ABR,11649,5576,6073,6275,5211,163,ITF,ITF1,13,Abruzzo,Abruzzo,1304970,1753392,134.36,0.89
2056,2021-03-09,ABR,5176,1806,3370,4147,938,91,ITF,ITF1,13,Abruzzo,Abruzzo,1304970,1758568,134.76,0.4
2057,2021-08-13,ABR,7120,3831,3289,2015,4999,106,ITF,ITF1,13,Abruzzo,Abruzzo,1304970,1765688,135.3,0.55
2058,2021-07-01,ABR,12763,6283,6480,5769,6768,226,ITF,ITF1,13,Abruzzo,Abruzzo,1304970,1778451,136.28,0.98
2059,2021-06-17,ABR,10914,5457,5457,7298,3452,164,ITF,ITF1,13,Abruzzo,Abruzzo,1304970,1789365,137.12,0.84
2060,2021-08-24,ABR,6359,3411,2948,1876,4331,152,ITF,ITF1,13,Abruzzo,Abruzzo,1304970,1795724,137.61,0.49
2061,2021-02-01,ABR,1633,574,1059,268,1364,1,ITF,ITF1,13,Abruzzo,Abruzzo,1304970,1797357,137.73,0.13
2062,2021-08-31,ABR,6393,3480,2913,1688,4595,110,ITF,ITF1,13,Abruzzo,Abruzzo,1304970,1803750,138.22,0.49
2063,2021-03-23,ABR,4835,2191,2644,2209,2567,59,ITF,ITF1,13,Abruzzo,Abruzzo,1304970,1808585,138.59,0.37
2064,2021-01-25,ABR,1606,634,972,11,1593,2,ITF,ITF1,13,Abruzzo,Abruzzo,1304970,1810191,138.72,0.12
2065,2021-05-30,VDA,865,429,436,682,171,12,ITC,ITC2,2,Valle d'Aosta / Vallée d'Aoste,Valle d'Aosta,125666,865,0.69,0.69
2066,2021-07-26,VDA,1008,512,496,314,683,11,ITC,ITC2,2,Valle d'Aosta / Vallée d'Aoste,Valle d'Aosta,125666,1873,1.49,0.8
2067,2021-09-07,VDA,690,364,326,111,576,3,ITC,ITC2,2,Valle d'Aosta / Vallée d'Aoste,Valle d'Aosta,125666,2563,2.04,0.55
2068,2021-05-28,VDA,977,415,562,545,414,18,ITC,ITC2,2,Valle d'Aosta / Vallée d'Aoste,Valle d'Aosta,125666,3540,2.82,0.78
2069,2021-02-17,VDA,329,146,183,225,101,3,ITC,ITC2,2,Valle d'Aosta / Vallée d'Aoste,Valle d'Aosta,125666,3869,3.08,0.26
2070,2021-02-05,VDA,296,103,193,102,194,0,ITC,ITC2,2,Valle d'Aosta / Vallée d'Aoste,Valle d'Aosta,125666,4165,3.31,0.24
2071,2021-02-22,VDA,318,95,223,212,104,2,ITC,ITC2,2,Valle d'Aosta / Vallée d'Aoste,Valle d'Aosta,125666,4483,3.57,0.25
2072,2021-05-16,VDA,690,342,348,340,342,8,ITC,ITC2,2,Valle d'Aosta / Vallée d'Aoste,Valle d'Aosta,125666,5173,4.12,0.55
2073,2021-08-07,VDA,740,434,306,307,419,14,ITC,ITC2,2,Valle d'Aosta / Vallée d'Aoste,Valle d'Aosta,125666,5913,4.71,0.59
2074,2021-02-03,VDA,354,116,238,15,339,0,ITC,ITC2,2,Valle d'Aosta / Vallée d'Aoste,Valle d'Aosta,125666,6267,4.99,0.28
2075,2021-04-01,VDA,778,394,384,747,12,19,ITC,ITC2,2,Valle d'Aosta / Vallée d'Aoste,Valle d'Aosta,125666,7045,5.61,0.62
2076,2021-03-08,VDA,488,233,255,240,245,3,ITC,ITC2,2,Valle d'Aosta / Vallée d'Aoste,Valle d'Aosta,125666,7533,5.99,0.39
2077,2021-08-12,VDA,377,204,173,117,248,12,ITC,ITC2,2,Valle d'Aosta / Vallée d'Aoste,Valle d'Aosta,125666,7910,6.29,0.3
2078,2021-05-04,VDA,1136,511,625,435,674,27,ITC,ITC2,2,Valle d'Aosta / Vallée d'Aoste,Valle d'Aosta,125666,9046,7.2,0.9
2079,2021-06-16,VDA,1065,566,499,663,395,7,ITC,ITC2,2,Valle d'Aosta / Vallée d'Aoste,Valle d'Aosta,125666,10111,8.05,0.85
2080,2021-03-15,VDA,387,141,246,175,203,9,ITC,ITC2,2,Valle d'Aosta / Vallée d'Aoste,Valle d'Aosta,125666,10498,8.35,0.31
2081,2021-08-19,VDA,265,158,107,70,180,15,ITC,ITC2,2,Valle d'Aosta / Vallée d'Aoste,Valle d'Aosta,125666,10763,8.56,0.21
2082,2021-05-11,VDA,649,326,323,472,150,27,ITC,ITC2,2,Valle d'Aosta / Vallée d'Aoste,Valle d'Aosta,125666,11412,9.08,0.52
2083,2021-04-27,VDA,979,424,555,653,292,34,ITC,ITC2,2,Valle d'Aosta / Vallée d'Aoste,Valle d'Aosta,125666,12391,9.86,0.78
2084,2021-01-27,VDA,156,75,81,80,76,0,ITC,ITC2,2,Valle d'Aosta / Vallée d'Aoste,Valle d'Aosta,125666,12547,9.98,0.12
2085,2021-04-20,VDA,937,430,507,710,196,31,ITC,ITC2,2,Valle d'Aosta / Vallée d'Aoste,Valle d'Aosta,125666,13484,10.73,0.75
2086,2021-01-10,VDA,220,71,149,212,0,8,ITC,ITC2,2,Valle d'Aosta / Vallée d'Aoste,Valle d'Aosta,125666,13704,10.91,0.18
2087,2020-12-27,VDA,20,9,11,20,0,0,ITC,ITC2,2,Valle d'Aosta / Vallée d'Aoste,Valle d'Aosta,125666,13724,10.92,0.02
2088,2021-09-02,VDA,520,271,249,88,416,16,ITC,ITC2,2,Valle d'Aosta / Vallée d'Aoste,Valle d'Aosta,125666,14244,11.33,0.41
2089,2021-04-15,VDA,814,378,436,643,140,31,ITC,ITC2,2,Valle d'Aosta / Vallée d'Aoste,Valle d'Aosta,125666,15058,11.98,0.65
2090,2021-07-07,VDA,795,442,353,414,364,17,ITC,ITC2,2,Valle d'Aosta / Vallée d'Aoste,Valle d'Aosta,125666,15853,12.62,0.63
2091,2021-07-24,VDA,1019,536,483,327,682,10,ITC,ITC2,2,Valle d'Aosta / Vallée d'Aoste,Valle d'Aosta,125666,16872,13.43,0.81
2092,2021-05-02,VDA,765,345,420,581,160,24,ITC,ITC2,2,Valle d'Aosta / Vallée d'Aoste,Valle d'Aosta,125666,17637,14.03,0.61
2093,2021-01-22,VDA,58,22,36,22,36,0,ITC,ITC2,2,Valle d'Aosta / Vallée d'Aoste,Valle d'Aosta,125666,17695,14.08,0.05
2094,2021-01-08,VDA,301,131,170,301,0,0,ITC,ITC2,2,Valle d'Aosta / Vallée d'Aoste,Valle d'Aosta,125666,17996,14.32,0.24
2095,2021-03-06,VDA,22,4,18,18,0,4,ITC,ITC2,2,Valle d'Aosta / Vallée d'Aoste,Valle d'Aosta,125666,18018,14.34,0.02
2096,2021-07-12,VDA,979,483,496,238,733,8,ITC,ITC2,2,Valle d'Aosta / Vallée d'Aoste,Valle d'Aosta,125666,18997,15.12,0.78
2097,2021-04-03,VDA,676,341,335,649,15,12,ITC,ITC2,2,Valle d'Aosta / Vallée d'Aoste,Valle d'Aosta,125666,19673,15.65,0.54
2098,2021-03-20,VDA,209,87,122,168,36,5,ITC,ITC2,2,Valle d'Aosta / Vallée d'Aoste,Valle d'Aosta,125666,19882,15.82,0.17
2099,2021-06-28,VDA,994,499,495,327,662,5,ITC,ITC2,2,Valle d'Aosta / Vallée d'Aoste,Valle d'Aosta,125666,20876,16.61,0.79
2100,2021-06-11,VDA,1048,484,564,752,283,13,ITC,ITC2,2,Valle d'Aosta / Vallée d'Aoste,Valle d'Aosta,125666,21924,17.45,0.83
2101,2021-02-10,VDA,248,77,171,141,107,0,ITC,ITC2,2,Valle d'Aosta / Vallée d'Aoste,Valle d'Aosta,125666,22172,17.64,0.2
2102,2021-03-25,VDA,389,154,235,364,10,15,ITC,ITC2,2,Valle d'Aosta / Vallée d'Aoste,Valle d'Aosta,125666,22561,17.95,0.31
2103,2021-05-21,VDA,933,443,490,523,401,9,ITC,ITC2,2,Valle d'Aosta / Vallée d'Aoste,Valle d'Aosta,125666,23494,18.7,0.74
2104,2021-06-04,VDA,910,385,525,468,435,7,ITC,ITC2,2,Valle d'Aosta / Vallée d'Aoste,Valle d'Aosta,125666,24404,19.42,0.72
2105,2021-08-26,VDA,343,168,175,82,254,7,ITC,ITC2,2,Valle d'Aosta / Vallée d'Aoste,Valle d'Aosta,125666,24747,19.69,0.27
2106,2021-09-14,VDA,545,273,272,9,535,1,ITC,ITC2,2,Valle d'Aosta / Vallée d'Aoste,Valle d'Aosta,125666,25292,20.13,0.43
2107,2021-07-19,VDA,879,460,419,252,619,8,ITC,ITC2,2,Valle d'Aosta / Vallée d'Aoste,Valle d'Aosta,125666,26171,20.83,0.7
2108,2021-02-24,VDA,185,84,101,163,21,1,ITC,ITC2,2,Valle d'Aosta / Vallée d'Aoste,Valle d'Aosta,125666,26356,20.97,0.15
2109,2021-04-08,VDA,585,282,303,420,144,21,ITC,ITC2,2,Valle d'Aosta / Vallée d'Aoste,Valle d'Aosta,125666,26941,21.44,0.47
2110,2021-01-17,VDA,131,56,75,131,0,0,ITC,ITC2,2,Valle d'Aosta / Vallée d'Aoste,Valle d'Aosta,125666,27072,21.54,0.1
2111,2021-06-23,VDA,1044,551,493,422,617,5,ITC,ITC2,2,Valle d'Aosta / Vallée d'Aoste,Valle d'Aosta,125666,28116,22.37,0.83
2112,2021-06-30,VDA,1121,544,577,417,695,9,ITC,ITC2,2,Valle d'Aosta / Vallée d'Aoste,Valle d'Aosta,125666,29237,23.27,0.89
2113,2021-06-09,VDA,1055,560,495,1010,35,10,ITC,ITC2,2,Valle d'Aosta / Vallée d'Aoste,Valle d'Aosta,125666,30292,24.11,0.84
2114,2021-03-01,VDA,182,66,116,140,34,8,ITC,ITC2,2,Valle d'Aosta / Vallée d'Aoste,Valle d'Aosta,125666,30474,24.25,0.14
2115,2021-02-15,VDA,264,136,128,226,35,3,ITC,ITC2,2,Valle d'Aosta / Vallée d'Aoste,Valle d'Aosta,125666,30738,24.46,0.21
2116,2021-08-14,VDA,465,256,209,135,314,16,ITC,ITC2,2,Valle d'Aosta / Vallée d'Aoste,Valle d'Aosta,125666,31203,24.83,0.37
2117,2021-03-13,VDA,147,88,59,141,0,6,ITC,ITC2,2,Valle d'Aosta / Vallée d'Aoste,Valle d'Aosta,125666,31350,24.95,0.12
2118,2021-01-15,VDA,220,83,137,220,0,0,ITC,ITC2,2,Valle d'Aosta / Vallée d'Aoste,Valle d'Aosta,125666,31570,25.12,0.18
2119,2021-04-13,VDA,373,171,202,312,44,17,ITC,ITC2,2,Valle d'Aosta / Vallée d'Aoste,Valle d'Aosta,125666,31943,25.42,0.3
2120,2021-07-05,VDA,836,357,479,313,510,13,ITC,ITC2,2,Valle d'Aosta / Vallée d'Aoste,Valle d'Aosta,125666,32779,26.08,0.67
2121,2021-03-27,VDA,337,166,171,292,31,14,ITC,ITC2,2,Valle d'Aosta / Vallée d'Aoste,Valle d'Aosta,125666,33116,26.35,0.27
2122,2021-06-18,VDA,1003,445,558,589,400,14,ITC,ITC2,2,Valle d'Aosta / Vallée d'Aoste,Valle d'Aosta,125666,34119,27.15,0.8
2123,2021-05-23,VDA,999,465,534,654,340,5,ITC,ITC2,2,Valle d'Aosta / Vallée d'Aoste,Valle d'Aosta,125666,35118,27.95,0.79
2124,2021-01-29,VDA,321,139,182,2,319,0,ITC,ITC2,2,Valle d'Aosta / Vallée d'Aoste,Valle d'Aosta,125666,35439,28.2,0.26
2125,2021-08-31,VDA,672,344,328,135,531,6,ITC,ITC2,2,Valle d'Aosta / Vallée d'Aoste,Valle d'Aosta,125666,36111,28.74,0.53
2126,2021-04-22,VDA,1068,450,618,652,383,33,ITC,ITC2,2,Valle d'Aosta / Vallée d'Aoste,Valle d'Aosta,125666,37179,29.59,0.85
2127,2021-05-09,VDA,574,287,287,425,130,19,ITC,ITC2,2,Valle d'Aosta / Vallée d'Aoste,Valle d'Aosta,125666,37753,30.04,0.46
2128,2021-07-31,VDA,892,466,426,319,557,16,ITC,ITC2,2,Valle d'Aosta / Vallée d'Aoste,Valle d'Aosta,125666,38645,30.75,0.71
2129,2021-04-17,VDA,638,407,231,596,2,40,ITC,ITC2,2,Valle d'Aosta / Vallée d'Aoste,Valle d'Aosta,125666,39283,31.26,0.51
2130,2021-01-07,VDA,280,113,167,280,0,0,ITC,ITC2,2,Valle d'Aosta / Vallée d'Aoste,Valle d'Aosta,125666,39563,31.48,0.22
2131,2021-02-19,VDA,292,102,190,267,24,1,ITC,ITC2,2,Valle d'Aosta / Vallée d'Aoste,Valle d'Aosta,125666,39855,31.72,0.23
2132,2021-08-04,VDA,1047,572,475,372,657,18,ITC,ITC2,2,Valle d'Aosta / Vallée d'Aoste,Valle d'Aosta,125666,40902,32.55,0.83
2133,2021-01-05,VDA,151,55,96,151,0,0,ITC,ITC2,2,Valle d'Aosta / Vallée d'Aoste,Valle d'Aosta,125666,41053,32.67,0.12
2134,2021-01-14,VDA,237,69,168,237,0,0,ITC,ITC2,2,Valle d'Aosta / Vallée d'Aoste,Valle d'Aosta,125666,41290,32.86,0.19
2135,2021-07-23,VDA,975,485,490,356,609,10,ITC,ITC2,2,Valle d'Aosta / Vallée d'Aoste,Valle d'Aosta,125666,42265,33.63,0.78
2136,2021-01-19,VDA,256,77,179,256,0,0,ITC,ITC2,2,Valle d'Aosta / Vallée d'Aoste,Valle d'Aosta,125666,42521,33.84,0.2
2137,2021-04-12,VDA,487,187,300,305,164,18,ITC,ITC2,2,Valle d'Aosta / Vallée d'Aoste,Valle d'Aosta,125666,43008,34.22,0.39
2138,2021-04-29,VDA,1293,636,657,742,532,19,ITC,ITC2,2,Valle d'Aosta / Vallée d'Aoste,Valle d'Aosta,125666,44301,35.25,1.03
2139,2021-07-21,VDA,1169,639,530,306,850,13,ITC,ITC2,2,Valle d'Aosta / Vallée d'Aoste,Valle d'Aosta,125666,45470,36.18,0.93
2140,2021-07-04,VDA,1193,531,662,350,829,14,ITC,ITC2,2,Valle d'Aosta / Vallée d'Aoste,Valle d'Aosta,125666,46663,37.13,0.95
2141,2021-06-13,VDA,857,403,454,370,482,5,ITC,ITC2,2,Valle d'Aosta / Vallée d'Aoste,Valle d'Aosta,125666,47520,37.81,0.68
2142,2021-06-08,VDA,772,408,364,731,33,8,ITC,ITC2,2,Valle d'Aosta / Vallée d'Aoste,Valle d'Aosta,125666,48292,38.43,0.61
2143,2021-02-26,VDA,210,58,152,110,86,14,ITC,ITC2,2,Valle d'Aosta / Vallée d'Aoste,Valle d'Aosta,125666,48502,38.6,0.17
2144,2021-05-25,VDA,1117,532,585,530,575,12,ITC,ITC2,2,Valle d'Aosta / Vallée d'Aoste,Valle d'Aosta,125666,49619,39.48,0.89
2145,2021-02-14,VDA,48,16,32,1,47,0,ITC,ITC2,2,Valle d'Aosta / Vallée d'Aoste,Valle d'Aosta,125666,49667,39.52,0.04
2146,2021-05-08,VDA,909,544,365,500,383,26,ITC,ITC2,2,Valle d'Aosta / Vallée d'Aoste,Valle d'Aosta,125666,50576,40.25,0.72
2147,2021-08-30,VDA,547,276,271,115,394,38,ITC,ITC2,2,Valle d'Aosta / Vallée d'Aoste,Valle d'Aosta,125666,51123,40.68,0.44
2148,2021-01-31,VDA,291,91,200,58,233,0,ITC,ITC2,2,Valle d'Aosta / Vallée d'Aoste,Valle d'Aosta,125666,51414,40.91,0.23
2149,2021-03-22,VDA,561,205,356,326,229,6,ITC,ITC2,2,Valle d'Aosta / Vallée d'Aoste,Valle d'Aosta,125666,51975,41.36,0.45
2150,2021-08-02,VDA,761,408,353,304,447,10,ITC,ITC2,2,Valle d'Aosta / Vallée d'Aoste,Valle d'Aosta,125666,52736,41.97,0.61
2151,2021-04-24,VDA,723,401,322,534,167,22,ITC,ITC2,2,Valle d'Aosta / Vallée d'Aoste,Valle d'Aosta,125666,53459,42.54,0.58
2152,2021-07-28,VDA,1425,765,660,356,1049,20,ITC,ITC2,2,Valle d'Aosta / Vallée d'Aoste,Valle d'Aosta,125666,54884,43.67,1.13
2153,2021-04-19,VDA,753,326,427,521,209,23,ITC,ITC2,2,Valle d'Aosta / Vallée d'Aoste,Valle d'Aosta,125666,55637,44.27,0.6
2154,2021-03-29,VDA,494,233,261,450,40,4,ITC,ITC2,2,Valle d'Aosta / Vallée d'Aoste,Valle d'Aosta,125666,56131,44.67,0.39
2155,2021-06-20,VDA,1134,545,589,477,644,13,ITC,ITC2,2,Valle d'Aosta / Vallée d'Aoste,Valle d'Aosta,125666,57265,45.57,0.9
2156,2021-03-12,VDA,535,177,358,301,226,8,ITC,ITC2,2,Valle d'Aosta / Vallée d'Aoste,Valle d'Aosta,125666,57800,45.99,0.43
2157,2021-09-11,VDA,390,238,152,2,385,3,ITC,ITC2,2,Valle d'Aosta / Vallée d'Aoste,Valle d'Aosta,125666,58190,46.31,0.31
2158,2021-03-10,VDA,439,184,255,220,214,5,ITC,ITC2,2,Valle d'Aosta / Vallée d'Aoste,Valle d'Aosta,125666,58629,46.65,0.35
2159,2021-02-21,VDA,18,3,15,0,18,0,ITC,ITC2,2,Valle d'Aosta / Vallée d'Aoste,Valle d'Aosta,125666,58647,46.67,0.01
2160,2021-09-09,VDA,324,174,150,100,215,9,ITC,ITC2,2,Valle d'Aosta / Vallée d'Aoste,Valle d'Aosta,125666,58971,46.93,0.26
2161,2021-06-01,VDA,874,471,403,511,354,9,ITC,ITC2,2,Valle d'Aosta / Vallée d'Aoste,Valle d'Aosta,125666,59845,47.62,0.7
2162,2021-09-04,VDA,513,271,242,130,368,15,ITC,ITC2,2,Valle d'Aosta / Vallée d'Aoste,Valle d'Aosta,125666,60358,48.03,0.41
2163,2021-03-17,VDA,438,185,253,259,165,14,ITC,ITC2,2,Valle d'Aosta / Vallée d'Aoste,Valle d'Aosta,125666,60796,48.38,0.35
2164,2021-03-03,VDA,258,119,139,182,71,5,ITC,ITC2,2,Valle d'Aosta / Vallée d'Aoste,Valle d'Aosta,125666,61054,48.58,0.21
2165,2021-08-16,VDA,422,211,211,129,276,17,ITC,ITC2,2,Valle d'Aosta / Vallée d'Aoste,Valle d'Aosta,125666,61476,48.92,0.34
2166,2021-04-05,VDA,465,223,242,445,6,14,ITC,ITC2,2,Valle d'Aosta / Vallée d'Aoste,Valle d'Aosta,125666,61941,49.29,0.37
2167,2021-06-27,VDA,1254,609,645,311,931,12,ITC,ITC2,2,Valle d'Aosta / Vallée d'Aoste,Valle d'Aosta,125666,63195,50.29,1.0
2168,2021-07-14,VDA,1021,534,487,289,728,4,ITC,ITC2,2,Valle d'Aosta / Vallée d'Aoste,Valle d'Aosta,125666,64216,51.1,0.81
2169,2021-04-10,VDA,405,191,214,389,5,11,ITC,ITC2,2,Valle d'Aosta / Vallée d'Aoste,Valle d'Aosta,125666,64621,51.42,0.32
2170,2020-12-31,VDA,18,4,14,18,0,0,ITC,ITC2,2,Valle d'Aosta / Vallée d'Aoste,Valle d'Aosta,125666,64639,51.44,0.01
2171,2021-06-06,VDA,1161,582,579,780,374,7,ITC,ITC2,2,Valle d'Aosta / Vallée d'Aoste,Valle d'Aosta,125666,65800,52.36,0.92
2172,2021-06-15,VDA,924,508,416,654,257,13,ITC,ITC2,2,Valle d'Aosta / Vallée d'Aoste,Valle d'Aosta,125666,66724,53.1,0.74
2173,2021-08-11,VDA,777,380,397,304,452,21,ITC,ITC2,2,Valle d'Aosta / Vallée d'Aoste,Valle d'Aosta,125666,67501,53.71,0.62
2174,2021-05-18,VDA,972,484,488,349,619,4,ITC,ITC2,2,Valle d'Aosta / Vallée d'Aoste,Valle d'Aosta,125666,68473,54.49,0.77
2175,2021-02-07,VDA,292,120,172,190,102,0,ITC,ITC2,2,Valle d'Aosta / Vallée d'Aoste,Valle d'Aosta,125666,68765,54.72,0.23
2176,2021-08-09,VDA,675,336,339,250,404,21,ITC,ITC2,2,Valle d'Aosta / Vallée d'Aoste,Valle d'Aosta,125666,69440,55.26,0.54
2177,2021-05-01,VDA,941,564,377,440,484,17,ITC,ITC2,2,Valle d'Aosta / Vallée d'Aoste,Valle d'Aosta,125666,70381,56.01,0.75
2178,2021-04-14,VDA,942,430,512,692,224,26,ITC,ITC2,2,Valle d'Aosta / Vallée d'Aoste,Valle d'Aosta,125666,71323,56.76,0.75
2179,2021-07-06,VDA,886,481,405,158,723,5,ITC,ITC2,2,Valle d'Aosta / Vallée d'Aoste,Valle d'Aosta,125666,72209,57.46,0.71
2180,2021-01-02,VDA,6,5,1,6,0,0,ITC,ITC2,2,Valle d'Aosta / Vallée d'Aoste,Valle d'Aosta,125666,72215,57.47,0.0
2181,2021-03-26,VDA,498,204,294,482,7,9,ITC,ITC2,2,Valle d'Aosta / Vallée d'Aoste,Valle d'Aosta,125666,72713,57.86,0.4
2182,2021-06-17,VDA,991,530,461,635,342,14,ITC,ITC2,2,Valle d'Aosta / Vallée d'Aoste,Valle d'Aosta,125666,73704,58.65,0.79
2183,2021-06-05,VDA,927,477,450,730,188,9,ITC,ITC2,2,Valle d'Aosta / Vallée d'Aoste,Valle d'Aosta,125666,74631,59.39,0.74
2184,2021-02-11,VDA,232,107,125,222,9,1,ITC,ITC2,2,Valle d'Aosta / Vallée d'Aoste,Valle d'Aosta,125666,74863,59.57,0.18
2185,2021-07-18,VDA,931,457,474,242,674,15,ITC,ITC2,2,Valle d'Aosta / Vallée d'Aoste,Valle d'Aosta,125666,75794,60.31,0.74
2186,2021-04-09,VDA,238,111,127,201,33,4,ITC,ITC2,2,Valle d'Aosta / Vallée d'Aoste,Valle d'Aosta,125666,76032,60.5,0.19
2187,2021-09-13,VDA,289,149,140,14,274,1,ITC,ITC2,2,Valle d'Aosta / Vallée d'Aoste,Valle d'Aosta,125666,76321,60.73,0.23
2188,2021-05-22,VDA,956,505,451,545,401,10,ITC,ITC2,2,Valle d'Aosta / Vallée d'Aoste,Valle d'Aosta,125666,77277,61.49,0.76
2189,2021-01-16,VDA,238,80,158,238,0,0,ITC,ITC2,2,Valle d'Aosta / Vallée d'Aoste,Valle d'Aosta,125666,77515,61.68,0.19
2190,2021-06-22,VDA,1192,666,526,531,649,12,ITC,ITC2,2,Valle d'Aosta / Vallée d'Aoste,Valle d'Aosta,125666,78707,62.63,0.95
2191,2021-03-14,VDA,394,202,192,376,0,18,ITC,ITC2,2,Valle d'Aosta / Vallée d'Aoste,Valle d'Aosta,125666,79101,62.95,0.31
2192,2021-04-26,VDA,718,330,388,516,170,32,ITC,ITC2,2,Valle d'Aosta / Vallée d'Aoste,Valle d'Aosta,125666,79819,63.52,0.57
2193,2021-08-27,VDA,498,259,239,122,366,10,ITC,ITC2,2,Valle d'Aosta / Vallée d'Aoste,Valle d'Aosta,125666,80317,63.91,0.4
2194,2021-07-01,VDA,962,473,489,328,621,13,ITC,ITC2,2,Valle d'Aosta / Vallée d'Aoste,Valle d'Aosta,125666,81279,64.68,0.77
2195,2021-08-23,VDA,404,205,199,91,299,14,ITC,ITC2,2,Valle d'Aosta / Vallée d'Aoste,Valle d'Aosta,125666,81683,65.0,0.32
2196,2021-02-23,VDA,217,124,93,216,0,1,ITC,ITC2,2,Valle d'Aosta / Vallée d'Aoste,Valle d'Aosta,125666,81900,65.17,0.17
2197,2021-07-16,VDA,1079,555,524,338,731,10,ITC,ITC2,2,Valle d'Aosta / Vallée d'Aoste,Valle d'Aosta,125666,82979,66.03,0.86
2198,2021-01-26,VDA,149,52,97,2,147,0,ITC,ITC2,2,Valle d'Aosta / Vallée d'Aoste,Valle d'Aosta,125666,83128,66.15,0.12
2199,2021-02-12,VDA,263,96,167,216,46,1,ITC,ITC2,2,Valle d'Aosta / Vallée d'Aoste,Valle d'Aosta,125666,83391,66.36,0.21
2200,2021-01-12,VDA,303,73,230,303,0,0,ITC,ITC2,2,Valle d'Aosta / Vallée d'Aoste,Valle d'Aosta,125666,83694,66.6,0.24
2201,2021-09-01,VDA,800,428,372,188,586,26,ITC,ITC2,2,Valle d'Aosta / Vallée d'Aoste,Valle d'Aosta,125666,84494,67.24,0.64
2202,2021-05-24,VDA,1141,518,623,678,447,16,ITC,ITC2,2,Valle d'Aosta / Vallée d'Aoste,Valle d'Aosta,125666,85635,68.14,0.91
2203,2021-05-10,VDA,786,385,401,533,235,18,ITC,ITC2,2,Valle d'Aosta / Vallée d'Aoste,Valle d'Aosta,125666,86421,68.77,0.63
2204,2021-08-18,VDA,687,356,331,235,433,19,ITC,ITC2,2,Valle d'Aosta / Vallée d'Aoste,Valle d'Aosta,125666,87108,69.32,0.55
2205,2021-07-30,VDA,966,501,465,419,525,22,ITC,ITC2,2,Valle d'Aosta / Vallée d'Aoste,Valle d'Aosta,125666,88074,70.09,0.77
2206,2021-04-21,VDA,869,410,459,588,249,32,ITC,ITC2,2,Valle d'Aosta / Vallée d'Aoste,Valle d'Aosta,125666,88943,70.78,0.69
2207,2021-07-13,VDA,1063,567,496,309,748,6,ITC,ITC2,2,Valle d'Aosta / Vallée d'Aoste,Valle d'Aosta,125666,90006,71.62,0.85
2208,2021-08-01,VDA,842,445,397,286,547,9,ITC,ITC2,2,Valle d'Aosta / Vallée d'Aoste,Valle d'Aosta,125666,90848,72.29,0.67
2209,2021-01-28,VDA,294,124,170,55,239,0,ITC,ITC2,2,Valle d'Aosta / Vallée d'Aoste,Valle d'Aosta,125666,91142,72.53,0.23
2210,2021-06-12,VDA,1234,600,634,1058,167,9,ITC,ITC2,2,Valle d'Aosta / Vallée d'Aoste,Valle d'Aosta,125666,92376,73.51,0.98
2211,2021-06-03,VDA,1313,670,643,882,414,17,ITC,ITC2,2,Valle d'Aosta / Vallée d'Aoste,Valle d'Aosta,125666,93689,74.55,1.04
2212,2021-08-25,VDA,681,348,333,128,527,26,ITC,ITC2,2,Valle d'Aosta / Vallée d'Aoste,Valle d'Aosta,125666,94370,75.1,0.54
2213,2021-05-17,VDA,809,417,392,365,434,10,ITC,ITC2,2,Valle d'Aosta / Vallée d'Aoste,Valle d'Aosta,125666,95179,75.74,0.64
2214,2021-08-08,VDA,580,298,282,176,394,10,ITC,ITC2,2,Valle d'Aosta / Vallée d'Aoste,Valle d'Aosta,125666,95759,76.2,0.46
2215,2021-05-15,VDA,1068,615,453,368,687,13,ITC,ITC2,2,Valle d'Aosta / Vallée d'Aoste,Valle d'Aosta,125666,96827,77.05,0.85
2216,2021-02-04,VDA,295,86,209,8,287,0,ITC,ITC2,2,Valle d'Aosta / Vallée d'Aoste,Valle d'Aosta,125666,97122,77.29,0.23
2217,2021-04-28,VDA,1220,633,587,683,503,34,ITC,ITC2,2,Valle d'Aosta / Vallée d'Aoste,Valle d'Aosta,125666,98342,78.26,0.97
2218,2021-01-21,VDA,33,12,21,33,0,0,ITC,ITC2,2,Valle d'Aosta / Vallée d'Aoste,Valle d'Aosta,125666,98375,78.28,0.03
2219,2021-01-04,VDA,144,61,83,144,0,0,ITC,ITC2,2,Valle d'Aosta / Vallée d'Aoste,Valle d'Aosta,125666,98519,78.4,0.11
2220,2021-03-05,VDA,277,125,152,53,223,1,ITC,ITC2,2,Valle d'Aosta / Vallée d'Aoste,Valle d'Aosta,125666,98796,78.62,0.22
2221,2021-02-28,VDA,260,86,174,73,183,4,ITC,ITC2,2,Valle d'Aosta / Vallée d'Aoste,Valle d'Aosta,125666,99056,78.82,0.21
2222,2021-05-05,VDA,1039,566,473,435,582,22,ITC,ITC2,2,Valle d'Aosta / Vallée d'Aoste,Valle d'Aosta,125666,100095,79.65,0.83
2223,2021-07-25,VDA,1021,494,527,262,749,10,ITC,ITC2,2,Valle d'Aosta / Vallée d'Aoste,Valle d'Aosta,125666,101116,80.46,0.81
2224,2021-04-16,VDA,599,261,338,566,2,31,ITC,ITC2,2,Valle d'Aosta / Vallée d'Aoste,Valle d'Aosta,125666,101715,80.94,0.48
2225,2021-04-02,VDA,875,345,530,626,226,23,ITC,ITC2,2,Valle d'Aosta / Vallée d'Aoste,Valle d'Aosta,125666,102590,81.64,0.7
2226,2021-09-06,VDA,495,245,250,145,319,31,ITC,ITC2,2,Valle d'Aosta / Vallée d'Aoste,Valle d'Aosta,125666,103085,82.03,0.39
2227,2021-05-29,VDA,800,436,364,554,239,7,ITC,ITC2,2,Valle d'Aosta / Vallée d'Aoste,Valle d'Aosta,125666,103885,82.67,0.64
2228,2021-07-11,VDA,908,472,436,253,643,12,ITC,ITC2,2,Valle d'Aosta / Vallée d'Aoste,Valle d'Aosta,125666,104793,83.39,0.72
2229,2021-02-25,VDA,202,101,101,190,8,4,ITC,ITC2,2,Valle d'Aosta / Vallée d'Aoste,Valle d'Aosta,125666,104995,83.55,0.16
2230,2021-01-09,VDA,445,200,245,445,0,0,ITC,ITC2,2,Valle d'Aosta / Vallée d'Aoste,Valle d'Aosta,125666,105440,83.9,0.35
2231,2021-06-24,VDA,1227,631,596,381,837,9,ITC,ITC2,2,Valle d'Aosta / Vallée d'Aoste,Valle d'Aosta,125666,106667,84.88,0.98
2232,2021-07-03,VDA,937,486,451,390,537,10,ITC,ITC2,2,Valle d'Aosta / Vallée d'Aoste,Valle d'Aosta,125666,107604,85.63,0.75
2233,2021-08-29,VDA,209,120,89,6,202,1,ITC,ITC2,2,Valle d'Aosta / Vallée d'Aoste,Valle d'Aosta,125666,107813,85.79,0.17
2234,2021-02-08,VDA,224,83,141,25,199,0,ITC,ITC2,2,Valle d'Aosta / Vallée d'Aoste,Valle d'Aosta,125666,108037,85.97,0.18
2235,2021-03-23,VDA,382,150,232,231,135,16,ITC,ITC2,2,Valle d'Aosta / Vallée d'Aoste,Valle d'Aosta,125666,108419,86.28,0.3
2236,2021-05-19,VDA,993,498,495,410,575,8,ITC,ITC2,2,Valle d'Aosta / Vallée d'Aoste,Valle d'Aosta,125666,109412,87.07,0.79
2237,2021-03-21,VDA,360,169,191,351,0,9,ITC,ITC2,2,Valle d'Aosta / Vallée d'Aoste,Valle d'Aosta,125666,109772,87.35,0.29
2238,2021-06-29,VDA,782,390,392,236,543,3,ITC,ITC2,2,Valle d'Aosta / Vallée d'Aoste,Valle d'Aosta,125666,110554,87.97,0.62
2239,2021-06-10,VDA,1058,611,447,1007,41,10,ITC,ITC2,2,Valle d'Aosta / Vallée d'Aoste,Valle d'Aosta,125666,111612,88.82,0.84
2240,2021-03-02,VDA,340,166,174,291,3,46,ITC,ITC2,2,Valle d'Aosta / Vallée d'Aoste,Valle d'Aosta,125666,111952,89.09,0.27
2241,2021-03-19,VDA,322,85,237,285,35,2,ITC,ITC2,2,Valle d'Aosta / Vallée d'Aoste,Valle d'Aosta,125666,112274,89.34,0.26
2242,2021-05-07,VDA,566,247,319,514,30,22,ITC,ITC2,2,Valle d'Aosta / Vallée d'Aoste,Valle d'Aosta,125666,112840,89.79,0.45
2243,2021-04-23,VDA,923,443,480,511,383,29,ITC,ITC2,2,Valle d'Aosta / Vallée d'Aoste,Valle d'Aosta,125666,113763,90.53,0.73
2244,2021-01-13,VDA,338,110,228,338,0,0,ITC,ITC2,2,Valle d'Aosta / Vallée d'Aoste,Valle d'Aosta,125666,114101,90.8,0.27
2245,2021-07-29,VDA,998,508,490,320,667,11,ITC,ITC2,2,Valle d'Aosta / Vallée d'Aoste,Valle d'Aosta,125666,115099,91.59,0.79
2246,2021-07-15,VDA,1099,596,503,287,800,12,ITC,ITC2,2,Valle d'Aosta / Vallée d'Aoste,Valle d'Aosta,125666,116198,92.47,0.87
2247,2021-04-06,VDA,743,382,361,598,112,33,ITC,ITC2,2,Valle d'Aosta / Vallée d'Aoste,Valle d'Aosta,125666,116941,93.06,0.59
2248,2021-08-06,VDA,821,400,421,402,398,21,ITC,ITC2,2,Valle d'Aosta / Vallée d'Aoste,Valle d'Aosta,125666,117762,93.71,0.65
2249,2021-08-10,VDA,854,437,417,581,263,10,ITC,ITC2,2,Valle d'Aosta / Vallée d'Aoste,Valle d'Aosta,125666,118616,94.39,0.68
2250,2021-08-05,VDA,787,406,381,281,480,26,ITC,ITC2,2,Valle d'Aosta / Vallée d'Aoste,Valle d'Aosta,125666,119403,95.02,0.63
2251,2021-01-06,VDA,66,34,32,66,0,0,ITC,ITC2,2,Valle d'Aosta / Vallée d'Aoste,Valle d'Aosta,125666,119469,95.07,0.05
2252,2021-02-18,VDA,349,153,196,256,88,5,ITC,ITC2,2,Valle d'Aosta / Vallée d'Aoste,Valle d'Aosta,125666,119818,95.35,0.28
2253,2021-09-05,VDA,143,75,68,4,136,3,ITC,ITC2,2,Valle d'Aosta / Vallée d'Aoste,Valle d'Aosta,125666,119961,95.46,0.11
2254,2021-03-16,VDA,186,37,149,109,68,9,ITC,ITC2,2,Valle d'Aosta / Vallée d'Aoste,Valle d'Aosta,125666,120147,95.61,0.15
2255,2021-02-06,VDA,290,104,186,91,198,1,ITC,ITC2,2,Valle d'Aosta / Vallée d'Aoste,Valle d'Aosta,125666,120437,95.84,0.23
2256,2021-04-30,VDA,833,357,476,469,347,17,ITC,ITC2,2,Valle d'Aosta / Vallée d'Aoste,Valle d'Aosta,125666,121270,96.5,0.66
2257,2021-01-20,VDA,64,15,49,64,0,0,ITC,ITC2,2,Valle d'Aosta / Vallée d'Aoste,Valle d'Aosta,125666,121334,96.55,0.05
2258,2021-07-22,VDA,981,519,462,266,704,11,ITC,ITC2,2,Valle d'Aosta / Vallée d'Aoste,Valle d'Aosta,125666,122315,97.33,0.78
2259,2021-03-28,VDA,524,213,311,497,0,27,ITC,ITC2,2,Valle d'Aosta / Vallée d'Aoste,Valle d'Aosta,125666,122839,97.75,0.42
2260,2021-03-11,VDA,392,164,228,152,239,1,ITC,ITC2,2,Valle d'Aosta / Vallée d'Aoste,Valle d'Aosta,125666,123231,98.06,0.31
2261,2021-06-02,VDA,1217,689,528,810,402,5,ITC,ITC2,2,Valle d'Aosta / Vallée d'Aoste,Valle d'Aosta,125666,124448,99.03,0.97
2262,2021-06-19,VDA,1295,671,624,658,621,16,ITC,ITC2,2,Valle d'Aosta / Vallée d'Aoste,Valle d'Aosta,125666,125743,100.06,1.03
2263,2021-09-10,VDA,615,300,315,208,364,43,ITC,ITC2,2,Valle d'Aosta / Vallée d'Aoste,Valle d'Aosta,125666,126358,100.55,0.49
2264,2021-08-24,VDA,672,370,302,144,518,10,ITC,ITC2,2,Valle d'Aosta / Vallée d'Aoste,Valle d'Aosta,125666,127030,101.09,0.53
2265,2021-03-09,VDA,206,96,110,167,32,7,ITC,ITC2,2,Valle d'Aosta / Vallée d'Aoste,Valle d'Aosta,125666,127236,101.25,0.16
2266,2021-02-20,VDA,257,215,42,244,10,3,ITC,ITC2,2,Valle d'Aosta / Vallée d'Aoste,Valle d'Aosta,125666,127493,101.45,0.2
2267,2021-01-11,VDA,328,113,215,328,0,0,ITC,ITC2,2,Valle d'Aosta / Vallée d'Aoste,Valle d'Aosta,125666,127821,101.71,0.26
2268,2021-03-18,VDA,136,43,93,96,37,3,ITC,ITC2,2,Valle d'Aosta / Vallée d'Aoste,Valle d'Aosta,125666,127957,101.82,0.11
2269,2021-06-26,VDA,1066,512,554,352,707,7,ITC,ITC2,2,Valle d'Aosta / Vallée d'Aoste,Valle d'Aosta,125666,129023,102.67,0.85
2270,2021-03-04,VDA,291,139,152,38,251,2,ITC,ITC2,2,Valle d'Aosta / Vallée d'Aoste,Valle d'Aosta,125666,129314,102.9,0.23
2271,2021-05-26,VDA,1212,587,625,567,634,11,ITC,ITC2,2,Valle d'Aosta / Vallée d'Aoste,Valle d'Aosta,125666,130526,103.87,0.96
2272,2021-09-03,VDA,534,283,251,139,369,26,ITC,ITC2,2,Valle d'Aosta / Vallée d'Aoste,Valle d'Aosta,125666,131060,104.29,0.42
2273,2021-08-13,VDA,495,273,222,203,283,9,ITC,ITC2,2,Valle d'Aosta / Vallée d'Aoste,Valle d'Aosta,125666,131555,104.69,0.39
2274,2021-05-03,VDA,841,400,441,459,352,30,ITC,ITC2,2,Valle d'Aosta / Vallée d'Aoste,Valle d'Aosta,125666,132396,105.36,0.67
2275,2021-03-07,VDA,64,30,34,11,53,0,ITC,ITC2,2,Valle d'Aosta / Vallée d'Aoste,Valle d'Aosta,125666,132460,105.41,0.05
2276,2021-08-20,VDA,473,240,233,142,316,15,ITC,ITC2,2,Valle d'Aosta / Vallée d'Aoste,Valle d'Aosta,125666,132933,105.78,0.38
2277,2021-01-18,VDA,214,74,140,214,0,0,ITC,ITC2,2,Valle d'Aosta / Vallée d'Aoste,Valle d'Aosta,125666,133147,105.95,0.17
2278,2021-04-11,VDA,479,208,271,462,0,17,ITC,ITC2,2,Valle d'Aosta / Vallée d'Aoste,Valle d'Aosta,125666,133626,106.33,0.38
2279,2021-04-04,VDA,573,254,319,562,0,11,ITC,ITC2,2,Valle d'Aosta / Vallée d'Aoste,Valle d'Aosta,125666,134199,106.79,0.46
2280,2021-08-17,VDA,560,306,254,210,342,8,ITC,ITC2,2,Valle d'Aosta / Vallée d'Aoste,Valle d'Aosta,125666,134759,107.24,0.45
2281,2021-02-13,VDA,218,198,20,215,1,2,ITC,ITC2,2,Valle d'Aosta / Vallée d'Aoste,Valle d'Aosta,125666,134977,107.41,0.17
2282,2021-01-30,VDA,440,203,237,12,426,2,ITC,ITC2,2,Valle d'Aosta / Vallée d'Aoste,Valle d'Aosta,125666,135417,107.76,0.35
2283,2021-01-25,VDA,150,67,83,1,149,0,ITC,ITC2,2,Valle d'Aosta / Vallée d'Aoste,Valle d'Aosta,125666,135567,107.88,0.12
2284,2021-07-10,VDA,1295,670,625,320,964,11,ITC,ITC2,2,Valle d'Aosta / Vallée d'Aoste,Valle d'Aosta,125666,136862,108.91,1.03
2285,2021-08-22,VDA,177,88,89,8,169,0,ITC,ITC2,2,Valle d'Aosta / Vallée d'Aoste,Valle d'Aosta,125666,137039,109.05,0.14
2286,2021-05-14,VDA,964,444,520,264,670,30,ITC,ITC2,2,Valle d'Aosta / Vallée d'Aoste,Valle d'Aosta,125666,138003,109.82,0.77
2287,2021-02-01,VDA,409,128,281,86,320,3,ITC,ITC2,2,Valle d'Aosta / Vallée d'Aoste,Valle d'Aosta,125666,138412,110.14,0.33
2288,2021-07-08,VDA,1276,709,567,339,926,11,ITC,ITC2,2,Valle d'Aosta / Vallée d'Aoste,Valle d'Aosta,125666,139688,111.16,1.02
2289,2021-03-30,VDA,402,223,179,364,20,18,ITC,ITC2,2,Valle d'Aosta / Vallée d'Aoste,Valle d'Aosta,125666,140090,111.48,0.32
2290,2021-05-12,VDA,1145,550,595,450,671,24,ITC,ITC2,2,Valle d'Aosta / Vallée d'Aoste,Valle d'Aosta,125666,141235,112.39,0.91
2291,2021-07-17,VDA,987,521,466,249,731,7,ITC,ITC2,2,Valle d'Aosta / Vallée d'Aoste,Valle d'Aosta,125666,142222,113.17,0.79
2292,2021-03-31,VDA,555,302,253,511,26,18,ITC,ITC2,2,Valle d'Aosta / Vallée d'Aoste,Valle d'Aosta,125666,142777,113.62,0.44
2293,2021-05-27,VDA,1093,498,595,575,506,12,ITC,ITC2,2,Valle d'Aosta / Vallée d'Aoste,Valle d'Aosta,125666,143870,114.49,0.87
2294,2021-05-13,VDA,1146,561,585,523,602,21,ITC,ITC2,2,Valle d'Aosta / Vallée d'Aoste,Valle d'Aosta,125666,145016,115.4,0.91
2295,2021-02-02,VDA,287,73,214,3,284,0,ITC,ITC2,2,Valle d'Aosta / Vallée d'Aoste,Valle d'Aosta,125666,145303,115.63,0.23
2296,2021-07-09,VDA,946,446,500,279,657,10,ITC,ITC2,2,Valle d'Aosta / Vallée d'Aoste,Valle d'Aosta,125666,146249,116.38,0.75
2297,2021-06-25,VDA,980,445,535,323,653,4,ITC,ITC2,2,Valle d'Aosta / Vallée d'Aoste,Valle d'Aosta,125666,147229,117.16,0.78
2298,2021-08-21,VDA,441,221,220,93,331,17,ITC,ITC2,2,Valle d'Aosta / Vallée d'Aoste,Valle d'Aosta,125666,147670,117.51,0.35
2299,2021-05-20,VDA,1045,475,570,592,440,13,ITC,ITC2,2,Valle d'Aosta / Vallée d'Aoste,Valle d'Aosta,125666,148715,118.34,0.83
2300,2021-07-02,VDA,873,387,486,304,563,6,ITC,ITC2,2,Valle d'Aosta / Vallée d'Aoste,Valle d'Aosta,125666,149588,119.04,0.69
2301,2021-03-24,VDA,518,230,288,256,259,3,ITC,ITC2,2,Valle d'Aosta / Vallée d'Aoste,Valle d'Aosta,125666,150106,119.45,0.41
2302,2021-08-28,VDA,535,285,250,90,423,22,ITC,ITC2,2,Valle d'Aosta / Vallée d'Aoste,Valle d'Aosta,125666,150641,119.87,0.43
2303,2021-05-06,VDA,1083,516,567,664,385,34,ITC,ITC2,2,Valle d'Aosta / Vallée d'Aoste,Valle d'Aosta,125666,151724,120.74,0.86
2304,2021-02-16,VDA,328,53,275,316,6,6,ITC,ITC2,2,Valle d'Aosta / Vallée d'Aoste,Valle d'Aosta,125666,152052,121.0,0.26
2305,2021-04-07,VDA,910,474,436,655,229,26,ITC,ITC2,2,Valle d'Aosta / Vallée d'Aoste,Valle d'Aosta,125666,152962,121.72,0.72
2306,2021-09-08,VDA,607,307,300,207,346,54,ITC,ITC2,2,Valle d'Aosta / Vallée d'Aoste,Valle d'Aosta,125666,153569,122.2,0.48
2307,2021-02-09,VDA,255,86,169,70,184,1,ITC,ITC2,2,Valle d'Aosta / Vallée d'Aoste,Valle d'Aosta,125666,153824,122.41,0.2
2308,2021-07-20,VDA,1121,585,536,387,724,10,ITC,ITC2,2,Valle d'Aosta / Vallée d'Aoste,Valle d'Aosta,125666,154945,123.3,0.89
2309,2021-09-15,VDA,280,138,142,6,273,1,ITC,ITC2,2,Valle d'Aosta / Vallée d'Aoste,Valle d'Aosta,125666,155225,123.52,0.22
2310,2021-04-18,VDA,523,255,268,495,2,26,ITC,ITC2,2,Valle d'Aosta / Vallée d'Aoste,Valle d'Aosta,125666,155748,123.94,0.42
2311,2021-06-14,VDA,1017,523,494,575,428,14,ITC,ITC2,2,Valle d'Aosta / Vallée d'Aoste,Valle d'Aosta,125666,156765,124.75,0.81
2312,2021-05-31,VDA,881,396,485,490,380,11,ITC,ITC2,2,Valle d'Aosta / Vallée d'Aoste,Valle d'Aosta,125666,157646,125.45,0.7
2313,2021-07-27,VDA,1130,604,526,568,552,10,ITC,ITC2,2,Valle d'Aosta / Vallée d'Aoste,Valle d'Aosta,125666,158776,126.35,0.9
2314,2021-04-25,VDA,850,409,441,674,139,37,ITC,ITC2,2,Valle d'Aosta / Vallée d'Aoste,Valle d'Aosta,125666,159626,127.02,0.68
2315,2021-06-21,VDA,1124,600,524,608,506,10,ITC,ITC2,2,Valle d'Aosta / Vallée d'Aoste,Valle d'Aosta,125666,160750,127.92,0.89
2316,2021-06-07,VDA,711,347,364,637,61,13,ITC,ITC2,2,Valle d'Aosta / Vallée d'Aoste,Valle d'Aosta,125666,161461,128.48,0.57
2317,2021-02-27,VDA,232,86,146,120,107,5,ITC,ITC2,2,Valle d'Aosta / Vallée d'Aoste,Valle d'Aosta,125666,161693,128.67,0.18
2318,2021-08-03,VDA,946,489,457,573,358,15,ITC,ITC2,2,Valle d'Aosta / Vallée d'Aoste,Valle d'Aosta,125666,162639,129.42,0.75
2319,2021-07-18,LIG,2384,1223,1161,383,1984,17,ITC,ITC3,7,Liguria,Liguria,1550640,2384,0.15,0.15
2320,2021-06-05,LIG,8110,4132,3978,4922,3156,32,ITC,ITC3,7,Liguria,Liguria,1550640,10494,0.68,0.52
2321,2021-04-09,LIG,12486,5570,6916,10563,1787,136,ITC,ITC3,7,Liguria,Liguria,1550640,22980,1.48,0.81
2322,2021-09-13,LIG,6992,3602,3390,2331,4541,120,ITC,ITC3,7,Liguria,Liguria,1550640,29972,1.93,0.45
2323,2021-03-31,LIG,11956,5292,6664,9072,2780,104,ITC,ITC3,7,Liguria,Liguria,1550640,41928,2.7,0.77
2324,2021-03-26,LIG,9361,4043,5318,6094,3160,107,ITC,ITC3,7,Liguria,Liguria,1550640,51289,3.31,0.6
2325,2021-07-04,LIG,4863,2583,2280,3800,1001,62,ITC,ITC3,7,Liguria,Liguria,1550640,56152,3.62,0.31
2326,2021-01-02,LIG,693,247,446,693,0,0,ITC,ITC3,7,Liguria,Liguria,1550640,56845,3.67,0.04
2327,2021-08-01,LIG,1490,856,634,152,1338,0,ITC,ITC3,7,Liguria,Liguria,1550640,58335,3.76,0.1
2328,2021-02-16,LIG,2431,958,1473,1996,430,5,ITC,ITC3,7,Liguria,Liguria,1550640,60766,3.92,0.16
2329,2021-07-23,LIG,20025,10315,9710,5119,14781,125,ITC,ITC3,7,Liguria,Liguria,1550640,80791,5.21,1.29
2330,2021-05-27,LIG,17015,8720,8295,12675,4179,161,ITC,ITC3,7,Liguria,Liguria,1550640,97806,6.31,1.1
2331,2021-04-14,LIG,13085,5675,7410,10752,2211,122,ITC,ITC3,7,Liguria,Liguria,1550640,110891,7.15,0.84
2332,2021-03-14,LIG,1659,752,907,1043,604,12,ITC,ITC3,7,Liguria,Liguria,1550640,112550,7.26,0.11
2333,2021-08-18,LIG,12225,6594,5631,4242,7856,127,ITC,ITC3,7,Liguria,Liguria,1550640,124775,8.05,0.79
2334,2021-06-22,LIG,15821,7469,8352,7613,8140,68,ITC,ITC3,7,Liguria,Liguria,1550640,140596,9.07,1.02
2335,2021-07-06,LIG,12377,6074,6303,5628,6659,90,ITC,ITC3,7,Liguria,Liguria,1550640,152973,9.87,0.8
2336,2021-05-10,LIG,12662,5649,7013,6199,6382,81,ITC,ITC3,7,Liguria,Liguria,1550640,165635,10.68,0.82
2337,2021-02-28,LIG,1060,580,480,1048,11,1,ITC,ITC3,7,Liguria,Liguria,1550640,166695,10.75,0.07
2338,2021-09-01,LIG,8501,4477,4024,2709,5719,73,ITC,ITC3,7,Liguria,Liguria,1550640,175196,11.3,0.55
2339,2021-04-26,LIG,10593,4998,5595,7864,2642,87,ITC,ITC3,7,Liguria,Liguria,1550640,185789,11.98,0.68
2340,2021-01-16,LIG,1279,558,721,1274,0,5,ITC,ITC3,7,Liguria,Liguria,1550640,187068,12.06,0.08
2341,2021-02-02,LIG,2675,1007,1668,127,2546,2,ITC,ITC3,7,Liguria,Liguria,1550640,189743,12.24,0.17
2342,2021-04-28,LIG,14470,6527,7943,6381,8001,88,ITC,ITC3,7,Liguria,Liguria,1550640,204213,13.17,0.93
2343,2021-01-28,LIG,2851,972,1879,37,2814,0,ITC,ITC3,7,Liguria,Liguria,1550640,207064,13.35,0.18
2344,2021-08-30,LIG,9787,5229,4558,2461,7241,85,ITC,ITC3,7,Liguria,Liguria,1550640,216851,13.98,0.63
2345,2021-02-11,LIG,1990,773,1217,1092,888,10,ITC,ITC3,7,Liguria,Liguria,1550640,218841,14.11,0.13
2346,2021-05-22,LIG,6657,3222,3435,4879,1687,91,ITC,ITC3,7,Liguria,Liguria,1550640,225498,14.54,0.43
2347,2021-06-10,LIG,18898,9742,9156,13125,5677,96,ITC,ITC3,7,Liguria,Liguria,1550640,244396,15.76,1.22
2348,2021-03-19,LIG,5304,2237,3067,2099,3153,52,ITC,ITC3,7,Liguria,Liguria,1550640,249700,16.1,0.34
2349,2021-03-02,LIG,4083,1695,2388,3765,310,8,ITC,ITC3,7,Liguria,Liguria,1550640,253783,16.37,0.26
2350,2020-12-28,LIG,80,30,50,80,0,0,ITC,ITC3,7,Liguria,Liguria,1550640,253863,16.37,0.01
2351,2021-06-03,LIG,15554,7710,7844,9108,6391,55,ITC,ITC3,7,Liguria,Liguria,1550640,269417,17.37,1.0
2352,2021-04-07,LIG,13696,6115,7581,11311,2293,92,ITC,ITC3,7,Liguria,Liguria,1550640,283113,18.26,0.88
2353,2021-02-23,LIG,3809,1559,2250,3663,109,37,ITC,ITC3,7,Liguria,Liguria,1550640,286922,18.5,0.25
2354,2021-06-15,LIG,17445,8475,8970,9274,8096,75,ITC,ITC3,7,Liguria,Liguria,1550640,304367,19.63,1.13
2355,2021-03-07,LIG,1915,1139,776,1602,301,12,ITC,ITC3,7,Liguria,Liguria,1550640,306282,19.75,0.12
2356,2021-09-08,LIG,7479,3908,3571,2130,5246,103,ITC,ITC3,7,Liguria,Liguria,1550640,313761,20.23,0.48
2357,2021-06-17,LIG,16711,7942,8769,9080,7546,85,ITC,ITC3,7,Liguria,Liguria,1550640,330472,21.31,1.08
2358,2021-05-29,LIG,6890,3263,3627,3989,2874,27,ITC,ITC3,7,Liguria,Liguria,1550640,337362,21.76,0.44
2359,2021-09-06,LIG,8035,4155,3880,2722,5210,103,ITC,ITC3,7,Liguria,Liguria,1550640,345397,22.27,0.52
2360,2021-07-25,LIG,6405,3272,3133,651,5743,11,ITC,ITC3,7,Liguria,Liguria,1550640,351802,22.69,0.41
2361,2021-02-09,LIG,1956,696,1260,262,1691,3,ITC,ITC3,7,Liguria,Liguria,1550640,353758,22.81,0.13
2362,2021-05-03,LIG,13270,5925,7345,6361,6822,87,ITC,ITC3,7,Liguria,Liguria,1550640,367028,23.67,0.86
2363,2021-08-11,LIG,13137,6738,6399,4788,8233,116,ITC,ITC3,7,Liguria,Liguria,1550640,380165,24.52,0.85
2364,2021-03-21,LIG,551,220,331,69,482,0,ITC,ITC3,7,Liguria,Liguria,1550640,380716,24.55,0.04
2365,2021-08-25,LIG,9357,5039,4318,3215,6026,116,ITC,ITC3,7,Liguria,Liguria,1550640,390073,25.16,0.6
2366,2021-01-23,LIG,813,297,516,156,657,0,ITC,ITC3,7,Liguria,Liguria,1550640,390886,25.21,0.05
2367,2021-06-29,LIG,15193,7238,7955,8626,6467,100,ITC,ITC3,7,Liguria,Liguria,1550640,406079,26.19,0.98
2368,2021-05-17,LIG,12049,5529,6520,8597,3381,71,ITC,ITC3,7,Liguria,Liguria,1550640,418128,26.96,0.78
2369,2021-01-09,LIG,1338,484,854,1337,0,1,ITC,ITC3,7,Liguria,Liguria,1550640,419466,27.05,0.09
2370,2021-04-19,LIG,12842,5622,7220,8918,3835,89,ITC,ITC3,7,Liguria,Liguria,1550640,432308,27.88,0.83
2371,2021-07-13,LIG,13106,6447,6659,3470,9582,54,ITC,ITC3,7,Liguria,Liguria,1550640,445414,28.72,0.85
2372,2021-01-21,LIG,1109,385,724,677,431,1,ITC,ITC3,7,Liguria,Liguria,1550640,446523,28.8,0.07
2373,2021-08-20,LIG,9436,5031,4405,3139,6201,96,ITC,ITC3,7,Liguria,Liguria,1550640,455959,29.4,0.61
2374,2021-08-06,LIG,12218,6211,6007,3974,8126,118,ITC,ITC3,7,Liguria,Liguria,1550640,468177,30.19,0.79
2375,2021-02-04,LIG,2820,990,1830,177,2643,0,ITC,ITC3,7,Liguria,Liguria,1550640,470997,30.37,0.18
2376,2021-05-15,LIG,7325,3277,4048,4295,2964,66,ITC,ITC3,7,Liguria,Liguria,1550640,478322,30.85,0.47
2377,2021-02-21,LIG,868,490,378,862,4,2,ITC,ITC3,7,Liguria,Liguria,1550640,479190,30.9,0.06
2378,2021-07-11,LIG,2154,1195,959,1233,903,18,ITC,ITC3,7,Liguria,Liguria,1550640,481344,31.04,0.14
2379,2021-06-24,LIG,11167,5451,5716,6219,4869,79,ITC,ITC3,7,Liguria,Liguria,1550640,492511,31.76,0.72
2380,2021-04-02,LIG,11796,5223,6573,9221,2489,86,ITC,ITC3,7,Liguria,Liguria,1550640,504307,32.52,0.76
2381,2021-04-21,LIG,14297,6461,7836,8861,5347,89,ITC,ITC3,7,Liguria,Liguria,1550640,518604,33.44,0.92
2382,2021-07-30,LIG,16099,8343,7756,4663,11342,94,ITC,ITC3,7,Liguria,Liguria,1550640,534703,34.48,1.04
2383,2021-08-13,LIG,10901,5630,5271,3931,6876,94,ITC,ITC3,7,Liguria,Liguria,1550640,545604,35.19,0.7
2384,2021-05-08,LIG,7540,3337,4203,2274,5228,38,ITC,ITC3,7,Liguria,Liguria,1550640,553144,35.67,0.49
2385,2021-01-25,LIG,2735,894,1841,474,2260,1,ITC,ITC3,7,Liguria,Liguria,1550640,555879,35.85,0.18
2386,2021-08-10,LIG,13141,6561,6580,4284,8714,143,ITC,ITC3,7,Liguria,Liguria,1550640,569020,36.7,0.85
2387,2021-06-14,LIG,15170,7324,7846,8210,6883,77,ITC,ITC3,7,Liguria,Liguria,1550640,584190,37.67,0.98
2388,2021-02-25,LIG,3461,1351,2110,3308,130,23,ITC,ITC3,7,Liguria,Liguria,1550640,587651,37.9,0.22
2389,2021-09-10,LIG,6915,3685,3230,1954,4859,102,ITC,ITC3,7,Liguria,Liguria,1550640,594566,38.34,0.45
2390,2021-06-02,LIG,8545,4349,4196,5336,3177,32,ITC,ITC3,7,Liguria,Liguria,1550640,603111,38.89,0.55
2391,2021-06-19,LIG,7418,3777,3641,5689,1674,55,ITC,ITC3,7,Liguria,Liguria,1550640,610529,39.37,0.48
2392,2021-04-23,LIG,14699,6654,8045,8460,6130,109,ITC,ITC3,7,Liguria,Liguria,1550640,625228,40.32,0.95
2393,2021-03-11,LIG,6424,3103,3321,4358,2015,51,ITC,ITC3,7,Liguria,Liguria,1550640,631652,40.73,0.41
2394,2021-01-13,LIG,2762,1016,1746,2761,0,1,ITC,ITC3,7,Liguria,Liguria,1550640,634414,40.91,0.18
2395,2021-01-04,LIG,2625,857,1768,2624,0,1,ITC,ITC3,7,Liguria,Liguria,1550640,637039,41.08,0.17
2396,2021-08-03,LIG,14142,7224,6918,3970,10072,100,ITC,ITC3,7,Liguria,Liguria,1550640,651181,41.99,0.91
2397,2021-08-15,LIG,1411,786,625,848,530,33,ITC,ITC3,7,Liguria,Liguria,1550640,652592,42.09,0.09
2398,2021-05-24,LIG,11894,5596,6298,9282,2512,100,ITC,ITC3,7,Liguria,Liguria,1550640,664486,42.85,0.77
2399,2021-05-07,LIG,13618,6049,7569,5706,7815,97,ITC,ITC3,7,Liguria,Liguria,1550640,678104,43.73,0.88
2400,2021-09-15,LIG,1836,932,904,695,1099,42,ITC,ITC3,7,Liguria,Liguria,1550640,679940,43.85,0.12
2401,2021-02-13,LIG,1081,509,572,798,280,3,ITC,ITC3,7,Liguria,Liguria,1550640,681021,43.92,0.07
2402,2021-01-30,LIG,1666,572,1094,22,1643,1,ITC,ITC3,7,Liguria,Liguria,1550640,682687,44.03,0.11
2403,2021-03-28,LIG,1141,510,631,381,752,8,ITC,ITC3,7,Liguria,Liguria,1550640,683828,44.1,0.07
2404,2021-08-29,LIG,738,420,318,173,562,3,ITC,ITC3,7,Liguria,Liguria,1550640,684566,44.15,0.05
2405,2021-02-06,LIG,1892,768,1124,145,1747,0,ITC,ITC3,7,Liguria,Liguria,1550640,686458,44.27,0.12
2406,2021-09-05,LIG,1014,569,445,271,738,5,ITC,ITC3,7,Liguria,Liguria,1550640,687472,44.33,0.07
2407,2021-08-17,LIG,9858,5172,4686,3642,6116,100,ITC,ITC3,7,Liguria,Liguria,1550640,697330,44.97,0.64
2408,2021-03-04,LIG,4743,2119,2624,3840,848,55,ITC,ITC3,7,Liguria,Liguria,1550640,702073,45.28,0.31
2409,2021-06-12,LIG,10264,4993,5271,7442,2760,62,ITC,ITC3,7,Liguria,Liguria,1550640,712337,45.94,0.66
2410,2021-04-30,LIG,14440,6453,7987,5773,8580,87,ITC,ITC3,7,Liguria,Liguria,1550640,726777,46.87,0.93
2411,2021-03-06,LIG,3308,1844,1464,2582,706,20,ITC,ITC3,7,Liguria,Liguria,1550640,730085,47.08,0.21
2412,2020-12-30,LIG,12,5,7,12,0,0,ITC,ITC3,7,Liguria,Liguria,1550640,730097,47.08,0.0
2413,2021-07-03,LIG,8828,4380,4448,5437,3331,60,ITC,ITC3,7,Liguria,Liguria,1550640,738925,47.65,0.57
2414,2021-04-11,LIG,4251,1930,2321,3958,249,44,ITC,ITC3,7,Liguria,Liguria,1550640,743176,47.93,0.27
2415,2021-07-20,LIG,13983,6884,7099,2707,11204,72,ITC,ITC3,7,Liguria,Liguria,1550640,757159,48.83,0.9
2416,2021-01-18,LIG,2146,749,1397,1987,157,2,ITC,ITC3,7,Liguria,Liguria,1550640,759305,48.97,0.14
2417,2021-08-08,LIG,1207,650,557,542,659,6,ITC,ITC3,7,Liguria,Liguria,1550640,760512,49.05,0.08
2418,2021-07-22,LIG,21457,10903,10554,4550,16790,117,ITC,ITC3,7,Liguria,Liguria,1550640,781969,50.43,1.38
2419,2021-05-05,LIG,13726,6143,7583,5177,8464,85,ITC,ITC3,7,Liguria,Liguria,1550640,795695,51.31,0.89
2420,2021-07-29,LIG,18012,9220,8792,4408,13520,84,ITC,ITC3,7,Liguria,Liguria,1550640,813707,52.48,1.16
2421,2021-06-07,LIG,15717,7669,8048,8616,7039,62,ITC,ITC3,7,Liguria,Liguria,1550640,829424,53.49,1.01
2422,2021-06-26,LIG,7230,3366,3864,4433,2724,73,ITC,ITC3,7,Liguria,Liguria,1550640,836654,53.96,0.47
2423,2021-07-10,LIG,6910,3486,3424,2725,4136,49,ITC,ITC3,7,Liguria,Liguria,1550640,843564,54.4,0.45
2424,2021-04-04,LIG,764,369,395,508,251,5,ITC,ITC3,7,Liguria,Liguria,1550640,844328,54.45,0.05
2425,2021-04-18,LIG,2619,1165,1454,2094,470,55,ITC,ITC3,7,Liguria,Liguria,1550640,846947,54.62,0.17
2426,2021-06-21,LIG,14853,7043,7810,8501,6261,91,ITC,ITC3,7,Liguria,Liguria,1550640,861800,55.58,0.96
2427,2021-04-16,LIG,12024,5300,6724,10034,1833,157,ITC,ITC3,7,Liguria,Liguria,1550640,873824,56.35,0.78
2428,2021-01-06,LIG,1666,618,1048,1663,0,3,ITC,ITC3,7,Liguria,Liguria,1550640,875490,56.46,0.11
2429,2021-02-18,LIG,2772,1128,1644,2425,339,8,ITC,ITC3,7,Liguria,Liguria,1550640,878262,56.64,0.18
2430,2021-05-14,LIG,13164,5871,7293,8638,4352,174,ITC,ITC3,7,Liguria,Liguria,1550640,891426,57.49,0.85
2431,2021-08-22,LIG,760,441,319,173,579,8,ITC,ITC3,7,Liguria,Liguria,1550640,892186,57.54,0.05
2432,2021-05-31,LIG,14754,7396,7358,9124,5547,83,ITC,ITC3,7,Liguria,Liguria,1550640,906940,58.49,0.95
2433,2021-03-09,LIG,5942,2757,3185,4450,1434,58,ITC,ITC3,7,Liguria,Liguria,1550640,912882,58.87,0.38
2434,2021-02-20,LIG,1338,639,699,1335,1,2,ITC,ITC3,7,Liguria,Liguria,1550640,914220,58.96,0.09
2435,2021-08-07,LIG,5208,2661,2547,1125,4058,25,ITC,ITC3,7,Liguria,Liguria,1550640,919428,59.29,0.34
2436,2021-05-16,LIG,3713,1864,1849,2119,1567,27,ITC,ITC3,7,Liguria,Liguria,1550640,923141,59.53,0.24
2437,2021-08-24,LIG,8738,4532,4206,2902,5738,98,ITC,ITC3,7,Liguria,Liguria,1550640,931879,60.1,0.56
2438,2021-02-22,LIG,3349,1479,1870,3197,143,9,ITC,ITC3,7,Liguria,Liguria,1550640,935228,60.31,0.22
2439,2021-06-11,LIG,17874,9100,8774,11720,6082,72,ITC,ITC3,7,Liguria,Liguria,1550640,953102,61.47,1.15
2440,2021-04-15,LIG,11854,5242,6612,9889,1859,106,ITC,ITC3,7,Liguria,Liguria,1550640,964956,62.23,0.76
2441,2021-04-08,LIG,13798,6184,7614,11614,2049,135,ITC,ITC3,7,Liguria,Liguria,1550640,978754,63.12,0.89
2442,2021-09-12,LIG,115,67,48,67,47,1,ITC,ITC3,7,Liguria,Liguria,1550640,978869,63.13,0.01
2443,2021-07-17,LIG,6515,3359,3156,1798,4696,21,ITC,ITC3,7,Liguria,Liguria,1550640,985384,63.55,0.42
2444,2021-07-31,LIG,8266,4414,3852,1309,6927,30,ITC,ITC3,7,Liguria,Liguria,1550640,993650,64.08,0.53
2445,2021-06-04,LIG,14800,7267,7533,9223,5500,77,ITC,ITC3,7,Liguria,Liguria,1550640,1008450,65.03,0.95
2446,2021-01-22,LIG,1829,606,1223,1337,490,2,ITC,ITC3,7,Liguria,Liguria,1550640,1010279,65.15,0.12
2447,2021-05-02,LIG,3981,1837,2144,503,3472,6,ITC,ITC3,7,Liguria,Liguria,1550640,1014260,65.41,0.26
2448,2021-05-04,LIG,13662,6095,7567,5360,8236,66,ITC,ITC3,7,Liguria,Liguria,1550640,1027922,66.29,0.88
2449,2021-08-12,LIG,12540,6450,6090,4598,7850,92,ITC,ITC3,7,Liguria,Liguria,1550640,1040462,67.1,0.81
2450,2021-09-07,LIG,7799,4125,3674,2648,5060,91,ITC,ITC3,7,Liguria,Liguria,1550640,1048261,67.6,0.5
2451,2021-06-16,LIG,16415,7930,8485,9188,7138,89,ITC,ITC3,7,Liguria,Liguria,1550640,1064676,68.66,1.06
2452,2021-03-08,LIG,5631,2462,3169,3907,1692,32,ITC,ITC3,7,Liguria,Liguria,1550640,1070307,69.02,0.36
2453,2021-03-25,LIG,9784,4236,5548,6243,3397,144,ITC,ITC3,7,Liguria,Liguria,1550640,1080091,69.65,0.63
2454,2021-01-01,LIG,146,56,90,146,0,0,ITC,ITC3,7,Liguria,Liguria,1550640,1080237,69.66,0.01
2455,2021-03-16,LIG,6091,2733,3358,2317,3735,39,ITC,ITC3,7,Liguria,Liguria,1550640,1086328,70.06,0.39
2456,2021-01-11,LIG,2659,994,1665,2657,0,2,ITC,ITC3,7,Liguria,Liguria,1550640,1088987,70.23,0.17
2457,2021-07-12,LIG,13463,6466,6997,4140,9246,77,ITC,ITC3,7,Liguria,Liguria,1550640,1102450,71.1,0.87
2458,2021-01-10,LIG,651,264,387,647,0,4,ITC,ITC3,7,Liguria,Liguria,1550640,1103101,71.14,0.04
2459,2021-04-20,LIG,14252,6522,7730,9741,4359,152,ITC,ITC3,7,Liguria,Liguria,1550640,1117353,72.06,0.92
2460,2021-07-27,LIG,17446,8887,8559,4350,13008,88,ITC,ITC3,7,Liguria,Liguria,1550640,1134799,73.18,1.13
2461,2021-01-08,LIG,2941,1002,1939,2939,0,2,ITC,ITC3,7,Liguria,Liguria,1550640,1137740,73.37,0.19
2462,2021-01-27,LIG,1749,604,1145,139,1609,1,ITC,ITC3,7,Liguria,Liguria,1550640,1139489,73.49,0.11
2463,2021-05-21,LIG,12873,5967,6906,9605,3135,133,ITC,ITC3,7,Liguria,Liguria,1550640,1152362,74.32,0.83
2464,2021-02-27,LIG,1889,921,968,1756,129,4,ITC,ITC3,7,Liguria,Liguria,1550640,1154251,74.44,0.12
2465,2021-02-10,LIG,2325,840,1485,1017,1305,3,ITC,ITC3,7,Liguria,Liguria,1550640,1156576,74.59,0.15
2466,2021-08-14,LIG,3212,1717,1495,896,2298,18,ITC,ITC3,7,Liguria,Liguria,1550640,1159788,74.79,0.21
2467,2021-03-18,LIG,4992,2126,2866,1978,2984,30,ITC,ITC3,7,Liguria,Liguria,1550640,1164780,75.12,0.32
2468,2021-04-01,LIG,12442,5520,6922,9588,2776,78,ITC,ITC3,7,Liguria,Liguria,1550640,1177222,75.92,0.8
2469,2021-03-27,LIG,3936,1550,2386,2515,1398,23,ITC,ITC3,7,Liguria,Liguria,1550640,1181158,76.17,0.25
2470,2021-07-05,LIG,11933,5778,6155,5298,6550,85,ITC,ITC3,7,Liguria,Liguria,1550640,1193091,76.94,0.77
2471,2021-04-13,LIG,13089,5875,7214,10948,2029,112,ITC,ITC3,7,Liguria,Liguria,1550640,1206180,77.79,0.84
2472,2021-07-19,LIG,12113,6038,6075,3320,8702,91,ITC,ITC3,7,Liguria,Liguria,1550640,1218293,78.57,0.78
2473,2021-08-05,LIG,14257,7364,6893,4112,10055,90,ITC,ITC3,7,Liguria,Liguria,1550640,1232550,79.49,0.92
2474,2021-04-27,LIG,14825,6701,8124,7145,7613,67,ITC,ITC3,7,Liguria,Liguria,1550640,1247375,80.44,0.96
2475,2021-02-03,LIG,2321,792,1529,51,2270,0,ITC,ITC3,7,Liguria,Liguria,1550640,1249696,80.59,0.15
2476,2021-06-28,LIG,11629,5628,6001,7215,4315,99,ITC,ITC3,7,Liguria,Liguria,1550640,1261325,81.34,0.75
2477,2021-03-20,LIG,2318,995,1323,1130,1175,13,ITC,ITC3,7,Liguria,Liguria,1550640,1263643,81.49,0.15
2478,2021-08-26,LIG,9055,4738,4317,2618,6361,76,ITC,ITC3,7,Liguria,Liguria,1550640,1272698,82.08,0.58
2479,2021-02-17,LIG,2701,1185,1516,2254,435,12,ITC,ITC3,7,Liguria,Liguria,1550640,1275399,82.25,0.17
2480,2021-07-24,LIG,11611,6041,5570,2305,9250,56,ITC,ITC3,7,Liguria,Liguria,1550640,1287010,83.0,0.75
2481,2021-05-28,LIG,16326,8158,8168,11620,4562,144,ITC,ITC3,7,Liguria,Liguria,1550640,1303336,84.05,1.05
2482,2021-01-05,LIG,2880,896,1984,2880,0,0,ITC,ITC3,7,Liguria,Liguria,1550640,1306216,84.24,0.19
2483,2021-03-03,LIG,4586,1850,2736,3446,1030,110,ITC,ITC3,7,Liguria,Liguria,1550640,1310802,84.53,0.3
2484,2021-08-04,LIG,13865,6981,6884,3253,10503,109,ITC,ITC3,7,Liguria,Liguria,1550640,1324667,85.43,0.89
2485,2021-05-09,LIG,2827,1245,1582,1085,1712,30,ITC,ITC3,7,Liguria,Liguria,1550640,1327494,85.61,0.18
2486,2021-01-29,LIG,3101,1070,2031,63,3038,0,ITC,ITC3,7,Liguria,Liguria,1550640,1330595,85.81,0.2
2487,2021-01-20,LIG,1560,557,1003,1547,12,1,ITC,ITC3,7,Liguria,Liguria,1550640,1332155,85.91,0.1
2488,2021-08-19,LIG,9834,5177,4657,2711,7018,105,ITC,ITC3,7,Liguria,Liguria,1550640,1341989,86.54,0.63
2489,2021-07-09,LIG,12849,6333,6516,4172,8597,80,ITC,ITC3,7,Liguria,Liguria,1550640,1354838,87.37,0.83
2490,2021-08-31,LIG,9552,5050,4502,2651,6840,61,ITC,ITC3,7,Liguria,Liguria,1550640,1364390,87.99,0.62
2491,2021-05-23,LIG,2310,1121,1189,1172,1124,14,ITC,ITC3,7,Liguria,Liguria,1550640,1366700,88.14,0.15
2492,2021-03-01,LIG,3541,1447,2094,3386,136,19,ITC,ITC3,7,Liguria,Liguria,1550640,1370241,88.37,0.23
2493,2021-06-09,LIG,19109,9591,9518,12439,6590,80,ITC,ITC3,7,Liguria,Liguria,1550640,1389350,89.6,1.23
2494,2021-09-02,LIG,8453,4505,3948,2852,5518,83,ITC,ITC3,7,Liguria,Liguria,1550640,1397803,90.14,0.55
2495,2021-06-08,LIG,18130,9045,9085,11392,6653,85,ITC,ITC3,7,Liguria,Liguria,1550640,1415933,91.31,1.17
2496,2021-03-17,LIG,5561,2371,3190,2456,3086,19,ITC,ITC3,7,Liguria,Liguria,1550640,1421494,91.67,0.36
2497,2021-06-25,LIG,13850,6621,7229,6850,6922,78,ITC,ITC3,7,Liguria,Liguria,1550640,1435344,92.56,0.89
2498,2021-08-21,LIG,3073,1672,1401,906,2122,45,ITC,ITC3,7,Liguria,Liguria,1550640,1438417,92.76,0.2
2499,2021-05-13,LIG,13328,6093,7235,8895,4273,160,ITC,ITC3,7,Liguria,Liguria,1550640,1451745,93.62,0.86
2500,2021-02-19,LIG,3223,1307,1916,3033,176,14,ITC,ITC3,7,Liguria,Liguria,1550640,1454968,93.83,0.21
2501,2021-05-30,LIG,3311,1616,1695,1339,1949,23,ITC,ITC3,7,Liguria,Liguria,1550640,1458279,94.04,0.21
2502,2021-02-24,LIG,3769,1562,2207,3458,259,52,ITC,ITC3,7,Liguria,Liguria,1550640,1462048,94.29,0.24
2503,2020-12-29,LIG,125,33,92,125,0,0,ITC,ITC3,7,Liguria,Liguria,1550640,1462173,94.29,0.01
2504,2021-01-12,LIG,2476,890,1586,2475,0,1,ITC,ITC3,7,Liguria,Liguria,1550640,1464649,94.45,0.16
2505,2021-04-22,LIG,13882,6217,7665,8658,5090,134,ITC,ITC3,7,Liguria,Liguria,1550640,1478531,95.35,0.9
2506,2021-04-05,LIG,3985,1757,2228,2313,1651,21,ITC,ITC3,7,Liguria,Liguria,1550640,1482516,95.61,0.26
2507,2021-07-16,LIG,12634,6226,6408,3139,9437,58,ITC,ITC3,7,Liguria,Liguria,1550640,1495150,96.42,0.81
2508,2021-09-11,LIG,2167,1186,981,853,1282,32,ITC,ITC3,7,Liguria,Liguria,1550640,1497317,96.56,0.14
2509,2021-05-11,LIG,13943,6400,7543,7199,6632,112,ITC,ITC3,7,Liguria,Liguria,1550640,1511260,97.46,0.9
2510,2021-03-29,LIG,10594,4629,5965,7364,3135,95,ITC,ITC3,7,Liguria,Liguria,1550640,1521854,98.14,0.68
2511,2021-08-23,LIG,10575,5516,5059,3535,6928,112,ITC,ITC3,7,Liguria,Liguria,1550640,1532429,98.83,0.68
2512,2021-06-01,LIG,16355,8237,8118,10908,5376,71,ITC,ITC3,7,Liguria,Liguria,1550640,1548784,99.88,1.05
2513,2021-09-09,LIG,7737,4135,3602,2539,5090,108,ITC,ITC3,7,Liguria,Liguria,1550640,1556521,100.38,0.5
2514,2021-06-18,LIG,15428,7510,7918,8110,7225,93,ITC,ITC3,7,Liguria,Liguria,1550640,1571949,101.37,0.99
2515,2021-03-10,LIG,5924,2868,3056,3952,1917,55,ITC,ITC3,7,Liguria,Liguria,1550640,1577873,101.76,0.38
2516,2021-07-21,LIG,19216,9522,9694,3800,15328,88,ITC,ITC3,7,Liguria,Liguria,1550640,1597089,103.0,1.24
2517,2021-04-29,LIG,15596,6983,8613,6644,8858,94,ITC,ITC3,7,Liguria,Liguria,1550640,1612685,104.0,1.01
2518,2021-04-12,LIG,12395,5479,6916,10277,2022,96,ITC,ITC3,7,Liguria,Liguria,1550640,1625080,104.8,0.8
2519,2021-01-19,LIG,1375,440,935,1281,90,4,ITC,ITC3,7,Liguria,Liguria,1550640,1626455,104.89,0.09
2520,2021-02-05,LIG,2740,994,1746,299,2440,1,ITC,ITC3,7,Liguria,Liguria,1550640,1629195,105.07,0.18
2521,2021-03-24,LIG,9195,4040,5155,5819,3293,83,ITC,ITC3,7,Liguria,Liguria,1550640,1638390,105.66,0.59
2522,2021-07-02,LIG,12997,6376,6621,6363,6525,109,ITC,ITC3,7,Liguria,Liguria,1550640,1651387,106.5,0.84
2523,2020-12-31,LIG,991,352,639,991,0,0,ITC,ITC3,7,Liguria,Liguria,1550640,1652378,106.56,0.06
2524,2021-04-10,LIG,7895,3564,4331,6906,914,75,ITC,ITC3,7,Liguria,Liguria,1550640,1660273,107.07,0.51
2525,2021-01-17,LIG,866,301,565,865,0,1,ITC,ITC3,7,Liguria,Liguria,1550640,1661139,107.13,0.06
2526,2021-04-03,LIG,5410,2500,2910,4436,944,30,ITC,ITC3,7,Liguria,Liguria,1550640,1666549,107.47,0.35
2527,2021-01-24,LIG,762,242,520,116,646,0,ITC,ITC3,7,Liguria,Liguria,1550640,1667311,107.52,0.05
2528,2021-07-14,LIG,11527,5674,5853,3408,8041,78,ITC,ITC3,7,Liguria,Liguria,1550640,1678838,108.27,0.74
2529,2021-07-28,LIG,18489,9524,8965,5801,12553,135,ITC,ITC3,7,Liguria,Liguria,1550640,1697327,109.46,1.19
2530,2021-05-06,LIG,14542,6446,8096,6073,8340,129,ITC,ITC3,7,Liguria,Liguria,1550640,1711869,110.4,0.94
2531,2021-01-26,LIG,2490,809,1681,16,2474,0,ITC,ITC3,7,Liguria,Liguria,1550640,1714359,110.56,0.16
2532,2021-01-31,LIG,625,271,354,4,621,0,ITC,ITC3,7,Liguria,Liguria,1550640,1714984,110.6,0.04
2533,2021-07-07,LIG,11807,5652,6155,4921,6805,81,ITC,ITC3,7,Liguria,Liguria,1550640,1726791,111.36,0.76
2534,2021-06-30,LIG,15103,7207,7896,8181,6824,98,ITC,ITC3,7,Liguria,Liguria,1550640,1741894,112.33,0.97
2535,2021-01-15,LIG,2264,756,1508,2259,0,5,ITC,ITC3,7,Liguria,Liguria,1550640,1744158,112.48,0.15
2536,2021-04-25,LIG,1936,921,1015,1509,415,12,ITC,ITC3,7,Liguria,Liguria,1550640,1746094,112.6,0.12
2537,2021-03-13,LIG,3853,1638,2215,2964,859,30,ITC,ITC3,7,Liguria,Liguria,1550640,1749947,112.85,0.25
2538,2021-06-23,LIG,14353,6867,7486,9055,5208,90,ITC,ITC3,7,Liguria,Liguria,1550640,1764300,113.78,0.93
2539,2021-06-27,LIG,1951,896,1055,681,1254,16,ITC,ITC3,7,Liguria,Liguria,1550640,1766251,113.9,0.13
2540,2021-02-12,LIG,1941,691,1250,896,1044,1,ITC,ITC3,7,Liguria,Liguria,1550640,1768192,114.03,0.13
2541,2021-08-16,LIG,9927,5139,4788,3774,6050,103,ITC,ITC3,7,Liguria,Liguria,1550640,1778119,114.67,0.64
2542,2021-03-15,LIG,7371,3123,4248,4502,2822,47,ITC,ITC3,7,Liguria,Liguria,1550640,1785490,115.15,0.48
2543,2021-02-14,LIG,233,122,111,233,0,0,ITC,ITC3,7,Liguria,Liguria,1550640,1785723,115.16,0.02
2544,2021-05-25,LIG,14281,6959,7322,10957,3197,127,ITC,ITC3,7,Liguria,Liguria,1550640,1800004,116.08,0.92
2545,2021-09-04,LIG,3019,1684,1335,878,2114,27,ITC,ITC3,7,Liguria,Liguria,1550640,1803023,116.28,0.19
2546,2021-03-22,LIG,7760,3476,4284,4744,2943,73,ITC,ITC3,7,Liguria,Liguria,1550640,1810783,116.78,0.5
2547,2021-02-07,LIG,407,153,254,2,405,0,ITC,ITC3,7,Liguria,Liguria,1550640,1811190,116.8,0.03
2548,2021-05-18,LIG,13500,6135,7365,10057,3316,127,ITC,ITC3,7,Liguria,Liguria,1550640,1824690,117.67,0.87
2549,2021-08-28,LIG,4131,2337,1794,1006,3098,27,ITC,ITC3,7,Liguria,Liguria,1550640,1828821,117.94,0.27
2550,2021-05-20,LIG,12952,6010,6942,8791,4040,121,ITC,ITC3,7,Liguria,Liguria,1550640,1841773,118.78,0.84
2551,2021-01-14,LIG,2983,1056,1927,2982,0,1,ITC,ITC3,7,Liguria,Liguria,1550640,1844756,118.97,0.19
2552,2021-03-12,LIG,6223,2874,3349,3690,2475,58,ITC,ITC3,7,Liguria,Liguria,1550640,1850979,119.37,0.4
2553,2021-07-01,LIG,13576,6546,7030,7286,6178,112,ITC,ITC3,7,Liguria,Liguria,1550640,1864555,120.24,0.88
2554,2021-05-19,LIG,13585,5966,7619,10326,3127,132,ITC,ITC3,7,Liguria,Liguria,1550640,1878140,121.12,0.88
2555,2021-03-23,LIG,9298,4236,5062,5993,3219,86,ITC,ITC3,7,Liguria,Liguria,1550640,1887438,121.72,0.6
2556,2021-08-27,LIG,9211,4916,4295,2830,6302,79,ITC,ITC3,7,Liguria,Liguria,1550640,1896649,122.31,0.59
2557,2021-07-15,LIG,14791,7483,7308,5132,9518,141,ITC,ITC3,7,Liguria,Liguria,1550640,1911440,123.27,0.95
2558,2021-02-01,LIG,2575,929,1646,101,2474,0,ITC,ITC3,7,Liguria,Liguria,1550640,1914015,123.43,0.17
2559,2021-07-08,LIG,13683,6724,6959,6141,7431,111,ITC,ITC3,7,Liguria,Liguria,1550640,1927698,124.32,0.88
2560,2021-05-12,LIG,12123,5492,6631,6612,5410,101,ITC,ITC3,7,Liguria,Liguria,1550640,1939821,125.1,0.78
2561,2021-05-26,LIG,16701,8433,8268,12172,4383,146,ITC,ITC3,7,Liguria,Liguria,1550640,1956522,126.18,1.08
2562,2021-03-30,LIG,12230,5432,6798,8752,3395,83,ITC,ITC3,7,Liguria,Liguria,1550640,1968752,126.96,0.79
2563,2021-09-03,LIG,7366,4061,3305,2198,5088,80,ITC,ITC3,7,Liguria,Liguria,1550640,1976118,127.44,0.48
2564,2021-04-06,LIG,13267,5906,7361,10895,2265,107,ITC,ITC3,7,Liguria,Liguria,1550640,1989385,128.29,0.86
2565,2021-02-08,LIG,1983,744,1239,299,1684,0,ITC,ITC3,7,Liguria,Liguria,1550640,1991368,128.42,0.13
2566,2020-12-27,LIG,135,56,79,134,0,1,ITC,ITC3,7,Liguria,Liguria,1550640,1991503,128.43,0.01
2567,2021-02-15,LIG,2265,840,1425,1853,400,12,ITC,ITC3,7,Liguria,Liguria,1550640,1993768,128.58,0.15
2568,2021-09-14,LIG,6334,3284,3050,2281,3955,98,ITC,ITC3,7,Liguria,Liguria,1550640,2000102,128.99,0.41
2569,2021-01-03,LIG,738,233,505,736,0,2,ITC,ITC3,7,Liguria,Liguria,1550640,2000840,129.03,0.05
2570,2021-07-26,LIG,17686,9025,8661,4708,12863,115,ITC,ITC3,7,Liguria,Liguria,1550640,2018526,130.17,1.14
2571,2021-01-07,LIG,3226,1096,2130,3223,0,3,ITC,ITC3,7,Liguria,Liguria,1550640,2021752,130.38,0.21
2572,2021-06-13,LIG,5643,2706,2937,5129,456,58,ITC,ITC3,7,Liguria,Liguria,1550640,2027395,130.75,0.36
2573,2021-04-17,LIG,7393,3219,4174,6580,755,58,ITC,ITC3,7,Liguria,Liguria,1550640,2034788,131.22,0.48
2574,2021-05-01,LIG,7154,3260,3894,1314,5810,30,ITC,ITC3,7,Liguria,Liguria,1550640,2041942,131.68,0.46
2575,2021-03-05,LIG,4876,2155,2721,3692,1137,47,ITC,ITC3,7,Liguria,Liguria,1550640,2046818,132.0,0.31
2576,2021-08-09,LIG,12008,6109,5899,4348,7532,128,ITC,ITC3,7,Liguria,Liguria,1550640,2058826,132.77,0.77
2577,2021-06-06,LIG,3814,2032,1782,2933,862,19,ITC,ITC3,7,Liguria,Liguria,1550640,2062640,133.02,0.25
2578,2021-04-24,LIG,8221,3798,4423,4984,3155,82,ITC,ITC3,7,Liguria,Liguria,1550640,2070861,133.55,0.53
2579,2021-02-26,LIG,3772,1526,2246,3418,329,25,ITC,ITC3,7,Liguria,Liguria,1550640,2074633,133.79,0.24
2580,2021-08-02,LIG,13113,6518,6595,2968,10062,83,ITC,ITC3,7,Liguria,Liguria,1550640,2087746,134.64,0.85
2581,2021-06-20,LIG,1336,658,678,1045,275,16,ITC,ITC3,7,Liguria,Liguria,1550640,2089082,134.72,0.09
2582,2021-07-20,LOM,95029,49096,45933,6920,87371,738,ITC,ITC4,3,Lombardia,Lombardia,10060574,95029,0.94,0.94
2583,2021-09-15,LOM,15795,8325,7470,2890,12441,464,ITC,ITC4,3,Lombardia,Lombardia,10060574,110824,1.1,0.16
2584,2021-02-04,LOM,28024,8171,19853,2049,25970,5,ITC,ITC4,3,Lombardia,Lombardia,10060574,138848,1.38,0.28
2585,2021-07-18,LOM,97107,50593,46514,8542,87871,694,ITC,ITC4,3,Lombardia,Lombardia,10060574,235955,2.35,0.97
2586,2021-04-09,LOM,52460,22397,30063,35593,16023,844,ITC,ITC4,3,Lombardia,Lombardia,10060574,288415,2.87,0.52
2587,2021-03-28,LOM,20641,7883,12758,13968,6288,385,ITC,ITC4,3,Lombardia,Lombardia,10060574,309056,3.07,0.21
2588,2021-04-14,LOM,47238,21050,26188,33539,12987,712,ITC,ITC4,3,Lombardia,Lombardia,10060574,356294,3.54,0.47
2589,2021-01-04,LOM,6135,2120,4015,6128,0,7,ITC,ITC4,3,Lombardia,Lombardia,10060574,362429,3.6,0.06
2590,2021-06-19,LOM,104408,52033,52375,56226,46756,1426,ITC,ITC4,3,Lombardia,Lombardia,10060574,466837,4.64,1.04
2591,2021-07-06,LOM,102191,50891,51300,23098,77677,1416,ITC,ITC4,3,Lombardia,Lombardia,10060574,569028,5.66,1.02
2592,2021-09-01,LOM,60218,32356,27862,30532,25955,3731,ITC,ITC4,3,Lombardia,Lombardia,10060574,629246,6.25,0.6
2593,2021-05-24,LOM,89626,43529,46097,48601,40087,938,ITC,ITC4,3,Lombardia,Lombardia,10060574,718872,7.15,0.89
2594,2021-02-11,LOM,17136,5026,12110,9636,7421,79,ITC,ITC4,3,Lombardia,Lombardia,10060574,736008,7.32,0.17
2595,2021-01-16,LOM,15648,5786,9862,15637,0,11,ITC,ITC4,3,Lombardia,Lombardia,10060574,751656,7.47,0.16
2596,2021-08-15,LOM,7000,3988,3012,2933,3884,183,ITC,ITC4,3,Lombardia,Lombardia,10060574,758656,7.54,0.07
2597,2021-08-01,LOM,53144,28435,24709,27339,24266,1539,ITC,ITC4,3,Lombardia,Lombardia,10060574,811800,8.07,0.53
2598,2021-04-23,LOM,73645,33373,40272,55554,16659,1432,ITC,ITC4,3,Lombardia,Lombardia,10060574,885445,8.8,0.73
2599,2021-08-27,LOM,35741,19220,16521,18530,14623,2588,ITC,ITC4,3,Lombardia,Lombardia,10060574,921186,9.16,0.36
2600,2021-09-13,LOM,36376,19670,16706,6343,29009,1024,ITC,ITC4,3,Lombardia,Lombardia,10060574,957562,9.52,0.36
2601,2021-06-05,LOM,102450,52963,49487,91100,9837,1513,ITC,ITC4,3,Lombardia,Lombardia,10060574,1060012,10.54,1.02
2602,2021-03-14,LOM,14884,5350,9534,11215,3290,379,ITC,ITC4,3,Lombardia,Lombardia,10060574,1074896,10.68,0.15
2603,2021-08-06,LOM,85615,46654,38961,17805,66961,849,ITC,ITC4,3,Lombardia,Lombardia,10060574,1160511,11.54,0.85
2604,2021-04-28,LOM,95811,43696,52115,66883,26952,1976,ITC,ITC4,3,Lombardia,Lombardia,10060574,1256322,12.49,0.95
2605,2021-06-24,LOM,109769,56743,53026,78372,29015,2382,ITC,ITC4,3,Lombardia,Lombardia,10060574,1366091,13.58,1.09
2606,2021-03-16,LOM,25543,10134,15409,16310,9111,122,ITC,ITC4,3,Lombardia,Lombardia,10060574,1391634,13.83,0.25
2607,2021-05-12,LOM,87572,41779,45793,57284,27611,2677,ITC,ITC4,3,Lombardia,Lombardia,10060574,1479206,14.7,0.87
2608,2021-02-16,LOM,9529,3081,6448,8977,451,101,ITC,ITC4,3,Lombardia,Lombardia,10060574,1488735,14.8,0.09
2609,2021-06-10,LOM,102736,52275,50461,86425,14505,1806,ITC,ITC4,3,Lombardia,Lombardia,10060574,1591471,15.82,1.02
2610,2021-03-02,LOM,22843,9711,13132,19529,3048,266,ITC,ITC4,3,Lombardia,Lombardia,10060574,1614314,16.05,0.23
2611,2021-08-20,LOM,27131,15012,12119,14128,11908,1095,ITC,ITC4,3,Lombardia,Lombardia,10060574,1641445,16.32,0.27
2612,2021-07-13,LOM,108721,56844,51877,15460,92028,1233,ITC,ITC4,3,Lombardia,Lombardia,10060574,1750166,17.4,1.08
2613,2021-04-04,LOM,7615,3232,4383,3682,3899,34,ITC,ITC4,3,Lombardia,Lombardia,10060574,1757781,17.47,0.08
2614,2021-04-02,LOM,41420,16954,24466,26212,14650,558,ITC,ITC4,3,Lombardia,Lombardia,10060574,1799201,17.88,0.41
2615,2021-07-08,LOM,114715,58458,56257,13229,100461,1025,ITC,ITC4,3,Lombardia,Lombardia,10060574,1913916,19.02,1.14
2616,2021-07-25,LOM,86641,45738,40903,9423,76437,781,ITC,ITC4,3,Lombardia,Lombardia,10060574,2000557,19.89,0.86
2617,2021-04-16,LOM,53731,23938,29793,38415,14398,918,ITC,ITC4,3,Lombardia,Lombardia,10060574,2054288,20.42,0.53
2618,2021-05-03,LOM,83746,39781,43965,69438,12146,2162,ITC,ITC4,3,Lombardia,Lombardia,10060574,2138034,21.25,0.83
2619,2021-01-23,LOM,1127,361,766,925,199,3,ITC,ITC4,3,Lombardia,Lombardia,10060574,2139161,21.26,0.01
2620,2021-09-08,LOM,58129,31740,26389,13512,42882,1735,ITC,ITC4,3,Lombardia,Lombardia,10060574,2197290,21.84,0.58
2621,2021-05-31,LOM,95747,47432,48315,78389,16256,1102,ITC,ITC4,3,Lombardia,Lombardia,10060574,2293037,22.79,0.95
2622,2021-07-27,LOM,104944,56847,48097,7482,96759,703,ITC,ITC4,3,Lombardia,Lombardia,10060574,2397981,23.84,1.04
2623,2021-03-26,LOM,41382,15732,25650,27502,13194,686,ITC,ITC4,3,Lombardia,Lombardia,10060574,2439363,24.25,0.41
2624,2021-05-22,LOM,70687,33870,36817,31726,38245,716,ITC,ITC4,3,Lombardia,Lombardia,10060574,2510050,24.95,0.7
2625,2021-05-29,LOM,88395,42443,45952,41396,46155,844,ITC,ITC4,3,Lombardia,Lombardia,10060574,2598445,25.83,0.88
2626,2021-02-18,LOM,14065,4931,9134,12828,1038,199,ITC,ITC4,3,Lombardia,Lombardia,10060574,2612510,25.97,0.14
2627,2021-01-09,LOM,12510,4613,7897,12502,0,8,ITC,ITC4,3,Lombardia,Lombardia,10060574,2625020,26.09,0.12
2628,2021-03-07,LOM,12100,5366,6734,9340,2563,197,ITC,ITC4,3,Lombardia,Lombardia,10060574,2637120,26.21,0.12
2629,2021-01-27,LOM,8074,2689,5385,807,7265,2,ITC,ITC4,3,Lombardia,Lombardia,10060574,2645194,26.29,0.08
2630,2021-07-03,LOM,102519,51722,50797,44538,55870,2111,ITC,ITC4,3,Lombardia,Lombardia,10060574,2747713,27.31,1.02
2631,2021-03-25,LOM,43052,16098,26954,29248,12882,922,ITC,ITC4,3,Lombardia,Lombardia,10060574,2790765,27.74,0.43
2632,2021-05-10,LOM,85313,40904,44409,61471,21601,2241,ITC,ITC4,3,Lombardia,Lombardia,10060574,2876078,28.59,0.85
2633,2021-01-30,LOM,12359,4587,7772,146,12204,9,ITC,ITC4,3,Lombardia,Lombardia,10060574,2888437,28.71,0.12
2634,2021-06-17,LOM,108671,52751,55920,50239,57251,1181,ITC,ITC4,3,Lombardia,Lombardia,10060574,2997108,29.79,1.08
2635,2021-03-09,LOM,33270,12882,20388,25246,7424,600,ITC,ITC4,3,Lombardia,Lombardia,10060574,3030378,30.12,0.33
2636,2021-08-13,LOM,53456,29607,23849,20526,31663,1267,ITC,ITC4,3,Lombardia,Lombardia,10060574,3083834,30.65,0.53
2637,2021-05-05,LOM,88126,42012,46114,70411,15366,2349,ITC,ITC4,3,Lombardia,Lombardia,10060574,3171960,31.53,0.88
2638,2021-07-01,LOM,105143,52895,52248,53336,49402,2405,ITC,ITC4,3,Lombardia,Lombardia,10060574,3277103,32.57,1.05
2639,2021-02-23,LOM,11835,4807,7028,11292,332,211,ITC,ITC4,3,Lombardia,Lombardia,10060574,3288938,32.69,0.12
2640,2021-08-08,LOM,58843,31958,26885,16681,41366,796,ITC,ITC4,3,Lombardia,Lombardia,10060574,3347781,33.28,0.58
2641,2021-08-25,LOM,44524,24049,20475,21661,19752,3111,ITC,ITC4,3,Lombardia,Lombardia,10060574,3392305,33.72,0.44
2642,2020-12-28,LOM,108,47,61,108,0,0,ITC,ITC4,3,Lombardia,Lombardia,10060574,3392413,33.72,0.0
2643,2021-04-21,LOM,71889,32584,39305,55817,14701,1371,ITC,ITC4,3,Lombardia,Lombardia,10060574,3464302,34.43,0.71
2644,2021-01-11,LOM,16317,5396,10921,16307,0,10,ITC,ITC4,3,Lombardia,Lombardia,10060574,3480619,34.6,0.16
2645,2021-01-28,LOM,12280,3723,8557,795,11478,7,ITC,ITC4,3,Lombardia,Lombardia,10060574,3492899,34.72,0.12
2646,2021-09-03,LOM,52922,28450,24472,22722,27552,2648,ITC,ITC4,3,Lombardia,Lombardia,10060574,3545821,35.24,0.53
2647,2021-08-12,LOM,56899,31255,25644,21998,33522,1379,ITC,ITC4,3,Lombardia,Lombardia,10060574,3602720,35.81,0.57
2648,2021-04-11,LOM,32231,13947,18284,24319,7397,515,ITC,ITC4,3,Lombardia,Lombardia,10060574,3634951,36.13,0.32
2649,2021-01-01,LOM,24,7,17,24,0,0,ITC,ITC4,3,Lombardia,Lombardia,10060574,3634975,36.13,0.0
2650,2021-06-07,LOM,99044,50446,48598,84031,13385,1628,ITC,ITC4,3,Lombardia,Lombardia,10060574,3734019,37.12,0.98
2651,2021-02-27,LOM,13955,5876,8079,13153,645,157,ITC,ITC4,3,Lombardia,Lombardia,10060574,3747974,37.25,0.14
2652,2020-12-30,LOM,115,42,73,115,0,0,ITC,ITC4,3,Lombardia,Lombardia,10060574,3748089,37.26,0.0
2653,2021-09-12,LOM,26940,14514,12426,8978,16760,1202,ITC,ITC4,3,Lombardia,Lombardia,10060574,3775029,37.52,0.27
2654,2021-06-21,LOM,113388,58087,55301,78212,33002,2174,ITC,ITC4,3,Lombardia,Lombardia,10060574,3888417,38.65,1.13
2655,2021-09-10,LOM,52632,28269,24363,11415,39441,1776,ITC,ITC4,3,Lombardia,Lombardia,10060574,3941049,39.17,0.52
2656,2021-06-02,LOM,84717,43617,41100,76985,6408,1324,ITC,ITC4,3,Lombardia,Lombardia,10060574,4025766,40.02,0.84
2657,2021-03-11,LOM,36283,13506,22777,25637,9958,688,ITC,ITC4,3,Lombardia,Lombardia,10060574,4062049,40.38,0.36
2658,2021-07-29,LOM,74428,40430,33998,33776,38701,1951,ITC,ITC4,3,Lombardia,Lombardia,10060574,4136477,41.12,0.74
2659,2021-06-12,LOM,89330,48067,41263,84304,3176,1850,ITC,ITC4,3,Lombardia,Lombardia,10060574,4225807,42.0,0.89
2660,2021-06-29,LOM,107321,53217,54104,57427,47885,2009,ITC,ITC4,3,Lombardia,Lombardia,10060574,4333128,43.07,1.07
2661,2021-03-21,LOM,23523,8499,15024,17720,5198,605,ITC,ITC4,3,Lombardia,Lombardia,10060574,4356651,43.3,0.23
2662,2021-02-13,LOM,6427,2445,3982,4887,1479,61,ITC,ITC4,3,Lombardia,Lombardia,10060574,4363078,43.37,0.06
2663,2021-07-17,LOM,108506,57295,51211,10219,97360,927,ITC,ITC4,3,Lombardia,Lombardia,10060574,4471584,44.45,1.08
2664,2021-01-13,LOM,26491,8103,18388,26466,0,25,ITC,ITC4,3,Lombardia,Lombardia,10060574,4498075,44.71,0.26
2665,2021-08-29,LOM,25186,13529,11657,12726,11159,1301,ITC,ITC4,3,Lombardia,Lombardia,10060574,4523261,44.96,0.25
2666,2021-05-21,LOM,93936,45281,48655,28390,64784,762,ITC,ITC4,3,Lombardia,Lombardia,10060574,4617197,45.89,0.93
2667,2021-05-07,LOM,92461,43752,48709,67926,22473,2062,ITC,ITC4,3,Lombardia,Lombardia,10060574,4709658,46.81,0.92
2668,2021-03-18,LOM,27469,10984,16485,15939,11303,227,ITC,ITC4,3,Lombardia,Lombardia,10060574,4737127,47.09,0.27
2669,2021-08-22,LOM,18209,10165,8044,7600,10066,543,ITC,ITC4,3,Lombardia,Lombardia,10060574,4755336,47.27,0.18
2670,2021-05-14,LOM,86050,41438,44612,53160,30369,2521,ITC,ITC4,3,Lombardia,Lombardia,10060574,4841386,48.12,0.86
2671,2021-07-10,LOM,107278,54308,52970,13913,92182,1183,ITC,ITC4,3,Lombardia,Lombardia,10060574,4948664,49.19,1.07
2672,2021-06-16,LOM,99376,50482,48894,49854,48369,1153,ITC,ITC4,3,Lombardia,Lombardia,10060574,5048040,50.18,0.99
2673,2021-03-06,LOM,21365,9109,12256,16542,4519,304,ITC,ITC4,3,Lombardia,Lombardia,10060574,5069405,50.39,0.21
2674,2021-06-09,LOM,103748,52256,51492,87433,14585,1730,ITC,ITC4,3,Lombardia,Lombardia,10060574,5173153,51.42,1.03
2675,2021-03-08,LOM,29828,11212,18616,22165,7129,534,ITC,ITC4,3,Lombardia,Lombardia,10060574,5202981,51.72,0.3
2676,2021-05-17,LOM,94695,45374,49321,29504,64442,749,ITC,ITC4,3,Lombardia,Lombardia,10060574,5297676,52.66,0.94
2677,2021-05-19,LOM,83307,39787,43520,33121,49375,811,ITC,ITC4,3,Lombardia,Lombardia,10060574,5380983,53.49,0.83
2678,2021-02-08,LOM,10137,2937,7200,2125,8004,8,ITC,ITC4,3,Lombardia,Lombardia,10060574,5391120,53.59,0.1
2679,2021-02-25,LOM,15360,6371,8989,13535,1624,201,ITC,ITC4,3,Lombardia,Lombardia,10060574,5406480,53.74,0.15
2680,2021-02-06,LOM,15311,5556,9755,1014,14292,5,ITC,ITC4,3,Lombardia,Lombardia,10060574,5421791,53.89,0.15
2681,2021-07-24,LOM,95878,50656,45222,9741,85280,857,ITC,ITC4,3,Lombardia,Lombardia,10060574,5517669,54.84,0.95
2682,2021-08-10,LOM,61478,33269,28209,18712,41699,1067,ITC,ITC4,3,Lombardia,Lombardia,10060574,5579147,55.46,0.61
2683,2021-05-02,LOM,83539,38349,45190,59223,22481,1835,ITC,ITC4,3,Lombardia,Lombardia,10060574,5662686,56.29,0.83
2684,2021-07-22,LOM,99406,52038,47368,12511,85443,1452,ITC,ITC4,3,Lombardia,Lombardia,10060574,5762092,57.27,0.99
2685,2021-04-13,LOM,47700,21291,26409,32929,14112,659,ITC,ITC4,3,Lombardia,Lombardia,10060574,5809792,57.75,0.47
2686,2021-08-03,LOM,85831,46538,39293,13487,71621,723,ITC,ITC4,3,Lombardia,Lombardia,10060574,5895623,58.6,0.85
2687,2021-04-25,LOM,51618,23665,27953,45520,4841,1257,ITC,ITC4,3,Lombardia,Lombardia,10060574,5947241,59.11,0.51
2688,2021-06-28,LOM,108102,55069,53033,74293,31194,2615,ITC,ITC4,3,Lombardia,Lombardia,10060574,6055343,60.19,1.07
2689,2021-07-15,LOM,109395,56280,53115,13385,94820,1190,ITC,ITC4,3,Lombardia,Lombardia,10060574,6164738,61.28,1.09
2690,2021-04-06,LOM,43103,17598,25505,24449,17958,696,ITC,ITC4,3,Lombardia,Lombardia,10060574,6207841,61.7,0.43
2691,2021-09-05,LOM,33251,18026,15225,12428,19466,1357,ITC,ITC4,3,Lombardia,Lombardia,10060574,6241092,62.04,0.33
2692,2021-03-04,LOM,29377,12136,17241,20064,9088,225,ITC,ITC4,3,Lombardia,Lombardia,10060574,6270469,62.33,0.29
2693,2021-02-20,LOM,9376,3876,5500,8846,333,197,ITC,ITC4,3,Lombardia,Lombardia,10060574,6279845,62.42,0.09
2694,2021-04-18,LOM,36442,16242,20200,30526,5248,668,ITC,ITC4,3,Lombardia,Lombardia,10060574,6316287,62.78,0.36
2695,2021-01-08,LOM,12757,3941,8816,12746,0,11,ITC,ITC4,3,Lombardia,Lombardia,10060574,6329044,62.91,0.13
2696,2021-03-30,LOM,39746,15637,24109,24256,14872,618,ITC,ITC4,3,Lombardia,Lombardia,10060574,6368790,63.3,0.4
2697,2021-01-06,LOM,7168,2532,4636,7162,0,6,ITC,ITC4,3,Lombardia,Lombardia,10060574,6375958,63.38,0.07
2698,2021-08-26,LOM,38676,20775,17901,20336,15546,2794,ITC,ITC4,3,Lombardia,Lombardia,10060574,6414634,63.76,0.38
2699,2021-05-18,LOM,88261,42183,46078,31860,55598,803,ITC,ITC4,3,Lombardia,Lombardia,10060574,6502895,64.64,0.88
2700,2021-06-04,LOM,104655,54323,50332,93201,9664,1790,ITC,ITC4,3,Lombardia,Lombardia,10060574,6607550,65.68,1.04
2701,2021-02-24,LOM,14728,5961,8767,13575,958,195,ITC,ITC4,3,Lombardia,Lombardia,10060574,6622278,65.82,0.15
2702,2021-05-16,LOM,68741,32519,36222,35548,32235,958,ITC,ITC4,3,Lombardia,Lombardia,10060574,6691019,66.51,0.68
2703,2021-02-05,LOM,25793,7495,18298,2430,23351,12,ITC,ITC4,3,Lombardia,Lombardia,10060574,6716812,66.76,0.26
2704,2021-02-22,LOM,11954,4824,7130,11444,310,200,ITC,ITC4,3,Lombardia,Lombardia,10060574,6728766,66.88,0.12
2705,2021-06-26,LOM,105935,55459,50476,77782,25747,2406,ITC,ITC4,3,Lombardia,Lombardia,10060574,6834701,67.94,1.05
2706,2021-02-10,LOM,14463,4528,9935,7568,6866,29,ITC,ITC4,3,Lombardia,Lombardia,10060574,6849164,68.08,0.14
2707,2021-09-09,LOM,56628,31085,25543,11920,43090,1618,ITC,ITC4,3,Lombardia,Lombardia,10060574,6905792,68.64,0.56
2708,2021-05-04,LOM,86888,41098,45790,70258,14426,2204,ITC,ITC4,3,Lombardia,Lombardia,10060574,6992680,69.51,0.86
2709,2021-01-24,LOM,1202,458,744,538,664,0,ITC,ITC4,3,Lombardia,Lombardia,10060574,6993882,69.52,0.01
2710,2021-08-21,LOM,21329,11877,9452,9485,11071,773,ITC,ITC4,3,Lombardia,Lombardia,10060574,7015211,69.73,0.21
2711,2021-04-30,LOM,117550,54899,62651,87202,27685,2663,ITC,ITC4,3,Lombardia,Lombardia,10060574,7132761,70.9,1.17
2712,2021-01-20,LOM,5717,1393,4324,5597,115,5,ITC,ITC4,3,Lombardia,Lombardia,10060574,7138478,70.95,0.06
2713,2021-01-22,LOM,3199,885,2314,3125,69,5,ITC,ITC4,3,Lombardia,Lombardia,10060574,7141677,70.99,0.03
2714,2021-06-14,LOM,94883,48207,46676,49129,44636,1118,ITC,ITC4,3,Lombardia,Lombardia,10060574,7236560,71.93,0.94
2715,2021-08-17,LOM,33281,18418,14863,17417,14677,1187,ITC,ITC4,3,Lombardia,Lombardia,10060574,7269841,72.26,0.33
2716,2021-05-26,LOM,93791,44686,49105,42745,50155,891,ITC,ITC4,3,Lombardia,Lombardia,10060574,7363632,73.19,0.93
2717,2021-02-15,LOM,9063,3171,5892,8398,486,179,ITC,ITC4,3,Lombardia,Lombardia,10060574,7372695,73.28,0.09
2718,2021-03-20,LOM,32616,12174,20442,22248,9861,507,ITC,ITC4,3,Lombardia,Lombardia,10060574,7405311,73.61,0.32
2719,2020-12-27,LOM,718,414,304,718,0,0,ITC,ITC4,3,Lombardia,Lombardia,10060574,7406029,73.61,0.01
2720,2021-08-02,LOM,83640,45306,38334,18337,64393,910,ITC,ITC4,3,Lombardia,Lombardia,10060574,7489669,74.45,0.83
2721,2021-06-30,LOM,107009,53009,54000,56592,48294,2123,ITC,ITC4,3,Lombardia,Lombardia,10060574,7596678,75.51,1.06
2722,2021-03-22,LOM,40370,14315,26055,28947,10580,843,ITC,ITC4,3,Lombardia,Lombardia,10060574,7637048,75.91,0.4
2723,2021-04-08,LOM,52479,21802,30677,35304,16501,674,ITC,ITC4,3,Lombardia,Lombardia,10060574,7689527,76.43,0.52
2724,2020-12-29,LOM,106,45,61,106,0,0,ITC,ITC4,3,Lombardia,Lombardia,10060574,7689633,76.43,0.0
2725,2021-07-14,LOM,109454,56863,52591,14354,93691,1409,ITC,ITC4,3,Lombardia,Lombardia,10060574,7799087,77.52,1.09
2726,2021-07-31,LOM,71113,38778,32335,36366,32724,2023,ITC,ITC4,3,Lombardia,Lombardia,10060574,7870200,78.23,0.71
2727,2021-04-22,LOM,74076,33447,40629,56218,16446,1412,ITC,ITC4,3,Lombardia,Lombardia,10060574,7944276,78.96,0.74
2728,2021-03-03,LOM,27029,11533,15496,19491,7318,220,ITC,ITC4,3,Lombardia,Lombardia,10060574,7971305,79.23,0.27
2729,2021-08-19,LOM,28973,15938,13035,14772,13075,1126,ITC,ITC4,3,Lombardia,Lombardia,10060574,8000278,79.52,0.29
2730,2021-05-11,LOM,86951,41460,45491,58212,26255,2484,ITC,ITC4,3,Lombardia,Lombardia,10060574,8087229,80.39,0.86
2731,2021-09-02,LOM,56469,30558,25911,25772,27699,2998,ITC,ITC4,3,Lombardia,Lombardia,10060574,8143698,80.95,0.56
2732,2021-05-28,LOM,93709,44882,48827,42037,50759,913,ITC,ITC4,3,Lombardia,Lombardia,10060574,8237407,81.88,0.93
2733,2021-02-17,LOM,12038,3779,8259,10448,1392,198,ITC,ITC4,3,Lombardia,Lombardia,10060574,8249445,82.0,0.12
2734,2021-06-11,LOM,101536,51719,49817,84940,14701,1895,ITC,ITC4,3,Lombardia,Lombardia,10060574,8350981,83.01,1.01
2735,2021-07-07,LOM,112069,56177,55892,18000,92909,1160,ITC,ITC4,3,Lombardia,Lombardia,10060574,8463050,84.12,1.11
2736,2021-04-15,LOM,49490,21873,27617,34891,13840,759,ITC,ITC4,3,Lombardia,Lombardia,10060574,8512540,84.61,0.49
2737,2021-01-05,LOM,7879,2585,5294,7873,0,6,ITC,ITC4,3,Lombardia,Lombardia,10060574,8520419,84.69,0.08
2738,2021-03-27,LOM,32534,12416,20118,23117,8776,641,ITC,ITC4,3,Lombardia,Lombardia,10060574,8552953,85.01,0.32
2739,2021-03-13,LOM,27237,9795,17442,20558,6123,556,ITC,ITC4,3,Lombardia,Lombardia,10060574,8580190,85.29,0.27
2740,2021-09-14,LOM,36170,19397,16773,7413,27617,1140,ITC,ITC4,3,Lombardia,Lombardia,10060574,8616360,85.64,0.36
2741,2021-08-05,LOM,90300,49271,41029,15754,73757,789,ITC,ITC4,3,Lombardia,Lombardia,10060574,8706660,86.54,0.9
2742,2021-01-15,LOM,25296,7459,17837,25244,0,52,ITC,ITC4,3,Lombardia,Lombardia,10060574,8731956,86.79,0.25
2743,2021-08-07,LOM,79729,43278,36451,16074,62847,808,ITC,ITC4,3,Lombardia,Lombardia,10060574,8811685,87.59,0.79
2744,2021-04-29,LOM,115668,53638,62030,83084,29929,2655,ITC,ITC4,3,Lombardia,Lombardia,10060574,8927353,88.74,1.15
2745,2021-06-25,LOM,108340,56259,52081,78358,27670,2312,ITC,ITC4,3,Lombardia,Lombardia,10060574,9035693,89.81,1.08
2746,2021-02-03,LOM,25738,7958,17780,1078,24655,5,ITC,ITC4,3,Lombardia,Lombardia,10060574,9061431,90.07,0.26
2747,2021-04-01,LOM,43200,17324,25876,26086,16399,715,ITC,ITC4,3,Lombardia,Lombardia,10060574,9104631,90.5,0.43
2748,2021-06-01,LOM,94050,46133,47917,75804,17132,1114,ITC,ITC4,3,Lombardia,Lombardia,10060574,9198681,91.43,0.93
2749,2021-01-02,LOM,202,74,128,202,0,0,ITC,ITC4,3,Lombardia,Lombardia,10060574,9198883,91.43,0.0
2750,2021-06-08,LOM,102959,52320,50639,87173,14104,1682,ITC,ITC4,3,Lombardia,Lombardia,10060574,9301842,92.46,1.02
2751,2021-02-28,LOM,7886,3256,4630,7604,210,72,ITC,ITC4,3,Lombardia,Lombardia,10060574,9309728,92.54,0.08
2752,2021-08-04,LOM,90173,48832,41341,14482,75032,659,ITC,ITC4,3,Lombardia,Lombardia,10060574,9399901,93.43,0.9
2753,2021-04-26,LOM,88033,40952,47081,67034,19171,1828,ITC,ITC4,3,Lombardia,Lombardia,10060574,9487934,94.31,0.88
2754,2021-06-18,LOM,107727,52909,54818,51786,54700,1241,ITC,ITC4,3,Lombardia,Lombardia,10060574,9595661,95.38,1.07
2755,2021-08-14,LOM,26545,14888,11657,11130,14861,554,ITC,ITC4,3,Lombardia,Lombardia,10060574,9622206,95.64,0.26
2756,2021-03-01,LOM,18802,8236,10566,16888,1708,206,ITC,ITC4,3,Lombardia,Lombardia,10060574,9641008,95.83,0.19
2757,2021-08-23,LOM,57493,31501,25992,23774,30431,3288,ITC,ITC4,3,Lombardia,Lombardia,10060574,9698501,96.4,0.57
2758,2021-05-15,LOM,80996,38809,42187,45385,33450,2161,ITC,ITC4,3,Lombardia,Lombardia,10060574,9779497,97.21,0.81
2759,2021-07-11,LOM,90347,45708,44639,11765,77524,1058,ITC,ITC4,3,Lombardia,Lombardia,10060574,9869844,98.1,0.9
2760,2021-05-13,LOM,87236,41798,45438,55590,28905,2741,ITC,ITC4,3,Lombardia,Lombardia,10060574,9957080,98.97,0.87
2761,2021-02-02,LOM,20011,6649,13362,497,19511,3,ITC,ITC4,3,Lombardia,Lombardia,10060574,9977091,99.17,0.2
2762,2021-03-31,LOM,42280,17152,25128,26201,15391,688,ITC,ITC4,3,Lombardia,Lombardia,10060574,10019371,99.59,0.42
2763,2021-05-09,LOM,69729,32894,36835,54422,13283,2024,ITC,ITC4,3,Lombardia,Lombardia,10060574,10089100,100.28,0.69
2764,2021-01-29,LOM,13551,4149,9402,686,12862,3,ITC,ITC4,3,Lombardia,Lombardia,10060574,10102651,100.42,0.13
2765,2021-06-13,LOM,76004,40566,35438,72282,2131,1591,ITC,ITC4,3,Lombardia,Lombardia,10060574,10178655,101.17,0.76
2766,2021-04-05,LOM,27392,11698,15694,19027,8110,255,ITC,ITC4,3,Lombardia,Lombardia,10060574,10206047,101.45,0.27
2767,2021-01-03,LOM,857,316,541,856,0,1,ITC,ITC4,3,Lombardia,Lombardia,10060574,10206904,101.45,0.01
2768,2021-06-22,LOM,111260,58107,53153,79174,29959,2127,ITC,ITC4,3,Lombardia,Lombardia,10060574,10318164,102.56,1.11
2769,2021-07-21,LOM,94011,48497,45514,8617,84531,863,ITC,ITC4,3,Lombardia,Lombardia,10060574,10412175,103.49,0.93
2770,2021-04-12,LOM,47360,20626,26734,32291,14417,652,ITC,ITC4,3,Lombardia,Lombardia,10060574,10459535,103.97,0.47
2771,2021-02-21,LOM,5055,1864,3191,4940,17,98,ITC,ITC4,3,Lombardia,Lombardia,10060574,10464590,104.02,0.05
2772,2021-07-28,LOM,77459,41730,35729,19117,56591,1751,ITC,ITC4,3,Lombardia,Lombardia,10060574,10542049,104.79,0.77
2773,2021-04-19,LOM,60409,27490,32919,49680,9422,1307,ITC,ITC4,3,Lombardia,Lombardia,10060574,10602458,105.39,0.6
2774,2021-06-15,LOM,96080,48897,47183,49024,46001,1055,ITC,ITC4,3,Lombardia,Lombardia,10060574,10698538,106.34,0.96
2775,2021-03-10,LOM,33370,12761,20609,24852,7911,607,ITC,ITC4,3,Lombardia,Lombardia,10060574,10731908,106.67,0.33
2776,2021-05-06,LOM,89955,42233,47722,70955,16584,2416,ITC,ITC4,3,Lombardia,Lombardia,10060574,10821863,107.57,0.89
2777,2021-01-26,LOM,8396,2719,5677,348,8047,1,ITC,ITC4,3,Lombardia,Lombardia,10060574,10830259,107.65,0.08
2778,2021-07-09,LOM,115796,59021,56775,11742,103168,886,ITC,ITC4,3,Lombardia,Lombardia,10060574,10946055,108.8,1.15
2779,2021-06-03,LOM,97206,49745,47461,84615,10920,1671,ITC,ITC4,3,Lombardia,Lombardia,10060574,11043261,109.77,0.97
2780,2021-06-20,LOM,89054,44375,44679,52800,35009,1245,ITC,ITC4,3,Lombardia,Lombardia,10060574,11132315,110.65,0.89
2781,2021-03-12,LOM,35341,12991,22350,24459,10261,621,ITC,ITC4,3,Lombardia,Lombardia,10060574,11167656,111.0,0.35
2782,2021-03-29,LOM,40082,15559,24523,24538,14865,679,ITC,ITC4,3,Lombardia,Lombardia,10060574,11207738,111.4,0.4
2783,2021-07-23,LOM,95532,50070,45462,11433,82843,1256,ITC,ITC4,3,Lombardia,Lombardia,10060574,11303270,112.35,0.95
2784,2021-08-09,LOM,68983,37024,31959,18638,49297,1048,ITC,ITC4,3,Lombardia,Lombardia,10060574,11372253,113.04,0.69
2785,2021-05-01,LOM,96107,43735,52372,65014,29331,1762,ITC,ITC4,3,Lombardia,Lombardia,10060574,11468360,113.99,0.96
2786,2021-01-21,LOM,5533,1612,3921,4821,695,17,ITC,ITC4,3,Lombardia,Lombardia,10060574,11473893,114.05,0.05
2787,2021-02-07,LOM,7322,2831,4491,335,6984,3,ITC,ITC4,3,Lombardia,Lombardia,10060574,11481215,114.12,0.07
2788,2021-01-19,LOM,8065,2333,5732,7580,471,14,ITC,ITC4,3,Lombardia,Lombardia,10060574,11489280,114.2,0.08
2789,2021-08-11,LOM,61387,33589,27798,22460,37579,1348,ITC,ITC4,3,Lombardia,Lombardia,10060574,11550667,114.81,0.61
2790,2021-08-28,LOM,35008,19242,15766,17761,15041,2206,ITC,ITC4,3,Lombardia,Lombardia,10060574,11585675,115.16,0.35
2791,2021-05-20,LOM,95617,46244,49373,31716,63084,817,ITC,ITC4,3,Lombardia,Lombardia,10060574,11681292,116.11,0.95
2792,2021-03-05,LOM,29008,11973,17035,20252,8447,309,ITC,ITC4,3,Lombardia,Lombardia,10060574,11710300,116.4,0.29
2793,2021-06-27,LOM,90955,46823,44132,69777,18875,2303,ITC,ITC4,3,Lombardia,Lombardia,10060574,11801255,117.3,0.9
2794,2021-03-19,LOM,32516,12954,19562,18920,13272,324,ITC,ITC4,3,Lombardia,Lombardia,10060574,11833771,117.63,0.32
2795,2021-09-04,LOM,45600,24702,20898,20522,22545,2533,ITC,ITC4,3,Lombardia,Lombardia,10060574,11879371,118.08,0.45
2796,2021-08-18,LOM,30916,17059,13857,17905,11642,1369,ITC,ITC4,3,Lombardia,Lombardia,10060574,11910287,118.39,0.31
2797,2021-01-31,LOM,9827,3815,6012,29,9798,0,ITC,ITC4,3,Lombardia,Lombardia,10060574,11920114,118.48,0.1
2798,2021-05-25,LOM,91228,43648,47580,43858,46546,824,ITC,ITC4,3,Lombardia,Lombardia,10060574,12011342,119.39,0.91
2799,2021-02-14,LOM,3586,1547,2039,2934,637,15,ITC,ITC4,3,Lombardia,Lombardia,10060574,12014928,119.43,0.04
2800,2021-01-12,LOM,20341,6746,13595,20310,0,31,ITC,ITC4,3,Lombardia,Lombardia,10060574,12035269,119.63,0.2
2801,2021-04-20,LOM,67717,30853,36864,55895,10362,1460,ITC,ITC4,3,Lombardia,Lombardia,10060574,12102986,120.3,0.67
2802,2021-01-10,LOM,10556,3982,6574,10547,0,9,ITC,ITC4,3,Lombardia,Lombardia,10060574,12113542,120.41,0.1
2803,2021-01-17,LOM,8361,3351,5010,8154,201,6,ITC,ITC4,3,Lombardia,Lombardia,10060574,12121903,120.49,0.08
2804,2021-06-23,LOM,111088,57465,53623,76652,32295,2141,ITC,ITC4,3,Lombardia,Lombardia,10060574,12232991,121.59,1.1
2805,2021-03-15,LOM,31638,11362,20276,22426,8585,627,ITC,ITC4,3,Lombardia,Lombardia,10060574,12264629,121.91,0.31
2806,2021-09-11,LOM,41125,22336,18789,13302,25965,1858,ITC,ITC4,3,Lombardia,Lombardia,10060574,12305754,122.32,0.41
2807,2021-05-27,LOM,95024,45509,49515,40622,53611,791,ITC,ITC4,3,Lombardia,Lombardia,10060574,12400778,123.26,0.94
2808,2021-04-24,LOM,75875,33627,42248,53414,21168,1293,ITC,ITC4,3,Lombardia,Lombardia,10060574,12476653,124.02,0.75
2809,2021-01-14,LOM,26982,7825,19157,26930,0,52,ITC,ITC4,3,Lombardia,Lombardia,10060574,12503635,124.28,0.27
2810,2021-08-16,LOM,38949,21058,17891,16836,21068,1045,ITC,ITC4,3,Lombardia,Lombardia,10060574,12542584,124.67,0.39
2811,2021-05-08,LOM,87842,40793,47049,63427,22119,2296,ITC,ITC4,3,Lombardia,Lombardia,10060574,12630426,125.54,0.87
2812,2021-07-16,LOM,108926,56713,52213,11136,96627,1163,ITC,ITC4,3,Lombardia,Lombardia,10060574,12739352,126.63,1.08
2813,2021-04-07,LOM,50661,20952,29709,34083,15866,712,ITC,ITC4,3,Lombardia,Lombardia,10060574,12790013,127.13,0.5
2814,2021-04-27,LOM,86114,40013,46101,67633,16613,1868,ITC,ITC4,3,Lombardia,Lombardia,10060574,12876127,127.99,0.86
2815,2021-09-06,LOM,56267,30324,25943,16508,37730,2029,ITC,ITC4,3,Lombardia,Lombardia,10060574,12932394,128.55,0.56
2816,2021-03-17,LOM,26348,10531,15817,15140,11047,161,ITC,ITC4,3,Lombardia,Lombardia,10060574,12958742,128.81,0.26
2817,2021-07-04,LOM,86771,43400,43371,40188,44624,1959,ITC,ITC4,3,Lombardia,Lombardia,10060574,13045513,129.67,0.86
2818,2021-08-30,LOM,71230,37841,33389,43170,22408,5652,ITC,ITC4,3,Lombardia,Lombardia,10060574,13116743,130.38,0.71
2819,2021-07-02,LOM,104040,52144,51896,48876,52962,2202,ITC,ITC4,3,Lombardia,Lombardia,10060574,13220783,131.41,1.03
2820,2021-03-24,LOM,43440,15688,27752,30469,12069,902,ITC,ITC4,3,Lombardia,Lombardia,10060574,13264223,131.84,0.43
2821,2021-02-09,LOM,12234,3338,8896,4027,8193,14,ITC,ITC4,3,Lombardia,Lombardia,10060574,13276457,131.97,0.12
2822,2021-01-18,LOM,9269,2992,6277,8279,975,15,ITC,ITC4,3,Lombardia,Lombardia,10060574,13285726,132.06,0.09
2823,2021-03-23,LOM,42644,15495,27149,28861,12911,872,ITC,ITC4,3,Lombardia,Lombardia,10060574,13328370,132.48,0.42
2824,2021-08-24,LOM,47551,25872,21679,24453,19456,3642,ITC,ITC4,3,Lombardia,Lombardia,10060574,13375921,132.95,0.47
2825,2021-01-25,LOM,7128,2400,4728,514,6611,3,ITC,ITC4,3,Lombardia,Lombardia,10060574,13383049,133.02,0.07
2826,2021-02-01,LOM,16132,5343,10789,307,15823,2,ITC,ITC4,3,Lombardia,Lombardia,10060574,13399181,133.19,0.16
2827,2021-07-05,LOM,101940,49793,52147,31505,68543,1892,ITC,ITC4,3,Lombardia,Lombardia,10060574,13501121,134.2,1.01
2828,2021-08-31,LOM,62823,33490,29333,36687,21584,4552,ITC,ITC4,3,Lombardia,Lombardia,10060574,13563944,134.82,0.62
2829,2021-07-12,LOM,111892,57515,54377,14805,95948,1139,ITC,ITC4,3,Lombardia,Lombardia,10060574,13675836,135.93,1.11
2830,2021-04-03,LOM,36338,14905,21433,25789,10164,385,ITC,ITC4,3,Lombardia,Lombardia,10060574,13712174,136.3,0.36
2831,2021-09-07,LOM,60950,33278,27672,15566,43322,2062,ITC,ITC4,3,Lombardia,Lombardia,10060574,13773124,136.9,0.61
2832,2021-05-30,LOM,74429,35615,38814,33795,40015,619,ITC,ITC4,3,Lombardia,Lombardia,10060574,13847553,137.64,0.74
2833,2021-07-26,LOM,109616,58920,50696,7714,101147,755,ITC,ITC4,3,Lombardia,Lombardia,10060574,13957169,138.73,1.09
2834,2021-05-23,LOM,60825,28966,31859,26297,34015,513,ITC,ITC4,3,Lombardia,Lombardia,10060574,14017994,139.34,0.6
2835,2021-02-12,LOM,14028,4389,9639,8887,4982,159,ITC,ITC4,3,Lombardia,Lombardia,10060574,14032022,139.48,0.14
2836,2021-07-19,LOM,96928,50319,46609,10805,85043,1080,ITC,ITC4,3,Lombardia,Lombardia,10060574,14128950,140.44,0.96
2837,2021-04-10,LOM,52824,21878,30946,40097,11977,750,ITC,ITC4,3,Lombardia,Lombardia,10060574,14181774,140.96,0.53
2838,2021-06-06,LOM,90137,46351,43786,79534,9222,1381,ITC,ITC4,3,Lombardia,Lombardia,10060574,14271911,141.86,0.9
2839,2021-01-07,LOM,11812,3657,8155,11771,0,41,ITC,ITC4,3,Lombardia,Lombardia,10060574,14283723,141.98,0.12
2840,2021-02-19,LOM,14230,5402,8828,13329,725,176,ITC,ITC4,3,Lombardia,Lombardia,10060574,14297953,142.12,0.14
2841,2021-04-17,LOM,48589,21331,27258,36983,10878,728,ITC,ITC4,3,Lombardia,Lombardia,10060574,14346542,142.6,0.48
2842,2021-02-26,LOM,18448,7572,10876,16330,1909,209,ITC,ITC4,3,Lombardia,Lombardia,10060574,14364990,142.78,0.18
2843,2021-07-30,LOM,73309,39804,33505,35096,36094,2119,ITC,ITC4,3,Lombardia,Lombardia,10060574,14438299,143.51,0.73
2844,2020-12-31,LOM,715,302,413,715,0,0,ITC,ITC4,3,Lombardia,Lombardia,10060574,14439014,143.52,0.01
2845,2021-08-10,CAL,9788,4916,4872,3602,6084,102,ITF,ITF6,18,Calabria,Calabria,1947131,9788,0.5,0.5
2846,2021-06-14,CAL,14359,6511,7848,9628,4654,77,ITF,ITF6,18,Calabria,Calabria,1947131,24147,1.24,0.74
2847,2021-03-04,CAL,5497,3198,2299,4677,800,20,ITF,ITF6,18,Calabria,Calabria,1947131,29644,1.52,0.28
2848,2021-06-12,CAL,13247,6299,6948,10781,2398,68,ITF,ITF6,18,Calabria,Calabria,1947131,42891,2.2,0.68
2849,2021-03-09,CAL,6592,3440,3152,5529,989,74,ITF,ITF6,18,Calabria,Calabria,1947131,49483,2.54,0.34
2850,2021-02-20,CAL,1511,789,722,1169,328,14,ITF,ITF6,18,Calabria,Calabria,1947131,50994,2.62,0.08
2851,2021-08-22,CAL,1524,769,755,484,1021,19,ITF,ITF6,18,Calabria,Calabria,1947131,52518,2.7,0.08
2852,2021-05-31,CAL,15301,7348,7953,7310,7909,82,ITF,ITF6,18,Calabria,Calabria,1947131,67819,3.48,0.79
2853,2021-07-27,CAL,17586,8993,8593,5020,12478,88,ITF,ITF6,18,Calabria,Calabria,1947131,85405,4.39,0.9
2854,2021-01-06,CAL,957,520,437,957,0,0,ITF,ITF6,18,Calabria,Calabria,1947131,86362,4.44,0.05
2855,2021-04-16,CAL,10349,5052,5297,8644,1644,61,ITF,ITF6,18,Calabria,Calabria,1947131,96711,4.97,0.53
2856,2021-02-18,CAL,1890,877,1013,1637,234,19,ITF,ITF6,18,Calabria,Calabria,1947131,98601,5.06,0.1
2857,2021-02-06,CAL,2937,1352,1585,439,2497,1,ITF,ITF6,18,Calabria,Calabria,1947131,101538,5.21,0.15
2858,2021-09-05,CAL,1497,812,685,698,782,17,ITF,ITF6,18,Calabria,Calabria,1947131,103035,5.29,0.08
2859,2021-07-10,CAL,15946,7539,8407,3244,12658,44,ITF,ITF6,18,Calabria,Calabria,1947131,118981,6.11,0.82
2860,2021-01-23,CAL,403,188,215,360,43,0,ITF,ITF6,18,Calabria,Calabria,1947131,119384,6.13,0.02
2861,2021-04-18,CAL,5882,2809,3073,4939,918,25,ITF,ITF6,18,Calabria,Calabria,1947131,125266,6.43,0.3
2862,2021-04-04,CAL,1574,789,785,1141,422,11,ITF,ITF6,18,Calabria,Calabria,1947131,126840,6.51,0.08
2863,2021-06-26,CAL,15586,7202,8384,7574,7941,71,ITF,ITF6,18,Calabria,Calabria,1947131,142426,7.31,0.8
2864,2021-08-08,CAL,4219,2146,2073,1493,2698,28,ITF,ITF6,18,Calabria,Calabria,1947131,146645,7.53,0.22
2865,2021-07-22,CAL,18331,9026,9305,3489,14751,91,ITF,ITF6,18,Calabria,Calabria,1947131,164976,8.47,0.94
2866,2021-04-30,CAL,15116,7415,7701,10528,4509,79,ITF,ITF6,18,Calabria,Calabria,1947131,180092,9.25,0.78
2867,2021-07-01,CAL,12399,5838,6561,5476,6839,84,ITF,ITF6,18,Calabria,Calabria,1947131,192491,9.89,0.64
2868,2021-02-01,CAL,2560,1213,1347,237,2320,3,ITF,ITF6,18,Calabria,Calabria,1947131,195051,10.02,0.13
2869,2021-07-08,CAL,12054,5618,6436,2693,9316,45,ITF,ITF6,18,Calabria,Calabria,1947131,207105,10.64,0.62
2870,2021-01-11,CAL,2194,1063,1131,2192,0,2,ITF,ITF6,18,Calabria,Calabria,1947131,209299,10.75,0.11
2871,2021-01-25,CAL,1090,522,568,150,940,0,ITF,ITF6,18,Calabria,Calabria,1947131,210389,10.81,0.06
2872,2021-05-05,CAL,13636,6523,7113,8416,5141,79,ITF,ITF6,18,Calabria,Calabria,1947131,224025,11.51,0.7
2873,2021-08-17,CAL,7685,3914,3771,2760,4829,96,ITF,ITF6,18,Calabria,Calabria,1947131,231710,11.9,0.39
2874,2021-09-15,CAL,3052,1516,1536,1194,1791,67,ITF,ITF6,18,Calabria,Calabria,1947131,234762,12.06,0.16
2875,2021-02-25,CAL,2930,1576,1354,2286,604,40,ITF,ITF6,18,Calabria,Calabria,1947131,237692,12.21,0.15
2876,2021-03-11,CAL,7317,3483,3834,5948,1316,53,ITF,ITF6,18,Calabria,Calabria,1947131,245009,12.58,0.38
2877,2021-06-19,CAL,15856,7422,8434,8498,7289,69,ITF,ITF6,18,Calabria,Calabria,1947131,260865,13.4,0.81
2878,2021-09-10,CAL,8983,4554,4429,3614,5164,205,ITF,ITF6,18,Calabria,Calabria,1947131,269848,13.86,0.46
2879,2021-08-03,CAL,14099,7127,6972,3910,10115,74,ITF,ITF6,18,Calabria,Calabria,1947131,283947,14.58,0.72
2880,2021-06-21,CAL,15419,7105,8314,7997,7383,39,ITF,ITF6,18,Calabria,Calabria,1947131,299366,15.37,0.79
2881,2021-01-04,CAL,1076,533,543,1073,0,3,ITF,ITF6,18,Calabria,Calabria,1947131,300442,15.43,0.06
2882,2021-04-23,CAL,13155,6461,6694,9439,3615,101,ITF,ITF6,18,Calabria,Calabria,1947131,313597,16.11,0.68
2883,2021-01-13,CAL,2110,1067,1043,2098,0,12,ITF,ITF6,18,Calabria,Calabria,1947131,315707,16.21,0.11
2884,2021-03-28,CAL,2696,1235,1461,1565,1126,5,ITF,ITF6,18,Calabria,Calabria,1947131,318403,16.35,0.14
2885,2021-08-29,CAL,1683,887,796,721,932,30,ITF,ITF6,18,Calabria,Calabria,1947131,320086,16.44,0.09
2886,2021-01-30,CAL,2213,1172,1041,295,1915,3,ITF,ITF6,18,Calabria,Calabria,1947131,322299,16.55,0.11
2887,2021-02-17,CAL,1879,833,1046,1649,213,17,ITF,ITF6,18,Calabria,Calabria,1947131,324178,16.65,0.1
2888,2021-07-24,CAL,18182,9345,8837,4683,13399,100,ITF,ITF6,18,Calabria,Calabria,1947131,342360,17.58,0.93
2889,2021-05-28,CAL,21019,10216,10803,11424,9482,113,ITF,ITF6,18,Calabria,Calabria,1947131,363379,18.66,1.08
2890,2021-06-07,CAL,18009,8424,9585,14712,3216,81,ITF,ITF6,18,Calabria,Calabria,1947131,381388,19.59,0.92
2891,2021-05-24,CAL,17787,8913,8874,9937,7769,81,ITF,ITF6,18,Calabria,Calabria,1947131,399175,20.5,0.91
2892,2021-05-07,CAL,16288,7670,8618,9649,6542,97,ITF,ITF6,18,Calabria,Calabria,1947131,415463,21.34,0.84
2893,2021-02-13,CAL,1420,613,807,1046,371,3,ITF,ITF6,18,Calabria,Calabria,1947131,416883,21.41,0.07
2894,2021-08-15,CAL,52,24,28,18,33,1,ITF,ITF6,18,Calabria,Calabria,1947131,416935,21.41,0.0
2895,2021-05-12,CAL,16500,8047,8453,10826,5577,97,ITF,ITF6,18,Calabria,Calabria,1947131,433435,22.26,0.85
2896,2021-05-26,CAL,18750,9340,9410,10335,8323,92,ITF,ITF6,18,Calabria,Calabria,1947131,452185,23.22,0.96
2897,2021-03-30,CAL,6520,2849,3671,3654,2842,24,ITF,ITF6,18,Calabria,Calabria,1947131,458705,23.56,0.33
2898,2021-09-03,CAL,9066,4631,4435,3572,5303,191,ITF,ITF6,18,Calabria,Calabria,1947131,467771,24.02,0.47
2899,2021-05-19,CAL,18324,9081,9243,11258,6990,76,ITF,ITF6,18,Calabria,Calabria,1947131,486095,24.96,0.94
2900,2021-01-18,CAL,1310,594,716,1057,249,4,ITF,ITF6,18,Calabria,Calabria,1947131,487405,25.03,0.07
2901,2021-07-03,CAL,15183,7148,8035,5285,9820,78,ITF,ITF6,18,Calabria,Calabria,1947131,502588,25.81,0.78
2902,2021-04-11,CAL,4214,1916,2298,2243,1954,17,ITF,ITF6,18,Calabria,Calabria,1947131,506802,26.03,0.22
2903,2021-07-20,CAL,17495,8484,9011,3196,14225,74,ITF,ITF6,18,Calabria,Calabria,1947131,524297,26.93,0.9
2904,2021-03-02,CAL,4425,2503,1922,3620,796,9,ITF,ITF6,18,Calabria,Calabria,1947131,528722,27.15,0.23
2905,2021-03-16,CAL,3875,1901,1974,2183,1679,13,ITF,ITF6,18,Calabria,Calabria,1947131,532597,27.35,0.2
2906,2021-07-29,CAL,17595,8772,8823,4718,12775,102,ITF,ITF6,18,Calabria,Calabria,1947131,550192,28.26,0.9
2907,2021-02-11,CAL,2353,1053,1300,1064,1267,22,ITF,ITF6,18,Calabria,Calabria,1947131,552545,28.38,0.12
2908,2021-03-06,CAL,8548,4406,4142,7706,817,25,ITF,ITF6,18,Calabria,Calabria,1947131,561093,28.82,0.44
2909,2021-08-19,CAL,5871,2944,2927,2346,3467,58,ITF,ITF6,18,Calabria,Calabria,1947131,566964,29.12,0.3
2910,2021-05-09,CAL,9709,4534,5175,6040,3621,48,ITF,ITF6,18,Calabria,Calabria,1947131,576673,29.62,0.5
2911,2021-01-29,CAL,2081,1005,1076,226,1854,1,ITF,ITF6,18,Calabria,Calabria,1947131,578754,29.72,0.11
2912,2021-05-14,CAL,19955,9584,10371,12949,6890,116,ITF,ITF6,18,Calabria,Calabria,1947131,598709,30.75,1.02
2913,2021-04-27,CAL,9986,4908,5078,7960,1974,52,ITF,ITF6,18,Calabria,Calabria,1947131,608695,31.26,0.51
2914,2021-02-03,CAL,2872,1481,1391,516,2351,5,ITF,ITF6,18,Calabria,Calabria,1947131,611567,31.41,0.15
2915,2021-07-19,CAL,19022,9112,9910,3034,15937,51,ITF,ITF6,18,Calabria,Calabria,1947131,630589,32.39,0.98
2916,2021-08-05,CAL,12473,6289,6184,3879,8495,99,ITF,ITF6,18,Calabria,Calabria,1947131,643062,33.03,0.64
2917,2021-06-23,CAL,17253,7879,9374,8145,9025,83,ITF,ITF6,18,Calabria,Calabria,1947131,660315,33.91,0.89
2918,2021-03-13,CAL,7032,3048,3984,5945,1049,38,ITF,ITF6,18,Calabria,Calabria,1947131,667347,34.27,0.36
2919,2021-06-11,CAL,17832,8761,9071,15126,2581,125,ITF,ITF6,18,Calabria,Calabria,1947131,685179,35.19,0.92
2920,2021-01-08,CAL,2202,1049,1153,2195,0,7,ITF,ITF6,18,Calabria,Calabria,1947131,687381,35.3,0.11
2921,2021-03-18,CAL,4510,2110,2400,2345,2139,26,ITF,ITF6,18,Calabria,Calabria,1947131,691891,35.53,0.23
2922,2021-04-15,CAL,7800,3820,3980,5997,1756,47,ITF,ITF6,18,Calabria,Calabria,1947131,699691,35.93,0.4
2923,2021-04-01,CAL,8701,3961,4740,4153,4510,38,ITF,ITF6,18,Calabria,Calabria,1947131,708392,36.38,0.45
2924,2021-04-08,CAL,9373,4441,4932,5833,3489,51,ITF,ITF6,18,Calabria,Calabria,1947131,717765,36.86,0.48
2925,2021-09-12,CAL,2135,1120,1015,824,1274,37,ITF,ITF6,18,Calabria,Calabria,1947131,719900,36.97,0.11
2926,2021-02-10,CAL,2527,1086,1441,876,1636,15,ITF,ITF6,18,Calabria,Calabria,1947131,722427,37.1,0.13
2927,2021-07-17,CAL,18336,9046,9290,2707,15561,68,ITF,ITF6,18,Calabria,Calabria,1947131,740763,38.04,0.94
2928,2021-06-04,CAL,17546,8158,9388,12951,4525,70,ITF,ITF6,18,Calabria,Calabria,1947131,758309,38.94,0.9
2929,2021-05-21,CAL,21375,10886,10489,13859,7407,109,ITF,ITF6,18,Calabria,Calabria,1947131,779684,40.04,1.1
2930,2021-05-04,CAL,16536,7625,8911,11622,4808,106,ITF,ITF6,18,Calabria,Calabria,1947131,796220,40.89,0.85
2931,2021-08-12,CAL,7645,3881,3764,2801,4668,176,ITF,ITF6,18,Calabria,Calabria,1947131,803865,41.28,0.39
2932,2021-01-22,CAL,662,276,386,660,2,0,ITF,ITF6,18,Calabria,Calabria,1947131,804527,41.32,0.03
2933,2021-05-02,CAL,12562,5862,6700,10583,1911,68,ITF,ITF6,18,Calabria,Calabria,1947131,817089,41.96,0.65
2934,2021-04-13,CAL,6975,3425,3550,5612,1336,27,ITF,ITF6,18,Calabria,Calabria,1947131,824064,42.32,0.36
2935,2021-01-20,CAL,1410,630,780,1406,1,3,ITF,ITF6,18,Calabria,Calabria,1947131,825474,42.39,0.07
2936,2021-01-03,CAL,6,3,3,6,0,0,ITF,ITF6,18,Calabria,Calabria,1947131,825480,42.39,0.0
2937,2021-03-27,CAL,8856,4034,4822,4668,4144,44,ITF,ITF6,18,Calabria,Calabria,1947131,834336,42.85,0.45
2938,2021-07-05,CAL,13385,6252,7133,4262,9058,65,ITF,ITF6,18,Calabria,Calabria,1947131,847721,43.54,0.69
2939,2021-03-08,CAL,5523,2991,2532,4405,1085,33,ITF,ITF6,18,Calabria,Calabria,1947131,853244,43.82,0.28
2940,2021-03-25,CAL,7558,3572,3986,4585,2935,38,ITF,ITF6,18,Calabria,Calabria,1947131,860802,44.21,0.39
2941,2021-09-07,CAL,5889,2978,2911,2768,2979,142,ITF,ITF6,18,Calabria,Calabria,1947131,866691,44.51,0.3
2942,2021-06-16,CAL,18343,8476,9867,12127,6126,90,ITF,ITF6,18,Calabria,Calabria,1947131,885034,45.45,0.94
2943,2021-05-23,CAL,11395,5555,5840,6995,4356,44,ITF,ITF6,18,Calabria,Calabria,1947131,896429,46.04,0.59
2944,2021-03-01,CAL,2764,1567,1197,2299,461,4,ITF,ITF6,18,Calabria,Calabria,1947131,899193,46.18,0.14
2945,2021-06-09,CAL,18266,8626,9640,15896,2285,85,ITF,ITF6,18,Calabria,Calabria,1947131,917459,47.12,0.94
2946,2021-08-31,CAL,6827,3376,3451,2670,4030,127,ITF,ITF6,18,Calabria,Calabria,1947131,924286,47.47,0.35
2947,2021-02-27,CAL,4068,2097,1971,3674,387,7,ITF,ITF6,18,Calabria,Calabria,1947131,928354,47.68,0.21
2948,2021-07-31,CAL,13809,7060,6749,3637,10096,76,ITF,ITF6,18,Calabria,Calabria,1947131,942163,48.39,0.71
2949,2021-01-27,CAL,1492,757,735,384,1107,1,ITF,ITF6,18,Calabria,Calabria,1947131,943655,48.46,0.08
2950,2021-01-15,CAL,2820,1267,1553,2814,0,6,ITF,ITF6,18,Calabria,Calabria,1947131,946475,48.61,0.14
2951,2021-04-25,CAL,15901,8070,7831,14800,1033,68,ITF,ITF6,18,Calabria,Calabria,1947131,962376,49.43,0.82
2952,2021-08-26,CAL,7208,3602,3606,3178,3907,123,ITF,ITF6,18,Calabria,Calabria,1947131,969584,49.8,0.37
2953,2021-06-30,CAL,16393,7509,8884,7016,9275,102,ITF,ITF6,18,Calabria,Calabria,1947131,985977,50.64,0.84
2954,2021-06-28,CAL,13308,6127,7181,5373,7867,68,ITF,ITF6,18,Calabria,Calabria,1947131,999285,51.32,0.68
2955,2021-02-22,CAL,2106,1074,1032,1536,561,9,ITF,ITF6,18,Calabria,Calabria,1947131,1001391,51.43,0.11
2956,2021-06-02,CAL,12116,5807,6309,8787,3279,50,ITF,ITF6,18,Calabria,Calabria,1947131,1013507,52.05,0.62
2957,2021-08-07,CAL,9527,4874,4653,3018,6445,64,ITF,ITF6,18,Calabria,Calabria,1947131,1023034,52.54,0.49
2958,2021-05-16,CAL,13818,6741,7077,9920,3844,54,ITF,ITF6,18,Calabria,Calabria,1947131,1036852,53.25,0.71
2959,2021-08-24,CAL,6509,3229,3280,2321,4101,87,ITF,ITF6,18,Calabria,Calabria,1947131,1043361,53.58,0.33
2960,2021-07-21,CAL,22116,10623,11493,4514,17487,115,ITF,ITF6,18,Calabria,Calabria,1947131,1065477,54.72,1.14
2961,2021-01-17,CAL,914,441,473,808,100,6,ITF,ITF6,18,Calabria,Calabria,1947131,1066391,54.77,0.05
2962,2021-03-24,CAL,8023,3670,4353,4585,3413,25,ITF,ITF6,18,Calabria,Calabria,1947131,1074414,55.18,0.41
2963,2021-04-10,CAL,11741,5314,6427,6828,4868,45,ITF,ITF6,18,Calabria,Calabria,1947131,1086155,55.78,0.6
2964,2021-01-05,CAL,1553,732,821,1551,0,2,ITF,ITF6,18,Calabria,Calabria,1947131,1087708,55.86,0.08
2965,2021-01-12,CAL,2094,1035,1059,2085,0,9,ITF,ITF6,18,Calabria,Calabria,1947131,1089802,55.97,0.11
2966,2021-03-29,CAL,5788,2501,3287,3977,1777,34,ITF,ITF6,18,Calabria,Calabria,1947131,1095590,56.27,0.3
2967,2021-01-31,CAL,1132,564,568,148,984,0,ITF,ITF6,18,Calabria,Calabria,1947131,1096722,56.33,0.06
2968,2021-07-07,CAL,13976,6585,7391,3902,9998,76,ITF,ITF6,18,Calabria,Calabria,1947131,1110698,57.04,0.72
2969,2021-05-11,CAL,15151,7336,7815,10244,4835,72,ITF,ITF6,18,Calabria,Calabria,1947131,1125849,57.82,0.78
2970,2021-07-16,CAL,21057,10035,11022,3376,17604,77,ITF,ITF6,18,Calabria,Calabria,1947131,1146906,58.9,1.08
2971,2021-09-11,CAL,4843,2581,2262,1913,2809,121,ITF,ITF6,18,Calabria,Calabria,1947131,1151749,59.15,0.25
2972,2021-06-18,CAL,18921,8809,10112,11283,7520,118,ITF,ITF6,18,Calabria,Calabria,1947131,1170670,60.12,0.97
2973,2021-07-12,CAL,17981,8539,9442,2687,15245,49,ITF,ITF6,18,Calabria,Calabria,1947131,1188651,61.05,0.92
2974,2021-01-10,CAL,958,540,418,958,0,0,ITF,ITF6,18,Calabria,Calabria,1947131,1189609,61.1,0.05
2975,2021-04-20,CAL,7907,3992,3915,6080,1750,77,ITF,ITF6,18,Calabria,Calabria,1947131,1197516,61.5,0.41
2976,2021-08-16,CAL,6976,3567,3409,2376,4538,62,ITF,ITF6,18,Calabria,Calabria,1947131,1204492,61.86,0.36
2977,2021-02-12,CAL,1717,673,1044,943,768,6,ITF,ITF6,18,Calabria,Calabria,1947131,1206209,61.95,0.09
2978,2021-09-02,CAL,7540,3917,3623,3159,4259,122,ITF,ITF6,18,Calabria,Calabria,1947131,1213749,62.34,0.39
2979,2021-02-14,CAL,491,229,262,453,37,1,ITF,ITF6,18,Calabria,Calabria,1947131,1214240,62.36,0.03
2980,2021-05-25,CAL,16428,8047,8381,10215,6126,87,ITF,ITF6,18,Calabria,Calabria,1947131,1230668,63.2,0.84
2981,2021-01-26,CAL,1894,910,984,269,1624,1,ITF,ITF6,18,Calabria,Calabria,1947131,1232562,63.3,0.1
2982,2021-07-28,CAL,21385,10737,10648,5897,15374,114,ITF,ITF6,18,Calabria,Calabria,1947131,1253947,64.4,1.1
2983,2021-04-22,CAL,9843,4922,4921,6851,2938,54,ITF,ITF6,18,Calabria,Calabria,1947131,1263790,64.91,0.51
2984,2021-05-06,CAL,13362,6324,7038,8924,4365,73,ITF,ITF6,18,Calabria,Calabria,1947131,1277152,65.59,0.69
2985,2021-08-14,CAL,2233,1195,1038,728,1489,16,ITF,ITF6,18,Calabria,Calabria,1947131,1279385,65.71,0.11
2986,2021-07-14,CAL,22648,10681,11967,4159,18412,77,ITF,ITF6,18,Calabria,Calabria,1947131,1302033,66.87,1.16
2987,2021-04-05,CAL,3647,1730,1917,2674,960,13,ITF,ITF6,18,Calabria,Calabria,1947131,1305680,67.06,0.19
2988,2021-03-10,CAL,6890,3508,3382,5473,1378,39,ITF,ITF6,18,Calabria,Calabria,1947131,1312570,67.41,0.35
2989,2021-08-23,CAL,7683,3815,3868,2796,4781,106,ITF,ITF6,18,Calabria,Calabria,1947131,1320253,67.81,0.39
2990,2021-06-01,CAL,12887,5977,6910,7884,4943,60,ITF,ITF6,18,Calabria,Calabria,1947131,1333140,68.47,0.66
2991,2021-09-09,CAL,6298,3152,3146,2398,3786,114,ITF,ITF6,18,Calabria,Calabria,1947131,1339438,68.79,0.32
2992,2021-05-13,CAL,15986,7693,8293,11176,4733,77,ITF,ITF6,18,Calabria,Calabria,1947131,1355424,69.61,0.82
2993,2021-02-19,CAL,1521,689,832,1248,264,9,ITF,ITF6,18,Calabria,Calabria,1947131,1356945,69.69,0.08
2994,2021-05-30,CAL,11011,5309,5702,6822,4154,35,ITF,ITF6,18,Calabria,Calabria,1947131,1367956,70.25,0.57
2995,2021-02-05,CAL,3866,1747,2119,472,3379,15,ITF,ITF6,18,Calabria,Calabria,1947131,1371822,70.45,0.2
2996,2021-04-29,CAL,12527,6094,6433,8655,3812,60,ITF,ITF6,18,Calabria,Calabria,1947131,1384349,71.1,0.64
2997,2021-04-12,CAL,7047,3428,3619,5353,1665,29,ITF,ITF6,18,Calabria,Calabria,1947131,1391396,71.46,0.36
2998,2021-01-19,CAL,1132,499,633,1117,13,2,ITF,ITF6,18,Calabria,Calabria,1947131,1392528,71.52,0.06
2999,2021-07-04,CAL,5957,2824,3133,1992,3929,36,ITF,ITF6,18,Calabria,Calabria,1947131,1398485,71.82,0.31
3000,2021-03-20,CAL,6793,3113,3680,4182,2594,17,ITF,ITF6,18,Calabria,Calabria,1947131,1405278,72.17,0.35
3001,2021-03-15,CAL,3667,1771,1896,2167,1488,12,ITF,ITF6,18,Calabria,Calabria,1947131,1408945,72.36,0.19
3002,2021-08-28,CAL,5310,2782,2528,1902,3314,94,ITF,ITF6,18,Calabria,Calabria,1947131,1414255,72.63,0.27
3003,2021-07-02,CAL,16277,7536,8741,6237,9952,88,ITF,ITF6,18,Calabria,Calabria,1947131,1430532,73.47,0.84
3004,2021-05-20,CAL,17000,8509,8491,11272,5659,69,ITF,ITF6,18,Calabria,Calabria,1947131,1447532,74.34,0.87
3005,2021-02-24,CAL,1953,997,956,1468,479,6,ITF,ITF6,18,Calabria,Calabria,1947131,1449485,74.44,0.1
3006,2021-03-03,CAL,5123,2798,2325,4019,1090,14,ITF,ITF6,18,Calabria,Calabria,1947131,1454608,74.71,0.26
3007,2021-08-04,CAL,16017,8119,7898,4247,11667,103,ITF,ITF6,18,Calabria,Calabria,1947131,1470625,75.53,0.82
3008,2021-06-29,CAL,13078,6041,7037,5352,7674,52,ITF,ITF6,18,Calabria,Calabria,1947131,1483703,76.2,0.67
3009,2021-05-03,CAL,14859,6807,8052,10463,4302,94,ITF,ITF6,18,Calabria,Calabria,1947131,1498562,76.96,0.76
3010,2021-03-21,CAL,4471,1931,2540,2728,1730,13,ITF,ITF6,18,Calabria,Calabria,1947131,1503033,77.19,0.23
3011,2021-03-07,CAL,3415,1744,1671,3308,93,14,ITF,ITF6,18,Calabria,Calabria,1947131,1506448,77.37,0.18
3012,2021-08-11,CAL,11057,5672,5385,3521,7421,115,ITF,ITF6,18,Calabria,Calabria,1947131,1517505,77.94,0.57
3013,2021-01-24,CAL,47,20,27,41,6,0,ITF,ITF6,18,Calabria,Calabria,1947131,1517552,77.94,0.0
3014,2021-07-09,CAL,15682,7308,8374,3635,11976,71,ITF,ITF6,18,Calabria,Calabria,1947131,1533234,78.74,0.81
3015,2021-08-21,CAL,3646,1859,1787,1440,2159,47,ITF,ITF6,18,Calabria,Calabria,1947131,1536880,78.93,0.19
3016,2020-12-28,CAL,6,2,4,6,0,0,ITF,ITF6,18,Calabria,Calabria,1947131,1536886,78.93,0.0
3017,2021-06-03,CAL,14257,6655,7602,9588,4615,54,ITF,ITF6,18,Calabria,Calabria,1947131,1551143,79.66,0.73
3018,2021-04-07,CAL,9203,4181,5022,5071,4074,58,ITF,ITF6,18,Calabria,Calabria,1947131,1560346,80.14,0.47
3019,2021-02-23,CAL,1618,766,852,1494,119,5,ITF,ITF6,18,Calabria,Calabria,1947131,1561964,80.22,0.08
3020,2021-06-27,CAL,8428,3948,4480,4987,3399,42,ITF,ITF6,18,Calabria,Calabria,1947131,1570392,80.65,0.43
3021,2021-04-03,CAL,9462,4093,5369,4535,4864,63,ITF,ITF6,18,Calabria,Calabria,1947131,1579854,81.14,0.49
3022,2021-01-28,CAL,2300,1144,1156,78,2222,0,ITF,ITF6,18,Calabria,Calabria,1947131,1582154,81.26,0.12
3023,2021-08-13,CAL,7593,3917,3676,2442,5083,68,ITF,ITF6,18,Calabria,Calabria,1947131,1589747,81.65,0.39
3024,2021-06-08,CAL,16688,7904,8784,14513,2051,124,ITF,ITF6,18,Calabria,Calabria,1947131,1606435,82.5,0.86
3025,2021-03-17,CAL,4201,1882,2319,2190,2001,10,ITF,ITF6,18,Calabria,Calabria,1947131,1610636,82.72,0.22
3026,2021-06-25,CAL,18837,8748,10089,8065,10685,87,ITF,ITF6,18,Calabria,Calabria,1947131,1629473,83.69,0.97
3027,2021-07-13,CAL,17441,8159,9282,2307,15064,70,ITF,ITF6,18,Calabria,Calabria,1947131,1646914,84.58,0.9
3028,2021-05-17,CAL,14915,7464,7451,10135,4721,59,ITF,ITF6,18,Calabria,Calabria,1947131,1661829,85.35,0.77
3029,2021-08-25,CAL,8845,4330,4515,3326,5386,133,ITF,ITF6,18,Calabria,Calabria,1947131,1670674,85.8,0.45
3030,2021-06-15,CAL,15162,7052,8110,10238,4832,92,ITF,ITF6,18,Calabria,Calabria,1947131,1685836,86.58,0.78
3031,2021-03-14,CAL,2776,1073,1703,2283,486,7,ITF,ITF6,18,Calabria,Calabria,1947131,1688612,86.72,0.14
3032,2021-08-18,CAL,9457,4850,4607,3389,5968,100,ITF,ITF6,18,Calabria,Calabria,1947131,1698069,87.21,0.49
3033,2021-06-22,CAL,14627,6918,7709,7378,7153,96,ITF,ITF6,18,Calabria,Calabria,1947131,1712696,87.96,0.75
3034,2021-05-10,CAL,13175,6127,7048,7687,5421,67,ITF,ITF6,18,Calabria,Calabria,1947131,1725871,88.64,0.68
3035,2021-03-31,CAL,9165,4181,4984,5065,4062,38,ITF,ITF6,18,Calabria,Calabria,1947131,1735036,89.11,0.47
3036,2021-04-09,CAL,8044,3772,4272,5057,2897,90,ITF,ITF6,18,Calabria,Calabria,1947131,1743080,89.52,0.41
3037,2021-09-13,CAL,8462,4281,4181,3212,5099,151,ITF,ITF6,18,Calabria,Calabria,1947131,1751542,89.96,0.43
3038,2021-07-18,CAL,8791,4205,4586,1280,7479,32,ITF,ITF6,18,Calabria,Calabria,1947131,1760333,90.41,0.45
3039,2021-02-21,CAL,671,307,364,591,79,1,ITF,ITF6,18,Calabria,Calabria,1947131,1761004,90.44,0.03
3040,2021-04-28,CAL,12578,6101,6477,9622,2884,72,ITF,ITF6,18,Calabria,Calabria,1947131,1773582,91.09,0.65
3041,2021-02-04,CAL,3677,1748,1929,646,3025,6,ITF,ITF6,18,Calabria,Calabria,1947131,1777259,91.28,0.19
3042,2021-05-15,CAL,27281,13057,14224,20268,6881,132,ITF,ITF6,18,Calabria,Calabria,1947131,1804540,92.68,1.4
3043,2021-08-06,CAL,15624,7934,7690,5088,10402,134,ITF,ITF6,18,Calabria,Calabria,1947131,1820164,93.48,0.8
3044,2021-02-02,CAL,2376,1170,1206,176,2200,0,ITF,ITF6,18,Calabria,Calabria,1947131,1822540,93.6,0.12
3045,2021-01-16,CAL,2429,1140,1289,2426,0,3,ITF,ITF6,18,Calabria,Calabria,1947131,1824969,93.73,0.12
3046,2021-06-17,CAL,15820,7229,8591,9595,6171,54,ITF,ITF6,18,Calabria,Calabria,1947131,1840789,94.54,0.81
3047,2021-03-26,CAL,8120,3854,4266,4947,3139,34,ITF,ITF6,18,Calabria,Calabria,1947131,1848909,94.96,0.42
3048,2021-09-08,CAL,7723,3985,3738,3303,4265,155,ITF,ITF6,18,Calabria,Calabria,1947131,1856632,95.35,0.4
3049,2021-07-06,CAL,12494,5750,6744,3825,8603,66,ITF,ITF6,18,Calabria,Calabria,1947131,1869126,95.99,0.64
3050,2021-01-02,CAL,166,94,72,166,0,0,ITF,ITF6,18,Calabria,Calabria,1947131,1869292,96.0,0.01
3051,2021-05-08,CAL,18590,8432,10158,10504,8007,79,ITF,ITF6,18,Calabria,Calabria,1947131,1887882,96.96,0.95
3052,2021-05-22,CAL,22203,10564,11639,14212,7902,89,ITF,ITF6,18,Calabria,Calabria,1947131,1910085,98.1,1.14
3053,2021-08-30,CAL,9384,4715,4669,3151,6108,125,ITF,ITF6,18,Calabria,Calabria,1947131,1919469,98.58,0.48
3054,2021-04-21,CAL,11638,5847,5791,8637,2939,62,ITF,ITF6,18,Calabria,Calabria,1947131,1931107,99.18,0.6
3055,2021-07-30,CAL,19741,10065,9676,5515,14097,129,ITF,ITF6,18,Calabria,Calabria,1947131,1950848,100.19,1.01
3056,2021-04-02,CAL,8561,3923,4638,4585,3942,34,ITF,ITF6,18,Calabria,Calabria,1947131,1959409,100.63,0.44
3057,2021-04-19,CAL,7909,3820,4089,6173,1688,48,ITF,ITF6,18,Calabria,Calabria,1947131,1967318,101.04,0.41
3058,2021-01-09,CAL,2105,1130,975,2097,0,8,ITF,ITF6,18,Calabria,Calabria,1947131,1969423,101.14,0.11
3059,2021-09-01,CAL,9139,4692,4447,3499,5495,145,ITF,ITF6,18,Calabria,Calabria,1947131,1978562,101.61,0.47
3060,2021-02-28,CAL,2379,1086,1293,2219,157,3,ITF,ITF6,18,Calabria,Calabria,1947131,1980941,101.74,0.12
3061,2021-04-26,CAL,10195,5061,5134,7710,2435,50,ITF,ITF6,18,Calabria,Calabria,1947131,1991136,102.26,0.52
3062,2021-06-05,CAL,20799,9716,11083,17636,3082,81,ITF,ITF6,18,Calabria,Calabria,1947131,2011935,103.33,1.07
3063,2021-02-07,CAL,872,435,437,143,727,2,ITF,ITF6,18,Calabria,Calabria,1947131,2012807,103.37,0.04
3064,2021-05-18,CAL,15346,7678,7668,11849,3428,69,ITF,ITF6,18,Calabria,Calabria,1947131,2028153,104.16,0.79
3065,2021-03-22,CAL,5009,2355,2654,3185,1801,23,ITF,ITF6,18,Calabria,Calabria,1947131,2033162,104.42,0.26
3066,2021-09-04,CAL,5552,2959,2593,2320,3126,106,ITF,ITF6,18,Calabria,Calabria,1947131,2038714,104.7,0.29
3067,2021-06-24,CAL,15422,7026,8396,6982,8360,80,ITF,ITF6,18,Calabria,Calabria,1947131,2054136,105.5,0.79
3068,2021-03-19,CAL,4268,1997,2271,1885,2376,7,ITF,ITF6,18,Calabria,Calabria,1947131,2058404,105.71,0.22
3069,2021-07-11,CAL,6435,2986,3449,846,5578,11,ITF,ITF6,18,Calabria,Calabria,1947131,2064839,106.05,0.33
3070,2021-06-10,CAL,15899,7335,8564,12985,2811,103,ITF,ITF6,18,Calabria,Calabria,1947131,2080738,106.86,0.82
3071,2021-02-09,CAL,2178,922,1256,953,1215,10,ITF,ITF6,18,Calabria,Calabria,1947131,2082916,106.97,0.11
3072,2021-05-29,CAL,19303,8963,10340,9354,9874,75,ITF,ITF6,18,Calabria,Calabria,1947131,2102219,107.96,0.99
3073,2021-09-06,CAL,7997,4113,3884,3437,4420,140,ITF,ITF6,18,Calabria,Calabria,1947131,2110216,108.38,0.41
3074,2021-07-25,CAL,6949,3571,3378,1467,5450,32,ITF,ITF6,18,Calabria,Calabria,1947131,2117165,108.73,0.36
3075,2021-04-14,CAL,8099,3911,4188,6588,1461,50,ITF,ITF6,18,Calabria,Calabria,1947131,2125264,109.15,0.42
3076,2021-02-16,CAL,1754,746,1008,1467,281,6,ITF,ITF6,18,Calabria,Calabria,1947131,2127018,109.24,0.09
3077,2021-07-23,CAL,22746,11351,11395,5558,17085,103,ITF,ITF6,18,Calabria,Calabria,1947131,2149764,110.41,1.17
3078,2021-05-27,CAL,17677,8743,8934,9771,7823,83,ITF,ITF6,18,Calabria,Calabria,1947131,2167441,111.31,0.91
3079,2021-08-01,CAL,4895,2562,2333,1172,3699,24,ITF,ITF6,18,Calabria,Calabria,1947131,2172336,111.57,0.25
3080,2021-03-23,CAL,5268,2470,2798,3420,1824,24,ITF,ITF6,18,Calabria,Calabria,1947131,2177604,111.84,0.27
3081,2021-08-27,CAL,9166,4773,4393,3613,5393,160,ITF,ITF6,18,Calabria,Calabria,1947131,2186770,112.31,0.47
3082,2021-07-15,CAL,18283,8809,9474,2519,15711,53,ITF,ITF6,18,Calabria,Calabria,1947131,2205053,113.25,0.94
3083,2021-02-15,CAL,1184,568,616,1014,165,5,ITF,ITF6,18,Calabria,Calabria,1947131,2206237,113.31,0.06
3084,2021-09-14,CAL,6547,3224,3323,2523,3895,129,ITF,ITF6,18,Calabria,Calabria,1947131,2212784,113.64,0.34
3085,2020-12-27,CAL,317,169,148,317,0,0,ITF,ITF6,18,Calabria,Calabria,1947131,2213101,113.66,0.02
3086,2021-04-06,CAL,8188,3730,4458,4464,3687,37,ITF,ITF6,18,Calabria,Calabria,1947131,2221289,114.08,0.42
3087,2021-02-08,CAL,1880,748,1132,667,1210,3,ITF,ITF6,18,Calabria,Calabria,1947131,2223169,114.18,0.1
3088,2021-04-24,CAL,19309,9608,9701,15756,3463,90,ITF,ITF6,18,Calabria,Calabria,1947131,2242478,115.17,0.99
3089,2021-02-26,CAL,3171,1685,1486,2692,464,15,ITF,ITF6,18,Calabria,Calabria,1947131,2245649,115.33,0.16
3090,2021-08-02,CAL,15081,7538,7543,3725,11298,58,ITF,ITF6,18,Calabria,Calabria,1947131,2260730,116.11,0.77
3091,2021-06-20,CAL,6651,3150,3501,3815,2808,28,ITF,ITF6,18,Calabria,Calabria,1947131,2267381,116.45,0.34
3092,2021-06-06,CAL,13812,6641,7171,12016,1725,71,ITF,ITF6,18,Calabria,Calabria,1947131,2281193,117.16,0.71
3093,2021-01-07,CAL,2226,1091,1135,2222,0,4,ITF,ITF6,18,Calabria,Calabria,1947131,2283419,117.27,0.11
3094,2021-06-13,CAL,6862,3367,3495,5729,1077,56,ITF,ITF6,18,Calabria,Calabria,1947131,2290281,117.62,0.35
3095,2021-04-17,CAL,10865,5078,5787,9027,1787,51,ITF,ITF6,18,Calabria,Calabria,1947131,2301146,118.18,0.56
3096,2021-05-01,CAL,16752,7981,8771,12399,4261,92,ITF,ITF6,18,Calabria,Calabria,1947131,2317898,119.04,0.86
3097,2021-03-05,CAL,6244,3624,2620,5649,579,16,ITF,ITF6,18,Calabria,Calabria,1947131,2324142,119.36,0.32
3098,2021-08-09,CAL,13176,6715,6461,4642,8371,163,ITF,ITF6,18,Calabria,Calabria,1947131,2337318,120.04,0.68
3099,2021-07-26,CAL,18797,9339,9458,5215,13489,93,ITF,ITF6,18,Calabria,Calabria,1947131,2356115,121.0,0.97
3100,2021-03-12,CAL,5162,2473,2689,4075,1065,22,ITF,ITF6,18,Calabria,Calabria,1947131,2361277,121.27,0.27
3101,2021-01-14,CAL,2677,1272,1405,2671,0,6,ITF,ITF6,18,Calabria,Calabria,1947131,2363954,121.41,0.14
3102,2021-01-21,CAL,984,461,523,946,35,3,ITF,ITF6,18,Calabria,Calabria,1947131,2364938,121.46,0.05
3103,2021-08-20,CAL,7567,3821,3746,3018,4458,91,ITF,ITF6,18,Calabria,Calabria,1947131,2372505,121.85,0.39
3104,2021-02-11,SAR,1322,490,832,1207,115,0,ITG,ITG2,20,Sardegna,Sardegna,1639591,1322,0.08,0.08
3105,2021-09-10,SAR,10289,5472,4817,2647,7472,170,ITG,ITG2,20,Sardegna,Sardegna,1639591,11611,0.71,0.63
3106,2021-09-01,SAR,8245,4308,3937,3115,5040,90,ITG,ITG2,20,Sardegna,Sardegna,1639591,19856,1.21,0.5
3107,2021-05-24,SAR,14491,7259,7232,8360,5999,132,ITG,ITG2,20,Sardegna,Sardegna,1639591,34347,2.09,0.88
3108,2021-02-13,SAR,1458,563,895,1452,2,4,ITG,ITG2,20,Sardegna,Sardegna,1639591,35805,2.18,0.09
3109,2021-08-27,SAR,8385,4495,3890,4909,3334,142,ITG,ITG2,20,Sardegna,Sardegna,1639591,44190,2.7,0.51
3110,2021-05-19,SAR,17080,8682,8398,12630,4279,171,ITG,ITG2,20,Sardegna,Sardegna,1639591,61270,3.74,1.04
3111,2021-06-05,SAR,17889,8442,9447,11286,6468,135,ITG,ITG2,20,Sardegna,Sardegna,1639591,79159,4.83,1.09
3112,2021-02-25,SAR,2940,1275,1665,2297,608,35,ITG,ITG2,20,Sardegna,Sardegna,1639591,82099,5.01,0.18
3113,2021-03-14,SAR,613,379,234,602,1,10,ITG,ITG2,20,Sardegna,Sardegna,1639591,82712,5.04,0.04
3114,2021-04-09,SAR,12484,5528,6956,7935,4402,147,ITG,ITG2,20,Sardegna,Sardegna,1639591,95196,5.81,0.76
3115,2021-07-20,SAR,16150,7931,8219,3653,12406,91,ITG,ITG2,20,Sardegna,Sardegna,1639591,111346,6.79,0.99
3116,2021-04-11,SAR,5416,2450,2966,4263,1124,29,ITG,ITG2,20,Sardegna,Sardegna,1639591,116762,7.12,0.33
3117,2021-09-15,SAR,4905,2687,2218,939,3916,50,ITG,ITG2,20,Sardegna,Sardegna,1639591,121667,7.42,0.3
3118,2021-06-07,SAR,12567,6145,6422,9437,3007,123,ITG,ITG2,20,Sardegna,Sardegna,1639591,134234,8.19,0.77
3119,2021-01-16,SAR,1498,530,968,1498,0,0,ITG,ITG2,20,Sardegna,Sardegna,1639591,135732,8.28,0.09
3120,2021-08-15,SAR,19,10,9,9,10,0,ITG,ITG2,20,Sardegna,Sardegna,1639591,135751,8.28,0.0
3121,2021-08-01,SAR,3055,1502,1553,1031,1988,36,ITG,ITG2,20,Sardegna,Sardegna,1639591,138806,8.47,0.19
3122,2021-04-23,SAR,13066,5791,7275,7361,5556,149,ITG,ITG2,20,Sardegna,Sardegna,1639591,151872,9.26,0.8
3123,2021-05-10,SAR,9949,4416,5533,7210,2560,179,ITG,ITG2,20,Sardegna,Sardegna,1639591,161821,9.87,0.61
3124,2021-01-30,SAR,3946,1426,2520,368,3578,0,ITG,ITG2,20,Sardegna,Sardegna,1639591,165767,10.11,0.24
3125,2021-06-19,SAR,15347,7515,7832,9118,6130,99,ITG,ITG2,20,Sardegna,Sardegna,1639591,181114,11.05,0.94
3126,2021-07-06,SAR,15935,7722,8213,4660,11175,100,ITG,ITG2,20,Sardegna,Sardegna,1639591,197049,12.02,0.97
3127,2021-03-28,SAR,4631,1829,2802,4476,79,76,ITG,ITG2,20,Sardegna,Sardegna,1639591,201680,12.3,0.28
3128,2021-01-04,SAR,609,230,379,609,0,0,ITG,ITG2,20,Sardegna,Sardegna,1639591,202289,12.34,0.04
3129,2021-03-09,SAR,5562,2754,2808,4757,732,73,ITG,ITG2,20,Sardegna,Sardegna,1639591,207851,12.68,0.34
3130,2021-08-13,SAR,9951,5419,4532,6314,3518,119,ITG,ITG2,20,Sardegna,Sardegna,1639591,217802,13.28,0.61
3131,2021-05-05,SAR,10282,4678,5604,8009,2062,211,ITG,ITG2,20,Sardegna,Sardegna,1639591,228084,13.91,0.63
3132,2021-07-01,SAR,19835,9765,10070,7256,12484,95,ITG,ITG2,20,Sardegna,Sardegna,1639591,247919,15.12,1.21
3133,2021-03-23,SAR,6501,2905,3596,5229,1089,183,ITG,ITG2,20,Sardegna,Sardegna,1639591,254420,15.52,0.4
3134,2021-07-15,SAR,18779,9236,9543,4646,14031,102,ITG,ITG2,20,Sardegna,Sardegna,1639591,273199,16.66,1.15
3135,2021-05-29,SAR,18031,8658,9373,13249,4612,170,ITG,ITG2,20,Sardegna,Sardegna,1639591,291230,17.76,1.1
3136,2021-02-18,SAR,1898,738,1160,1794,64,40,ITG,ITG2,20,Sardegna,Sardegna,1639591,293128,17.88,0.12
3137,2021-09-08,SAR,12254,6567,5687,3187,8925,142,ITG,ITG2,20,Sardegna,Sardegna,1639591,305382,18.63,0.75
3138,2021-05-31,SAR,11372,5409,5963,8162,3112,98,ITG,ITG2,20,Sardegna,Sardegna,1639591,316754,19.32,0.69
3139,2021-07-27,SAR,16535,8385,8150,4216,12208,111,ITG,ITG2,20,Sardegna,Sardegna,1639591,333289,20.33,1.01
3140,2021-04-18,SAR,5155,2237,2918,2239,2886,30,ITG,ITG2,20,Sardegna,Sardegna,1639591,338444,20.64,0.31
3141,2021-04-30,SAR,11316,5344,5972,6823,4301,192,ITG,ITG2,20,Sardegna,Sardegna,1639591,349760,21.33,0.69
3142,2021-05-17,SAR,12843,6268,6575,9139,3554,150,ITG,ITG2,20,Sardegna,Sardegna,1639591,362603,22.12,0.78
3143,2021-02-06,SAR,1983,706,1277,566,1414,3,ITG,ITG2,20,Sardegna,Sardegna,1639591,364586,22.24,0.12
3144,2021-02-23,SAR,1577,1050,527,1278,282,17,ITG,ITG2,20,Sardegna,Sardegna,1639591,366163,22.33,0.1
3145,2021-02-04,SAR,2302,825,1477,915,1384,3,ITG,ITG2,20,Sardegna,Sardegna,1639591,368465,22.47,0.14
3146,2021-04-02,SAR,9331,3624,5707,5926,3252,153,ITG,ITG2,20,Sardegna,Sardegna,1639591,377796,23.04,0.57
3147,2021-07-13,SAR,17809,8524,9285,3252,14479,78,ITG,ITG2,20,Sardegna,Sardegna,1639591,395605,24.13,1.09
3148,2021-04-04,SAR,2,1,1,0,2,0,ITG,ITG2,20,Sardegna,Sardegna,1639591,395607,24.13,0.0
3149,2021-08-08,SAR,1884,979,905,1020,841,23,ITG,ITG2,20,Sardegna,Sardegna,1639591,397491,24.24,0.11
3150,2021-06-26,SAR,19164,9013,10151,5451,13635,78,ITG,ITG2,20,Sardegna,Sardegna,1639591,416655,25.41,1.17
3151,2021-08-22,SAR,1162,650,512,403,756,3,ITG,ITG2,20,Sardegna,Sardegna,1639591,417817,25.48,0.07
3152,2021-06-12,SAR,14755,7194,7561,9935,4702,118,ITG,ITG2,20,Sardegna,Sardegna,1639591,432572,26.38,0.9
3153,2021-03-04,SAR,4393,2313,2080,3067,1260,66,ITG,ITG2,20,Sardegna,Sardegna,1639591,436965,26.65,0.27
3154,2021-03-21,SAR,4054,1815,2239,2586,1441,27,ITG,ITG2,20,Sardegna,Sardegna,1639591,441019,26.9,0.25
3155,2021-03-02,SAR,3062,1636,1426,1824,1162,76,ITG,ITG2,20,Sardegna,Sardegna,1639591,444081,27.08,0.19
3156,2021-04-28,SAR,9126,4309,4817,5213,3761,152,ITG,ITG2,20,Sardegna,Sardegna,1639591,453207,27.64,0.56
3157,2021-01-18,SAR,911,328,583,782,129,0,ITG,ITG2,20,Sardegna,Sardegna,1639591,454118,27.7,0.06
3158,2021-06-24,SAR,19202,9214,9988,8111,10985,106,ITG,ITG2,20,Sardegna,Sardegna,1639591,473320,28.87,1.17
3159,2021-03-16,SAR,4447,1967,2480,3472,930,45,ITG,ITG2,20,Sardegna,Sardegna,1639591,477767,29.14,0.27
3160,2021-07-08,SAR,18445,8972,9473,3832,14528,85,ITG,ITG2,20,Sardegna,Sardegna,1639591,496212,30.26,1.12
3161,2021-07-25,SAR,4343,2142,2201,862,3466,15,ITG,ITG2,20,Sardegna,Sardegna,1639591,500555,30.53,0.26
3162,2021-04-16,SAR,14605,6530,8075,9004,5422,179,ITG,ITG2,20,Sardegna,Sardegna,1639591,515160,31.42,0.89
3163,2021-01-23,SAR,61,23,38,0,61,0,ITG,ITG2,20,Sardegna,Sardegna,1639591,515221,31.42,0.0
3164,2021-08-03,SAR,14575,7509,7066,7514,6863,198,ITG,ITG2,20,Sardegna,Sardegna,1639591,529796,32.31,0.89
3165,2021-08-20,SAR,10175,5355,4820,4794,5231,150,ITG,ITG2,20,Sardegna,Sardegna,1639591,539971,32.93,0.62
3166,2021-05-12,SAR,11226,5282,5944,7861,3154,211,ITG,ITG2,20,Sardegna,Sardegna,1639591,551197,33.62,0.68
3167,2021-09-03,SAR,8717,4701,4016,3079,5544,94,ITG,ITG2,20,Sardegna,Sardegna,1639591,559914,34.15,0.53
3168,2020-12-28,SAR,69,27,42,69,0,0,ITG,ITG2,20,Sardegna,Sardegna,1639591,559983,34.15,0.0
3169,2021-01-08,SAR,3353,1238,2115,3351,0,2,ITG,ITG2,20,Sardegna,Sardegna,1639591,563336,34.36,0.2
3170,2021-06-02,SAR,9786,4692,5094,8060,1640,86,ITG,ITG2,20,Sardegna,Sardegna,1639591,573122,34.96,0.6
3171,2021-07-29,SAR,17895,9042,8853,6524,11205,166,ITG,ITG2,20,Sardegna,Sardegna,1639591,591017,36.05,1.09
3172,2021-04-20,SAR,11197,5066,6131,7797,3297,103,ITG,ITG2,20,Sardegna,Sardegna,1639591,602214,36.73,0.68
3173,2021-07-24,SAR,12385,6386,5999,1993,10363,29,ITG,ITG2,20,Sardegna,Sardegna,1639591,614599,37.48,0.76
3174,2021-08-10,SAR,14245,7511,6734,6255,7828,162,ITG,ITG2,20,Sardegna,Sardegna,1639591,628844,38.35,0.87
3175,2021-05-02,SAR,6075,2727,3348,5296,676,103,ITG,ITG2,20,Sardegna,Sardegna,1639591,634919,38.72,0.37
3176,2021-02-08,SAR,1477,536,941,859,617,1,ITG,ITG2,20,Sardegna,Sardegna,1639591,636396,38.81,0.09
3177,2021-08-12,SAR,12481,6614,5867,6626,5687,168,ITG,ITG2,20,Sardegna,Sardegna,1639591,648877,39.58,0.76
3178,2021-06-16,SAR,17639,8278,9361,12166,5312,161,ITG,ITG2,20,Sardegna,Sardegna,1639591,666516,40.65,1.08
3179,2021-01-01,SAR,33,17,16,33,0,0,ITG,ITG2,20,Sardegna,Sardegna,1639591,666549,40.65,0.0
3180,2021-01-13,SAR,579,182,397,579,0,0,ITG,ITG2,20,Sardegna,Sardegna,1639591,667128,40.69,0.04
3181,2021-05-07,SAR,14607,6666,7941,9787,4558,262,ITG,ITG2,20,Sardegna,Sardegna,1639591,681735,41.58,0.89
3182,2021-01-27,SAR,1436,506,930,78,1358,0,ITG,ITG2,20,Sardegna,Sardegna,1639591,683171,41.67,0.09
3183,2021-07-03,SAR,15845,7563,8282,3234,12577,34,ITG,ITG2,20,Sardegna,Sardegna,1639591,699016,42.63,0.97
3184,2021-03-25,SAR,9279,4021,5258,7821,1309,149,ITG,ITG2,20,Sardegna,Sardegna,1639591,708295,43.2,0.57
3185,2021-08-29,SAR,467,250,217,355,98,14,ITG,ITG2,20,Sardegna,Sardegna,1639591,708762,43.23,0.03
3186,2021-05-21,SAR,22798,11233,11565,16385,6133,280,ITG,ITG2,20,Sardegna,Sardegna,1639591,731560,44.62,1.39
3187,2021-03-18,SAR,7318,3096,4222,5601,1640,77,ITG,ITG2,20,Sardegna,Sardegna,1639591,738878,45.06,0.45
3188,2021-05-14,SAR,14670,6894,7776,10818,3652,200,ITG,ITG2,20,Sardegna,Sardegna,1639591,753548,45.96,0.89
3189,2021-02-03,SAR,1122,419,703,426,695,1,ITG,ITG2,20,Sardegna,Sardegna,1639591,754670,46.03,0.07
3190,2021-07-10,SAR,14241,6888,7353,2704,11503,34,ITG,ITG2,20,Sardegna,Sardegna,1639591,768911,46.9,0.87
3191,2021-04-01,SAR,10295,4105,6190,7119,3024,152,ITG,ITG2,20,Sardegna,Sardegna,1639591,779206,47.52,0.63
3192,2021-08-05,SAR,15651,8231,7420,8688,6800,163,ITG,ITG2,20,Sardegna,Sardegna,1639591,794857,48.48,0.95
3193,2021-02-20,SAR,2044,856,1188,1683,337,24,ITG,ITG2,20,Sardegna,Sardegna,1639591,796901,48.6,0.12
3194,2021-02-22,SAR,1651,954,697,1391,234,26,ITG,ITG2,20,Sardegna,Sardegna,1639591,798552,48.7,0.1
3195,2021-03-11,SAR,6464,3110,3354,5171,1209,84,ITG,ITG2,20,Sardegna,Sardegna,1639591,805016,49.1,0.39
3196,2021-09-12,SAR,3234,1794,1440,622,2586,26,ITG,ITG2,20,Sardegna,Sardegna,1639591,808250,49.3,0.2
3197,2021-06-04,SAR,14519,6947,7572,9788,4571,160,ITG,ITG2,20,Sardegna,Sardegna,1639591,822769,50.18,0.89
3198,2021-06-21,SAR,14035,6738,7297,5124,8837,74,ITG,ITG2,20,Sardegna,Sardegna,1639591,836804,51.04,0.86
3199,2021-03-13,SAR,2774,1085,1689,2452,281,41,ITG,ITG2,20,Sardegna,Sardegna,1639591,839578,51.21,0.17
3200,2021-03-30,SAR,8925,3623,5302,6483,2286,156,ITG,ITG2,20,Sardegna,Sardegna,1639591,848503,51.75,0.54
3201,2021-01-06,SAR,1639,556,1083,1639,0,0,ITG,ITG2,20,Sardegna,Sardegna,1639591,850142,51.85,0.1
3202,2021-06-23,SAR,20549,9669,10880,6192,14264,93,ITG,ITG2,20,Sardegna,Sardegna,1639591,870691,53.1,1.25
3203,2021-06-14,SAR,13750,6644,7106,9791,3817,142,ITG,ITG2,20,Sardegna,Sardegna,1639591,884441,53.94,0.84
3204,2021-03-06,SAR,2950,1219,1731,1081,1795,74,ITG,ITG2,20,Sardegna,Sardegna,1639591,887391,54.12,0.18
3205,2021-06-28,SAR,14994,7041,7953,3049,11878,67,ITG,ITG2,20,Sardegna,Sardegna,1639591,902385,55.04,0.91
3206,2021-04-06,SAR,7578,3159,4419,5062,2438,78,ITG,ITG2,20,Sardegna,Sardegna,1639591,909963,55.5,0.46
3207,2020-12-27,SAR,68,37,31,68,0,0,ITG,ITG2,20,Sardegna,Sardegna,1639591,910031,55.5,0.0
3208,2021-07-17,SAR,12871,6301,6570,3178,9626,67,ITG,ITG2,20,Sardegna,Sardegna,1639591,922902,56.29,0.79
3209,2021-07-31,SAR,10321,5458,4863,5276,4963,82,ITG,ITG2,20,Sardegna,Sardegna,1639591,933223,56.92,0.63
3210,2021-08-19,SAR,10762,5689,5073,5732,4897,133,ITG,ITG2,20,Sardegna,Sardegna,1639591,943985,57.57,0.66
3211,2021-02-27,SAR,1930,646,1284,1326,561,43,ITG,ITG2,20,Sardegna,Sardegna,1639591,945915,57.69,0.12
3212,2021-07-22,SAR,18338,9268,9070,4508,13721,109,ITG,ITG2,20,Sardegna,Sardegna,1639591,964253,58.81,1.12
3213,2021-04-13,SAR,7706,3624,4082,5786,1854,66,ITG,ITG2,20,Sardegna,Sardegna,1639591,971959,59.28,0.47
3214,2021-06-09,SAR,15474,7369,8105,11575,3748,151,ITG,ITG2,20,Sardegna,Sardegna,1639591,987433,60.22,0.94
3215,2021-01-20,SAR,215,78,137,213,2,0,ITG,ITG2,20,Sardegna,Sardegna,1639591,987648,60.24,0.01
3216,2021-03-29,SAR,4861,1887,2974,4169,595,97,ITG,ITG2,20,Sardegna,Sardegna,1639591,992509,60.53,0.3
3217,2021-04-15,SAR,11959,5576,6383,6817,5021,121,ITG,ITG2,20,Sardegna,Sardegna,1639591,1004468,61.26,0.73
3218,2021-01-05,SAR,1358,458,900,1358,0,0,ITG,ITG2,20,Sardegna,Sardegna,1639591,1005826,61.35,0.08
3219,2021-01-22,SAR,84,47,37,56,28,0,ITG,ITG2,20,Sardegna,Sardegna,1639591,1005910,61.35,0.01
3220,2021-07-26,SAR,14608,7289,7319,4121,10410,77,ITG,ITG2,20,Sardegna,Sardegna,1639591,1020518,62.24,0.89
3221,2021-04-17,SAR,10182,4528,5654,5421,4673,88,ITG,ITG2,20,Sardegna,Sardegna,1639591,1030700,62.86,0.62
3222,2021-09-02,SAR,10325,5548,4777,3967,6246,112,ITG,ITG2,20,Sardegna,Sardegna,1639591,1041025,63.49,0.63
3223,2021-07-21,SAR,19392,9500,9892,3907,15401,84,ITG,ITG2,20,Sardegna,Sardegna,1639591,1060417,64.68,1.18
3224,2021-02-10,SAR,1976,775,1201,1444,526,6,ITG,ITG2,20,Sardegna,Sardegna,1639591,1062393,64.8,0.12
3225,2021-09-09,SAR,11712,6261,5451,2228,9345,139,ITG,ITG2,20,Sardegna,Sardegna,1639591,1074105,65.51,0.71
3226,2021-08-07,SAR,8215,4310,3905,5442,2705,68,ITG,ITG2,20,Sardegna,Sardegna,1639591,1082320,66.01,0.5
3227,2021-04-29,SAR,11276,5133,6143,6684,4431,161,ITG,ITG2,20,Sardegna,Sardegna,1639591,1093596,66.7,0.69
3228,2021-06-25,SAR,16515,7812,8703,3898,12559,58,ITG,ITG2,20,Sardegna,Sardegna,1639591,1110111,67.71,1.01
3229,2021-01-10,SAR,2220,762,1458,2219,0,1,ITG,ITG2,20,Sardegna,Sardegna,1639591,1112331,67.84,0.14
3230,2021-08-09,SAR,13418,6974,6444,6477,6795,146,ITG,ITG2,20,Sardegna,Sardegna,1639591,1125749,68.66,0.82
3231,2021-08-26,SAR,9429,4999,4430,5353,3949,127,ITG,ITG2,20,Sardegna,Sardegna,1639591,1135178,69.24,0.58
3232,2021-04-25,SAR,4538,2284,2254,3704,784,50,ITG,ITG2,20,Sardegna,Sardegna,1639591,1139716,69.51,0.28
3233,2021-01-15,SAR,1575,575,1000,1573,0,2,ITG,ITG2,20,Sardegna,Sardegna,1639591,1141291,69.61,0.1
3234,2021-08-17,SAR,10608,5535,5073,6093,4389,126,ITG,ITG2,20,Sardegna,Sardegna,1639591,1151899,70.26,0.65
3235,2021-02-01,SAR,1555,620,935,226,1329,0,ITG,ITG2,20,Sardegna,Sardegna,1639591,1153454,70.35,0.09
3236,2021-05-09,SAR,6181,2888,3293,5162,926,93,ITG,ITG2,20,Sardegna,Sardegna,1639591,1159635,70.73,0.38
3237,2021-05-26,SAR,15551,8197,7354,9708,5661,182,ITG,ITG2,20,Sardegna,Sardegna,1639591,1175186,71.68,0.95
3238,2021-02-15,SAR,962,349,613,923,31,8,ITG,ITG2,20,Sardegna,Sardegna,1639591,1176148,71.73,0.06
3239,2021-03-20,SAR,5223,2080,3143,2909,2286,28,ITG,ITG2,20,Sardegna,Sardegna,1639591,1181371,72.05,0.32
3240,2021-09-04,SAR,5114,2803,2311,1554,3512,48,ITG,ITG2,20,Sardegna,Sardegna,1639591,1186485,72.36,0.31
3241,2021-06-13,SAR,9502,4678,4824,6162,3260,80,ITG,ITG2,20,Sardegna,Sardegna,1639591,1195987,72.94,0.58
3242,2021-09-05,SAR,664,370,294,133,525,6,ITG,ITG2,20,Sardegna,Sardegna,1639591,1196651,72.98,0.04
3243,2021-05-28,SAR,18013,8716,9297,13527,4297,189,ITG,ITG2,20,Sardegna,Sardegna,1639591,1214664,74.08,1.1
3244,2021-02-17,SAR,1417,582,835,1279,74,64,ITG,ITG2,20,Sardegna,Sardegna,1639591,1216081,74.17,0.09
3245,2021-05-25,SAR,15158,7705,7453,8496,6487,175,ITG,ITG2,20,Sardegna,Sardegna,1639591,1231239,75.09,0.92
3246,2021-06-11,SAR,14784,7025,7759,9089,5539,156,ITG,ITG2,20,Sardegna,Sardegna,1639591,1246023,76.0,0.9
3247,2021-03-03,SAR,4140,2295,1845,2747,1306,87,ITG,ITG2,20,Sardegna,Sardegna,1639591,1250163,76.25,0.25
3248,2021-06-30,SAR,17772,8514,9258,4804,12886,82,ITG,ITG2,20,Sardegna,Sardegna,1639591,1267935,77.33,1.08
3249,2021-03-22,SAR,3744,1517,2227,3132,526,86,ITG,ITG2,20,Sardegna,Sardegna,1639591,1271679,77.56,0.23
3250,2021-04-08,SAR,13608,5971,7637,8333,5154,121,ITG,ITG2,20,Sardegna,Sardegna,1639591,1285287,78.39,0.83
3251,2021-07-14,SAR,16914,8192,8722,3774,13029,111,ITG,ITG2,20,Sardegna,Sardegna,1639591,1302201,79.42,1.03
3252,2020-12-29,SAR,57,32,25,57,0,0,ITG,ITG2,20,Sardegna,Sardegna,1639591,1302258,79.43,0.0
3253,2021-04-22,SAR,10629,4686,5943,5542,4993,94,ITG,ITG2,20,Sardegna,Sardegna,1639591,1312887,80.07,0.65
3254,2021-01-12,SAR,890,417,473,890,0,0,ITG,ITG2,20,Sardegna,Sardegna,1639591,1313777,80.13,0.05
3255,2021-05-18,SAR,14787,7386,7401,9419,5226,142,ITG,ITG2,20,Sardegna,Sardegna,1639591,1328564,81.03,0.9
3256,2021-02-24,SAR,2448,1310,1138,2211,195,42,ITG,ITG2,20,Sardegna,Sardegna,1639591,1331012,81.18,0.15
3257,2021-08-28,SAR,4163,2395,1768,2853,1251,59,ITG,ITG2,20,Sardegna,Sardegna,1639591,1335175,81.43,0.25
3258,2021-09-14,SAR,10521,5674,4847,1910,8476,135,ITG,ITG2,20,Sardegna,Sardegna,1639591,1345696,82.08,0.64
3259,2021-06-06,SAR,10037,5001,5036,6314,3654,69,ITG,ITG2,20,Sardegna,Sardegna,1639591,1355733,82.69,0.61
3260,2021-01-03,SAR,90,36,54,90,0,0,ITG,ITG2,20,Sardegna,Sardegna,1639591,1355823,82.69,0.01
3261,2021-07-07,SAR,15909,7729,8180,4084,11772,53,ITG,ITG2,20,Sardegna,Sardegna,1639591,1371732,83.66,0.97
3262,2021-08-21,SAR,5622,3055,2567,3638,1894,90,ITG,ITG2,20,Sardegna,Sardegna,1639591,1377354,84.01,0.34
3263,2021-03-08,SAR,4734,2464,2270,3455,1226,53,ITG,ITG2,20,Sardegna,Sardegna,1639591,1382088,84.29,0.29
3264,2021-04-12,SAR,7060,3203,3857,5256,1728,76,ITG,ITG2,20,Sardegna,Sardegna,1639591,1389148,84.73,0.43
3265,2021-01-02,SAR,61,22,39,61,0,0,ITG,ITG2,20,Sardegna,Sardegna,1639591,1389209,84.73,0.0
3266,2021-06-08,SAR,14838,7072,7766,11169,3512,157,ITG,ITG2,20,Sardegna,Sardegna,1639591,1404047,85.63,0.9
3267,2021-02-28,SAR,368,169,199,139,227,2,ITG,ITG2,20,Sardegna,Sardegna,1639591,1404415,85.66,0.02
3268,2021-08-04,SAR,16218,8528,7690,9601,6352,265,ITG,ITG2,20,Sardegna,Sardegna,1639591,1420633,86.65,0.99
3269,2021-04-26,SAR,6948,3297,3651,5921,927,100,ITG,ITG2,20,Sardegna,Sardegna,1639591,1427581,87.07,0.42
3270,2021-07-02,SAR,18944,8892,10052,4404,14441,99,ITG,ITG2,20,Sardegna,Sardegna,1639591,1446525,88.22,1.16
3271,2021-04-27,SAR,7757,3591,4166,5573,2072,112,ITG,ITG2,20,Sardegna,Sardegna,1639591,1454282,88.7,0.47
3272,2021-01-17,SAR,867,278,589,866,1,0,ITG,ITG2,20,Sardegna,Sardegna,1639591,1455149,88.75,0.05
3273,2021-03-15,SAR,2828,1328,1500,2409,377,42,ITG,ITG2,20,Sardegna,Sardegna,1639591,1457977,88.92,0.17
3274,2021-07-04,SAR,8207,3988,4219,2067,6125,15,ITG,ITG2,20,Sardegna,Sardegna,1639591,1466184,89.42,0.5
3275,2021-03-26,SAR,8635,3550,5085,6963,1532,140,ITG,ITG2,20,Sardegna,Sardegna,1639591,1474819,89.95,0.53
3276,2021-08-30,SAR,8752,4669,4083,4835,3760,157,ITG,ITG2,20,Sardegna,Sardegna,1639591,1483571,90.48,0.53
3277,2021-05-22,SAR,25071,12013,13058,19586,5181,304,ITG,ITG2,20,Sardegna,Sardegna,1639591,1508642,92.01,1.53
3278,2021-01-19,SAR,751,271,480,695,55,1,ITG,ITG2,20,Sardegna,Sardegna,1639591,1509393,92.06,0.05
3279,2021-03-17,SAR,6628,2870,3758,4957,1633,38,ITG,ITG2,20,Sardegna,Sardegna,1639591,1516021,92.46,0.4
3280,2021-06-27,SAR,9020,4311,4709,2957,6035,28,ITG,ITG2,20,Sardegna,Sardegna,1639591,1525041,93.01,0.55
3281,2021-01-29,SAR,3046,1119,1927,45,2999,2,ITG,ITG2,20,Sardegna,Sardegna,1639591,1528087,93.2,0.19
3282,2021-08-02,SAR,13118,6602,6516,6209,6730,179,ITG,ITG2,20,Sardegna,Sardegna,1639591,1541205,94.0,0.8
3283,2021-01-28,SAR,3038,1084,1954,68,2970,0,ITG,ITG2,20,Sardegna,Sardegna,1639591,1544243,94.18,0.19
3284,2021-05-11,SAR,9112,4247,4865,6453,2521,138,ITG,ITG2,20,Sardegna,Sardegna,1639591,1553355,94.74,0.56
3285,2021-01-31,SAR,2154,765,1389,45,2109,0,ITG,ITG2,20,Sardegna,Sardegna,1639591,1555509,94.87,0.13
3286,2021-02-14,SAR,542,263,279,540,2,0,ITG,ITG2,20,Sardegna,Sardegna,1639591,1556051,94.9,0.03
3287,2021-07-18,SAR,5693,2874,2819,982,4701,10,ITG,ITG2,20,Sardegna,Sardegna,1639591,1561744,95.25,0.35
3288,2021-08-18,SAR,10693,5533,5160,5707,4856,130,ITG,ITG2,20,Sardegna,Sardegna,1639591,1572437,95.9,0.65
3289,2021-07-23,SAR,15761,7788,7973,3405,12278,78,ITG,ITG2,20,Sardegna,Sardegna,1639591,1588198,96.87,0.96
3290,2021-04-14,SAR,8369,3928,4441,7029,1276,64,ITG,ITG2,20,Sardegna,Sardegna,1639591,1596567,97.38,0.51
3291,2021-06-01,SAR,14328,6659,7669,9637,4595,96,ITG,ITG2,20,Sardegna,Sardegna,1639591,1610895,98.25,0.87
3292,2021-02-21,SAR,1589,709,880,1558,30,1,ITG,ITG2,20,Sardegna,Sardegna,1639591,1612484,98.35,0.1
3293,2021-07-28,SAR,16797,8622,8175,6318,10331,148,ITG,ITG2,20,Sardegna,Sardegna,1639591,1629281,99.37,1.02
3294,2021-04-19,SAR,10259,4647,5612,8662,1451,146,ITG,ITG2,20,Sardegna,Sardegna,1639591,1639540,100.0,0.63
3295,2021-01-09,SAR,4087,1443,2644,4087,0,0,ITG,ITG2,20,Sardegna,Sardegna,1639591,1643627,100.25,0.25
3296,2021-06-15,SAR,14690,6808,7882,9812,4742,136,ITG,ITG2,20,Sardegna,Sardegna,1639591,1658317,101.14,0.9
3297,2021-03-07,SAR,1663,752,911,1114,545,4,ITG,ITG2,20,Sardegna,Sardegna,1639591,1659980,101.24,0.1
3298,2021-03-24,SAR,7505,3134,4371,5994,1360,151,ITG,ITG2,20,Sardegna,Sardegna,1639591,1667485,101.7,0.46
3299,2021-05-01,SAR,10012,4798,5214,5423,4486,103,ITG,ITG2,20,Sardegna,Sardegna,1639591,1677497,102.31,0.61
3300,2021-01-21,SAR,140,69,71,98,42,0,ITG,ITG2,20,Sardegna,Sardegna,1639591,1677637,102.32,0.01
3301,2021-02-07,SAR,1128,397,731,228,899,1,ITG,ITG2,20,Sardegna,Sardegna,1639591,1678765,102.39,0.07
3302,2021-08-11,SAR,11927,6361,5566,6147,5600,180,ITG,ITG2,20,Sardegna,Sardegna,1639591,1690692,103.12,0.73
3303,2021-05-03,SAR,8337,3855,4482,6602,1623,112,ITG,ITG2,20,Sardegna,Sardegna,1639591,1699029,103.63,0.51
3304,2021-05-20,SAR,16416,7896,8520,11295,4913,208,ITG,ITG2,20,Sardegna,Sardegna,1639591,1715445,104.63,1.0
3305,2021-02-09,SAR,2299,840,1459,1290,1004,5,ITG,ITG2,20,Sardegna,Sardegna,1639591,1717744,104.77,0.14
3306,2021-02-26,SAR,2834,1117,1717,2473,308,53,ITG,ITG2,20,Sardegna,Sardegna,1639591,1720578,104.94,0.17
3307,2021-09-13,SAR,10455,5637,4818,2469,7875,111,ITG,ITG2,20,Sardegna,Sardegna,1639591,1731033,105.58,0.64
3308,2021-06-22,SAR,19342,8991,10351,7164,12077,101,ITG,ITG2,20,Sardegna,Sardegna,1639591,1750375,106.76,1.18
3309,2021-07-09,SAR,15884,7601,8283,3431,12370,83,ITG,ITG2,20,Sardegna,Sardegna,1639591,1766259,107.73,0.97
3310,2021-03-31,SAR,10635,4234,6401,8065,2438,132,ITG,ITG2,20,Sardegna,Sardegna,1639591,1776894,108.37,0.65
3311,2021-08-25,SAR,10063,5290,4773,4241,5711,111,ITG,ITG2,20,Sardegna,Sardegna,1639591,1786957,108.99,0.61
3312,2021-09-11,SAR,6501,3466,3035,1212,5254,35,ITG,ITG2,20,Sardegna,Sardegna,1639591,1793458,109.38,0.4
3313,2021-06-03,SAR,16400,7645,8755,10566,5693,141,ITG,ITG2,20,Sardegna,Sardegna,1639591,1809858,110.38,1.0
3314,2021-06-20,SAR,6295,2807,3488,3635,2628,32,ITG,ITG2,20,Sardegna,Sardegna,1639591,1816153,110.77,0.38
3315,2021-05-27,SAR,17862,9268,8594,12109,5544,209,ITG,ITG2,20,Sardegna,Sardegna,1639591,1834015,111.86,1.09
3316,2021-02-16,SAR,703,291,412,667,27,9,ITG,ITG2,20,Sardegna,Sardegna,1639591,1834718,111.9,0.04
3317,2021-03-05,SAR,5235,2622,2613,2822,2372,41,ITG,ITG2,20,Sardegna,Sardegna,1639591,1839953,112.22,0.32
3318,2021-04-05,SAR,2093,798,1295,2048,1,44,ITG,ITG2,20,Sardegna,Sardegna,1639591,1842046,112.35,0.13
3319,2021-09-06,SAR,9286,4875,4411,2548,6624,114,ITG,ITG2,20,Sardegna,Sardegna,1639591,1851332,112.91,0.57
3320,2021-06-29,SAR,17900,8609,9291,3759,14092,49,ITG,ITG2,20,Sardegna,Sardegna,1639591,1869232,114.01,1.09
3321,2021-05-04,SAR,9683,4428,5255,7623,1905,155,ITG,ITG2,20,Sardegna,Sardegna,1639591,1878915,114.6,0.59
3322,2021-01-24,SAR,91,35,56,5,86,0,ITG,ITG2,20,Sardegna,Sardegna,1639591,1879006,114.6,0.01
3323,2021-06-18,SAR,16491,7509,8982,8603,7772,116,ITG,ITG2,20,Sardegna,Sardegna,1639591,1895497,115.61,1.01
3324,2021-03-10,SAR,6082,2965,3117,5147,856,79,ITG,ITG2,20,Sardegna,Sardegna,1639591,1901579,115.98,0.37
3325,2021-08-14,SAR,1794,1025,769,990,794,10,ITG,ITG2,20,Sardegna,Sardegna,1639591,1903373,116.09,0.11
3326,2021-05-06,SAR,13177,6066,7111,9734,3193,250,ITG,ITG2,20,Sardegna,Sardegna,1639591,1916550,116.89,0.8
3327,2021-03-01,SAR,2296,1167,1129,1598,667,31,ITG,ITG2,20,Sardegna,Sardegna,1639591,1918846,117.03,0.14
3328,2021-03-19,SAR,7324,3064,4260,5017,2244,63,ITG,ITG2,20,Sardegna,Sardegna,1639591,1926170,117.48,0.45
3329,2021-07-16,SAR,16935,8476,8459,4552,12248,135,ITG,ITG2,20,Sardegna,Sardegna,1639591,1943105,118.51,1.03
3330,2021-04-07,SAR,13731,6105,7626,7907,5739,85,ITG,ITG2,20,Sardegna,Sardegna,1639591,1956836,119.35,0.84
3331,2021-04-24,SAR,10554,4907,5647,7960,2454,140,ITG,ITG2,20,Sardegna,Sardegna,1639591,1967390,119.99,0.64
3332,2021-01-14,SAR,1128,433,695,1128,0,0,ITG,ITG2,20,Sardegna,Sardegna,1639591,1968518,120.06,0.07
3333,2021-03-12,SAR,6024,2635,3389,4553,1318,153,ITG,ITG2,20,Sardegna,Sardegna,1639591,1974542,120.43,0.37
3334,2021-05-13,SAR,12452,5874,6578,8769,3469,214,ITG,ITG2,20,Sardegna,Sardegna,1639591,1986994,121.19,0.76
3335,2021-02-02,SAR,1534,681,853,258,1276,0,ITG,ITG2,20,Sardegna,Sardegna,1639591,1988528,121.28,0.09
3336,2021-08-23,SAR,10523,5567,4956,5636,4710,177,ITG,ITG2,20,Sardegna,Sardegna,1639591,1999051,121.92,0.64
3337,2021-05-15,SAR,13878,6444,7434,10242,3444,192,ITG,ITG2,20,Sardegna,Sardegna,1639591,2012929,122.77,0.85
3338,2021-07-11,SAR,6380,3119,3261,1424,4920,36,ITG,ITG2,20,Sardegna,Sardegna,1639591,2019309,123.16,0.39
3339,2021-01-26,SAR,1381,474,907,27,1354,0,ITG,ITG2,20,Sardegna,Sardegna,1639591,2020690,123.24,0.08
3340,2021-08-16,SAR,8462,4412,4050,4551,3795,116,ITG,ITG2,20,Sardegna,Sardegna,1639591,2029152,123.76,0.52
3341,2021-05-08,SAR,13213,6000,7213,10755,2289,169,ITG,ITG2,20,Sardegna,Sardegna,1639591,2042365,124.57,0.81
3342,2021-04-21,SAR,12181,5579,6602,6478,5599,104,ITG,ITG2,20,Sardegna,Sardegna,1639591,2054546,125.31,0.74
3343,2021-01-11,SAR,1219,522,697,1218,0,1,ITG,ITG2,20,Sardegna,Sardegna,1639591,2055765,125.38,0.07
3344,2021-06-17,SAR,18468,8531,9937,9920,8427,121,ITG,ITG2,20,Sardegna,Sardegna,1639591,2074233,126.51,1.13
3345,2021-01-25,SAR,612,228,384,23,589,0,ITG,ITG2,20,Sardegna,Sardegna,1639591,2074845,126.55,0.04
3346,2021-08-24,SAR,10105,5404,4701,4813,5137,155,ITG,ITG2,20,Sardegna,Sardegna,1639591,2084950,127.16,0.62
3347,2021-05-16,SAR,8253,3838,4415,6003,2162,88,ITG,ITG2,20,Sardegna,Sardegna,1639591,2093203,127.67,0.5
3348,2021-07-12,SAR,15335,7414,7921,2400,12877,58,ITG,ITG2,20,Sardegna,Sardegna,1639591,2108538,128.6,0.94
3349,2021-09-07,SAR,9563,5084,4479,2541,6903,119,ITG,ITG2,20,Sardegna,Sardegna,1639591,2118101,129.18,0.58
3350,2021-07-05,SAR,15584,7571,8013,3327,12208,49,ITG,ITG2,20,Sardegna,Sardegna,1639591,2133685,130.14,0.95
3351,2021-08-31,SAR,9296,4957,4339,4750,4387,159,ITG,ITG2,20,Sardegna,Sardegna,1639591,2142981,130.7,0.57
3352,2021-02-05,SAR,1923,757,1166,435,1486,2,ITG,ITG2,20,Sardegna,Sardegna,1639591,2144904,130.82,0.12
3353,2021-04-03,SAR,4728,1824,2904,2671,1986,71,ITG,ITG2,20,Sardegna,Sardegna,1639591,2149632,131.11,0.29
3354,2021-05-30,SAR,9746,4842,4904,7312,2366,68,ITG,ITG2,20,Sardegna,Sardegna,1639591,2159378,131.7,0.59
3355,2021-02-19,SAR,1521,477,1044,1416,56,49,ITG,ITG2,20,Sardegna,Sardegna,1639591,2160899,131.8,0.09
3356,2021-03-27,SAR,5832,2217,3615,5310,423,99,ITG,ITG2,20,Sardegna,Sardegna,1639591,2166731,132.15,0.36
3357,2021-05-23,SAR,10036,4817,5219,7685,2255,96,ITG,ITG2,20,Sardegna,Sardegna,1639591,2176767,132.76,0.61
3358,2021-02-12,SAR,2249,938,1311,2183,60,6,ITG,ITG2,20,Sardegna,Sardegna,1639591,2179016,132.9,0.14
3359,2021-07-19,SAR,15230,7630,7600,2796,12383,51,ITG,ITG2,20,Sardegna,Sardegna,1639591,2194246,133.83,0.93
3360,2021-04-10,SAR,10603,4785,5818,8533,1962,108,ITG,ITG2,20,Sardegna,Sardegna,1639591,2204849,134.48,0.65
3361,2021-01-07,SAR,3170,1110,2060,3166,0,4,ITG,ITG2,20,Sardegna,Sardegna,1639591,2208019,134.67,0.19
3362,2021-06-10,SAR,17816,8479,9337,11644,6046,126,ITG,ITG2,20,Sardegna,Sardegna,1639591,2225835,135.76,1.09
3363,2021-08-06,SAR,13830,7180,6650,7995,5661,174,ITG,ITG2,20,Sardegna,Sardegna,1639591,2239665,136.6,0.84
3364,2020-12-31,SAR,41,22,19,41,0,0,ITG,ITG2,20,Sardegna,Sardegna,1639591,2239706,136.6,0.0
3365,2021-07-30,SAR,15205,7858,7347,6621,8417,167,ITG,ITG2,20,Sardegna,Sardegna,1639591,2254911,137.53,0.93
3366,2021-07-27,VEN,42278,22195,20083,11798,30044,436,ITH,ITH3,5,Veneto,Veneto,4905854,42278,0.86,0.86
3367,2021-08-01,VEN,27915,14943,12972,11051,16354,510,ITH,ITH3,5,Veneto,Veneto,4905854,70193,1.43,0.57
3368,2021-04-23,VEN,31321,13862,17459,21443,8711,1167,ITH,ITH3,5,Veneto,Veneto,4905854,101514,2.07,0.64
3369,2021-05-17,VEN,26553,13002,13551,15649,10079,825,ITH,ITH3,5,Veneto,Veneto,4905854,128067,2.61,0.54
3370,2021-02-06,VEN,4099,1354,2745,708,3391,0,ITH,ITH3,5,Veneto,Veneto,4905854,132166,2.69,0.08
3371,2021-08-25,VEN,20075,10888,9187,8033,11463,579,ITH,ITH3,5,Veneto,Veneto,4905854,152241,3.1,0.41
3372,2021-02-23,VEN,7384,3253,4131,7028,270,86,ITH,ITH3,5,Veneto,Veneto,4905854,159625,3.25,0.15
3373,2021-07-18,VEN,37722,19763,17959,3847,33625,250,ITH,ITH3,5,Veneto,Veneto,4905854,197347,4.02,0.77
3374,2021-02-25,VEN,7904,3345,4559,7158,607,139,ITH,ITH3,5,Veneto,Veneto,4905854,205251,4.18,0.16
3375,2021-04-09,VEN,31206,13768,17438,21913,8350,943,ITH,ITH3,5,Veneto,Veneto,4905854,236457,4.82,0.64
3376,2021-09-13,VEN,25501,14169,11332,3123,22072,306,ITH,ITH3,5,Veneto,Veneto,4905854,261958,5.34,0.52
3377,2021-06-05,VEN,46888,24153,22735,37325,8105,1458,ITH,ITH3,5,Veneto,Veneto,4905854,308846,6.3,0.96
3378,2021-08-13,VEN,24467,13835,10632,18329,5367,771,ITH,ITH3,5,Veneto,Veneto,4905854,333313,6.79,0.5
3379,2021-08-27,VEN,26675,14276,12399,8223,17876,576,ITH,ITH3,5,Veneto,Veneto,4905854,359988,7.34,0.54
3380,2021-05-05,VEN,44418,21283,23135,36224,6563,1631,ITH,ITH3,5,Veneto,Veneto,4905854,404406,8.24,0.91
3381,2021-07-01,VEN,51015,26056,24959,20694,29311,1010,ITH,ITH3,5,Veneto,Veneto,4905854,455421,9.28,1.04
3382,2021-01-11,VEN,7244,2102,5142,7243,0,1,ITH,ITH3,5,Veneto,Veneto,4905854,462665,9.43,0.15
3383,2021-04-21,VEN,32409,13205,19204,15565,16066,778,ITH,ITH3,5,Veneto,Veneto,4905854,495074,10.09,0.66
3384,2021-05-22,VEN,34845,16711,18134,12720,21453,672,ITH,ITH3,5,Veneto,Veneto,4905854,529919,10.8,0.71
3385,2021-02-11,VEN,4015,1238,2777,3349,628,38,ITH,ITH3,5,Veneto,Veneto,4905854,533934,10.88,0.08
3386,2021-01-28,VEN,9216,2666,6550,169,9045,2,ITH,ITH3,5,Veneto,Veneto,4905854,543150,11.07,0.19
3387,2021-06-17,VEN,51787,25945,25842,25568,25068,1151,ITH,ITH3,5,Veneto,Veneto,4905854,594937,12.13,1.06
3388,2021-03-09,VEN,16566,7459,9107,9828,6338,400,ITH,ITH3,5,Veneto,Veneto,4905854,611503,12.46,0.34
3389,2021-09-08,VEN,27868,14711,13157,5292,21774,802,ITH,ITH3,5,Veneto,Veneto,4905854,639371,13.03,0.57
3390,2021-05-31,VEN,31655,16246,15409,20886,9936,833,ITH,ITH3,5,Veneto,Veneto,4905854,671026,13.68,0.65
3391,2021-03-26,VEN,29619,13164,16455,23281,5469,869,ITH,ITH3,5,Veneto,Veneto,4905854,700645,14.28,0.6
3392,2021-01-23,VEN,4057,1250,2807,31,4026,0,ITH,ITH3,5,Veneto,Veneto,4905854,704702,14.36,0.08
3393,2021-06-29,VEN,45588,22740,22848,19050,25848,690,ITH,ITH3,5,Veneto,Veneto,4905854,750290,15.29,0.93
3394,2021-03-21,VEN,11992,4756,7236,8286,3466,240,ITH,ITH3,5,Veneto,Veneto,4905854,762282,15.54,0.24
3395,2021-01-16,VEN,4612,1542,3070,4612,0,0,ITH,ITH3,5,Veneto,Veneto,4905854,766894,15.63,0.09
3396,2021-07-13,VEN,43577,22615,20962,5421,37846,310,ITH,ITH3,5,Veneto,Veneto,4905854,810471,16.52,0.89
3397,2021-04-04,VEN,7790,3535,4255,6514,1148,128,ITH,ITH3,5,Veneto,Veneto,4905854,818261,16.68,0.16
3398,2021-02-16,VEN,6644,2870,3774,6439,176,29,ITH,ITH3,5,Veneto,Veneto,4905854,824905,16.81,0.14
3399,2021-05-29,VEN,33068,16702,16366,24244,7702,1122,ITH,ITH3,5,Veneto,Veneto,4905854,857973,17.49,0.67
3400,2021-02-18,VEN,5833,2456,3377,5730,64,39,ITH,ITH3,5,Veneto,Veneto,4905854,863806,17.61,0.12
3401,2021-07-25,VEN,33204,17545,15659,10851,21888,465,ITH,ITH3,5,Veneto,Veneto,4905854,897010,18.28,0.68
3402,2021-04-16,VEN,24473,10505,13968,11894,11895,684,ITH,ITH3,5,Veneto,Veneto,4905854,921483,18.78,0.5
3403,2021-08-06,VEN,38353,20936,17417,19886,17598,869,ITH,ITH3,5,Veneto,Veneto,4905854,959836,19.57,0.78
3404,2021-04-28,VEN,32466,15198,17268,22250,9024,1192,ITH,ITH3,5,Veneto,Veneto,4905854,992302,20.23,0.66
3405,2021-07-20,VEN,44379,23691,20688,6878,36992,509,ITH,ITH3,5,Veneto,Veneto,4905854,1036681,21.13,0.9
3406,2021-01-18,VEN,2766,778,1988,2560,201,5,ITH,ITH3,5,Veneto,Veneto,4905854,1039447,21.19,0.06
3407,2021-02-04,VEN,7398,2030,5368,550,6847,1,ITH,ITH3,5,Veneto,Veneto,4905854,1046845,21.34,0.15
3408,2021-08-08,VEN,20536,11405,9131,10686,9542,308,ITH,ITH3,5,Veneto,Veneto,4905854,1067381,21.76,0.42
3409,2021-09-15,VEN,8428,4523,3905,1334,6942,152,ITH,ITH3,5,Veneto,Veneto,4905854,1075809,21.93,0.17
3410,2021-06-12,VEN,48708,24505,24203,36402,10834,1472,ITH,ITH3,5,Veneto,Veneto,4905854,1124517,22.92,0.99
3411,2021-05-12,VEN,37014,17921,19093,30258,5128,1628,ITH,ITH3,5,Veneto,Veneto,4905854,1161531,23.68,0.75
3412,2021-07-08,VEN,46733,24317,22416,4505,41926,302,ITH,ITH3,5,Veneto,Veneto,4905854,1208264,24.63,0.95
3413,2021-06-24,VEN,56229,28480,27749,17632,37906,691,ITH,ITH3,5,Veneto,Veneto,4905854,1264493,25.78,1.15
3414,2021-03-16,VEN,12538,5358,7180,6633,5626,279,ITH,ITH3,5,Veneto,Veneto,4905854,1277031,26.03,0.26
3415,2021-08-20,VEN,19467,10545,8922,11304,7582,581,ITH,ITH3,5,Veneto,Veneto,4905854,1296498,26.43,0.4
3416,2021-03-02,VEN,11498,4628,6870,7935,3312,251,ITH,ITH3,5,Veneto,Veneto,4905854,1307996,26.66,0.23
3417,2021-06-10,VEN,52417,27046,25371,41326,9383,1708,ITH,ITH3,5,Veneto,Veneto,4905854,1360413,27.73,1.07
3418,2021-04-02,VEN,24122,10635,13487,17147,6332,643,ITH,ITH3,5,Veneto,Veneto,4905854,1384535,28.22,0.49
3419,2021-03-14,VEN,15187,5945,9242,13843,894,450,ITH,ITH3,5,Veneto,Veneto,4905854,1399722,28.53,0.31
3420,2021-05-10,VEN,36523,17088,19435,25420,9856,1247,ITH,ITH3,5,Veneto,Veneto,4905854,1436245,29.28,0.74
3421,2021-01-30,VEN,8769,2684,6085,690,8079,0,ITH,ITH3,5,Veneto,Veneto,4905854,1445014,29.45,0.18
3422,2021-03-07,VEN,4495,1769,2726,3862,561,72,ITH,ITH3,5,Veneto,Veneto,4905854,1449509,29.55,0.09
3423,2021-03-28,VEN,31315,13610,17705,26882,3615,818,ITH,ITH3,5,Veneto,Veneto,4905854,1480824,30.18,0.64
3424,2021-06-19,VEN,49307,25084,24223,25676,22599,1032,ITH,ITH3,5,Veneto,Veneto,4905854,1530131,31.19,1.01
3425,2021-07-06,VEN,36156,18628,17528,13206,22314,636,ITH,ITH3,5,Veneto,Veneto,4905854,1566287,31.93,0.74
3426,2021-04-14,VEN,15947,6917,9030,8769,6634,544,ITH,ITH3,5,Veneto,Veneto,4905854,1582234,32.25,0.33
3427,2021-01-04,VEN,6741,2037,4704,6739,0,2,ITH,ITH3,5,Veneto,Veneto,4905854,1588975,32.39,0.14
3428,2021-09-01,VEN,21028,10759,10269,7629,12645,754,ITH,ITH3,5,Veneto,Veneto,4905854,1610003,32.82,0.43
3429,2021-05-24,VEN,33094,16435,16659,7631,25054,409,ITH,ITH3,5,Veneto,Veneto,4905854,1643097,33.49,0.67
3430,2021-08-15,VEN,3106,1763,1343,2617,426,63,ITH,ITH3,5,Veneto,Veneto,4905854,1646203,33.56,0.06
3431,2021-01-09,VEN,7937,2539,5398,7932,0,5,ITH,ITH3,5,Veneto,Veneto,4905854,1654140,33.72,0.16
3432,2021-08-05,VEN,39260,21450,17810,15719,22936,605,ITH,ITH3,5,Veneto,Veneto,4905854,1693400,34.52,0.8
3433,2021-04-18,VEN,17531,7262,10269,9506,7567,458,ITH,ITH3,5,Veneto,Veneto,4905854,1710931,34.88,0.36
3434,2021-01-08,VEN,9416,2837,6579,9402,0,14,ITH,ITH3,5,Veneto,Veneto,4905854,1720347,35.07,0.19
3435,2021-04-30,VEN,50268,23621,26647,33162,15674,1432,ITH,ITH3,5,Veneto,Veneto,4905854,1770615,36.09,1.02
3436,2021-01-20,VEN,1039,368,671,387,652,0,ITH,ITH3,5,Veneto,Veneto,4905854,1771654,36.11,0.02
3437,2021-05-02,VEN,37247,17266,19981,25604,10331,1312,ITH,ITH3,5,Veneto,Veneto,4905854,1808901,36.87,0.76
3438,2021-06-14,VEN,42634,21563,21071,26297,15321,1016,ITH,ITH3,5,Veneto,Veneto,4905854,1851535,37.74,0.87
3439,2021-03-06,VEN,10687,4357,6330,7216,3280,191,ITH,ITH3,5,Veneto,Veneto,4905854,1862222,37.96,0.22
3440,2021-08-10,VEN,28509,15642,12867,16426,11478,605,ITH,ITH3,5,Veneto,Veneto,4905854,1890731,38.54,0.58
3441,2020-12-30,VEN,699,245,454,699,0,0,ITH,ITH3,5,Veneto,Veneto,4905854,1891430,38.55,0.01
3442,2021-09-03,VEN,32069,17166,14903,7545,23726,798,ITH,ITH3,5,Veneto,Veneto,4905854,1923499,39.21,0.65
3443,2021-06-09,VEN,42840,21972,20868,33779,7506,1555,ITH,ITH3,5,Veneto,Veneto,4905854,1966339,40.08,0.87
3444,2021-06-28,VEN,47675,24128,23547,18421,28549,705,ITH,ITH3,5,Veneto,Veneto,4905854,2014014,41.05,0.97
3445,2021-01-25,VEN,6471,2077,4394,156,6315,0,ITH,ITH3,5,Veneto,Veneto,4905854,2020485,41.19,0.13
3446,2021-07-29,VEN,47548,25137,22411,20158,26542,848,ITH,ITH3,5,Veneto,Veneto,4905854,2068033,42.15,0.97
3447,2021-03-23,VEN,22240,10253,11987,16879,4718,643,ITH,ITH3,5,Veneto,Veneto,4905854,2090273,42.61,0.45
3448,2021-05-19,VEN,33162,15186,17976,16226,15995,941,ITH,ITH3,5,Veneto,Veneto,4905854,2123435,43.28,0.68
3449,2021-02-08,VEN,5007,1559,3448,1923,3078,6,ITH,ITH3,5,Veneto,Veneto,4905854,2128442,43.39,0.1
3450,2021-04-06,VEN,29033,13367,15666,23258,5046,729,ITH,ITH3,5,Veneto,Veneto,4905854,2157475,43.98,0.59
3451,2021-02-01,VEN,8564,2502,6062,157,8407,0,ITH,ITH3,5,Veneto,Veneto,4905854,2166039,44.15,0.17
3452,2021-02-15,VEN,4392,1827,2565,4143,240,9,ITH,ITH3,5,Veneto,Veneto,4905854,2170431,44.24,0.09
3453,2021-03-30,VEN,36008,15318,20690,29732,5252,1024,ITH,ITH3,5,Veneto,Veneto,4905854,2206439,44.98,0.73
3454,2021-01-13,VEN,5989,1606,4383,5986,0,3,ITH,ITH3,5,Veneto,Veneto,4905854,2212428,45.1,0.12
3455,2021-08-03,VEN,40739,21562,19177,17594,22428,717,ITH,ITH3,5,Veneto,Veneto,4905854,2253167,45.93,0.83
3456,2021-04-25,VEN,18336,8155,10181,12901,4836,599,ITH,ITH3,5,Veneto,Veneto,4905854,2271503,46.3,0.37
3457,2021-06-21,VEN,44341,22193,22148,20461,22972,908,ITH,ITH3,5,Veneto,Veneto,4905854,2315844,47.21,0.9
3458,2021-01-06,VEN,8142,2391,5751,8139,0,3,ITH,ITH3,5,Veneto,Veneto,4905854,2323986,47.37,0.17
3459,2021-08-22,VEN,9254,5048,4206,5874,3106,274,ITH,ITH3,5,Veneto,Veneto,4905854,2333240,47.56,0.19
3460,2021-05-14,VEN,46836,22278,24558,24288,20960,1588,ITH,ITH3,5,Veneto,Veneto,4905854,2380076,48.52,0.95
3461,2021-02-20,VEN,6433,2019,4414,6277,75,81,ITH,ITH3,5,Veneto,Veneto,4905854,2386509,48.65,0.13
3462,2021-06-02,VEN,20318,10239,10079,15347,4347,624,ITH,ITH3,5,Veneto,Veneto,4905854,2406827,49.06,0.41
3463,2021-08-24,VEN,19898,10609,9289,8906,10461,531,ITH,ITH3,5,Veneto,Veneto,4905854,2426725,49.47,0.41
3464,2021-09-10,VEN,28163,15522,12641,4320,23413,430,ITH,ITH3,5,Veneto,Veneto,4905854,2454888,50.04,0.57
3465,2021-03-11,VEN,19838,8893,10945,13795,5576,467,ITH,ITH3,5,Veneto,Veneto,4905854,2474726,50.44,0.4
3466,2021-03-18,VEN,12626,5145,7481,7037,5236,353,ITH,ITH3,5,Veneto,Veneto,4905854,2487352,50.7,0.26
3467,2021-06-26,VEN,48091,24518,23573,13593,34006,492,ITH,ITH3,5,Veneto,Veneto,4905854,2535443,51.68,0.98
3468,2021-07-15,VEN,51447,26924,24523,6027,45040,380,ITH,ITH3,5,Veneto,Veneto,4905854,2586890,52.73,1.05
3469,2021-04-20,VEN,22470,9510,12960,7881,14012,577,ITH,ITH3,5,Veneto,Veneto,4905854,2609360,53.19,0.46
3470,2021-08-17,VEN,19264,10463,8801,11210,7594,460,ITH,ITH3,5,Veneto,Veneto,4905854,2628624,53.58,0.39
3471,2021-05-09,VEN,35091,16145,18946,23789,10055,1247,ITH,ITH3,5,Veneto,Veneto,4905854,2663715,54.3,0.72
3472,2021-08-12,VEN,24168,13083,11085,17298,6165,705,ITH,ITH3,5,Veneto,Veneto,4905854,2687883,54.79,0.49
3473,2021-06-07,VEN,44708,23325,21383,36176,7043,1489,ITH,ITH3,5,Veneto,Veneto,4905854,2732591,55.7,0.91
3474,2021-02-27,VEN,8994,2693,6301,7963,849,182,ITH,ITH3,5,Veneto,Veneto,4905854,2741585,55.88,0.18
3475,2021-03-04,VEN,12990,4890,8100,9119,3479,392,ITH,ITH3,5,Veneto,Veneto,4905854,2754575,56.15,0.26
3476,2021-07-03,VEN,38708,20120,18588,11030,27103,575,ITH,ITH3,5,Veneto,Veneto,4905854,2793283,56.94,0.79
3477,2021-06-16,VEN,47796,23580,24216,25252,21446,1098,ITH,ITH3,5,Veneto,Veneto,4905854,2841079,57.91,0.97
3478,2021-01-01,VEN,1528,471,1057,1527,0,1,ITH,ITH3,5,Veneto,Veneto,4905854,2842607,57.94,0.03
3479,2021-03-25,VEN,25977,11064,14913,18970,6105,902,ITH,ITH3,5,Veneto,Veneto,4905854,2868584,58.47,0.53
3480,2021-04-11,VEN,21015,8878,12137,14228,6299,488,ITH,ITH3,5,Veneto,Veneto,4905854,2889599,58.9,0.43
3481,2021-07-22,VEN,48400,25128,23272,13313,34435,652,ITH,ITH3,5,Veneto,Veneto,4905854,2937999,59.89,0.99
3482,2021-04-13,VEN,14043,6331,7712,8054,5483,506,ITH,ITH3,5,Veneto,Veneto,4905854,2952042,60.17,0.29
3483,2021-07-05,VEN,39143,20285,18858,14146,24197,800,ITH,ITH3,5,Veneto,Veneto,4905854,2991185,60.97,0.8
3484,2021-01-03,VEN,5157,1562,3595,5157,0,0,ITH,ITH3,5,Veneto,Veneto,4905854,2996342,61.08,0.11
3485,2021-03-08,VEN,13644,6282,7362,9302,4078,264,ITH,ITH3,5,Veneto,Veneto,4905854,3009986,61.35,0.28
3486,2021-08-02,VEN,40106,21039,19067,16311,23167,628,ITH,ITH3,5,Veneto,Veneto,4905854,3050092,62.17,0.82
3487,2021-04-10,VEN,27485,11989,15496,18375,8474,636,ITH,ITH3,5,Veneto,Veneto,4905854,3077577,62.73,0.56
3488,2021-09-14,VEN,21581,11770,9811,3139,18158,284,ITH,ITH3,5,Veneto,Veneto,4905854,3099158,63.17,0.44
3489,2021-06-06,VEN,37452,19174,18278,31494,4731,1227,ITH,ITH3,5,Veneto,Veneto,4905854,3136610,63.94,0.76
3490,2020-12-27,VEN,880,395,485,880,0,0,ITH,ITH3,5,Veneto,Veneto,4905854,3137490,63.95,0.02
3491,2021-09-07,VEN,26521,14126,12395,5550,20244,727,ITH,ITH3,5,Veneto,Veneto,4905854,3164011,64.49,0.54
3492,2021-06-23,VEN,49372,24460,24912,14552,34021,799,ITH,ITH3,5,Veneto,Veneto,4905854,3213383,65.5,1.01
3493,2021-03-15,VEN,16672,7330,9342,10954,5212,506,ITH,ITH3,5,Veneto,Veneto,4905854,3230055,65.84,0.34
3494,2021-04-27,VEN,28213,12798,15415,20132,6916,1165,ITH,ITH3,5,Veneto,Veneto,4905854,3258268,66.42,0.58
3495,2021-01-17,VEN,1933,781,1152,1584,349,0,ITH,ITH3,5,Veneto,Veneto,4905854,3260201,66.46,0.04
3496,2021-02-03,VEN,5955,1672,4283,474,5477,4,ITH,ITH3,5,Veneto,Veneto,4905854,3266156,66.58,0.12
3497,2021-08-07,VEN,28952,16293,12659,16342,12068,542,ITH,ITH3,5,Veneto,Veneto,4905854,3295108,67.17,0.59
3498,2021-04-29,VEN,50334,23414,26920,35403,13185,1746,ITH,ITH3,5,Veneto,Veneto,4905854,3345442,68.19,1.03
3499,2021-07-21,VEN,43282,22341,20941,8696,34088,498,ITH,ITH3,5,Veneto,Veneto,4905854,3388724,69.08,0.88
3500,2021-02-05,VEN,8391,2541,5850,1407,6975,9,ITH,ITH3,5,Veneto,Veneto,4905854,3397115,69.25,0.17
3501,2021-02-22,VEN,7019,3044,3975,6581,391,47,ITH,ITH3,5,Veneto,Veneto,4905854,3404134,69.39,0.14
3502,2021-05-07,VEN,48655,23313,25342,37608,8683,2364,ITH,ITH3,5,Veneto,Veneto,4905854,3452789,70.38,0.99
3503,2021-01-27,VEN,7149,2069,5080,239,6909,1,ITH,ITH3,5,Veneto,Veneto,4905854,3459938,70.53,0.15
3504,2021-02-13,VEN,3267,1473,1794,3231,20,16,ITH,ITH3,5,Veneto,Veneto,4905854,3463205,70.59,0.07
3505,2021-09-02,VEN,22721,12132,10589,6097,15828,796,ITH,ITH3,5,Veneto,Veneto,4905854,3485926,71.06,0.46
3506,2021-03-03,VEN,12102,4648,7454,8389,3502,211,ITH,ITH3,5,Veneto,Veneto,4905854,3498028,71.3,0.25
3507,2021-06-11,VEN,47320,24619,22701,34708,11183,1429,ITH,ITH3,5,Veneto,Veneto,4905854,3545348,72.27,0.96
3508,2021-06-25,VEN,51725,26169,25556,15077,36007,641,ITH,ITH3,5,Veneto,Veneto,4905854,3597073,73.32,1.05
3509,2021-05-26,VEN,31171,15237,15934,13991,16499,681,ITH,ITH3,5,Veneto,Veneto,4905854,3628244,73.96,0.64
3510,2021-08-31,VEN,19792,10461,9331,6986,12206,600,ITH,ITH3,5,Veneto,Veneto,4905854,3648036,74.36,0.4
3511,2021-03-01,VEN,9395,3717,5678,7410,1822,163,ITH,ITH3,5,Veneto,Veneto,4905854,3657431,74.55,0.19
3512,2021-07-12,VEN,43248,22783,20465,4014,38912,322,ITH,ITH3,5,Veneto,Veneto,4905854,3700679,75.43,0.88
3513,2021-04-03,VEN,21996,9647,12349,13868,7722,406,ITH,ITH3,5,Veneto,Veneto,4905854,3722675,75.88,0.45
3514,2021-03-20,VEN,13035,5393,7642,10657,2082,296,ITH,ITH3,5,Veneto,Veneto,4905854,3735710,76.15,0.27
3515,2021-01-10,VEN,5036,1673,3363,5035,0,1,ITH,ITH3,5,Veneto,Veneto,4905854,3740746,76.25,0.1
3516,2021-05-16,VEN,28422,14015,14407,20316,7081,1025,ITH,ITH3,5,Veneto,Veneto,4905854,3769168,76.83,0.58
3517,2021-08-09,VEN,34779,18648,16131,17149,16862,768,ITH,ITH3,5,Veneto,Veneto,4905854,3803947,77.54,0.71
3518,2021-08-26,VEN,22331,11897,10434,8326,13395,610,ITH,ITH3,5,Veneto,Veneto,4905854,3826278,77.99,0.46
3519,2021-06-18,VEN,53663,26782,26881,23982,28638,1043,ITH,ITH3,5,Veneto,Veneto,4905854,3879941,79.09,1.09
3520,2021-09-09,VEN,30016,16589,13427,4308,25283,425,ITH,ITH3,5,Veneto,Veneto,4905854,3909957,79.7,0.61
3521,2021-03-27,VEN,32093,14018,18075,25376,5807,910,ITH,ITH3,5,Veneto,Veneto,4905854,3942050,80.35,0.65
3522,2021-09-11,VEN,20843,11690,9153,3028,17482,333,ITH,ITH3,5,Veneto,Veneto,4905854,3962893,80.78,0.42
3523,2021-07-07,VEN,40988,21324,19664,15642,24546,800,ITH,ITH3,5,Veneto,Veneto,4905854,4003881,81.61,0.84
3524,2021-08-19,VEN,19569,10669,8900,12232,6807,530,ITH,ITH3,5,Veneto,Veneto,4905854,4023450,82.01,0.4
3525,2021-05-11,VEN,33209,16521,16688,27154,4729,1326,ITH,ITH3,5,Veneto,Veneto,4905854,4056659,82.69,0.68
3526,2021-01-22,VEN,1080,332,748,25,1055,0,ITH,ITH3,5,Veneto,Veneto,4905854,4057739,82.71,0.02
3527,2021-05-30,VEN,22551,11273,11278,15206,6691,654,ITH,ITH3,5,Veneto,Veneto,4905854,4080290,83.17,0.46
3528,2021-07-26,VEN,43649,22947,20702,17000,26016,633,ITH,ITH3,5,Veneto,Veneto,4905854,4123939,84.06,0.89
3529,2021-07-19,VEN,44750,23571,21179,7963,36391,396,ITH,ITH3,5,Veneto,Veneto,4905854,4168689,84.97,0.91
3530,2021-02-26,VEN,8297,3273,5024,6942,1260,95,ITH,ITH3,5,Veneto,Veneto,4905854,4176986,85.14,0.17
3531,2021-04-24,VEN,24769,10831,13938,14965,9080,724,ITH,ITH3,5,Veneto,Veneto,4905854,4201755,85.65,0.5
3532,2021-01-14,VEN,7066,1927,5139,7049,0,17,ITH,ITH3,5,Veneto,Veneto,4905854,4208821,85.79,0.14
3533,2021-03-12,VEN,18665,8196,10469,11330,6752,583,ITH,ITH3,5,Veneto,Veneto,4905854,4227486,86.17,0.38
3534,2021-05-18,VEN,27038,12552,14486,12631,13642,765,ITH,ITH3,5,Veneto,Veneto,4905854,4254524,86.72,0.55
3535,2021-06-30,VEN,45824,23106,22718,17874,27201,749,ITH,ITH3,5,Veneto,Veneto,4905854,4300348,87.66,0.93
3536,2021-03-22,VEN,18157,8185,9972,12583,5050,524,ITH,ITH3,5,Veneto,Veneto,4905854,4318505,88.03,0.37
3537,2021-03-13,VEN,17242,7312,9930,13736,3132,374,ITH,ITH3,5,Veneto,Veneto,4905854,4335747,88.38,0.35
3538,2021-01-15,VEN,5880,1819,4061,5874,0,6,ITH,ITH3,5,Veneto,Veneto,4905854,4341627,88.5,0.12
3539,2021-08-28,VEN,20873,11592,9281,8643,11492,738,ITH,ITH3,5,Veneto,Veneto,4905854,4362500,88.92,0.43
3540,2021-05-20,VEN,44855,21264,23591,19366,24380,1109,ITH,ITH3,5,Veneto,Veneto,4905854,4407355,89.84,0.91
3541,2021-02-09,VEN,5250,1892,3358,3431,1806,13,ITH,ITH3,5,Veneto,Veneto,4905854,4412605,89.95,0.11
3542,2021-08-30,VEN,26924,14273,12651,7978,18326,620,ITH,ITH3,5,Veneto,Veneto,4905854,4439529,90.49,0.55
3543,2021-07-14,VEN,43640,22436,21204,5282,37961,397,ITH,ITH3,5,Veneto,Veneto,4905854,4483169,91.38,0.89
3544,2021-04-22,VEN,32079,13947,18132,15471,15781,827,ITH,ITH3,5,Veneto,Veneto,4905854,4515248,92.04,0.65
3545,2021-07-31,VEN,35180,18904,16276,17037,17502,641,ITH,ITH3,5,Veneto,Veneto,4905854,4550428,92.76,0.72
3546,2021-08-14,VEN,9918,5808,4110,7270,2400,248,ITH,ITH3,5,Veneto,Veneto,4905854,4560346,92.96,0.2
3547,2021-05-23,VEN,34492,16470,18022,10620,23400,472,ITH,ITH3,5,Veneto,Veneto,4905854,4594838,93.66,0.7
3548,2021-02-12,VEN,4314,1446,2868,3670,572,72,ITH,ITH3,5,Veneto,Veneto,4905854,4599152,93.75,0.09
3549,2021-01-29,VEN,9029,2789,6240,365,8664,0,ITH,ITH3,5,Veneto,Veneto,4905854,4608181,93.93,0.18
3550,2021-05-08,VEN,41532,18787,22745,28255,11838,1439,ITH,ITH3,5,Veneto,Veneto,4905854,4649713,94.78,0.85
3551,2021-07-30,VEN,45593,24249,21344,22632,22081,880,ITH,ITH3,5,Veneto,Veneto,4905854,4695306,95.71,0.93
3552,2021-08-16,VEN,19713,10670,9043,12965,6168,580,ITH,ITH3,5,Veneto,Veneto,4905854,4715019,96.11,0.4
3553,2020-12-31,VEN,3221,1042,2179,3221,0,0,ITH,ITH3,5,Veneto,Veneto,4905854,4718240,96.18,0.07
3554,2021-07-04,VEN,33886,17580,16306,14990,18289,607,ITH,ITH3,5,Veneto,Veneto,4905854,4752126,96.87,0.69
3555,2021-04-12,VEN,14920,6346,8574,6397,8219,304,ITH,ITH3,5,Veneto,Veneto,4905854,4767046,97.17,0.3
3556,2021-01-02,VEN,5744,1767,3977,5743,0,1,ITH,ITH3,5,Veneto,Veneto,4905854,4772790,97.29,0.12
3557,2021-04-17,VEN,22451,9099,13352,14372,7278,801,ITH,ITH3,5,Veneto,Veneto,4905854,4795241,97.75,0.46
3558,2021-01-07,VEN,8362,2317,6045,8361,0,1,ITH,ITH3,5,Veneto,Veneto,4905854,4803603,97.92,0.17
3559,2021-06-13,VEN,37346,19260,18086,29317,6958,1071,ITH,ITH3,5,Veneto,Veneto,4905854,4840949,98.68,0.76
3560,2021-01-21,VEN,2294,719,1575,19,2275,0,ITH,ITH3,5,Veneto,Veneto,4905854,4843243,98.72,0.05
3561,2021-03-05,VEN,13341,5023,8318,9222,3674,445,ITH,ITH3,5,Veneto,Veneto,4905854,4856584,99.0,0.27
3562,2021-09-04,VEN,23586,12885,10701,6051,16883,652,ITH,ITH3,5,Veneto,Veneto,4905854,4880170,99.48,0.48
3563,2021-05-27,VEN,46671,22926,23745,22365,23260,1046,ITH,ITH3,5,Veneto,Veneto,4905854,4926841,100.43,0.95
3564,2021-02-07,VEN,2316,863,1453,714,1601,1,ITH,ITH3,5,Veneto,Veneto,4905854,4929157,100.48,0.05
3565,2021-09-06,VEN,28302,15206,13096,5834,21785,683,ITH,ITH3,5,Veneto,Veneto,4905854,4957459,101.05,0.58
3566,2021-07-02,VEN,49570,25142,24428,16289,32497,784,ITH,ITH3,5,Veneto,Veneto,4905854,5007029,102.06,1.01
3567,2021-03-24,VEN,22126,9581,12545,14663,6806,657,ITH,ITH3,5,Veneto,Veneto,4905854,5029155,102.51,0.45
3568,2021-01-19,VEN,1313,475,838,1163,149,1,ITH,ITH3,5,Veneto,Veneto,4905854,5030468,102.54,0.03
3569,2021-07-23,VEN,44497,23460,21037,15138,28785,574,ITH,ITH3,5,Veneto,Veneto,4905854,5074965,103.45,0.91
3570,2021-05-01,VEN,38877,18252,20625,28708,8929,1240,ITH,ITH3,5,Veneto,Veneto,4905854,5113842,104.24,0.79
3571,2021-06-03,VEN,54537,28045,26492,40871,12007,1659,ITH,ITH3,5,Veneto,Veneto,4905854,5168379,105.35,1.11
3572,2021-06-20,VEN,41215,20068,21147,18925,21545,745,ITH,ITH3,5,Veneto,Veneto,4905854,5209594,106.19,0.84
3573,2021-02-19,VEN,7323,3141,4182,6995,204,124,ITH,ITH3,5,Veneto,Veneto,4905854,5216917,106.34,0.15
3574,2021-08-23,VEN,24523,13033,11490,10578,13234,711,ITH,ITH3,5,Veneto,Veneto,4905854,5241440,106.84,0.5
3575,2021-02-21,VEN,4640,1212,3428,4516,5,119,ITH,ITH3,5,Veneto,Veneto,4905854,5246080,106.94,0.09
3576,2021-05-15,VEN,36276,17520,18756,24818,10023,1435,ITH,ITH3,5,Veneto,Veneto,4905854,5282356,107.67,0.74
3577,2021-06-01,VEN,26997,13570,13427,15787,10561,649,ITH,ITH3,5,Veneto,Veneto,4905854,5309353,108.22,0.55
3578,2021-06-08,VEN,43860,22678,21182,36186,6153,1521,ITH,ITH3,5,Veneto,Veneto,4905854,5353213,109.12,0.89
3579,2021-05-25,VEN,27872,13454,14418,11274,16097,501,ITH,ITH3,5,Veneto,Veneto,4905854,5381085,109.69,0.57
3580,2021-02-14,VEN,126,56,70,113,13,0,ITH,ITH3,5,Veneto,Veneto,4905854,5381211,109.69,0.0
3581,2021-02-28,VEN,4136,1389,2747,3224,837,75,ITH,ITH3,5,Veneto,Veneto,4905854,5385347,109.77,0.08
3582,2021-03-17,VEN,14646,5991,8655,7526,6797,323,ITH,ITH3,5,Veneto,Veneto,4905854,5399993,110.07,0.3
3583,2021-06-27,VEN,40242,20557,19685,15347,24313,582,ITH,ITH3,5,Veneto,Veneto,4905854,5440235,110.89,0.82
3584,2021-03-19,VEN,13804,5672,8132,7402,6106,296,ITH,ITH3,5,Veneto,Veneto,4905854,5454039,111.17,0.28
3585,2021-08-21,VEN,12192,6879,5313,8287,3386,519,ITH,ITH3,5,Veneto,Veneto,4905854,5466231,111.42,0.25
3586,2021-05-04,VEN,43033,20383,22650,33353,8033,1647,ITH,ITH3,5,Veneto,Veneto,4905854,5509264,112.3,0.88
3587,2021-01-24,VEN,4117,1219,2898,28,4089,0,ITH,ITH3,5,Veneto,Veneto,4905854,5513381,112.38,0.08
3588,2021-07-28,VEN,40309,20927,19382,12061,27797,451,ITH,ITH3,5,Veneto,Veneto,4905854,5553690,113.21,0.82
3589,2021-01-12,VEN,5231,1517,3714,5223,0,8,ITH,ITH3,5,Veneto,Veneto,4905854,5558921,113.31,0.11
3590,2021-04-19,VEN,21559,8929,12630,4707,16421,431,ITH,ITH3,5,Veneto,Veneto,4905854,5580480,113.75,0.44
3591,2021-04-05,VEN,19165,8376,10789,13423,5439,303,ITH,ITH3,5,Veneto,Veneto,4905854,5599645,114.14,0.39
3592,2021-01-26,VEN,6927,2093,4834,149,6778,0,ITH,ITH3,5,Veneto,Veneto,4905854,5606572,114.28,0.14
3593,2021-05-06,VEN,47058,22067,24991,36579,8499,1980,ITH,ITH3,5,Veneto,Veneto,4905854,5653630,115.24,0.96
3594,2021-03-10,VEN,19044,8728,10316,12959,5686,399,ITH,ITH3,5,Veneto,Veneto,4905854,5672674,115.63,0.39
3595,2021-04-07,VEN,36066,16206,19860,27610,7341,1115,ITH,ITH3,5,Veneto,Veneto,4905854,5708740,116.37,0.74
3596,2021-07-16,VEN,44749,24074,20675,6957,37331,461,ITH,ITH3,5,Veneto,Veneto,4905854,5753489,117.28,0.91
3597,2021-01-31,VEN,4789,1566,3223,408,4381,0,ITH,ITH3,5,Veneto,Veneto,4905854,5758278,117.38,0.1
3598,2021-03-29,VEN,31480,13708,17772,26645,3830,1005,ITH,ITH3,5,Veneto,Veneto,4905854,5789758,118.02,0.64
3599,2021-05-13,VEN,44352,21887,22465,32585,9919,1848,ITH,ITH3,5,Veneto,Veneto,4905854,5834110,118.92,0.9
3600,2021-02-02,VEN,6515,1881,4634,396,6119,0,ITH,ITH3,5,Veneto,Veneto,4905854,5840625,119.05,0.13
3601,2021-07-09,VEN,45097,23786,21311,4126,40685,286,ITH,ITH3,5,Veneto,Veneto,4905854,5885722,119.97,0.92
3602,2021-03-31,VEN,38987,16463,22524,30428,7508,1051,ITH,ITH3,5,Veneto,Veneto,4905854,5924709,120.77,0.79
3603,2021-07-11,VEN,34239,17925,16314,3699,30284,256,ITH,ITH3,5,Veneto,Veneto,4905854,5958948,121.47,0.7
3604,2021-05-03,VEN,40712,19813,20899,32801,6439,1472,ITH,ITH3,5,Veneto,Veneto,4905854,5999660,122.3,0.83
3605,2021-05-28,VEN,46971,22979,23992,23675,22086,1210,ITH,ITH3,5,Veneto,Veneto,4905854,6046631,123.25,0.96
3606,2021-07-24,VEN,41712,22365,19347,13301,27774,637,ITH,ITH3,5,Veneto,Veneto,4905854,6088343,124.1,0.85
3607,2021-07-10,VEN,43199,23217,19982,6302,36543,354,ITH,ITH3,5,Veneto,Veneto,4905854,6131542,124.98,0.88
3608,2021-09-05,VEN,15199,8395,6804,3475,11432,292,ITH,ITH3,5,Veneto,Veneto,4905854,6146741,125.29,0.31
3609,2021-07-17,VEN,40616,21487,19129,4295,35976,345,ITH,ITH3,5,Veneto,Veneto,4905854,6187357,126.12,0.83
3610,2021-09-12,VEN,15323,8629,6694,2357,12806,160,ITH,ITH3,5,Veneto,Veneto,4905854,6202680,126.43,0.31
3611,2021-08-29,VEN,13397,7352,6045,4493,8580,324,ITH,ITH3,5,Veneto,Veneto,4905854,6216077,126.71,0.27
3612,2021-05-21,VEN,44869,22069,22800,19801,23959,1109,ITH,ITH3,5,Veneto,Veneto,4905854,6260946,127.62,0.91
3613,2021-02-17,VEN,6022,2772,3250,5900,94,28,ITH,ITH3,5,Veneto,Veneto,4905854,6266968,127.74,0.12
3614,2021-04-01,VEN,25405,11197,14208,18211,6414,780,ITH,ITH3,5,Veneto,Veneto,4905854,6292373,128.26,0.52
3615,2021-04-15,VEN,20949,8659,12290,9369,10833,747,ITH,ITH3,5,Veneto,Veneto,4905854,6313322,128.69,0.43
3616,2021-01-05,VEN,7335,2186,5149,7333,0,2,ITH,ITH3,5,Veneto,Veneto,4905854,6320657,128.84,0.15
3617,2021-02-10,VEN,4763,1593,3170,3692,1061,10,ITH,ITH3,5,Veneto,Veneto,4905854,6325420,128.94,0.1
3618,2021-04-08,VEN,32417,14389,18028,23350,7889,1178,ITH,ITH3,5,Veneto,Veneto,4905854,6357837,129.6,0.66
3619,2021-06-04,VEN,49652,25841,23811,39825,8150,1677,ITH,ITH3,5,Veneto,Veneto,4905854,6407489,130.61,1.01
3620,2021-02-24,VEN,8622,3680,4942,7996,489,137,ITH,ITH3,5,Veneto,Veneto,4905854,6416111,130.78,0.18
3621,2021-06-22,VEN,43746,21630,22116,18500,24389,857,ITH,ITH3,5,Veneto,Veneto,4905854,6459857,131.68,0.89
3622,2021-08-18,VEN,23326,12572,10754,14206,8443,677,ITH,ITH3,5,Veneto,Veneto,4905854,6483183,132.15,0.48
3623,2021-08-04,VEN,42478,22686,19792,22607,18772,1099,ITH,ITH3,5,Veneto,Veneto,4905854,6525661,133.02,0.87
3624,2021-04-26,VEN,20734,9461,11273,14912,5140,682,ITH,ITH3,5,Veneto,Veneto,4905854,6546395,133.44,0.42
3625,2021-06-15,VEN,47847,24304,23543,29144,17549,1154,ITH,ITH3,5,Veneto,Veneto,4905854,6594242,134.42,0.98
3626,2021-08-11,VEN,26790,14796,11994,15650,10570,570,ITH,ITH3,5,Veneto,Veneto,4905854,6621032,134.96,0.55
3627,2021-01-23,PAT,584,338,246,389,194,1,ITH,ITH2,4,Provincia Autonoma Trento,P.A. Trento,541380,584,0.11,0.11
3628,2021-05-03,PAT,4311,2223,2088,3844,157,310,ITH,ITH2,4,Provincia Autonoma Trento,P.A. Trento,541380,4895,0.9,0.8
3629,2021-08-13,PAT,5961,3378,2583,2589,3222,150,ITH,ITH2,4,Provincia Autonoma Trento,P.A. Trento,541380,10856,2.01,1.1
3630,2021-07-01,PAT,7150,3737,3413,3588,3364,198,ITH,ITH2,4,Provincia Autonoma Trento,P.A. Trento,541380,18006,3.33,1.32
3631,2021-05-05,PAT,5060,2611,2449,4433,306,321,ITH,ITH2,4,Provincia Autonoma Trento,P.A. Trento,541380,23066,4.26,0.93
3632,2021-07-13,PAT,3839,1952,1887,1774,1934,131,ITH,ITH2,4,Provincia Autonoma Trento,P.A. Trento,541380,26905,4.97,0.71
3633,2021-04-21,PAT,2945,1372,1573,2739,51,155,ITH,ITH2,4,Provincia Autonoma Trento,P.A. Trento,541380,29850,5.51,0.54
3634,2021-01-28,PAT,554,156,398,51,503,0,ITH,ITH2,4,Provincia Autonoma Trento,P.A. Trento,541380,30404,5.62,0.1
3635,2021-01-11,PAT,765,235,530,765,0,0,ITH,ITH2,4,Provincia Autonoma Trento,P.A. Trento,541380,31169,5.76,0.14
3636,2021-03-09,PAT,1670,620,1050,980,653,37,ITH,ITH2,4,Provincia Autonoma Trento,P.A. Trento,541380,32839,6.07,0.31
3637,2021-06-17,PAT,6752,3563,3189,2044,4538,170,ITH,ITH2,4,Provincia Autonoma Trento,P.A. Trento,541380,39591,7.31,1.25
3638,2021-09-08,PAT,1544,780,764,482,1033,29,ITH,ITH2,4,Provincia Autonoma Trento,P.A. Trento,541380,41135,7.6,0.29
3639,2021-07-27,PAT,4816,2547,2269,1753,2951,112,ITH,ITH2,4,Provincia Autonoma Trento,P.A. Trento,541380,45951,8.49,0.89
3640,2021-05-31,PAT,4807,2215,2592,1608,3088,111,ITH,ITH2,4,Provincia Autonoma Trento,P.A. Trento,541380,50758,9.38,0.89
3641,2021-02-06,PAT,582,302,280,439,143,0,ITH,ITH2,4,Provincia Autonoma Trento,P.A. Trento,541380,51340,9.48,0.11
3642,2021-02-23,PAT,1128,403,725,887,218,23,ITH,ITH2,4,Provincia Autonoma Trento,P.A. Trento,541380,52468,9.69,0.21
3643,2021-05-17,PAT,4357,2157,2200,3752,363,242,ITH,ITH2,4,Provincia Autonoma Trento,P.A. Trento,541380,56825,10.5,0.8
3644,2021-08-25,PAT,4395,2347,2048,1084,3238,73,ITH,ITH2,4,Provincia Autonoma Trento,P.A. Trento,541380,61220,11.31,0.81
3645,2021-06-29,PAT,6430,3241,3189,2768,3534,128,ITH,ITH2,4,Provincia Autonoma Trento,P.A. Trento,541380,67650,12.5,1.19
3646,2021-06-12,PAT,5429,2718,2711,436,4943,50,ITH,ITH2,4,Provincia Autonoma Trento,P.A. Trento,541380,73079,13.5,1.0
3647,2021-03-21,PAT,136,74,62,131,0,5,ITH,ITH2,4,Provincia Autonoma Trento,P.A. Trento,541380,73215,13.52,0.03
3648,2021-04-09,PAT,2806,1195,1611,1528,1209,69,ITH,ITH2,4,Provincia Autonoma Trento,P.A. Trento,541380,76021,14.04,0.52
3649,2021-02-11,PAT,1171,377,794,803,367,1,ITH,ITH2,4,Provincia Autonoma Trento,P.A. Trento,541380,77192,14.26,0.22
3650,2021-07-18,PAT,464,243,221,116,339,9,ITH,ITH2,4,Provincia Autonoma Trento,P.A. Trento,541380,77656,14.34,0.09
3651,2021-02-25,PAT,1656,649,1007,1200,446,10,ITH,ITH2,4,Provincia Autonoma Trento,P.A. Trento,541380,79312,14.65,0.31
3652,2020-12-30,PAT,7,3,4,7,0,0,ITH,ITH2,4,Provincia Autonoma Trento,P.A. Trento,541380,79319,14.65,0.0
3653,2021-06-05,PAT,4132,1939,2193,689,3364,79,ITH,ITH2,4,Provincia Autonoma Trento,P.A. Trento,541380,83451,15.41,0.76
3654,2021-08-08,PAT,635,338,297,241,386,8,ITH,ITH2,4,Provincia Autonoma Trento,P.A. Trento,541380,84086,15.53,0.12
3655,2021-08-27,PAT,3798,2065,1733,924,2790,84,ITH,ITH2,4,Provincia Autonoma Trento,P.A. Trento,541380,87884,16.23,0.7
3656,2021-03-26,PAT,3277,1282,1995,2518,612,147,ITH,ITH2,4,Provincia Autonoma Trento,P.A. Trento,541380,91161,16.84,0.61
3657,2021-08-06,PAT,6474,3566,2908,2668,3685,121,ITH,ITH2,4,Provincia Autonoma Trento,P.A. Trento,541380,97635,18.03,1.2
3658,2021-01-16,PAT,322,148,174,322,0,0,ITH,ITH2,4,Provincia Autonoma Trento,P.A. Trento,541380,97957,18.09,0.06
3659,2021-04-28,PAT,4291,1996,2295,3897,139,255,ITH,ITH2,4,Provincia Autonoma Trento,P.A. Trento,541380,102248,18.89,0.79
3660,2021-02-16,PAT,676,248,428,660,5,11,ITH,ITH2,4,Provincia Autonoma Trento,P.A. Trento,541380,102924,19.01,0.12
3661,2021-04-23,PAT,3668,1786,1882,3430,56,182,ITH,ITH2,4,Provincia Autonoma Trento,P.A. Trento,541380,106592,19.69,0.68
3662,2021-01-30,PAT,396,136,260,155,241,0,ITH,ITH2,4,Provincia Autonoma Trento,P.A. Trento,541380,106988,19.76,0.07
3663,2021-05-10,PAT,3271,1679,1592,2532,518,221,ITH,ITH2,4,Provincia Autonoma Trento,P.A. Trento,541380,110259,20.37,0.6
3664,2021-03-14,PAT,110,67,43,19,89,2,ITH,ITH2,4,Provincia Autonoma Trento,P.A. Trento,541380,110369,20.39,0.02
3665,2021-03-07,PAT,24,6,18,24,0,0,ITH,ITH2,4,Provincia Autonoma Trento,P.A. Trento,541380,110393,20.39,0.0
3666,2021-01-09,PAT,195,42,153,195,0,0,ITH,ITH2,4,Provincia Autonoma Trento,P.A. Trento,541380,110588,20.43,0.04
3667,2021-06-24,PAT,6056,3171,2885,3650,2208,198,ITH,ITH2,4,Provincia Autonoma Trento,P.A. Trento,541380,116644,21.55,1.12
3668,2021-05-12,PAT,3348,1511,1837,1962,1220,166,ITH,ITH2,4,Provincia Autonoma Trento,P.A. Trento,541380,119992,22.16,0.62
3669,2021-03-16,PAT,1407,514,893,581,792,34,ITH,ITH2,4,Provincia Autonoma Trento,P.A. Trento,541380,121399,22.42,0.26
3670,2021-09-15,PAT,775,390,385,283,452,40,ITH,ITH2,4,Provincia Autonoma Trento,P.A. Trento,541380,122174,22.57,0.14
3671,2021-07-20,PAT,4830,2610,2220,1744,2934,152,ITH,ITH2,4,Provincia Autonoma Trento,P.A. Trento,541380,127004,23.46,0.89
3672,2021-04-14,PAT,3146,1480,1666,2253,738,155,ITH,ITH2,4,Provincia Autonoma Trento,P.A. Trento,541380,130150,24.04,0.58
3673,2021-03-28,PAT,768,304,464,717,2,49,ITH,ITH2,4,Provincia Autonoma Trento,P.A. Trento,541380,130918,24.18,0.14
3674,2021-01-04,PAT,905,250,655,903,0,2,ITH,ITH2,4,Provincia Autonoma Trento,P.A. Trento,541380,131823,24.35,0.17
3675,2021-07-06,PAT,5238,2763,2475,3115,1931,192,ITH,ITH2,4,Provincia Autonoma Trento,P.A. Trento,541380,137061,25.32,0.97
3676,2021-01-18,PAT,690,168,522,631,59,0,ITH,ITH2,4,Provincia Autonoma Trento,P.A. Trento,541380,137751,25.44,0.13
3677,2021-05-22,PAT,3375,1666,1709,849,2435,91,ITH,ITH2,4,Provincia Autonoma Trento,P.A. Trento,541380,141126,26.07,0.62
3678,2021-05-29,PAT,2445,1328,1117,783,1571,91,ITH,ITH2,4,Provincia Autonoma Trento,P.A. Trento,541380,143571,26.52,0.45
3679,2021-04-02,PAT,2893,1179,1714,2044,684,165,ITH,ITH2,4,Provincia Autonoma Trento,P.A. Trento,541380,146464,27.05,0.53
3680,2021-04-16,PAT,2906,1377,1529,2598,150,158,ITH,ITH2,4,Provincia Autonoma Trento,P.A. Trento,541380,149370,27.59,0.54
3681,2021-02-18,PAT,1436,504,932,1349,69,18,ITH,ITH2,4,Provincia Autonoma Trento,P.A. Trento,541380,150806,27.86,0.27
3682,2021-07-25,PAT,366,205,161,139,218,9,ITH,ITH2,4,Provincia Autonoma Trento,P.A. Trento,541380,151172,27.92,0.07
3683,2021-05-24,PAT,4493,2077,2416,1268,3110,115,ITH,ITH2,4,Provincia Autonoma Trento,P.A. Trento,541380,155665,28.75,0.83
3684,2021-09-01,PAT,3924,2092,1832,831,3017,76,ITH,ITH2,4,Provincia Autonoma Trento,P.A. Trento,541380,159589,29.48,0.72
3685,2021-03-02,PAT,1323,446,877,910,382,31,ITH,ITH2,4,Provincia Autonoma Trento,P.A. Trento,541380,160912,29.72,0.24
3686,2021-06-10,PAT,6218,3029,3189,1813,4268,137,ITH,ITH2,4,Provincia Autonoma Trento,P.A. Trento,541380,167130,30.87,1.15
3687,2021-09-03,PAT,3482,1906,1576,784,2649,49,ITH,ITH2,4,Provincia Autonoma Trento,P.A. Trento,541380,170612,31.51,0.64
3688,2021-06-19,PAT,3146,1722,1424,236,2879,31,ITH,ITH2,4,Provincia Autonoma Trento,P.A. Trento,541380,173758,32.1,0.58
3689,2021-07-08,PAT,4166,2215,1951,2511,1483,172,ITH,ITH2,4,Provincia Autonoma Trento,P.A. Trento,541380,177924,32.86,0.77
3690,2021-02-04,PAT,1014,321,693,430,583,1,ITH,ITH2,4,Provincia Autonoma Trento,P.A. Trento,541380,178938,33.05,0.19
3691,2021-04-01,PAT,2945,1251,1694,1744,1106,95,ITH,ITH2,4,Provincia Autonoma Trento,P.A. Trento,541380,181883,33.6,0.54
3692,2021-07-10,PAT,1098,565,533,148,920,30,ITH,ITH2,4,Provincia Autonoma Trento,P.A. Trento,541380,182981,33.8,0.2
3693,2021-03-23,PAT,2483,962,1521,1628,755,100,ITH,ITH2,4,Provincia Autonoma Trento,P.A. Trento,541380,185464,34.26,0.46
3694,2021-05-28,PAT,3805,1768,2037,1399,2265,141,ITH,ITH2,4,Provincia Autonoma Trento,P.A. Trento,541380,189269,34.96,0.7
3695,2021-01-25,PAT,849,231,618,25,824,0,ITH,ITH2,4,Provincia Autonoma Trento,P.A. Trento,541380,190118,35.12,0.16
3696,2021-03-18,PAT,2335,964,1371,1221,1089,25,ITH,ITH2,4,Provincia Autonoma Trento,P.A. Trento,541380,192453,35.55,0.43
3697,2021-06-09,PAT,6329,3123,3206,2113,4131,85,ITH,ITH2,4,Provincia Autonoma Trento,P.A. Trento,541380,198782,36.72,1.17
3698,2021-06-26,PAT,1437,754,683,676,727,34,ITH,ITH2,4,Provincia Autonoma Trento,P.A. Trento,541380,200219,36.98,0.27
3699,2021-06-28,PAT,6954,3597,3357,2955,3869,130,ITH,ITH2,4,Provincia Autonoma Trento,P.A. Trento,541380,207173,38.27,1.28
3700,2021-04-06,PAT,2288,969,1319,1459,770,59,ITH,ITH2,4,Provincia Autonoma Trento,P.A. Trento,541380,209461,38.69,0.42
3701,2021-07-15,PAT,4299,2301,1998,1791,2364,144,ITH,ITH2,4,Provincia Autonoma Trento,P.A. Trento,541380,213760,39.48,0.79
3702,2021-08-20,PAT,5218,2880,2338,1487,3630,101,ITH,ITH2,4,Provincia Autonoma Trento,P.A. Trento,541380,218978,40.45,0.96
3703,2021-05-14,PAT,5445,2615,2830,3715,1429,301,ITH,ITH2,4,Provincia Autonoma Trento,P.A. Trento,541380,224423,41.45,1.01
3704,2021-08-22,PAT,406,243,163,220,171,15,ITH,ITH2,4,Provincia Autonoma Trento,P.A. Trento,541380,224829,41.53,0.07
3705,2021-02-08,PAT,1194,333,861,347,847,0,ITH,ITH2,4,Provincia Autonoma Trento,P.A. Trento,541380,226023,41.75,0.22
3706,2021-08-24,PAT,4606,2468,2138,1293,3221,92,ITH,ITH2,4,Provincia Autonoma Trento,P.A. Trento,541380,230629,42.6,0.85
3707,2021-07-24,PAT,994,547,447,520,445,29,ITH,ITH2,4,Provincia Autonoma Trento,P.A. Trento,541380,231623,42.78,0.18
3708,2021-02-20,PAT,412,247,165,124,287,1,ITH,ITH2,4,Provincia Autonoma Trento,P.A. Trento,541380,232035,42.86,0.08
3709,2021-01-08,PAT,1538,341,1197,1537,0,1,ITH,ITH2,4,Provincia Autonoma Trento,P.A. Trento,541380,233573,43.14,0.28
3710,2021-06-14,PAT,5819,3010,2809,2043,3656,120,ITH,ITH2,4,Provincia Autonoma Trento,P.A. Trento,541380,239392,44.22,1.07
3711,2021-04-18,PAT,1865,850,1015,1796,9,60,ITH,ITH2,4,Provincia Autonoma Trento,P.A. Trento,541380,241257,44.56,0.34
3712,2021-03-06,PAT,809,285,524,615,152,42,ITH,ITH2,4,Provincia Autonoma Trento,P.A. Trento,541380,242066,44.71,0.15
3713,2021-04-11,PAT,2392,1161,1231,2201,99,92,ITH,ITH2,4,Provincia Autonoma Trento,P.A. Trento,541380,244458,45.15,0.44
3714,2021-02-27,PAT,1054,468,586,606,428,20,ITH,ITH2,4,Provincia Autonoma Trento,P.A. Trento,541380,245512,45.35,0.19
3715,2021-08-03,PAT,6213,3357,2856,2488,3596,129,ITH,ITH2,4,Provincia Autonoma Trento,P.A. Trento,541380,251725,46.5,1.15
3716,2021-01-01,PAT,222,51,171,222,0,0,ITH,ITH2,4,Provincia Autonoma Trento,P.A. Trento,541380,251947,46.54,0.04
3717,2021-06-07,PAT,5889,2930,2959,2679,3028,182,ITH,ITH2,4,Provincia Autonoma Trento,P.A. Trento,541380,257836,47.63,1.09
3718,2021-04-25,PAT,2003,953,1050,1872,7,124,ITH,ITH2,4,Provincia Autonoma Trento,P.A. Trento,541380,259839,48.0,0.37
3719,2021-03-25,PAT,2916,1128,1788,1742,1060,114,ITH,ITH2,4,Provincia Autonoma Trento,P.A. Trento,541380,262755,48.53,0.54
3720,2021-07-03,PAT,1268,681,587,78,1185,5,ITH,ITH2,4,Provincia Autonoma Trento,P.A. Trento,541380,264023,48.77,0.23
3721,2021-03-30,PAT,2467,999,1468,1672,693,102,ITH,ITH2,4,Provincia Autonoma Trento,P.A. Trento,541380,266490,49.22,0.46
3722,2021-03-04,PAT,2388,807,1581,1556,790,42,ITH,ITH2,4,Provincia Autonoma Trento,P.A. Trento,541380,268878,49.67,0.44
3723,2021-01-27,PAT,873,310,563,115,756,2,ITH,ITH2,4,Provincia Autonoma Trento,P.A. Trento,541380,269751,49.83,0.16
3724,2021-02-13,PAT,540,335,205,172,368,0,ITH,ITH2,4,Provincia Autonoma Trento,P.A. Trento,541380,270291,49.93,0.1
3725,2021-05-07,PAT,6092,3133,2959,4853,854,385,ITH,ITH2,4,Provincia Autonoma Trento,P.A. Trento,541380,276383,51.05,1.13
3726,2021-04-20,PAT,2909,1388,1521,2690,37,182,ITH,ITH2,4,Provincia Autonoma Trento,P.A. Trento,541380,279292,51.59,0.54
3727,2021-05-09,PAT,2354,1225,1129,1868,347,139,ITH,ITH2,4,Provincia Autonoma Trento,P.A. Trento,541380,281646,52.02,0.43
3728,2021-08-17,PAT,5453,2884,2569,1941,3377,135,ITH,ITH2,4,Provincia Autonoma Trento,P.A. Trento,541380,287099,53.03,1.01
3729,2021-02-15,PAT,547,193,354,419,126,2,ITH,ITH2,4,Provincia Autonoma Trento,P.A. Trento,541380,287646,53.13,0.1
3730,2021-05-26,PAT,3963,1870,2093,1116,2724,123,ITH,ITH2,4,Provincia Autonoma Trento,P.A. Trento,541380,291609,53.86,0.73
3731,2021-04-13,PAT,2618,1090,1528,2026,509,83,ITH,ITH2,4,Provincia Autonoma Trento,P.A. Trento,541380,294227,54.35,0.48
3732,2021-01-20,PAT,308,77,231,296,12,0,ITH,ITH2,4,Provincia Autonoma Trento,P.A. Trento,541380,294535,54.4,0.06
3733,2021-04-30,PAT,4992,2434,2558,4442,163,387,ITH,ITH2,4,Provincia Autonoma Trento,P.A. Trento,541380,299527,55.33,0.92
3734,2021-05-19,PAT,5196,2514,2682,3670,1274,252,ITH,ITH2,4,Provincia Autonoma Trento,P.A. Trento,541380,304723,56.29,0.96
3735,2021-09-10,PAT,2454,1271,1183,736,1641,77,ITH,ITH2,4,Provincia Autonoma Trento,P.A. Trento,541380,307177,56.74,0.45
3736,2021-05-02,PAT,3564,1979,1585,3295,39,230,ITH,ITH2,4,Provincia Autonoma Trento,P.A. Trento,541380,310741,57.4,0.66
3737,2021-08-10,PAT,5996,3205,2791,2900,2910,186,ITH,ITH2,4,Provincia Autonoma Trento,P.A. Trento,541380,316737,58.51,1.11
3738,2021-03-13,PAT,965,496,469,841,48,76,ITH,ITH2,4,Provincia Autonoma Trento,P.A. Trento,541380,317702,58.68,0.18
3739,2021-07-05,PAT,5434,2850,2584,3792,1393,249,ITH,ITH2,4,Provincia Autonoma Trento,P.A. Trento,541380,323136,59.69,1.0
3740,2021-09-12,PAT,7,4,3,3,4,0,ITH,ITH2,4,Provincia Autonoma Trento,P.A. Trento,541380,323143,59.69,0.0
3741,2021-06-21,PAT,6260,3387,2873,3649,2425,186,ITH,ITH2,4,Provincia Autonoma Trento,P.A. Trento,541380,329403,60.85,1.16
3742,2021-08-29,PAT,615,346,269,310,281,24,ITH,ITH2,4,Provincia Autonoma Trento,P.A. Trento,541380,330018,60.96,0.11
3743,2021-07-17,PAT,1099,537,562,270,809,20,ITH,ITH2,4,Provincia Autonoma Trento,P.A. Trento,541380,331117,61.16,0.2
3744,2021-05-21,PAT,5216,2506,2710,3138,1806,272,ITH,ITH2,4,Provincia Autonoma Trento,P.A. Trento,541380,336333,62.13,0.96
3745,2021-02-01,PAT,1278,356,922,98,1180,0,ITH,ITH2,4,Provincia Autonoma Trento,P.A. Trento,541380,337611,62.36,0.24
3746,2021-08-31,PAT,4406,2292,2114,1242,3063,101,ITH,ITH2,4,Provincia Autonoma Trento,P.A. Trento,541380,342017,63.18,0.81
3747,2021-01-13,PAT,444,131,313,444,0,0,ITH,ITH2,4,Provincia Autonoma Trento,P.A. Trento,541380,342461,63.26,0.08
3748,2021-02-12,PAT,1033,346,687,592,439,2,ITH,ITH2,4,Provincia Autonoma Trento,P.A. Trento,541380,343494,63.45,0.19
3749,2021-03-01,PAT,1255,460,795,928,302,25,ITH,ITH2,4,Provincia Autonoma Trento,P.A. Trento,541380,344749,63.68,0.23
3750,2021-03-20,PAT,888,409,479,663,211,14,ITH,ITH2,4,Provincia Autonoma Trento,P.A. Trento,541380,345637,63.84,0.16
3751,2021-03-03,PAT,1672,628,1044,1115,520,37,ITH,ITH2,4,Provincia Autonoma Trento,P.A. Trento,541380,347309,64.15,0.31
3752,2021-09-02,PAT,3351,1755,1596,949,2354,48,ITH,ITH2,4,Provincia Autonoma Trento,P.A. Trento,541380,350660,64.77,0.62
3753,2021-06-11,PAT,7310,3477,3833,1492,5712,106,ITH,ITH2,4,Provincia Autonoma Trento,P.A. Trento,541380,357970,66.12,1.35
3754,2021-08-28,PAT,1343,827,516,548,758,37,ITH,ITH2,4,Provincia Autonoma Trento,P.A. Trento,541380,359313,66.37,0.25
3755,2021-08-21,PAT,1320,783,537,602,679,39,ITH,ITH2,4,Provincia Autonoma Trento,P.A. Trento,541380,360633,66.61,0.24
3756,2021-06-25,PAT,7799,4160,3639,4171,3449,179,ITH,ITH2,4,Provincia Autonoma Trento,P.A. Trento,541380,368432,68.05,1.44
3757,2021-06-06,PAT,2269,1080,1189,431,1817,21,ITH,ITH2,4,Provincia Autonoma Trento,P.A. Trento,541380,370701,68.47,0.42
3758,2021-09-14,PAT,1968,983,985,581,1339,48,ITH,ITH2,4,Provincia Autonoma Trento,P.A. Trento,541380,372669,68.84,0.36
3759,2021-07-12,PAT,4274,2154,2120,2037,2043,194,ITH,ITH2,4,Provincia Autonoma Trento,P.A. Trento,541380,376943,69.63,0.79
3760,2021-02-17,PAT,1175,450,725,1058,112,5,ITH,ITH2,4,Provincia Autonoma Trento,P.A. Trento,541380,378118,69.84,0.22
3761,2021-08-02,PAT,5378,2852,2526,1606,3703,69,ITH,ITH2,4,Provincia Autonoma Trento,P.A. Trento,541380,383496,70.84,0.99
3762,2021-06-02,PAT,2884,1383,1501,895,1916,73,ITH,ITH2,4,Provincia Autonoma Trento,P.A. Trento,541380,386380,71.37,0.53
3763,2021-03-11,PAT,2622,984,1638,1507,1055,60,ITH,ITH2,4,Provincia Autonoma Trento,P.A. Trento,541380,389002,71.85,0.48
3764,2021-07-22,PAT,4779,2588,2191,1897,2739,143,ITH,ITH2,4,Provincia Autonoma Trento,P.A. Trento,541380,393781,72.74,0.88
3765,2021-07-07,PAT,4529,2432,2097,2921,1406,202,ITH,ITH2,4,Provincia Autonoma Trento,P.A. Trento,541380,398310,73.57,0.84
3766,2021-01-03,PAT,503,166,337,503,0,0,ITH,ITH2,4,Provincia Autonoma Trento,P.A. Trento,541380,398813,73.67,0.09
3767,2021-07-21,PAT,4710,2524,2186,1522,3088,100,ITH,ITH2,4,Provincia Autonoma Trento,P.A. Trento,541380,403523,74.54,0.87
3768,2021-04-29,PAT,4703,2266,2437,4174,214,315,ITH,ITH2,4,Provincia Autonoma Trento,P.A. Trento,541380,408226,75.4,0.87
3769,2021-08-07,PAT,1624,931,693,817,769,38,ITH,ITH2,4,Provincia Autonoma Trento,P.A. Trento,541380,409850,75.7,0.3
3770,2021-01-22,PAT,1748,459,1289,350,1396,2,ITH,ITH2,4,Provincia Autonoma Trento,P.A. Trento,541380,411598,76.03,0.32
3771,2021-02-05,PAT,835,288,547,285,550,0,ITH,ITH2,4,Provincia Autonoma Trento,P.A. Trento,541380,412433,76.18,0.15
3772,2021-05-16,PAT,1358,756,602,1042,248,68,ITH,ITH2,4,Provincia Autonoma Trento,P.A. Trento,541380,413791,76.43,0.25
3773,2021-01-05,PAT,759,262,497,759,0,0,ITH,ITH2,4,Provincia Autonoma Trento,P.A. Trento,541380,414550,76.57,0.14
3774,2021-04-15,PAT,3234,1459,1775,2830,156,248,ITH,ITH2,4,Provincia Autonoma Trento,P.A. Trento,541380,417784,77.17,0.6
3775,2021-06-18,PAT,7068,3761,3307,1785,5190,93,ITH,ITH2,4,Provincia Autonoma Trento,P.A. Trento,541380,424852,78.48,1.31
3776,2021-03-27,PAT,1673,747,926,1322,263,88,ITH,ITH2,4,Provincia Autonoma Trento,P.A. Trento,541380,426525,78.78,0.31
3777,2021-01-10,PAT,87,20,67,87,0,0,ITH,ITH2,4,Provincia Autonoma Trento,P.A. Trento,541380,426612,78.8,0.02
3778,2021-01-29,PAT,1426,363,1063,56,1370,0,ITH,ITH2,4,Provincia Autonoma Trento,P.A. Trento,541380,428038,79.06,0.26
3779,2021-06-13,PAT,3734,2061,1673,279,3430,25,ITH,ITH2,4,Provincia Autonoma Trento,P.A. Trento,541380,431772,79.75,0.69
3780,2020-12-27,PAT,107,43,64,107,0,0,ITH,ITH2,4,Provincia Autonoma Trento,P.A. Trento,541380,431879,79.77,0.02
3781,2021-02-03,PAT,877,326,551,417,460,0,ITH,ITH2,4,Provincia Autonoma Trento,P.A. Trento,541380,432756,79.94,0.16
3782,2021-07-19,PAT,4811,2534,2277,1456,3224,131,ITH,ITH2,4,Provincia Autonoma Trento,P.A. Trento,541380,437567,80.82,0.89
3783,2021-05-23,PAT,1995,1015,980,431,1535,29,ITH,ITH2,4,Provincia Autonoma Trento,P.A. Trento,541380,439562,81.19,0.37
3784,2021-04-10,PAT,2877,1352,1525,1995,803,79,ITH,ITH2,4,Provincia Autonoma Trento,P.A. Trento,541380,442439,81.72,0.53
3785,2021-08-14,PAT,290,156,134,50,237,3,ITH,ITH2,4,Provincia Autonoma Trento,P.A. Trento,541380,442729,81.78,0.05
3786,2021-07-02,PAT,7425,4037,3388,3581,3596,248,ITH,ITH2,4,Provincia Autonoma Trento,P.A. Trento,541380,450154,83.15,1.37
3787,2021-01-15,PAT,628,149,479,627,0,1,ITH,ITH2,4,Provincia Autonoma Trento,P.A. Trento,541380,450782,83.27,0.12
3788,2021-05-20,PAT,5122,2408,2714,3149,1690,283,ITH,ITH2,4,Provincia Autonoma Trento,P.A. Trento,541380,455904,84.21,0.95
3789,2021-03-24,PAT,2415,963,1452,1467,827,121,ITH,ITH2,4,Provincia Autonoma Trento,P.A. Trento,541380,458319,84.66,0.45
3790,2021-02-09,PAT,952,303,649,448,503,1,ITH,ITH2,4,Provincia Autonoma Trento,P.A. Trento,541380,459271,84.83,0.18
3791,2021-03-17,PAT,2131,813,1318,1130,907,94,ITH,ITH2,4,Provincia Autonoma Trento,P.A. Trento,541380,461402,85.23,0.39
3792,2021-05-30,PAT,1777,876,901,864,843,70,ITH,ITH2,4,Provincia Autonoma Trento,P.A. Trento,541380,463179,85.56,0.33
3793,2021-04-03,PAT,1183,487,696,936,178,69,ITH,ITH2,4,Provincia Autonoma Trento,P.A. Trento,541380,464362,85.77,0.22
3794,2021-09-07,PAT,1525,795,730,448,1033,44,ITH,ITH2,4,Provincia Autonoma Trento,P.A. Trento,541380,465887,86.06,0.28
3795,2021-04-24,PAT,3580,1714,1866,3352,16,212,ITH,ITH2,4,Provincia Autonoma Trento,P.A. Trento,541380,469467,86.72,0.66
3796,2021-02-26,PAT,1257,445,812,932,299,26,ITH,ITH2,4,Provincia Autonoma Trento,P.A. Trento,541380,470724,86.95,0.23
3797,2021-01-14,PAT,731,218,513,729,0,2,ITH,ITH2,4,Provincia Autonoma Trento,P.A. Trento,541380,471455,87.08,0.14
3798,2021-02-28,PAT,246,122,124,236,0,10,ITH,ITH2,4,Provincia Autonoma Trento,P.A. Trento,541380,471701,87.13,0.05
3799,2021-08-04,PAT,6209,3313,2896,2572,3499,138,ITH,ITH2,4,Provincia Autonoma Trento,P.A. Trento,541380,477910,88.28,1.15
3800,2021-06-08,PAT,6046,2919,3127,1784,4133,129,ITH,ITH2,4,Provincia Autonoma Trento,P.A. Trento,541380,483956,89.39,1.12
3801,2021-04-26,PAT,2676,1260,1416,2410,96,170,ITH,ITH2,4,Provincia Autonoma Trento,P.A. Trento,541380,486632,89.89,0.49
3802,2021-08-09,PAT,5352,2854,2498,2286,2924,142,ITH,ITH2,4,Provincia Autonoma Trento,P.A. Trento,541380,491984,90.88,0.99
3803,2021-08-26,PAT,4124,2164,1960,1069,2957,98,ITH,ITH2,4,Provincia Autonoma Trento,P.A. Trento,541380,496108,91.64,0.76
3804,2021-02-22,PAT,755,262,493,663,86,6,ITH,ITH2,4,Provincia Autonoma Trento,P.A. Trento,541380,496863,91.78,0.14
3805,2021-05-18,PAT,4323,2047,2276,3169,869,285,ITH,ITH2,4,Provincia Autonoma Trento,P.A. Trento,541380,501186,92.58,0.8
3806,2021-09-09,PAT,1710,846,864,595,1059,56,ITH,ITH2,4,Provincia Autonoma Trento,P.A. Trento,541380,502896,92.89,0.32
3807,2021-06-04,PAT,5929,2652,3277,1732,4062,135,ITH,ITH2,4,Provincia Autonoma Trento,P.A. Trento,541380,508825,93.99,1.1
3808,2021-02-24,PAT,1373,543,830,943,406,24,ITH,ITH2,4,Provincia Autonoma Trento,P.A. Trento,541380,510198,94.24,0.25
3809,2021-06-03,PAT,4845,2279,2566,1237,3515,93,ITH,ITH2,4,Provincia Autonoma Trento,P.A. Trento,541380,515043,95.14,0.89
3810,2021-09-11,PAT,693,394,299,469,190,34,ITH,ITH2,4,Provincia Autonoma Trento,P.A. Trento,541380,515736,95.26,0.13
3811,2021-01-19,PAT,434,89,345,434,0,0,ITH,ITH2,4,Provincia Autonoma Trento,P.A. Trento,541380,516170,95.34,0.08
3812,2021-07-14,PAT,4190,2177,2013,1703,2355,132,ITH,ITH2,4,Provincia Autonoma Trento,P.A. Trento,541380,520360,96.12,0.77
3813,2021-04-22,PAT,3175,1482,1693,2946,46,183,ITH,ITH2,4,Provincia Autonoma Trento,P.A. Trento,541380,523535,96.7,0.59
3814,2021-07-31,PAT,1499,858,641,1076,383,40,ITH,ITH2,4,Provincia Autonoma Trento,P.A. Trento,541380,525034,96.98,0.28
3815,2021-04-07,PAT,2656,1029,1627,1577,955,124,ITH,ITH2,4,Provincia Autonoma Trento,P.A. Trento,541380,527690,97.47,0.49
3816,2021-07-16,PAT,4598,2369,2229,1736,2707,155,ITH,ITH2,4,Provincia Autonoma Trento,P.A. Trento,541380,532288,98.32,0.85
3817,2021-02-02,PAT,942,254,688,192,750,0,ITH,ITH2,4,Provincia Autonoma Trento,P.A. Trento,541380,533230,98.49,0.17
3818,2021-07-09,PAT,5154,2733,2421,3046,1885,223,ITH,ITH2,4,Provincia Autonoma Trento,P.A. Trento,541380,538384,99.45,0.95
3819,2021-05-13,PAT,3458,1607,1851,2103,1127,228,ITH,ITH2,4,Provincia Autonoma Trento,P.A. Trento,541380,541842,100.09,0.64
3820,2021-03-31,PAT,2624,1001,1623,1656,868,100,ITH,ITH2,4,Provincia Autonoma Trento,P.A. Trento,541380,544466,100.57,0.48
3821,2021-01-26,PAT,577,173,404,28,549,0,ITH,ITH2,4,Provincia Autonoma Trento,P.A. Trento,541380,545043,100.68,0.11
3822,2021-05-06,PAT,5616,2795,2821,4447,794,375,ITH,ITH2,4,Provincia Autonoma Trento,P.A. Trento,541380,550659,101.71,1.04
3823,2021-02-19,PAT,945,366,579,847,65,33,ITH,ITH2,4,Provincia Autonoma Trento,P.A. Trento,541380,551604,101.89,0.17
3824,2021-08-11,PAT,5848,3150,2698,3100,2585,163,ITH,ITH2,4,Provincia Autonoma Trento,P.A. Trento,541380,557452,102.97,1.08
3825,2021-06-27,PAT,1368,735,633,395,961,12,ITH,ITH2,4,Provincia Autonoma Trento,P.A. Trento,541380,558820,103.22,0.25
3826,2021-01-12,PAT,541,173,368,540,0,1,ITH,ITH2,4,Provincia Autonoma Trento,P.A. Trento,541380,559361,103.32,0.1
3827,2021-07-30,PAT,5852,3097,2755,2292,3449,111,ITH,ITH2,4,Provincia Autonoma Trento,P.A. Trento,541380,565213,104.4,1.08
3828,2021-08-16,PAT,4852,2564,2288,1810,2931,111,ITH,ITH2,4,Provincia Autonoma Trento,P.A. Trento,541380,570065,105.3,0.9
3829,2021-05-25,PAT,4867,2315,2552,1742,2975,150,ITH,ITH2,4,Provincia Autonoma Trento,P.A. Trento,541380,574932,106.2,0.9
3830,2021-05-08,PAT,3195,1743,1452,2571,426,198,ITH,ITH2,4,Provincia Autonoma Trento,P.A. Trento,541380,578127,106.79,0.59
3831,2021-02-14,PAT,250,189,61,11,239,0,ITH,ITH2,4,Provincia Autonoma Trento,P.A. Trento,541380,578377,106.83,0.05
3832,2021-08-18,PAT,4635,2553,2082,1436,3113,86,ITH,ITH2,4,Provincia Autonoma Trento,P.A. Trento,541380,583012,107.69,0.86
3833,2021-05-27,PAT,4379,2034,2345,1164,3081,134,ITH,ITH2,4,Provincia Autonoma Trento,P.A. Trento,541380,587391,108.5,0.81
3834,2021-09-04,PAT,932,544,388,482,412,38,ITH,ITH2,4,Provincia Autonoma Trento,P.A. Trento,541380,588323,108.67,0.17
3835,2021-03-12,PAT,2603,991,1612,1709,815,79,ITH,ITH2,4,Provincia Autonoma Trento,P.A. Trento,541380,590926,109.15,0.48
3836,2021-06-20,PAT,1900,1050,850,31,1864,5,ITH,ITH2,4,Provincia Autonoma Trento,P.A. Trento,541380,592826,109.5,0.35
3837,2021-09-13,PAT,2423,1302,1121,820,1545,58,ITH,ITH2,4,Provincia Autonoma Trento,P.A. Trento,541380,595249,109.95,0.45
3838,2021-01-02,PAT,522,149,373,522,0,0,ITH,ITH2,4,Provincia Autonoma Trento,P.A. Trento,541380,595771,110.05,0.1
3839,2021-03-29,PAT,2569,1011,1558,1697,742,130,ITH,ITH2,4,Provincia Autonoma Trento,P.A. Trento,541380,598340,110.52,0.47
3840,2021-04-12,PAT,3156,1455,1701,2526,504,126,ITH,ITH2,4,Provincia Autonoma Trento,P.A. Trento,541380,601496,111.1,0.58
3841,2021-07-23,PAT,4763,2443,2320,1670,2955,138,ITH,ITH2,4,Provincia Autonoma Trento,P.A. Trento,541380,606259,111.98,0.88
3842,2021-03-10,PAT,2486,973,1513,1473,948,65,ITH,ITH2,4,Provincia Autonoma Trento,P.A. Trento,541380,608745,112.44,0.46
3843,2021-02-10,PAT,872,295,577,513,358,1,ITH,ITH2,4,Provincia Autonoma Trento,P.A. Trento,541380,609617,112.6,0.16
3844,2021-07-26,PAT,3901,2058,1843,834,2996,71,ITH,ITH2,4,Provincia Autonoma Trento,P.A. Trento,541380,613518,113.32,0.72
3845,2021-04-08,PAT,3182,1336,1846,1955,1133,94,ITH,ITH2,4,Provincia Autonoma Trento,P.A. Trento,541380,616700,113.91,0.59
3846,2021-03-19,PAT,2467,925,1542,1503,881,83,ITH,ITH2,4,Provincia Autonoma Trento,P.A. Trento,541380,619167,114.37,0.46
3847,2021-04-05,PAT,35,17,18,30,2,3,ITH,ITH2,4,Provincia Autonoma Trento,P.A. Trento,541380,619202,114.37,0.01
3848,2021-01-21,PAT,376,104,272,247,129,0,ITH,ITH2,4,Provincia Autonoma Trento,P.A. Trento,541380,619578,114.44,0.07
3849,2021-05-01,PAT,4889,2486,2403,4551,37,301,ITH,ITH2,4,Provincia Autonoma Trento,P.A. Trento,541380,624467,115.35,0.9
3850,2021-02-21,PAT,158,95,63,44,114,0,ITH,ITH2,4,Provincia Autonoma Trento,P.A. Trento,541380,624625,115.38,0.03
3851,2021-05-15,PAT,1605,833,772,649,915,41,ITH,ITH2,4,Provincia Autonoma Trento,P.A. Trento,541380,626230,115.67,0.3
3852,2021-06-01,PAT,4105,1926,2179,1081,2912,112,ITH,ITH2,4,Provincia Autonoma Trento,P.A. Trento,541380,630335,116.43,0.76
3853,2020-12-31,PAT,1701,480,1221,1701,0,0,ITH,ITH2,4,Provincia Autonoma Trento,P.A. Trento,541380,632036,116.75,0.31
3854,2021-06-22,PAT,6384,3479,2905,3627,2568,189,ITH,ITH2,4,Provincia Autonoma Trento,P.A. Trento,541380,638420,117.92,1.18
3855,2021-03-05,PAT,2308,736,1572,1643,569,96,ITH,ITH2,4,Provincia Autonoma Trento,P.A. Trento,541380,640728,118.35,0.43
3856,2021-01-07,PAT,1301,328,973,1298,0,3,ITH,ITH2,4,Provincia Autonoma Trento,P.A. Trento,541380,642029,118.59,0.24
3857,2021-04-17,PAT,2253,1148,1105,2090,57,106,ITH,ITH2,4,Provincia Autonoma Trento,P.A. Trento,541380,644282,119.01,0.42
3858,2021-04-19,PAT,2646,1244,1402,2429,23,194,ITH,ITH2,4,Provincia Autonoma Trento,P.A. Trento,541380,646928,119.5,0.49
3859,2021-07-28,PAT,4869,2670,2199,2158,2573,138,ITH,ITH2,4,Provincia Autonoma Trento,P.A. Trento,541380,651797,120.4,0.9
3860,2021-06-15,PAT,6332,3342,2990,1632,4565,135,ITH,ITH2,4,Provincia Autonoma Trento,P.A. Trento,541380,658129,121.57,1.17
3861,2021-01-06,PAT,43,13,30,43,0,0,ITH,ITH2,4,Provincia Autonoma Trento,P.A. Trento,541380,658172,121.57,0.01
3862,2021-08-05,PAT,6392,3496,2896,2951,3318,123,ITH,ITH2,4,Provincia Autonoma Trento,P.A. Trento,541380,664564,122.75,1.18
3863,2021-08-12,PAT,5702,3049,2653,2203,3324,175,ITH,ITH2,4,Provincia Autonoma Trento,P.A. Trento,541380,670266,123.81,1.05
3864,2021-07-29,PAT,5480,2912,2568,2647,2714,119,ITH,ITH2,4,Provincia Autonoma Trento,P.A. Trento,541380,675746,124.82,1.01
3865,2021-06-16,PAT,6327,3416,2911,1989,4214,124,ITH,ITH2,4,Provincia Autonoma Trento,P.A. Trento,541380,682073,125.99,1.17
3866,2021-03-15,PAT,1453,573,880,929,469,55,ITH,ITH2,4,Provincia Autonoma Trento,P.A. Trento,541380,683526,126.26,0.27
3867,2021-08-19,PAT,4633,2486,2147,1110,3440,83,ITH,ITH2,4,Provincia Autonoma Trento,P.A. Trento,541380,688159,127.11,0.86
3868,2021-01-17,PAT,255,199,56,255,0,0,ITH,ITH2,4,Provincia Autonoma Trento,P.A. Trento,541380,688414,127.16,0.05
3869,2021-06-23,PAT,6694,3547,3147,4626,1871,197,ITH,ITH2,4,Provincia Autonoma Trento,P.A. Trento,541380,695108,128.4,1.24
3870,2021-05-11,PAT,3743,1768,1975,2641,863,239,ITH,ITH2,4,Provincia Autonoma Trento,P.A. Trento,541380,698851,129.09,0.69
3871,2021-04-27,PAT,3956,1902,2054,3597,70,289,ITH,ITH2,4,Provincia Autonoma Trento,P.A. Trento,541380,702807,129.82,0.73
3872,2021-05-04,PAT,4572,2490,2082,4170,97,305,ITH,ITH2,4,Provincia Autonoma Trento,P.A. Trento,541380,707379,130.66,0.84
3873,2021-03-08,PAT,1426,439,987,1042,354,30,ITH,ITH2,4,Provincia Autonoma Trento,P.A. Trento,541380,708805,130.93,0.26
3874,2021-03-22,PAT,2349,995,1354,1405,885,59,ITH,ITH2,4,Provincia Autonoma Trento,P.A. Trento,541380,711154,131.36,0.43
3875,2021-01-24,PAT,562,285,277,226,336,0,ITH,ITH2,4,Provincia Autonoma Trento,P.A. Trento,541380,711716,131.46,0.1
3876,2021-06-30,PAT,6875,3531,3344,2690,4056,129,ITH,ITH2,4,Provincia Autonoma Trento,P.A. Trento,541380,718591,132.73,1.27
3877,2021-01-31,PAT,77,16,61,1,76,0,ITH,ITH2,4,Provincia Autonoma Trento,P.A. Trento,541380,718668,132.75,0.01
3878,2021-07-04,PAT,225,125,100,66,157,2,ITH,ITH2,4,Provincia Autonoma Trento,P.A. Trento,541380,718893,132.79,0.04
3879,2021-08-30,PAT,3896,1987,1909,1181,2604,111,ITH,ITH2,4,Provincia Autonoma Trento,P.A. Trento,541380,722789,133.51,0.72
3880,2021-08-23,PAT,4341,2289,2052,1429,2746,166,ITH,ITH2,4,Provincia Autonoma Trento,P.A. Trento,541380,727130,134.31,0.8
3881,2021-09-06,PAT,3135,1647,1488,968,2066,101,ITH,ITH2,4,Provincia Autonoma Trento,P.A. Trento,541380,730265,134.89,0.58
3882,2021-07-11,PAT,1035,566,469,131,895,9,ITH,ITH2,4,Provincia Autonoma Trento,P.A. Trento,541380,731300,135.08,0.19
3883,2021-01-30,SIC,7735,3556,4179,141,7591,3,ITG,ITG1,19,Sicilia,Sicilia,4999891,7735,0.15,0.15
3884,2021-03-28,SIC,10992,5152,5840,6911,4013,68,ITG,ITG1,19,Sicilia,Sicilia,4999891,18727,0.37,0.22
3885,2021-09-10,SIC,25223,12574,12649,8820,15969,434,ITG,ITG1,19,Sicilia,Sicilia,4999891,43950,0.88,0.5
3886,2021-07-15,SIC,48429,22473,25956,8009,40157,263,ITG,ITG1,19,Sicilia,Sicilia,4999891,92379,1.85,0.97
3887,2021-04-11,SIC,15379,7595,7784,8227,7040,112,ITG,ITG1,19,Sicilia,Sicilia,4999891,107758,2.16,0.31
3888,2021-07-20,SIC,48509,23630,24879,12786,35360,363,ITG,ITG1,19,Sicilia,Sicilia,4999891,156267,3.13,0.97
3889,2020-12-30,SIC,186,110,76,185,0,1,ITG,ITG1,19,Sicilia,Sicilia,4999891,156453,3.13,0.0
3890,2021-01-16,SIC,2737,1221,1516,2716,0,21,ITG,ITG1,19,Sicilia,Sicilia,4999891,159190,3.18,0.05
3891,2021-07-01,SIC,31038,14101,16937,10783,19998,257,ITG,ITG1,19,Sicilia,Sicilia,4999891,190228,3.8,0.62
3892,2021-04-09,SIC,20234,9845,10389,10921,9049,264,ITG,ITG1,19,Sicilia,Sicilia,4999891,210462,4.21,0.4
3893,2021-03-23,SIC,20975,10091,10884,15232,5567,176,ITG,ITG1,19,Sicilia,Sicilia,4999891,231437,4.63,0.42
3894,2021-02-13,SIC,2979,1124,1855,2686,256,37,ITG,ITG1,19,Sicilia,Sicilia,4999891,234416,4.69,0.06
3895,2021-05-24,SIC,35895,17455,18440,15597,20065,233,ITG,ITG1,19,Sicilia,Sicilia,4999891,270311,5.41,0.72
3896,2021-08-15,SIC,2513,1428,1085,1509,954,50,ITG,ITG1,19,Sicilia,Sicilia,4999891,272824,5.46,0.05
3897,2021-08-01,SIC,19966,10434,9532,7855,11965,146,ITG,ITG1,19,Sicilia,Sicilia,4999891,292790,5.86,0.4
3898,2021-06-19,SIC,44305,21065,23240,18761,25221,323,ITG,ITG1,19,Sicilia,Sicilia,4999891,337095,6.74,0.89
3899,2021-04-23,SIC,28632,13723,14909,22407,5841,384,ITG,ITG1,19,Sicilia,Sicilia,4999891,365727,7.31,0.57
3900,2021-08-29,SIC,14527,7931,6596,4754,9627,146,ITG,ITG1,19,Sicilia,Sicilia,4999891,380254,7.61,0.29
3901,2021-02-25,SIC,9941,5208,4733,8684,1164,93,ITG,ITG1,19,Sicilia,Sicilia,4999891,390195,7.8,0.2
3902,2021-06-05,SIC,59962,28523,31439,48733,10601,628,ITG,ITG1,19,Sicilia,Sicilia,4999891,450157,9.0,1.2
3903,2021-03-14,SIC,8784,3931,4853,4895,3837,52,ITG,ITG1,19,Sicilia,Sicilia,4999891,458941,9.18,0.18
3904,2021-08-03,SIC,32102,15756,16346,13908,17774,420,ITG,ITG1,19,Sicilia,Sicilia,4999891,491043,9.82,0.64
3905,2021-03-02,SIC,14782,6379,8403,11885,2781,116,ITG,ITG1,19,Sicilia,Sicilia,4999891,505825,10.12,0.3
3906,2021-01-04,SIC,8685,4330,4355,8635,0,50,ITG,ITG1,19,Sicilia,Sicilia,4999891,514510,10.29,0.17
3907,2021-01-18,SIC,1627,676,951,1456,160,11,ITG,ITG1,19,Sicilia,Sicilia,4999891,516137,10.32,0.03
3908,2021-04-28,SIC,29288,13723,15565,19716,9163,409,ITG,ITG1,19,Sicilia,Sicilia,4999891,545425,10.91,0.59
3909,2021-08-10,SIC,21848,10886,10962,10667,10917,264,ITG,ITG1,19,Sicilia,Sicilia,4999891,567273,11.35,0.44
3910,2021-09-15,SIC,11281,5605,5676,3527,7577,177,ITG,ITG1,19,Sicilia,Sicilia,4999891,578554,11.57,0.23
3911,2021-06-24,SIC,42367,19673,22694,17633,24374,360,ITG,ITG1,19,Sicilia,Sicilia,4999891,620921,12.42,0.85
3912,2021-06-07,SIC,49696,23420,26276,41116,8043,537,ITG,ITG1,19,Sicilia,Sicilia,4999891,670617,13.41,0.99
3913,2021-01-25,SIC,7455,3690,3765,266,7182,7,ITG,ITG1,19,Sicilia,Sicilia,4999891,678072,13.56,0.15
3914,2021-05-05,SIC,26411,12237,14174,16280,9685,446,ITG,ITG1,19,Sicilia,Sicilia,4999891,704483,14.09,0.53
3915,2021-05-19,SIC,42918,20777,22141,28198,14337,383,ITG,ITG1,19,Sicilia,Sicilia,4999891,747401,14.95,0.86
3916,2021-04-04,SIC,6799,3324,3475,5434,1295,70,ITG,ITG1,19,Sicilia,Sicilia,4999891,754200,15.08,0.14
3917,2021-07-13,SIC,46137,21175,24962,6919,38998,220,ITG,ITG1,19,Sicilia,Sicilia,4999891,800337,16.01,0.92
3918,2020-12-28,SIC,274,169,105,273,0,1,ITG,ITG1,19,Sicilia,Sicilia,4999891,800611,16.01,0.01
3919,2021-08-27,SIC,23365,11881,11484,9852,13186,327,ITG,ITG1,19,Sicilia,Sicilia,4999891,823976,16.48,0.47
3920,2021-05-17,SIC,31939,15410,16529,18997,12647,295,ITG,ITG1,19,Sicilia,Sicilia,4999891,855915,17.12,0.64
3921,2021-03-21,SIC,15226,7346,7880,11184,3970,72,ITG,ITG1,19,Sicilia,Sicilia,4999891,871141,17.42,0.3
3922,2021-02-06,SIC,4736,2119,2617,1450,3266,20,ITG,ITG1,19,Sicilia,Sicilia,4999891,875877,17.52,0.09
3923,2021-02-04,SIC,6762,3084,3678,1420,5312,30,ITG,ITG1,19,Sicilia,Sicilia,4999891,882639,17.65,0.14
3924,2021-09-03,SIC,21886,11054,10832,9911,11602,373,ITG,ITG1,19,Sicilia,Sicilia,4999891,904525,18.09,0.44
3925,2021-06-26,SIC,37269,17782,19487,16351,20610,308,ITG,ITG1,19,Sicilia,Sicilia,4999891,941794,18.84,0.75
3926,2021-04-30,SIC,35061,16359,18702,23520,11056,485,ITG,ITG1,19,Sicilia,Sicilia,4999891,976855,19.54,0.7
3927,2021-03-04,SIC,15261,6710,8551,11011,4122,128,ITG,ITG1,19,Sicilia,Sicilia,4999891,992116,19.84,0.31
3928,2021-08-08,SIC,15317,8131,7186,7412,7715,190,ITG,ITG1,19,Sicilia,Sicilia,4999891,1007433,20.15,0.31
3929,2021-06-12,SIC,45805,22399,23406,39372,5897,536,ITG,ITG1,19,Sicilia,Sicilia,4999891,1053238,21.07,0.92
3930,2021-02-11,SIC,5239,2061,3178,4654,467,118,ITG,ITG1,19,Sicilia,Sicilia,4999891,1058477,21.17,0.1
3931,2021-04-16,SIC,28868,14501,14367,20243,8301,324,ITG,ITG1,19,Sicilia,Sicilia,4999891,1087345,21.75,0.58
3932,2021-01-23,SIC,4491,2310,2181,209,4272,10,ITG,ITG1,19,Sicilia,Sicilia,4999891,1091836,21.84,0.09
3933,2021-01-06,SIC,6270,3302,2968,6205,0,65,ITG,ITG1,19,Sicilia,Sicilia,4999891,1098106,21.96,0.13
3934,2021-02-23,SIC,8785,4667,4118,8229,468,88,ITG,ITG1,19,Sicilia,Sicilia,4999891,1106891,22.14,0.18
3935,2021-03-09,SIC,13190,5780,7410,10841,2218,131,ITG,ITG1,19,Sicilia,Sicilia,4999891,1120081,22.4,0.26
3936,2021-01-11,SIC,5931,2618,3313,5871,0,60,ITG,ITG1,19,Sicilia,Sicilia,4999891,1126012,22.52,0.12
3937,2021-05-31,SIC,38140,17171,20969,21284,16560,296,ITG,ITG1,19,Sicilia,Sicilia,4999891,1164152,23.28,0.76
3938,2021-09-08,SIC,20316,10118,10198,9206,10703,407,ITG,ITG1,19,Sicilia,Sicilia,4999891,1184468,23.69,0.41
3939,2021-08-22,SIC,10330,5504,4826,3913,6299,118,ITG,ITG1,19,Sicilia,Sicilia,4999891,1194798,23.9,0.21
3940,2021-02-18,SIC,5343,3148,2195,4844,431,68,ITG,ITG1,19,Sicilia,Sicilia,4999891,1200141,24.0,0.11
3941,2021-05-12,SIC,36869,17398,19471,21406,14928,535,ITG,ITG1,19,Sicilia,Sicilia,4999891,1237010,24.74,0.74
3942,2021-08-20,SIC,18797,9363,9434,9858,8673,266,ITG,ITG1,19,Sicilia,Sicilia,4999891,1255807,25.12,0.38
3943,2021-07-27,SIC,43339,21478,21861,19270,23605,464,ITG,ITG1,19,Sicilia,Sicilia,4999891,1299146,25.98,0.87
3944,2021-03-16,SIC,9644,4334,5310,3570,6003,71,ITG,ITG1,19,Sicilia,Sicilia,4999891,1308790,26.18,0.19
3945,2021-07-08,SIC,38404,17498,20906,6531,31647,226,ITG,ITG1,19,Sicilia,Sicilia,4999891,1347194,26.94,0.77
3946,2021-06-04,SIC,57871,26768,31103,45402,11962,507,ITG,ITG1,19,Sicilia,Sicilia,4999891,1405065,28.1,1.16
3947,2021-09-12,SIC,14010,7468,6542,4972,8806,232,ITG,ITG1,19,Sicilia,Sicilia,4999891,1419075,28.38,0.28
3948,2021-04-06,SIC,17767,8485,9282,13256,4298,213,ITG,ITG1,19,Sicilia,Sicilia,4999891,1436842,28.74,0.36
3949,2021-02-22,SIC,7946,4131,3815,7370,493,83,ITG,ITG1,19,Sicilia,Sicilia,4999891,1444788,28.9,0.16
3950,2020-12-27,SIC,148,95,53,147,0,1,ITG,ITG1,19,Sicilia,Sicilia,4999891,1444936,28.9,0.0
3951,2021-06-02,SIC,35284,16298,18986,27102,7782,400,ITG,ITG1,19,Sicilia,Sicilia,4999891,1480220,29.61,0.71
3952,2021-06-16,SIC,40447,18808,21639,21271,18817,359,ITG,ITG1,19,Sicilia,Sicilia,4999891,1520667,30.41,0.81
3953,2021-03-25,SIC,20480,9535,10945,14751,5549,180,ITG,ITG1,19,Sicilia,Sicilia,4999891,1541147,30.82,0.41
3954,2021-07-03,SIC,33886,16289,17597,9030,24610,246,ITG,ITG1,19,Sicilia,Sicilia,4999891,1575033,31.5,0.68
3955,2021-09-07,SIC,22700,11291,11409,9471,12809,420,ITG,ITG1,19,Sicilia,Sicilia,4999891,1597733,31.96,0.45
3956,2021-03-06,SIC,12651,5064,7587,9765,2783,103,ITG,ITG1,19,Sicilia,Sicilia,4999891,1610384,32.21,0.25
3957,2021-01-01,SIC,825,441,384,821,0,4,ITG,ITG1,19,Sicilia,Sicilia,4999891,1611209,32.22,0.02
3958,2021-04-20,SIC,18995,9004,9991,13436,5249,310,ITG,ITG1,19,Sicilia,Sicilia,4999891,1630204,32.6,0.38
3959,2021-07-29,SIC,36208,17891,18317,14329,21537,342,ITG,ITG1,19,Sicilia,Sicilia,4999891,1666412,33.33,0.72
3960,2021-04-02,SIC,13905,6562,7343,9047,4738,120,ITG,ITG1,19,Sicilia,Sicilia,4999891,1680317,33.61,0.28
3961,2021-02-10,SIC,4354,1776,2578,3888,383,83,ITG,ITG1,19,Sicilia,Sicilia,4999891,1684671,33.69,0.09
3962,2021-05-21,SIC,48725,23084,25641,26667,21631,427,ITG,ITG1,19,Sicilia,Sicilia,4999891,1733396,34.67,0.97
3963,2021-08-12,SIC,15123,7582,7541,7978,6903,242,ITG,ITG1,19,Sicilia,Sicilia,4999891,1748519,34.97,0.3
3964,2021-05-07,SIC,36606,17282,19324,24578,11629,399,ITG,ITG1,19,Sicilia,Sicilia,4999891,1785125,35.7,0.73
3965,2021-03-11,SIC,15465,6715,8750,12892,2418,155,ITG,ITG1,19,Sicilia,Sicilia,4999891,1800590,36.01,0.31
3966,2021-01-27,SIC,7297,3714,3583,164,7132,1,ITG,ITG1,19,Sicilia,Sicilia,4999891,1807887,36.16,0.15
3967,2021-01-13,SIC,5192,2449,2743,5158,0,34,ITG,ITG1,19,Sicilia,Sicilia,4999891,1813079,36.26,0.1
3968,2021-01-20,SIC,969,513,456,691,275,3,ITG,ITG1,19,Sicilia,Sicilia,4999891,1814048,36.28,0.02
3969,2021-03-18,SIC,15418,7758,7660,9739,5624,55,ITG,ITG1,19,Sicilia,Sicilia,4999891,1829466,36.59,0.31
3970,2021-03-01,SIC,12776,6079,6697,10992,1658,126,ITG,ITG1,19,Sicilia,Sicilia,4999891,1842242,36.85,0.26
3971,2021-06-09,SIC,49788,23684,26104,41910,7266,612,ITG,ITG1,19,Sicilia,Sicilia,4999891,1892030,37.84,1.0
3972,2021-07-17,SIC,49325,24294,25031,9314,39711,300,ITG,ITG1,19,Sicilia,Sicilia,4999891,1941355,38.83,0.99
3973,2021-04-08,SIC,19022,9345,9677,9281,9542,199,ITG,ITG1,19,Sicilia,Sicilia,4999891,1960377,39.21,0.38
3974,2021-02-20,SIC,7171,3707,3464,6802,272,97,ITG,ITG1,19,Sicilia,Sicilia,4999891,1967548,39.35,0.14
3975,2021-02-03,SIC,5945,2793,3152,706,5231,8,ITG,ITG1,19,Sicilia,Sicilia,4999891,1973493,39.47,0.12
3976,2021-04-27,SIC,26460,12689,13771,15147,10960,353,ITG,ITG1,19,Sicilia,Sicilia,4999891,1999953,40.0,0.53
3977,2021-08-05,SIC,23867,11850,12017,11522,12037,308,ITG,ITG1,19,Sicilia,Sicilia,4999891,2023820,40.48,0.48
3978,2021-05-14,SIC,52249,24499,27750,35786,15682,781,ITG,ITG1,19,Sicilia,Sicilia,4999891,2076069,41.52,1.05
3979,2021-02-27,SIC,12241,5505,6736,10936,1204,101,ITG,ITG1,19,Sicilia,Sicilia,4999891,2088310,41.77,0.24
3980,2021-07-12,SIC,49013,22618,26395,6443,42368,202,ITG,ITG1,19,Sicilia,Sicilia,4999891,2137323,42.75,0.98
3981,2021-02-08,SIC,3888,1680,2208,2081,1759,48,ITG,ITG1,19,Sicilia,Sicilia,4999891,2141211,42.83,0.08
3982,2021-01-22,SIC,1294,641,653,261,1031,2,ITG,ITG1,19,Sicilia,Sicilia,4999891,2142505,42.85,0.03
3983,2021-04-01,SIC,14331,6627,7704,9517,4669,145,ITG,ITG1,19,Sicilia,Sicilia,4999891,2156836,43.14,0.29
3984,2021-07-10,SIC,46921,22357,24564,6057,40655,209,ITG,ITG1,19,Sicilia,Sicilia,4999891,2203757,44.08,0.94
3985,2021-06-23,SIC,44515,20711,23804,17928,26251,336,ITG,ITG1,19,Sicilia,Sicilia,4999891,2248272,44.97,0.89
3986,2021-07-24,SIC,40737,21214,19523,16792,23633,312,ITG,ITG1,19,Sicilia,Sicilia,4999891,2289009,45.78,0.81
3987,2021-02-15,SIC,3777,1769,2008,3137,564,76,ITG,ITG1,19,Sicilia,Sicilia,4999891,2292786,45.86,0.08
3988,2021-07-22,SIC,40678,19970,20708,11226,29155,297,ITG,ITG1,19,Sicilia,Sicilia,4999891,2333464,46.67,0.81
3989,2021-05-26,SIC,44745,21040,23705,23908,20492,345,ITG,ITG1,19,Sicilia,Sicilia,4999891,2378209,47.57,0.89
3990,2021-01-03,SIC,4818,2519,2299,4784,0,34,ITG,ITG1,19,Sicilia,Sicilia,4999891,2383027,47.66,0.1
3991,2021-04-13,SIC,20272,9874,10398,11228,8843,201,ITG,ITG1,19,Sicilia,Sicilia,4999891,2403299,48.07,0.41
3992,2021-07-31,SIC,28761,14936,13825,10444,18049,268,ITG,ITG1,19,Sicilia,Sicilia,4999891,2432060,48.64,0.58
3993,2021-09-05,SIC,12737,6903,5834,5499,7043,195,ITG,ITG1,19,Sicilia,Sicilia,4999891,2444797,48.9,0.25
3994,2021-06-14,SIC,43494,20661,22833,28168,14897,429,ITG,ITG1,19,Sicilia,Sicilia,4999891,2488291,49.77,0.87
3995,2021-05-28,SIC,51285,22994,28291,24318,26553,414,ITG,ITG1,19,Sicilia,Sicilia,4999891,2539576,50.79,1.03
3996,2021-08-19,SIC,19564,9764,9800,10488,8765,311,ITG,ITG1,19,Sicilia,Sicilia,4999891,2559140,51.18,0.39
3997,2021-02-19,SIC,4979,2695,2284,4328,564,87,ITG,ITG1,19,Sicilia,Sicilia,4999891,2564119,51.28,0.1
3998,2021-03-08,SIC,13526,5975,7551,10781,2616,129,ITG,ITG1,19,Sicilia,Sicilia,4999891,2577645,51.55,0.27
3999,2021-08-21,SIC,13741,7168,6573,6200,7353,188,ITG,ITG1,19,Sicilia,Sicilia,4999891,2591386,51.83,0.27
4000,2021-05-30,SIC,35789,16180,19609,17430,18063,296,ITG,ITG1,19,Sicilia,Sicilia,4999891,2627175,52.54,0.72
4001,2021-05-13,SIC,47505,22277,25228,30294,16561,650,ITG,ITG1,19,Sicilia,Sicilia,4999891,2674680,53.49,0.95
4002,2021-01-31,SIC,4062,1944,2118,107,3953,2,ITG,ITG1,19,Sicilia,Sicilia,4999891,2678742,53.58,0.08
4003,2021-08-26,SIC,20016,10108,9908,9100,10608,308,ITG,ITG1,19,Sicilia,Sicilia,4999891,2698758,53.98,0.4
4004,2021-02-07,SIC,2323,983,1340,664,1649,10,ITG,ITG1,19,Sicilia,Sicilia,4999891,2701081,54.02,0.05
4005,2021-07-14,SIC,47565,22028,25537,7931,39373,261,ITG,ITG1,19,Sicilia,Sicilia,4999891,2748646,54.97,0.95
4006,2021-05-18,SIC,36144,17400,18744,23247,12491,406,ITG,ITG1,19,Sicilia,Sicilia,4999891,2784790,55.7,0.72
4007,2021-07-21,SIC,42971,20970,22001,10636,32021,314,ITG,ITG1,19,Sicilia,Sicilia,4999891,2827761,56.56,0.86
4008,2021-07-07,SIC,35432,16209,19223,6035,29156,241,ITG,ITG1,19,Sicilia,Sicilia,4999891,2863193,57.27,0.71
4009,2021-08-09,SIC,25181,12862,12319,12487,12317,377,ITG,ITG1,19,Sicilia,Sicilia,4999891,2888374,57.77,0.5
4010,2021-01-19,SIC,1527,677,850,1271,241,15,ITG,ITG1,19,Sicilia,Sicilia,4999891,2889901,57.8,0.03
4011,2021-06-11,SIC,49978,23849,26129,41595,7712,671,ITG,ITG1,19,Sicilia,Sicilia,4999891,2939879,58.8,1.0
4012,2021-04-29,SIC,31823,14849,16974,21802,9562,459,ITG,ITG1,19,Sicilia,Sicilia,4999891,2971702,59.44,0.64
4013,2021-03-03,SIC,14591,6551,8040,11382,3077,132,ITG,ITG1,19,Sicilia,Sicilia,4999891,2986293,59.73,0.29
4014,2021-08-07,SIC,20055,10403,9652,10818,8900,337,ITG,ITG1,19,Sicilia,Sicilia,4999891,3006348,60.13,0.4
4015,2021-01-15,SIC,5325,2335,2990,5258,0,67,ITG,ITG1,19,Sicilia,Sicilia,4999891,3011673,60.23,0.11
4016,2021-04-25,SIC,21404,10209,11195,16138,5019,247,ITG,ITG1,19,Sicilia,Sicilia,4999891,3033077,60.66,0.43
4017,2021-02-01,SIC,5955,2641,3314,293,5648,14,ITG,ITG1,19,Sicilia,Sicilia,4999891,3039032,60.78,0.12
4018,2021-03-22,SIC,16696,7923,8773,11168,5432,96,ITG,ITG1,19,Sicilia,Sicilia,4999891,3055728,61.12,0.33
4019,2021-06-30,SIC,32621,15042,17579,11448,20851,322,ITG,ITG1,19,Sicilia,Sicilia,4999891,3088349,61.77,0.65
4020,2020-12-29,SIC,299,185,114,298,0,1,ITG,ITG1,19,Sicilia,Sicilia,4999891,3088648,61.77,0.01
4021,2021-06-13,SIC,34550,17168,17382,30604,3512,434,ITG,ITG1,19,Sicilia,Sicilia,4999891,3123198,62.47,0.69
4022,2021-01-08,SIC,8158,3797,4361,8065,0,93,ITG,ITG1,19,Sicilia,Sicilia,4999891,3131356,62.63,0.16
4023,2021-04-18,SIC,19837,9918,9919,15283,4364,190,ITG,ITG1,19,Sicilia,Sicilia,4999891,3151193,63.03,0.4
4024,2021-08-31,SIC,27968,14177,13791,10306,17363,299,ITG,ITG1,19,Sicilia,Sicilia,4999891,3179161,63.58,0.56
4025,2021-03-30,SIC,14589,6774,7815,9715,4771,103,ITG,ITG1,19,Sicilia,Sicilia,4999891,3193750,63.88,0.29
4026,2021-03-13,SIC,12227,5395,6832,7636,4499,92,ITG,ITG1,19,Sicilia,Sicilia,4999891,3205977,64.12,0.24
4027,2021-04-17,SIC,26011,13154,12857,18661,7068,282,ITG,ITG1,19,Sicilia,Sicilia,4999891,3231988,64.64,0.52
4028,2021-07-26,SIC,44549,22206,22343,16703,27475,371,ITG,ITG1,19,Sicilia,Sicilia,4999891,3276537,65.53,0.89
4029,2021-03-17,SIC,15057,7445,7612,9077,5853,127,ITG,ITG1,19,Sicilia,Sicilia,4999891,3291594,65.83,0.3
4030,2021-06-25,SIC,39808,18681,21127,17384,22085,339,ITG,ITG1,19,Sicilia,Sicilia,4999891,3331402,66.63,0.8
4031,2021-07-09,SIC,44829,20687,24142,6402,38243,184,ITG,ITG1,19,Sicilia,Sicilia,4999891,3376231,67.53,0.9
4032,2021-01-24,SIC,4336,2268,2068,121,4213,2,ITG,ITG1,19,Sicilia,Sicilia,4999891,3380567,67.61,0.09
4033,2021-05-04,SIC,26867,12477,14390,17148,9299,420,ITG,ITG1,19,Sicilia,Sicilia,4999891,3407434,68.15,0.54
4034,2021-03-15,SIC,10693,4737,5956,5658,4955,80,ITG,ITG1,19,Sicilia,Sicilia,4999891,3418127,68.36,0.21
4035,2021-04-10,SIC,20448,9978,10470,11301,8972,175,ITG,ITG1,19,Sicilia,Sicilia,4999891,3438575,68.77,0.41
4036,2021-01-17,SIC,1315,599,716,1240,66,9,ITG,ITG1,19,Sicilia,Sicilia,4999891,3439890,68.8,0.03
4037,2021-07-02,SIC,30578,14240,16338,9942,20350,286,ITG,ITG1,19,Sicilia,Sicilia,4999891,3470468,69.41,0.61
4038,2021-07-19,SIC,48974,23596,25378,11649,36966,359,ITG,ITG1,19,Sicilia,Sicilia,4999891,3519442,70.39,0.98
4039,2021-05-11,SIC,32695,15507,17188,19684,12502,509,ITG,ITG1,19,Sicilia,Sicilia,4999891,3552137,71.04,0.65
4040,2021-02-17,SIC,5222,3204,2018,4500,670,52,ITG,ITG1,19,Sicilia,Sicilia,4999891,3557359,71.15,0.1
4041,2021-04-24,SIC,31216,14716,16500,23141,7640,435,ITG,ITG1,19,Sicilia,Sicilia,4999891,3588575,71.77,0.62
4042,2021-08-02,SIC,32983,16395,16588,12850,19784,349,ITG,ITG1,19,Sicilia,Sicilia,4999891,3621558,72.43,0.66
4043,2021-01-10,SIC,3568,1599,1969,3546,0,22,ITG,ITG1,19,Sicilia,Sicilia,4999891,3625126,72.5,0.07
4044,2021-01-05,SIC,10634,5230,5404,10551,0,83,ITG,ITG1,19,Sicilia,Sicilia,4999891,3635760,72.72,0.21
4045,2021-05-25,SIC,33577,15440,18137,13946,19376,255,ITG,ITG1,19,Sicilia,Sicilia,4999891,3669337,73.39,0.67
4046,2021-03-29,SIC,15049,7085,7964,10399,4500,150,ITG,ITG1,19,Sicilia,Sicilia,4999891,3684386,73.69,0.3
4047,2021-09-02,SIC,23138,11841,11297,10006,12743,389,ITG,ITG1,19,Sicilia,Sicilia,4999891,3707524,74.15,0.46
4048,2021-06-01,SIC,38994,17729,21265,24596,14047,351,ITG,ITG1,19,Sicilia,Sicilia,4999891,3746518,74.93,0.78
4049,2021-04-05,SIC,8024,3958,4066,6510,1442,72,ITG,ITG1,19,Sicilia,Sicilia,4999891,3754542,75.09,0.16
4050,2021-09-09,SIC,23621,11818,11803,8334,14846,441,ITG,ITG1,19,Sicilia,Sicilia,4999891,3778163,75.56,0.47
4051,2021-04-12,SIC,19023,9221,9802,11487,7277,259,ITG,ITG1,19,Sicilia,Sicilia,4999891,3797186,75.95,0.38
4052,2021-02-14,SIC,1055,402,653,905,140,10,ITG,ITG1,19,Sicilia,Sicilia,4999891,3798241,75.97,0.02
4053,2021-08-16,SIC,20312,10426,9886,10906,9090,316,ITG,ITG1,19,Sicilia,Sicilia,4999891,3818553,76.37,0.41
4054,2021-02-24,SIC,9379,4803,4576,8701,567,111,ITG,ITG1,19,Sicilia,Sicilia,4999891,3827932,76.56,0.19
4055,2021-01-21,SIC,1457,715,742,490,956,11,ITG,ITG1,19,Sicilia,Sicilia,4999891,3829389,76.59,0.03
4056,2021-05-01,SIC,24457,11321,13136,18999,5171,287,ITG,ITG1,19,Sicilia,Sicilia,4999891,3853846,77.08,0.49
4057,2021-07-06,SIC,37130,17170,19960,10285,26533,312,ITG,ITG1,19,Sicilia,Sicilia,4999891,3890976,77.82,0.74
4058,2021-05-10,SIC,28740,13797,14943,16168,12221,351,ITG,ITG1,19,Sicilia,Sicilia,4999891,3919716,78.4,0.57
4059,2021-08-18,SIC,21946,11326,10620,11666,9911,369,ITG,ITG1,19,Sicilia,Sicilia,4999891,3941662,78.83,0.44
4060,2021-03-26,SIC,18000,8361,9639,12340,5502,158,ITG,ITG1,19,Sicilia,Sicilia,4999891,3959662,79.19,0.36
4061,2021-06-06,SIC,49538,23925,25613,41148,7831,559,ITG,ITG1,19,Sicilia,Sicilia,4999891,4009200,80.19,0.99
4062,2021-09-14,SIC,24521,11927,12594,8739,15312,470,ITG,ITG1,19,Sicilia,Sicilia,4999891,4033721,80.68,0.49
4063,2021-02-26,SIC,11988,5882,6106,10191,1681,116,ITG,ITG1,19,Sicilia,Sicilia,4999891,4045709,80.92,0.24
4064,2021-05-06,SIC,29488,14016,15472,18152,10843,493,ITG,ITG1,19,Sicilia,Sicilia,4999891,4075197,81.51,0.59
4065,2021-08-28,SIC,20874,11178,9696,7260,13394,220,ITG,ITG1,19,Sicilia,Sicilia,4999891,4096071,81.92,0.42
4066,2021-08-14,SIC,6143,3341,2802,3308,2714,121,ITG,ITG1,19,Sicilia,Sicilia,4999891,4102214,82.05,0.12
4067,2021-07-28,SIC,37669,18871,18798,14685,22661,323,ITG,ITG1,19,Sicilia,Sicilia,4999891,4139883,82.8,0.75
4068,2021-06-22,SIC,40055,18409,21646,18342,21335,378,ITG,ITG1,19,Sicilia,Sicilia,4999891,4179938,83.6,0.8
4069,2021-03-05,SIC,15789,6852,8937,11395,4244,150,ITG,ITG1,19,Sicilia,Sicilia,4999891,4195727,83.92,0.32
4070,2021-02-16,SIC,4200,2208,1992,3663,467,70,ITG,ITG1,19,Sicilia,Sicilia,4999891,4199927,84.0,0.08
4071,2021-01-02,SIC,4889,2546,2343,4852,0,37,ITG,ITG1,19,Sicilia,Sicilia,4999891,4204816,84.1,0.1
4072,2021-01-28,SIC,9037,4277,4760,361,8675,1,ITG,ITG1,19,Sicilia,Sicilia,4999891,4213853,84.28,0.18
4073,2021-07-04,SIC,26520,12805,13715,7608,18736,176,ITG,ITG1,19,Sicilia,Sicilia,4999891,4240373,84.81,0.53
4074,2021-05-08,SIC,35673,17047,18626,24893,10324,456,ITG,ITG1,19,Sicilia,Sicilia,4999891,4276046,85.52,0.71
4075,2021-01-26,SIC,9582,4745,4837,213,9368,1,ITG,ITG1,19,Sicilia,Sicilia,4999891,4285628,85.71,0.19
4076,2021-06-17,SIC,41892,19505,22387,20360,21157,375,ITG,ITG1,19,Sicilia,Sicilia,4999891,4327520,86.55,0.84
4077,2020-12-31,SIC,898,478,420,890,0,8,ITG,ITG1,19,Sicilia,Sicilia,4999891,4328418,86.57,0.02
4078,2021-03-07,SIC,9271,3457,5814,8129,1083,59,ITG,ITG1,19,Sicilia,Sicilia,4999891,4337689,86.76,0.19
4079,2021-06-15,SIC,46180,21765,24415,28203,17539,438,ITG,ITG1,19,Sicilia,Sicilia,4999891,4383869,87.68,0.92
4080,2021-03-24,SIC,20987,9879,11108,15039,5744,204,ITG,ITG1,19,Sicilia,Sicilia,4999891,4404856,88.1,0.42
4081,2021-09-06,SIC,23279,11836,11443,9962,12903,414,ITG,ITG1,19,Sicilia,Sicilia,4999891,4428135,88.56,0.47
4082,2021-08-06,SIC,24786,12581,12205,13505,10870,411,ITG,ITG1,19,Sicilia,Sicilia,4999891,4452921,89.06,0.5
4083,2021-04-26,SIC,21710,10278,11432,13300,8089,321,ITG,ITG1,19,Sicilia,Sicilia,4999891,4474631,89.49,0.43
4084,2021-02-02,SIC,5324,2499,2825,610,4704,10,ITG,ITG1,19,Sicilia,Sicilia,4999891,4479955,89.6,0.11
4085,2021-08-04,SIC,24362,12011,12351,10979,13057,326,ITG,ITG1,19,Sicilia,Sicilia,4999891,4504317,90.09,0.49
4086,2021-07-18,SIC,39282,19785,19497,8095,30952,235,ITG,ITG1,19,Sicilia,Sicilia,4999891,4543599,90.87,0.79
4087,2021-01-14,SIC,5267,2494,2773,5205,0,62,ITG,ITG1,19,Sicilia,Sicilia,4999891,4548866,90.98,0.11
4088,2021-03-31,SIC,14526,6710,7816,9441,4935,150,ITG,ITG1,19,Sicilia,Sicilia,4999891,4563392,91.27,0.29
4089,2021-01-07,SIC,9075,4212,4863,8991,0,84,ITG,ITG1,19,Sicilia,Sicilia,4999891,4572467,91.45,0.18
4090,2021-05-22,SIC,48027,22813,25214,28303,19325,399,ITG,ITG1,19,Sicilia,Sicilia,4999891,4620494,92.41,0.96
4091,2021-08-30,SIC,28218,14385,13833,10213,17659,346,ITG,ITG1,19,Sicilia,Sicilia,4999891,4648712,92.98,0.56
4092,2021-02-28,SIC,7131,3033,4098,6456,630,45,ITG,ITG1,19,Sicilia,Sicilia,4999891,4655843,93.12,0.14
4093,2021-09-13,SIC,27250,13546,13704,9546,17209,495,ITG,ITG1,19,Sicilia,Sicilia,4999891,4683093,93.66,0.55
4094,2021-06-08,SIC,47711,22407,25304,40455,6713,543,ITG,ITG1,19,Sicilia,Sicilia,4999891,4730804,94.62,0.95
4095,2021-08-11,SIC,16211,8342,7869,8735,7187,289,ITG,ITG1,19,Sicilia,Sicilia,4999891,4747015,94.94,0.32
4096,2021-01-09,SIC,7257,3425,3832,7196,0,61,ITG,ITG1,19,Sicilia,Sicilia,4999891,4754272,95.09,0.15
4097,2021-05-03,SIC,23328,10803,12525,13262,9800,266,ITG,ITG1,19,Sicilia,Sicilia,4999891,4777600,95.55,0.47
4098,2021-07-11,SIC,36046,16873,19173,3665,32285,96,ITG,ITG1,19,Sicilia,Sicilia,4999891,4813646,96.28,0.72
4099,2021-07-25,SIC,31813,16766,15047,11847,19706,260,ITG,ITG1,19,Sicilia,Sicilia,4999891,4845459,96.91,0.64
4100,2021-04-19,SIC,18293,8673,9620,12462,5590,241,ITG,ITG1,19,Sicilia,Sicilia,4999891,4863752,97.28,0.37
4101,2021-02-21,SIC,5169,2501,2668,5044,107,18,ITG,ITG1,19,Sicilia,Sicilia,4999891,4868921,97.38,0.1
4102,2021-04-15,SIC,21594,10496,11098,12000,9358,236,ITG,ITG1,19,Sicilia,Sicilia,4999891,4890515,97.81,0.43
4103,2021-06-20,SIC,33455,15831,17624,15112,18080,263,ITG,ITG1,19,Sicilia,Sicilia,4999891,4923970,98.48,0.67
4104,2021-04-22,SIC,26775,12643,14132,19889,6463,423,ITG,ITG1,19,Sicilia,Sicilia,4999891,4950745,99.02,0.54
4105,2021-03-10,SIC,13962,6135,7827,11625,2188,149,ITG,ITG1,19,Sicilia,Sicilia,4999891,4964707,99.3,0.28
4106,2021-05-29,SIC,47218,21486,25732,23547,23223,448,ITG,ITG1,19,Sicilia,Sicilia,4999891,5011925,100.24,0.94
4107,2021-08-13,SIC,11516,5967,5549,5976,5301,239,ITG,ITG1,19,Sicilia,Sicilia,4999891,5023441,100.47,0.23
4108,2021-02-09,SIC,4350,1800,2550,3248,1037,65,ITG,ITG1,19,Sicilia,Sicilia,4999891,5027791,100.56,0.09
4109,2021-05-20,SIC,44105,21133,22972,27752,15937,416,ITG,ITG1,19,Sicilia,Sicilia,4999891,5071896,101.44,0.88
4110,2021-01-12,SIC,4377,2142,2235,4331,0,46,ITG,ITG1,19,Sicilia,Sicilia,4999891,5076273,101.53,0.09
4111,2021-06-18,SIC,43613,20151,23462,18860,24381,372,ITG,ITG1,19,Sicilia,Sicilia,4999891,5119886,102.4,0.87
4112,2021-06-27,SIC,25312,12202,13110,12097,12983,232,ITG,ITG1,19,Sicilia,Sicilia,4999891,5145198,102.91,0.51
4113,2021-05-15,SIC,56538,26407,30131,40368,15251,919,ITG,ITG1,19,Sicilia,Sicilia,4999891,5201736,104.04,1.13
4114,2021-03-19,SIC,16327,8062,8265,10652,5579,96,ITG,ITG1,19,Sicilia,Sicilia,4999891,5218063,104.36,0.33
4115,2021-08-23,SIC,24080,11903,12177,10800,12929,351,ITG,ITG1,19,Sicilia,Sicilia,4999891,5242143,104.85,0.48
4116,2021-09-01,SIC,24942,12716,12226,10576,14011,355,ITG,ITG1,19,Sicilia,Sicilia,4999891,5267085,105.34,0.5
4117,2021-03-12,SIC,12894,5574,7320,10663,2071,160,ITG,ITG1,19,Sicilia,Sicilia,4999891,5279979,105.6,0.26
4118,2021-08-25,SIC,21833,10844,10989,9975,11497,361,ITG,ITG1,19,Sicilia,Sicilia,4999891,5301812,106.04,0.44
4119,2021-06-29,SIC,31459,14737,16722,15726,15326,407,ITG,ITG1,19,Sicilia,Sicilia,4999891,5333271,106.67,0.63
4120,2021-05-16,SIC,33720,16445,17275,21893,11527,300,ITG,ITG1,19,Sicilia,Sicilia,4999891,5366991,107.34,0.67
4121,2021-05-02,SIC,24619,11435,13184,17697,6605,317,ITG,ITG1,19,Sicilia,Sicilia,4999891,5391610,107.83,0.49
4122,2021-03-20,SIC,18605,8987,9618,13366,5144,95,ITG,ITG1,19,Sicilia,Sicilia,4999891,5410215,108.21,0.37
4123,2021-08-24,SIC,23742,11765,11977,10975,12399,368,ITG,ITG1,19,Sicilia,Sicilia,4999891,5433957,108.68,0.47
4124,2021-06-28,SIC,31943,14878,17065,14906,16743,294,ITG,ITG1,19,Sicilia,Sicilia,4999891,5465900,109.32,0.64
4125,2021-07-05,SIC,37543,17621,19922,8913,28389,241,ITG,ITG1,19,Sicilia,Sicilia,4999891,5503443,110.07,0.75
4126,2021-06-21,SIC,40252,18633,21619,18419,21504,329,ITG,ITG1,19,Sicilia,Sicilia,4999891,5543695,110.88,0.81
4127,2021-05-09,SIC,28442,13323,15119,19765,8299,378,ITG,ITG1,19,Sicilia,Sicilia,4999891,5572137,111.45,0.57
4128,2021-08-17,SIC,18570,9498,9072,10106,8138,326,ITG,ITG1,19,Sicilia,Sicilia,4999891,5590707,111.82,0.37
4129,2021-09-04,SIC,18295,9850,8445,8347,9604,344,ITG,ITG1,19,Sicilia,Sicilia,4999891,5609002,112.18,0.37
4130,2021-02-05,SIC,6789,3006,3783,2086,4665,38,ITG,ITG1,19,Sicilia,Sicilia,4999891,5615791,112.32,0.14
4131,2021-04-03,SIC,16420,7818,8602,13419,2837,164,ITG,ITG1,19,Sicilia,Sicilia,4999891,5632211,112.65,0.33
4132,2021-03-27,SIC,15699,7406,8293,10684,4888,127,ITG,ITG1,19,Sicilia,Sicilia,4999891,5647910,112.96,0.31
4133,2021-01-29,SIC,9186,4257,4929,404,8770,12,ITG,ITG1,19,Sicilia,Sicilia,4999891,5657096,113.14,0.18
4134,2021-02-12,SIC,4606,1829,2777,4241,286,79,ITG,ITG1,19,Sicilia,Sicilia,4999891,5661702,113.24,0.09
4135,2021-05-23,SIC,34109,16608,17501,19855,14026,228,ITG,ITG1,19,Sicilia,Sicilia,4999891,5695811,113.92,0.68
4136,2021-06-10,SIC,53058,24909,28149,45150,7252,656,ITG,ITG1,19,Sicilia,Sicilia,4999891,5748869,114.98,1.06
4137,2021-05-27,SIC,47626,21935,25691,24464,22738,424,ITG,ITG1,19,Sicilia,Sicilia,4999891,5796495,115.93,0.95
4138,2021-04-14,SIC,20585,9940,10645,11615,8774,196,ITG,ITG1,19,Sicilia,Sicilia,4999891,5817080,116.34,0.41
4139,2021-07-23,SIC,41520,20857,20663,14375,26820,325,ITG,ITG1,19,Sicilia,Sicilia,4999891,5858600,117.17,0.83
4140,2021-04-21,SIC,22400,10753,11647,15990,6127,283,ITG,ITG1,19,Sicilia,Sicilia,4999891,5881000,117.62,0.45
4141,2021-04-07,SIC,18454,9069,9385,9737,8518,199,ITG,ITG1,19,Sicilia,Sicilia,4999891,5899454,117.99,0.37
4142,2021-09-11,SIC,21347,11070,10277,7696,13271,380,ITG,ITG1,19,Sicilia,Sicilia,4999891,5920801,118.42,0.43
4143,2021-07-16,SIC,49375,23385,25990,8722,40363,290,ITG,ITG1,19,Sicilia,Sicilia,4999891,5970176,119.41,0.99
4144,2021-07-30,SIC,32507,16112,16395,12075,20144,288,ITG,ITG1,19,Sicilia,Sicilia,4999891,6002683,120.06,0.65
4145,2021-06-03,SIC,46010,21101,24909,33765,11720,525,ITG,ITG1,19,Sicilia,Sicilia,4999891,6048693,120.98,0.92
4146,2021-04-28,FVG,7343,3242,4101,3692,3515,136,ITH,ITH4,6,Friuli-Venezia Giulia,Friuli Venezia Giulia,1215220,7343,0.6,0.6
4147,2021-01-23,FVG,816,323,493,5,811,0,ITH,ITH4,6,Friuli-Venezia Giulia,Friuli Venezia Giulia,1215220,8159,0.67,0.07
4148,2021-01-30,FVG,2285,745,1540,270,2015,0,ITH,ITH4,6,Friuli-Venezia Giulia,Friuli Venezia Giulia,1215220,10444,0.86,0.19
4149,2021-07-13,FVG,11088,5715,5373,1172,9765,151,ITH,ITH4,6,Friuli-Venezia Giulia,Friuli Venezia Giulia,1215220,21532,1.77,0.91
4150,2021-08-29,FVG,3156,1779,1377,1797,1259,100,ITH,ITH4,6,Friuli-Venezia Giulia,Friuli Venezia Giulia,1215220,24688,2.03,0.26
4151,2021-06-24,FVG,11124,5675,5449,1897,9116,111,ITH,ITH4,6,Friuli-Venezia Giulia,Friuli Venezia Giulia,1215220,35812,2.95,0.92
4152,2021-03-16,FVG,3193,1302,1891,1023,2085,85,ITH,ITH4,6,Friuli-Venezia Giulia,Friuli Venezia Giulia,1215220,39005,3.21,0.26
4153,2021-08-20,FVG,6293,3556,2737,2721,3306,266,ITH,ITH4,6,Friuli-Venezia Giulia,Friuli Venezia Giulia,1215220,45298,3.73,0.52
4154,2021-05-12,FVG,11198,5179,6019,9348,1433,417,ITH,ITH4,6,Friuli-Venezia Giulia,Friuli Venezia Giulia,1215220,56496,4.65,0.92
4155,2021-07-20,FVG,9411,4932,4479,2448,6667,296,ITH,ITH4,6,Friuli-Venezia Giulia,Friuli Venezia Giulia,1215220,65907,5.42,0.77
4156,2021-08-03,FVG,10193,5371,4822,5274,4558,361,ITH,ITH4,6,Friuli-Venezia Giulia,Friuli Venezia Giulia,1215220,76100,6.26,0.84
4157,2021-04-11,FVG,3435,1519,1916,2414,907,114,ITH,ITH4,6,Friuli-Venezia Giulia,Friuli Venezia Giulia,1215220,79535,6.54,0.28
4158,2021-09-15,FVG,817,406,411,417,355,45,ITH,ITH4,6,Friuli-Venezia Giulia,Friuli Venezia Giulia,1215220,80352,6.61,0.07
4159,2021-06-07,FVG,9231,4787,4444,7843,1001,387,ITH,ITH4,6,Friuli-Venezia Giulia,Friuli Venezia Giulia,1215220,89583,7.37,0.76
4160,2020-12-28,FVG,1,0,1,1,0,0,ITH,ITH4,6,Friuli-Venezia Giulia,Friuli Venezia Giulia,1215220,89584,7.37,0.0
4161,2021-03-28,FVG,4947,2356,2591,4690,158,99,ITH,ITH4,6,Friuli-Venezia Giulia,Friuli Venezia Giulia,1215220,94531,7.78,0.41
4162,2021-01-18,FVG,1964,608,1356,1870,94,0,ITH,ITH4,6,Friuli-Venezia Giulia,Friuli Venezia Giulia,1215220,96495,7.94,0.16
4163,2021-01-04,FVG,1509,560,949,1509,0,0,ITH,ITH4,6,Friuli-Venezia Giulia,Friuli Venezia Giulia,1215220,98004,8.06,0.12
4164,2021-05-24,FVG,11483,5559,5924,7528,3651,304,ITH,ITH4,6,Friuli-Venezia Giulia,Friuli Venezia Giulia,1215220,109487,9.01,0.94
4165,2021-02-13,FVG,568,180,388,560,6,2,ITH,ITH4,6,Friuli-Venezia Giulia,Friuli Venezia Giulia,1215220,110055,9.06,0.05
4166,2021-08-15,FVG,1,1,0,0,1,0,ITH,ITH4,6,Friuli-Venezia Giulia,Friuli Venezia Giulia,1215220,110056,9.06,0.0
4167,2021-03-02,FVG,4224,1520,2704,2702,1500,22,ITH,ITH4,6,Friuli-Venezia Giulia,Friuli Venezia Giulia,1215220,114280,9.4,0.35
4168,2021-09-03,FVG,4047,2102,1945,2041,1740,266,ITH,ITH4,6,Friuli-Venezia Giulia,Friuli Venezia Giulia,1215220,118327,9.74,0.33
4169,2021-03-04,FVG,3461,1601,1860,2771,661,29,ITH,ITH4,6,Friuli-Venezia Giulia,Friuli Venezia Giulia,1215220,121788,10.02,0.28
4170,2021-06-12,FVG,8238,4721,3517,6788,1162,288,ITH,ITH4,6,Friuli-Venezia Giulia,Friuli Venezia Giulia,1215220,130026,10.7,0.68
4171,2021-02-18,FVG,3230,1503,1727,2804,408,18,ITH,ITH4,6,Friuli-Venezia Giulia,Friuli Venezia Giulia,1215220,133256,10.97,0.27
4172,2021-04-02,FVG,6611,2939,3672,4641,1841,129,ITH,ITH4,6,Friuli-Venezia Giulia,Friuli Venezia Giulia,1215220,139867,11.51,0.54
4173,2021-07-08,FVG,13120,7089,6031,1364,11575,181,ITH,ITH4,6,Friuli-Venezia Giulia,Friuli Venezia Giulia,1215220,152987,12.59,1.08
4174,2021-02-04,FVG,2728,808,1920,35,2693,0,ITH,ITH4,6,Friuli-Venezia Giulia,Friuli Venezia Giulia,1215220,155715,12.81,0.22
4175,2021-08-08,FVG,4337,2355,1982,1919,2327,91,ITH,ITH4,6,Friuli-Venezia Giulia,Friuli Venezia Giulia,1215220,160052,13.17,0.36
4176,2021-04-30,FVG,7417,3270,4147,3577,3666,174,ITH,ITH4,6,Friuli-Venezia Giulia,Friuli Venezia Giulia,1215220,167469,13.78,0.61
4177,2021-05-05,FVG,9806,4280,5526,6083,3479,244,ITH,ITH4,6,Friuli-Venezia Giulia,Friuli Venezia Giulia,1215220,177275,14.59,0.81
4178,2021-01-25,FVG,1595,571,1024,200,1395,0,ITH,ITH4,6,Friuli-Venezia Giulia,Friuli Venezia Giulia,1215220,178870,14.72,0.13
4179,2021-07-01,FVG,12394,6450,5944,2639,9497,258,ITH,ITH4,6,Friuli-Venezia Giulia,Friuli Venezia Giulia,1215220,191264,15.74,1.02
4180,2021-03-23,FVG,3909,1697,2212,1743,2145,21,ITH,ITH4,6,Friuli-Venezia Giulia,Friuli Venezia Giulia,1215220,195173,16.06,0.32
4181,2021-01-16,FVG,1232,362,870,1232,0,0,ITH,ITH4,6,Friuli-Venezia Giulia,Friuli Venezia Giulia,1215220,196405,16.16,0.1
4182,2021-04-04,FVG,4,2,2,2,2,0,ITH,ITH4,6,Friuli-Venezia Giulia,Friuli Venezia Giulia,1215220,196409,16.16,0.0
4183,2021-06-26,FVG,10397,5305,5092,4118,6177,102,ITH,ITH4,6,Friuli-Venezia Giulia,Friuli Venezia Giulia,1215220,206806,17.02,0.86
4184,2021-04-21,FVG,7785,3471,4314,4020,3684,81,ITH,ITH4,6,Friuli-Venezia Giulia,Friuli Venezia Giulia,1215220,214591,17.66,0.64
4185,2021-01-11,FVG,1895,613,1282,1894,0,1,ITH,ITH4,6,Friuli-Venezia Giulia,Friuli Venezia Giulia,1215220,216486,17.81,0.16
4186,2021-07-15,FVG,10097,5143,4954,946,8907,244,ITH,ITH4,6,Friuli-Venezia Giulia,Friuli Venezia Giulia,1215220,226583,18.65,0.83
4187,2021-04-23,FVG,7563,3428,4135,3521,3902,140,ITH,ITH4,6,Friuli-Venezia Giulia,Friuli Venezia Giulia,1215220,234146,19.27,0.62
4188,2021-08-01,FVG,3601,1928,1673,1478,1875,248,ITH,ITH4,6,Friuli-Venezia Giulia,Friuli Venezia Giulia,1215220,237747,19.56,0.3
4189,2021-08-22,FVG,2061,1180,881,788,1236,37,ITH,ITH4,6,Friuli-Venezia Giulia,Friuli Venezia Giulia,1215220,239808,19.73,0.17
4190,2021-05-19,FVG,12137,5993,6144,9324,2375,438,ITH,ITH4,6,Friuli-Venezia Giulia,Friuli Venezia Giulia,1215220,251945,20.73,1.0
4191,2021-03-14,FVG,1403,554,849,1124,252,27,ITH,ITH4,6,Friuli-Venezia Giulia,Friuli Venezia Giulia,1215220,253348,20.85,0.12
4192,2021-09-08,FVG,3194,1821,1373,1466,1551,177,ITH,ITH4,6,Friuli-Venezia Giulia,Friuli Venezia Giulia,1215220,256542,21.11,0.26
4193,2021-05-31,FVG,8960,4449,4511,6474,2230,256,ITH,ITH4,6,Friuli-Venezia Giulia,Friuli Venezia Giulia,1215220,265502,21.85,0.74
4194,2021-07-27,FVG,9527,4794,4733,2650,6651,226,ITH,ITH4,6,Friuli-Venezia Giulia,Friuli Venezia Giulia,1215220,275029,22.63,0.78
4195,2021-02-06,FVG,1155,339,816,21,1133,1,ITH,ITH4,6,Friuli-Venezia Giulia,Friuli Venezia Giulia,1215220,276184,22.73,0.1
4196,2021-02-23,FVG,2651,1281,1370,2463,181,7,ITH,ITH4,6,Friuli-Venezia Giulia,Friuli Venezia Giulia,1215220,278835,22.95,0.22
4197,2021-05-17,FVG,8848,4111,4737,6076,2498,274,ITH,ITH4,6,Friuli-Venezia Giulia,Friuli Venezia Giulia,1215220,287683,23.67,0.73
4198,2021-03-09,FVG,4024,1730,2294,1243,2756,25,ITH,ITH4,6,Friuli-Venezia Giulia,Friuli Venezia Giulia,1215220,291707,24.0,0.33
4199,2021-04-16,FVG,7016,3054,3962,4938,1942,136,ITH,ITH4,6,Friuli-Venezia Giulia,Friuli Venezia Giulia,1215220,298723,24.58,0.58
4200,2021-01-06,FVG,716,265,451,716,0,0,ITH,ITH4,6,Friuli-Venezia Giulia,Friuli Venezia Giulia,1215220,299439,24.64,0.06
4201,2021-02-11,FVG,1969,679,1290,1740,225,4,ITH,ITH4,6,Friuli-Venezia Giulia,Friuli Venezia Giulia,1215220,301408,24.8,0.16
4202,2021-04-09,FVG,8056,3737,4319,6576,1305,175,ITH,ITH4,6,Friuli-Venezia Giulia,Friuli Venezia Giulia,1215220,309464,25.47,0.66
4203,2021-03-21,FVG,2676,1003,1673,2214,410,52,ITH,ITH4,6,Friuli-Venezia Giulia,Friuli Venezia Giulia,1215220,312140,25.69,0.22
4204,2021-08-27,FVG,6173,3324,2849,1394,4567,212,ITH,ITH4,6,Friuli-Venezia Giulia,Friuli Venezia Giulia,1215220,318313,26.19,0.51
4205,2021-06-19,FVG,8575,4469,4106,1352,7157,66,ITH,ITH4,6,Friuli-Venezia Giulia,Friuli Venezia Giulia,1215220,326888,26.9,0.71
4206,2021-09-10,FVG,3931,2179,1752,656,3164,111,ITH,ITH4,6,Friuli-Venezia Giulia,Friuli Venezia Giulia,1215220,330819,27.22,0.32
4207,2021-07-03,FVG,11432,6096,5336,1098,10186,148,ITH,ITH4,6,Friuli-Venezia Giulia,Friuli Venezia Giulia,1215220,342251,28.16,0.94
4208,2021-03-25,FVG,5548,2435,3113,3333,2140,75,ITH,ITH4,6,Friuli-Venezia Giulia,Friuli Venezia Giulia,1215220,347799,28.62,0.46
4209,2021-03-30,FVG,7623,3407,4216,6287,1201,135,ITH,ITH4,6,Friuli-Venezia Giulia,Friuli Venezia Giulia,1215220,355422,29.25,0.63
4210,2021-06-09,FVG,11369,5984,5385,9485,1400,484,ITH,ITH4,6,Friuli-Venezia Giulia,Friuli Venezia Giulia,1215220,366791,30.18,0.94
4211,2021-04-08,FVG,7472,3236,4236,5407,1930,135,ITH,ITH4,6,Friuli-Venezia Giulia,Friuli Venezia Giulia,1215220,374263,30.8,0.61
4212,2021-05-21,FVG,11294,5045,6249,7913,3034,347,ITH,ITH4,6,Friuli-Venezia Giulia,Friuli Venezia Giulia,1215220,385557,31.73,0.93
4213,2021-02-10,FVG,1353,499,854,1265,88,0,ITH,ITH4,6,Friuli-Venezia Giulia,Friuli Venezia Giulia,1215220,386910,31.84,0.11
4214,2021-07-17,FVG,7392,3967,3425,620,6688,84,ITH,ITH4,6,Friuli-Venezia Giulia,Friuli Venezia Giulia,1215220,394302,32.45,0.61
4215,2021-02-01,FVG,2107,690,1417,17,2090,0,ITH,ITH4,6,Friuli-Venezia Giulia,Friuli Venezia Giulia,1215220,396409,32.62,0.17
4216,2021-08-31,FVG,7554,4043,3511,1351,6009,194,ITH,ITH4,6,Friuli-Venezia Giulia,Friuli Venezia Giulia,1215220,403963,33.24,0.62
4217,2021-09-12,FVG,2362,1264,1098,1433,845,84,ITH,ITH4,6,Friuli-Venezia Giulia,Friuli Venezia Giulia,1215220,406325,33.44,0.19
4218,2021-06-04,FVG,12172,6238,5934,10268,1454,450,ITH,ITH4,6,Friuli-Venezia Giulia,Friuli Venezia Giulia,1215220,418497,34.44,1.0
4219,2021-07-05,FVG,9599,4883,4716,1320,8136,143,ITH,ITH4,6,Friuli-Venezia Giulia,Friuli Venezia Giulia,1215220,428096,35.23,0.79
4220,2021-06-21,FVG,9220,4510,4710,1828,7254,138,ITH,ITH4,6,Friuli-Venezia Giulia,Friuli Venezia Giulia,1215220,437316,35.99,0.76
4221,2021-03-13,FVG,2947,1124,1823,1660,1274,13,ITH,ITH4,6,Friuli-Venezia Giulia,Friuli Venezia Giulia,1215220,440263,36.23,0.24
4222,2021-02-27,FVG,3542,1206,2336,3524,1,17,ITH,ITH4,6,Friuli-Venezia Giulia,Friuli Venezia Giulia,1215220,443805,36.52,0.29
4223,2021-04-25,FVG,2382,992,1390,2188,13,181,ITH,ITH4,6,Friuli-Venezia Giulia,Friuli Venezia Giulia,1215220,446187,36.72,0.2
4224,2021-01-01,FVG,2,2,0,2,0,0,ITH,ITH4,6,Friuli-Venezia Giulia,Friuli Venezia Giulia,1215220,446189,36.72,0.0
4225,2021-01-15,FVG,2021,605,1416,2020,0,1,ITH,ITH4,6,Friuli-Venezia Giulia,Friuli Venezia Giulia,1215220,448210,36.88,0.17
4226,2021-04-18,FVG,6064,2814,3250,5420,410,234,ITH,ITH4,6,Friuli-Venezia Giulia,Friuli Venezia Giulia,1215220,454274,37.38,0.5
4227,2021-01-08,FVG,2344,751,1593,2344,0,0,ITH,ITH4,6,Friuli-Venezia Giulia,Friuli Venezia Giulia,1215220,456618,37.57,0.19
4228,2021-06-14,FVG,10323,5012,5311,5188,4838,297,ITH,ITH4,6,Friuli-Venezia Giulia,Friuli Venezia Giulia,1215220,466941,38.42,0.85
4229,2021-02-20,FVG,2079,941,1138,1932,144,3,ITH,ITH4,6,Friuli-Venezia Giulia,Friuli Venezia Giulia,1215220,469020,38.6,0.17
4230,2021-01-22,FVG,117,56,61,28,89,0,ITH,ITH4,6,Friuli-Venezia Giulia,Friuli Venezia Giulia,1215220,469137,38.61,0.01
4231,2021-03-06,FVG,3513,1201,2312,3154,327,32,ITH,ITH4,6,Friuli-Venezia Giulia,Friuli Venezia Giulia,1215220,472650,38.89,0.29
4232,2021-07-10,FVG,8806,4545,4261,142,8638,26,ITH,ITH4,6,Friuli-Venezia Giulia,Friuli Venezia Giulia,1215220,481456,39.62,0.72
4233,2021-04-01,FVG,6435,3074,3361,5327,1018,90,ITH,ITH4,6,Friuli-Venezia Giulia,Friuli Venezia Giulia,1215220,487891,40.15,0.53
4234,2021-09-05,FVG,2717,1474,1243,1310,1313,94,ITH,ITH4,6,Friuli-Venezia Giulia,Friuli Venezia Giulia,1215220,490608,40.37,0.22
4235,2021-05-28,FVG,10661,5109,5552,6231,4145,285,ITH,ITH4,6,Friuli-Venezia Giulia,Friuli Venezia Giulia,1215220,501269,41.25,0.88
4236,2021-09-07,FVG,3110,1674,1436,1216,1701,193,ITH,ITH4,6,Friuli-Venezia Giulia,Friuli Venezia Giulia,1215220,504379,41.51,0.26
4237,2021-07-12,FVG,10041,5157,4884,1110,8775,156,ITH,ITH4,6,Friuli-Venezia Giulia,Friuli Venezia Giulia,1215220,514420,42.33,0.83
4238,2021-01-27,FVG,1273,427,846,450,821,2,ITH,ITH4,6,Friuli-Venezia Giulia,Friuli Venezia Giulia,1215220,515693,42.44,0.1
4239,2021-05-07,FVG,10948,5012,5936,7184,3563,201,ITH,ITH4,6,Friuli-Venezia Giulia,Friuli Venezia Giulia,1215220,526641,43.34,0.9
4240,2021-05-09,FVG,7387,3317,4070,3373,3877,137,ITH,ITH4,6,Friuli-Venezia Giulia,Friuli Venezia Giulia,1215220,534028,43.94,0.61
4241,2021-07-31,FVG,7369,3787,3582,1271,6008,90,ITH,ITH4,6,Friuli-Venezia Giulia,Friuli Venezia Giulia,1215220,541397,44.55,0.61
4242,2021-08-17,FVG,3638,1959,1679,2808,601,229,ITH,ITH4,6,Friuli-Venezia Giulia,Friuli Venezia Giulia,1215220,545035,44.85,0.3
4243,2021-05-26,FVG,13472,6728,6744,9647,3467,358,ITH,ITH4,6,Friuli-Venezia Giulia,Friuli Venezia Giulia,1215220,558507,45.96,1.11
4244,2021-02-15,FVG,2461,914,1547,2201,254,6,ITH,ITH4,6,Friuli-Venezia Giulia,Friuli Venezia Giulia,1215220,560968,46.16,0.2
4245,2021-03-11,FVG,3484,1520,1964,1715,1754,15,ITH,ITH4,6,Friuli-Venezia Giulia,Friuli Venezia Giulia,1215220,564452,46.45,0.29
4246,2021-04-13,FVG,7397,3299,4098,5657,1612,128,ITH,ITH4,6,Friuli-Venezia Giulia,Friuli Venezia Giulia,1215220,571849,47.06,0.61
4247,2021-01-03,FVG,313,123,190,313,0,0,ITH,ITH4,6,Friuli-Venezia Giulia,Friuli Venezia Giulia,1215220,572162,47.08,0.03
4248,2021-07-22,FVG,7724,4107,3617,3273,4148,303,ITH,ITH4,6,Friuli-Venezia Giulia,Friuli Venezia Giulia,1215220,579886,47.72,0.64
4249,2021-07-24,FVG,6172,3337,2835,2918,3080,174,ITH,ITH4,6,Friuli-Venezia Giulia,Friuli Venezia Giulia,1215220,586058,48.23,0.51
4250,2021-08-24,FVG,6638,3583,3055,754,5753,131,ITH,ITH4,6,Friuli-Venezia Giulia,Friuli Venezia Giulia,1215220,592696,48.77,0.55
4251,2021-08-10,FVG,7317,4080,3237,5299,1658,360,ITH,ITH4,6,Friuli-Venezia Giulia,Friuli Venezia Giulia,1215220,600013,49.37,0.6
4252,2021-05-02,FVG,6917,3257,3660,3810,2964,143,ITH,ITH4,6,Friuli-Venezia Giulia,Friuli Venezia Giulia,1215220,606930,49.94,0.57
4253,2021-05-16,FVG,10028,4803,5225,8376,1407,245,ITH,ITH4,6,Friuli-Venezia Giulia,Friuli Venezia Giulia,1215220,616958,50.77,0.83
4254,2021-05-14,FVG,10866,5400,5466,7927,2639,300,ITH,ITH4,6,Friuli-Venezia Giulia,Friuli Venezia Giulia,1215220,627824,51.66,0.89
4255,2021-02-03,FVG,2650,792,1858,22,2627,1,ITH,ITH4,6,Friuli-Venezia Giulia,Friuli Venezia Giulia,1215220,630474,51.88,0.22
4256,2021-02-08,FVG,2361,697,1664,90,2270,1,ITH,ITH4,6,Friuli-Venezia Giulia,Friuli Venezia Giulia,1215220,632835,52.08,0.19
4257,2021-03-01,FVG,2970,1045,1925,2892,53,25,ITH,ITH4,6,Friuli-Venezia Giulia,Friuli Venezia Giulia,1215220,635805,52.32,0.24
4258,2021-03-18,FVG,3378,1424,1954,1684,1686,8,ITH,ITH4,6,Friuli-Venezia Giulia,Friuli Venezia Giulia,1215220,639183,52.6,0.28
4259,2021-06-28,FVG,9926,5002,4924,2122,7713,91,ITH,ITH4,6,Friuli-Venezia Giulia,Friuli Venezia Giulia,1215220,649109,53.41,0.82
4260,2021-03-20,FVG,3410,1414,1996,1300,2096,14,ITH,ITH4,6,Friuli-Venezia Giulia,Friuli Venezia Giulia,1215220,652519,53.7,0.28
4261,2021-01-13,FVG,2657,837,1820,2656,0,1,ITH,ITH4,6,Friuli-Venezia Giulia,Friuli Venezia Giulia,1215220,655176,53.91,0.22
4262,2021-04-06,FVG,6691,3142,3549,5426,1157,108,ITH,ITH4,6,Friuli-Venezia Giulia,Friuli Venezia Giulia,1215220,661867,54.46,0.55
4263,2020-12-27,FVG,262,149,113,261,0,1,ITH,ITH4,6,Friuli-Venezia Giulia,Friuli Venezia Giulia,1215220,662129,54.49,0.02
4264,2021-02-12,FVG,1195,428,767,1142,49,4,ITH,ITH4,6,Friuli-Venezia Giulia,Friuli Venezia Giulia,1215220,663324,54.58,0.1
4265,2021-08-14,FVG,206,151,55,188,4,14,ITH,ITH4,6,Friuli-Venezia Giulia,Friuli Venezia Giulia,1215220,663530,54.6,0.02
4266,2021-08-28,FVG,2895,1574,1321,1776,961,158,ITH,ITH4,6,Friuli-Venezia Giulia,Friuli Venezia Giulia,1215220,666425,54.84,0.24
4267,2021-05-06,FVG,11981,5570,6411,7714,3987,280,ITH,ITH4,6,Friuli-Venezia Giulia,Friuli Venezia Giulia,1215220,678406,55.83,0.99
4268,2021-07-02,FVG,11115,5747,5368,2115,8808,192,ITH,ITH4,6,Friuli-Venezia Giulia,Friuli Venezia Giulia,1215220,689521,56.74,0.91
4269,2021-02-19,FVG,3301,1320,1981,2842,442,17,ITH,ITH4,6,Friuli-Venezia Giulia,Friuli Venezia Giulia,1215220,692822,57.01,0.27
4270,2021-09-14,FVG,3220,1679,1541,644,2478,98,ITH,ITH4,6,Friuli-Venezia Giulia,Friuli Venezia Giulia,1215220,696042,57.28,0.26
4271,2021-07-29,FVG,9614,4903,4711,3231,6089,294,ITH,ITH4,6,Friuli-Venezia Giulia,Friuli Venezia Giulia,1215220,705656,58.07,0.79
4272,2021-04-20,FVG,7147,3079,4068,3097,3920,130,ITH,ITH4,6,Friuli-Venezia Giulia,Friuli Venezia Giulia,1215220,712803,58.66,0.59
4273,2021-01-10,FVG,2943,919,2024,2943,0,0,ITH,ITH4,6,Friuli-Venezia Giulia,Friuli Venezia Giulia,1215220,715746,58.9,0.24
4274,2021-07-14,FVG,10912,5582,5330,1256,9463,193,ITH,ITH4,6,Friuli-Venezia Giulia,Friuli Venezia Giulia,1215220,726658,59.8,0.9
4275,2021-04-05,FVG,2912,1449,1463,2832,16,64,ITH,ITH4,6,Friuli-Venezia Giulia,Friuli Venezia Giulia,1215220,729570,60.04,0.24
4276,2021-01-12,FVG,2273,719,1554,2273,0,0,ITH,ITH4,6,Friuli-Venezia Giulia,Friuli Venezia Giulia,1215220,731843,60.22,0.19
4277,2021-01-29,FVG,2419,815,1604,266,2153,0,ITH,ITH4,6,Friuli-Venezia Giulia,Friuli Venezia Giulia,1215220,734262,60.42,0.2
4278,2021-04-22,FVG,6802,3093,3709,3034,3696,72,ITH,ITH4,6,Friuli-Venezia Giulia,Friuli Venezia Giulia,1215220,741064,60.98,0.56
4279,2021-01-20,FVG,754,322,432,18,736,0,ITH,ITH4,6,Friuli-Venezia Giulia,Friuli Venezia Giulia,1215220,741818,61.04,0.06
4280,2021-02-22,FVG,2494,1199,1295,2070,419,5,ITH,ITH4,6,Friuli-Venezia Giulia,Friuli Venezia Giulia,1215220,744312,61.25,0.21
4281,2021-06-02,FVG,9430,4964,4466,8814,282,334,ITH,ITH4,6,Friuli-Venezia Giulia,Friuli Venezia Giulia,1215220,753742,62.03,0.78
4282,2021-08-09,FVG,7838,4194,3644,2371,5283,184,ITH,ITH4,6,Friuli-Venezia Giulia,Friuli Venezia Giulia,1215220,761580,62.67,0.64
4283,2021-02-07,FVG,1568,482,1086,384,1183,1,ITH,ITH4,6,Friuli-Venezia Giulia,Friuli Venezia Giulia,1215220,763148,62.8,0.13
4284,2021-09-09,FVG,3724,1962,1762,1828,1674,222,ITH,ITH4,6,Friuli-Venezia Giulia,Friuli Venezia Giulia,1215220,766872,63.11,0.31
4285,2021-08-26,FVG,7471,4043,3428,1406,5830,235,ITH,ITH4,6,Friuli-Venezia Giulia,Friuli Venezia Giulia,1215220,774343,63.72,0.61
4286,2021-05-18,FVG,10866,5435,5431,8402,2102,362,ITH,ITH4,6,Friuli-Venezia Giulia,Friuli Venezia Giulia,1215220,785209,64.61,0.89
4287,2021-06-01,FVG,10147,5133,5014,7694,2129,324,ITH,ITH4,6,Friuli-Venezia Giulia,Friuli Venezia Giulia,1215220,795356,65.45,0.83
4288,2021-06-18,FVG,10981,5422,5559,3401,7312,268,ITH,ITH4,6,Friuli-Venezia Giulia,Friuli Venezia Giulia,1215220,806337,66.35,0.9
4289,2021-03-10,FVG,3602,1711,1891,1744,1796,62,ITH,ITH4,6,Friuli-Venezia Giulia,Friuli Venezia Giulia,1215220,809939,66.65,0.3
4290,2021-02-24,FVG,2532,1093,1439,2503,18,11,ITH,ITH4,6,Friuli-Venezia Giulia,Friuli Venezia Giulia,1215220,812471,66.86,0.21
4291,2021-03-27,FVG,5383,2922,2461,3923,1412,48,ITH,ITH4,6,Friuli-Venezia Giulia,Friuli Venezia Giulia,1215220,817854,67.3,0.44
4292,2021-04-15,FVG,6527,2886,3641,5092,1275,160,ITH,ITH4,6,Friuli-Venezia Giulia,Friuli Venezia Giulia,1215220,824381,67.84,0.54
4293,2021-04-29,FVG,6809,2998,3811,4014,2607,188,ITH,ITH4,6,Friuli-Venezia Giulia,Friuli Venezia Giulia,1215220,831190,68.4,0.56
4294,2021-01-05,FVG,1679,552,1127,1677,0,2,ITH,ITH4,6,Friuli-Venezia Giulia,Friuli Venezia Giulia,1215220,832869,68.54,0.14
4295,2021-08-07,FVG,4840,2614,2226,2778,1932,130,ITH,ITH4,6,Friuli-Venezia Giulia,Friuli Venezia Giulia,1215220,837709,68.93,0.4
4296,2021-08-02,FVG,9035,4642,4393,2864,5915,256,ITH,ITH4,6,Friuli-Venezia Giulia,Friuli Venezia Giulia,1215220,846744,69.68,0.74
4297,2021-09-02,FVG,6954,3770,3184,1921,4793,240,ITH,ITH4,6,Friuli-Venezia Giulia,Friuli Venezia Giulia,1215220,853698,70.25,0.57
4298,2021-05-25,FVG,12962,6407,6555,9287,3328,347,ITH,ITH4,6,Friuli-Venezia Giulia,Friuli Venezia Giulia,1215220,866660,71.32,1.07
4299,2021-08-16,FVG,4819,2593,2226,2695,1876,248,ITH,ITH4,6,Friuli-Venezia Giulia,Friuli Venezia Giulia,1215220,871479,71.71,0.4
4300,2021-06-11,FVG,10945,5968,4977,9631,839,475,ITH,ITH4,6,Friuli-Venezia Giulia,Friuli Venezia Giulia,1215220,882424,72.61,0.9
4301,2021-03-03,FVG,3657,1642,2015,2350,1277,30,ITH,ITH4,6,Friuli-Venezia Giulia,Friuli Venezia Giulia,1215220,886081,72.92,0.3
4302,2021-09-04,FVG,2796,1514,1282,1602,994,200,ITH,ITH4,6,Friuli-Venezia Giulia,Friuli Venezia Giulia,1215220,888877,73.15,0.23
4303,2021-06-13,FVG,8716,4538,4178,5168,3330,218,ITH,ITH4,6,Friuli-Venezia Giulia,Friuli Venezia Giulia,1215220,897593,73.86,0.72
4304,2021-07-26,FVG,8562,4269,4293,1775,6574,213,ITH,ITH4,6,Friuli-Venezia Giulia,Friuli Venezia Giulia,1215220,906155,74.57,0.7
4305,2021-04-17,FVG,7469,3240,4229,5818,1484,167,ITH,ITH4,6,Friuli-Venezia Giulia,Friuli Venezia Giulia,1215220,913624,75.18,0.61
4306,2021-07-28,FVG,10504,5358,5146,4012,6043,449,ITH,ITH4,6,Friuli-Venezia Giulia,Friuli Venezia Giulia,1215220,924128,76.05,0.86
4307,2021-07-19,FVG,9446,4939,4507,852,8440,154,ITH,ITH4,6,Friuli-Venezia Giulia,Friuli Venezia Giulia,1215220,933574,76.82,0.78
4308,2021-06-25,FVG,11009,5533,5476,2370,8564,75,ITH,ITH4,6,Friuli-Venezia Giulia,Friuli Venezia Giulia,1215220,944583,77.73,0.91
4309,2021-07-09,FVG,11960,6355,5605,2124,9545,291,ITH,ITH4,6,Friuli-Venezia Giulia,Friuli Venezia Giulia,1215220,956543,78.71,0.98
4310,2021-03-17,FVG,3242,1270,1972,736,2496,10,ITH,ITH4,6,Friuli-Venezia Giulia,Friuli Venezia Giulia,1215220,959785,78.98,0.27
4311,2021-08-21,FVG,2897,1559,1338,283,2574,40,ITH,ITH4,6,Friuli-Venezia Giulia,Friuli Venezia Giulia,1215220,962682,79.22,0.24
4312,2021-05-13,FVG,11226,5428,5798,8743,2081,402,ITH,ITH4,6,Friuli-Venezia Giulia,Friuli Venezia Giulia,1215220,973908,80.14,0.92
4313,2021-02-16,FVG,2518,1136,1382,2398,116,4,ITH,ITH4,6,Friuli-Venezia Giulia,Friuli Venezia Giulia,1215220,976426,80.35,0.21
4314,2021-03-24,FVG,3988,1727,2261,2465,1485,38,ITH,ITH4,6,Friuli-Venezia Giulia,Friuli Venezia Giulia,1215220,980414,80.68,0.33
4315,2021-05-20,FVG,12736,6336,6400,9795,2532,409,ITH,ITH4,6,Friuli-Venezia Giulia,Friuli Venezia Giulia,1215220,993150,81.73,1.05
4316,2021-04-24,FVG,6693,2952,3741,5207,1245,241,ITH,ITH4,6,Friuli-Venezia Giulia,Friuli Venezia Giulia,1215220,999843,82.28,0.55
4317,2021-06-06,FVG,9505,4637,4868,7642,1568,295,ITH,ITH4,6,Friuli-Venezia Giulia,Friuli Venezia Giulia,1215220,1009348,83.06,0.78
4318,2021-02-26,FVG,3785,2131,1654,3582,171,32,ITH,ITH4,6,Friuli-Venezia Giulia,Friuli Venezia Giulia,1215220,1013133,83.37,0.31
4319,2021-02-17,FVG,2365,1006,1359,1873,489,3,ITH,ITH4,6,Friuli-Venezia Giulia,Friuli Venezia Giulia,1215220,1015498,83.56,0.19
4320,2021-05-30,FVG,11080,4998,6082,7237,3595,248,ITH,ITH4,6,Friuli-Venezia Giulia,Friuli Venezia Giulia,1215220,1026578,84.48,0.91
4321,2021-08-06,FVG,6461,3397,3064,2362,3932,167,ITH,ITH4,6,Friuli-Venezia Giulia,Friuli Venezia Giulia,1215220,1033039,85.01,0.53
4322,2021-08-11,FVG,7941,4194,3747,5233,2374,334,ITH,ITH4,6,Friuli-Venezia Giulia,Friuli Venezia Giulia,1215220,1040980,85.66,0.65
4323,2021-05-03,FVG,7257,3303,3954,3347,3793,117,ITH,ITH4,6,Friuli-Venezia Giulia,Friuli Venezia Giulia,1215220,1048237,86.26,0.6
4324,2021-06-20,FVG,6528,3240,3288,1488,4940,100,ITH,ITH4,6,Friuli-Venezia Giulia,Friuli Venezia Giulia,1215220,1054765,86.8,0.54
4325,2021-03-29,FVG,7040,3134,3906,5374,1590,76,ITH,ITH4,6,Friuli-Venezia Giulia,Friuli Venezia Giulia,1215220,1061805,87.38,0.58
4326,2021-07-07,FVG,11328,5800,5528,1449,9751,128,ITH,ITH4,6,Friuli-Venezia Giulia,Friuli Venezia Giulia,1215220,1073133,88.31,0.93
4327,2021-07-21,FVG,8654,4384,4270,2045,6348,261,ITH,ITH4,6,Friuli-Venezia Giulia,Friuli Venezia Giulia,1215220,1081787,89.02,0.71
4328,2021-02-05,FVG,2632,792,1840,89,2543,0,ITH,ITH4,6,Friuli-Venezia Giulia,Friuli Venezia Giulia,1215220,1084419,89.24,0.22
4329,2021-04-14,FVG,7256,3135,4121,5412,1719,125,ITH,ITH4,6,Friuli-Venezia Giulia,Friuli Venezia Giulia,1215220,1091675,89.83,0.6
4330,2021-07-06,FVG,11222,5858,5364,1351,9757,114,ITH,ITH4,6,Friuli-Venezia Giulia,Friuli Venezia Giulia,1215220,1102897,90.76,0.92
4331,2021-07-23,FVG,9062,4645,4417,3042,5594,426,ITH,ITH4,6,Friuli-Venezia Giulia,Friuli Venezia Giulia,1215220,1111959,91.5,0.75
4332,2021-04-03,FVG,4022,1994,2028,2622,1339,61,ITH,ITH4,6,Friuli-Venezia Giulia,Friuli Venezia Giulia,1215220,1115981,91.83,0.33
4333,2021-06-10,FVG,11593,6035,5558,9694,1485,414,ITH,ITH4,6,Friuli-Venezia Giulia,Friuli Venezia Giulia,1215220,1127574,92.79,0.95
4334,2021-09-01,FVG,8525,4651,3874,2092,6222,211,ITH,ITH4,6,Friuli-Venezia Giulia,Friuli Venezia Giulia,1215220,1136099,93.49,0.7
4335,2021-03-19,FVG,3279,1370,1909,1317,1947,15,ITH,ITH4,6,Friuli-Venezia Giulia,Friuli Venezia Giulia,1215220,1139378,93.76,0.27
4336,2021-06-27,FVG,7671,3832,3839,3714,3858,99,ITH,ITH4,6,Friuli-Venezia Giulia,Friuli Venezia Giulia,1215220,1147049,94.39,0.63
4337,2021-06-29,FVG,11386,5807,5579,1227,10050,109,ITH,ITH4,6,Friuli-Venezia Giulia,Friuli Venezia Giulia,1215220,1158435,95.33,0.94
4338,2021-01-26,FVG,1979,649,1330,217,1761,1,ITH,ITH4,6,Friuli-Venezia Giulia,Friuli Venezia Giulia,1215220,1160414,95.49,0.16
4339,2021-02-09,FVG,1845,555,1290,1556,288,1,ITH,ITH4,6,Friuli-Venezia Giulia,Friuli Venezia Giulia,1215220,1162259,95.64,0.15
4340,2021-02-02,FVG,2489,816,1673,218,2271,0,ITH,ITH4,6,Friuli-Venezia Giulia,Friuli Venezia Giulia,1215220,1164748,95.85,0.2
4341,2021-01-14,FVG,2593,794,1799,2590,0,3,ITH,ITH4,6,Friuli-Venezia Giulia,Friuli Venezia Giulia,1215220,1167341,96.06,0.21
4342,2021-08-13,FVG,3886,2180,1706,2722,968,196,ITH,ITH4,6,Friuli-Venezia Giulia,Friuli Venezia Giulia,1215220,1171227,96.38,0.32
4343,2021-06-08,FVG,10560,5537,5023,9629,501,430,ITH,ITH4,6,Friuli-Venezia Giulia,Friuli Venezia Giulia,1215220,1181787,97.25,0.87
4344,2021-02-28,FVG,2692,1005,1687,2269,394,29,ITH,ITH4,6,Friuli-Venezia Giulia,Friuli Venezia Giulia,1215220,1184479,97.47,0.22
4345,2021-08-04,FVG,9358,4840,4518,4675,4381,302,ITH,ITH4,6,Friuli-Venezia Giulia,Friuli Venezia Giulia,1215220,1193837,98.24,0.77
4346,2021-04-26,FVG,5494,2467,3027,3718,1656,120,ITH,ITH4,6,Friuli-Venezia Giulia,Friuli Venezia Giulia,1215220,1199331,98.69,0.45
4347,2021-07-16,FVG,9810,5240,4570,1702,7959,149,ITH,ITH4,6,Friuli-Venezia Giulia,Friuli Venezia Giulia,1215220,1209141,99.5,0.81
4348,2021-04-07,FVG,7860,3644,4216,6952,789,119,ITH,ITH4,6,Friuli-Venezia Giulia,Friuli Venezia Giulia,1215220,1217001,100.15,0.65
4349,2021-05-27,FVG,12866,6159,6707,7393,5248,225,ITH,ITH4,6,Friuli-Venezia Giulia,Friuli Venezia Giulia,1215220,1229867,101.21,1.06
4350,2021-07-30,FVG,9080,4730,4350,2774,6044,262,ITH,ITH4,6,Friuli-Venezia Giulia,Friuli Venezia Giulia,1215220,1238947,101.95,0.75
4351,2021-01-28,FVG,2250,798,1452,355,1895,0,ITH,ITH4,6,Friuli-Venezia Giulia,Friuli Venezia Giulia,1215220,1241197,102.14,0.19
4352,2021-05-08,FVG,10345,4674,5671,5359,4793,193,ITH,ITH4,6,Friuli-Venezia Giulia,Friuli Venezia Giulia,1215220,1251542,102.99,0.85
4353,2021-02-14,FVG,1,0,1,0,1,0,ITH,ITH4,6,Friuli-Venezia Giulia,Friuli Venezia Giulia,1215220,1251543,102.99,0.0
4354,2021-08-18,FVG,4720,2513,2207,3014,1473,233,ITH,ITH4,6,Friuli-Venezia Giulia,Friuli Venezia Giulia,1215220,1256263,103.38,0.39
4355,2021-05-10,FVG,8010,3558,4452,6221,1545,244,ITH,ITH4,6,Friuli-Venezia Giulia,Friuli Venezia Giulia,1215220,1264273,104.04,0.66
4356,2021-05-15,FVG,12694,6120,6574,7685,4705,304,ITH,ITH4,6,Friuli-Venezia Giulia,Friuli Venezia Giulia,1215220,1276967,105.08,1.04
4357,2021-05-01,FVG,7215,3252,3963,5909,1046,260,ITH,ITH4,6,Friuli-Venezia Giulia,Friuli Venezia Giulia,1215220,1284182,105.67,0.59
4358,2021-01-21,FVG,899,347,552,3,896,0,ITH,ITH4,6,Friuli-Venezia Giulia,Friuli Venezia Giulia,1215220,1285081,105.75,0.07
4359,2021-02-21,FVG,802,281,521,421,379,2,ITH,ITH4,6,Friuli-Venezia Giulia,Friuli Venezia Giulia,1215220,1285883,105.81,0.07
4360,2021-08-25,FVG,7849,4202,3647,3022,4463,364,ITH,ITH4,6,Friuli-Venezia Giulia,Friuli Venezia Giulia,1215220,1293732,106.46,0.65
4361,2021-06-03,FVG,12478,6767,5711,9911,2131,436,ITH,ITH4,6,Friuli-Venezia Giulia,Friuli Venezia Giulia,1215220,1306210,107.49,1.03
4362,2021-09-11,FVG,1190,672,518,607,535,48,ITH,ITH4,6,Friuli-Venezia Giulia,Friuli Venezia Giulia,1215220,1307400,107.59,0.1
4363,2021-01-19,FVG,6,2,4,6,0,0,ITH,ITH4,6,Friuli-Venezia Giulia,Friuli Venezia Giulia,1215220,1307406,107.59,0.0
4364,2021-03-31,FVG,8149,3574,4575,7173,850,126,ITH,ITH4,6,Friuli-Venezia Giulia,Friuli Venezia Giulia,1215220,1315555,108.26,0.67
4365,2021-04-10,FVG,5061,2217,2844,3753,1230,78,ITH,ITH4,6,Friuli-Venezia Giulia,Friuli Venezia Giulia,1215220,1320616,108.67,0.42
4366,2021-05-23,FVG,10296,4868,5428,5922,4157,217,ITH,ITH4,6,Friuli-Venezia Giulia,Friuli Venezia Giulia,1215220,1330912,109.52,0.85
4367,2021-07-04,FVG,9358,4797,4561,2891,6211,256,ITH,ITH4,6,Friuli-Venezia Giulia,Friuli Venezia Giulia,1215220,1340270,110.29,0.77
4368,2021-03-26,FVG,6061,2634,3427,3854,2029,178,ITH,ITH4,6,Friuli-Venezia Giulia,Friuli Venezia Giulia,1215220,1346331,110.79,0.5
4369,2021-03-12,FVG,4164,1736,2428,2753,1385,26,ITH,ITH4,6,Friuli-Venezia Giulia,Friuli Venezia Giulia,1215220,1350495,111.13,0.34
4370,2021-01-02,FVG,1217,470,747,1217,0,0,ITH,ITH4,6,Friuli-Venezia Giulia,Friuli Venezia Giulia,1215220,1351712,111.23,0.1
4371,2021-04-12,FVG,7288,3196,4092,5996,1136,156,ITH,ITH4,6,Friuli-Venezia Giulia,Friuli Venezia Giulia,1215220,1359000,111.83,0.6
4372,2021-01-07,FVG,2108,726,1382,2108,0,0,ITH,ITH4,6,Friuli-Venezia Giulia,Friuli Venezia Giulia,1215220,1361108,112.01,0.17
4373,2021-03-05,FVG,3833,1543,2290,2731,1079,23,ITH,ITH4,6,Friuli-Venezia Giulia,Friuli Venezia Giulia,1215220,1364941,112.32,0.32
4374,2021-04-19,FVG,6733,3142,3591,3212,3426,95,ITH,ITH4,6,Friuli-Venezia Giulia,Friuli Venezia Giulia,1215220,1371674,112.87,0.55
4375,2021-01-09,FVG,2534,846,1688,2533,0,1,ITH,ITH4,6,Friuli-Venezia Giulia,Friuli Venezia Giulia,1215220,1374208,113.08,0.21
4376,2021-06-15,FVG,12178,6196,5982,5351,6542,285,ITH,ITH4,6,Friuli-Venezia Giulia,Friuli Venezia Giulia,1215220,1386386,114.09,1.0
4377,2021-03-07,FVG,2557,939,1618,2496,1,60,ITH,ITH4,6,Friuli-Venezia Giulia,Friuli Venezia Giulia,1215220,1388943,114.3,0.21
4378,2020-12-31,FVG,1048,381,667,1047,0,1,ITH,ITH4,6,Friuli-Venezia Giulia,Friuli Venezia Giulia,1215220,1389991,114.38,0.09
4379,2021-06-17,FVG,11443,5790,5653,2280,9048,115,ITH,ITH4,6,Friuli-Venezia Giulia,Friuli Venezia Giulia,1215220,1401434,115.32,0.94
4380,2021-06-22,FVG,11611,5979,5632,2362,9112,137,ITH,ITH4,6,Friuli-Venezia Giulia,Friuli Venezia Giulia,1215220,1413045,116.28,0.96
4381,2020-12-30,FVG,626,244,382,626,0,0,ITH,ITH4,6,Friuli-Venezia Giulia,Friuli Venezia Giulia,1215220,1413671,116.33,0.05
4382,2021-06-05,FVG,10347,5348,4999,8396,1556,395,ITH,ITH4,6,Friuli-Venezia Giulia,Friuli Venezia Giulia,1215220,1424018,117.18,0.85
4383,2021-02-25,FVG,3178,1660,1518,3115,30,33,ITH,ITH4,6,Friuli-Venezia Giulia,Friuli Venezia Giulia,1215220,1427196,117.44,0.26
4384,2021-06-16,FVG,12205,5923,6282,3899,8040,266,ITH,ITH4,6,Friuli-Venezia Giulia,Friuli Venezia Giulia,1215220,1439401,118.45,1.0
4385,2021-08-12,FVG,7987,4282,3705,5194,2500,293,ITH,ITH4,6,Friuli-Venezia Giulia,Friuli Venezia Giulia,1215220,1447388,119.11,0.66
4386,2021-06-23,FVG,12104,5859,6245,1993,9961,150,ITH,ITH4,6,Friuli-Venezia Giulia,Friuli Venezia Giulia,1215220,1459492,120.1,1.0
4387,2021-08-19,FVG,4894,2617,2277,1739,3002,153,ITH,ITH4,6,Friuli-Venezia Giulia,Friuli Venezia Giulia,1215220,1464386,120.5,0.4
4388,2021-08-05,FVG,7146,3675,3471,3248,3695,203,ITH,ITH4,6,Friuli-Venezia Giulia,Friuli Venezia Giulia,1215220,1471532,121.09,0.59
4389,2021-04-27,FVG,8151,3742,4409,3552,4498,101,ITH,ITH4,6,Friuli-Venezia Giulia,Friuli Venezia Giulia,1215220,1479683,121.76,0.67
4390,2021-05-04,FVG,9618,4342,5276,6003,3387,228,ITH,ITH4,6,Friuli-Venezia Giulia,Friuli Venezia Giulia,1215220,1489301,122.55,0.79
4391,2021-01-24,FVG,307,121,186,2,305,0,ITH,ITH4,6,Friuli-Venezia Giulia,Friuli Venezia Giulia,1215220,1489608,122.58,0.03
4392,2021-06-30,FVG,13206,6722,6484,1386,11646,174,ITH,ITH4,6,Friuli-Venezia Giulia,Friuli Venezia Giulia,1215220,1502814,123.67,1.09
4393,2021-03-08,FVG,4135,1648,2487,2028,2092,15,ITH,ITH4,6,Friuli-Venezia Giulia,Friuli Venezia Giulia,1215220,1506949,124.01,0.34
4394,2021-03-22,FVG,3671,1455,2216,1672,1960,39,ITH,ITH4,6,Friuli-Venezia Giulia,Friuli Venezia Giulia,1215220,1510620,124.31,0.3
4395,2021-01-17,FVG,1715,522,1193,1713,0,2,ITH,ITH4,6,Friuli-Venezia Giulia,Friuli Venezia Giulia,1215220,1512335,124.45,0.14
4396,2021-03-15,FVG,3964,1814,2150,1614,2326,24,ITH,ITH4,6,Friuli-Venezia Giulia,Friuli Venezia Giulia,1215220,1516299,124.78,0.33
4397,2021-05-11,FVG,9189,4433,4756,7156,1813,220,ITH,ITH4,6,Friuli-Venezia Giulia,Friuli Venezia Giulia,1215220,1525488,125.53,0.76
4398,2021-01-31,FVG,2727,842,1885,385,2342,0,ITH,ITH4,6,Friuli-Venezia Giulia,Friuli Venezia Giulia,1215220,1528215,125.76,0.22
4399,2021-08-23,FVG,4736,2446,2290,2597,1784,355,ITH,ITH4,6,Friuli-Venezia Giulia,Friuli Venezia Giulia,1215220,1532951,126.15,0.39
4400,2021-05-29,FVG,12043,5857,6186,6780,4996,267,ITH,ITH4,6,Friuli-Venezia Giulia,Friuli Venezia Giulia,1215220,1544994,127.14,0.99
4401,2021-07-25,FVG,3900,2027,1873,1917,1876,107,ITH,ITH4,6,Friuli-Venezia Giulia,Friuli Venezia Giulia,1215220,1548894,127.46,0.32
4402,2021-07-11,FVG,6871,3589,3282,2386,4184,301,ITH,ITH4,6,Friuli-Venezia Giulia,Friuli Venezia Giulia,1215220,1555765,128.02,0.57
4403,2021-09-06,FVG,3945,2238,1707,733,3089,123,ITH,ITH4,6,Friuli-Venezia Giulia,Friuli Venezia Giulia,1215220,1559710,128.35,0.32
4404,2021-08-30,FVG,7350,3914,3436,2481,4634,235,ITH,ITH4,6,Friuli-Venezia Giulia,Friuli Venezia Giulia,1215220,1567060,128.95,0.6
4405,2021-09-13,FVG,2490,1311,1179,554,1845,91,ITH,ITH4,6,Friuli-Venezia Giulia,Friuli Venezia Giulia,1215220,1569550,129.16,0.2
4406,2021-05-22,FVG,11604,5209,6395,7087,4242,275,ITH,ITH4,6,Friuli-Venezia Giulia,Friuli Venezia Giulia,1215220,1581154,130.11,0.95
4407,2021-07-18,FVG,5471,2961,2510,439,5008,24,ITH,ITH4,6,Friuli-Venezia Giulia,Friuli Venezia Giulia,1215220,1586625,130.56,0.45
4408,2021-08-01,TOS,29934,15325,14609,13793,15654,487,ITI,ITI1,9,Toscana,Toscana,3729641,29934,0.8,0.8
4409,2021-06-05,TOS,28456,13609,14847,20559,7621,276,ITI,ITI1,9,Toscana,Toscana,3729641,58390,1.57,0.76
4410,2021-09-13,TOS,18442,9805,8637,3543,14521,378,ITI,ITI1,9,Toscana,Toscana,3729641,76832,2.06,0.49
4411,2021-08-08,TOS,25039,12922,12117,14610,9928,501,ITI,ITI1,9,Toscana,Toscana,3729641,101871,2.73,0.67
4412,2021-01-11,TOS,5185,1719,3466,5084,0,101,ITI,ITI1,9,Toscana,Toscana,3729641,107056,2.87,0.14
4413,2021-04-21,TOS,29660,12693,16967,16852,12169,639,ITI,ITI1,9,Toscana,Toscana,3729641,136716,3.67,0.8
4414,2021-02-23,TOS,7755,3337,4418,7241,162,352,ITI,ITI1,9,Toscana,Toscana,3729641,144471,3.87,0.21
4415,2021-06-03,TOS,32067,15458,16609,27153,4589,325,ITI,ITI1,9,Toscana,Toscana,3729641,176538,4.73,0.86
4416,2021-05-22,TOS,26037,12667,13370,21490,4298,249,ITI,ITI1,9,Toscana,Toscana,3729641,202575,5.43,0.7
4417,2021-05-05,TOS,30167,13466,16701,14854,14577,736,ITI,ITI1,9,Toscana,Toscana,3729641,232742,6.24,0.81
4418,2021-08-13,TOS,23116,12524,10592,11339,11231,546,ITI,ITI1,9,Toscana,Toscana,3729641,255858,6.86,0.62
4419,2021-02-28,TOS,1665,669,996,868,727,70,ITI,ITI1,9,Toscana,Toscana,3729641,257523,6.9,0.04
4420,2021-02-11,TOS,5423,2037,3386,5099,242,82,ITI,ITI1,9,Toscana,Toscana,3729641,262946,7.05,0.15
4421,2021-02-09,TOS,4534,1485,3049,3809,611,114,ITI,ITI1,9,Toscana,Toscana,3729641,267480,7.17,0.12
4422,2021-04-07,TOS,35848,15483,20365,28157,7267,424,ITI,ITI1,9,Toscana,Toscana,3729641,303328,8.13,0.96
4423,2021-08-27,TOS,16282,8705,7577,7747,8007,528,ITI,ITI1,9,Toscana,Toscana,3729641,319610,8.57,0.44
4424,2021-01-28,TOS,6288,1885,4403,349,5932,7,ITI,ITI1,9,Toscana,Toscana,3729641,325898,8.74,0.17
4425,2021-07-01,TOS,32089,15538,16551,10722,21083,284,ITI,ITI1,9,Toscana,Toscana,3729641,357987,9.6,0.86
4426,2021-03-26,TOS,20753,9435,11318,14710,5831,212,ITI,ITI1,9,Toscana,Toscana,3729641,378740,10.15,0.56
4427,2021-03-09,TOS,11177,4586,6591,5532,5565,80,ITI,ITI1,9,Toscana,Toscana,3729641,389917,10.45,0.3
4428,2021-04-09,TOS,24610,10589,14021,20718,3442,450,ITI,ITI1,9,Toscana,Toscana,3729641,414527,11.11,0.66
4429,2021-07-18,TOS,30394,15282,15112,8342,21842,210,ITI,ITI1,9,Toscana,Toscana,3729641,444921,11.93,0.81
4430,2021-06-17,TOS,32624,16715,15909,26715,5564,345,ITI,ITI1,9,Toscana,Toscana,3729641,477545,12.8,0.87
4431,2021-07-30,TOS,37917,20407,17510,10794,26765,358,ITI,ITI1,9,Toscana,Toscana,3729641,515462,13.82,1.02
4432,2021-06-22,TOS,31066,15634,15432,22466,8220,380,ITI,ITI1,9,Toscana,Toscana,3729641,546528,14.65,0.83
4433,2021-05-17,TOS,29784,14883,14901,20559,8946,279,ITI,ITI1,9,Toscana,Toscana,3729641,576312,15.45,0.8
4434,2021-03-21,TOS,3296,1629,1667,1819,1434,43,ITI,ITI1,9,Toscana,Toscana,3729641,579608,15.54,0.09
4435,2021-08-25,TOS,20304,10607,9697,10601,8974,729,ITI,ITI1,9,Toscana,Toscana,3729641,599912,16.08,0.54
4436,2021-01-23,TOS,3982,1361,2621,641,3335,6,ITI,ITI1,9,Toscana,Toscana,3729641,603894,16.19,0.11
4437,2021-06-29,TOS,37057,18042,19015,7975,28926,156,ITI,ITI1,9,Toscana,Toscana,3729641,640951,17.19,0.99
4438,2021-05-03,TOS,11946,5518,6428,10363,1335,248,ITI,ITI1,9,Toscana,Toscana,3729641,652897,17.51,0.32
4439,2021-01-16,TOS,3298,1059,2239,3240,0,58,ITI,ITI1,9,Toscana,Toscana,3729641,656195,17.59,0.09
4440,2021-04-26,TOS,10149,4936,5213,7456,2557,136,ITI,ITI1,9,Toscana,Toscana,3729641,666344,17.87,0.27
4441,2021-01-02,TOS,3547,1126,2421,3503,0,44,ITI,ITI1,9,Toscana,Toscana,3729641,669891,17.96,0.1
4442,2021-09-08,TOS,21342,11086,10256,7205,13395,742,ITI,ITI1,9,Toscana,Toscana,3729641,691233,18.53,0.57
4443,2021-02-16,TOS,9372,3367,6005,8420,721,231,ITI,ITI1,9,Toscana,Toscana,3729641,700605,18.78,0.25
4444,2021-09-01,TOS,23580,12406,11174,13371,9167,1042,ITI,ITI1,9,Toscana,Toscana,3729641,724185,19.42,0.63
4445,2021-06-10,TOS,26457,13572,12885,25546,561,350,ITI,ITI1,9,Toscana,Toscana,3729641,750642,20.13,0.71
4446,2021-05-24,TOS,33764,16729,17035,23897,9587,280,ITI,ITI1,9,Toscana,Toscana,3729641,784406,21.03,0.91
4447,2021-06-12,TOS,29404,15157,14247,24653,4392,359,ITI,ITI1,9,Toscana,Toscana,3729641,813810,21.82,0.79
4448,2021-04-16,TOS,29001,12897,16104,21439,6928,634,ITI,ITI1,9,Toscana,Toscana,3729641,842811,22.6,0.78
4449,2021-07-25,TOS,33929,16777,17152,7053,26695,181,ITI,ITI1,9,Toscana,Toscana,3729641,876740,23.51,0.91
4450,2021-03-02,TOS,10600,3795,6805,7039,3447,114,ITI,ITI1,9,Toscana,Toscana,3729641,887340,23.79,0.28
4451,2021-01-04,TOS,5240,1998,3242,5173,0,67,ITI,ITI1,9,Toscana,Toscana,3729641,892580,23.93,0.14
4452,2021-04-14,TOS,20208,8353,11855,14533,5127,548,ITI,ITI1,9,Toscana,Toscana,3729641,912788,24.47,0.54
4453,2021-08-20,TOS,20227,11093,9134,9966,9764,497,ITI,ITI1,9,Toscana,Toscana,3729641,933015,25.02,0.54
4454,2021-03-19,TOS,10175,4476,5699,7130,2897,148,ITI,ITI1,9,Toscana,Toscana,3729641,943190,25.29,0.27
4455,2021-01-21,TOS,1593,687,906,862,722,9,ITI,ITI1,9,Toscana,Toscana,3729641,944783,25.33,0.04
4456,2021-09-06,TOS,22820,11828,10992,9465,12328,1027,ITI,ITI1,9,Toscana,Toscana,3729641,967603,25.94,0.61
4457,2021-02-04,TOS,4264,1597,2667,942,3295,27,ITI,ITI1,9,Toscana,Toscana,3729641,971867,26.06,0.11
4458,2021-05-15,TOS,29377,13866,15511,22871,5910,596,ITI,ITI1,9,Toscana,Toscana,3729641,1001244,26.85,0.79
4459,2021-04-28,TOS,19158,8195,10963,3446,15354,358,ITI,ITI1,9,Toscana,Toscana,3729641,1020402,27.36,0.51
4460,2021-02-18,TOS,8874,3301,5573,7793,897,184,ITI,ITI1,9,Toscana,Toscana,3729641,1029276,27.6,0.24
4461,2021-05-29,TOS,31582,15266,16316,23182,8173,227,ITI,ITI1,9,Toscana,Toscana,3729641,1060858,28.44,0.85
4462,2021-03-28,TOS,6211,2807,3404,5875,253,83,ITI,ITI1,9,Toscana,Toscana,3729641,1067069,28.61,0.17
4463,2021-01-30,TOS,4625,1623,3002,173,4434,18,ITI,ITI1,9,Toscana,Toscana,3729641,1071694,28.73,0.12
4464,2021-07-06,TOS,25797,13040,12757,11037,14531,229,ITI,ITI1,9,Toscana,Toscana,3729641,1097491,29.43,0.69
4465,2021-05-10,TOS,26245,12418,13827,15247,10651,347,ITI,ITI1,9,Toscana,Toscana,3729641,1123736,30.13,0.7
4466,2021-03-14,TOS,7191,2577,4614,3163,3935,93,ITI,ITI1,9,Toscana,Toscana,3729641,1130927,30.32,0.19
4467,2021-08-18,TOS,25952,13825,12127,12845,12503,604,ITI,ITI1,9,Toscana,Toscana,3729641,1156879,31.02,0.7
4468,2021-07-13,TOS,29350,14738,14612,7715,21459,176,ITI,ITI1,9,Toscana,Toscana,3729641,1186229,31.81,0.79
4469,2021-04-02,TOS,32015,13579,18436,23682,8078,255,ITI,ITI1,9,Toscana,Toscana,3729641,1218244,32.66,0.86
4470,2021-07-11,TOS,26192,12729,13463,9170,16848,174,ITI,ITI1,9,Toscana,Toscana,3729641,1244436,33.37,0.7
4471,2021-06-24,TOS,29470,14633,14837,19319,9754,397,ITI,ITI1,9,Toscana,Toscana,3729641,1273906,34.16,0.79
4472,2021-01-09,TOS,4542,1622,2920,4475,0,67,ITI,ITI1,9,Toscana,Toscana,3729641,1278448,34.28,0.12
4473,2021-09-15,TOS,5944,3076,2868,1440,4258,246,ITI,ITI1,9,Toscana,Toscana,3729641,1284392,34.44,0.16
4474,2021-03-07,TOS,5659,2362,3297,2001,3547,111,ITI,ITI1,9,Toscana,Toscana,3729641,1290051,34.59,0.15
4475,2021-07-20,TOS,37341,19108,18233,7966,29183,192,ITI,ITI1,9,Toscana,Toscana,3729641,1327392,35.59,1.0
4476,2021-05-02,TOS,11181,4936,6245,8979,1968,234,ITI,ITI1,9,Toscana,Toscana,3729641,1338573,35.89,0.3
4477,2021-08-10,TOS,25936,13492,12444,16355,8933,648,ITI,ITI1,9,Toscana,Toscana,3729641,1364509,36.59,0.7
4478,2021-02-25,TOS,10648,4315,6333,9484,995,169,ITI,ITI1,9,Toscana,Toscana,3729641,1375157,36.87,0.29
4479,2021-06-28,TOS,37708,18146,19562,8436,29102,170,ITI,ITI1,9,Toscana,Toscana,3729641,1412865,37.88,1.01
4480,2021-01-20,TOS,1346,644,702,1034,249,63,ITI,ITI1,9,Toscana,Toscana,3729641,1414211,37.92,0.04
4481,2021-04-30,TOS,40254,17814,22440,19653,19955,646,ITI,ITI1,9,Toscana,Toscana,3729641,1454465,39.0,1.08
4482,2021-01-25,TOS,5136,1895,3241,243,4889,4,ITI,ITI1,9,Toscana,Toscana,3729641,1459601,39.14,0.14
4483,2021-04-18,TOS,8372,4097,4275,7061,1035,276,ITI,ITI1,9,Toscana,Toscana,3729641,1467973,39.36,0.22
4484,2021-07-27,TOS,38738,20142,18596,11269,27120,349,ITI,ITI1,9,Toscana,Toscana,3729641,1506711,40.4,1.04
4485,2021-07-10,TOS,29316,14187,15129,7952,21174,190,ITI,ITI1,9,Toscana,Toscana,3729641,1536027,41.18,0.79
4486,2021-06-14,TOS,31836,16352,15484,27429,4109,298,ITI,ITI1,9,Toscana,Toscana,3729641,1567863,42.04,0.85
4487,2021-03-04,TOS,17902,6981,10921,14657,3085,160,ITI,ITI1,9,Toscana,Toscana,3729641,1585765,42.52,0.48
4488,2021-08-06,TOS,32967,17676,15291,15347,17143,477,ITI,ITI1,9,Toscana,Toscana,3729641,1618732,43.4,0.88
4489,2021-03-23,TOS,9448,4414,5034,6960,2288,200,ITI,ITI1,9,Toscana,Toscana,3729641,1628180,43.66,0.25
4490,2020-12-30,TOS,327,104,223,326,0,1,ITI,ITI1,9,Toscana,Toscana,3729641,1628507,43.66,0.01
4491,2021-08-24,TOS,21889,11481,10408,12726,8299,864,ITI,ITI1,9,Toscana,Toscana,3729641,1650396,44.25,0.59
4492,2021-08-05,TOS,34758,18025,16733,12126,22259,373,ITI,ITI1,9,Toscana,Toscana,3729641,1685154,45.18,0.93
4493,2021-06-02,TOS,27615,13634,13981,21868,5512,235,ITI,ITI1,9,Toscana,Toscana,3729641,1712769,45.92,0.74
4494,2021-04-06,TOS,22252,9843,12409,18091,3742,419,ITI,ITI1,9,Toscana,Toscana,3729641,1735021,46.52,0.6
4495,2021-09-10,TOS,18076,9483,8593,5505,11946,625,ITI,ITI1,9,Toscana,Toscana,3729641,1753097,47.0,0.48
4496,2021-02-08,TOS,4132,1372,2760,3561,459,112,ITI,ITI1,9,Toscana,Toscana,3729641,1757229,47.12,0.11
4497,2021-07-15,TOS,31266,15304,15962,8094,22924,248,ITI,ITI1,9,Toscana,Toscana,3729641,1788495,47.95,0.84
4498,2021-05-19,TOS,27979,13589,14390,18644,9068,267,ITI,ITI1,9,Toscana,Toscana,3729641,1816474,48.7,0.75
4499,2021-04-13,TOS,8505,3513,4992,5740,2482,283,ITI,ITI1,9,Toscana,Toscana,3729641,1824979,48.93,0.23
4500,2021-07-22,TOS,39406,19806,19600,4478,34757,171,ITI,ITI1,9,Toscana,Toscana,3729641,1864385,49.99,1.06
4501,2021-05-26,TOS,35627,17117,18510,20149,15221,257,ITI,ITI1,9,Toscana,Toscana,3729641,1900012,50.94,0.96
4502,2021-03-30,TOS,17041,7645,9396,13269,3574,198,ITI,ITI1,9,Toscana,Toscana,3729641,1917053,51.4,0.46
4503,2021-09-03,TOS,14173,7403,6770,7545,5922,706,ITI,ITI1,9,Toscana,Toscana,3729641,1931226,51.78,0.38
4504,2021-07-08,TOS,21098,10372,10726,9268,11589,241,ITI,ITI1,9,Toscana,Toscana,3729641,1952324,52.35,0.57
4505,2021-04-25,TOS,11067,5252,5815,8759,2146,162,ITI,ITI1,9,Toscana,Toscana,3729641,1963391,52.64,0.3
4506,2021-08-03,TOS,36360,18931,17429,12169,23812,379,ITI,ITI1,9,Toscana,Toscana,3729641,1999751,53.62,0.97
4507,2021-01-13,TOS,4126,1423,2703,4061,0,65,ITI,ITI1,9,Toscana,Toscana,3729641,2003877,53.73,0.11
4508,2021-04-23,TOS,25686,11435,14251,8800,16355,531,ITI,ITI1,9,Toscana,Toscana,3729641,2029563,54.42,0.69
4509,2021-03-18,TOS,9993,3987,6006,5865,3989,139,ITI,ITI1,9,Toscana,Toscana,3729641,2039556,54.69,0.27
4510,2021-06-26,TOS,34585,16775,17810,9989,24363,233,ITI,ITI1,9,Toscana,Toscana,3729641,2074141,55.61,0.93
4511,2021-06-09,TOS,34852,17584,17268,33958,463,431,ITI,ITI1,9,Toscana,Toscana,3729641,2108993,56.55,0.93
4512,2021-04-04,TOS,13930,6613,7317,13510,255,165,ITI,ITI1,9,Toscana,Toscana,3729641,2122923,56.92,0.37
4513,2021-03-16,TOS,4924,1889,3035,2584,2259,81,ITI,ITI1,9,Toscana,Toscana,3729641,2127847,57.05,0.13
4514,2021-02-27,TOS,2000,763,1237,1019,903,78,ITI,ITI1,9,Toscana,Toscana,3729641,2129847,57.11,0.05
4515,2021-06-07,TOS,34981,17164,17817,30978,3655,348,ITI,ITI1,9,Toscana,Toscana,3729641,2164828,58.04,0.94
4516,2021-08-22,TOS,18526,9967,8559,7307,10903,316,ITI,ITI1,9,Toscana,Toscana,3729641,2183354,58.54,0.5
4517,2021-02-20,TOS,4724,1815,2909,4051,537,136,ITI,ITI1,9,Toscana,Toscana,3729641,2188078,58.67,0.13
4518,2021-05-31,TOS,30361,14652,15709,19270,10849,242,ITI,ITI1,9,Toscana,Toscana,3729641,2218439,59.48,0.81
4519,2021-05-14,TOS,33407,15461,17946,20022,12743,642,ITI,ITI1,9,Toscana,Toscana,3729641,2251846,60.38,0.9
4520,2021-05-12,TOS,34235,15591,18644,13584,20065,586,ITI,ITI1,9,Toscana,Toscana,3729641,2286081,61.29,0.92
4521,2021-01-18,TOS,1127,639,488,979,98,50,ITI,ITI1,9,Toscana,Toscana,3729641,2287208,61.33,0.03
4522,2021-02-01,TOS,5524,1962,3562,520,4994,10,ITI,ITI1,9,Toscana,Toscana,3729641,2292732,61.47,0.15
4523,2021-08-17,TOS,26014,14036,11978,11480,14037,497,ITI,ITI1,9,Toscana,Toscana,3729641,2318746,62.17,0.7
4524,2021-06-21,TOS,31210,15500,15710,18142,12802,266,ITI,ITI1,9,Toscana,Toscana,3729641,2349956,63.01,0.84
4525,2021-01-06,TOS,4614,1503,3111,4562,0,52,ITI,ITI1,9,Toscana,Toscana,3729641,2354570,63.13,0.12
4526,2021-03-11,TOS,16045,6417,9628,12487,3373,185,ITI,ITI1,9,Toscana,Toscana,3729641,2370615,63.56,0.43
4527,2021-06-19,TOS,26527,13932,12595,21397,4791,339,ITI,ITI1,9,Toscana,Toscana,3729641,2397142,64.27,0.71
4528,2021-05-07,TOS,32191,14720,17471,11349,20227,615,ITI,ITI1,9,Toscana,Toscana,3729641,2429333,65.14,0.86
4529,2021-08-15,TOS,14689,7761,6928,5269,9236,184,ITI,ITI1,9,Toscana,Toscana,3729641,2444022,65.53,0.39
4530,2021-07-29,TOS,39418,20536,18882,12611,26459,348,ITI,ITI1,9,Toscana,Toscana,3729641,2483440,66.59,1.06
4531,2021-02-13,TOS,7869,2390,5479,7493,227,149,ITI,ITI1,9,Toscana,Toscana,3729641,2491309,66.8,0.21
4532,2021-01-08,TOS,6063,1695,4368,5970,0,93,ITI,ITI1,9,Toscana,Toscana,3729641,2497372,66.96,0.16
4533,2021-07-12,TOS,28288,14008,14280,9663,18321,304,ITI,ITI1,9,Toscana,Toscana,3729641,2525660,67.72,0.76
4534,2021-04-01,TOS,27169,11270,15899,16192,10735,242,ITI,ITI1,9,Toscana,Toscana,3729641,2552829,68.45,0.73
4535,2021-03-15,TOS,8703,3646,5057,4079,4449,175,ITI,ITI1,9,Toscana,Toscana,3729641,2561532,68.68,0.23
4536,2021-06-23,TOS,31584,15318,16266,19819,11399,366,ITI,ITI1,9,Toscana,Toscana,3729641,2593116,69.53,0.85
4537,2020-12-27,TOS,629,275,354,624,0,5,ITI,ITI1,9,Toscana,Toscana,3729641,2593745,69.54,0.02
4538,2021-08-02,TOS,35313,18090,17223,13361,21557,395,ITI,ITI1,9,Toscana,Toscana,3729641,2629058,70.49,0.95
4539,2021-09-14,TOS,16073,8706,7367,3194,12540,339,ITI,ITI1,9,Toscana,Toscana,3729641,2645131,70.92,0.43
4540,2021-01-03,TOS,3364,1070,2294,3317,0,47,ITI,ITI1,9,Toscana,Toscana,3729641,2648495,71.01,0.09
4541,2021-09-02,TOS,18085,9436,8649,11057,6113,915,ITI,ITI1,9,Toscana,Toscana,3729641,2666580,71.5,0.48
4542,2021-03-20,TOS,6593,2979,3614,5363,1139,91,ITI,ITI1,9,Toscana,Toscana,3729641,2673173,71.67,0.18
4543,2021-01-22,TOS,2867,1064,1803,526,2338,3,ITI,ITI1,9,Toscana,Toscana,3729641,2676040,71.75,0.08
4544,2021-07-07,TOS,25647,12610,13037,9331,16122,194,ITI,ITI1,9,Toscana,Toscana,3729641,2701687,72.44,0.69
4545,2021-05-21,TOS,28963,13504,15459,17229,11477,257,ITI,ITI1,9,Toscana,Toscana,3729641,2730650,73.21,0.78
4546,2021-08-29,TOS,16997,8985,8012,7579,8835,583,ITI,ITI1,9,Toscana,Toscana,3729641,2747647,73.67,0.46
4547,2021-03-01,TOS,4476,1732,2744,766,3643,67,ITI,ITI1,9,Toscana,Toscana,3729641,2752123,73.79,0.12
4548,2021-01-01,TOS,2410,814,1596,2364,0,46,ITI,ITI1,9,Toscana,Toscana,3729641,2754533,73.86,0.06
4549,2021-04-11,TOS,3641,1680,1961,3331,155,155,ITI,ITI1,9,Toscana,Toscana,3729641,2758174,73.95,0.1
4550,2021-07-03,TOS,29439,14832,14607,11876,17178,385,ITI,ITI1,9,Toscana,Toscana,3729641,2787613,74.74,0.79
4551,2021-08-07,TOS,30478,16297,14181,14220,15771,487,ITI,ITI1,9,Toscana,Toscana,3729641,2818091,75.56,0.82
4552,2021-03-06,TOS,7137,2859,4278,2849,4203,85,ITI,ITI1,9,Toscana,Toscana,3729641,2825228,75.75,0.19
4553,2021-08-21,TOS,17986,9959,8027,8148,9459,379,ITI,ITI1,9,Toscana,Toscana,3729641,2843214,76.23,0.48
4554,2021-02-03,TOS,4227,1452,2775,236,3987,4,ITI,ITI1,9,Toscana,Toscana,3729641,2847441,76.35,0.11
4555,2021-04-27,TOS,10377,4927,5450,3667,6506,204,ITI,ITI1,9,Toscana,Toscana,3729641,2857818,76.62,0.28
4556,2021-07-19,TOS,38038,18960,19078,8805,28943,290,ITI,ITI1,9,Toscana,Toscana,3729641,2895856,77.64,1.02
4557,2021-01-17,TOS,2541,870,1671,1992,514,35,ITI,ITI1,9,Toscana,Toscana,3729641,2898397,77.71,0.07
4558,2021-07-05,TOS,30533,15095,15438,10340,19961,232,ITI,ITI1,9,Toscana,Toscana,3729641,2928930,78.53,0.82
4559,2021-03-08,TOS,6742,2960,3782,1865,4830,47,ITI,ITI1,9,Toscana,Toscana,3729641,2935672,78.71,0.18
4560,2021-06-16,TOS,31801,16280,15521,26288,5189,324,ITI,ITI1,9,Toscana,Toscana,3729641,2967473,79.56,0.85
4561,2021-05-30,TOS,28705,13958,14747,21510,6953,242,ITI,ITI1,9,Toscana,Toscana,3729641,2996178,80.33,0.77
4562,2021-09-07,TOS,18922,9795,9127,6729,11561,632,ITI,ITI1,9,Toscana,Toscana,3729641,3015100,80.84,0.51
4563,2021-05-23,TOS,28445,13678,14767,25613,2563,269,ITI,ITI1,9,Toscana,Toscana,3729641,3043545,81.6,0.76
4564,2021-08-31,TOS,20915,10894,10021,11383,8783,749,ITI,ITI1,9,Toscana,Toscana,3729641,3064460,82.17,0.56
4565,2021-08-14,TOS,22391,12223,10168,10456,11516,419,ITI,ITI1,9,Toscana,Toscana,3729641,3086851,82.77,0.6
4566,2021-08-12,TOS,25851,13451,12400,14309,10898,644,ITI,ITI1,9,Toscana,Toscana,3729641,3112702,83.46,0.69
4567,2021-07-26,TOS,38303,19868,18435,10082,27910,311,ITI,ITI1,9,Toscana,Toscana,3729641,3151005,84.49,1.03
4568,2021-01-10,TOS,3036,1123,1913,2982,0,54,ITI,ITI1,9,Toscana,Toscana,3729641,3154041,84.57,0.08
4569,2021-04-20,TOS,18165,8111,10054,12208,5593,364,ITI,ITI1,9,Toscana,Toscana,3729641,3172206,85.05,0.49
4570,2021-04-03,TOS,15018,6647,8371,13679,1123,216,ITI,ITI1,9,Toscana,Toscana,3729641,3187224,85.46,0.4
4571,2021-01-27,TOS,4836,1574,3262,199,4632,5,ITI,ITI1,9,Toscana,Toscana,3729641,3192060,85.59,0.13
4572,2021-02-05,TOS,5770,2250,3520,1905,3831,34,ITI,ITI1,9,Toscana,Toscana,3729641,3197830,85.74,0.15
4573,2021-05-16,TOS,26692,12895,13797,23926,2470,296,ITI,ITI1,9,Toscana,Toscana,3729641,3224522,86.46,0.72
4574,2021-02-15,TOS,8866,3407,5459,7866,828,172,ITI,ITI1,9,Toscana,Toscana,3729641,3233388,86.69,0.24
4575,2021-02-22,TOS,9891,4276,5615,9236,277,378,ITI,ITI1,9,Toscana,Toscana,3729641,3243279,86.96,0.27
4576,2021-05-08,TOS,29194,13132,16062,13263,15530,401,ITI,ITI1,9,Toscana,Toscana,3729641,3272473,87.74,0.78
4577,2021-03-12,TOS,17049,6645,10404,13322,3532,195,ITI,ITI1,9,Toscana,Toscana,3729641,3289522,88.2,0.46
4578,2021-08-16,TOS,30011,15753,14258,16606,12702,703,ITI,ITI1,9,Toscana,Toscana,3729641,3319533,89.0,0.8
4579,2021-01-14,TOS,3285,1186,2099,3249,0,36,ITI,ITI1,9,Toscana,Toscana,3729641,3322818,89.09,0.09
4580,2021-06-20,TOS,25188,12489,12699,15422,9522,244,ITI,ITI1,9,Toscana,Toscana,3729641,3348006,89.77,0.68
4581,2021-03-27,TOS,8866,4156,4710,8512,216,138,ITI,ITI1,9,Toscana,Toscana,3729641,3356872,90.01,0.24
4582,2021-06-30,TOS,38289,18528,19761,8462,29607,220,ITI,ITI1,9,Toscana,Toscana,3729641,3395161,91.03,1.03
4583,2021-02-14,TOS,9064,2587,6477,8800,110,154,ITI,ITI1,9,Toscana,Toscana,3729641,3404225,91.27,0.24
4584,2021-05-25,TOS,34212,16518,17694,19295,14644,273,ITI,ITI1,9,Toscana,Toscana,3729641,3438437,92.19,0.92
4585,2021-03-29,TOS,9687,4844,4843,9201,350,136,ITI,ITI1,9,Toscana,Toscana,3729641,3448124,92.45,0.26
4586,2021-09-11,TOS,19081,10005,9076,5450,13008,623,ITI,ITI1,9,Toscana,Toscana,3729641,3467205,92.96,0.51
4587,2021-01-15,TOS,3916,1362,2554,3856,0,60,ITI,ITI1,9,Toscana,Toscana,3729641,3471121,93.07,0.1
4588,2021-09-09,TOS,20021,10269,9752,6894,12197,930,ITI,ITI1,9,Toscana,Toscana,3729641,3491142,93.61,0.54
4589,2021-06-18,TOS,30832,16269,14563,25003,5412,417,ITI,ITI1,9,Toscana,Toscana,3729641,3521974,94.43,0.83
4590,2021-03-25,TOS,23990,10409,13581,15320,8408,262,ITI,ITI1,9,Toscana,Toscana,3729641,3545964,95.08,0.64
4591,2021-04-12,TOS,2631,1195,1436,1806,656,169,ITI,ITI1,9,Toscana,Toscana,3729641,3548595,95.15,0.07
4592,2021-07-04,TOS,31551,15322,16229,9360,21892,299,ITI,ITI1,9,Toscana,Toscana,3729641,3580146,95.99,0.85
4593,2020-12-31,TOS,802,201,601,798,0,4,ITI,ITI1,9,Toscana,Toscana,3729641,3580948,96.01,0.02
4594,2021-04-10,TOS,11715,5345,6370,10735,742,238,ITI,ITI1,9,Toscana,Toscana,3729641,3592663,96.33,0.31
4595,2021-02-10,TOS,4315,1309,3006,3633,526,156,ITI,ITI1,9,Toscana,Toscana,3729641,3596978,96.44,0.12
4596,2021-05-04,TOS,18329,8220,10109,12414,5470,445,ITI,ITI1,9,Toscana,Toscana,3729641,3615307,96.93,0.49
4597,2021-02-12,TOS,7682,2719,4963,7355,213,114,ITI,ITI1,9,Toscana,Toscana,3729641,3622989,97.14,0.21
4598,2021-04-24,TOS,13452,6175,7277,5622,7461,369,ITI,ITI1,9,Toscana,Toscana,3729641,3636441,97.5,0.36
4599,2021-06-27,TOS,33310,16081,17229,5911,27265,134,ITI,ITI1,9,Toscana,Toscana,3729641,3669751,98.39,0.89
4600,2021-05-27,TOS,28385,13212,15173,13280,14883,222,ITI,ITI1,9,Toscana,Toscana,3729641,3698136,99.16,0.76
4601,2021-03-31,TOS,32802,13293,19509,20206,12253,343,ITI,ITI1,9,Toscana,Toscana,3729641,3730938,100.03,0.88
4602,2021-09-04,TOS,16679,8918,7761,7542,8372,765,ITI,ITI1,9,Toscana,Toscana,3729641,3747617,100.48,0.45
4603,2021-07-09,TOS,29147,14120,15027,7689,21260,198,ITI,ITI1,9,Toscana,Toscana,3729641,3776764,101.26,0.78
4604,2021-03-22,TOS,5262,2772,2490,4676,448,138,ITI,ITI1,9,Toscana,Toscana,3729641,3782026,101.4,0.14
4605,2021-07-28,TOS,38579,20171,18408,12106,26134,339,ITI,ITI1,9,Toscana,Toscana,3729641,3820605,102.44,1.03
4606,2021-01-26,TOS,5400,1795,3605,218,5178,4,ITI,ITI1,9,Toscana,Toscana,3729641,3826005,102.58,0.14
4607,2021-05-06,TOS,31437,13674,17763,13451,17291,695,ITI,ITI1,9,Toscana,Toscana,3729641,3857442,103.43,0.84
4608,2021-04-19,TOS,9105,4516,4589,7754,1034,317,ITI,ITI1,9,Toscana,Toscana,3729641,3866547,103.67,0.24
4609,2021-04-17,TOS,20584,9232,11352,17948,2146,490,ITI,ITI1,9,Toscana,Toscana,3729641,3887131,104.22,0.55
4610,2021-08-30,TOS,24791,12542,12249,13124,10540,1127,ITI,ITI1,9,Toscana,Toscana,3729641,3911922,104.89,0.66
4611,2021-03-17,TOS,11449,4600,6849,6818,4537,94,ITI,ITI1,9,Toscana,Toscana,3729641,3923371,105.19,0.31
4612,2021-06-25,TOS,33655,16833,16822,12105,21267,283,ITI,ITI1,9,Toscana,Toscana,3729641,3957026,106.1,0.9
4613,2021-06-08,TOS,32611,16730,15881,31734,492,385,ITI,ITI1,9,Toscana,Toscana,3729641,3989637,106.97,0.87
4614,2021-02-26,TOS,10106,3849,6257,8676,1211,219,ITI,ITI1,9,Toscana,Toscana,3729641,3999743,107.24,0.27
4615,2021-06-06,TOS,28330,13665,14665,22589,5373,368,ITI,ITI1,9,Toscana,Toscana,3729641,4028073,108.0,0.76
4616,2021-07-21,TOS,38516,19659,18857,7342,30937,237,ITI,ITI1,9,Toscana,Toscana,3729641,4066589,109.03,1.03
4617,2021-05-13,TOS,35201,15549,19652,13203,21357,641,ITI,ITI1,9,Toscana,Toscana,3729641,4101790,109.98,0.94
4618,2021-08-04,TOS,34858,18034,16824,11358,23080,420,ITI,ITI1,9,Toscana,Toscana,3729641,4136648,110.91,0.93
4619,2021-04-29,TOS,39396,17746,21650,18562,20170,664,ITI,ITI1,9,Toscana,Toscana,3729641,4176044,111.97,1.06
4620,2021-03-24,TOS,20047,8317,11730,10411,9491,145,ITI,ITI1,9,Toscana,Toscana,3729641,4196091,112.51,0.54
4621,2021-08-23,TOS,22754,11819,10935,11482,10542,730,ITI,ITI1,9,Toscana,Toscana,3729641,4218845,113.12,0.61
4622,2021-02-19,TOS,8345,2968,5377,7652,513,180,ITI,ITI1,9,Toscana,Toscana,3729641,4227190,113.34,0.22
4623,2021-05-01,TOS,23341,10072,13269,13728,9228,385,ITI,ITI1,9,Toscana,Toscana,3729641,4250531,113.97,0.63
4624,2021-03-05,TOS,16906,6697,10209,11963,4761,182,ITI,ITI1,9,Toscana,Toscana,3729641,4267437,114.42,0.45
4625,2021-08-09,TOS,28983,14722,14261,18506,9765,712,ITI,ITI1,9,Toscana,Toscana,3729641,4296420,115.2,0.78
4626,2021-06-13,TOS,24622,12355,12267,22600,1659,363,ITI,ITI1,9,Toscana,Toscana,3729641,4321042,115.86,0.66
4627,2021-05-11,TOS,27971,12997,14974,12101,15490,380,ITI,ITI1,9,Toscana,Toscana,3729641,4349013,116.61,0.75
4628,2021-08-19,TOS,24202,12838,11364,11914,11656,632,ITI,ITI1,9,Toscana,Toscana,3729641,4373215,117.26,0.65
4629,2021-03-13,TOS,9313,3317,5996,5190,3968,155,ITI,ITI1,9,Toscana,Toscana,3729641,4382528,117.51,0.25
4630,2021-07-14,TOS,28964,14297,14667,8604,20101,259,ITI,ITI1,9,Toscana,Toscana,3729641,4411492,118.28,0.78
4631,2021-01-29,TOS,6150,1702,4448,290,5848,12,ITI,ITI1,9,Toscana,Toscana,3729641,4417642,118.45,0.16
4632,2021-05-09,TOS,22557,9785,12772,9413,12882,262,ITI,ITI1,9,Toscana,Toscana,3729641,4440199,119.05,0.6
4633,2021-08-26,TOS,18583,9740,8843,9496,8365,722,ITI,ITI1,9,Toscana,Toscana,3729641,4458782,119.55,0.5
4634,2021-01-24,TOS,3349,1072,2277,196,3150,3,ITI,ITI1,9,Toscana,Toscana,3729641,4462131,119.64,0.09
4635,2021-01-07,TOS,6180,1840,4340,6092,0,88,ITI,ITI1,9,Toscana,Toscana,3729641,4468311,119.81,0.17
4636,2021-02-21,TOS,5165,2104,3061,4790,170,205,ITI,ITI1,9,Toscana,Toscana,3729641,4473476,119.94,0.14
4637,2021-06-01,TOS,26966,13400,13566,22872,3838,256,ITI,ITI1,9,Toscana,Toscana,3729641,4500442,120.67,0.72
4638,2021-07-02,TOS,28316,14212,14104,10816,17202,298,ITI,ITI1,9,Toscana,Toscana,3729641,4528758,121.43,0.76
4639,2021-06-15,TOS,31237,16080,15157,26312,4576,349,ITI,ITI1,9,Toscana,Toscana,3729641,4559995,122.26,0.84
4640,2021-03-10,TOS,18418,7421,10997,14315,3997,106,ITI,ITI1,9,Toscana,Toscana,3729641,4578413,122.76,0.49
4641,2021-02-02,TOS,3745,1477,2268,187,3551,7,ITI,ITI1,9,Toscana,Toscana,3729641,4582158,122.86,0.1
4642,2021-07-16,TOS,27689,14053,13636,7704,19730,255,ITI,ITI1,9,Toscana,Toscana,3729641,4609847,123.6,0.74
4643,2021-05-20,TOS,29788,13930,15858,18641,10862,285,ITI,ITI1,9,Toscana,Toscana,3729641,4639635,124.4,0.8
4644,2021-08-28,TOS,15794,8507,7287,6375,8965,454,ITI,ITI1,9,Toscana,Toscana,3729641,4655429,124.82,0.42
4645,2021-01-31,TOS,3052,1131,1921,100,2949,3,ITI,ITI1,9,Toscana,Toscana,3729641,4658481,124.9,0.08
4646,2021-04-05,TOS,15288,6826,8462,14371,737,180,ITI,ITI1,9,Toscana,Toscana,3729641,4673769,125.31,0.41
4647,2021-02-07,TOS,2818,958,1860,872,1926,20,ITI,ITI1,9,Toscana,Toscana,3729641,4676587,125.39,0.08
4648,2021-07-23,TOS,38463,19308,19155,4385,33921,157,ITI,ITI1,9,Toscana,Toscana,3729641,4715050,126.42,1.03
4649,2021-05-18,TOS,28853,14281,14572,19765,8835,253,ITI,ITI1,9,Toscana,Toscana,3729641,4743903,127.19,0.77
4650,2021-09-05,TOS,15151,8039,7112,6344,8282,525,ITI,ITI1,9,Toscana,Toscana,3729641,4759054,127.6,0.41
4651,2021-02-06,TOS,4539,1555,2984,1270,3236,33,ITI,ITI1,9,Toscana,Toscana,3729641,4763593,127.72,0.12
4652,2021-09-12,TOS,18271,9468,8803,4305,13414,552,ITI,ITI1,9,Toscana,Toscana,3729641,4781864,128.21,0.49
4653,2021-07-17,TOS,27760,14344,13416,8961,18558,241,ITI,ITI1,9,Toscana,Toscana,3729641,4809624,128.96,0.74
4654,2021-06-11,TOS,29764,15502,14262,24736,4661,367,ITI,ITI1,9,Toscana,Toscana,3729641,4839388,129.75,0.8
4655,2021-04-15,TOS,24510,10242,14268,15354,8625,531,ITI,ITI1,9,Toscana,Toscana,3729641,4863898,130.41,0.66
4656,2021-02-17,TOS,8228,3193,5035,7349,754,125,ITI,ITI1,9,Toscana,Toscana,3729641,4872126,130.63,0.22
4657,2021-07-24,TOS,38456,19376,19080,6847,31376,233,ITI,ITI1,9,Toscana,Toscana,3729641,4910582,131.66,1.03
4658,2021-05-28,TOS,30155,13959,16196,17431,12493,231,ITI,ITI1,9,Toscana,Toscana,3729641,4940737,132.47,0.81
4659,2021-04-22,TOS,35788,15317,20471,17401,17559,828,ITI,ITI1,9,Toscana,Toscana,3729641,4976525,133.43,0.96
4660,2021-02-24,TOS,10408,4489,5919,10070,198,140,ITI,ITI1,9,Toscana,Toscana,3729641,4986933,133.71,0.28
4661,2021-07-31,TOS,35850,19221,16629,12370,23022,458,ITI,ITI1,9,Toscana,Toscana,3729641,5022783,134.67,0.96
4662,2021-06-04,TOS,28344,13453,14891,20262,7812,270,ITI,ITI1,9,Toscana,Toscana,3729641,5051127,135.43,0.76
4663,2021-04-08,TOS,29819,12615,17204,23001,6449,369,ITI,ITI1,9,Toscana,Toscana,3729641,5080946,136.23,0.8
4664,2021-03-03,TOS,18233,6538,11695,14495,3610,128,ITI,ITI1,9,Toscana,Toscana,3729641,5099179,136.72,0.49
4665,2021-01-05,TOS,5386,1835,3551,5326,0,60,ITI,ITI1,9,Toscana,Toscana,3729641,5104565,136.86,0.14
4666,2021-01-19,TOS,1116,535,581,1074,0,42,ITI,ITI1,9,Toscana,Toscana,3729641,5105681,136.89,0.03
4667,2021-08-11,TOS,27068,14196,12872,16912,9419,737,ITI,ITI1,9,Toscana,Toscana,3729641,5132749,137.62,0.73
4668,2021-01-12,TOS,3631,1417,2214,3558,0,73,ITI,ITI1,9,Toscana,Toscana,3729641,5136380,137.72,0.1
4669,2021-02-20,LAZ,9227,4279,4948,8368,785,74,ITI,ITI4,12,Lazio,Lazio,5879082,9227,0.16,0.16
4670,2021-05-31,LAZ,51825,23077,28748,30880,19923,1022,ITI,ITI4,12,Lazio,Lazio,5879082,61052,1.04,0.88
4671,2021-04-04,LAZ,17671,8203,9468,12261,5293,117,ITI,ITI4,12,Lazio,Lazio,5879082,78723,1.34,0.3
4672,2021-05-26,LAZ,47692,21936,25756,34884,12157,651,ITI,ITI4,12,Lazio,Lazio,5879082,126415,2.15,0.81
4673,2021-03-04,LAZ,19486,8754,10732,14187,5035,264,ITI,ITI4,12,Lazio,Lazio,5879082,145901,2.48,0.33
4674,2021-06-12,LAZ,69965,32130,37835,39881,29427,657,ITI,ITI4,12,Lazio,Lazio,5879082,215866,3.67,1.19
4675,2021-06-14,LAZ,63117,29577,33540,32327,30219,571,ITI,ITI4,12,Lazio,Lazio,5879082,278983,4.75,1.07
4676,2021-03-21,LAZ,18295,7204,11091,13024,5071,200,ITI,ITI4,12,Lazio,Lazio,5879082,297278,5.06,0.31
4677,2021-07-22,LAZ,61199,30577,30622,28491,31166,1542,ITI,ITI4,12,Lazio,Lazio,5879082,358477,6.1,1.04
4678,2021-09-03,LAZ,26013,13574,12439,7372,18157,484,ITI,ITI4,12,Lazio,Lazio,5879082,384490,6.54,0.44
4679,2021-05-17,LAZ,44657,20451,24206,35419,8625,613,ITI,ITI4,12,Lazio,Lazio,5879082,429147,7.3,0.76
4680,2021-02-06,LAZ,6284,2566,3718,906,5374,4,ITI,ITI4,12,Lazio,Lazio,5879082,435431,7.41,0.11
4681,2021-08-08,LAZ,50341,26065,24276,18026,31479,836,ITI,ITI4,12,Lazio,Lazio,5879082,485772,8.26,0.86
4682,2021-06-26,LAZ,56250,26517,29733,24703,30945,602,ITI,ITI4,12,Lazio,Lazio,5879082,542022,9.22,0.96
4683,2021-04-30,LAZ,41744,18498,23246,26626,14396,722,ITI,ITI4,12,Lazio,Lazio,5879082,583766,9.93,0.71
4684,2021-08-22,LAZ,8774,5303,3471,2535,6150,89,ITI,ITI4,12,Lazio,Lazio,5879082,592540,10.08,0.15
4685,2021-04-16,LAZ,34582,15770,18812,21919,12228,435,ITI,ITI4,12,Lazio,Lazio,5879082,627122,10.67,0.59
4686,2021-01-23,LAZ,7219,2871,4348,589,6630,0,ITI,ITI4,12,Lazio,Lazio,5879082,634341,10.79,0.12
4687,2021-01-06,LAZ,5202,1991,3211,5082,0,120,ITI,ITI4,12,Lazio,Lazio,5879082,639543,10.88,0.09
4688,2021-02-18,LAZ,10097,5022,5075,9110,877,110,ITI,ITI4,12,Lazio,Lazio,5879082,649640,11.05,0.17
4689,2021-05-12,LAZ,47632,21625,26007,30244,16697,691,ITI,ITI4,12,Lazio,Lazio,5879082,697272,11.86,0.81
4690,2021-02-01,LAZ,5687,2186,3501,354,5332,1,ITI,ITI4,12,Lazio,Lazio,5879082,702959,11.96,0.1
4691,2021-03-16,LAZ,13644,5782,7862,7052,6508,84,ITI,ITI4,12,Lazio,Lazio,5879082,716603,12.19,0.23
4692,2021-03-09,LAZ,22059,9968,12091,16465,5230,364,ITI,ITI4,12,Lazio,Lazio,5879082,738662,12.56,0.38
4693,2021-01-11,LAZ,5705,2174,3531,5559,0,146,ITI,ITI4,12,Lazio,Lazio,5879082,744367,12.66,0.1
4694,2021-03-30,LAZ,27161,13212,13949,19566,7227,368,ITI,ITI4,12,Lazio,Lazio,5879082,771528,13.12,0.46
4695,2021-07-08,LAZ,64382,31607,32775,28169,35520,693,ITI,ITI4,12,Lazio,Lazio,5879082,835910,14.22,1.1
4696,2021-07-27,LAZ,56500,27454,29046,8151,48016,333,ITI,ITI4,12,Lazio,Lazio,5879082,892410,15.18,0.96
4697,2021-04-18,LAZ,23873,10610,13263,15852,7704,317,ITI,ITI4,12,Lazio,Lazio,5879082,916283,15.59,0.41
4698,2021-09-10,LAZ,11442,5874,5568,6165,4653,624,ITI,ITI4,12,Lazio,Lazio,5879082,927725,15.78,0.19
4699,2021-03-28,LAZ,19206,7841,11365,13538,5320,348,ITI,ITI4,12,Lazio,Lazio,5879082,946931,16.11,0.33
4700,2020-12-30,LAZ,1658,640,1018,1647,0,11,ITI,ITI4,12,Lazio,Lazio,5879082,948589,16.13,0.03
4701,2021-07-01,LAZ,48583,23240,25343,7187,41173,223,ITI,ITI4,12,Lazio,Lazio,5879082,997172,16.96,0.83
4702,2021-04-09,LAZ,27742,12634,15108,19126,8283,333,ITI,ITI4,12,Lazio,Lazio,5879082,1024914,17.43,0.47
4703,2021-03-23,LAZ,25499,11975,13524,18493,6645,361,ITI,ITI4,12,Lazio,Lazio,5879082,1050413,17.87,0.43
4704,2021-02-11,LAZ,7080,3069,4011,6448,607,25,ITI,ITI4,12,Lazio,Lazio,5879082,1057493,17.99,0.12
4705,2021-04-11,LAZ,19246,8537,10709,13122,5934,190,ITI,ITI4,12,Lazio,Lazio,5879082,1076739,18.31,0.33
4706,2021-02-13,LAZ,6616,2628,3988,6147,422,47,ITI,ITI4,12,Lazio,Lazio,5879082,1083355,18.43,0.11
4707,2021-07-20,LAZ,63464,31660,31804,28459,33756,1249,ITI,ITI4,12,Lazio,Lazio,5879082,1146819,19.51,1.08
4708,2021-05-24,LAZ,44057,20212,23845,33563,9837,657,ITI,ITI4,12,Lazio,Lazio,5879082,1190876,20.26,0.75
4709,2021-06-19,LAZ,66589,31417,35172,35285,30484,820,ITI,ITI4,12,Lazio,Lazio,5879082,1257465,21.39,1.13
4710,2021-05-07,LAZ,48351,22667,25684,29790,17840,721,ITI,ITI4,12,Lazio,Lazio,5879082,1305816,22.21,0.82
4711,2021-03-11,LAZ,25528,12044,13484,18873,6288,367,ITI,ITI4,12,Lazio,Lazio,5879082,1331344,22.65,0.43
4712,2021-08-15,LAZ,1519,941,578,799,697,23,ITI,ITI4,12,Lazio,Lazio,5879082,1332863,22.67,0.03
4713,2021-07-03,LAZ,53262,25082,28180,4646,48468,148,ITI,ITI4,12,Lazio,Lazio,5879082,1386125,23.58,0.91
4714,2021-02-25,LAZ,12821,5612,7209,11399,1215,207,ITI,ITI4,12,Lazio,Lazio,5879082,1398946,23.8,0.22
4715,2021-06-05,LAZ,66418,32725,33693,42937,22797,684,ITI,ITI4,12,Lazio,Lazio,5879082,1465364,24.93,1.13
4716,2021-01-25,LAZ,8173,3287,4886,828,7345,0,ITI,ITI4,12,Lazio,Lazio,5879082,1473537,25.06,0.14
4717,2021-05-05,LAZ,46874,21508,25366,30361,15884,629,ITI,ITI4,12,Lazio,Lazio,5879082,1520411,25.86,0.8
4718,2021-03-02,LAZ,17267,7647,9620,13117,3955,195,ITI,ITI4,12,Lazio,Lazio,5879082,1537678,26.16,0.29
4719,2021-01-18,LAZ,6391,2606,3785,5284,981,126,ITI,ITI4,12,Lazio,Lazio,5879082,1544069,26.26,0.11
4720,2021-04-28,LAZ,33047,15079,17968,20916,11672,459,ITI,ITI4,12,Lazio,Lazio,5879082,1577116,26.83,0.56
4721,2021-07-15,LAZ,45063,22064,22999,6707,37918,438,ITI,ITI4,12,Lazio,Lazio,5879082,1622179,27.59,0.77
4722,2021-01-13,LAZ,5866,2244,3622,5704,0,162,ITI,ITI4,12,Lazio,Lazio,5879082,1628045,27.69,0.1
4723,2021-04-23,LAZ,37993,18297,19696,22045,15409,539,ITI,ITI4,12,Lazio,Lazio,5879082,1666038,28.34,0.65
4724,2021-08-03,LAZ,32512,16572,15940,5160,27150,202,ITI,ITI4,12,Lazio,Lazio,5879082,1698550,28.89,0.55
4725,2021-01-30,LAZ,7025,2898,4127,819,6205,1,ITI,ITI4,12,Lazio,Lazio,5879082,1705575,29.01,0.12
4726,2021-08-10,LAZ,51046,26404,24642,21596,28461,989,ITI,ITI4,12,Lazio,Lazio,5879082,1756621,29.88,0.87
4727,2021-05-19,LAZ,47342,21750,25592,36496,10170,676,ITI,ITI4,12,Lazio,Lazio,5879082,1803963,30.68,0.81
4728,2021-08-27,LAZ,30669,16088,14581,7646,22449,574,ITI,ITI4,12,Lazio,Lazio,5879082,1834632,31.21,0.52
4729,2021-09-15,LAZ,6604,3278,3326,1590,4827,187,ITI,ITI4,12,Lazio,Lazio,5879082,1841236,31.32,0.11
4730,2021-01-04,LAZ,7586,2944,4642,7480,0,106,ITI,ITI4,12,Lazio,Lazio,5879082,1848822,31.45,0.13
4731,2021-06-24,LAZ,64091,30573,33518,28618,34809,664,ITI,ITI4,12,Lazio,Lazio,5879082,1912913,32.54,1.09
4732,2021-06-07,LAZ,62690,29347,33343,32714,29371,605,ITI,ITI4,12,Lazio,Lazio,5879082,1975603,33.6,1.07
4733,2021-06-09,LAZ,70557,33422,37135,35984,33921,652,ITI,ITI4,12,Lazio,Lazio,5879082,2046160,34.8,1.2
4734,2021-04-27,LAZ,30854,13935,16919,19425,10975,454,ITI,ITI4,12,Lazio,Lazio,5879082,2077014,35.33,0.52
4735,2021-03-01,LAZ,17143,7373,9770,12985,3896,262,ITI,ITI4,12,Lazio,Lazio,5879082,2094157,35.62,0.29
4736,2021-08-05,LAZ,33651,17471,16180,22011,10600,1040,ITI,ITI4,12,Lazio,Lazio,5879082,2127808,36.19,0.57
4737,2021-02-15,LAZ,8054,3553,4501,7311,652,91,ITI,ITI4,12,Lazio,Lazio,5879082,2135862,36.33,0.14
4738,2021-01-29,LAZ,8418,3206,5212,931,7485,2,ITI,ITI4,12,Lazio,Lazio,5879082,2144280,36.47,0.14
4739,2021-09-05,LAZ,10097,5166,4931,6601,3055,441,ITI,ITI4,12,Lazio,Lazio,5879082,2154377,36.64,0.17
4740,2021-02-17,LAZ,9232,4625,4607,8262,898,72,ITI,ITI4,12,Lazio,Lazio,5879082,2163609,36.8,0.16
4741,2021-05-28,LAZ,57284,26647,30637,43152,13348,784,ITI,ITI4,12,Lazio,Lazio,5879082,2220893,37.78,0.97
4742,2021-08-19,LAZ,9290,5329,3961,3007,6175,108,ITI,ITI4,12,Lazio,Lazio,5879082,2230183,37.93,0.16
4743,2021-01-03,LAZ,5349,2017,3332,5290,0,59,ITI,ITI4,12,Lazio,Lazio,5879082,2235532,38.03,0.09
4744,2021-04-13,LAZ,25846,11983,13863,17639,7752,455,ITI,ITI4,12,Lazio,Lazio,5879082,2261378,38.46,0.44
4745,2021-07-31,LAZ,56268,29581,26687,5556,50406,306,ITI,ITI4,12,Lazio,Lazio,5879082,2317646,39.42,0.96
4746,2021-01-08,LAZ,7967,2988,4979,7770,0,197,ITI,ITI4,12,Lazio,Lazio,5879082,2325613,39.56,0.14
4747,2021-08-29,LAZ,27436,13960,13476,9011,17832,593,ITI,ITI4,12,Lazio,Lazio,5879082,2353049,40.02,0.47
4748,2021-04-01,LAZ,29811,14144,15667,22225,7182,404,ITI,ITI4,12,Lazio,Lazio,5879082,2382860,40.53,0.51
4749,2021-07-10,LAZ,71156,35718,35438,25061,45425,670,ITI,ITI4,12,Lazio,Lazio,5879082,2454016,41.74,1.21
4750,2021-07-24,LAZ,30781,15526,15255,3230,27393,158,ITI,ITI4,12,Lazio,Lazio,5879082,2484797,42.27,0.52
4751,2021-02-03,LAZ,6501,2495,4006,963,5531,7,ITI,ITI4,12,Lazio,Lazio,5879082,2491298,42.38,0.11
4752,2021-01-20,LAZ,4838,1960,2878,3288,1545,5,ITI,ITI4,12,Lazio,Lazio,5879082,2496136,42.46,0.08
4753,2021-05-14,LAZ,51657,23606,28051,32423,18417,817,ITI,ITI4,12,Lazio,Lazio,5879082,2547793,43.34,0.88
4754,2021-03-18,LAZ,14316,6116,8200,7778,6446,92,ITI,ITI4,12,Lazio,Lazio,5879082,2562109,43.58,0.24
4755,2021-03-25,LAZ,29556,13736,15820,22387,6689,480,ITI,ITI4,12,Lazio,Lazio,5879082,2591665,44.08,0.5
4756,2021-01-27,LAZ,6190,2417,3773,1063,5127,0,ITI,ITI4,12,Lazio,Lazio,5879082,2597855,44.19,0.11
4757,2021-02-22,LAZ,11520,5028,6492,10810,554,156,ITI,ITI4,12,Lazio,Lazio,5879082,2609375,44.38,0.2
4758,2021-06-02,LAZ,43540,21609,21931,31440,11539,561,ITI,ITI4,12,Lazio,Lazio,5879082,2652915,45.12,0.74
4759,2021-06-11,LAZ,69843,32861,36982,36675,32498,670,ITI,ITI4,12,Lazio,Lazio,5879082,2722758,46.31,1.19
4760,2021-08-07,LAZ,35031,18973,16058,21999,11904,1128,ITI,ITI4,12,Lazio,Lazio,5879082,2757789,46.91,0.6
4761,2021-07-19,LAZ,63205,31079,32126,28315,33747,1143,ITI,ITI4,12,Lazio,Lazio,5879082,2820994,47.98,1.08
4762,2021-01-15,LAZ,6725,2772,3953,6554,0,171,ITI,ITI4,12,Lazio,Lazio,5879082,2827719,48.1,0.11
4763,2021-04-25,LAZ,24582,11280,13302,16375,7875,332,ITI,ITI4,12,Lazio,Lazio,5879082,2852301,48.52,0.42
4764,2021-04-06,LAZ,24672,11298,13374,17147,7190,335,ITI,ITI4,12,Lazio,Lazio,5879082,2876973,48.94,0.42
4765,2020-12-27,LAZ,276,132,144,276,0,0,ITI,ITI4,12,Lazio,Lazio,5879082,2877249,48.94,0.0
4766,2021-03-20,LAZ,19282,7677,11605,13089,5923,270,ITI,ITI4,12,Lazio,Lazio,5879082,2896531,49.27,0.33
4767,2021-07-17,LAZ,43955,22171,21784,2188,41660,107,ITI,ITI4,12,Lazio,Lazio,5879082,2940486,50.02,0.75
4768,2021-06-30,LAZ,63049,29674,33375,29755,32739,555,ITI,ITI4,12,Lazio,Lazio,5879082,3003535,51.09,1.07
4769,2021-04-08,LAZ,26909,12336,14573,18761,7729,419,ITI,ITI4,12,Lazio,Lazio,5879082,3030444,51.55,0.46
4770,2021-06-21,LAZ,62053,28834,33219,28501,32935,617,ITI,ITI4,12,Lazio,Lazio,5879082,3092497,52.6,1.06
4771,2021-03-13,LAZ,21857,8759,13098,15704,5916,237,ITI,ITI4,12,Lazio,Lazio,5879082,3114354,52.97,0.37
4772,2021-09-14,LAZ,17974,8899,9075,7125,9959,890,ITI,ITI4,12,Lazio,Lazio,5879082,3132328,53.28,0.31
4773,2021-06-23,LAZ,62381,29389,32992,28438,33438,505,ITI,ITI4,12,Lazio,Lazio,5879082,3194709,54.34,1.06
4774,2021-04-15,LAZ,32062,14358,17704,20661,10892,509,ITI,ITI4,12,Lazio,Lazio,5879082,3226771,54.89,0.55
4775,2021-08-26,LAZ,32194,16702,15492,8263,23368,563,ITI,ITI4,12,Lazio,Lazio,5879082,3258965,55.43,0.55
4776,2021-02-10,LAZ,8261,3459,4802,4851,3405,5,ITI,ITI4,12,Lazio,Lazio,5879082,3267226,55.57,0.14
4777,2021-05-21,LAZ,52155,25096,27059,37321,14128,706,ITI,ITI4,12,Lazio,Lazio,5879082,3319381,56.46,0.89
4778,2021-06-04,LAZ,62101,30278,31823,43563,17874,664,ITI,ITI4,12,Lazio,Lazio,5879082,3381482,57.52,1.06
4779,2021-09-12,LAZ,7472,3745,3727,4807,2129,536,ITI,ITI4,12,Lazio,Lazio,5879082,3388954,57.64,0.13
4780,2021-05-04,LAZ,40318,18546,21772,26073,13721,524,ITI,ITI4,12,Lazio,Lazio,5879082,3429272,58.33,0.69
4781,2021-07-29,LAZ,56097,28579,27518,7677,48036,384,ITI,ITI4,12,Lazio,Lazio,5879082,3485369,59.28,0.95
4782,2021-01-01,LAZ,3603,1398,2205,3563,0,40,ITI,ITI4,12,Lazio,Lazio,5879082,3488972,59.35,0.06
4783,2021-01-10,LAZ,4136,1739,2397,4069,0,67,ITI,ITI4,12,Lazio,Lazio,5879082,3493108,59.42,0.07
4784,2021-06-16,LAZ,64775,31111,33664,32079,32050,646,ITI,ITI4,12,Lazio,Lazio,5879082,3557883,60.52,1.1
4785,2021-04-20,LAZ,31190,14312,16878,19371,11378,441,ITI,ITI4,12,Lazio,Lazio,5879082,3589073,61.05,0.53
4786,2021-09-07,LAZ,13210,6703,6507,6986,5767,457,ITI,ITI4,12,Lazio,Lazio,5879082,3602283,61.27,0.22
4787,2021-03-06,LAZ,18408,7098,11310,13899,4278,231,ITI,ITI4,12,Lazio,Lazio,5879082,3620691,61.59,0.31
4788,2021-01-31,LAZ,4466,1858,2608,481,3985,0,ITI,ITI4,12,Lazio,Lazio,5879082,3625157,61.66,0.08
4789,2021-05-11,LAZ,48409,22233,26176,31130,16601,678,ITI,ITI4,12,Lazio,Lazio,5879082,3673566,62.49,0.82
4790,2021-07-16,LAZ,44400,21365,23035,3258,40954,188,ITI,ITI4,12,Lazio,Lazio,5879082,3717966,63.24,0.76
4791,2021-04-24,LAZ,33594,15160,18434,20140,12910,544,ITI,ITI4,12,Lazio,Lazio,5879082,3751560,63.81,0.57
4792,2021-08-02,LAZ,37612,19664,17948,6567,30811,234,ITI,ITI4,12,Lazio,Lazio,5879082,3789172,64.45,0.64
4793,2021-08-21,LAZ,10212,5872,4340,3220,6888,104,ITI,ITI4,12,Lazio,Lazio,5879082,3799384,64.63,0.17
4794,2021-06-01,LAZ,49179,23732,25447,30084,18603,492,ITI,ITI4,12,Lazio,Lazio,5879082,3848563,65.46,0.84
4795,2021-04-05,LAZ,19991,9157,10834,13618,6217,156,ITI,ITI4,12,Lazio,Lazio,5879082,3868554,65.8,0.34
4796,2021-09-09,LAZ,12200,6218,5982,6236,5416,548,ITI,ITI4,12,Lazio,Lazio,5879082,3880754,66.01,0.21
4797,2021-07-28,LAZ,58353,29814,28539,8671,49325,357,ITI,ITI4,12,Lazio,Lazio,5879082,3939107,67.0,0.99
4798,2021-05-25,LAZ,47656,22375,25281,35320,11737,599,ITI,ITI4,12,Lazio,Lazio,5879082,3986763,67.81,0.81
4799,2021-09-02,LAZ,26237,13469,12768,8003,17788,446,ITI,ITI4,12,Lazio,Lazio,5879082,4013000,68.26,0.45
4800,2021-05-06,LAZ,48904,22790,26114,30544,17625,735,ITI,ITI4,12,Lazio,Lazio,5879082,4061904,69.09,0.83
4801,2021-08-14,LAZ,2540,1436,1104,993,1515,32,ITI,ITI4,12,Lazio,Lazio,5879082,4064444,69.13,0.04
4802,2021-08-16,LAZ,3703,2041,1662,2061,1580,62,ITI,ITI4,12,Lazio,Lazio,5879082,4068147,69.2,0.06
4803,2021-01-17,LAZ,4961,2052,2909,4683,213,65,ITI,ITI4,12,Lazio,Lazio,5879082,4073108,69.28,0.08
4804,2021-07-02,LAZ,48578,23278,25300,6615,41772,191,ITI,ITI4,12,Lazio,Lazio,5879082,4121686,70.11,0.83
4805,2021-02-08,LAZ,9761,4170,5591,4511,5248,2,ITI,ITI4,12,Lazio,Lazio,5879082,4131447,70.27,0.17
4806,2021-05-02,LAZ,32946,14466,18480,22942,9473,531,ITI,ITI4,12,Lazio,Lazio,5879082,4164393,70.83,0.56
4807,2021-01-22,LAZ,4036,1653,2383,520,3516,0,ITI,ITI4,12,Lazio,Lazio,5879082,4168429,70.9,0.07
4808,2021-02-27,LAZ,11544,4337,7207,10351,1052,141,ITI,ITI4,12,Lazio,Lazio,5879082,4179973,71.1,0.2
4809,2021-05-20,LAZ,51959,25076,26883,37233,13994,732,ITI,ITI4,12,Lazio,Lazio,5879082,4231932,71.98,0.88
4810,2021-08-28,LAZ,32621,17034,15587,11034,20839,748,ITI,ITI4,12,Lazio,Lazio,5879082,4264553,72.54,0.55
4811,2021-06-20,LAZ,55347,25455,29892,29605,24969,773,ITI,ITI4,12,Lazio,Lazio,5879082,4319900,73.48,0.94
4812,2021-06-06,LAZ,58298,28107,30191,35144,22546,608,ITI,ITI4,12,Lazio,Lazio,5879082,4378198,74.47,0.99
4813,2021-02-26,LAZ,13201,5761,7440,11549,1465,187,ITI,ITI4,12,Lazio,Lazio,5879082,4391399,74.7,0.22
4814,2021-08-12,LAZ,48048,24884,23164,20836,26230,982,ITI,ITI4,12,Lazio,Lazio,5879082,4439447,75.51,0.82
4815,2021-02-24,LAZ,12111,5237,6874,10937,1044,130,ITI,ITI4,12,Lazio,Lazio,5879082,4451558,75.72,0.21
4816,2021-07-07,LAZ,62720,31060,31660,28383,33729,608,ITI,ITI4,12,Lazio,Lazio,5879082,4514278,76.79,1.07
4817,2021-03-29,LAZ,25608,12165,13443,18207,7085,316,ITI,ITI4,12,Lazio,Lazio,5879082,4539886,77.22,0.44
4818,2021-03-15,LAZ,21040,9877,11163,14001,6773,266,ITI,ITI4,12,Lazio,Lazio,5879082,4560926,77.58,0.36
4819,2021-01-05,LAZ,7457,2833,4624,7354,0,103,ITI,ITI4,12,Lazio,Lazio,5879082,4568383,77.71,0.13
4820,2021-01-24,LAZ,5705,2232,3473,620,5085,0,ITI,ITI4,12,Lazio,Lazio,5879082,4574088,77.8,0.1
4821,2021-02-07,LAZ,4977,2052,2925,413,4563,1,ITI,ITI4,12,Lazio,Lazio,5879082,4579065,77.89,0.08
4822,2021-05-18,LAZ,45134,20652,24482,34902,9618,614,ITI,ITI4,12,Lazio,Lazio,5879082,4624199,78.66,0.77
4823,2021-03-22,LAZ,23440,10575,12865,16360,6740,340,ITI,ITI4,12,Lazio,Lazio,5879082,4647639,79.05,0.4
4824,2020-12-29,LAZ,498,182,316,494,0,4,ITI,ITI4,12,Lazio,Lazio,5879082,4648137,79.06,0.01
4825,2021-05-30,LAZ,41286,17663,23623,33243,7379,664,ITI,ITI4,12,Lazio,Lazio,5879082,4689423,79.76,0.7
4826,2021-05-13,LAZ,50301,22617,27684,31656,17888,757,ITI,ITI4,12,Lazio,Lazio,5879082,4739724,80.62,0.86
4827,2021-08-04,LAZ,48037,24211,23826,20735,26613,689,ITI,ITI4,12,Lazio,Lazio,5879082,4787761,81.44,0.82
4828,2021-03-08,LAZ,20966,9109,11857,15354,5309,303,ITI,ITI4,12,Lazio,Lazio,5879082,4808727,81.79,0.36
4829,2021-04-22,LAZ,39253,19526,19727,23818,14747,688,ITI,ITI4,12,Lazio,Lazio,5879082,4847980,82.46,0.67
4830,2021-03-10,LAZ,23392,10690,12702,17361,5669,362,ITI,ITI4,12,Lazio,Lazio,5879082,4871372,82.86,0.4
4831,2021-01-12,LAZ,5551,2048,3503,5408,0,143,ITI,ITI4,12,Lazio,Lazio,5879082,4876923,82.95,0.09
4832,2021-06-18,LAZ,64468,31058,33410,30307,33396,765,ITI,ITI4,12,Lazio,Lazio,5879082,4941391,84.05,1.1
4833,2021-04-12,LAZ,23954,10802,13152,16656,6967,331,ITI,ITI4,12,Lazio,Lazio,5879082,4965345,84.46,0.41
4834,2021-07-21,LAZ,63496,32370,31126,29268,32842,1386,ITI,ITI4,12,Lazio,Lazio,5879082,5028841,85.54,1.08
4835,2021-06-08,LAZ,66846,31911,34935,36158,30029,659,ITI,ITI4,12,Lazio,Lazio,5879082,5095687,86.67,1.14
4836,2021-07-14,LAZ,42228,20588,21640,6210,35650,368,ITI,ITI4,12,Lazio,Lazio,5879082,5137915,87.39,0.72
4837,2021-01-09,LAZ,6426,2617,3809,6313,0,113,ITI,ITI4,12,Lazio,Lazio,5879082,5144341,87.5,0.11
4838,2021-04-19,LAZ,30184,13727,16457,18963,10738,483,ITI,ITI4,12,Lazio,Lazio,5879082,5174525,88.02,0.51
4839,2021-02-21,LAZ,7000,3184,3816,6483,467,50,ITI,ITI4,12,Lazio,Lazio,5879082,5181525,88.13,0.12
4840,2021-01-19,LAZ,4791,1969,2822,4334,454,3,ITI,ITI4,12,Lazio,Lazio,5879082,5186316,88.22,0.08
4841,2021-04-29,LAZ,38870,17357,21513,24815,13375,680,ITI,ITI4,12,Lazio,Lazio,5879082,5225186,88.88,0.66
4842,2021-03-03,LAZ,17921,7900,10021,13343,4315,263,ITI,ITI4,12,Lazio,Lazio,5879082,5243107,89.18,0.3
4843,2021-08-09,LAZ,52720,26780,25940,21955,29688,1077,ITI,ITI4,12,Lazio,Lazio,5879082,5295827,90.08,0.9
4844,2021-01-26,LAZ,7989,3134,4855,744,7245,0,ITI,ITI4,12,Lazio,Lazio,5879082,5303816,90.22,0.14
4845,2021-04-02,LAZ,29574,14187,15387,21760,7401,413,ITI,ITI4,12,Lazio,Lazio,5879082,5333390,90.72,0.5
4846,2021-07-11,LAZ,44171,22276,21895,3759,40254,158,ITI,ITI4,12,Lazio,Lazio,5879082,5377561,91.47,0.75
4847,2021-01-28,LAZ,8340,3188,5152,837,7502,1,ITI,ITI4,12,Lazio,Lazio,5879082,5385901,91.61,0.14
4848,2021-07-04,LAZ,46629,21711,24918,4129,42411,89,ITI,ITI4,12,Lazio,Lazio,5879082,5432530,92.4,0.79
4849,2021-05-08,LAZ,45525,20786,24739,29325,15466,734,ITI,ITI4,12,Lazio,Lazio,5879082,5478055,93.18,0.77
4850,2021-09-08,LAZ,12224,6294,5930,6820,4829,575,ITI,ITI4,12,Lazio,Lazio,5879082,5490279,93.39,0.21
4851,2021-07-09,LAZ,65108,31415,33693,27616,36728,764,ITI,ITI4,12,Lazio,Lazio,5879082,5555387,94.49,1.11
4852,2021-05-01,LAZ,38277,17212,21065,25709,12081,487,ITI,ITI4,12,Lazio,Lazio,5879082,5593664,95.15,0.65
4853,2021-04-17,LAZ,32497,14255,18242,19961,12071,465,ITI,ITI4,12,Lazio,Lazio,5879082,5626161,95.7,0.55
4854,2021-07-26,LAZ,50913,25081,25832,6667,43925,321,ITI,ITI4,12,Lazio,Lazio,5879082,5677074,96.56,0.87
4855,2021-08-11,LAZ,49025,25716,23309,20488,27655,882,ITI,ITI4,12,Lazio,Lazio,5879082,5726099,97.4,0.83
4856,2021-05-03,LAZ,39654,17907,21747,26185,12789,680,ITI,ITI4,12,Lazio,Lazio,5879082,5765753,98.07,0.67
4857,2021-07-25,LAZ,24674,12149,12525,2100,22524,50,ITI,ITI4,12,Lazio,Lazio,5879082,5790427,98.49,0.42
4858,2021-09-04,LAZ,14282,7268,7014,9675,3873,734,ITI,ITI4,12,Lazio,Lazio,5879082,5804709,98.73,0.24
4859,2021-06-13,LAZ,58474,26240,32234,33076,24881,517,ITI,ITI4,12,Lazio,Lazio,5879082,5863183,99.73,0.99
4860,2021-03-07,LAZ,14177,5486,8691,10354,3604,219,ITI,ITI4,12,Lazio,Lazio,5879082,5877360,99.97,0.24
4861,2021-06-15,LAZ,66254,32030,34224,33375,32297,582,ITI,ITI4,12,Lazio,Lazio,5879082,5943614,101.1,1.13
4862,2021-03-24,LAZ,27999,13154,14845,21314,6277,408,ITI,ITI4,12,Lazio,Lazio,5879082,5971613,101.57,0.48
4863,2021-09-06,LAZ,14421,7363,7058,7939,5879,603,ITI,ITI4,12,Lazio,Lazio,5879082,5986034,101.82,0.25
4864,2021-08-20,LAZ,8421,4743,3678,2118,6204,99,ITI,ITI4,12,Lazio,Lazio,5879082,5994455,101.96,0.14
4865,2021-05-29,LAZ,52117,23451,28666,40197,11056,864,ITI,ITI4,12,Lazio,Lazio,5879082,6046572,102.85,0.89
4866,2021-02-14,LAZ,5808,2383,3425,5301,476,31,ITI,ITI4,12,Lazio,Lazio,5879082,6052380,102.95,0.1
4867,2021-02-28,LAZ,10292,4042,6250,9646,545,101,ITI,ITI4,12,Lazio,Lazio,5879082,6062672,103.12,0.18
4868,2021-01-02,LAZ,6843,2682,4161,6763,0,80,ITI,ITI4,12,Lazio,Lazio,5879082,6069515,103.24,0.12
4869,2021-07-13,LAZ,42768,20971,21797,5509,36912,347,ITI,ITI4,12,Lazio,Lazio,5879082,6112283,103.97,0.73
4870,2021-03-26,LAZ,30396,14086,16310,23012,6913,471,ITI,ITI4,12,Lazio,Lazio,5879082,6142679,104.48,0.52
4871,2021-07-06,LAZ,62644,30400,32244,28559,33579,506,ITI,ITI4,12,Lazio,Lazio,5879082,6205323,105.55,1.07
4872,2021-08-01,LAZ,39798,21220,18578,5731,33756,311,ITI,ITI4,12,Lazio,Lazio,5879082,6245121,106.23,0.68
4873,2021-05-10,LAZ,44528,20364,24164,30366,13451,711,ITI,ITI4,12,Lazio,Lazio,5879082,6289649,106.98,0.76
4874,2021-08-18,LAZ,9514,5500,4014,3269,6125,120,ITI,ITI4,12,Lazio,Lazio,5879082,6299163,107.15,0.16
4875,2021-05-27,LAZ,58584,27262,31322,43968,13825,791,ITI,ITI4,12,Lazio,Lazio,5879082,6357747,108.14,1.0
4876,2021-06-29,LAZ,59536,28290,31246,27743,31195,598,ITI,ITI4,12,Lazio,Lazio,5879082,6417283,109.15,1.01
4877,2021-01-14,LAZ,5670,2236,3434,5495,0,175,ITI,ITI4,12,Lazio,Lazio,5879082,6422953,109.25,0.1
4878,2021-04-07,LAZ,26052,12198,13854,18343,7330,379,ITI,ITI4,12,Lazio,Lazio,5879082,6449005,109.69,0.44
4879,2020-12-28,LAZ,961,414,547,956,0,5,ITI,ITI4,12,Lazio,Lazio,5879082,6449966,109.71,0.02
4880,2021-01-16,LAZ,5781,2338,3443,5633,0,148,ITI,ITI4,12,Lazio,Lazio,5879082,6455747,109.81,0.1
4881,2021-04-26,LAZ,29360,13511,15849,19547,9303,510,ITI,ITI4,12,Lazio,Lazio,5879082,6485107,110.31,0.5
4882,2021-02-02,LAZ,5921,2219,3702,641,5277,3,ITI,ITI4,12,Lazio,Lazio,5879082,6491028,110.41,0.1
4883,2021-07-18,LAZ,58414,29740,28674,22785,34818,811,ITI,ITI4,12,Lazio,Lazio,5879082,6549442,111.4,0.99
4884,2021-03-12,LAZ,24159,11173,12986,17386,6402,371,ITI,ITI4,12,Lazio,Lazio,5879082,6573601,111.81,0.41
4885,2021-08-13,LAZ,43645,22689,20956,20119,22437,1089,ITI,ITI4,12,Lazio,Lazio,5879082,6617246,112.56,0.74
4886,2021-02-09,LAZ,8858,3808,5050,4581,4270,7,ITI,ITI4,12,Lazio,Lazio,5879082,6626104,112.71,0.15
4887,2021-02-23,LAZ,11120,4796,6324,10211,778,131,ITI,ITI4,12,Lazio,Lazio,5879082,6637224,112.9,0.19
4888,2021-06-22,LAZ,62874,29088,33786,28597,33551,726,ITI,ITI4,12,Lazio,Lazio,5879082,6700098,113.97,1.07
4889,2021-03-14,LAZ,17304,6781,10523,11855,5182,267,ITI,ITI4,12,Lazio,Lazio,5879082,6717402,114.26,0.29
4890,2021-09-13,LAZ,18556,9469,9087,5426,12426,704,ITI,ITI4,12,Lazio,Lazio,5879082,6735958,114.57,0.32
4891,2021-03-17,LAZ,13890,5954,7936,7471,6299,120,ITI,ITI4,12,Lazio,Lazio,5879082,6749848,114.81,0.24
4892,2021-06-25,LAZ,63468,30655,32813,28133,34729,606,ITI,ITI4,12,Lazio,Lazio,5879082,6813316,115.89,1.08
4893,2021-06-27,LAZ,47271,21621,25650,20570,26197,504,ITI,ITI4,12,Lazio,Lazio,5879082,6860587,116.69,0.8
4894,2021-08-23,LAZ,22761,12399,10362,16343,5424,994,ITI,ITI4,12,Lazio,Lazio,5879082,6883348,117.08,0.39
4895,2021-03-05,LAZ,19627,8697,10930,14617,4764,246,ITI,ITI4,12,Lazio,Lazio,5879082,6902975,117.42,0.33
4896,2021-02-16,LAZ,8377,4046,4331,7707,626,44,ITI,ITI4,12,Lazio,Lazio,5879082,6911352,117.56,0.14
4897,2021-01-21,LAZ,5744,2416,3328,632,5112,0,ITI,ITI4,12,Lazio,Lazio,5879082,6917096,117.66,0.1
4898,2021-03-31,LAZ,27911,13503,14408,20401,7158,352,ITI,ITI4,12,Lazio,Lazio,5879082,6945007,118.13,0.47
4899,2021-01-07,LAZ,7942,2982,4960,7785,0,157,ITI,ITI4,12,Lazio,Lazio,5879082,6952949,118.27,0.14
4900,2021-02-04,LAZ,6476,2582,3894,1151,5324,1,ITI,ITI4,12,Lazio,Lazio,5879082,6959425,118.38,0.11
4901,2021-08-25,LAZ,31749,16670,15079,9918,21223,608,ITI,ITI4,12,Lazio,Lazio,5879082,6991174,118.92,0.54
4902,2021-05-22,LAZ,55235,27070,28165,43679,10714,842,ITI,ITI4,12,Lazio,Lazio,5879082,7046409,119.86,0.94
4903,2021-08-30,LAZ,30585,15449,15136,9988,19904,693,ITI,ITI4,12,Lazio,Lazio,5879082,7076994,120.38,0.52
4904,2021-05-15,LAZ,57525,27478,30047,40052,16593,880,ITI,ITI4,12,Lazio,Lazio,5879082,7134519,121.35,0.98
4905,2021-03-19,LAZ,17521,7603,9918,11003,6359,159,ITI,ITI4,12,Lazio,Lazio,5879082,7152040,121.65,0.3
4906,2021-09-01,LAZ,26466,13566,12900,8164,17776,526,ITI,ITI4,12,Lazio,Lazio,5879082,7178506,122.1,0.45
4907,2021-03-27,LAZ,26570,10812,15758,19496,6522,552,ITI,ITI4,12,Lazio,Lazio,5879082,7205076,122.55,0.45
4908,2021-08-31,LAZ,31110,15393,15717,11683,18481,946,ITI,ITI4,12,Lazio,Lazio,5879082,7236186,123.08,0.53
4909,2021-07-05,LAZ,61758,29730,32028,25599,35080,1079,ITI,ITI4,12,Lazio,Lazio,5879082,7297944,124.13,1.05
4910,2021-05-23,LAZ,47189,22897,24292,39132,7410,647,ITI,ITI4,12,Lazio,Lazio,5879082,7345133,124.94,0.8
4911,2021-05-09,LAZ,37578,17274,20304,25784,11294,500,ITI,ITI4,12,Lazio,Lazio,5879082,7382711,125.58,0.64
4912,2021-08-17,LAZ,8191,4762,3429,3959,4138,94,ITI,ITI4,12,Lazio,Lazio,5879082,7390902,125.72,0.14
4913,2021-07-12,LAZ,41463,20735,20728,5864,35362,237,ITI,ITI4,12,Lazio,Lazio,5879082,7432365,126.42,0.71
4914,2021-05-16,LAZ,51031,24575,26456,36909,13522,600,ITI,ITI4,12,Lazio,Lazio,5879082,7483396,127.29,0.87
4915,2021-08-24,LAZ,18836,10063,8773,11749,6373,714,ITI,ITI4,12,Lazio,Lazio,5879082,7502232,127.61,0.32
4916,2021-06-28,LAZ,58983,28204,30779,27481,31042,460,ITI,ITI4,12,Lazio,Lazio,5879082,7561215,128.61,1.0
4917,2021-02-12,LAZ,6902,2883,4019,6380,440,82,ITI,ITI4,12,Lazio,Lazio,5879082,7568117,128.73,0.12
4918,2020-12-31,LAZ,5377,2153,3224,5317,0,60,ITI,ITI4,12,Lazio,Lazio,5879082,7573494,128.82,0.09
4919,2021-09-11,LAZ,12359,6108,6251,8344,3135,880,ITI,ITI4,12,Lazio,Lazio,5879082,7585853,129.03,0.21
4920,2021-04-10,LAZ,23958,10426,13532,16473,7209,276,ITI,ITI4,12,Lazio,Lazio,5879082,7609811,129.44,0.41
4921,2021-02-05,LAZ,7343,3004,4339,1221,6118,4,ITI,ITI4,12,Lazio,Lazio,5879082,7617154,129.56,0.12
4922,2021-04-03,LAZ,24867,11231,13636,17892,6744,231,ITI,ITI4,12,Lazio,Lazio,5879082,7642021,129.99,0.42
4923,2021-02-19,LAZ,10101,5105,4996,9079,873,149,ITI,ITI4,12,Lazio,Lazio,5879082,7652122,130.16,0.17
4924,2021-06-17,LAZ,67089,32288,34801,31812,34542,735,ITI,ITI4,12,Lazio,Lazio,5879082,7719211,131.3,1.14
4925,2021-04-21,LAZ,33183,15082,18101,20237,12503,443,ITI,ITI4,12,Lazio,Lazio,5879082,7752394,131.86,0.56
4926,2021-07-30,LAZ,56087,29084,27003,7478,48248,361,ITI,ITI4,12,Lazio,Lazio,5879082,7808481,132.82,0.95
4927,2021-06-03,LAZ,56931,28762,28169,38293,17895,743,ITI,ITI4,12,Lazio,Lazio,5879082,7865412,133.79,0.97
4928,2021-08-06,LAZ,33656,17701,15955,22405,10187,1064,ITI,ITI4,12,Lazio,Lazio,5879082,7899068,134.36,0.57
4929,2021-06-10,LAZ,72291,34163,38128,37314,34114,863,ITI,ITI4,12,Lazio,Lazio,5879082,7971359,135.59,1.23
4930,2021-04-14,LAZ,29405,13328,16077,18855,10197,353,ITI,ITI4,12,Lazio,Lazio,5879082,8000764,136.09,0.5
4931,2021-07-23,LAZ,58524,29356,29168,26810,29931,1783,ITI,ITI4,12,Lazio,Lazio,5879082,8059288,137.08,1.0
4932,2021-01-10,BAS,77,24,53,77,0,0,ITF,ITF5,17,Basilicata,Basilicata,559084,77,0.01,0.01
4933,2021-04-20,BAS,4151,1982,2169,2179,1944,28,ITF,ITF5,17,Basilicata,Basilicata,559084,4228,0.76,0.74
4934,2021-08-07,BAS,4518,2377,2141,1360,3098,60,ITF,ITF5,17,Basilicata,Basilicata,559084,8746,1.56,0.81
4935,2021-08-12,BAS,3918,2000,1918,1677,2159,82,ITF,ITF5,17,Basilicata,Basilicata,559084,12664,2.27,0.7
4936,2021-07-26,BAS,5417,2721,2696,1991,3388,38,ITF,ITF5,17,Basilicata,Basilicata,559084,18081,3.23,0.97
4937,2021-01-22,BAS,67,24,43,67,0,0,ITF,ITF5,17,Basilicata,Basilicata,559084,18148,3.25,0.01
4938,2021-07-24,BAS,5750,2946,2804,1777,3923,50,ITF,ITF5,17,Basilicata,Basilicata,559084,23898,4.27,1.03
4939,2021-05-04,BAS,4143,1996,2147,3569,524,50,ITF,ITF5,17,Basilicata,Basilicata,559084,28041,5.02,0.74
4940,2021-03-08,BAS,1477,725,752,823,621,33,ITF,ITF5,17,Basilicata,Basilicata,559084,29518,5.28,0.26
4941,2021-06-16,BAS,4606,2086,2520,2126,2460,20,ITF,ITF5,17,Basilicata,Basilicata,559084,34124,6.1,0.82
4942,2021-03-25,BAS,1886,606,1280,1513,349,24,ITF,ITF5,17,Basilicata,Basilicata,559084,36010,6.44,0.34
4943,2021-01-27,BAS,421,179,242,113,308,0,ITF,ITF5,17,Basilicata,Basilicata,559084,36431,6.52,0.08
4944,2021-02-10,BAS,552,241,311,497,53,2,ITF,ITF5,17,Basilicata,Basilicata,559084,36983,6.61,0.1
4945,2021-05-21,BAS,4578,2321,2257,1480,3086,12,ITF,ITF5,17,Basilicata,Basilicata,559084,41561,7.43,0.82
4946,2021-04-08,BAS,788,361,427,760,10,18,ITF,ITF5,17,Basilicata,Basilicata,559084,42349,7.57,0.14
4947,2021-04-22,BAS,5051,2353,2698,3382,1614,55,ITF,ITF5,17,Basilicata,Basilicata,559084,47400,8.48,0.9
4948,2021-07-31,BAS,5470,2878,2592,1823,3591,56,ITF,ITF5,17,Basilicata,Basilicata,559084,52870,9.46,0.98
4949,2021-07-17,BAS,5857,2917,2940,1709,4109,39,ITF,ITF5,17,Basilicata,Basilicata,559084,58727,10.5,1.05
4950,2021-06-30,BAS,3452,1668,1784,2315,1111,26,ITF,ITF5,17,Basilicata,Basilicata,559084,62179,11.12,0.62
4951,2021-06-04,BAS,4832,2289,2543,3749,1046,37,ITF,ITF5,17,Basilicata,Basilicata,559084,67011,11.99,0.86
4952,2021-09-12,BAS,1754,929,825,303,1423,28,ITF,ITF5,17,Basilicata,Basilicata,559084,68765,12.3,0.31
4953,2021-02-24,BAS,1815,744,1071,1729,75,11,ITF,ITF5,17,Basilicata,Basilicata,559084,70580,12.62,0.32
4954,2021-08-26,BAS,2524,1279,1245,1120,1340,64,ITF,ITF5,17,Basilicata,Basilicata,559084,73104,13.08,0.45
4955,2021-02-22,BAS,1799,778,1021,1737,53,9,ITF,ITF5,17,Basilicata,Basilicata,559084,74903,13.4,0.32
4956,2021-05-30,BAS,2778,1421,1357,920,1853,5,ITF,ITF5,17,Basilicata,Basilicata,559084,77681,13.89,0.5
4957,2021-04-03,BAS,1815,754,1061,1464,338,13,ITF,ITF5,17,Basilicata,Basilicata,559084,79496,14.22,0.32
4958,2021-09-07,BAS,2657,1371,1286,679,1906,72,ITF,ITF5,17,Basilicata,Basilicata,559084,82153,14.69,0.48
4959,2021-08-24,BAS,3270,1768,1502,1480,1713,77,ITF,ITF5,17,Basilicata,Basilicata,559084,85423,15.28,0.58
4960,2021-01-15,BAS,819,353,466,819,0,0,ITF,ITF5,17,Basilicata,Basilicata,559084,86242,15.43,0.15
4961,2020-12-27,BAS,106,41,65,106,0,0,ITF,ITF5,17,Basilicata,Basilicata,559084,86348,15.44,0.02
4962,2021-03-20,BAS,1307,577,730,276,1024,7,ITF,ITF5,17,Basilicata,Basilicata,559084,87655,15.68,0.23
4963,2021-06-28,BAS,3641,1747,1894,2113,1509,19,ITF,ITF5,17,Basilicata,Basilicata,559084,91296,16.33,0.65
4964,2021-01-08,BAS,556,220,336,556,0,0,ITF,ITF5,17,Basilicata,Basilicata,559084,91852,16.43,0.1
4965,2021-03-15,BAS,2382,998,1384,511,1852,19,ITF,ITF5,17,Basilicata,Basilicata,559084,94234,16.86,0.43
4966,2021-01-17,BAS,331,133,198,330,1,0,ITF,ITF5,17,Basilicata,Basilicata,559084,94565,16.91,0.06
4967,2021-04-27,BAS,4730,2243,2487,4349,327,54,ITF,ITF5,17,Basilicata,Basilicata,559084,99295,17.76,0.85
4968,2021-08-05,BAS,4557,2320,2237,1284,3232,41,ITF,ITF5,17,Basilicata,Basilicata,559084,103852,18.58,0.82
4969,2021-05-02,BAS,4182,2001,2181,3489,629,64,ITF,ITF5,17,Basilicata,Basilicata,559084,108034,19.32,0.75
4970,2021-04-15,BAS,3431,1679,1752,2586,799,46,ITF,ITF5,17,Basilicata,Basilicata,559084,111465,19.94,0.61
4971,2021-07-07,BAS,5203,2470,2733,2019,3169,15,ITF,ITF5,17,Basilicata,Basilicata,559084,116668,20.87,0.93
4972,2021-01-03,BAS,910,347,563,910,0,0,ITF,ITF5,17,Basilicata,Basilicata,559084,117578,21.03,0.16
4973,2021-06-09,BAS,4422,2071,2351,3966,423,33,ITF,ITF5,17,Basilicata,Basilicata,559084,122000,21.82,0.79
4974,2021-04-13,BAS,2120,1054,1066,1278,823,19,ITF,ITF5,17,Basilicata,Basilicata,559084,124120,22.2,0.38
4975,2021-03-01,BAS,553,286,267,384,169,0,ITF,ITF5,17,Basilicata,Basilicata,559084,124673,22.3,0.1
4976,2021-08-14,BAS,3478,1906,1572,1421,1997,60,ITF,ITF5,17,Basilicata,Basilicata,559084,128151,22.92,0.62
4977,2021-06-18,BAS,4466,2067,2399,2180,2259,27,ITF,ITF5,17,Basilicata,Basilicata,559084,132617,23.72,0.8
4978,2021-09-02,BAS,3031,1624,1407,881,2072,78,ITF,ITF5,17,Basilicata,Basilicata,559084,135648,24.26,0.54
4979,2021-04-01,BAS,2739,1121,1618,1968,740,31,ITF,ITF5,17,Basilicata,Basilicata,559084,138387,24.75,0.49
4980,2021-02-03,BAS,675,305,370,32,643,0,ITF,ITF5,17,Basilicata,Basilicata,559084,139062,24.87,0.12
4981,2021-02-17,BAS,1137,493,644,1058,77,2,ITF,ITF5,17,Basilicata,Basilicata,559084,140199,25.08,0.2
4982,2021-05-28,BAS,3617,1811,1806,918,2666,33,ITF,ITF5,17,Basilicata,Basilicata,559084,143816,25.72,0.65
4983,2021-06-11,BAS,4237,1983,2254,3167,1028,42,ITF,ITF5,17,Basilicata,Basilicata,559084,148053,26.48,0.76
4984,2021-08-19,BAS,3595,1871,1724,1671,1836,88,ITF,ITF5,17,Basilicata,Basilicata,559084,151648,27.12,0.64
4985,2021-05-11,BAS,2654,1353,1301,1597,1033,24,ITF,ITF5,17,Basilicata,Basilicata,559084,154302,27.6,0.47
4986,2021-02-05,BAS,998,449,549,64,932,2,ITF,ITF5,17,Basilicata,Basilicata,559084,155300,27.78,0.18
4987,2021-07-12,BAS,5441,2592,2849,1606,3809,26,ITF,ITF5,17,Basilicata,Basilicata,559084,160741,28.75,0.97
4988,2021-05-16,BAS,4977,2470,2507,2809,2113,55,ITF,ITF5,17,Basilicata,Basilicata,559084,165718,29.64,0.89
4989,2021-07-19,BAS,5926,2890,3036,1998,3886,42,ITF,ITF5,17,Basilicata,Basilicata,559084,171644,30.7,1.06
4990,2021-05-23,BAS,4518,2302,2216,1527,2984,7,ITF,ITF5,17,Basilicata,Basilicata,559084,176162,31.51,0.81
4991,2021-06-23,BAS,3240,1522,1718,2331,876,33,ITF,ITF5,17,Basilicata,Basilicata,559084,179402,32.09,0.58
4992,2021-09-14,BAS,2338,1283,1055,464,1826,48,ITF,ITF5,17,Basilicata,Basilicata,559084,181740,32.51,0.42
4993,2021-03-13,BAS,1811,896,915,740,1049,22,ITF,ITF5,17,Basilicata,Basilicata,559084,183551,32.83,0.32
4994,2021-03-06,BAS,1377,544,833,752,612,13,ITF,ITF5,17,Basilicata,Basilicata,559084,184928,33.08,0.25
4995,2021-05-09,BAS,4688,2342,2346,2945,1694,49,ITF,ITF5,17,Basilicata,Basilicata,559084,189616,33.92,0.84
4996,2021-02-15,BAS,636,240,396,576,44,16,ITF,ITF5,17,Basilicata,Basilicata,559084,190252,34.03,0.11
4997,2021-01-29,BAS,619,233,386,63,556,0,ITF,ITF5,17,Basilicata,Basilicata,559084,190871,34.14,0.11
4998,2021-06-27,BAS,3007,1477,1530,2377,616,14,ITF,ITF5,17,Basilicata,Basilicata,559084,193878,34.68,0.54
4999,2021-04-29,BAS,4859,2399,2460,4342,441,76,ITF,ITF5,17,Basilicata,Basilicata,559084,198737,35.55,0.87
5000,2021-03-17,BAS,1474,615,859,24,1446,4,ITF,ITF5,17,Basilicata,Basilicata,559084,200211,35.81,0.26
5001,2021-01-19,BAS,199,84,115,199,0,0,ITF,ITF5,17,Basilicata,Basilicata,559084,200410,35.85,0.04
5002,2021-07-09,BAS,5338,2608,2730,1696,3633,9,ITF,ITF5,17,Basilicata,Basilicata,559084,205748,36.8,0.95
5003,2021-04-17,BAS,3461,1655,1806,2170,1262,29,ITF,ITF5,17,Basilicata,Basilicata,559084,209209,37.42,0.62
5004,2021-08-23,BAS,3315,1736,1579,1369,1864,82,ITF,ITF5,17,Basilicata,Basilicata,559084,212524,38.01,0.59
5005,2021-01-24,BAS,869,317,552,58,810,1,ITF,ITF5,17,Basilicata,Basilicata,559084,213393,38.17,0.16
5006,2021-05-13,BAS,5986,2969,3017,3298,2598,90,ITF,ITF5,17,Basilicata,Basilicata,559084,219379,39.24,1.07
5007,2021-08-21,BAS,3268,1778,1490,1711,1461,96,ITF,ITF5,17,Basilicata,Basilicata,559084,222647,39.82,0.58
5008,2021-07-14,BAS,5641,2721,2920,1627,3989,25,ITF,ITF5,17,Basilicata,Basilicata,559084,228288,40.83,1.01
5009,2021-04-05,BAS,726,235,491,411,305,10,ITF,ITF5,17,Basilicata,Basilicata,559084,229014,40.96,0.13
5010,2021-03-22,BAS,1223,549,674,641,574,8,ITF,ITF5,17,Basilicata,Basilicata,559084,230237,41.18,0.22
5011,2021-03-03,BAS,1807,843,964,1215,565,27,ITF,ITF5,17,Basilicata,Basilicata,559084,232044,41.5,0.32
5012,2021-06-01,BAS,6137,2927,3210,3034,3076,27,ITF,ITF5,17,Basilicata,Basilicata,559084,238181,42.6,1.1
5013,2021-09-09,BAS,3182,1702,1480,684,2418,80,ITF,ITF5,17,Basilicata,Basilicata,559084,241363,43.17,0.57
5014,2021-08-04,BAS,4500,2232,2268,1423,3035,42,ITF,ITF5,17,Basilicata,Basilicata,559084,245863,43.98,0.8
5015,2021-06-08,BAS,4589,2196,2393,4193,358,38,ITF,ITF5,17,Basilicata,Basilicata,559084,250452,44.8,0.82
5016,2021-04-12,BAS,2175,1054,1121,1651,494,30,ITF,ITF5,17,Basilicata,Basilicata,559084,252627,45.19,0.39
5017,2021-07-21,BAS,5846,2942,2904,1612,4201,33,ITF,ITF5,17,Basilicata,Basilicata,559084,258473,46.23,1.05
5018,2021-04-19,BAS,4182,1920,2262,2395,1653,134,ITF,ITF5,17,Basilicata,Basilicata,559084,262655,46.98,0.75
5019,2021-07-28,BAS,5037,2576,2461,1929,3048,60,ITF,ITF5,17,Basilicata,Basilicata,559084,267692,47.88,0.9
5020,2021-06-25,BAS,3318,1571,1747,2444,840,34,ITF,ITF5,17,Basilicata,Basilicata,559084,271010,48.47,0.59
5021,2021-07-04,BAS,3112,1563,1549,2164,922,26,ITF,ITF5,17,Basilicata,Basilicata,559084,274122,49.03,0.56
5022,2021-08-30,BAS,3199,1711,1488,1549,1546,104,ITF,ITF5,17,Basilicata,Basilicata,559084,277321,49.6,0.57
5023,2021-03-24,BAS,2001,770,1231,1481,494,26,ITF,ITF5,17,Basilicata,Basilicata,559084,279322,49.96,0.36
5024,2021-07-02,BAS,3689,1839,1850,2484,1176,29,ITF,ITF5,17,Basilicata,Basilicata,559084,283011,50.62,0.66
5025,2021-02-07,BAS,384,163,221,49,335,0,ITF,ITF5,17,Basilicata,Basilicata,559084,283395,50.69,0.07
5026,2021-05-18,BAS,5896,2855,3041,3378,2492,26,ITF,ITF5,17,Basilicata,Basilicata,559084,289291,51.74,1.05
5027,2021-08-09,BAS,4013,2066,1947,1568,2398,47,ITF,ITF5,17,Basilicata,Basilicata,559084,293304,52.46,0.72
5028,2021-07-23,BAS,5551,2781,2770,1889,3616,46,ITF,ITF5,17,Basilicata,Basilicata,559084,298855,53.45,0.99
5029,2021-05-01,BAS,4708,2139,2569,3883,755,70,ITF,ITF5,17,Basilicata,Basilicata,559084,303563,54.3,0.84
5030,2021-02-26,BAS,2163,907,1256,2075,82,6,ITF,ITF5,17,Basilicata,Basilicata,559084,305726,54.68,0.39
5031,2021-05-20,BAS,5885,2981,2904,2886,2971,28,ITF,ITF5,17,Basilicata,Basilicata,559084,311611,55.74,1.05
5032,2021-08-28,BAS,2275,1287,988,1110,1105,60,ITF,ITF5,17,Basilicata,Basilicata,559084,313886,56.14,0.41
5033,2021-06-06,BAS,4512,2074,2438,3695,779,38,ITF,ITF5,17,Basilicata,Basilicata,559084,318398,56.95,0.81
5034,2021-03-05,BAS,1884,870,1014,1103,764,17,ITF,ITF5,17,Basilicata,Basilicata,559084,320282,57.29,0.34
5035,2021-06-13,BAS,3014,1440,1574,2678,308,28,ITF,ITF5,17,Basilicata,Basilicata,559084,323296,57.83,0.54
5036,2021-05-27,BAS,3623,1863,1760,1072,2537,14,ITF,ITF5,17,Basilicata,Basilicata,559084,326919,58.47,0.65
5037,2021-09-04,BAS,2605,1397,1208,773,1764,68,ITF,ITF5,17,Basilicata,Basilicata,559084,329524,58.94,0.47
5038,2021-05-25,BAS,4200,2114,2086,868,3322,10,ITF,ITF5,17,Basilicata,Basilicata,559084,333724,59.69,0.75
5039,2021-02-14,BAS,151,48,103,105,0,46,ITF,ITF5,17,Basilicata,Basilicata,559084,333875,59.72,0.03
5040,2021-01-31,BAS,78,24,54,0,78,0,ITF,ITF5,17,Basilicata,Basilicata,559084,333953,59.73,0.01
5041,2021-01-12,BAS,217,88,129,217,0,0,ITF,ITF5,17,Basilicata,Basilicata,559084,334170,59.77,0.04
5042,2021-05-08,BAS,4845,2407,2438,3379,1413,53,ITF,ITF5,17,Basilicata,Basilicata,559084,339015,60.64,0.87
5043,2021-08-16,BAS,3566,1866,1700,1484,1998,84,ITF,ITF5,17,Basilicata,Basilicata,559084,342581,61.28,0.64
5044,2021-03-10,BAS,1688,847,841,838,839,11,ITF,ITF5,17,Basilicata,Basilicata,559084,344269,61.58,0.3
5045,2021-03-29,BAS,2482,898,1584,2141,288,53,ITF,ITF5,17,Basilicata,Basilicata,559084,346751,62.02,0.44
5046,2021-01-05,BAS,952,410,542,952,0,0,ITF,ITF5,17,Basilicata,Basilicata,559084,347703,62.19,0.17
5047,2021-06-20,BAS,4010,1883,2127,1939,2036,35,ITF,ITF5,17,Basilicata,Basilicata,559084,351713,62.91,0.72
5048,2021-09-11,BAS,2868,1520,1348,763,2040,65,ITF,ITF5,17,Basilicata,Basilicata,559084,354581,63.42,0.51
5049,2021-03-14,BAS,1014,480,534,530,471,13,ITF,ITF5,17,Basilicata,Basilicata,559084,355595,63.6,0.18
5050,2021-03-31,BAS,3122,1273,1849,2301,791,30,ITF,ITF5,17,Basilicata,Basilicata,559084,358717,64.16,0.56
5051,2021-09-13,BAS,2383,1261,1122,490,1847,46,ITF,ITF5,17,Basilicata,Basilicata,559084,361100,64.59,0.43
5052,2021-06-22,BAS,4355,2060,2295,2223,2100,32,ITF,ITF5,17,Basilicata,Basilicata,559084,365455,65.37,0.78
5053,2021-06-05,BAS,4800,2210,2590,3823,941,36,ITF,ITF5,17,Basilicata,Basilicata,559084,370255,66.23,0.86
5054,2021-06-15,BAS,3222,1417,1805,2225,976,21,ITF,ITF5,17,Basilicata,Basilicata,559084,373477,66.8,0.58
5055,2021-02-28,BAS,813,347,466,772,37,4,ITF,ITF5,17,Basilicata,Basilicata,559084,374290,66.95,0.15
5056,2021-01-02,BAS,957,383,574,956,0,1,ITF,ITF5,17,Basilicata,Basilicata,559084,375247,67.12,0.17
5057,2021-01-16,BAS,726,305,421,726,0,0,ITF,ITF5,17,Basilicata,Basilicata,559084,375973,67.25,0.13
5058,2021-04-26,BAS,4466,2165,2301,4196,221,49,ITF,ITF5,17,Basilicata,Basilicata,559084,380439,68.05,0.8
5059,2021-09-01,BAS,3248,1683,1565,1045,2104,99,ITF,ITF5,17,Basilicata,Basilicata,559084,383687,68.63,0.58
5060,2021-02-11,BAS,958,406,552,873,83,2,ITF,ITF5,17,Basilicata,Basilicata,559084,384645,68.8,0.17
5061,2021-08-11,BAS,3710,1923,1787,1429,2223,58,ITF,ITF5,17,Basilicata,Basilicata,559084,388355,69.46,0.66
5062,2021-04-14,BAS,2047,1002,1045,1354,677,16,ITF,ITF5,17,Basilicata,Basilicata,559084,390402,69.83,0.37
5063,2021-01-21,BAS,31,10,21,30,1,0,ITF,ITF5,17,Basilicata,Basilicata,559084,390433,69.83,0.01
5064,2021-01-04,BAS,614,275,339,614,0,0,ITF,ITF5,17,Basilicata,Basilicata,559084,391047,69.94,0.11
5065,2021-07-06,BAS,4210,2008,2202,2114,2060,36,ITF,ITF5,17,Basilicata,Basilicata,559084,395257,70.7,0.75
5066,2021-04-24,BAS,4584,2222,2362,3477,1051,56,ITF,ITF5,17,Basilicata,Basilicata,559084,399841,71.52,0.82
5067,2021-08-02,BAS,4610,2334,2276,1779,2791,40,ITF,ITF5,17,Basilicata,Basilicata,559084,404451,72.34,0.82
5068,2021-07-16,BAS,5933,2900,3033,1802,4097,34,ITF,ITF5,17,Basilicata,Basilicata,559084,410384,73.4,1.06
5069,2021-03-19,BAS,2315,1003,1312,260,2048,7,ITF,ITF5,17,Basilicata,Basilicata,559084,412699,73.82,0.41
5070,2021-08-20,BAS,3124,1680,1444,1452,1593,79,ITF,ITF5,17,Basilicata,Basilicata,559084,415823,74.38,0.56
5071,2021-02-16,BAS,908,377,531,791,98,19,ITF,ITF5,17,Basilicata,Basilicata,559084,416731,74.54,0.16
5072,2021-01-28,BAS,921,408,513,119,802,0,ITF,ITF5,17,Basilicata,Basilicata,559084,417652,74.7,0.16
5073,2021-09-06,BAS,3015,1571,1444,747,2190,78,ITF,ITF5,17,Basilicata,Basilicata,559084,420667,75.24,0.54
5074,2021-05-10,BAS,4804,2382,2422,2709,2042,53,ITF,ITF5,17,Basilicata,Basilicata,559084,425471,76.1,0.86
5075,2021-08-18,BAS,3571,1975,1596,1499,1976,96,ITF,ITF5,17,Basilicata,Basilicata,559084,429042,76.74,0.64
5076,2021-07-18,BAS,4390,2163,2227,1578,2785,27,ITF,ITF5,17,Basilicata,Basilicata,559084,433432,77.53,0.79
5077,2021-08-01,BAS,4211,2115,2096,1634,2537,40,ITF,ITF5,17,Basilicata,Basilicata,559084,437643,78.28,0.75
5078,2021-06-29,BAS,3856,1880,1976,2785,1043,28,ITF,ITF5,17,Basilicata,Basilicata,559084,441499,78.97,0.69
5079,2021-03-21,BAS,1178,547,631,475,700,3,ITF,ITF5,17,Basilicata,Basilicata,559084,442677,79.18,0.21
5080,2021-01-23,BAS,762,325,437,33,729,0,ITF,ITF5,17,Basilicata,Basilicata,559084,443439,79.32,0.14
5081,2021-05-03,BAS,4511,2043,2468,3620,827,64,ITF,ITF5,17,Basilicata,Basilicata,559084,447950,80.12,0.81
5082,2021-02-09,BAS,495,216,279,317,178,0,ITF,ITF5,17,Basilicata,Basilicata,559084,448445,80.21,0.09
5083,2021-08-27,BAS,2479,1313,1166,999,1410,70,ITF,ITF5,17,Basilicata,Basilicata,559084,450924,80.65,0.44
5084,2021-02-23,BAS,1912,773,1139,1753,141,18,ITF,ITF5,17,Basilicata,Basilicata,559084,452836,81.0,0.34
5085,2021-06-03,BAS,4922,2258,2664,3703,1181,38,ITF,ITF5,17,Basilicata,Basilicata,559084,457758,81.88,0.88
5086,2021-03-12,BAS,1924,989,935,786,1108,30,ITF,ITF5,17,Basilicata,Basilicata,559084,459682,82.22,0.34
5087,2021-05-17,BAS,5548,2735,2813,3362,2136,50,ITF,ITF5,17,Basilicata,Basilicata,559084,465230,83.21,0.99
5088,2021-08-25,BAS,2683,1408,1275,1260,1339,84,ITF,ITF5,17,Basilicata,Basilicata,559084,467913,83.69,0.48
5089,2021-01-26,BAS,813,358,455,101,712,0,ITF,ITF5,17,Basilicata,Basilicata,559084,468726,83.84,0.15
5090,2021-05-06,BAS,5069,2441,2628,3431,1587,51,ITF,ITF5,17,Basilicata,Basilicata,559084,473795,84.74,0.91
5091,2021-05-15,BAS,6533,3344,3189,3875,2575,83,ITF,ITF5,17,Basilicata,Basilicata,559084,480328,85.91,1.17
5092,2021-04-02,BAS,2346,1059,1287,1715,606,25,ITF,ITF5,17,Basilicata,Basilicata,559084,482674,86.33,0.42
5093,2021-02-04,BAS,1108,446,662,64,1044,0,ITF,ITF5,17,Basilicata,Basilicata,559084,483782,86.53,0.2
5094,2021-07-11,BAS,5032,2406,2626,1509,3498,25,ITF,ITF5,17,Basilicata,Basilicata,559084,488814,87.43,0.9
5095,2021-09-15,BAS,1211,647,564,313,861,37,ITF,ITF5,17,Basilicata,Basilicata,559084,490025,87.65,0.22
5096,2021-02-02,BAS,370,145,225,175,194,1,ITF,ITF5,17,Basilicata,Basilicata,559084,490395,87.71,0.07
5097,2021-08-08,BAS,3664,1873,1791,1112,2521,31,ITF,ITF5,17,Basilicata,Basilicata,559084,494059,88.37,0.66
5098,2021-02-21,BAS,284,113,171,284,0,0,ITF,ITF5,17,Basilicata,Basilicata,559084,494343,88.42,0.05
5099,2021-03-07,BAS,898,313,585,848,40,10,ITF,ITF5,17,Basilicata,Basilicata,559084,495241,88.58,0.16
5100,2021-01-09,BAS,560,161,399,560,0,0,ITF,ITF5,17,Basilicata,Basilicata,559084,495801,88.68,0.1
5101,2021-08-29,BAS,2331,1249,1082,1255,979,97,ITF,ITF5,17,Basilicata,Basilicata,559084,498132,89.1,0.42
5102,2021-07-03,BAS,3946,2104,1842,2756,1144,46,ITF,ITF5,17,Basilicata,Basilicata,559084,502078,89.8,0.71
5103,2021-05-07,BAS,4637,2280,2357,3264,1341,32,ITF,ITF5,17,Basilicata,Basilicata,559084,506715,90.63,0.83
5104,2021-08-15,BAS,2705,1431,1274,1137,1528,40,ITF,ITF5,17,Basilicata,Basilicata,559084,509420,91.12,0.48
5105,2021-05-22,BAS,5493,2725,2768,1929,3553,11,ITF,ITF5,17,Basilicata,Basilicata,559084,514913,92.1,0.98
5106,2021-03-26,BAS,1958,703,1255,1668,262,28,ITF,ITF5,17,Basilicata,Basilicata,559084,516871,92.45,0.35
5107,2021-09-08,BAS,2818,1491,1327,766,2003,49,ITF,ITF5,17,Basilicata,Basilicata,559084,519689,92.95,0.5
5108,2021-02-13,BAS,802,314,488,703,61,38,ITF,ITF5,17,Basilicata,Basilicata,559084,520491,93.1,0.14
5109,2021-05-24,BAS,4833,2344,2489,1087,3733,13,ITF,ITF5,17,Basilicata,Basilicata,559084,525324,93.96,0.86
5110,2021-07-29,BAS,4856,2523,2333,1907,2902,47,ITF,ITF5,17,Basilicata,Basilicata,559084,530180,94.83,0.87
5111,2021-06-02,BAS,5962,2806,3156,4375,1544,43,ITF,ITF5,17,Basilicata,Basilicata,559084,536142,95.9,1.07
5112,2021-01-14,BAS,973,413,560,973,0,0,ITF,ITF5,17,Basilicata,Basilicata,559084,537115,96.07,0.17
5113,2021-04-07,BAS,1214,552,662,1159,36,19,ITF,ITF5,17,Basilicata,Basilicata,559084,538329,96.29,0.22
5114,2021-04-25,BAS,2990,1459,1531,2906,52,32,ITF,ITF5,17,Basilicata,Basilicata,559084,541319,96.82,0.53
5115,2021-05-29,BAS,3060,1534,1526,824,2225,11,ITF,ITF5,17,Basilicata,Basilicata,559084,544379,97.37,0.55
5116,2021-01-13,BAS,917,387,530,917,0,0,ITF,ITF5,17,Basilicata,Basilicata,559084,545296,97.53,0.16
5117,2021-04-23,BAS,4553,2192,2361,3476,1015,62,ITF,ITF5,17,Basilicata,Basilicata,559084,549849,98.35,0.81
5118,2021-01-30,BAS,713,230,483,129,584,0,ITF,ITF5,17,Basilicata,Basilicata,559084,550562,98.48,0.13
5119,2021-07-25,BAS,4478,2254,2224,1606,2848,24,ITF,ITF5,17,Basilicata,Basilicata,559084,555040,99.28,0.8
5120,2021-06-21,BAS,4258,2045,2213,2142,2095,21,ITF,ITF5,17,Basilicata,Basilicata,559084,559298,100.04,0.76
5121,2021-06-19,BAS,4466,2178,2288,2370,2074,22,ITF,ITF5,17,Basilicata,Basilicata,559084,563764,100.84,0.8
5122,2021-03-28,BAS,2147,746,1401,2110,20,17,ITF,ITF5,17,Basilicata,Basilicata,559084,565911,101.22,0.38
5123,2021-03-11,BAS,1804,934,870,819,964,21,ITF,ITF5,17,Basilicata,Basilicata,559084,567715,101.54,0.32
5124,2021-07-10,BAS,5529,2668,2861,1595,3925,9,ITF,ITF5,17,Basilicata,Basilicata,559084,573244,102.53,0.99
5125,2021-05-14,BAS,5907,2798,3109,3271,2530,106,ITF,ITF5,17,Basilicata,Basilicata,559084,579151,103.59,1.06
5126,2021-03-18,BAS,1364,571,793,17,1338,9,ITF,ITF5,17,Basilicata,Basilicata,559084,580515,103.83,0.24
5127,2021-08-22,BAS,2444,1282,1162,1024,1372,48,ITF,ITF5,17,Basilicata,Basilicata,559084,582959,104.27,0.44
5128,2021-06-26,BAS,3337,1614,1723,2750,558,29,ITF,ITF5,17,Basilicata,Basilicata,559084,586296,104.87,0.6
5129,2021-09-10,BAS,2657,1343,1314,539,2057,61,ITF,ITF5,17,Basilicata,Basilicata,559084,588953,105.34,0.48
5130,2021-04-18,BAS,3720,1843,1877,2327,1370,23,ITF,ITF5,17,Basilicata,Basilicata,559084,592673,106.01,0.67
5131,2021-02-20,BAS,1169,536,633,1050,119,0,ITF,ITF5,17,Basilicata,Basilicata,559084,593842,106.22,0.21
5132,2021-07-27,BAS,4713,2370,2343,1812,2855,46,ITF,ITF5,17,Basilicata,Basilicata,559084,598555,107.06,0.84
5133,2021-05-31,BAS,4230,2010,2220,1713,2509,8,ITF,ITF5,17,Basilicata,Basilicata,559084,602785,107.82,0.76
5134,2021-02-18,BAS,1075,404,671,855,217,3,ITF,ITF5,17,Basilicata,Basilicata,559084,603860,108.01,0.19
5135,2021-03-30,BAS,2874,1219,1655,2497,361,16,ITF,ITF5,17,Basilicata,Basilicata,559084,606734,108.52,0.51
5136,2021-02-08,BAS,566,195,371,155,411,0,ITF,ITF5,17,Basilicata,Basilicata,559084,607300,108.62,0.1
5137,2021-05-19,BAS,2873,1499,1374,1183,1677,13,ITF,ITF5,17,Basilicata,Basilicata,559084,610173,109.14,0.51
5138,2021-02-25,BAS,1796,740,1056,1737,48,11,ITF,ITF5,17,Basilicata,Basilicata,559084,611969,109.46,0.32
5139,2021-08-10,BAS,4416,2326,2090,1514,2831,71,ITF,ITF5,17,Basilicata,Basilicata,559084,616385,110.25,0.79
5140,2021-02-06,BAS,928,381,547,146,782,0,ITF,ITF5,17,Basilicata,Basilicata,559084,617313,110.42,0.17
5141,2021-04-30,BAS,5285,2375,2910,4061,1162,62,ITF,ITF5,17,Basilicata,Basilicata,559084,622598,111.36,0.95
5142,2021-01-20,BAS,85,22,63,84,1,0,ITF,ITF5,17,Basilicata,Basilicata,559084,622683,111.38,0.02
5143,2021-08-03,BAS,5060,2574,2486,1827,3184,49,ITF,ITF5,17,Basilicata,Basilicata,559084,627743,112.28,0.91
5144,2021-08-17,BAS,3508,1763,1745,1398,2044,66,ITF,ITF5,17,Basilicata,Basilicata,559084,631251,112.91,0.63
5145,2021-05-12,BAS,4730,2330,2400,2800,1881,49,ITF,ITF5,17,Basilicata,Basilicata,559084,635981,113.75,0.85
5146,2021-07-15,BAS,6479,3211,3268,1668,4785,26,ITF,ITF5,17,Basilicata,Basilicata,559084,642460,114.91,1.16
5147,2021-04-06,BAS,1274,465,809,1072,184,18,ITF,ITF5,17,Basilicata,Basilicata,559084,643734,115.14,0.23
5148,2021-09-05,BAS,2282,1205,1077,466,1783,33,ITF,ITF5,17,Basilicata,Basilicata,559084,646016,115.55,0.41
5149,2021-03-04,BAS,1914,914,1000,1076,809,29,ITF,ITF5,17,Basilicata,Basilicata,559084,647930,115.89,0.34
5150,2021-06-12,BAS,3686,1694,1992,2959,689,38,ITF,ITF5,17,Basilicata,Basilicata,559084,651616,116.55,0.66
5151,2021-04-09,BAS,1152,350,802,1062,63,27,ITF,ITF5,17,Basilicata,Basilicata,559084,652768,116.76,0.21
5152,2021-07-13,BAS,5854,2826,3028,1770,4035,49,ITF,ITF5,17,Basilicata,Basilicata,559084,658622,117.8,1.05
5153,2021-07-08,BAS,5137,2429,2708,1852,3260,25,ITF,ITF5,17,Basilicata,Basilicata,559084,663759,118.72,0.92
5154,2021-01-06,BAS,296,130,166,296,0,0,ITF,ITF5,17,Basilicata,Basilicata,559084,664055,118.78,0.05
5155,2021-04-16,BAS,3326,1636,1690,2399,902,25,ITF,ITF5,17,Basilicata,Basilicata,559084,667381,119.37,0.59
5156,2021-06-14,BAS,4825,2156,2669,2090,2711,24,ITF,ITF5,17,Basilicata,Basilicata,559084,672206,120.23,0.86
5157,2021-03-23,BAS,1646,635,1011,1455,171,20,ITF,ITF5,17,Basilicata,Basilicata,559084,673852,120.53,0.29
5158,2021-07-01,BAS,3712,1857,1855,2564,1114,34,ITF,ITF5,17,Basilicata,Basilicata,559084,677564,121.19,0.66
5159,2021-09-03,BAS,2863,1522,1341,762,2038,63,ITF,ITF5,17,Basilicata,Basilicata,559084,680427,121.7,0.51
5160,2021-02-01,BAS,248,94,154,46,202,0,ITF,ITF5,17,Basilicata,Basilicata,559084,680675,121.75,0.04
5161,2021-05-26,BAS,4489,2260,2229,1676,2784,29,ITF,ITF5,17,Basilicata,Basilicata,559084,685164,122.55,0.8
5162,2021-02-27,BAS,2004,863,1141,1822,165,17,ITF,ITF5,17,Basilicata,Basilicata,559084,687168,122.91,0.36
5163,2021-07-20,BAS,5693,2792,2901,1688,3965,40,ITF,ITF5,17,Basilicata,Basilicata,559084,692861,123.93,1.02
5164,2021-06-07,BAS,4239,1921,2318,3885,316,38,ITF,ITF5,17,Basilicata,Basilicata,559084,697100,124.69,0.76
5165,2021-04-11,BAS,966,393,573,760,176,30,ITF,ITF5,17,Basilicata,Basilicata,559084,698066,124.86,0.17
5166,2021-04-04,BAS,611,227,384,187,418,6,ITF,ITF5,17,Basilicata,Basilicata,559084,698677,124.97,0.11
5167,2021-07-22,BAS,5797,2888,2909,1786,3949,62,ITF,ITF5,17,Basilicata,Basilicata,559084,704474,126.01,1.04
5168,2021-03-27,BAS,2257,866,1391,1809,434,14,ITF,ITF5,17,Basilicata,Basilicata,559084,706731,126.41,0.4
5169,2021-08-31,BAS,3098,1593,1505,1677,1276,145,ITF,ITF5,17,Basilicata,Basilicata,559084,709829,126.96,0.55
5170,2021-07-05,BAS,3270,1615,1655,2214,1021,35,ITF,ITF5,17,Basilicata,Basilicata,559084,713099,127.55,0.58
5171,2021-01-07,BAS,644,321,323,644,0,0,ITF,ITF5,17,Basilicata,Basilicata,559084,713743,127.66,0.12
5172,2021-02-19,BAS,1627,739,888,1559,63,5,ITF,ITF5,17,Basilicata,Basilicata,559084,715370,127.95,0.29
5173,2021-02-12,BAS,781,334,447,748,32,1,ITF,ITF5,17,Basilicata,Basilicata,559084,716151,128.09,0.14
5174,2021-04-10,BAS,1035,379,656,924,84,27,ITF,ITF5,17,Basilicata,Basilicata,559084,717186,128.28,0.19
5175,2021-06-24,BAS,4090,1939,2151,2151,1901,38,ITF,ITF5,17,Basilicata,Basilicata,559084,721276,129.01,0.73
5176,2021-04-28,BAS,4707,2158,2549,4203,441,63,ITF,ITF5,17,Basilicata,Basilicata,559084,725983,129.85,0.84
5177,2021-03-02,BAS,805,387,418,662,138,5,ITF,ITF5,17,Basilicata,Basilicata,559084,726788,130.0,0.14
5178,2021-08-06,BAS,4216,2158,2058,1317,2846,53,ITF,ITF5,17,Basilicata,Basilicata,559084,731004,130.75,0.75
5179,2021-06-10,BAS,4346,2101,2245,3867,442,37,ITF,ITF5,17,Basilicata,Basilicata,559084,735350,131.53,0.78
5180,2021-08-13,BAS,3661,1904,1757,1423,2147,91,ITF,ITF5,17,Basilicata,Basilicata,559084,739011,132.18,0.65
5181,2021-07-30,BAS,4765,2436,2329,1914,2802,49,ITF,ITF5,17,Basilicata,Basilicata,559084,743776,133.03,0.85
5182,2021-06-17,BAS,4442,2045,2397,2087,2330,25,ITF,ITF5,17,Basilicata,Basilicata,559084,748218,133.83,0.79
5183,2021-04-21,BAS,3953,1846,2107,2243,1679,31,ITF,ITF5,17,Basilicata,Basilicata,559084,752171,134.54,0.71
5184,2021-01-18,BAS,465,158,307,366,99,0,ITF,ITF5,17,Basilicata,Basilicata,559084,752636,134.62,0.08
5185,2021-03-16,BAS,1926,809,1117,226,1697,3,ITF,ITF5,17,Basilicata,Basilicata,559084,754562,134.96,0.34
5186,2021-05-05,BAS,4338,2050,2288,3376,891,71,ITF,ITF5,17,Basilicata,Basilicata,559084,758900,135.74,0.78
5187,2021-03-09,BAS,1418,726,692,780,615,23,ITF,ITF5,17,Basilicata,Basilicata,559084,760318,135.99,0.25
5188,2021-01-25,BAS,1054,441,613,74,979,1,ITF,ITF5,17,Basilicata,Basilicata,559084,761372,136.18,0.19
5189,2021-01-11,BAS,186,67,119,186,0,0,ITF,ITF5,17,Basilicata,Basilicata,559084,761558,136.22,0.03
5190,2021-07-20,EMR,43146,22554,20592,6666,35791,689,ITH,ITH5,8,Emilia-Romagna,Emilia-Romagna,4459477,43146,0.97,0.97
5191,2021-04-11,EMR,15285,6940,8345,11981,3050,254,ITH,ITH5,8,Emilia-Romagna,Emilia-Romagna,4459477,58431,1.31,0.34
5192,2021-01-30,EMR,10095,3528,6567,137,9957,1,ITH,ITH5,8,Emilia-Romagna,Emilia-Romagna,4459477,68526,1.54,0.23
5193,2021-02-18,EMR,7045,2893,4152,6441,588,16,ITH,ITH5,8,Emilia-Romagna,Emilia-Romagna,4459477,75571,1.69,0.16
5194,2021-09-15,EMR,6201,3246,2955,1553,4437,211,ITH,ITH5,8,Emilia-Romagna,Emilia-Romagna,4459477,81772,1.83,0.14
5195,2021-06-07,EMR,40575,20826,19749,33445,6265,865,ITH,ITH5,8,Emilia-Romagna,Emilia-Romagna,4459477,122347,2.74,0.91
5196,2021-08-03,EMR,38517,20274,18243,15574,22292,651,ITH,ITH5,8,Emilia-Romagna,Emilia-Romagna,4459477,160864,3.61,0.86
5197,2021-05-12,EMR,38970,18312,20658,28474,9702,794,ITH,ITH5,8,Emilia-Romagna,Emilia-Romagna,4459477,199834,4.48,0.87
5198,2021-02-01,EMR,10332,3618,6714,355,9975,2,ITH,ITH5,8,Emilia-Romagna,Emilia-Romagna,4459477,210166,4.71,0.23
5199,2021-01-18,EMR,3131,881,2250,2448,680,3,ITH,ITH5,8,Emilia-Romagna,Emilia-Romagna,4459477,213297,4.78,0.07
5200,2021-03-16,EMR,12256,5028,7228,4875,7316,65,ITH,ITH5,8,Emilia-Romagna,Emilia-Romagna,4459477,225553,5.06,0.27
5201,2021-01-25,EMR,6466,2148,4318,205,6260,1,ITH,ITH5,8,Emilia-Romagna,Emilia-Romagna,4459477,232019,5.2,0.14
5202,2021-07-01,EMR,34544,16883,17661,14810,18856,878,ITH,ITH5,8,Emilia-Romagna,Emilia-Romagna,4459477,266563,5.98,0.77
5203,2021-03-23,EMR,18804,8149,10655,11948,6690,166,ITH,ITH5,8,Emilia-Romagna,Emilia-Romagna,4459477,285367,6.4,0.42
5204,2021-06-21,EMR,37598,19008,18590,16076,20897,625,ITH,ITH5,8,Emilia-Romagna,Emilia-Romagna,4459477,322965,7.24,0.84
5205,2021-07-08,EMR,41353,20601,20752,4725,36209,419,ITH,ITH5,8,Emilia-Romagna,Emilia-Romagna,4459477,364318,8.17,0.93
5206,2021-03-30,EMR,23345,10335,13010,17993,5042,310,ITH,ITH5,8,Emilia-Romagna,Emilia-Romagna,4459477,387663,8.69,0.52
5207,2021-07-22,EMR,40385,21556,18829,15243,24206,936,ITH,ITH5,8,Emilia-Romagna,Emilia-Romagna,4459477,428048,9.6,0.91
5208,2021-01-04,EMR,7312,2526,4786,7309,0,3,ITH,ITH5,8,Emilia-Romagna,Emilia-Romagna,4459477,435360,9.76,0.16
5209,2021-08-17,EMR,22387,12303,10084,14504,6858,1025,ITH,ITH5,8,Emilia-Romagna,Emilia-Romagna,4459477,457747,10.26,0.5
5210,2021-09-03,EMR,23750,12779,10971,6310,16835,605,ITH,ITH5,8,Emilia-Romagna,Emilia-Romagna,4459477,481497,10.8,0.53
5211,2021-05-26,EMR,33350,14758,18592,9928,23036,386,ITH,ITH5,8,Emilia-Romagna,Emilia-Romagna,4459477,514847,11.55,0.75
5212,2021-06-12,EMR,41390,21888,19502,35466,4922,1002,ITH,ITH5,8,Emilia-Romagna,Emilia-Romagna,4459477,556237,12.47,0.93
5213,2021-03-04,EMR,16462,5351,11111,13345,3025,92,ITH,ITH5,8,Emilia-Romagna,Emilia-Romagna,4459477,572699,12.84,0.37
5214,2021-05-24,EMR,30012,13740,16272,17967,11530,515,ITH,ITH5,8,Emilia-Romagna,Emilia-Romagna,4459477,602711,13.52,0.67
5215,2021-02-13,EMR,3631,1086,2545,3018,599,14,ITH,ITH5,8,Emilia-Romagna,Emilia-Romagna,4459477,606342,13.6,0.08
5216,2021-01-23,EMR,2448,871,1577,439,2009,0,ITH,ITH5,8,Emilia-Romagna,Emilia-Romagna,4459477,608790,13.65,0.05
5217,2021-05-07,EMR,35339,16986,18353,22667,11895,777,ITH,ITH5,8,Emilia-Romagna,Emilia-Romagna,4459477,644129,14.44,0.79
5218,2021-07-03,EMR,32128,15937,16191,11409,20025,694,ITH,ITH5,8,Emilia-Romagna,Emilia-Romagna,4459477,676257,15.16,0.72
5219,2021-08-29,EMR,20593,11394,9199,8473,11259,861,ITH,ITH5,8,Emilia-Romagna,Emilia-Romagna,4459477,696850,15.63,0.46
5220,2021-04-16,EMR,29243,13766,15477,20014,8842,387,ITH,ITH5,8,Emilia-Romagna,Emilia-Romagna,4459477,726093,16.28,0.66
5221,2021-01-06,EMR,8293,2956,5337,8292,0,1,ITH,ITH5,8,Emilia-Romagna,Emilia-Romagna,4459477,734386,16.47,0.19
5222,2021-08-08,EMR,21624,11717,9907,10574,10496,554,ITH,ITH5,8,Emilia-Romagna,Emilia-Romagna,4459477,756010,16.95,0.48
5223,2021-04-30,EMR,36660,16810,19850,21239,14810,611,ITH,ITH5,8,Emilia-Romagna,Emilia-Romagna,4459477,792670,17.77,0.82
5224,2021-03-28,EMR,13549,6059,7490,9546,3885,118,ITH,ITH5,8,Emilia-Romagna,Emilia-Romagna,4459477,806219,18.08,0.3
5225,2021-02-11,EMR,4257,1417,2840,3397,843,17,ITH,ITH5,8,Emilia-Romagna,Emilia-Romagna,4459477,810476,18.17,0.1
5226,2021-07-29,EMR,40793,21529,19264,14506,25554,733,ITH,ITH5,8,Emilia-Romagna,Emilia-Romagna,4459477,851269,19.09,0.91
5227,2021-07-27,EMR,41132,21851,19281,17004,23328,800,ITH,ITH5,8,Emilia-Romagna,Emilia-Romagna,4459477,892401,20.01,0.92
5228,2021-04-18,EMR,17528,8406,9122,12365,4934,229,ITH,ITH5,8,Emilia-Romagna,Emilia-Romagna,4459477,909929,20.4,0.39
5229,2021-06-14,EMR,41346,21375,19971,27454,13089,803,ITH,ITH5,8,Emilia-Romagna,Emilia-Romagna,4459477,951275,21.33,0.93
5230,2021-07-15,EMR,50400,26250,24150,7896,41796,708,ITH,ITH5,8,Emilia-Romagna,Emilia-Romagna,4459477,1001675,22.46,1.13
5231,2021-04-23,EMR,29584,13818,15766,14309,14896,379,ITH,ITH5,8,Emilia-Romagna,Emilia-Romagna,4459477,1031259,23.13,0.66
5232,2021-01-13,EMR,9077,2943,6134,9072,0,5,ITH,ITH5,8,Emilia-Romagna,Emilia-Romagna,4459477,1040336,23.33,0.2
5233,2021-04-04,EMR,9886,4720,5166,7529,2273,84,ITH,ITH5,8,Emilia-Romagna,Emilia-Romagna,4459477,1050222,23.55,0.22
5234,2021-01-11,EMR,9357,3278,6079,9348,0,9,ITH,ITH5,8,Emilia-Romagna,Emilia-Romagna,4459477,1059579,23.76,0.21
5235,2021-05-31,EMR,29819,13779,16040,17733,11533,553,ITH,ITH5,8,Emilia-Romagna,Emilia-Romagna,4459477,1089398,24.43,0.67
5236,2021-02-20,EMR,5320,2094,3226,5050,263,7,ITH,ITH5,8,Emilia-Romagna,Emilia-Romagna,4459477,1094718,24.55,0.12
5237,2021-03-09,EMR,14806,6036,8770,10756,3954,96,ITH,ITH5,8,Emilia-Romagna,Emilia-Romagna,4459477,1109524,24.88,0.33
5238,2021-05-05,EMR,30147,14005,16142,18306,11276,565,ITH,ITH5,8,Emilia-Romagna,Emilia-Romagna,4459477,1139671,25.56,0.68
5239,2021-08-27,EMR,27880,14995,12885,6932,20207,741,ITH,ITH5,8,Emilia-Romagna,Emilia-Romagna,4459477,1167551,26.18,0.63
5240,2021-05-19,EMR,33844,14998,18846,18042,15269,533,ITH,ITH5,8,Emilia-Romagna,Emilia-Romagna,4459477,1201395,26.94,0.76
5241,2021-09-10,EMR,26083,14119,11964,5248,20174,661,ITH,ITH5,8,Emilia-Romagna,Emilia-Romagna,4459477,1227478,27.53,0.58
5242,2021-06-02,EMR,24123,12071,12052,18681,4980,462,ITH,ITH5,8,Emilia-Romagna,Emilia-Romagna,4459477,1251601,28.07,0.54
5243,2021-08-15,EMR,6652,3690,2962,3282,3200,170,ITH,ITH5,8,Emilia-Romagna,Emilia-Romagna,4459477,1258253,28.22,0.15
5244,2021-06-26,EMR,37489,18999,18490,21010,15541,938,ITH,ITH5,8,Emilia-Romagna,Emilia-Romagna,4459477,1295742,29.06,0.84
5245,2021-08-22,EMR,16470,9045,7425,6741,9103,626,ITH,ITH5,8,Emilia-Romagna,Emilia-Romagna,4459477,1312212,29.43,0.37
5246,2021-07-10,EMR,42101,21439,20662,6801,34651,649,ITH,ITH5,8,Emilia-Romagna,Emilia-Romagna,4459477,1354313,30.37,0.94
5247,2021-09-05,EMR,17117,9218,7899,6405,9985,727,ITH,ITH5,8,Emilia-Romagna,Emilia-Romagna,4459477,1371430,30.75,0.38
5248,2021-02-25,EMR,9250,3498,5752,8272,955,23,ITH,ITH5,8,Emilia-Romagna,Emilia-Romagna,4459477,1380680,30.96,0.21
5249,2021-06-19,EMR,36695,18365,18330,16738,19407,550,ITH,ITH5,8,Emilia-Romagna,Emilia-Romagna,4459477,1417375,31.78,0.82
5250,2021-03-11,EMR,17499,7332,10167,11455,5857,187,ITH,ITH5,8,Emilia-Romagna,Emilia-Romagna,4459477,1434874,32.18,0.39
5251,2021-02-06,EMR,7603,2408,5195,2108,5491,4,ITH,ITH5,8,Emilia-Romagna,Emilia-Romagna,4459477,1442477,32.35,0.17
5252,2021-01-10,EMR,7174,2686,4488,7173,0,1,ITH,ITH5,8,Emilia-Romagna,Emilia-Romagna,4459477,1449651,32.51,0.16
5253,2021-06-16,EMR,45961,23538,22423,25241,19966,754,ITH,ITH5,8,Emilia-Romagna,Emilia-Romagna,4459477,1495612,33.54,1.03
5254,2021-03-08,EMR,12220,5099,7121,9471,2664,85,ITH,ITH5,8,Emilia-Romagna,Emilia-Romagna,4459477,1507832,33.81,0.27
5255,2021-06-30,EMR,34264,17292,16972,17702,15667,895,ITH,ITH5,8,Emilia-Romagna,Emilia-Romagna,4459477,1542096,34.58,0.77
5256,2021-07-17,EMR,43667,23055,20612,7175,35752,740,ITH,ITH5,8,Emilia-Romagna,Emilia-Romagna,4459477,1585763,35.56,0.98
5257,2021-01-15,EMR,7753,2407,5346,7745,0,8,ITH,ITH5,8,Emilia-Romagna,Emilia-Romagna,4459477,1593516,35.73,0.17
5258,2021-06-09,EMR,43189,21936,21253,35731,6438,1020,ITH,ITH5,8,Emilia-Romagna,Emilia-Romagna,4459477,1636705,36.7,0.97
5259,2021-03-01,EMR,10104,3585,6519,7817,2262,25,ITH,ITH5,8,Emilia-Romagna,Emilia-Romagna,4459477,1646809,36.93,0.23
5260,2021-08-05,EMR,36770,19457,17313,18387,17410,973,ITH,ITH5,8,Emilia-Romagna,Emilia-Romagna,4459477,1683579,37.75,0.82
5261,2021-08-12,EMR,27711,15054,12657,19267,6879,1565,ITH,ITH5,8,Emilia-Romagna,Emilia-Romagna,4459477,1711290,38.37,0.62
5262,2021-05-04,EMR,29316,13730,15586,15165,13674,477,ITH,ITH5,8,Emilia-Romagna,Emilia-Romagna,4459477,1740606,39.03,0.66
5263,2021-02-27,EMR,10967,3998,6969,9192,1742,33,ITH,ITH5,8,Emilia-Romagna,Emilia-Romagna,4459477,1751573,39.28,0.25
5264,2021-04-25,EMR,22360,10244,12116,14403,7515,442,ITH,ITH5,8,Emilia-Romagna,Emilia-Romagna,4459477,1773933,39.78,0.5
5265,2021-08-10,EMR,31343,16771,14572,15369,14919,1055,ITH,ITH5,8,Emilia-Romagna,Emilia-Romagna,4459477,1805276,40.48,0.7
5266,2021-03-13,EMR,16143,6363,9780,10592,5314,237,ITH,ITH5,8,Emilia-Romagna,Emilia-Romagna,4459477,1821419,40.84,0.36
5267,2021-07-05,EMR,33243,16209,17034,11200,21386,657,ITH,ITH5,8,Emilia-Romagna,Emilia-Romagna,4459477,1854662,41.59,0.75
5268,2021-03-27,EMR,21683,9075,12608,14522,6912,249,ITH,ITH5,8,Emilia-Romagna,Emilia-Romagna,4459477,1876345,42.08,0.49
5269,2021-04-13,EMR,23726,11132,12594,19032,4344,350,ITH,ITH5,8,Emilia-Romagna,Emilia-Romagna,4459477,1900071,42.61,0.53
5270,2021-01-03,EMR,2763,945,1818,2763,0,0,ITH,ITH5,8,Emilia-Romagna,Emilia-Romagna,4459477,1902834,42.67,0.06
5271,2021-08-31,EMR,28050,14954,13096,8309,18676,1065,ITH,ITH5,8,Emilia-Romagna,Emilia-Romagna,4459477,1930884,43.3,0.63
5272,2021-05-23,EMR,25506,11868,13638,13580,11609,317,ITH,ITH5,8,Emilia-Romagna,Emilia-Romagna,4459477,1956390,43.87,0.57
5273,2021-07-19,EMR,42008,22125,19883,6635,34775,598,ITH,ITH5,8,Emilia-Romagna,Emilia-Romagna,4459477,1998398,44.81,0.94
5274,2021-09-14,EMR,20125,10870,9255,4447,15137,541,ITH,ITH5,8,Emilia-Romagna,Emilia-Romagna,4459477,2018523,45.26,0.45
5275,2021-07-12,EMR,44072,22331,21741,5424,38138,510,ITH,ITH5,8,Emilia-Romagna,Emilia-Romagna,4459477,2062595,46.25,0.99
5276,2021-09-07,EMR,26046,14080,11966,5855,19603,588,ITH,ITH5,8,Emilia-Romagna,Emilia-Romagna,4459477,2088641,46.84,0.58
5277,2021-04-20,EMR,22655,10419,12236,13888,8366,401,ITH,ITH5,8,Emilia-Romagna,Emilia-Romagna,4459477,2111296,47.34,0.51
5278,2021-06-23,EMR,38081,19097,18984,18468,18887,726,ITH,ITH5,8,Emilia-Romagna,Emilia-Romagna,4459477,2149377,48.2,0.85
5279,2021-01-08,EMR,10877,3587,7290,10874,0,3,ITH,ITH5,8,Emilia-Romagna,Emilia-Romagna,4459477,2160254,48.44,0.24
5280,2021-03-06,EMR,21036,5971,15065,18169,2743,124,ITH,ITH5,8,Emilia-Romagna,Emilia-Romagna,4459477,2181290,48.91,0.47
5281,2021-05-09,EMR,25644,12269,13375,18279,6973,392,ITH,ITH5,8,Emilia-Romagna,Emilia-Romagna,4459477,2206934,49.49,0.58
5282,2021-01-29,EMR,10427,3500,6927,290,10137,0,ITH,ITH5,8,Emilia-Romagna,Emilia-Romagna,4459477,2217361,49.72,0.23
5283,2021-02-15,EMR,2902,849,2053,2709,125,68,ITH,ITH5,8,Emilia-Romagna,Emilia-Romagna,4459477,2220263,49.79,0.07
5284,2021-01-27,EMR,8372,2951,5421,461,7911,0,ITH,ITH5,8,Emilia-Romagna,Emilia-Romagna,4459477,2228635,49.98,0.19
5285,2021-07-31,EMR,36230,19241,16989,12138,23389,703,ITH,ITH5,8,Emilia-Romagna,Emilia-Romagna,4459477,2264865,50.79,0.81
5286,2021-08-19,EMR,21550,11571,9979,11931,8732,887,ITH,ITH5,8,Emilia-Romagna,Emilia-Romagna,4459477,2286415,51.27,0.48
5287,2021-08-26,EMR,27605,14730,12875,9340,17305,960,ITH,ITH5,8,Emilia-Romagna,Emilia-Romagna,4459477,2314020,51.89,0.62
5288,2021-09-12,EMR,14619,7997,6622,3859,10308,452,ITH,ITH5,8,Emilia-Romagna,Emilia-Romagna,4459477,2328639,52.22,0.33
5289,2021-06-04,EMR,45768,23028,22740,36806,8207,755,ITH,ITH5,8,Emilia-Romagna,Emilia-Romagna,4459477,2374407,53.24,1.03
5290,2021-05-02,EMR,25595,11656,13939,13191,11999,405,ITH,ITH5,8,Emilia-Romagna,Emilia-Romagna,4459477,2400002,53.82,0.57
5291,2021-01-22,EMR,1832,477,1355,1087,743,2,ITH,ITH5,8,Emilia-Romagna,Emilia-Romagna,4459477,2401834,53.86,0.04
5292,2021-08-24,EMR,23397,12710,10687,10519,11767,1111,ITH,ITH5,8,Emilia-Romagna,Emilia-Romagna,4459477,2425231,54.38,0.52
5293,2021-02-08,EMR,5238,1537,3701,2317,2918,3,ITH,ITH5,8,Emilia-Romagna,Emilia-Romagna,4459477,2430469,54.5,0.12
5294,2021-05-16,EMR,25891,12183,13708,18365,7147,379,ITH,ITH5,8,Emilia-Romagna,Emilia-Romagna,4459477,2456360,55.08,0.58
5295,2021-02-22,EMR,7487,3094,4393,7201,273,13,ITH,ITH5,8,Emilia-Romagna,Emilia-Romagna,4459477,2463847,55.25,0.17
5296,2021-08-07,EMR,30984,17044,13940,17730,12212,1042,ITH,ITH5,8,Emilia-Romagna,Emilia-Romagna,4459477,2494831,55.94,0.69
5297,2021-04-27,EMR,32135,14874,17261,19233,12471,431,ITH,ITH5,8,Emilia-Romagna,Emilia-Romagna,4459477,2526966,56.67,0.72
5298,2021-06-11,EMR,45994,23872,22122,38329,6560,1105,ITH,ITH5,8,Emilia-Romagna,Emilia-Romagna,4459477,2572960,57.7,1.03
5299,2021-06-28,EMR,40082,19669,20413,19629,19580,873,ITH,ITH5,8,Emilia-Romagna,Emilia-Romagna,4459477,2613042,58.6,0.9
5300,2021-03-20,EMR,16094,6832,9262,8958,6967,169,ITH,ITH5,8,Emilia-Romagna,Emilia-Romagna,4459477,2629136,58.96,0.36
5301,2021-04-06,EMR,24771,11182,13589,19728,4751,292,ITH,ITH5,8,Emilia-Romagna,Emilia-Romagna,4459477,2653907,59.51,0.56
5302,2020-12-27,EMR,973,374,599,973,0,0,ITH,ITH5,8,Emilia-Romagna,Emilia-Romagna,4459477,2654880,59.53,0.02
5303,2021-06-13,EMR,28776,15012,13764,23807,4289,680,ITH,ITH5,8,Emilia-Romagna,Emilia-Romagna,4459477,2683656,60.18,0.65
5304,2021-03-05,EMR,17921,5864,12057,14291,3505,125,ITH,ITH5,8,Emilia-Romagna,Emilia-Romagna,4459477,2701577,60.58,0.4
5305,2021-03-22,EMR,17660,7821,9839,10616,6872,172,ITH,ITH5,8,Emilia-Romagna,Emilia-Romagna,4459477,2719237,60.98,0.4
5306,2021-02-12,EMR,5330,1679,3651,3900,1407,23,ITH,ITH5,8,Emilia-Romagna,Emilia-Romagna,4459477,2724567,61.1,0.12
5307,2021-04-10,EMR,20938,9305,11633,16456,4148,334,ITH,ITH5,8,Emilia-Romagna,Emilia-Romagna,4459477,2745505,61.57,0.47
5308,2021-04-17,EMR,27324,13087,14237,17577,9355,392,ITH,ITH5,8,Emilia-Romagna,Emilia-Romagna,4459477,2772829,62.18,0.61
5309,2021-01-07,EMR,10291,3408,6883,10287,0,4,ITH,ITH5,8,Emilia-Romagna,Emilia-Romagna,4459477,2783120,62.41,0.23
5310,2021-08-28,EMR,26290,14544,11746,8618,16845,827,ITH,ITH5,8,Emilia-Romagna,Emilia-Romagna,4459477,2809410,63.0,0.59
5311,2021-05-20,EMR,40414,18344,22070,18391,21504,519,ITH,ITH5,8,Emilia-Romagna,Emilia-Romagna,4459477,2849824,63.9,0.91
5312,2021-08-23,EMR,22608,11770,10838,11839,9475,1294,ITH,ITH5,8,Emilia-Romagna,Emilia-Romagna,4459477,2872432,64.41,0.51
5313,2021-05-28,EMR,41304,18966,22338,17271,23434,599,ITH,ITH5,8,Emilia-Romagna,Emilia-Romagna,4459477,2913736,65.34,0.93
5314,2021-04-22,EMR,29060,13455,15605,14616,14080,364,ITH,ITH5,8,Emilia-Romagna,Emilia-Romagna,4459477,2942796,65.99,0.65
5315,2021-01-12,EMR,9484,3127,6357,9475,0,9,ITH,ITH5,8,Emilia-Romagna,Emilia-Romagna,4459477,2952280,66.2,0.21
5316,2021-07-16,EMR,49792,26284,23508,7034,42086,672,ITH,ITH5,8,Emilia-Romagna,Emilia-Romagna,4459477,3002072,67.32,1.12
5317,2021-06-27,EMR,29599,14894,14705,16191,12735,673,ITH,ITH5,8,Emilia-Romagna,Emilia-Romagna,4459477,3031671,67.98,0.66
5318,2021-07-14,EMR,47985,24549,23436,5589,41861,535,ITH,ITH5,8,Emilia-Romagna,Emilia-Romagna,4459477,3079656,69.06,1.08
5319,2021-01-20,EMR,1331,269,1062,1329,1,1,ITH,ITH5,8,Emilia-Romagna,Emilia-Romagna,4459477,3080987,69.09,0.03
5320,2021-07-24,EMR,38880,20967,17913,17231,20645,1004,ITH,ITH5,8,Emilia-Romagna,Emilia-Romagna,4459477,3119867,69.96,0.87
5321,2021-04-15,EMR,29372,13987,15385,19243,9684,445,ITH,ITH5,8,Emilia-Romagna,Emilia-Romagna,4459477,3149239,70.62,0.66
5322,2021-06-18,EMR,42788,21456,21332,16284,25932,572,ITH,ITH5,8,Emilia-Romagna,Emilia-Romagna,4459477,3192027,71.58,0.96
5323,2021-03-10,EMR,18814,7743,11071,12984,5648,182,ITH,ITH5,8,Emilia-Romagna,Emilia-Romagna,4459477,3210841,72.0,0.42
5324,2021-05-18,EMR,29239,13283,15956,18101,10649,489,ITH,ITH5,8,Emilia-Romagna,Emilia-Romagna,4459477,3240080,72.66,0.66
5325,2021-02-07,EMR,4794,1537,3257,1724,3068,2,ITH,ITH5,8,Emilia-Romagna,Emilia-Romagna,4459477,3244874,72.76,0.11
5326,2021-02-24,EMR,9359,3568,5791,8453,890,16,ITH,ITH5,8,Emilia-Romagna,Emilia-Romagna,4459477,3254233,72.97,0.21
5327,2021-01-05,EMR,9373,3173,6200,9369,0,4,ITH,ITH5,8,Emilia-Romagna,Emilia-Romagna,4459477,3263606,73.18,0.21
5328,2021-08-09,EMR,30251,16138,14113,16645,12558,1048,ITH,ITH5,8,Emilia-Romagna,Emilia-Romagna,4459477,3293857,73.86,0.68
5329,2021-05-01,EMR,28432,12782,15650,15278,12795,359,ITH,ITH5,8,Emilia-Romagna,Emilia-Romagna,4459477,3322289,74.5,0.64
5330,2021-02-05,EMR,9311,2964,6347,1617,7690,4,ITH,ITH5,8,Emilia-Romagna,Emilia-Romagna,4459477,3331600,74.71,0.21
5331,2021-09-11,EMR,24805,14072,10733,4557,19690,558,ITH,ITH5,8,Emilia-Romagna,Emilia-Romagna,4459477,3356405,75.26,0.56
5332,2021-06-20,EMR,30752,15601,15151,15591,14675,486,ITH,ITH5,8,Emilia-Romagna,Emilia-Romagna,4459477,3387157,75.95,0.69
5333,2021-04-05,EMR,14857,6810,8047,11786,2895,176,ITH,ITH5,8,Emilia-Romagna,Emilia-Romagna,4459477,3402014,76.29,0.33
5334,2021-08-02,EMR,38534,20359,18175,14768,23097,669,ITH,ITH5,8,Emilia-Romagna,Emilia-Romagna,4459477,3440548,77.15,0.86
5335,2021-04-24,EMR,28656,13251,15405,14063,14243,350,ITH,ITH5,8,Emilia-Romagna,Emilia-Romagna,4459477,3469204,77.79,0.64
5336,2021-05-11,EMR,35824,16808,19016,27864,7264,696,ITH,ITH5,8,Emilia-Romagna,Emilia-Romagna,4459477,3505028,78.6,0.8
5337,2021-03-03,EMR,15899,5269,10630,13360,2486,53,ITH,ITH5,8,Emilia-Romagna,Emilia-Romagna,4459477,3520927,78.95,0.36
5338,2021-09-04,EMR,23722,12908,10814,8378,14448,896,ITH,ITH5,8,Emilia-Romagna,Emilia-Romagna,4459477,3544649,79.49,0.53
5339,2021-08-16,EMR,20223,10871,9352,12627,6580,1016,ITH,ITH5,8,Emilia-Romagna,Emilia-Romagna,4459477,3564872,79.94,0.45
5340,2021-09-02,EMR,25014,13318,11696,6469,17844,701,ITH,ITH5,8,Emilia-Romagna,Emilia-Romagna,4459477,3589886,80.5,0.56
5341,2021-05-25,EMR,25245,11240,14005,11301,13514,430,ITH,ITH5,8,Emilia-Romagna,Emilia-Romagna,4459477,3615131,81.07,0.57
5342,2021-02-14,EMR,1405,378,1027,1277,120,8,ITH,ITH5,8,Emilia-Romagna,Emilia-Romagna,4459477,3616536,81.1,0.03
5343,2021-08-14,EMR,15800,8911,6889,8318,7027,455,ITH,ITH5,8,Emilia-Romagna,Emilia-Romagna,4459477,3632336,81.45,0.35
5344,2021-05-06,EMR,35985,16627,19358,22154,13102,729,ITH,ITH5,8,Emilia-Romagna,Emilia-Romagna,4459477,3668321,82.26,0.81
5345,2021-01-26,EMR,8339,3001,5338,209,8129,1,ITH,ITH5,8,Emilia-Romagna,Emilia-Romagna,4459477,3676660,82.45,0.19
5346,2021-07-02,EMR,34760,17095,17665,12376,21728,656,ITH,ITH5,8,Emilia-Romagna,Emilia-Romagna,4459477,3711420,83.23,0.78
5347,2021-03-24,EMR,21242,9414,11828,13632,7387,223,ITH,ITH5,8,Emilia-Romagna,Emilia-Romagna,4459477,3732662,83.7,0.48
5348,2021-01-24,EMR,2446,887,1559,298,2148,0,ITH,ITH5,8,Emilia-Romagna,Emilia-Romagna,4459477,3735108,83.76,0.05
5349,2021-04-03,EMR,19971,8763,11208,15956,3800,215,ITH,ITH5,8,Emilia-Romagna,Emilia-Romagna,4459477,3755079,84.2,0.45
5350,2021-05-30,EMR,27104,12808,14296,12984,13715,405,ITH,ITH5,8,Emilia-Romagna,Emilia-Romagna,4459477,3782183,84.81,0.61
5351,2021-02-19,EMR,7329,3011,4318,6801,514,14,ITH,ITH5,8,Emilia-Romagna,Emilia-Romagna,4459477,3789512,84.98,0.16
5352,2021-07-26,EMR,39572,21101,18471,15889,22886,797,ITH,ITH5,8,Emilia-Romagna,Emilia-Romagna,4459477,3829084,85.86,0.89
5353,2020-12-31,EMR,2214,779,1435,2213,0,1,ITH,ITH5,8,Emilia-Romagna,Emilia-Romagna,4459477,3831298,85.91,0.05
5354,2021-06-06,EMR,36603,19002,17601,31537,4415,651,ITH,ITH5,8,Emilia-Romagna,Emilia-Romagna,4459477,3867901,86.73,0.82
5355,2021-02-26,EMR,9642,3677,5965,8562,1054,26,ITH,ITH5,8,Emilia-Romagna,Emilia-Romagna,4459477,3877543,86.95,0.22
5356,2021-08-06,EMR,34671,18597,16074,18799,14988,884,ITH,ITH5,8,Emilia-Romagna,Emilia-Romagna,4459477,3912214,87.73,0.78
5357,2021-04-28,EMR,33752,15604,18148,20263,12899,590,ITH,ITH5,8,Emilia-Romagna,Emilia-Romagna,4459477,3945966,88.48,0.76
5358,2021-06-24,EMR,40653,20418,20235,20270,19570,813,ITH,ITH5,8,Emilia-Romagna,Emilia-Romagna,4459477,3986619,89.4,0.91
5359,2021-06-25,EMR,42866,21814,21052,19736,22322,808,ITH,ITH5,8,Emilia-Romagna,Emilia-Romagna,4459477,4029485,90.36,0.96
5360,2021-03-17,EMR,13731,5699,8032,5817,7855,59,ITH,ITH5,8,Emilia-Romagna,Emilia-Romagna,4459477,4043216,90.67,0.31
5361,2021-08-21,EMR,19102,10687,8415,10436,7770,896,ITH,ITH5,8,Emilia-Romagna,Emilia-Romagna,4459477,4062318,91.09,0.43
5362,2021-05-13,EMR,35874,16521,19353,27292,7861,721,ITH,ITH5,8,Emilia-Romagna,Emilia-Romagna,4459477,4098192,91.9,0.8
5363,2021-03-15,EMR,13461,6252,7209,6852,6507,102,ITH,ITH5,8,Emilia-Romagna,Emilia-Romagna,4459477,4111653,92.2,0.3
5364,2021-02-09,EMR,4161,1253,2908,2307,1853,1,ITH,ITH5,8,Emilia-Romagna,Emilia-Romagna,4459477,4115814,92.29,0.09
5365,2021-09-01,EMR,22598,12044,10554,7183,14669,746,ITH,ITH5,8,Emilia-Romagna,Emilia-Romagna,4459477,4138412,92.8,0.51
5366,2021-05-15,EMR,33297,14998,18299,22214,10442,641,ITH,ITH5,8,Emilia-Romagna,Emilia-Romagna,4459477,4171709,93.55,0.75
5367,2021-04-29,EMR,44993,21152,23841,26608,17565,820,ITH,ITH5,8,Emilia-Romagna,Emilia-Romagna,4459477,4216702,94.56,1.01
5368,2021-01-19,EMR,2050,507,1543,2032,17,1,ITH,ITH5,8,Emilia-Romagna,Emilia-Romagna,4459477,4218752,94.6,0.05
5369,2021-07-07,EMR,37923,19151,18772,13397,23724,802,ITH,ITH5,8,Emilia-Romagna,Emilia-Romagna,4459477,4256675,95.45,0.85
5370,2021-03-29,EMR,21436,9619,11817,16539,4665,232,ITH,ITH5,8,Emilia-Romagna,Emilia-Romagna,4459477,4278111,95.93,0.48
5371,2021-07-23,EMR,40435,21907,18528,19796,19492,1147,ITH,ITH5,8,Emilia-Romagna,Emilia-Romagna,4459477,4318546,96.84,0.91
5372,2021-04-14,EMR,27063,12851,14212,20522,6114,427,ITH,ITH5,8,Emilia-Romagna,Emilia-Romagna,4459477,4345609,97.45,0.61
5373,2021-01-31,EMR,7709,2771,4938,240,7469,0,ITH,ITH5,8,Emilia-Romagna,Emilia-Romagna,4459477,4353318,97.62,0.17
5374,2021-06-29,EMR,37731,18608,19123,18132,18799,800,ITH,ITH5,8,Emilia-Romagna,Emilia-Romagna,4459477,4391049,98.47,0.85
5375,2021-03-21,EMR,11959,5296,6663,7261,4604,94,ITH,ITH5,8,Emilia-Romagna,Emilia-Romagna,4459477,4403008,98.73,0.27
5376,2021-06-10,EMR,45107,23170,21937,38676,5388,1043,ITH,ITH5,8,Emilia-Romagna,Emilia-Romagna,4459477,4448115,99.75,1.01
5377,2021-03-02,EMR,12664,4274,8390,10515,2091,58,ITH,ITH5,8,Emilia-Romagna,Emilia-Romagna,4459477,4460779,100.03,0.28
5378,2021-08-20,EMR,19730,10741,8989,10242,8518,970,ITH,ITH5,8,Emilia-Romagna,Emilia-Romagna,4459477,4480509,100.47,0.44
5379,2021-06-17,EMR,46708,23667,23041,21770,24231,707,ITH,ITH5,8,Emilia-Romagna,Emilia-Romagna,4459477,4527217,101.52,1.05
5380,2021-02-04,EMR,9935,3208,6727,1235,8699,1,ITH,ITH5,8,Emilia-Romagna,Emilia-Romagna,4459477,4537152,101.74,0.22
5381,2021-05-22,EMR,33180,14162,19018,16473,16250,457,ITH,ITH5,8,Emilia-Romagna,Emilia-Romagna,4459477,4570332,102.49,0.74
5382,2021-07-18,EMR,34588,17917,16671,8189,25831,568,ITH,ITH5,8,Emilia-Romagna,Emilia-Romagna,4459477,4604920,103.26,0.78
5383,2021-04-09,EMR,25803,11695,14108,19526,5761,516,ITH,ITH5,8,Emilia-Romagna,Emilia-Romagna,4459477,4630723,103.84,0.58
5384,2021-02-02,EMR,9499,3056,6443,534,8964,1,ITH,ITH5,8,Emilia-Romagna,Emilia-Romagna,4459477,4640222,104.05,0.21
5385,2021-03-19,EMR,15920,6970,8950,7791,7971,158,ITH,ITH5,8,Emilia-Romagna,Emilia-Romagna,4459477,4656142,104.41,0.36
5386,2021-04-07,EMR,26889,12307,14582,20463,6080,346,ITH,ITH5,8,Emilia-Romagna,Emilia-Romagna,4459477,4683031,105.01,0.6
5387,2021-01-14,EMR,8133,2596,5537,8124,0,9,ITH,ITH5,8,Emilia-Romagna,Emilia-Romagna,4459477,4691164,105.2,0.18
5388,2021-05-27,EMR,42351,18770,23581,13555,28288,508,ITH,ITH5,8,Emilia-Romagna,Emilia-Romagna,4459477,4733515,106.15,0.95
5389,2021-02-16,EMR,5774,2448,3326,5230,530,14,ITH,ITH5,8,Emilia-Romagna,Emilia-Romagna,4459477,4739289,106.27,0.13
5390,2021-08-01,EMR,30053,16164,13889,10274,19371,408,ITH,ITH5,8,Emilia-Romagna,Emilia-Romagna,4459477,4769342,106.95,0.67
5391,2021-08-18,EMR,22279,12201,10078,14568,6653,1058,ITH,ITH5,8,Emilia-Romagna,Emilia-Romagna,4459477,4791621,107.45,0.5
5392,2021-05-10,EMR,33895,16151,17744,26005,7263,627,ITH,ITH5,8,Emilia-Romagna,Emilia-Romagna,4459477,4825516,108.21,0.76
5393,2021-07-30,EMR,39863,21413,18450,15673,23464,726,ITH,ITH5,8,Emilia-Romagna,Emilia-Romagna,4459477,4865379,109.1,0.89
5394,2021-04-21,EMR,23976,10972,13004,13869,9745,362,ITH,ITH5,8,Emilia-Romagna,Emilia-Romagna,4459477,4889355,109.64,0.54
5395,2021-05-08,EMR,32380,15112,17268,20398,11439,543,ITH,ITH5,8,Emilia-Romagna,Emilia-Romagna,4459477,4921735,110.37,0.73
5396,2021-01-28,EMR,10264,3344,6920,348,9916,0,ITH,ITH5,8,Emilia-Romagna,Emilia-Romagna,4459477,4931999,110.6,0.23
5397,2021-02-21,EMR,4449,1707,2742,3999,440,10,ITH,ITH5,8,Emilia-Romagna,Emilia-Romagna,4459477,4936448,110.7,0.1
5398,2021-07-25,EMR,28480,15185,13295,10550,17443,487,ITH,ITH5,8,Emilia-Romagna,Emilia-Romagna,4459477,4964928,111.33,0.64
5399,2021-08-11,EMR,27760,14883,12877,12074,14879,807,ITH,ITH5,8,Emilia-Romagna,Emilia-Romagna,4459477,4992688,111.96,0.62
5400,2021-08-25,EMR,25139,13548,11591,9558,14611,970,ITH,ITH5,8,Emilia-Romagna,Emilia-Romagna,4459477,5017827,112.52,0.56
5401,2021-01-21,EMR,2167,730,1437,819,1348,0,ITH,ITH5,8,Emilia-Romagna,Emilia-Romagna,4459477,5019994,112.57,0.05
5402,2021-06-03,EMR,37937,18444,19493,29683,7561,693,ITH,ITH5,8,Emilia-Romagna,Emilia-Romagna,4459477,5057931,113.42,0.85
5403,2021-02-23,EMR,8217,3219,4998,7819,386,12,ITH,ITH5,8,Emilia-Romagna,Emilia-Romagna,4459477,5066148,113.6,0.18
5404,2021-03-12,EMR,18326,7710,10616,11308,6721,297,ITH,ITH5,8,Emilia-Romagna,Emilia-Romagna,4459477,5084474,114.02,0.41
5405,2021-08-13,EMR,21263,11803,9460,14264,6087,912,ITH,ITH5,8,Emilia-Romagna,Emilia-Romagna,4459477,5105737,114.49,0.48
5406,2021-08-30,EMR,27020,14188,12832,7626,18362,1032,ITH,ITH5,8,Emilia-Romagna,Emilia-Romagna,4459477,5132757,115.1,0.61
5407,2021-07-09,EMR,44925,22954,21971,5413,39088,424,ITH,ITH5,8,Emilia-Romagna,Emilia-Romagna,4459477,5177682,116.11,1.01
5408,2021-01-17,EMR,2898,890,2008,2648,249,1,ITH,ITH5,8,Emilia-Romagna,Emilia-Romagna,4459477,5180580,116.17,0.06
5409,2021-01-02,EMR,2379,917,1462,2379,0,0,ITH,ITH5,8,Emilia-Romagna,Emilia-Romagna,4459477,5182959,116.22,0.05
5410,2021-09-13,EMR,24167,13074,11093,4777,18683,707,ITH,ITH5,8,Emilia-Romagna,Emilia-Romagna,4459477,5207126,116.77,0.54
5411,2021-06-05,EMR,44329,22386,21943,36622,6925,782,ITH,ITH5,8,Emilia-Romagna,Emilia-Romagna,4459477,5251455,117.76,0.99
5412,2021-06-22,EMR,36543,18200,18343,16257,19641,645,ITH,ITH5,8,Emilia-Romagna,Emilia-Romagna,4459477,5287998,118.58,0.82
5413,2021-07-06,EMR,36817,18513,18304,12923,23199,695,ITH,ITH5,8,Emilia-Romagna,Emilia-Romagna,4459477,5324815,119.4,0.83
5414,2021-05-17,EMR,32485,15417,17068,22336,9565,584,ITH,ITH5,8,Emilia-Romagna,Emilia-Romagna,4459477,5357300,120.13,0.73
5415,2021-04-02,EMR,23376,10535,12841,18554,4489,333,ITH,ITH5,8,Emilia-Romagna,Emilia-Romagna,4459477,5380676,120.66,0.52
5416,2021-09-06,EMR,25281,13410,11871,7037,17435,809,ITH,ITH5,8,Emilia-Romagna,Emilia-Romagna,4459477,5405957,121.22,0.57
5417,2021-05-29,EMR,37953,16522,21431,16660,20767,526,ITH,ITH5,8,Emilia-Romagna,Emilia-Romagna,4459477,5443910,122.08,0.85
5418,2021-07-11,EMR,30400,15244,15156,2751,27380,269,ITH,ITH5,8,Emilia-Romagna,Emilia-Romagna,4459477,5474310,122.76,0.68
5419,2021-03-31,EMR,25289,11057,14232,19505,5473,311,ITH,ITH5,8,Emilia-Romagna,Emilia-Romagna,4459477,5499599,123.32,0.57
5420,2021-07-13,EMR,48503,24845,23658,6468,41348,687,ITH,ITH5,8,Emilia-Romagna,Emilia-Romagna,4459477,5548102,124.41,1.09
5421,2021-09-08,EMR,23513,12691,10822,5827,17061,625,ITH,ITH5,8,Emilia-Romagna,Emilia-Romagna,4459477,5571615,124.94,0.53
5422,2021-07-04,EMR,24273,12071,12202,10172,13610,491,ITH,ITH5,8,Emilia-Romagna,Emilia-Romagna,4459477,5595888,125.48,0.54
5423,2021-03-26,EMR,23739,10125,13614,17022,6443,274,ITH,ITH5,8,Emilia-Romagna,Emilia-Romagna,4459477,5619627,126.02,0.53
5424,2021-03-25,EMR,21484,9420,12064,14235,6993,256,ITH,ITH5,8,Emilia-Romagna,Emilia-Romagna,4459477,5641111,126.5,0.48
5425,2021-05-21,EMR,39389,17563,21826,21635,17133,621,ITH,ITH5,8,Emilia-Romagna,Emilia-Romagna,4459477,5680500,127.38,0.88
5426,2021-02-10,EMR,4024,1385,2639,2757,1261,6,ITH,ITH5,8,Emilia-Romagna,Emilia-Romagna,4459477,5684524,127.47,0.09
5427,2021-04-08,EMR,31403,14420,16983,25329,5335,739,ITH,ITH5,8,Emilia-Romagna,Emilia-Romagna,4459477,5715927,128.17,0.7
5428,2021-03-18,EMR,13773,5849,7924,5681,8005,87,ITH,ITH5,8,Emilia-Romagna,Emilia-Romagna,4459477,5729700,128.48,0.31
5429,2021-05-14,EMR,37358,17203,20155,26800,9657,901,ITH,ITH5,8,Emilia-Romagna,Emilia-Romagna,4459477,5767058,129.32,0.84
5430,2021-02-03,EMR,9348,2992,6356,962,8385,1,ITH,ITH5,8,Emilia-Romagna,Emilia-Romagna,4459477,5776406,129.53,0.21
5431,2021-04-01,EMR,23947,10765,13182,19070,4558,319,ITH,ITH5,8,Emilia-Romagna,Emilia-Romagna,4459477,5800353,130.07,0.54
5432,2021-02-17,EMR,6543,2766,3777,5757,773,13,ITH,ITH5,8,Emilia-Romagna,Emilia-Romagna,4459477,5806896,130.21,0.15
5433,2021-06-01,EMR,27199,13116,14083,16834,9930,435,ITH,ITH5,8,Emilia-Romagna,Emilia-Romagna,4459477,5834095,130.82,0.61
5434,2021-07-28,EMR,38706,20757,17949,13959,24055,692,ITH,ITH5,8,Emilia-Romagna,Emilia-Romagna,4459477,5872801,131.69,0.87
5435,2021-09-09,EMR,24733,13146,11587,5204,18903,626,ITH,ITH5,8,Emilia-Romagna,Emilia-Romagna,4459477,5897534,132.25,0.55
5436,2021-04-12,EMR,19260,9016,10244,14449,4452,359,ITH,ITH5,8,Emilia-Romagna,Emilia-Romagna,4459477,5916794,132.68,0.43
5437,2021-06-08,EMR,45153,23119,22034,36795,7549,809,ITH,ITH5,8,Emilia-Romagna,Emilia-Romagna,4459477,5961947,133.69,1.01
5438,2021-08-04,EMR,35346,18845,16501,13030,21688,628,ITH,ITH5,8,Emilia-Romagna,Emilia-Romagna,4459477,5997293,134.48,0.79
5439,2021-07-21,EMR,43693,23306,20387,10776,32284,633,ITH,ITH5,8,Emilia-Romagna,Emilia-Romagna,4459477,6040986,135.46,0.98
5440,2021-04-19,EMR,20922,9806,11116,14337,6284,301,ITH,ITH5,8,Emilia-Romagna,Emilia-Romagna,4459477,6061908,135.93,0.47
5441,2021-01-09,EMR,9999,3458,6541,9995,0,4,ITH,ITH5,8,Emilia-Romagna,Emilia-Romagna,4459477,6071907,136.16,0.22
5442,2021-06-15,EMR,43879,22643,21236,27906,15075,898,ITH,ITH5,8,Emilia-Romagna,Emilia-Romagna,4459477,6115786,137.14,0.98
5443,2021-03-07,EMR,7850,2962,4888,6288,1525,37,ITH,ITH5,8,Emilia-Romagna,Emilia-Romagna,4459477,6123636,137.32,0.18
5444,2021-05-03,EMR,28739,13570,15169,17396,10887,456,ITH,ITH5,8,Emilia-Romagna,Emilia-Romagna,4459477,6152375,137.96,0.64
5445,2021-02-28,EMR,6830,2528,4302,4959,1852,19,ITH,ITH5,8,Emilia-Romagna,Emilia-Romagna,4459477,6159205,138.11,0.15
5446,2021-04-26,EMR,27915,12940,14975,18037,9324,554,ITH,ITH5,8,Emilia-Romagna,Emilia-Romagna,4459477,6187120,138.74,0.63
5447,2021-01-16,EMR,5632,1719,3913,5631,0,1,ITH,ITH5,8,Emilia-Romagna,Emilia-Romagna,4459477,6192752,138.87,0.13
5448,2021-03-14,EMR,8807,3840,4967,4943,3800,64,ITH,ITH5,8,Emilia-Romagna,Emilia-Romagna,4459477,6201559,139.06,0.2
