,data,area,Vaccinazioni giornaliere,sesso_maschile,sesso_femminile,Operatori sanitari - sociosanitari,Personale non sanitario,Ospiti RSA,categoria_personale_scolastico,categoria_60_69,categoria_70_79,categoria_over80,categoria_soggetti_fragili,categoria_forze_armate,categoria_altro,prima_dose,seconda_dose,codice_NUTS1,codice_NUTS2,codice_regione_ISTAT,nome_area,Regione,popolazione,Totale vaccinazioni,Totale vaccinazioni ogni cento ab,Vaccinazioni giornaliere ogni cento ab
0,2021-02-01,PIE,8642,3053,5589,6170,1404,1068,0,0,0,0,0,0,0,578,8064,ITC,ITC1,1,Piemonte,Piemonte,4356406,8642,0.2,0.2
1,2021-02-05,PIE,9451,3078,6373,5766,2041,1643,0,0,0,1,0,0,0,657,8794,ITC,ITC1,1,Piemonte,Piemonte,4356406,18093,0.42,0.22
2,2021-02-20,PIE,3829,1252,2577,1100,1064,219,1416,0,0,30,0,0,0,3656,173,ITC,ITC1,1,Piemonte,Piemonte,4356406,21922,0.5,0.09
3,2021-03-26,PIE,17724,6974,10750,1162,743,527,2428,3,14,11527,601,712,7,8820,8904,ITC,ITC1,1,Piemonte,Piemonte,4356406,39646,0.91,0.41
4,2021-04-19,PIE,17128,8244,8884,232,135,114,25,545,3533,4156,8374,1,13,13397,3731,ITC,ITC1,1,Piemonte,Piemonte,4356406,56774,1.3,0.39
5,2021-02-19,PIE,5529,2171,3358,1989,1752,666,1078,0,1,34,0,0,9,5027,502,ITC,ITC1,1,Piemonte,Piemonte,4356406,62303,1.43,0.13
6,2021-04-05,PIE,14736,6233,8503,148,115,0,703,1,3904,7988,1843,33,1,12174,2562,ITC,ITC1,1,Piemonte,Piemonte,4356406,77039,1.77,0.34
7,2021-04-15,PIE,28275,12969,15306,862,393,304,51,1194,9373,6539,9526,6,27,22879,5396,ITC,ITC1,1,Piemonte,Piemonte,4356406,105314,2.42,0.65
8,2021-01-16,PIE,7771,2630,5141,4802,1597,1372,0,0,0,0,0,0,0,7771,0,ITC,ITC1,1,Piemonte,Piemonte,4356406,113085,2.6,0.18
9,2021-02-03,PIE,10197,3303,6894,6641,2301,1246,0,2,0,5,0,0,2,611,9586,ITC,ITC1,1,Piemonte,Piemonte,4356406,123282,2.83,0.23
10,2021-04-01,PIE,19205,7988,11217,665,371,288,914,6,1942,13843,911,261,4,11097,8108,ITC,ITC1,1,Piemonte,Piemonte,4356406,142487,3.27,0.44
11,2021-01-19,PIE,6423,2099,4324,3575,1300,1548,0,0,0,0,0,0,0,6414,9,ITC,ITC1,1,Piemonte,Piemonte,4356406,148910,3.42,0.15
12,2021-02-13,PIE,4152,1334,2818,2310,722,1114,5,0,0,1,0,0,0,2931,1221,ITC,ITC1,1,Piemonte,Piemonte,4356406,153062,3.51,0.1
13,2021-01-18,PIE,6164,2047,4117,3238,1403,1523,0,0,0,0,0,0,0,5916,248,ITC,ITC1,1,Piemonte,Piemonte,4356406,159226,3.65,0.14
14,2021-01-03,PIE,3062,966,2096,2715,295,52,0,0,0,0,0,0,0,3062,0,ITC,ITC1,1,Piemonte,Piemonte,4356406,162288,3.73,0.07
15,2021-01-04,PIE,5563,1679,3884,4590,736,235,0,0,0,0,0,0,2,5563,0,ITC,ITC1,1,Piemonte,Piemonte,4356406,167851,3.85,0.13
16,2021-02-12,PIE,6885,2212,4673,3527,1645,1707,2,0,0,4,0,0,0,3928,2957,ITC,ITC1,1,Piemonte,Piemonte,4356406,174736,4.01,0.16
17,2021-03-09,PIE,13938,5417,8521,1688,1543,356,2330,2,6,8006,1,6,0,11596,2342,ITC,ITC1,1,Piemonte,Piemonte,4356406,188674,4.33,0.32
18,2021-02-27,PIE,12678,4846,7832,885,963,232,3038,0,0,7558,1,0,1,12331,347,ITC,ITC1,1,Piemonte,Piemonte,4356406,201352,4.62,0.29
19,2021-03-20,PIE,11912,4896,7016,882,1039,163,1937,20,17,7683,18,24,129,6016,5896,ITC,ITC1,1,Piemonte,Piemonte,4356406,213264,4.9,0.27
20,2021-02-17,PIE,4787,2154,2633,2245,2030,497,1,0,1,1,0,0,12,3798,989,ITC,ITC1,1,Piemonte,Piemonte,4356406,218051,5.01,0.11
21,2021-03-08,PIE,13921,5284,8637,2041,1419,413,2628,1,1,7403,0,12,3,11208,2713,ITC,ITC1,1,Piemonte,Piemonte,4356406,231972,5.32,0.32
22,2021-03-27,PIE,18343,7812,10531,1215,1621,110,2109,13,939,11696,443,191,6,9530,8813,ITC,ITC1,1,Piemonte,Piemonte,4356406,250315,5.75,0.42
23,2021-03-01,PIE,12035,4839,7196,1157,1277,281,2435,0,4,6873,0,7,1,11226,809,ITC,ITC1,1,Piemonte,Piemonte,4356406,262350,6.02,0.28
24,2021-01-29,PIE,5941,1886,4055,4199,1067,673,0,0,0,2,0,0,0,455,5486,ITC,ITC1,1,Piemonte,Piemonte,4356406,268291,6.16,0.14
25,2021-02-16,PIE,3965,1754,2211,1821,1583,548,1,0,4,1,0,1,6,3207,758,ITC,ITC1,1,Piemonte,Piemonte,4356406,272256,6.25,0.09
26,2021-02-14,PIE,1476,498,978,796,381,285,14,0,0,0,0,0,0,876,600,ITC,ITC1,1,Piemonte,Piemonte,4356406,273732,6.28,0.03
27,2021-02-24,PIE,11405,4628,6777,1855,1291,408,2155,0,3,5684,0,5,4,10899,506,ITC,ITC1,1,Piemonte,Piemonte,4356406,285137,6.55,0.26
28,2021-03-31,PIE,19078,8090,10988,962,687,311,687,8,2526,13160,520,210,7,10387,8691,ITC,ITC1,1,Piemonte,Piemonte,4356406,304215,6.98,0.44
29,2021-01-09,PIE,6183,2185,3998,4488,1124,568,0,1,0,0,0,0,2,6183,0,ITC,ITC1,1,Piemonte,Piemonte,4356406,310398,7.13,0.14
30,2021-01-07,PIE,5386,1739,3647,4158,885,341,0,1,0,0,0,0,1,5386,0,ITC,ITC1,1,Piemonte,Piemonte,4356406,315784,7.25,0.12
31,2021-02-09,PIE,7351,2309,5042,4155,1366,1830,0,0,0,0,0,0,0,722,6629,ITC,ITC1,1,Piemonte,Piemonte,4356406,323135,7.42,0.17
32,2021-02-15,PIE,4431,1596,2835,2320,1143,962,1,0,2,2,0,1,0,3226,1205,ITC,ITC1,1,Piemonte,Piemonte,4356406,327566,7.52,0.1
33,2021-01-27,PIE,4196,1453,2743,2983,656,557,0,0,0,0,0,0,0,999,3197,ITC,ITC1,1,Piemonte,Piemonte,4356406,331762,7.62,0.1
34,2021-01-06,PIE,3116,1111,2005,2370,429,313,0,0,1,1,0,0,2,3116,0,ITC,ITC1,1,Piemonte,Piemonte,4356406,334878,7.69,0.07
35,2021-03-11,PIE,13692,5018,8674,2312,1416,381,2184,0,5,7370,0,18,6,10602,3090,ITC,ITC1,1,Piemonte,Piemonte,4356406,348570,8.0,0.31
36,2021-01-20,PIE,6535,2066,4469,3568,1153,1813,0,0,0,0,0,0,1,5818,717,ITC,ITC1,1,Piemonte,Piemonte,4356406,355105,8.15,0.15
37,2021-01-05,PIE,5380,1602,3778,4367,722,285,0,0,2,1,0,0,3,5380,0,ITC,ITC1,1,Piemonte,Piemonte,4356406,360485,8.27,0.12
38,2021-04-02,PIE,20040,8254,11786,885,438,389,878,4,2690,13319,1253,153,31,11640,8400,ITC,ITC1,1,Piemonte,Piemonte,4356406,380525,8.73,0.46
39,2021-04-09,PIE,25594,11249,14345,1217,523,251,46,41,7354,11083,5035,35,9,21093,4501,ITC,ITC1,1,Piemonte,Piemonte,4356406,406119,9.32,0.59
40,2021-01-28,PIE,5588,1809,3779,4118,878,590,0,1,0,1,0,0,0,384,5204,ITC,ITC1,1,Piemonte,Piemonte,4356406,411707,9.45,0.13
41,2021-02-25,PIE,12209,5247,6962,1446,2064,405,1959,0,2,6329,0,1,3,11663,546,ITC,ITC1,1,Piemonte,Piemonte,4356406,423916,9.73,0.28
42,2021-01-15,PIE,8967,2954,6013,5499,1922,1546,0,0,0,0,0,0,0,8967,0,ITC,ITC1,1,Piemonte,Piemonte,4356406,432883,9.94,0.21
43,2021-04-07,PIE,23475,9924,13551,951,441,268,533,7,5765,12347,3050,66,47,18030,5445,ITC,ITC1,1,Piemonte,Piemonte,4356406,456358,10.48,0.54
44,2021-01-11,PIE,8741,2980,5761,6054,1559,1126,0,1,0,0,0,0,1,8741,0,ITC,ITC1,1,Piemonte,Piemonte,4356406,465099,10.68,0.2
45,2021-02-02,PIE,10236,3507,6729,6870,2049,1317,0,0,0,0,0,0,0,815,9421,ITC,ITC1,1,Piemonte,Piemonte,4356406,475335,10.91,0.23
46,2021-02-11,PIE,6764,2107,4657,3424,1326,2010,3,0,0,0,0,0,1,3006,3758,ITC,ITC1,1,Piemonte,Piemonte,4356406,482099,11.07,0.16
47,2021-03-02,PIE,11192,4502,6690,907,1122,215,2517,0,4,6416,0,9,2,10376,816,ITC,ITC1,1,Piemonte,Piemonte,4356406,493291,11.32,0.26
48,2021-03-07,PIE,11967,4656,7311,1322,1134,111,2050,0,5,7343,0,0,2,11087,880,ITC,ITC1,1,Piemonte,Piemonte,4356406,505258,11.6,0.27
49,2021-01-14,PIE,9761,3150,6611,6175,2100,1484,0,0,0,0,0,0,2,9761,0,ITC,ITC1,1,Piemonte,Piemonte,4356406,515019,11.82,0.22
50,2021-03-25,PIE,17060,7189,9871,1035,963,626,1375,4,25,11999,559,467,7,8425,8635,ITC,ITC1,1,Piemonte,Piemonte,4356406,532079,12.21,0.39
51,2021-01-23,PIE,4256,1325,2931,3208,528,520,0,0,0,0,0,0,0,879,3377,ITC,ITC1,1,Piemonte,Piemonte,4356406,536335,12.31,0.1
52,2021-03-13,PIE,13032,4717,8315,1169,996,158,2138,1,3,8558,0,4,5,11589,1443,ITC,ITC1,1,Piemonte,Piemonte,4356406,549367,12.61,0.3
53,2021-01-17,PIE,3517,1168,2349,2082,595,840,0,0,0,0,0,0,0,2870,647,ITC,ITC1,1,Piemonte,Piemonte,4356406,552884,12.69,0.08
54,2021-04-08,PIE,24968,10842,14126,1055,522,271,412,16,7354,11210,4026,96,6,20266,4702,ITC,ITC1,1,Piemonte,Piemonte,4356406,577852,13.26,0.57
55,2021-01-26,PIE,6329,1878,4451,4726,874,728,0,0,0,0,0,0,1,735,5594,ITC,ITC1,1,Piemonte,Piemonte,4356406,584181,13.41,0.15
56,2021-03-17,PIE,12508,5049,7459,2083,806,236,9,1,9,9100,9,250,5,5221,7287,ITC,ITC1,1,Piemonte,Piemonte,4356406,596689,13.7,0.29
57,2021-03-14,PIE,8200,3331,4869,794,588,2,990,0,5,5815,0,1,5,5307,2893,ITC,ITC1,1,Piemonte,Piemonte,4356406,604889,13.89,0.19
58,2021-02-04,PIE,10198,3337,6861,6235,2198,1763,0,0,0,0,0,0,2,588,9610,ITC,ITC1,1,Piemonte,Piemonte,4356406,615087,14.12,0.23
59,2021-02-10,PIE,7453,2347,5106,3856,1500,2097,0,0,0,0,0,0,0,1316,6137,ITC,ITC1,1,Piemonte,Piemonte,4356406,622540,14.29,0.17
60,2021-01-31,PIE,4106,1748,2358,3077,654,375,0,0,0,0,0,0,0,112,3994,ITC,ITC1,1,Piemonte,Piemonte,4356406,626646,14.38,0.09
61,2021-02-18,PIE,4784,2089,2695,2254,1898,624,2,0,0,0,0,1,5,4354,430,ITC,ITC1,1,Piemonte,Piemonte,4356406,631430,14.49,0.11
62,2020-12-30,PIE,730,322,408,685,45,0,0,0,0,0,0,0,0,730,0,ITC,ITC1,1,Piemonte,Piemonte,4356406,632160,14.51,0.02
63,2021-03-19,PIE,10965,4491,6474,1092,645,429,271,3,19,8177,22,301,6,4407,6558,ITC,ITC1,1,Piemonte,Piemonte,4356406,643125,14.76,0.25
64,2021-03-28,PIE,16034,6892,9142,926,1914,34,2480,3,461,8926,1075,209,6,8426,7608,ITC,ITC1,1,Piemonte,Piemonte,4356406,659159,15.13,0.37
65,2020-12-31,PIE,3909,1334,2575,3415,356,134,0,0,0,0,0,0,4,3909,0,ITC,ITC1,1,Piemonte,Piemonte,4356406,663068,15.22,0.09
66,2021-04-06,PIE,20156,8768,11388,647,592,260,1319,13,5165,9620,2402,113,25,14992,5164,ITC,ITC1,1,Piemonte,Piemonte,4356406,683224,15.68,0.46
67,2021-02-07,PIE,3087,974,2113,1648,662,777,0,0,0,0,0,0,0,445,2642,ITC,ITC1,1,Piemonte,Piemonte,4356406,686311,15.75,0.07
68,2021-04-12,PIE,22392,10097,12295,605,296,235,60,235,7461,7214,6230,10,46,19426,2966,ITC,ITC1,1,Piemonte,Piemonte,4356406,708703,16.27,0.51
69,2021-01-08,PIE,5529,1761,3768,4078,1027,422,0,0,0,0,0,0,2,5529,0,ITC,ITC1,1,Piemonte,Piemonte,4356406,714232,16.39,0.13
70,2021-04-11,PIE,20801,9308,11493,399,231,68,254,217,7625,6881,5111,5,10,18640,2161,ITC,ITC1,1,Piemonte,Piemonte,4356406,735033,16.87,0.48
71,2021-03-18,PIE,11737,4797,6940,1463,770,342,18,3,14,8871,7,235,14,4027,7710,ITC,ITC1,1,Piemonte,Piemonte,4356406,746770,17.14,0.27
72,2021-01-21,PIE,6880,2314,4566,4707,840,1318,0,3,0,0,0,0,12,3385,3495,ITC,ITC1,1,Piemonte,Piemonte,4356406,753650,17.3,0.16
73,2021-02-26,PIE,12239,4912,7327,813,1427,487,2896,0,1,6613,0,1,1,11502,737,ITC,ITC1,1,Piemonte,Piemonte,4356406,765889,17.58,0.28
74,2021-03-03,PIE,12114,4640,7474,1103,1025,257,2665,0,2,7059,0,3,0,11295,819,ITC,ITC1,1,Piemonte,Piemonte,4356406,778003,17.86,0.28
75,2021-03-05,PIE,15259,5956,9303,2539,2011,655,2370,1,5,7673,1,4,0,11443,3816,ITC,ITC1,1,Piemonte,Piemonte,4356406,793262,18.21,0.35
76,2021-02-23,PIE,9230,3711,5519,2298,1346,389,1052,0,2,4106,0,33,4,8650,580,ITC,ITC1,1,Piemonte,Piemonte,4356406,802492,18.42,0.21
77,2021-01-25,PIE,6213,1938,4275,4786,862,562,0,0,1,1,0,0,1,983,5230,ITC,ITC1,1,Piemonte,Piemonte,4356406,808705,18.56,0.14
78,2021-01-01,PIE,1038,395,643,922,116,0,0,0,0,0,0,0,0,1038,0,ITC,ITC1,1,Piemonte,Piemonte,4356406,809743,18.59,0.02
79,2021-03-06,PIE,13988,5209,8779,2262,1126,462,2697,1,2,7437,1,0,0,11199,2789,ITC,ITC1,1,Piemonte,Piemonte,4356406,823731,18.91,0.32
80,2021-04-04,PIE,9239,4052,5187,197,302,0,294,0,2034,4225,2172,9,6,6526,2713,ITC,ITC1,1,Piemonte,Piemonte,4356406,832970,19.12,0.21
81,2021-03-16,PIE,10517,4267,6250,2229,872,322,13,7,10,6798,65,162,39,4462,6055,ITC,ITC1,1,Piemonte,Piemonte,4356406,843487,19.36,0.24
82,2020-12-27,PIE,913,369,544,761,73,76,0,1,0,0,0,0,2,913,0,ITC,ITC1,1,Piemonte,Piemonte,4356406,844400,19.38,0.02
83,2021-01-22,PIE,3864,1248,2616,2280,649,934,0,0,0,1,0,0,0,2523,1341,ITC,ITC1,1,Piemonte,Piemonte,4356406,848264,19.47,0.09
84,2021-03-12,PIE,13899,5152,8747,2142,1295,472,2274,0,4,7621,6,84,1,10965,2934,ITC,ITC1,1,Piemonte,Piemonte,4356406,862163,19.79,0.32
85,2021-04-18,PIE,22128,10469,11659,305,239,4,46,872,5334,4352,10950,10,16,19377,2751,ITC,ITC1,1,Piemonte,Piemonte,4356406,884291,20.3,0.51
86,2021-04-17,PIE,29402,13720,15682,689,316,48,56,2777,9720,4788,10984,9,15,26191,3211,ITC,ITC1,1,Piemonte,Piemonte,4356406,913693,20.97,0.67
87,2021-03-10,PIE,13577,5123,8454,1666,1339,280,2240,1,6,8017,1,26,1,11283,2294,ITC,ITC1,1,Piemonte,Piemonte,4356406,927270,21.29,0.31
88,2021-04-03,PIE,19372,8108,11264,308,236,76,540,13,2972,13410,1658,114,45,10827,8545,ITC,ITC1,1,Piemonte,Piemonte,4356406,946642,21.73,0.44
89,2021-02-22,PIE,8467,3464,5003,1705,1398,512,920,2,4,3914,0,9,3,7877,590,ITC,ITC1,1,Piemonte,Piemonte,4356406,955109,21.92,0.19
90,2021-02-28,PIE,10812,4058,6754,642,501,53,2790,1,1,6822,0,0,2,10572,240,ITC,ITC1,1,Piemonte,Piemonte,4356406,965921,22.17,0.25
91,2021-02-08,PIE,6916,2355,4561,3786,1557,1572,0,0,0,0,0,0,1,666,6250,ITC,ITC1,1,Piemonte,Piemonte,4356406,972837,22.33,0.16
92,2021-02-21,PIE,5086,2080,3006,685,263,47,737,0,0,3353,0,0,1,4984,102,ITC,ITC1,1,Piemonte,Piemonte,4356406,977923,22.45,0.12
93,2021-01-10,PIE,5214,2275,2939,3912,781,519,0,0,0,0,0,0,2,5214,0,ITC,ITC1,1,Piemonte,Piemonte,4356406,983137,22.57,0.12
94,2021-04-14,PIE,27020,12273,14747,854,421,445,59,771,10024,6789,7631,9,17,22531,4489,ITC,ITC1,1,Piemonte,Piemonte,4356406,1010157,23.19,0.62
95,2021-01-12,PIE,10046,3404,6642,6862,2010,1170,0,2,0,0,0,0,2,10046,0,ITC,ITC1,1,Piemonte,Piemonte,4356406,1020203,23.42,0.23
96,2021-03-21,PIE,10586,4679,5907,585,1475,9,1318,2,165,6897,1,133,1,4063,6523,ITC,ITC1,1,Piemonte,Piemonte,4356406,1030789,23.66,0.24
97,2021-03-29,PIE,15102,6351,8751,416,542,137,1330,1,1259,10362,732,321,2,8497,6605,ITC,ITC1,1,Piemonte,Piemonte,4356406,1045891,24.01,0.35
98,2021-03-15,PIE,10643,4154,6489,1716,1459,231,1469,2,5,5731,0,28,2,5028,5615,ITC,ITC1,1,Piemonte,Piemonte,4356406,1056534,24.25,0.24
99,2021-03-30,PIE,16823,6996,9827,782,433,287,994,6,1370,12115,534,298,4,8953,7870,ITC,ITC1,1,Piemonte,Piemonte,4356406,1073357,24.64,0.39
100,2021-01-30,PIE,5978,2135,3843,4367,1116,495,0,0,0,0,0,0,0,218,5760,ITC,ITC1,1,Piemonte,Piemonte,4356406,1079335,24.78,0.14
101,2021-04-16,PIE,26813,12530,14283,926,437,262,75,1617,7425,5692,10344,5,30,22255,4558,ITC,ITC1,1,Piemonte,Piemonte,4356406,1106148,25.39,0.62
102,2020-12-28,PIE,1,1,0,1,0,0,0,0,0,0,0,0,0,1,0,ITC,ITC1,1,Piemonte,Piemonte,4356406,1106149,25.39,0.0
103,2021-01-13,PIE,10080,3223,6857,6486,2261,1329,0,0,0,0,0,0,4,10080,0,ITC,ITC1,1,Piemonte,Piemonte,4356406,1116229,25.62,0.23
104,2021-04-13,PIE,25313,11373,13940,631,225,259,121,890,10235,6848,6075,7,22,21901,3412,ITC,ITC1,1,Piemonte,Piemonte,4356406,1141542,26.2,0.58
105,2021-02-06,PIE,7983,2664,5319,5101,1629,1251,0,0,0,1,0,0,1,400,7583,ITC,ITC1,1,Piemonte,Piemonte,4356406,1149525,26.39,0.18
106,2021-04-10,PIE,30025,13346,16679,896,454,138,134,346,11932,10206,5896,15,8,25728,4297,ITC,ITC1,1,Piemonte,Piemonte,4356406,1179550,27.08,0.69
107,2021-03-22,PIE,11402,4817,6585,874,910,181,1221,1,9,7913,38,253,2,3819,7583,ITC,ITC1,1,Piemonte,Piemonte,4356406,1190952,27.34,0.26
108,2021-03-04,PIE,14479,5727,8752,2186,1950,609,2190,0,2,7535,0,3,4,11530,2949,ITC,ITC1,1,Piemonte,Piemonte,4356406,1205431,27.67,0.33
109,2021-03-24,PIE,15469,6330,9139,1072,766,479,840,5,21,11508,380,388,10,6343,9126,ITC,ITC1,1,Piemonte,Piemonte,4356406,1220900,28.03,0.36
110,2021-03-23,PIE,12977,5389,7588,689,1020,222,1334,5,15,9238,259,184,11,6740,6237,ITC,ITC1,1,Piemonte,Piemonte,4356406,1233877,28.32,0.3
111,2021-01-02,PIE,3544,1134,2410,3078,410,53,0,1,0,0,0,0,2,3544,0,ITC,ITC1,1,Piemonte,Piemonte,4356406,1237421,28.4,0.08
112,2021-01-24,PIE,3152,958,2194,2634,372,146,0,0,0,0,0,0,0,434,2718,ITC,ITC1,1,Piemonte,Piemonte,4356406,1240573,28.48,0.07
113,2021-02-01,UMB,1260,333,927,875,33,352,0,0,0,0,0,0,0,47,1213,ITI,ITI2,10,Umbria,Umbria,882015,1260,0.14,0.14
114,2021-04-12,UMB,7059,3065,3994,204,17,0,17,30,2406,2909,1460,4,12,5341,1718,ITI,ITI2,10,Umbria,Umbria,882015,8319,0.94,0.8
115,2021-02-20,UMB,282,100,182,83,7,39,0,0,0,152,0,0,1,258,24,ITI,ITI2,10,Umbria,Umbria,882015,8601,0.98,0.03
116,2021-01-02,UMB,301,110,191,301,0,0,0,0,0,0,0,0,0,301,0,ITI,ITI2,10,Umbria,Umbria,882015,8902,1.01,0.03
117,2021-01-11,UMB,1281,337,944,878,12,384,0,1,0,0,0,0,6,1281,0,ITI,ITI2,10,Umbria,Umbria,882015,10183,1.15,0.15
118,2021-03-09,UMB,4029,1951,2078,143,566,106,23,0,1,2912,7,217,54,2737,1292,ITI,ITI2,10,Umbria,Umbria,882015,14212,1.61,0.46
119,2021-01-25,UMB,647,322,325,645,2,0,0,0,0,0,0,0,0,5,642,ITI,ITI2,10,Umbria,Umbria,882015,14859,1.68,0.07
120,2021-01-19,UMB,103,23,80,21,2,80,0,0,0,0,0,0,0,103,0,ITI,ITI2,10,Umbria,Umbria,882015,14962,1.7,0.01
121,2021-02-06,UMB,396,138,258,333,47,16,0,0,0,0,0,0,0,34,362,ITI,ITI2,10,Umbria,Umbria,882015,15358,1.74,0.04
122,2021-01-04,UMB,809,397,412,809,0,0,0,0,0,0,0,0,0,809,0,ITI,ITI2,10,Umbria,Umbria,882015,16167,1.83,0.09
123,2021-04-10,UMB,7423,3492,3931,81,62,30,50,49,2463,686,3970,18,14,7309,114,ITI,ITI2,10,Umbria,Umbria,882015,23590,2.67,0.84
124,2021-02-05,UMB,780,234,546,645,51,84,0,0,0,0,0,0,0,18,762,ITI,ITI2,10,Umbria,Umbria,882015,24370,2.76,0.09
125,2021-02-03,UMB,725,174,551,560,34,131,0,0,0,0,0,0,0,67,658,ITI,ITI2,10,Umbria,Umbria,882015,25095,2.85,0.08
126,2021-02-26,UMB,660,253,407,386,73,40,3,0,0,154,0,4,0,652,8,ITI,ITI2,10,Umbria,Umbria,882015,25755,2.92,0.07
127,2021-01-07,UMB,1291,383,908,884,1,404,0,0,0,1,0,0,1,1291,0,ITI,ITI2,10,Umbria,Umbria,882015,27046,3.07,0.15
128,2021-03-11,UMB,3539,1681,1858,144,652,239,158,0,0,2018,1,291,36,2533,1006,ITI,ITI2,10,Umbria,Umbria,882015,30585,3.47,0.4
129,2021-03-14,UMB,66,48,18,0,6,1,4,6,2,0,0,0,47,66,0,ITI,ITI2,10,Umbria,Umbria,882015,30651,3.48,0.01
130,2021-01-06,UMB,843,323,520,840,0,0,0,1,0,0,0,0,2,843,0,ITI,ITI2,10,Umbria,Umbria,882015,31494,3.57,0.1
131,2021-03-10,UMB,3985,1908,2077,122,783,157,75,3,3,2565,6,263,8,2729,1256,ITI,ITI2,10,Umbria,Umbria,882015,35479,4.02,0.45
132,2021-03-06,UMB,4265,1110,3155,422,186,26,2322,6,4,1127,0,125,47,4122,143,ITI,ITI2,10,Umbria,Umbria,882015,39744,4.51,0.48
133,2021-02-16,UMB,1307,655,652,34,4,0,0,2,1,1263,3,0,0,1298,9,ITI,ITI2,10,Umbria,Umbria,882015,41051,4.65,0.15
134,2021-02-17,UMB,1618,748,870,363,4,0,1,0,6,1240,1,0,3,1267,351,ITI,ITI2,10,Umbria,Umbria,882015,42669,4.84,0.18
135,2021-03-01,UMB,1503,774,729,110,10,0,1,0,0,1249,0,133,0,1389,114,ITI,ITI2,10,Umbria,Umbria,882015,44172,5.01,0.17
136,2021-01-05,UMB,850,428,422,847,0,0,0,1,0,0,0,0,2,850,0,ITI,ITI2,10,Umbria,Umbria,882015,45022,5.1,0.1
137,2021-04-03,UMB,2081,708,1373,143,208,30,216,5,29,1257,169,21,3,1053,1028,ITI,ITI2,10,Umbria,Umbria,882015,47103,5.34,0.24
138,2021-02-24,UMB,1520,565,955,1083,45,90,0,1,0,292,0,9,0,1505,15,ITI,ITI2,10,Umbria,Umbria,882015,48623,5.51,0.17
139,2021-01-16,UMB,221,73,148,146,32,43,0,0,0,0,0,0,0,221,0,ITI,ITI2,10,Umbria,Umbria,882015,48844,5.54,0.03
140,2021-04-01,UMB,4123,1702,2421,193,14,239,19,4,7,3144,451,5,47,2152,1971,ITI,ITI2,10,Umbria,Umbria,882015,52967,6.01,0.47
141,2021-03-20,UMB,2272,821,1451,316,679,0,1200,0,0,0,0,72,5,2247,25,ITI,ITI2,10,Umbria,Umbria,882015,55239,6.26,0.26
142,2021-02-08,UMB,637,203,434,368,111,154,0,0,0,0,0,4,0,88,549,ITI,ITI2,10,Umbria,Umbria,882015,55876,6.34,0.07
143,2021-01-15,UMB,696,213,483,588,44,64,0,0,0,0,0,0,0,696,0,ITI,ITI2,10,Umbria,Umbria,882015,56572,6.41,0.08
144,2021-01-09,UMB,1719,492,1227,888,7,824,0,0,0,0,0,0,0,1719,0,ITI,ITI2,10,Umbria,Umbria,882015,58291,6.61,0.19
145,2021-01-14,UMB,750,200,550,697,35,17,1,0,0,0,0,0,0,750,0,ITI,ITI2,10,Umbria,Umbria,882015,59041,6.69,0.09
146,2021-03-29,UMB,3798,1647,2151,247,42,58,26,9,11,2831,534,21,19,2318,1480,ITI,ITI2,10,Umbria,Umbria,882015,62839,7.12,0.43
147,2021-03-05,UMB,4591,1379,3212,604,320,7,2554,2,1,712,0,383,8,3935,656,ITI,ITI2,10,Umbria,Umbria,882015,67430,7.64,0.52
148,2021-02-02,UMB,942,274,668,713,16,212,0,0,0,0,0,0,1,32,910,ITI,ITI2,10,Umbria,Umbria,882015,68372,7.75,0.11
149,2021-04-18,UMB,1527,680,847,67,11,0,41,2,171,838,376,21,0,596,931,ITI,ITI2,10,Umbria,Umbria,882015,69899,7.92,0.17
150,2021-03-15,UMB,4595,1929,2666,1425,264,79,263,2,1,2343,7,206,5,2827,1768,ITI,ITI2,10,Umbria,Umbria,882015,74494,8.45,0.52
151,2021-02-10,UMB,715,349,366,606,106,3,0,0,0,0,0,0,0,700,15,ITI,ITI2,10,Umbria,Umbria,882015,75209,8.53,0.08
152,2021-04-14,UMB,8058,3632,4426,226,35,15,19,55,2858,3138,1693,12,7,6079,1979,ITI,ITI2,10,Umbria,Umbria,882015,83267,9.44,0.91
153,2021-03-07,UMB,845,180,665,17,82,25,676,0,0,45,0,0,0,838,7,ITI,ITI2,10,Umbria,Umbria,882015,84112,9.54,0.1
154,2021-01-13,UMB,450,139,311,379,29,42,0,0,0,0,0,0,0,450,0,ITI,ITI2,10,Umbria,Umbria,882015,84562,9.59,0.05
155,2021-04-07,UMB,5519,2274,3245,482,42,92,19,8,919,3180,757,18,2,3514,2005,ITI,ITI2,10,Umbria,Umbria,882015,90081,10.21,0.63
156,2021-03-13,UMB,1731,524,1207,120,154,49,1152,3,0,152,0,91,10,1486,245,ITI,ITI2,10,Umbria,Umbria,882015,91812,10.41,0.2
157,2021-01-18,UMB,613,219,394,347,114,144,0,2,1,0,0,0,5,529,84,ITI,ITI2,10,Umbria,Umbria,882015,92425,10.48,0.07
158,2021-02-15,UMB,1368,692,676,10,4,0,0,0,1,1351,2,0,0,1367,1,ITI,ITI2,10,Umbria,Umbria,882015,93793,10.63,0.16
159,2021-03-27,UMB,4247,1510,2737,752,595,1,576,4,7,2233,1,24,54,3907,340,ITI,ITI2,10,Umbria,Umbria,882015,98040,11.12,0.48
160,2021-03-04,UMB,4485,1853,2632,849,184,4,1466,2,0,1563,0,410,7,3657,828,ITI,ITI2,10,Umbria,Umbria,882015,102525,11.62,0.51
161,2021-04-02,UMB,4236,1694,2542,375,318,46,331,2,23,883,2155,35,68,3509,727,ITI,ITI2,10,Umbria,Umbria,882015,106761,12.1,0.48
162,2021-01-27,UMB,838,329,509,837,1,0,0,0,0,0,0,0,0,13,825,ITI,ITI2,10,Umbria,Umbria,882015,107599,12.2,0.1
163,2021-02-13,UMB,115,28,87,68,46,0,0,0,0,1,0,0,0,112,3,ITI,ITI2,10,Umbria,Umbria,882015,107714,12.21,0.01
164,2021-01-26,UMB,814,390,424,813,1,0,0,0,0,0,0,0,0,18,796,ITI,ITI2,10,Umbria,Umbria,882015,108528,12.3,0.09
165,2021-01-31,UMB,1056,276,780,765,10,281,0,0,0,0,0,0,0,25,1031,ITI,ITI2,10,Umbria,Umbria,882015,109584,12.42,0.12
166,2021-04-13,UMB,7630,3378,4252,218,23,21,19,60,2826,2875,1570,8,10,5961,1669,ITI,ITI2,10,Umbria,Umbria,882015,117214,13.29,0.87
167,2021-03-30,UMB,3939,1703,2236,179,31,108,20,0,0,3068,431,15,87,2407,1532,ITI,ITI2,10,Umbria,Umbria,882015,121153,13.74,0.45
168,2021-01-20,UMB,613,222,391,583,15,14,1,0,0,0,0,0,0,613,0,ITI,ITI2,10,Umbria,Umbria,882015,121766,13.81,0.07
169,2021-01-03,UMB,267,111,156,267,0,0,0,0,0,0,0,0,0,267,0,ITI,ITI2,10,Umbria,Umbria,882015,122033,13.84,0.03
170,2021-02-12,UMB,671,224,447,459,208,1,2,0,0,1,0,0,0,665,6,ITI,ITI2,10,Umbria,Umbria,882015,122704,13.91,0.08
171,2021-01-22,UMB,276,105,171,273,1,2,0,0,0,0,0,0,0,32,244,ITI,ITI2,10,Umbria,Umbria,882015,122980,13.94,0.03
172,2021-03-08,UMB,3668,1799,1869,141,289,46,42,0,1,2855,2,292,0,2305,1363,ITI,ITI2,10,Umbria,Umbria,882015,126648,14.36,0.42
173,2021-04-17,UMB,6475,2982,3493,158,31,14,127,27,1673,1393,3037,9,6,5133,1342,ITI,ITI2,10,Umbria,Umbria,882015,133123,15.09,0.73
174,2021-01-23,UMB,277,100,177,276,1,0,0,0,0,0,0,0,0,2,275,ITI,ITI2,10,Umbria,Umbria,882015,133400,15.12,0.03
175,2021-02-04,UMB,733,226,507,693,20,20,0,0,0,0,0,0,0,25,708,ITI,ITI2,10,Umbria,Umbria,882015,134133,15.21,0.08
176,2021-03-02,UMB,3638,1345,2293,318,233,55,1446,0,1,1302,0,283,0,3634,4,ITI,ITI2,10,Umbria,Umbria,882015,137771,15.62,0.41
177,2021-03-17,UMB,3330,1313,2017,1430,55,131,16,2,0,1683,1,8,4,1858,1472,ITI,ITI2,10,Umbria,Umbria,882015,141101,16.0,0.38
178,2021-04-08,UMB,5674,2393,3281,343,22,163,12,23,1395,2886,810,13,7,3986,1688,ITI,ITI2,10,Umbria,Umbria,882015,146775,16.64,0.64
179,2021-03-22,UMB,3558,1653,1905,163,235,0,147,3,2,2830,0,173,5,2312,1246,ITI,ITI2,10,Umbria,Umbria,882015,150333,17.04,0.4
180,2021-01-28,UMB,1240,392,848,891,4,345,0,0,0,0,0,0,0,19,1221,ITI,ITI2,10,Umbria,Umbria,882015,151573,17.18,0.14
181,2021-03-31,UMB,3873,1714,2159,177,39,160,23,1,5,2959,425,6,78,2211,1662,ITI,ITI2,10,Umbria,Umbria,882015,155446,17.62,0.44
182,2021-01-10,UMB,1056,275,781,740,3,309,0,1,1,1,0,0,1,1056,0,ITI,ITI2,10,Umbria,Umbria,882015,156502,17.74,0.12
183,2021-02-27,UMB,1658,354,1304,14,11,13,1560,0,0,0,0,60,0,1642,16,ITI,ITI2,10,Umbria,Umbria,882015,158160,17.93,0.19
184,2021-04-06,UMB,5233,2138,3095,598,55,79,28,16,374,3343,709,5,26,2885,2348,ITI,ITI2,10,Umbria,Umbria,882015,163393,18.52,0.59
185,2020-12-31,UMB,322,127,195,310,0,0,0,2,0,0,0,0,10,322,0,ITI,ITI2,10,Umbria,Umbria,882015,163715,18.56,0.04
186,2021-02-23,UMB,1693,658,1035,1187,95,17,0,0,0,394,0,0,0,1651,42,ITI,ITI2,10,Umbria,Umbria,882015,165408,18.75,0.19
187,2021-03-21,UMB,665,330,335,31,285,0,64,34,6,0,0,34,211,665,0,ITI,ITI2,10,Umbria,Umbria,882015,166073,18.83,0.08
188,2021-03-03,UMB,4436,1772,2664,720,247,86,1533,0,0,1519,0,329,2,3724,712,ITI,ITI2,10,Umbria,Umbria,882015,170509,19.33,0.5
189,2021-02-18,UMB,1495,582,913,324,14,170,0,0,1,985,0,0,1,1029,466,ITI,ITI2,10,Umbria,Umbria,882015,172004,19.5,0.17
190,2021-04-11,UMB,3097,1500,1597,30,1,2,4,23,920,136,1942,39,0,3048,49,ITI,ITI2,10,Umbria,Umbria,882015,175101,19.85,0.35
191,2021-01-08,UMB,1173,337,836,926,8,238,0,0,1,0,0,0,0,1173,0,ITI,ITI2,10,Umbria,Umbria,882015,176274,19.99,0.13
192,2021-04-05,UMB,4249,1728,2521,764,22,69,26,3,88,2653,615,6,3,2193,2056,ITI,ITI2,10,Umbria,Umbria,882015,180523,20.47,0.48
193,2021-04-04,UMB,59,20,39,0,0,0,0,0,22,37,0,0,0,23,36,ITI,ITI2,10,Umbria,Umbria,882015,180582,20.47,0.01
194,2021-02-25,UMB,1335,496,839,827,96,99,5,1,0,305,0,0,2,1283,52,ITI,ITI2,10,Umbria,Umbria,882015,181917,20.63,0.15
195,2021-02-19,UMB,743,293,450,282,12,14,0,0,0,433,2,0,0,526,217,ITI,ITI2,10,Umbria,Umbria,882015,182660,20.71,0.08
196,2021-03-26,UMB,4564,1682,2882,570,496,91,738,2,4,2482,0,155,26,4391,173,ITI,ITI2,10,Umbria,Umbria,882015,187224,21.23,0.52
197,2021-01-29,UMB,1221,343,878,934,16,271,0,0,0,0,0,0,0,79,1142,ITI,ITI2,10,Umbria,Umbria,882015,188445,21.37,0.14
198,2021-03-16,UMB,3505,1434,2071,1634,79,65,11,0,2,1708,1,0,5,1878,1627,ITI,ITI2,10,Umbria,Umbria,882015,191950,21.76,0.4
199,2021-03-12,UMB,2633,1031,1602,113,454,41,1193,2,0,465,2,309,54,2135,498,ITI,ITI2,10,Umbria,Umbria,882015,194583,22.06,0.3
200,2021-04-09,UMB,6261,2928,3333,86,56,24,85,32,1782,634,3530,10,22,6062,199,ITI,ITI2,10,Umbria,Umbria,882015,200844,22.77,0.71
201,2021-02-07,UMB,54,17,37,46,8,0,0,0,0,0,0,0,0,1,53,ITI,ITI2,10,Umbria,Umbria,882015,200898,22.78,0.01
202,2021-01-30,UMB,1577,483,1094,841,18,717,0,0,0,1,0,0,0,44,1533,ITI,ITI2,10,Umbria,Umbria,882015,202475,22.96,0.18
203,2021-03-25,UMB,3875,1691,2184,256,71,63,32,5,8,3267,1,123,49,2811,1064,ITI,ITI2,10,Umbria,Umbria,882015,206350,23.4,0.44
204,2021-01-24,UMB,254,104,150,254,0,0,0,0,0,0,0,0,0,1,253,ITI,ITI2,10,Umbria,Umbria,882015,206604,23.42,0.03
205,2020-12-27,UMB,85,45,40,67,2,16,0,0,0,0,0,0,0,85,0,ITI,ITI2,10,Umbria,Umbria,882015,206689,23.43,0.01
206,2021-03-24,UMB,4069,1758,2311,215,165,1,42,3,1,3529,0,111,2,2746,1323,ITI,ITI2,10,Umbria,Umbria,882015,210758,23.9,0.46
207,2021-03-23,UMB,3793,1685,2108,395,237,12,60,4,3,2852,0,175,55,2164,1629,ITI,ITI2,10,Umbria,Umbria,882015,214551,24.33,0.43
208,2021-01-21,UMB,610,202,408,428,13,169,0,0,0,0,0,0,0,341,269,ITI,ITI2,10,Umbria,Umbria,882015,215161,24.39,0.07
209,2021-04-16,UMB,7850,3627,4223,166,34,96,180,72,2448,1868,2942,16,28,6013,1837,ITI,ITI2,10,Umbria,Umbria,882015,223011,25.28,0.89
210,2021-04-19,UMB,3478,1547,1931,147,28,24,11,22,321,1959,954,2,10,1493,1985,ITI,ITI2,10,Umbria,Umbria,882015,226489,25.68,0.39
211,2021-02-22,UMB,1859,778,1081,736,89,1,0,1,2,1007,5,0,18,1773,86,ITI,ITI2,10,Umbria,Umbria,882015,228348,25.89,0.21
212,2021-01-17,UMB,54,17,37,47,7,0,0,0,0,0,0,0,0,54,0,ITI,ITI2,10,Umbria,Umbria,882015,228402,25.9,0.01
213,2021-03-19,UMB,1734,561,1173,462,234,68,724,4,0,192,0,27,23,1078,656,ITI,ITI2,10,Umbria,Umbria,882015,230136,26.09,0.2
214,2021-03-28,UMB,1095,442,653,65,15,5,37,5,7,937,0,24,0,1071,24,ITI,ITI2,10,Umbria,Umbria,882015,231231,26.22,0.12
215,2021-02-11,UMB,842,349,493,735,98,5,3,1,0,0,0,0,0,837,5,ITI,ITI2,10,Umbria,Umbria,882015,232073,26.31,0.1
216,2021-01-12,UMB,784,247,537,665,14,105,0,0,0,0,0,0,0,784,0,ITI,ITI2,10,Umbria,Umbria,882015,232857,26.4,0.09
217,2021-03-18,UMB,2831,1100,1731,975,119,246,12,3,5,1461,0,3,7,1593,1238,ITI,ITI2,10,Umbria,Umbria,882015,235688,26.72,0.32
218,2021-04-15,UMB,4609,2085,2524,181,30,36,22,35,1515,1862,903,15,10,3645,964,ITI,ITI2,10,Umbria,Umbria,882015,240297,27.24,0.52
219,2021-01-01,UMB,273,105,168,272,0,0,0,0,0,0,0,0,1,273,0,ITI,ITI2,10,Umbria,Umbria,882015,240570,27.28,0.03
220,2021-03-21,MOL,1246,542,704,14,1,0,0,0,2,1090,133,0,6,479,767,ITF,ITF2,14,Molise,Molise,305617,1246,0.41,0.41
221,2021-03-07,MOL,1131,501,630,2,16,0,0,0,0,1113,0,0,0,1129,2,ITF,ITF2,14,Molise,Molise,305617,2377,0.78,0.37
222,2021-02-23,MOL,581,223,358,136,39,61,1,0,0,340,0,0,4,362,219,ITF,ITF2,14,Molise,Molise,305617,2958,0.97,0.19
223,2021-01-13,MOL,474,160,314,256,69,144,1,1,1,0,0,0,2,474,0,ITF,ITF2,14,Molise,Molise,305617,3432,1.12,0.16
224,2021-02-02,MOL,539,176,363,295,64,180,0,0,0,0,0,0,0,216,323,ITF,ITF2,14,Molise,Molise,305617,3971,1.3,0.18
225,2021-03-12,MOL,1458,637,821,42,33,0,505,0,1,719,34,116,8,1422,36,ITF,ITF2,14,Molise,Molise,305617,5429,1.78,0.48
226,2021-03-24,MOL,1630,658,972,77,57,0,450,2,3,707,275,48,11,1228,402,ITF,ITF2,14,Molise,Molise,305617,7059,2.31,0.53
227,2021-03-23,MOL,1642,694,948,76,8,6,454,2,4,606,367,97,22,1435,207,ITF,ITF2,14,Molise,Molise,305617,8701,2.85,0.54
228,2021-04-18,MOL,553,254,299,0,0,0,1,1,87,277,182,0,5,104,449,ITF,ITF2,14,Molise,Molise,305617,9254,3.03,0.18
229,2020-12-27,MOL,50,20,30,29,4,17,0,0,0,0,0,0,0,50,0,ITF,ITF2,14,Molise,Molise,305617,9304,3.04,0.02
230,2021-04-06,MOL,1462,688,774,33,9,9,1,2,5,238,1145,18,2,1119,343,ITF,ITF2,14,Molise,Molise,305617,10766,3.52,0.48
231,2021-01-08,MOL,429,141,288,244,7,120,0,13,0,0,0,0,45,429,0,ITF,ITF2,14,Molise,Molise,305617,11195,3.66,0.14
232,2021-02-21,MOL,573,227,346,1,1,0,0,0,1,570,0,0,0,571,2,ITF,ITF2,14,Molise,Molise,305617,11768,3.85,0.19
233,2021-03-14,MOL,595,239,356,2,0,0,0,1,1,582,7,0,2,17,578,ITF,ITF2,14,Molise,Molise,305617,12363,4.05,0.19
234,2021-02-28,MOL,829,331,498,38,3,27,0,0,0,761,0,0,0,787,42,ITF,ITF2,14,Molise,Molise,305617,13192,4.32,0.27
235,2021-02-18,MOL,319,74,245,296,8,0,0,0,0,0,0,0,15,306,13,ITF,ITF2,14,Molise,Molise,305617,13511,4.42,0.1
236,2021-01-10,MOL,270,72,198,82,19,169,0,0,0,0,0,0,0,270,0,ITF,ITF2,14,Molise,Molise,305617,13781,4.51,0.09
237,2021-01-31,MOL,268,70,198,85,18,164,1,0,0,0,0,0,0,6,262,ITF,ITF2,14,Molise,Molise,305617,14049,4.6,0.09
238,2021-02-09,MOL,359,170,189,161,83,110,0,0,0,0,0,0,5,197,162,ITF,ITF2,14,Molise,Molise,305617,14408,4.71,0.12
239,2021-01-26,MOL,450,184,266,444,0,0,1,2,0,0,0,0,3,8,442,ITF,ITF2,14,Molise,Molise,305617,14858,4.86,0.15
240,2021-02-19,MOL,169,93,76,95,70,1,3,0,0,0,0,0,0,167,2,ITF,ITF2,14,Molise,Molise,305617,15027,4.92,0.06
241,2021-01-28,MOL,613,217,396,430,9,154,1,4,1,0,0,0,14,17,596,ITF,ITF2,14,Molise,Molise,305617,15640,5.12,0.2
242,2021-03-15,MOL,832,338,494,137,43,67,297,24,4,118,31,61,50,587,245,ITF,ITF2,14,Molise,Molise,305617,16472,5.39,0.27
243,2021-03-10,MOL,1737,720,1017,188,7,1,509,2,5,757,54,187,27,1687,50,ITF,ITF2,14,Molise,Molise,305617,18209,5.96,0.57
244,2021-04-17,MOL,1597,792,805,5,3,0,3,1,164,481,902,34,4,913,684,ITF,ITF2,14,Molise,Molise,305617,19806,6.48,0.52
245,2021-02-27,MOL,1366,568,798,25,29,14,1,1,0,1290,0,0,6,1347,19,ITF,ITF2,14,Molise,Molise,305617,21172,6.93,0.45
246,2021-03-30,MOL,1953,839,1114,45,1,1,424,2,4,573,800,82,21,1441,512,ITF,ITF2,14,Molise,Molise,305617,23125,7.57,0.64
247,2021-01-22,MOL,126,35,91,21,32,73,0,0,0,0,0,0,0,126,0,ITF,ITF2,14,Molise,Molise,305617,23251,7.61,0.04
248,2021-04-13,MOL,1615,710,905,7,4,1,1,12,910,322,350,1,7,1028,587,ITF,ITF2,14,Molise,Molise,305617,24866,8.14,0.53
249,2021-03-22,MOL,1146,439,707,106,5,2,458,7,3,255,216,59,35,903,243,ITF,ITF2,14,Molise,Molise,305617,26012,8.51,0.37
250,2021-04-10,MOL,2555,1233,1322,10,4,0,19,1,12,237,2261,9,2,2404,151,ITF,ITF2,14,Molise,Molise,305617,28567,9.35,0.84
251,2021-03-16,MOL,614,230,384,13,4,11,0,3,7,395,173,4,4,267,347,ITF,ITF2,14,Molise,Molise,305617,29181,9.55,0.2
252,2021-02-05,MOL,593,269,324,460,22,63,0,13,0,0,0,0,35,55,538,ITF,ITF2,14,Molise,Molise,305617,29774,9.74,0.19
253,2021-03-17,MOL,905,384,521,45,25,42,1,8,4,573,176,13,18,574,331,ITF,ITF2,14,Molise,Molise,305617,30679,10.04,0.3
254,2021-02-08,MOL,334,141,193,206,39,85,0,3,0,0,0,0,1,216,118,ITF,ITF2,14,Molise,Molise,305617,31013,10.15,0.11
255,2021-02-01,MOL,562,201,361,301,144,111,1,1,0,0,0,0,4,14,548,ITF,ITF2,14,Molise,Molise,305617,31575,10.33,0.18
256,2021-03-28,MOL,1589,741,848,155,15,0,1,0,1,1184,231,1,1,487,1102,ITF,ITF2,14,Molise,Molise,305617,33164,10.85,0.52
257,2021-02-22,MOL,265,129,136,56,65,62,0,27,0,8,0,0,47,250,15,ITF,ITF2,14,Molise,Molise,305617,33429,10.94,0.09
258,2021-04-19,MOL,1469,699,770,14,4,51,6,1,569,138,648,22,16,802,667,ITF,ITF2,14,Molise,Molise,305617,34898,11.42,0.48
259,2021-01-17,MOL,78,38,40,78,0,0,0,0,0,0,0,0,0,48,30,ITF,ITF2,14,Molise,Molise,305617,34976,11.44,0.03
260,2021-03-19,MOL,1180,479,701,32,1,9,248,2,4,727,151,2,4,753,427,ITF,ITF2,14,Molise,Molise,305617,36156,11.83,0.39
261,2021-01-29,MOL,421,136,285,227,23,109,3,12,0,0,0,0,47,6,415,ITF,ITF2,14,Molise,Molise,305617,36577,11.97,0.14
262,2021-03-29,MOL,1996,826,1170,108,8,5,525,4,55,480,772,22,17,1510,486,ITF,ITF2,14,Molise,Molise,305617,38573,12.62,0.65
263,2021-04-15,MOL,1895,777,1118,3,3,0,27,7,692,649,496,4,14,1057,838,ITF,ITF2,14,Molise,Molise,305617,40468,13.24,0.62
264,2021-03-18,MOL,1156,476,680,73,10,45,0,2,3,855,157,0,11,692,464,ITF,ITF2,14,Molise,Molise,305617,41624,13.62,0.38
265,2021-01-12,MOL,336,114,222,132,74,129,0,0,0,0,0,0,1,336,0,ITF,ITF2,14,Molise,Molise,305617,41960,13.73,0.11
266,2021-03-05,MOL,1219,649,570,322,5,0,73,9,2,618,0,151,39,1015,204,ITF,ITF2,14,Molise,Molise,305617,43179,14.13,0.4
267,2021-01-09,MOL,450,152,298,221,27,178,0,5,0,0,0,0,19,450,0,ITF,ITF2,14,Molise,Molise,305617,43629,14.28,0.15
268,2021-02-16,MOL,156,70,86,148,5,0,0,2,0,0,0,0,1,150,6,ITF,ITF2,14,Molise,Molise,305617,43785,14.33,0.05
269,2021-03-20,MOL,2320,968,1352,28,23,0,222,1,6,1857,147,21,15,999,1321,ITF,ITF2,14,Molise,Molise,305617,46105,15.09,0.76
270,2021-02-17,MOL,72,32,40,47,10,6,0,0,0,1,0,0,8,57,15,ITF,ITF2,14,Molise,Molise,305617,46177,15.11,0.02
271,2021-02-07,MOL,66,32,34,49,1,16,0,0,0,0,0,0,0,19,47,ITF,ITF2,14,Molise,Molise,305617,46243,15.13,0.02
272,2021-02-24,MOL,666,278,388,242,66,44,1,6,7,274,0,0,26,333,333,ITF,ITF2,14,Molise,Molise,305617,46909,15.35,0.22
273,2021-03-25,MOL,1806,730,1076,53,4,18,493,3,10,832,269,107,17,1309,497,ITF,ITF2,14,Molise,Molise,305617,48715,15.94,0.59
274,2021-01-30,MOL,461,158,303,189,52,180,0,6,0,0,0,0,34,12,449,ITF,ITF2,14,Molise,Molise,305617,49176,16.09,0.15
275,2021-03-04,MOL,850,417,433,252,20,69,0,0,1,469,0,36,3,526,324,ITF,ITF2,14,Molise,Molise,305617,50026,16.37,0.28
276,2021-01-14,MOL,646,239,407,418,102,115,0,2,0,0,0,0,9,646,0,ITF,ITF2,14,Molise,Molise,305617,50672,16.58,0.21
277,2021-04-01,MOL,1437,654,783,27,18,21,20,0,2,715,566,62,6,712,725,ITF,ITF2,14,Molise,Molise,305617,52109,17.05,0.47
278,2021-01-16,MOL,420,166,254,270,16,127,0,1,0,0,0,0,6,420,0,ITF,ITF2,14,Molise,Molise,305617,52529,17.19,0.14
279,2021-04-03,MOL,1764,847,917,28,74,0,26,13,16,266,1322,7,12,1731,33,ITF,ITF2,14,Molise,Molise,305617,54293,17.77,0.58
280,2021-04-05,MOL,370,181,189,1,0,0,0,0,1,96,272,0,0,271,99,ITF,ITF2,14,Molise,Molise,305617,54663,17.89,0.12
281,2021-03-06,MOL,1728,807,921,156,18,0,0,2,4,1395,0,152,1,1569,159,ITF,ITF2,14,Molise,Molise,305617,56391,18.45,0.57
282,2021-03-03,MOL,672,316,356,63,4,48,127,0,0,385,0,45,0,590,82,ITF,ITF2,14,Molise,Molise,305617,57063,18.67,0.22
283,2021-01-06,MOL,689,260,429,456,26,171,0,1,2,21,0,0,12,689,0,ITF,ITF2,14,Molise,Molise,305617,57752,18.9,0.23
284,2021-01-05,MOL,449,180,269,441,0,0,0,1,0,0,0,0,7,449,0,ITF,ITF2,14,Molise,Molise,305617,58201,19.04,0.15
285,2021-02-03,MOL,731,249,482,391,112,180,1,4,3,0,0,0,40,338,393,ITF,ITF2,14,Molise,Molise,305617,58932,19.28,0.24
286,2021-01-19,MOL,173,63,110,90,57,22,2,0,0,0,0,0,2,162,11,ITF,ITF2,14,Molise,Molise,305617,59105,19.34,0.06
287,2021-01-15,MOL,538,242,296,398,17,81,0,8,0,0,0,0,34,538,0,ITF,ITF2,14,Molise,Molise,305617,59643,19.52,0.18
288,2021-01-04,MOL,314,131,183,301,0,0,0,2,0,0,0,0,11,314,0,ITF,ITF2,14,Molise,Molise,305617,59957,19.62,0.1
289,2021-02-06,MOL,429,179,250,276,14,130,1,2,0,0,0,0,6,29,400,ITF,ITF2,14,Molise,Molise,305617,60386,19.76,0.14
290,2021-04-16,MOL,2354,1010,1344,54,4,6,8,7,692,722,849,7,5,1146,1208,ITF,ITF2,14,Molise,Molise,305617,62740,20.53,0.77
291,2021-04-09,MOL,2295,1240,1055,33,10,1,1,93,9,136,2004,2,6,2104,191,ITF,ITF2,14,Molise,Molise,305617,65035,21.28,0.75
292,2021-02-25,MOL,541,239,302,68,3,28,0,6,0,434,0,0,2,473,68,ITF,ITF2,14,Molise,Molise,305617,65576,21.46,0.18
293,2021-03-08,MOL,1376,522,854,359,51,23,404,2,1,409,36,76,15,1236,140,ITF,ITF2,14,Molise,Molise,305617,66952,21.91,0.45
294,2021-01-07,MOL,598,209,389,414,2,145,0,5,1,4,0,0,27,598,0,ITF,ITF2,14,Molise,Molise,305617,67550,22.1,0.2
295,2021-01-20,MOL,18,8,10,14,4,0,0,0,0,0,0,0,0,18,0,ITF,ITF2,14,Molise,Molise,305617,67568,22.11,0.01
296,2021-03-11,MOL,1463,636,827,42,2,14,499,4,2,699,12,185,4,1457,6,ITF,ITF2,14,Molise,Molise,305617,69031,22.59,0.48
297,2021-01-25,MOL,319,130,189,317,0,0,2,0,0,0,0,0,0,3,316,ITF,ITF2,14,Molise,Molise,305617,69350,22.69,0.1
298,2021-02-12,MOL,330,149,181,224,13,72,2,7,1,0,0,0,11,208,122,ITF,ITF2,14,Molise,Molise,305617,69680,22.8,0.11
299,2021-04-11,MOL,1146,579,567,0,5,0,0,1,1,48,1087,0,4,1133,13,ITF,ITF2,14,Molise,Molise,305617,70826,23.17,0.37
300,2021-01-11,MOL,557,194,363,196,243,111,0,1,0,0,0,0,6,557,0,ITF,ITF2,14,Molise,Molise,305617,71383,23.36,0.18
301,2021-02-04,MOL,758,295,463,502,95,141,1,3,0,0,0,0,16,77,681,ITF,ITF2,14,Molise,Molise,305617,72141,23.61,0.25
302,2021-04-07,MOL,1658,834,824,36,12,62,80,9,3,109,1312,29,6,1383,275,ITF,ITF2,14,Molise,Molise,305617,73799,24.15,0.54
303,2021-03-02,MOL,667,383,284,98,106,51,151,0,0,139,0,113,9,509,158,ITF,ITF2,14,Molise,Molise,305617,74466,24.37,0.22
304,2021-04-08,MOL,1726,889,837,105,15,6,35,5,3,172,1366,8,11,1525,201,ITF,ITF2,14,Molise,Molise,305617,76192,24.93,0.56
305,2021-03-31,MOL,2138,896,1242,202,13,32,263,6,12,799,693,96,22,1319,819,ITF,ITF2,14,Molise,Molise,305617,78330,25.63,0.7
306,2021-04-04,MOL,253,141,112,1,0,0,0,0,0,3,248,0,1,238,15,ITF,ITF2,14,Molise,Molise,305617,78583,25.71,0.08
307,2021-02-11,MOL,293,133,160,225,19,45,1,0,0,0,0,3,0,257,36,ITF,ITF2,14,Molise,Molise,305617,78876,25.81,0.1
308,2021-03-01,MOL,661,274,387,200,36,108,147,8,1,135,0,2,24,447,214,ITF,ITF2,14,Molise,Molise,305617,79537,26.03,0.22
309,2021-03-13,MOL,1189,594,595,29,5,6,0,5,4,981,6,151,2,200,989,ITF,ITF2,14,Molise,Molise,305617,80726,26.41,0.39
310,2021-03-26,MOL,2560,1038,1522,70,62,23,548,7,16,1005,746,70,13,1918,642,ITF,ITF2,14,Molise,Molise,305617,83286,27.25,0.84
311,2021-02-10,MOL,150,78,72,91,6,53,0,0,0,0,0,0,0,130,20,ITF,ITF2,14,Molise,Molise,305617,83436,27.3,0.05
312,2021-04-14,MOL,1783,759,1024,44,1,11,3,5,973,430,307,5,4,1132,651,ITF,ITF2,14,Molise,Molise,305617,85219,27.88,0.58
313,2021-02-15,MOL,144,70,74,117,10,15,0,0,0,0,0,0,2,141,3,ITF,ITF2,14,Molise,Molise,305617,85363,27.93,0.05
314,2021-02-20,MOL,1018,441,577,20,5,8,0,0,1,983,0,0,1,998,20,ITF,ITF2,14,Molise,Molise,305617,86381,28.26,0.33
315,2021-01-18,MOL,114,48,66,97,14,0,0,1,0,0,0,0,2,114,0,ITF,ITF2,14,Molise,Molise,305617,86495,28.3,0.04
316,2021-04-12,MOL,1251,546,705,17,2,1,0,11,944,87,183,1,5,1009,242,ITF,ITF2,14,Molise,Molise,305617,87746,28.71,0.41
317,2021-02-13,MOL,132,80,52,129,3,0,0,0,0,0,0,0,0,132,0,ITF,ITF2,14,Molise,Molise,305617,87878,28.75,0.04
318,2021-01-27,MOL,674,251,423,436,12,209,1,10,0,0,0,1,5,8,666,ITF,ITF2,14,Molise,Molise,305617,88552,28.97,0.22
319,2021-02-26,MOL,563,260,303,42,7,3,55,9,1,406,1,0,39,490,73,ITF,ITF2,14,Molise,Molise,305617,89115,29.16,0.18
320,2021-03-09,MOL,1329,579,750,199,6,0,393,4,1,409,76,218,23,1177,152,ITF,ITF2,14,Molise,Molise,305617,90444,29.59,0.43
321,2021-03-27,MOL,2707,1263,1444,18,58,0,1,6,4,1880,714,23,3,1274,1433,ITF,ITF2,14,Molise,Molise,305617,93151,30.48,0.89
322,2021-04-02,MOL,1386,680,706,47,77,0,2,8,8,658,463,105,18,625,761,ITF,ITF2,14,Molise,Molise,305617,94537,30.93,0.45
323,2021-01-21,MOL,6,2,4,0,6,0,0,0,0,0,0,0,0,6,0,ITF,ITF2,14,Molise,Molise,305617,94543,30.94,0.0
324,2021-03-21,PUG,2673,1220,1453,462,32,13,285,0,3,1779,14,38,47,570,2103,ITF,ITF4,16,Puglia,Puglia,4029053,2673,0.07,0.07
325,2021-01-30,PUG,5525,2513,3012,4749,325,419,6,0,2,3,5,4,12,411,5114,ITF,ITF4,16,Puglia,Puglia,4029053,8198,0.2,0.14
326,2021-01-14,PUG,4063,1586,2477,3180,377,499,2,1,1,0,0,0,3,4063,0,ITF,ITF4,16,Puglia,Puglia,4029053,12261,0.3,0.1
327,2021-01-24,PUG,1668,749,919,1286,231,150,0,0,0,1,0,0,0,152,1516,ITF,ITF4,16,Puglia,Puglia,4029053,13929,0.35,0.04
328,2021-03-05,PUG,17022,6777,10245,2307,827,273,7000,33,23,5335,18,1170,36,14861,2161,ITF,ITF4,16,Puglia,Puglia,4029053,30951,0.77,0.42
329,2021-03-15,PUG,11744,5606,6138,2091,644,115,682,24,30,7666,18,461,13,5254,6490,ITF,ITF4,16,Puglia,Puglia,4029053,42695,1.06,0.29
330,2021-03-03,PUG,16461,6606,9855,1990,636,192,6704,5,5,5988,2,936,3,14638,1823,ITF,ITF4,16,Puglia,Puglia,4029053,59156,1.47,0.41
331,2021-03-07,PUG,4912,1939,2973,930,101,2,1852,4,4,1681,7,325,6,4342,570,ITF,ITF4,16,Puglia,Puglia,4029053,64068,1.59,0.12
332,2021-04-14,PUG,30527,14403,16124,618,217,39,82,4342,14876,4744,5189,115,305,27305,3222,ITF,ITF4,16,Puglia,Puglia,4029053,94595,2.35,0.76
333,2021-01-13,PUG,4537,1729,2808,3973,329,230,2,1,0,0,0,0,2,4537,0,ITF,ITF4,16,Puglia,Puglia,4029053,99132,2.46,0.11
334,2021-04-19,PUG,13868,6430,7438,386,47,32,20,657,8738,1839,2060,32,57,11891,1977,ITF,ITF4,16,Puglia,Puglia,4029053,113000,2.8,0.34
335,2021-02-23,PUG,9332,4411,4921,1787,360,169,1017,11,15,5554,1,399,19,8859,473,ITF,ITF4,16,Puglia,Puglia,4029053,122332,3.04,0.23
336,2021-02-12,PUG,4098,1629,2469,2938,443,690,5,1,1,5,2,10,3,3008,1090,ITF,ITF4,16,Puglia,Puglia,4029053,126430,3.14,0.1
337,2021-03-20,PUG,8219,3716,4503,1423,86,54,808,22,48,5647,42,68,21,3642,4577,ITF,ITF4,16,Puglia,Puglia,4029053,134649,3.34,0.2
338,2021-01-27,PUG,4576,1928,2648,3932,239,396,2,1,3,0,0,0,3,611,3965,ITF,ITF4,16,Puglia,Puglia,4029053,139225,3.46,0.11
339,2021-03-18,PUG,9220,4160,5060,1744,481,202,91,17,26,6555,42,41,21,3125,6095,ITF,ITF4,16,Puglia,Puglia,4029053,148445,3.68,0.23
340,2021-01-29,PUG,6192,2659,3533,5516,376,288,3,3,0,1,0,0,5,437,5755,ITF,ITF4,16,Puglia,Puglia,4029053,154637,3.84,0.15
341,2021-02-24,PUG,10011,4689,5322,1923,602,117,557,9,12,6409,0,365,17,9422,589,ITF,ITF4,16,Puglia,Puglia,4029053,164648,4.09,0.25
342,2021-02-13,PUG,3722,1453,2269,2883,516,291,7,0,2,4,0,18,1,3029,693,ITF,ITF4,16,Puglia,Puglia,4029053,168370,4.18,0.09
343,2021-01-22,PUG,1407,577,830,877,154,373,1,0,0,1,0,0,1,990,417,ITF,ITF4,16,Puglia,Puglia,4029053,169777,4.21,0.03
344,2021-02-10,PUG,3603,1425,2178,2491,247,864,1,0,0,0,0,0,0,2122,1481,ITF,ITF4,16,Puglia,Puglia,4029053,173380,4.3,0.09
345,2021-03-08,PUG,14626,6064,8562,2138,839,218,3937,13,9,6811,6,633,22,12233,2393,ITF,ITF4,16,Puglia,Puglia,4029053,188006,4.67,0.36
346,2021-01-09,PUG,4871,2245,2626,4318,255,246,1,5,1,4,5,0,36,4871,0,ITF,ITF4,16,Puglia,Puglia,4029053,192877,4.79,0.12
347,2021-01-21,PUG,2129,903,1226,1429,167,527,0,0,1,3,0,0,2,1270,859,ITF,ITF4,16,Puglia,Puglia,4029053,195006,4.84,0.05
348,2021-02-15,PUG,3253,1268,1985,2249,527,453,3,0,1,1,1,7,11,2633,620,ITF,ITF4,16,Puglia,Puglia,4029053,198259,4.92,0.08
349,2021-03-19,PUG,7923,3638,4285,1759,276,69,259,14,21,5386,50,66,23,3384,4539,ITF,ITF4,16,Puglia,Puglia,4029053,206182,5.12,0.2
350,2021-03-29,PUG,12674,5906,6768,1590,581,240,1128,33,139,7908,606,399,50,5963,6711,ITF,ITF4,16,Puglia,Puglia,4029053,218856,5.43,0.31
351,2021-03-13,PUG,10071,3968,6103,2161,277,129,3322,7,11,3846,32,254,32,8343,1728,ITF,ITF4,16,Puglia,Puglia,4029053,228927,5.68,0.25
352,2021-03-17,PUG,10245,4676,5569,1791,464,62,72,32,37,7652,37,51,47,4143,6102,ITF,ITF4,16,Puglia,Puglia,4029053,239172,5.94,0.25
353,2021-01-28,PUG,5465,2271,3194,4782,339,327,3,3,0,0,0,6,5,473,4992,ITF,ITF4,16,Puglia,Puglia,4029053,244637,6.07,0.14
354,2021-04-11,PUG,15551,6822,8729,331,84,15,110,376,1027,5480,7998,18,112,13877,1674,ITF,ITF4,16,Puglia,Puglia,4029053,260188,6.46,0.39
355,2021-02-26,PUG,13646,4999,8647,2125,682,288,4659,12,10,5227,17,604,22,12619,1027,ITF,ITF4,16,Puglia,Puglia,4029053,273834,6.8,0.34
356,2021-01-04,PUG,4503,2012,2491,4372,88,11,1,1,0,2,0,0,28,4503,0,ITF,ITF4,16,Puglia,Puglia,4029053,278337,6.91,0.11
357,2021-03-02,PUG,16277,6037,10240,1396,665,113,8166,17,17,4350,5,1535,13,14972,1305,ITF,ITF4,16,Puglia,Puglia,4029053,294614,7.31,0.4
358,2021-01-19,PUG,1221,452,769,531,113,577,0,0,0,0,0,0,0,1211,10,ITF,ITF4,16,Puglia,Puglia,4029053,295835,7.34,0.03
359,2021-04-07,PUG,14524,6409,8115,1034,413,85,360,151,496,8614,2992,145,234,7921,6603,ITF,ITF4,16,Puglia,Puglia,4029053,310359,7.7,0.36
360,2021-01-23,PUG,3037,1292,1745,2523,176,309,1,3,6,14,0,0,5,886,2151,ITF,ITF4,16,Puglia,Puglia,4029053,313396,7.78,0.08
361,2021-02-03,PUG,5031,2002,3029,4366,476,184,3,2,0,0,0,0,0,730,4301,ITF,ITF4,16,Puglia,Puglia,4029053,318427,7.9,0.12
362,2021-04-08,PUG,16800,7317,9483,1006,323,181,506,183,789,9613,3942,89,168,10756,6044,ITF,ITF4,16,Puglia,Puglia,4029053,335227,8.32,0.42
363,2021-01-18,PUG,1845,770,1075,1182,215,445,0,0,0,1,0,1,1,1496,349,ITF,ITF4,16,Puglia,Puglia,4029053,337072,8.37,0.05
364,2021-01-06,PUG,3943,1664,2279,3313,224,373,0,11,1,0,0,0,21,3943,0,ITF,ITF4,16,Puglia,Puglia,4029053,341015,8.46,0.1
365,2021-03-06,PUG,15787,5896,9891,2104,465,72,7035,16,15,5470,25,565,20,13819,1968,ITF,ITF4,16,Puglia,Puglia,4029053,356802,8.86,0.39
366,2021-01-08,PUG,5575,2335,3240,4852,373,328,3,0,1,0,2,4,12,5575,0,ITF,ITF4,16,Puglia,Puglia,4029053,362377,8.99,0.14
367,2021-03-01,PUG,15042,5839,9203,1971,724,83,5145,8,15,6182,2,890,22,13674,1368,ITF,ITF4,16,Puglia,Puglia,4029053,377419,9.37,0.37
368,2020-12-31,PUG,1635,782,853,1549,38,44,3,0,1,0,0,0,0,1635,0,ITF,ITF4,16,Puglia,Puglia,4029053,379054,9.41,0.04
369,2021-02-09,PUG,3838,1568,2270,2532,661,622,6,2,3,9,1,0,2,2166,1672,ITF,ITF4,16,Puglia,Puglia,4029053,382892,9.5,0.1
370,2021-03-27,PUG,11907,5610,6297,959,578,69,1370,38,90,7441,1055,215,92,6765,5142,ITF,ITF4,16,Puglia,Puglia,4029053,394799,9.8,0.3
371,2021-02-28,PUG,5886,1786,4100,559,136,26,3416,6,3,1543,0,194,3,5700,186,ITF,ITF4,16,Puglia,Puglia,4029053,400685,9.94,0.15
372,2021-03-26,PUG,11399,5320,6079,1605,913,287,1340,36,116,6447,93,442,120,6760,4639,ITF,ITF4,16,Puglia,Puglia,4029053,412084,10.23,0.28
373,2021-01-31,PUG,1808,825,983,1502,103,198,2,1,0,2,0,0,0,73,1735,ITF,ITF4,16,Puglia,Puglia,4029053,413892,10.27,0.04
374,2021-04-04,PUG,5898,2938,2960,43,13,0,38,43,49,282,5298,25,107,5891,7,ITF,ITF4,16,Puglia,Puglia,4029053,419790,10.42,0.15
375,2021-04-05,PUG,12485,6070,6415,54,57,4,29,64,221,955,10963,11,127,11952,533,ITF,ITF4,16,Puglia,Puglia,4029053,432275,10.73,0.31
376,2021-01-11,PUG,3748,1587,2161,3216,336,175,2,5,0,0,0,6,8,3748,0,ITF,ITF4,16,Puglia,Puglia,4029053,436023,10.82,0.09
377,2021-01-20,PUG,1546,541,1005,781,125,627,0,0,3,9,0,0,1,1538,8,ITF,ITF4,16,Puglia,Puglia,4029053,437569,10.86,0.04
378,2021-01-02,PUG,2948,1300,1648,2829,91,23,4,0,0,0,0,0,1,2948,0,ITF,ITF4,16,Puglia,Puglia,4029053,440517,10.93,0.07
379,2021-02-21,PUG,2172,472,1700,537,73,49,1456,1,5,32,0,12,7,2111,61,ITF,ITF4,16,Puglia,Puglia,4029053,442689,10.99,0.05
380,2021-01-16,PUG,2507,1033,1474,1682,300,518,1,1,1,0,0,0,4,2507,0,ITF,ITF4,16,Puglia,Puglia,4029053,445196,11.05,0.06
381,2021-02-02,PUG,4333,1839,2494,3623,389,317,3,1,0,0,0,0,0,592,3741,ITF,ITF4,16,Puglia,Puglia,4029053,449529,11.16,0.11
382,2021-03-11,PUG,14333,6172,8161,2906,930,515,3676,5,7,5279,8,988,19,11231,3102,ITF,ITF4,16,Puglia,Puglia,4029053,463862,11.51,0.36
383,2021-01-15,PUG,4550,1865,2685,3598,369,558,4,2,0,1,0,13,5,4550,0,ITF,ITF4,16,Puglia,Puglia,4029053,468412,11.63,0.11
384,2021-04-01,PUG,13217,6042,7175,1237,449,217,1034,56,300,8011,1473,318,122,6883,6334,ITF,ITF4,16,Puglia,Puglia,4029053,481629,11.95,0.33
385,2021-04-18,PUG,20734,9878,10856,70,33,4,8,3716,9050,1299,6307,12,235,19676,1058,ITF,ITF4,16,Puglia,Puglia,4029053,502363,12.47,0.51
386,2020-12-27,PUG,506,249,257,403,6,63,0,8,1,0,0,0,25,506,0,ITF,ITF4,16,Puglia,Puglia,4029053,502869,12.48,0.01
387,2021-02-17,PUG,4265,1743,2522,2462,1171,598,1,7,2,1,0,1,22,3666,599,ITF,ITF4,16,Puglia,Puglia,4029053,507134,12.59,0.11
388,2021-03-23,PUG,10372,4977,5395,1852,412,51,991,29,44,6086,48,741,118,3918,6454,ITF,ITF4,16,Puglia,Puglia,4029053,517506,12.84,0.26
389,2021-03-24,PUG,12891,5942,6949,1906,614,162,1542,31,57,7912,69,496,102,5671,7220,ITF,ITF4,16,Puglia,Puglia,4029053,530397,13.16,0.32
390,2021-02-16,PUG,3379,1452,1927,2148,736,412,2,10,0,5,0,16,50,2734,645,ITF,ITF4,16,Puglia,Puglia,4029053,533776,13.25,0.08
391,2021-03-14,PUG,3262,1407,1855,944,81,84,1001,28,10,975,3,43,93,2496,766,ITF,ITF4,16,Puglia,Puglia,4029053,537038,13.33,0.08
392,2021-04-02,PUG,12234,5624,6610,866,385,277,626,133,583,7410,1398,169,387,7719,4515,ITF,ITF4,16,Puglia,Puglia,4029053,549272,13.63,0.3
393,2021-01-12,PUG,4206,1767,2439,3632,343,218,5,2,3,1,0,0,2,4206,0,ITF,ITF4,16,Puglia,Puglia,4029053,553478,13.74,0.1
394,2021-01-25,PUG,3820,1677,2143,3471,170,169,1,1,0,2,0,0,6,422,3398,ITF,ITF4,16,Puglia,Puglia,4029053,557298,13.83,0.09
395,2021-04-12,PUG,28201,13264,14937,501,233,26,157,2117,14649,4724,5456,149,189,25466,2735,ITF,ITF4,16,Puglia,Puglia,4029053,585499,14.53,0.7
396,2021-01-01,PUG,146,60,86,145,1,0,0,0,0,0,0,0,0,146,0,ITF,ITF4,16,Puglia,Puglia,4029053,585645,14.54,0.0
397,2021-03-04,PUG,15019,5857,9162,1530,588,323,6283,20,15,4778,5,1449,28,13641,1378,ITF,ITF4,16,Puglia,Puglia,4029053,600664,14.91,0.37
398,2021-02-11,PUG,3695,1401,2294,2570,391,723,2,1,0,0,0,0,8,2419,1276,ITF,ITF4,16,Puglia,Puglia,4029053,604359,15.0,0.09
399,2021-03-09,PUG,13147,5739,7408,1864,707,225,3540,18,10,5625,6,1089,63,11150,1997,ITF,ITF4,16,Puglia,Puglia,4029053,617506,15.33,0.33
400,2021-03-12,PUG,13829,6080,7749,3281,1137,432,2944,9,16,5005,9,984,12,9904,3925,ITF,ITF4,16,Puglia,Puglia,4029053,631335,15.67,0.34
401,2021-01-07,PUG,5713,2454,3259,5216,263,217,3,5,1,0,0,7,1,5713,0,ITF,ITF4,16,Puglia,Puglia,4029053,637048,15.81,0.14
402,2021-02-22,PUG,9616,4524,5092,1438,649,140,319,14,19,6809,2,215,11,9285,331,ITF,ITF4,16,Puglia,Puglia,4029053,646664,16.05,0.24
403,2021-02-08,PUG,3991,1609,2382,2964,605,389,1,1,0,1,1,26,3,1597,2394,ITF,ITF4,16,Puglia,Puglia,4029053,650655,16.15,0.1
404,2021-02-01,PUG,3961,1657,2304,3443,287,208,5,4,0,0,0,6,8,375,3586,ITF,ITF4,16,Puglia,Puglia,4029053,654616,16.25,0.1
405,2021-02-20,PUG,2966,1078,1888,2115,233,168,425,0,1,9,1,4,10,2710,256,ITF,ITF4,16,Puglia,Puglia,4029053,657582,16.32,0.07
406,2021-04-10,PUG,28405,12028,16377,554,189,118,266,550,1527,11490,13183,147,381,24267,4138,ITF,ITF4,16,Puglia,Puglia,4029053,685987,17.03,0.71
407,2021-02-05,PUG,5627,2270,3357,4565,512,526,6,0,0,0,0,14,4,1330,4297,ITF,ITF4,16,Puglia,Puglia,4029053,691614,17.17,0.14
408,2021-03-22,PUG,9324,4547,4777,604,369,12,1061,17,39,6751,43,361,67,3692,5632,ITF,ITF4,16,Puglia,Puglia,4029053,700938,17.4,0.23
409,2021-02-27,PUG,14108,4780,9328,1587,653,181,6173,14,7,5117,16,347,13,12929,1179,ITF,ITF4,16,Puglia,Puglia,4029053,715046,17.75,0.35
410,2021-04-16,PUG,33245,15699,17546,673,263,109,209,4683,14538,4165,8174,99,332,30250,2995,ITF,ITF4,16,Puglia,Puglia,4029053,748291,18.57,0.83
411,2021-01-17,PUG,1308,590,718,818,154,336,0,0,0,0,0,0,0,1239,69,ITF,ITF4,16,Puglia,Puglia,4029053,749599,18.6,0.03
412,2021-03-31,PUG,13776,6257,7519,1782,548,176,809,30,164,8497,1277,369,124,8225,5551,ITF,ITF4,16,Puglia,Puglia,4029053,763375,18.95,0.34
413,2021-02-04,PUG,5896,2356,3540,4444,792,653,6,0,0,0,0,0,1,1167,4729,ITF,ITF4,16,Puglia,Puglia,4029053,769271,19.09,0.15
414,2021-02-06,PUG,4511,1917,2594,3494,484,527,3,0,1,0,0,0,2,1590,2921,ITF,ITF4,16,Puglia,Puglia,4029053,773782,19.21,0.11
415,2021-02-18,PUG,4367,1842,2525,2701,957,680,2,1,1,5,1,11,8,3764,603,ITF,ITF4,16,Puglia,Puglia,4029053,778149,19.31,0.11
416,2021-04-03,PUG,9964,4279,5685,919,219,133,540,91,309,5378,2230,18,127,6420,3544,ITF,ITF4,16,Puglia,Puglia,4029053,788113,19.56,0.25
417,2021-03-28,PUG,3500,1642,1858,634,151,47,119,106,89,2044,177,3,130,1177,2323,ITF,ITF4,16,Puglia,Puglia,4029053,791613,19.65,0.09
418,2021-04-06,PUG,13041,5776,7265,698,320,151,211,94,469,8336,2451,129,182,6468,6573,ITF,ITF4,16,Puglia,Puglia,4029053,804654,19.97,0.32
419,2021-04-15,PUG,30882,14387,16495,544,217,42,119,4066,13024,5058,7399,96,317,27417,3465,ITF,ITF4,16,Puglia,Puglia,4029053,835536,20.74,0.77
420,2021-03-10,PUG,14367,6228,8139,2599,1070,355,3077,6,33,6546,7,653,21,11252,3115,ITF,ITF4,16,Puglia,Puglia,4029053,849903,21.09,0.36
421,2021-04-17,PUG,36201,17208,18993,497,145,80,165,4454,12535,4395,13380,79,471,33027,3174,ITF,ITF4,16,Puglia,Puglia,4029053,886104,21.99,0.9
422,2021-02-19,PUG,4728,2009,2719,3063,1189,389,7,2,1,2,0,49,26,4338,390,ITF,ITF4,16,Puglia,Puglia,4029053,890832,22.11,0.12
423,2021-02-14,PUG,784,348,436,681,32,70,1,0,0,0,0,0,0,662,122,ITF,ITF4,16,Puglia,Puglia,4029053,891616,22.13,0.02
424,2021-04-09,PUG,20761,8889,11872,1095,522,160,414,432,1124,9824,6737,143,310,16136,4625,ITF,ITF4,16,Puglia,Puglia,4029053,912377,22.64,0.52
425,2021-03-16,PUG,9769,4643,5126,2168,548,76,38,27,23,6569,129,143,48,3436,6333,ITF,ITF4,16,Puglia,Puglia,4029053,922146,22.89,0.24
426,2021-01-03,PUG,2007,943,1064,1818,38,145,1,1,1,0,3,0,0,2007,0,ITF,ITF4,16,Puglia,Puglia,4029053,924153,22.94,0.05
427,2021-02-25,PUG,11885,5035,6850,1746,763,419,2380,19,15,5783,0,726,34,10729,1156,ITF,ITF4,16,Puglia,Puglia,4029053,936038,23.23,0.29
428,2021-04-13,PUG,27434,13026,14408,661,245,47,118,4387,10582,5171,5784,122,317,24111,3323,ITF,ITF4,16,Puglia,Puglia,4029053,963472,23.91,0.68
429,2021-01-26,PUG,5359,2397,2962,4850,270,232,0,2,1,1,0,0,3,573,4786,ITF,ITF4,16,Puglia,Puglia,4029053,968831,24.05,0.13
430,2021-01-05,PUG,5098,2245,2853,4747,177,98,4,18,9,5,0,0,40,5098,0,ITF,ITF4,16,Puglia,Puglia,4029053,973929,24.17,0.13
431,2021-01-10,PUG,2348,1060,1288,2037,106,202,0,2,0,0,1,0,0,2348,0,ITF,ITF4,16,Puglia,Puglia,4029053,976277,24.23,0.06
432,2021-03-30,PUG,11689,5445,6244,1321,489,259,959,44,169,7068,953,368,59,5828,5861,ITF,ITF4,16,Puglia,Puglia,4029053,987966,24.52,0.29
433,2020-12-30,PUG,1,0,1,1,0,0,0,0,0,0,0,0,0,1,0,ITF,ITF4,16,Puglia,Puglia,4029053,987967,24.52,0.0
434,2021-03-25,PUG,10710,5188,5522,1262,655,62,659,22,48,7172,69,674,87,4558,6152,ITF,ITF4,16,Puglia,Puglia,4029053,998677,24.79,0.27
435,2021-02-07,PUG,1578,669,909,1039,227,309,1,0,2,0,0,0,0,253,1325,ITF,ITF4,16,Puglia,Puglia,4029053,1000255,24.83,0.04
436,2021-02-28,LOM,7884,3255,4629,1106,761,76,31,594,199,4343,0,88,686,7668,216,ITC,ITC4,3,Lombardia,Lombardia,10060574,7884,0.08,0.08
437,2021-03-19,LOM,32326,12873,19453,2730,1925,1415,3009,68,115,22414,350,158,142,19163,13163,ITC,ITC4,3,Lombardia,Lombardia,10060574,40210,0.4,0.32
438,2021-02-15,LOM,8912,3119,5793,6033,1677,1071,9,12,9,29,4,31,37,8491,421,ITC,ITC4,3,Lombardia,Lombardia,10060574,49122,0.49,0.09
439,2021-02-18,LOM,14036,4925,9111,6162,1880,1593,28,13,18,3438,3,859,42,13009,1027,ITC,ITC4,3,Lombardia,Lombardia,10060574,63158,0.63,0.14
440,2021-01-08,LOM,12664,3910,8754,9964,2236,376,0,17,9,6,1,0,55,12664,0,ITC,ITC4,3,Lombardia,Lombardia,10060574,75822,0.75,0.13
441,2021-04-06,LOM,42540,17370,25170,2149,1901,675,4520,279,545,27680,4353,128,310,24760,17780,ITC,ITC4,3,Lombardia,Lombardia,10060574,118362,1.18,0.42
442,2020-12-30,LOM,114,42,72,106,7,0,0,0,0,0,0,0,1,114,0,ITC,ITC4,3,Lombardia,Lombardia,10060574,118476,1.18,0.0
443,2021-03-28,LOM,20214,7693,12521,2014,1290,115,3873,196,412,11167,1008,34,105,14146,6068,ITC,ITC4,3,Lombardia,Lombardia,10060574,138690,1.38,0.2
444,2020-12-31,LOM,713,300,413,657,56,0,0,0,0,0,0,0,0,713,0,ITC,ITC4,3,Lombardia,Lombardia,10060574,139403,1.39,0.01
445,2021-02-09,LOM,12241,3328,8913,5736,2235,4125,4,16,5,78,4,2,36,4109,8132,ITC,ITC4,3,Lombardia,Lombardia,10060574,151644,1.51,0.12
446,2021-02-21,LOM,5022,1854,3168,1761,910,32,3,2,14,2234,2,42,22,5002,20,ITC,ITC4,3,Lombardia,Lombardia,10060574,156666,1.56,0.05
447,2021-04-02,LOM,40563,16571,23992,2527,1818,1150,4638,536,2164,24335,2919,130,346,26304,14259,ITC,ITC4,3,Lombardia,Lombardia,10060574,197229,1.96,0.4
448,2021-01-12,LOM,19842,6612,13230,13434,4534,1627,0,20,13,102,2,1,109,19842,0,ITC,ITC4,3,Lombardia,Lombardia,10060574,217071,2.16,0.2
449,2021-01-01,LOM,24,7,17,24,0,0,0,0,0,0,0,0,0,24,0,ITC,ITC4,3,Lombardia,Lombardia,10060574,217095,2.16,0.0
450,2021-03-16,LOM,25437,10106,15331,3313,1456,1433,76,311,249,18138,28,17,416,16401,9036,ITC,ITC4,3,Lombardia,Lombardia,10060574,242532,2.41,0.25
451,2021-01-21,LOM,5333,1567,3766,3017,1210,1025,0,8,4,7,1,0,61,4644,689,ITC,ITC4,3,Lombardia,Lombardia,10060574,247865,2.46,0.05
452,2021-03-15,LOM,31371,11241,20130,4682,2869,880,8314,273,377,12936,7,637,396,22895,8476,ITC,ITC4,3,Lombardia,Lombardia,10060574,279236,2.78,0.31
453,2021-02-19,LOM,14092,5364,8728,5561,1750,1148,16,22,42,4541,2,929,81,13410,682,ITC,ITC4,3,Lombardia,Lombardia,10060574,293328,2.92,0.14
454,2021-01-22,LOM,3095,863,2232,1580,619,873,0,2,3,13,0,0,5,3025,70,ITC,ITC4,3,Lombardia,Lombardia,10060574,296423,2.95,0.03
455,2021-03-12,LOM,35179,12932,22247,5109,3216,1492,7387,184,278,16061,10,1114,328,24981,10198,ITC,ITC4,3,Lombardia,Lombardia,10060574,331602,3.3,0.35
456,2021-02-08,LOM,9886,2875,7011,5245,2206,2341,0,5,2,53,4,0,30,2137,7749,ITC,ITC4,3,Lombardia,Lombardia,10060574,341488,3.39,0.1
457,2021-03-10,LOM,33123,12693,20430,6884,3854,2077,5476,429,302,12046,9,1608,438,25283,7840,ITC,ITC4,3,Lombardia,Lombardia,10060574,374611,3.72,0.33
458,2021-03-08,LOM,29627,11131,18496,6568,2980,1160,4557,421,210,11764,10,1612,345,22559,7068,ITC,ITC4,3,Lombardia,Lombardia,10060574,404238,4.02,0.29
459,2021-04-17,LOM,45830,20192,25638,511,199,226,320,397,28419,10371,5139,124,124,35864,9966,ITC,ITC4,3,Lombardia,Lombardia,10060574,450068,4.47,0.46
460,2021-04-18,LOM,35832,16008,19824,262,115,72,141,218,25830,5453,3544,99,98,30648,5184,ITC,ITC4,3,Lombardia,Lombardia,10060574,485900,4.83,0.36
461,2021-03-17,LOM,26105,10439,15666,2531,1413,1943,43,72,108,19526,174,44,251,15220,10885,ITC,ITC4,3,Lombardia,Lombardia,10060574,512005,5.09,0.26
462,2021-02-04,LOM,27295,7997,19298,15674,5805,5530,0,11,1,197,4,7,66,1962,25333,ITC,ITC4,3,Lombardia,Lombardia,10060574,539300,5.36,0.27
463,2021-03-31,LOM,41531,16822,24709,2561,1881,1446,6195,402,1798,23885,2786,150,427,26530,15001,ITC,ITC4,3,Lombardia,Lombardia,10060574,580831,5.77,0.41
464,2021-02-17,LOM,11952,3743,8209,7632,2229,1946,10,7,8,40,6,38,36,10563,1389,ITC,ITC4,3,Lombardia,Lombardia,10060574,592783,5.89,0.12
465,2020-12-27,LOM,717,413,304,615,46,14,0,13,7,1,1,0,20,717,0,ITC,ITC4,3,Lombardia,Lombardia,10060574,593500,5.9,0.01
466,2021-04-19,LOM,39190,17986,21204,734,306,172,283,2024,22560,7151,5591,111,258,32344,6846,ITC,ITC4,3,Lombardia,Lombardia,10060574,632690,6.29,0.39
467,2021-04-05,LOM,27040,11559,15481,537,558,70,692,196,324,23441,1104,28,90,19188,7852,ITC,ITC4,3,Lombardia,Lombardia,10060574,659730,6.56,0.27
468,2021-02-01,LOM,16040,5313,10727,11670,3370,902,1,3,3,45,3,1,42,324,15716,ITC,ITC4,3,Lombardia,Lombardia,10060574,675770,6.72,0.16
469,2021-01-31,LOM,9745,3763,5982,7576,2043,87,0,2,2,7,3,2,23,33,9712,ITC,ITC4,3,Lombardia,Lombardia,10060574,685515,6.81,0.1
470,2021-01-28,LOM,12163,3686,8477,9178,1855,971,1,11,5,29,2,1,110,776,11387,ITC,ITC4,3,Lombardia,Lombardia,10060574,697678,6.93,0.12
471,2021-01-03,LOM,853,316,537,744,89,4,0,0,0,1,1,0,14,853,0,ITC,ITC4,3,Lombardia,Lombardia,10060574,698531,6.94,0.01
472,2021-01-04,LOM,6075,2097,3978,4993,736,173,0,22,4,11,0,0,136,6075,0,ITC,ITC4,3,Lombardia,Lombardia,10060574,704606,7.0,0.06
473,2021-01-19,LOM,8098,2348,5750,4045,1772,2166,0,9,5,67,4,1,29,7622,476,ITC,ITC4,3,Lombardia,Lombardia,10060574,712704,7.08,0.08
474,2021-02-25,LOM,15174,6293,8881,2969,1339,1294,10,39,86,8099,4,1251,83,13628,1546,ITC,ITC4,3,Lombardia,Lombardia,10060574,727878,7.23,0.15
475,2021-02-03,LOM,25468,7874,17594,15586,5624,4018,1,17,9,144,6,8,55,1120,24348,ITC,ITC4,3,Lombardia,Lombardia,10060574,753346,7.49,0.25
476,2021-02-14,LOM,3578,1546,2032,2750,623,42,10,5,1,3,2,0,142,2944,634,ITC,ITC4,3,Lombardia,Lombardia,10060574,756924,7.52,0.04
477,2021-02-27,LOM,13939,5864,8075,2090,1232,568,48,208,309,8310,7,1124,43,13294,645,ITC,ITC4,3,Lombardia,Lombardia,10060574,770863,7.66,0.14
478,2021-03-18,LOM,27375,10945,16430,2194,1206,1526,100,65,161,21443,502,50,128,16177,11198,ITC,ITC4,3,Lombardia,Lombardia,10060574,798238,7.93,0.27
479,2021-02-07,LOM,7204,2796,4408,5542,1315,293,5,5,2,18,0,3,21,339,6865,ITC,ITC4,3,Lombardia,Lombardia,10060574,805442,8.01,0.07
480,2021-04-13,LOM,46969,20985,25984,933,641,696,952,515,24963,13126,4798,128,217,33039,13930,ITC,ITC4,3,Lombardia,Lombardia,10060574,852411,8.47,0.47
481,2020-12-28,LOM,107,47,60,105,2,0,0,0,0,0,0,0,0,107,0,ITC,ITC4,3,Lombardia,Lombardia,10060574,852518,8.47,0.0
482,2021-03-07,LOM,11910,5299,6611,3012,2099,82,706,261,329,4538,2,672,209,9350,2560,ITC,ITC4,3,Lombardia,Lombardia,10060574,864428,8.59,0.12
483,2021-03-25,LOM,42242,15758,26484,3408,2194,1387,10844,227,764,21102,1662,318,336,29854,12388,ITC,ITC4,3,Lombardia,Lombardia,10060574,906670,9.01,0.42
484,2021-03-30,LOM,39141,15341,23800,2647,1904,1151,6902,254,406,22260,2854,223,540,24442,14699,ITC,ITC4,3,Lombardia,Lombardia,10060574,945811,9.4,0.39
485,2021-01-26,LOM,8335,2709,5626,6650,1336,223,0,22,4,26,0,0,74,334,8001,ITC,ITC4,3,Lombardia,Lombardia,10060574,954146,9.48,0.08
486,2021-03-04,LOM,29287,12122,17165,6998,2472,2140,376,1622,1847,11136,6,2054,636,20233,9054,ITC,ITC4,3,Lombardia,Lombardia,10060574,983433,9.78,0.29
487,2021-01-17,LOM,8289,3327,4962,5554,748,244,0,169,55,72,6,5,1436,8088,201,ITC,ITC4,3,Lombardia,Lombardia,10060574,991722,9.86,0.08
488,2021-02-05,LOM,25326,7374,17952,14335,6139,4477,0,19,11,260,2,2,81,2379,22947,ITC,ITC4,3,Lombardia,Lombardia,10060574,1017048,10.11,0.25
489,2021-03-24,LOM,43023,15514,27509,2968,2444,1498,12493,413,748,20221,1250,563,425,31329,11694,ITC,ITC4,3,Lombardia,Lombardia,10060574,1060071,10.54,0.43
490,2021-04-10,LOM,50248,20912,29336,851,840,312,1465,494,2790,37500,5687,61,248,38535,11713,ITC,ITC4,3,Lombardia,Lombardia,10060574,1110319,11.04,0.5
491,2021-03-22,LOM,40023,14179,25844,2457,2338,804,12141,255,193,20450,536,533,316,29673,10350,ITC,ITC4,3,Lombardia,Lombardia,10060574,1150342,11.43,0.4
492,2021-03-23,LOM,42325,15339,26986,2236,2322,1284,12509,429,584,21282,765,405,509,29563,12762,ITC,ITC4,3,Lombardia,Lombardia,10060574,1192667,11.85,0.42
493,2021-01-24,LOM,1201,459,742,832,136,36,0,8,2,1,1,0,185,537,664,ITC,ITC4,3,Lombardia,Lombardia,10060574,1193868,11.87,0.01
494,2021-01-30,LOM,12315,4567,7748,9906,2116,161,1,18,2,8,1,1,101,195,12120,ITC,ITC4,3,Lombardia,Lombardia,10060574,1206183,11.99,0.12
495,2021-04-01,LOM,42314,16974,25340,2709,2074,1259,5738,816,1603,24848,2724,135,408,26537,15777,ITC,ITC4,3,Lombardia,Lombardia,10060574,1248497,12.41,0.42
496,2021-01-05,LOM,7815,2563,5252,6270,1206,173,0,29,4,8,0,0,125,7815,0,ITC,ITC4,3,Lombardia,Lombardia,10060574,1256312,12.49,0.08
497,2021-02-22,LOM,11705,4723,6982,4175,1449,961,28,13,13,4034,3,966,63,11395,310,ITC,ITC4,3,Lombardia,Lombardia,10060574,1268017,12.6,0.12
498,2021-01-18,LOM,9128,2957,6171,5192,1960,1831,0,16,13,54,5,2,55,8146,982,ITC,ITC4,3,Lombardia,Lombardia,10060574,1277145,12.69,0.09
499,2021-04-03,LOM,35839,14705,21134,960,960,86,2236,1000,1537,27205,1633,80,142,25822,10017,ITC,ITC4,3,Lombardia,Lombardia,10060574,1312984,13.05,0.36
500,2021-04-15,LOM,48011,21302,26709,1064,612,1008,653,264,25655,12166,6332,96,161,34400,13611,ITC,ITC4,3,Lombardia,Lombardia,10060574,1360995,13.53,0.48
501,2021-01-16,LOM,15357,5706,9651,8615,1384,1505,0,556,211,227,5,3,2851,15357,0,ITC,ITC4,3,Lombardia,Lombardia,10060574,1376352,13.68,0.15
502,2021-03-06,LOM,21308,9081,12227,4764,2177,451,1357,1898,1306,7523,7,1147,678,16791,4517,ITC,ITC4,3,Lombardia,Lombardia,10060574,1397660,13.89,0.21
503,2021-03-27,LOM,32126,12244,19882,1973,2413,323,6663,404,581,18178,1170,71,350,23531,8595,ITC,ITC4,3,Lombardia,Lombardia,10060574,1429786,14.21,0.32
504,2021-01-06,LOM,7057,2489,4568,5846,1106,38,2,24,1,0,0,0,40,7057,0,ITC,ITC4,3,Lombardia,Lombardia,10060574,1436843,14.28,0.07
505,2021-03-01,LOM,18766,8217,10549,2717,1181,927,29,554,321,10841,3,1656,537,17062,1704,ITC,ITC4,3,Lombardia,Lombardia,10060574,1455609,14.47,0.19
506,2021-03-20,LOM,32472,12133,20339,1984,2342,524,7856,150,139,18452,539,322,164,22632,9840,ITC,ITC4,3,Lombardia,Lombardia,10060574,1488081,14.79,0.32
507,2021-04-09,LOM,51061,21817,29244,2223,1899,1229,3021,256,2276,33415,6240,97,405,35290,15771,ITC,ITC4,3,Lombardia,Lombardia,10060574,1539142,15.3,0.51
508,2021-01-29,LOM,13438,4114,9324,10487,2325,573,0,5,3,9,1,0,35,654,12784,ITC,ITC4,3,Lombardia,Lombardia,10060574,1552580,15.43,0.13
509,2021-02-24,LOM,14653,5919,8734,3585,1498,1786,24,34,44,6321,0,1203,158,13730,923,ITC,ITC4,3,Lombardia,Lombardia,10060574,1567233,15.58,0.15
510,2021-02-16,LOM,9534,3084,6450,5847,2209,1393,19,13,4,8,7,8,26,9083,451,ITC,ITC4,3,Lombardia,Lombardia,10060574,1576767,15.67,0.09
511,2021-01-09,LOM,12404,4570,7834,9524,2119,196,0,60,12,6,0,1,486,12404,0,ITC,ITC4,3,Lombardia,Lombardia,10060574,1589171,15.8,0.12
512,2021-01-07,LOM,11712,3622,8090,8962,1794,786,1,14,8,34,2,1,110,11712,0,ITC,ITC4,3,Lombardia,Lombardia,10060574,1600883,15.91,0.12
513,2021-03-29,LOM,39828,15420,24408,2975,2111,434,8601,221,470,21689,2687,209,431,25105,14723,ITC,ITC4,3,Lombardia,Lombardia,10060574,1640711,16.31,0.4
514,2021-02-20,LOM,9427,3894,5533,4295,1020,225,4,24,37,2919,2,864,37,9131,296,ITC,ITC4,3,Lombardia,Lombardia,10060574,1650138,16.4,0.09
515,2021-04-11,LOM,31382,13610,17772,965,536,435,1204,223,697,22751,3699,794,78,24036,7346,ITC,ITC4,3,Lombardia,Lombardia,10060574,1681520,16.71,0.31
516,2021-03-21,LOM,23538,8539,14999,1082,1631,420,9127,114,207,9732,198,755,272,18283,5255,ITC,ITC4,3,Lombardia,Lombardia,10060574,1705058,16.95,0.23
517,2021-04-04,LOM,7561,3214,4347,204,263,68,205,198,347,5851,336,9,80,3666,3895,ITC,ITC4,3,Lombardia,Lombardia,10060574,1712619,17.02,0.08
518,2020-12-29,LOM,104,44,60,103,1,0,0,0,0,0,0,0,0,104,0,ITC,ITC4,3,Lombardia,Lombardia,10060574,1712723,17.02,0.0
519,2021-03-05,LOM,28925,11926,16999,7226,3067,1548,423,1293,2142,11060,14,1980,172,20530,8395,ITC,ITC4,3,Lombardia,Lombardia,10060574,1741648,17.31,0.29
520,2021-02-26,LOM,18338,7544,10794,3319,1716,1183,24,66,40,10575,7,1339,69,16490,1848,ITC,ITC4,3,Lombardia,Lombardia,10060574,1759986,17.49,0.18
521,2021-03-26,LOM,40673,15424,25249,2650,2195,795,8658,200,510,22589,2389,256,431,27959,12714,ITC,ITC4,3,Lombardia,Lombardia,10060574,1800659,17.9,0.4
522,2021-02-23,LOM,11721,4780,6941,3944,1403,851,3,20,31,4312,0,991,166,11412,309,ITC,ITC4,3,Lombardia,Lombardia,10060574,1812380,18.01,0.12
523,2021-01-13,LOM,26211,8007,18204,15795,5794,4193,1,28,14,197,4,3,182,26211,0,ITC,ITC4,3,Lombardia,Lombardia,10060574,1838591,18.28,0.26
524,2021-03-14,LOM,14872,5348,9524,1520,1745,80,5450,99,117,5272,2,413,174,11583,3289,ITC,ITC4,3,Lombardia,Lombardia,10060574,1853463,18.42,0.15
525,2021-02-10,LOM,14386,4501,9885,8533,2362,3335,6,25,17,79,1,3,25,7569,6817,ITC,ITC4,3,Lombardia,Lombardia,10060574,1867849,18.57,0.14
526,2021-04-14,LOM,46046,20611,25435,908,733,629,783,281,24905,11918,5606,86,197,33338,12708,ITC,ITC4,3,Lombardia,Lombardia,10060574,1913895,19.02,0.46
527,2021-01-10,LOM,10518,3957,6561,8175,2197,85,1,4,1,12,5,2,36,10518,0,ITC,ITC4,3,Lombardia,Lombardia,10060574,1924413,19.13,0.1
528,2021-03-03,LOM,26897,11486,15411,6403,1783,1797,471,1269,1900,10198,11,2030,1035,19626,7271,ITC,ITC4,3,Lombardia,Lombardia,10060574,1951310,19.4,0.27
529,2021-01-25,LOM,7023,2371,4652,5631,941,218,0,26,3,15,0,0,189,488,6535,ITC,ITC4,3,Lombardia,Lombardia,10060574,1958333,19.47,0.07
530,2021-02-12,LOM,13817,4326,9491,8098,2719,2851,3,7,8,102,3,5,21,9024,4793,ITC,ITC4,3,Lombardia,Lombardia,10060574,1972150,19.6,0.14
531,2021-01-27,LOM,8042,2676,5366,6202,1338,434,2,22,3,1,0,0,40,820,7222,ITC,ITC4,3,Lombardia,Lombardia,10060574,1980192,19.68,0.08
532,2021-03-09,LOM,33221,12841,20380,6076,4092,2385,5482,434,352,12530,10,1464,396,25788,7433,ITC,ITC4,3,Lombardia,Lombardia,10060574,2013413,20.01,0.33
533,2021-02-06,LOM,15240,5525,9715,9845,3034,1896,3,42,13,75,2,1,329,1083,14157,ITC,ITC4,3,Lombardia,Lombardia,10060574,2028653,20.16,0.15
534,2021-02-13,LOM,6410,2440,3970,4174,1466,709,4,7,6,17,3,4,20,4937,1473,ITC,ITC4,3,Lombardia,Lombardia,10060574,2035063,20.23,0.06
535,2021-04-16,LOM,51554,23194,28360,1671,688,853,383,360,28321,12456,6511,113,198,37965,13589,ITC,ITC4,3,Lombardia,Lombardia,10060574,2086617,20.74,0.51
536,2021-04-12,LOM,46831,20437,26394,1127,898,498,1660,310,24459,13648,3957,76,198,32589,14242,ITC,ITC4,3,Lombardia,Lombardia,10060574,2133448,21.21,0.47
537,2021-01-02,LOM,199,72,127,178,16,0,0,1,0,0,0,0,4,199,0,ITC,ITC4,3,Lombardia,Lombardia,10060574,2133647,21.21,0.0
538,2021-02-02,LOM,19827,6577,13250,13492,4501,1680,1,6,4,76,0,7,60,489,19338,ITC,ITC4,3,Lombardia,Lombardia,10060574,2153474,21.41,0.2
539,2021-01-20,LOM,5578,1364,4214,2743,1176,1557,0,14,6,61,0,0,21,5463,115,ITC,ITC4,3,Lombardia,Lombardia,10060574,2159052,21.46,0.06
540,2021-01-15,LOM,25071,7407,17664,13759,5893,4736,6,54,24,316,3,2,278,25071,0,ITC,ITC4,3,Lombardia,Lombardia,10060574,2184123,21.71,0.25
541,2021-03-11,LOM,36088,13426,22662,5874,3530,2189,6669,225,296,15544,7,1295,459,26217,9871,ITC,ITC4,3,Lombardia,Lombardia,10060574,2220211,22.07,0.36
542,2021-01-11,LOM,16024,5324,10700,11817,3362,699,2,9,5,45,1,1,83,16024,0,ITC,ITC4,3,Lombardia,Lombardia,10060574,2236235,22.23,0.16
543,2021-03-02,LOM,22808,9689,13119,3192,1451,2199,130,1113,378,11263,8,1843,1231,19778,3030,ITC,ITC4,3,Lombardia,Lombardia,10060574,2259043,22.45,0.23
544,2021-04-07,LOM,49968,20684,29284,1717,1424,1165,2456,275,1903,36440,4146,68,374,34289,15679,ITC,ITC4,3,Lombardia,Lombardia,10060574,2309011,22.95,0.5
545,2021-01-23,LOM,1114,357,757,644,259,138,0,8,6,1,0,0,58,916,198,ITC,ITC4,3,Lombardia,Lombardia,10060574,2310125,22.96,0.01
546,2021-04-08,LOM,51261,21394,29867,2219,1350,902,1548,270,2227,36840,5358,69,478,34913,16348,ITC,ITC4,3,Lombardia,Lombardia,10060574,2361386,23.47,0.51
547,2021-02-11,LOM,16954,4993,11961,9702,3316,3865,6,3,2,33,1,4,22,9613,7341,ITC,ITC4,3,Lombardia,Lombardia,10060574,2378340,23.64,0.17
548,2021-01-14,LOM,26703,7765,18938,15189,5570,5451,2,35,14,249,3,1,189,26703,0,ITC,ITC4,3,Lombardia,Lombardia,10060574,2405043,23.91,0.27
549,2021-03-13,LOM,27086,9739,17347,3750,2785,264,8139,222,675,10330,7,639,275,21024,6062,ITC,ITC4,3,Lombardia,Lombardia,10060574,2432129,24.17,0.27
550,2021-01-04,TOS,5065,1894,3171,4100,29,933,0,0,0,0,0,0,3,5065,0,ITI,ITI1,9,Toscana,Toscana,3729641,5065,0.14,0.14
551,2021-03-11,TOS,15454,5980,9474,2440,907,270,12,0,7,10292,1292,217,17,12136,3318,ITI,ITI1,9,Toscana,Toscana,3729641,20519,0.55,0.41
552,2021-03-03,TOS,18125,6460,11665,3324,1083,135,3446,3,0,9169,1,953,11,14522,3603,ITI,ITI1,9,Toscana,Toscana,3729641,38644,1.04,0.49
553,2021-02-20,TOS,4641,1790,2851,3350,1038,203,18,0,0,17,0,15,0,4128,513,ITI,ITI1,9,Toscana,Toscana,3729641,43285,1.16,0.12
554,2021-01-19,TOS,1104,531,573,392,220,491,0,0,0,0,0,0,1,1104,0,ITI,ITI1,9,Toscana,Toscana,3729641,44389,1.19,0.03
555,2021-03-18,TOS,9932,3966,5966,437,562,280,3,2,3,7765,867,7,6,5982,3950,ITI,ITI1,9,Toscana,Toscana,3729641,54321,1.46,0.27
556,2021-02-13,TOS,7784,2360,5424,3667,574,163,1,0,2,0,0,186,3191,7557,227,ITI,ITI1,9,Toscana,Toscana,3729641,62105,1.67,0.21
557,2021-04-05,TOS,15279,6824,8455,27,52,0,35,12,13541,257,1328,4,23,14541,738,ITI,ITI1,9,Toscana,Toscana,3729641,77384,2.07,0.41
558,2021-02-01,TOS,5508,1958,3550,4485,403,616,0,0,0,0,0,0,4,520,4988,ITI,ITI1,9,Toscana,Toscana,3729641,82892,2.22,0.15
559,2021-02-25,TOS,10616,4302,6314,1078,1634,259,3199,0,1,3217,4,1220,4,9622,994,ITI,ITI1,9,Toscana,Toscana,3729641,93508,2.51,0.28
560,2021-01-03,TOS,3336,1052,2284,2565,9,762,0,0,0,0,0,0,0,3336,0,ITI,ITI1,9,Toscana,Toscana,3729641,96844,2.6,0.09
561,2021-02-06,TOS,4527,1550,2977,3725,574,227,0,0,0,0,0,0,1,1294,3233,ITI,ITI1,9,Toscana,Toscana,3729641,101371,2.72,0.12
562,2021-01-22,TOS,2865,1064,1801,2026,81,758,0,0,0,0,0,0,0,527,2338,ITI,ITI1,9,Toscana,Toscana,3729641,104236,2.79,0.08
563,2021-02-12,TOS,7606,2683,4923,3742,380,188,0,0,1,3,0,402,2890,7393,213,ITI,ITI1,9,Toscana,Toscana,3729641,111842,3.0,0.2
564,2021-04-17,TOS,19850,8890,10960,502,388,68,1,21,7385,5572,5884,8,21,17876,1974,ITI,ITI1,9,Toscana,Toscana,3729641,131692,3.53,0.53
565,2021-03-08,TOS,6346,2610,3736,4063,747,191,8,0,0,66,965,304,2,1527,4819,ITI,ITI1,9,Toscana,Toscana,3729641,138038,3.7,0.17
566,2021-04-13,TOS,8341,3446,4895,250,469,266,5,35,52,5413,1811,30,10,5928,2413,ITI,ITI1,9,Toscana,Toscana,3729641,146379,3.92,0.22
567,2021-02-26,TOS,10063,3824,6239,1557,1653,298,3562,0,0,1804,2,1187,0,8857,1206,ITI,ITI1,9,Toscana,Toscana,3729641,156442,4.19,0.27
568,2021-02-03,TOS,4221,1452,2769,3475,239,505,0,0,0,1,0,0,1,241,3980,ITI,ITI1,9,Toscana,Toscana,3729641,160663,4.31,0.11
569,2021-04-16,TOS,27996,12493,15503,519,519,73,2,59,6586,14457,5710,22,49,21444,6552,ITI,ITI1,9,Toscana,Toscana,3729641,188659,5.06,0.75
570,2021-01-23,TOS,3949,1354,2595,2936,170,841,0,0,0,0,0,0,2,640,3309,ITI,ITI1,9,Toscana,Toscana,3729641,192608,5.16,0.11
571,2021-03-22,TOS,4836,2398,2438,221,366,380,314,27,2418,474,466,135,35,4393,443,ITI,ITI1,9,Toscana,Toscana,3729641,197444,5.29,0.13
572,2021-04-08,TOS,29217,12336,16881,268,264,186,5,61,1785,23344,3226,17,61,22937,6280,ITI,ITI1,9,Toscana,Toscana,3729641,226661,6.08,0.78
573,2021-03-30,TOS,16712,7401,9311,211,144,250,113,13,4544,8493,2726,200,18,13151,3561,ITI,ITI1,9,Toscana,Toscana,3729641,243373,6.53,0.45
574,2021-01-24,TOS,3349,1073,2276,2602,35,709,0,0,0,1,0,0,2,201,3148,ITI,ITI1,9,Toscana,Toscana,3729641,246722,6.62,0.09
575,2021-03-25,TOS,23451,10057,13394,225,313,406,710,46,2778,16005,2647,247,74,15162,8289,ITI,ITI1,9,Toscana,Toscana,3729641,270173,7.24,0.63
576,2021-03-02,TOS,10583,3787,6796,3170,986,154,3512,0,0,1847,0,910,4,7139,3444,ITI,ITI1,9,Toscana,Toscana,3729641,280756,7.53,0.28
577,2021-01-14,TOS,3254,1179,2075,2459,475,320,0,0,0,0,0,0,0,3254,0,ITI,ITI1,9,Toscana,Toscana,3729641,284010,7.61,0.09
578,2021-04-19,TOS,6615,3292,3323,463,188,44,7,21,263,375,5249,2,3,5849,766,ITI,ITI1,9,Toscana,Toscana,3729641,290625,7.79,0.18
579,2021-02-15,TOS,8768,3374,5394,4536,922,216,1138,0,0,56,0,801,1099,7943,825,ITI,ITI1,9,Toscana,Toscana,3729641,299393,8.03,0.24
580,2021-03-19,TOS,10084,4436,5648,641,442,303,35,22,2644,5231,712,13,41,7255,2829,ITI,ITI1,9,Toscana,Toscana,3729641,309477,8.3,0.27
581,2021-03-04,TOS,17512,6672,10840,2816,953,274,3694,2,8,8220,595,945,5,14436,3076,ITI,ITI1,9,Toscana,Toscana,3729641,326989,8.77,0.47
582,2021-01-17,TOS,2535,871,1664,2002,293,240,0,0,0,0,0,0,0,2022,513,ITI,ITI1,9,Toscana,Toscana,3729641,329524,8.84,0.07
583,2021-04-14,TOS,19648,8106,11542,397,405,92,1,27,126,16313,2245,10,32,14670,4978,ITI,ITI1,9,Toscana,Toscana,3729641,349172,9.36,0.53
584,2021-03-28,TOS,6202,2800,3402,37,26,145,89,22,2401,899,2543,22,18,5948,254,ITI,ITI1,9,Toscana,Toscana,3729641,355374,9.53,0.17
585,2021-04-02,TOS,31585,13356,18229,296,62,370,6,13,8604,19563,2525,112,34,23692,7893,ITI,ITI1,9,Toscana,Toscana,3729641,386959,10.38,0.85
586,2021-04-03,TOS,14920,6599,8321,101,42,99,13,16,6587,4854,3180,10,18,13795,1125,ITI,ITI1,9,Toscana,Toscana,3729641,401879,10.78,0.4
587,2021-02-18,TOS,8817,3285,5532,2924,1447,230,3142,0,0,214,0,860,0,7923,894,ITI,ITI1,9,Toscana,Toscana,3729641,410696,11.01,0.24
588,2021-03-15,TOS,8312,3309,5003,3214,1609,404,2281,0,2,36,325,438,3,3870,4442,ITI,ITI1,9,Toscana,Toscana,3729641,419008,11.23,0.22
589,2021-01-15,TOS,3878,1347,2531,2758,674,444,0,0,0,0,0,0,2,3878,0,ITI,ITI1,9,Toscana,Toscana,3729641,422886,11.34,0.1
590,2021-01-21,TOS,1589,686,903,579,220,790,0,0,0,0,0,0,0,867,722,ITI,ITI1,9,Toscana,Toscana,3729641,424475,11.38,0.04
591,2021-03-27,TOS,8793,4100,4693,113,70,225,198,17,3197,2067,2837,49,20,8578,215,ITI,ITI1,9,Toscana,Toscana,3729641,433268,11.62,0.24
592,2021-03-20,TOS,6489,2882,3607,914,563,165,34,4,3576,773,423,27,10,5354,1135,ITI,ITI1,9,Toscana,Toscana,3729641,439757,11.79,0.17
593,2021-02-17,TOS,8173,3168,5005,3464,1122,249,2485,0,0,218,0,635,0,7422,751,ITI,ITI1,9,Toscana,Toscana,3729641,447930,12.01,0.22
594,2021-04-09,TOS,24127,10383,13744,234,117,208,3,40,90,19962,3424,17,32,20795,3332,ITI,ITI1,9,Toscana,Toscana,3729641,472057,12.66,0.65
595,2021-02-23,TOS,7720,3324,4396,1490,1512,204,2831,0,0,510,1,1170,2,7559,161,ITI,ITI1,9,Toscana,Toscana,3729641,479777,12.86,0.21
596,2021-02-24,TOS,10366,4464,5902,81,1513,301,2947,0,0,4137,0,1382,5,10169,197,ITI,ITI1,9,Toscana,Toscana,3729641,490143,13.14,0.28
597,2021-03-07,TOS,5648,2356,3292,3103,642,123,774,0,0,15,418,573,0,2106,3542,ITI,ITI1,9,Toscana,Toscana,3729641,495791,13.29,0.15
598,2021-01-13,TOS,4062,1398,2664,3308,348,404,0,0,0,0,0,0,2,4062,0,ITI,ITI1,9,Toscana,Toscana,3729641,499853,13.4,0.11
599,2021-02-16,TOS,9268,3338,5930,5084,952,178,2323,0,0,10,0,720,1,8557,711,ITI,ITI1,9,Toscana,Toscana,3729641,509121,13.65,0.25
600,2021-04-04,TOS,13907,6599,7308,17,20,1,52,14,12885,170,723,5,20,13655,252,ITI,ITI1,9,Toscana,Toscana,3729641,523028,14.02,0.37
601,2021-03-01,TOS,4387,1671,2716,3192,597,137,25,0,0,9,1,424,2,747,3640,ITI,ITI1,9,Toscana,Toscana,3729641,527415,14.14,0.12
602,2021-04-18,TOS,7767,3858,3909,313,216,67,2,25,667,1120,5329,4,24,7002,765,ITI,ITI1,9,Toscana,Toscana,3729641,535182,14.35,0.21
603,2021-01-07,TOS,6018,1751,4267,5308,29,680,0,0,0,0,0,0,1,6018,0,ITI,ITI1,9,Toscana,Toscana,3729641,541200,14.51,0.16
604,2021-03-31,TOS,32316,12971,19345,278,96,264,3699,65,2643,23288,1475,441,67,20229,12087,ITI,ITI1,9,Toscana,Toscana,3729641,573516,15.38,0.87
605,2021-01-09,TOS,4485,1596,2889,3780,143,560,0,0,0,1,0,0,1,4485,0,ITI,ITI1,9,Toscana,Toscana,3729641,578001,15.5,0.12
606,2021-02-28,TOS,1649,667,982,1111,202,78,9,0,0,0,0,249,0,922,727,ITI,ITI1,9,Toscana,Toscana,3729641,579650,15.54,0.04
607,2021-01-31,TOS,3049,1129,1920,2465,133,448,0,0,0,1,0,0,2,106,2943,ITI,ITI1,9,Toscana,Toscana,3729641,582699,15.62,0.08
608,2021-04-01,TOS,26596,10953,15643,246,106,303,6,6,30,24325,1394,149,31,16074,10522,ITI,ITI1,9,Toscana,Toscana,3729641,609295,16.34,0.71
609,2021-02-21,TOS,5105,2089,3016,3666,1220,195,9,0,0,2,0,13,0,4935,170,ITI,ITI1,9,Toscana,Toscana,3729641,614400,16.47,0.14
610,2021-01-16,TOS,3271,1046,2225,2493,538,240,0,0,0,0,0,0,0,3271,0,ITI,ITI1,9,Toscana,Toscana,3729641,617671,16.56,0.09
611,2021-02-04,TOS,4253,1594,2659,3168,623,456,0,0,0,5,0,0,1,961,3292,ITI,ITI1,9,Toscana,Toscana,3729641,621924,16.68,0.11
612,2021-03-26,TOS,20288,9110,11178,250,325,213,333,27,3492,11804,3654,145,45,14586,5702,ITI,ITI1,9,Toscana,Toscana,3729641,642212,17.22,0.54
613,2021-04-06,TOS,22024,9697,12327,800,387,136,1626,125,10038,5596,2910,151,255,18335,3689,ITI,ITI1,9,Toscana,Toscana,3729641,664236,17.81,0.59
614,2021-01-10,TOS,3001,1104,1897,2432,134,431,0,1,0,0,0,0,3,3001,0,ITI,ITI1,9,Toscana,Toscana,3729641,667237,17.89,0.08
615,2021-01-20,TOS,1331,637,694,435,255,640,0,0,0,0,0,0,1,1083,248,ITI,ITI1,9,Toscana,Toscana,3729641,668568,17.93,0.04
616,2021-01-28,TOS,6282,1883,4399,5427,64,788,0,0,0,1,0,0,2,354,5928,ITI,ITI1,9,Toscana,Toscana,3729641,674850,18.09,0.17
617,2021-04-07,TOS,35323,15155,20168,309,540,98,20,57,11343,19677,3090,64,125,28152,7171,ITI,ITI1,9,Toscana,Toscana,3729641,710173,19.04,0.95
618,2021-01-11,TOS,5094,1691,3403,4362,209,522,0,0,0,0,0,0,1,5094,0,ITI,ITI1,9,Toscana,Toscana,3729641,715267,19.18,0.14
619,2021-04-12,TOS,2562,1170,1392,168,440,196,6,3,11,375,1357,4,2,1912,650,ITI,ITI1,9,Toscana,Toscana,3729641,717829,19.25,0.07
620,2021-01-25,TOS,5126,1896,3230,4160,54,909,0,0,0,1,0,0,2,249,4877,ITI,ITI1,9,Toscana,Toscana,3729641,722955,19.38,0.14
621,2021-04-11,TOS,3557,1639,1918,60,87,98,4,6,66,1608,1624,0,4,3404,153,ITI,ITI1,9,Toscana,Toscana,3729641,726512,19.48,0.1
622,2021-03-09,TOS,10587,4089,6498,4806,907,180,11,2,3,3298,1163,214,3,5035,5552,ITI,ITI1,9,Toscana,Toscana,3729641,737099,19.76,0.28
623,2021-02-27,TOS,1944,723,1221,1352,311,132,19,0,0,1,0,128,1,1042,902,ITI,ITI1,9,Toscana,Toscana,3729641,739043,19.82,0.05
624,2021-01-02,TOS,3498,1097,2401,2682,15,801,0,0,0,0,0,0,0,3498,0,ITI,ITI1,9,Toscana,Toscana,3729641,742541,19.91,0.09
625,2021-03-24,TOS,19572,7928,11644,222,385,195,773,51,2845,13928,871,224,78,10150,9422,ITI,ITI1,9,Toscana,Toscana,3729641,762113,20.43,0.52
626,2021-03-23,TOS,9047,4077,4970,309,312,328,338,52,2819,4018,659,148,64,6806,2241,ITI,ITI1,9,Toscana,Toscana,3729641,771160,20.68,0.24
627,2021-02-05,TOS,5748,2244,3504,4121,1180,442,0,0,0,1,0,0,4,1924,3824,ITI,ITI1,9,Toscana,Toscana,3729641,776908,20.83,0.15
628,2021-02-02,TOS,3742,1475,2267,3021,283,422,0,0,0,6,0,6,4,195,3547,ITI,ITI1,9,Toscana,Toscana,3729641,780650,20.93,0.1
629,2021-02-11,TOS,5383,2021,3362,2809,284,323,11,0,0,12,0,10,1934,5141,242,ITI,ITI1,9,Toscana,Toscana,3729641,786033,21.08,0.14
630,2021-04-10,TOS,11530,5253,6277,258,195,117,3,22,77,7981,2846,10,21,10791,739,ITI,ITI1,9,Toscana,Toscana,3729641,797563,21.38,0.31
631,2021-03-13,TOS,9276,3300,5976,2835,1697,68,3740,0,2,180,384,369,1,5314,3962,ITI,ITI1,9,Toscana,Toscana,3729641,806839,21.63,0.25
632,2021-01-18,TOS,1119,636,483,430,313,375,0,0,0,0,0,0,1,1021,98,ITI,ITI1,9,Toscana,Toscana,3729641,807958,21.66,0.03
633,2021-02-10,TOS,4264,1281,2983,3536,239,485,0,1,1,1,0,1,0,3740,524,ITI,ITI1,9,Toscana,Toscana,3729641,812222,21.78,0.11
634,2021-01-27,TOS,4834,1572,3262,4018,73,742,0,0,0,0,0,0,1,207,4627,ITI,ITI1,9,Toscana,Toscana,3729641,817056,21.91,0.13
635,2021-02-22,TOS,9817,4253,5564,3483,2234,316,2703,0,0,22,0,1058,1,9540,277,ITI,ITI1,9,Toscana,Toscana,3729641,826873,22.17,0.26
636,2021-04-15,TOS,23368,9792,13576,356,299,174,5,27,126,19437,2890,10,44,15234,8134,ITI,ITI1,9,Toscana,Toscana,3729641,850241,22.8,0.63
637,2021-01-06,TOS,4519,1459,3060,3984,9,525,0,0,0,0,0,0,1,4519,0,ITI,ITI1,9,Toscana,Toscana,3729641,854760,22.92,0.12
638,2021-03-29,TOS,9316,4534,4782,227,137,218,200,15,4855,774,2707,167,16,8992,324,ITI,ITI1,9,Toscana,Toscana,3729641,864076,23.17,0.25
639,2021-02-07,TOS,2806,953,1853,2349,299,157,0,0,0,0,0,0,1,885,1921,ITI,ITI1,9,Toscana,Toscana,3729641,866882,23.24,0.08
640,2021-01-01,TOS,2369,787,1582,1715,2,650,0,0,0,2,0,0,0,2369,0,ITI,ITI1,9,Toscana,Toscana,3729641,869251,23.31,0.06
641,2021-01-08,TOS,5944,1641,4303,5360,36,545,0,0,0,0,0,0,3,5944,0,ITI,ITI1,9,Toscana,Toscana,3729641,875195,23.47,0.16
642,2021-03-05,TOS,16442,6309,10133,3921,1684,170,3871,0,2,5273,656,861,4,11702,4740,ITI,ITI1,9,Toscana,Toscana,3729641,891637,23.91,0.44
643,2021-01-05,TOS,5243,1754,3489,4354,9,878,0,0,0,0,0,0,2,5243,0,ITI,ITI1,9,Toscana,Toscana,3729641,896880,24.05,0.14
644,2021-01-12,TOS,3581,1398,2183,2944,282,354,0,0,0,0,0,0,1,3581,0,ITI,ITI1,9,Toscana,Toscana,3729641,900461,24.14,0.1
645,2021-02-08,TOS,4097,1360,2737,3373,343,377,0,0,0,2,0,0,2,3638,459,ITI,ITI1,9,Toscana,Toscana,3729641,904558,24.25,0.11
646,2021-01-30,TOS,4622,1622,3000,3765,218,638,0,0,0,0,0,0,1,198,4424,ITI,ITI1,9,Toscana,Toscana,3729641,909180,24.38,0.12
647,2021-01-29,TOS,6136,1698,4438,5375,138,622,0,0,0,0,0,0,1,302,5834,ITI,ITI1,9,Toscana,Toscana,3729641,915316,24.54,0.16
648,2021-03-12,TOS,16448,6183,10265,2611,1587,303,3922,3,4,6996,280,728,14,12924,3524,ITI,ITI1,9,Toscana,Toscana,3729641,931764,24.98,0.44
649,2021-03-21,TOS,3232,1574,1658,660,796,77,12,0,1245,274,160,6,2,1799,1433,ITI,ITI1,9,Toscana,Toscana,3729641,934996,25.07,0.09
650,2021-03-10,TOS,17927,7030,10897,3005,851,271,14,3,3,12235,1317,217,11,13919,4008,ITI,ITI1,9,Toscana,Toscana,3729641,952923,25.55,0.48
651,2021-02-19,TOS,8286,2947,5339,2967,1207,245,3105,0,0,154,1,605,2,7779,507,ITI,ITI1,9,Toscana,Toscana,3729641,961209,25.77,0.22
652,2020-12-27,TOS,620,267,353,460,10,13,0,23,4,5,0,0,105,620,0,ITI,ITI1,9,Toscana,Toscana,3729641,961829,25.79,0.02
653,2020-12-30,TOS,327,104,223,34,10,283,0,0,0,0,0,0,0,327,0,ITI,ITI1,9,Toscana,Toscana,3729641,962156,25.8,0.01
654,2021-03-16,TOS,4885,1875,3010,1551,426,124,16,1,5,2104,642,13,3,2649,2236,ITI,ITI1,9,Toscana,Toscana,3729641,967041,25.93,0.13
655,2021-03-06,TOS,7095,2838,4257,3803,657,145,1146,0,2,30,918,394,0,2905,4190,ITI,ITI1,9,Toscana,Toscana,3729641,974136,26.12,0.19
656,2021-03-14,TOS,7207,2574,4633,3104,1195,122,2476,0,1,44,26,239,0,3272,3935,ITI,ITI1,9,Toscana,Toscana,3729641,981343,26.31,0.19
657,2021-02-09,TOS,4488,1468,3020,3582,386,514,0,0,0,4,0,0,2,3877,611,ITI,ITI1,9,Toscana,Toscana,3729641,985831,26.43,0.12
658,2021-03-17,TOS,11380,4572,6808,364,327,189,2,5,10,9728,740,2,13,6865,4515,ITI,ITI1,9,Toscana,Toscana,3729641,997211,26.74,0.31
659,2021-02-14,TOS,8993,2567,6426,3033,549,81,5,2,1,0,0,261,5061,8883,110,ITI,ITI1,9,Toscana,Toscana,3729641,1006204,26.98,0.24
660,2021-01-26,TOS,5393,1792,3601,4358,81,951,0,0,0,0,0,0,3,219,5174,ITI,ITI1,9,Toscana,Toscana,3729641,1011597,27.12,0.14
661,2020-12-31,TOS,805,202,603,97,10,698,0,0,0,0,0,0,0,805,0,ITI,ITI1,9,Toscana,Toscana,3729641,1012402,27.14,0.02
662,2021-01-07,LIG,3230,1095,2135,2340,316,466,4,18,5,0,0,1,80,3230,0,ITC,ITC3,7,Liguria,Liguria,1550640,3230,0.21,0.21
663,2021-01-08,LIG,2926,999,1927,2083,343,431,4,12,0,0,0,1,52,2926,0,ITC,ITC3,7,Liguria,Liguria,1550640,6156,0.4,0.19
664,2021-02-18,LIG,2761,1126,1635,958,195,349,2,22,7,1006,35,0,187,2431,330,ITC,ITC3,7,Liguria,Liguria,1550640,8917,0.58,0.18
665,2021-02-19,LIG,3096,1279,1817,989,245,97,3,39,22,1450,0,4,247,2920,176,ITC,ITC3,7,Liguria,Liguria,1550640,12013,0.77,0.2
666,2021-04-10,LIG,7416,3371,4045,213,90,34,9,164,3760,1317,1616,6,207,6747,669,ITC,ITC3,7,Liguria,Liguria,1550640,19429,1.25,0.48
667,2021-02-11,LIG,1961,761,1200,1240,229,456,6,2,1,0,4,0,23,1091,870,ITC,ITC3,7,Liguria,Liguria,1550640,21390,1.38,0.13
668,2021-03-13,LIG,3563,1514,2049,331,120,71,790,99,45,1522,11,179,395,2710,853,ITC,ITC3,7,Liguria,Liguria,1550640,24953,1.61,0.23
669,2021-01-18,LIG,2133,744,1389,1251,385,438,10,12,5,1,0,0,31,1976,157,ITC,ITC3,7,Liguria,Liguria,1550640,27086,1.75,0.14
670,2021-02-22,LIG,3328,1462,1866,712,104,235,2,2,13,2236,0,7,17,3190,138,ITC,ITC3,7,Liguria,Liguria,1550640,30414,1.96,0.21
671,2021-03-16,LIG,6067,2718,3349,934,176,323,6,35,77,4275,142,14,85,2350,3717,ITC,ITC3,7,Liguria,Liguria,1550640,36481,2.35,0.39
672,2020-12-29,LIG,125,33,92,93,11,21,0,0,0,0,0,0,0,125,0,ITC,ITC3,7,Liguria,Liguria,1550640,36606,2.36,0.01
673,2021-03-26,LIG,9094,3843,5251,602,325,65,1297,213,264,3890,1832,377,229,5940,3154,ITC,ITC3,7,Liguria,Liguria,1550640,45700,2.95,0.59
674,2021-03-12,LIG,6027,2769,3258,1205,457,84,4,77,79,3385,53,590,93,3562,2465,ITC,ITC3,7,Liguria,Liguria,1550640,51727,3.34,0.39
675,2021-04-02,LIG,11309,4959,6350,432,226,31,897,349,2890,3617,2431,139,297,8823,2486,ITC,ITC3,7,Liguria,Liguria,1550640,63036,4.07,0.73
676,2021-01-16,LIG,1278,557,721,753,196,299,1,4,2,0,1,0,22,1278,0,ITC,ITC3,7,Liguria,Liguria,1550640,64314,4.15,0.08
677,2021-04-04,LIG,756,366,390,30,0,0,0,36,64,325,222,0,79,507,249,ITC,ITC3,7,Liguria,Liguria,1550640,65070,4.2,0.05
678,2021-01-01,LIG,144,55,89,139,5,0,0,0,0,0,0,0,0,144,0,ITC,ITC3,7,Liguria,Liguria,1550640,65214,4.21,0.01
679,2021-01-05,LIG,2879,896,1983,2309,240,261,7,7,1,17,0,0,37,2879,0,ITC,ITC3,7,Liguria,Liguria,1550640,68093,4.39,0.19
680,2021-04-01,LIG,11982,5295,6687,435,240,141,936,332,3137,3706,2541,188,326,9212,2770,ITC,ITC3,7,Liguria,Liguria,1550640,80075,5.16,0.77
681,2021-01-20,LIG,1548,554,994,726,332,480,2,0,2,0,0,0,6,1536,12,ITC,ITC3,7,Liguria,Liguria,1550640,81623,5.26,0.1
682,2021-04-03,LIG,5187,2388,2799,116,78,3,19,136,2206,1394,1123,9,103,4245,942,ITC,ITC3,7,Liguria,Liguria,1550640,86810,5.6,0.33
683,2021-01-15,LIG,2254,753,1501,1326,349,517,2,8,1,2,1,0,48,2254,0,ITC,ITC3,7,Liguria,Liguria,1550640,89064,5.74,0.15
684,2021-01-06,LIG,1660,616,1044,1230,142,113,3,36,10,65,0,0,61,1660,0,ITC,ITC3,7,Liguria,Liguria,1550640,90724,5.85,0.11
685,2021-01-10,LIG,648,262,386,369,101,176,0,1,0,0,0,0,1,648,0,ITC,ITC3,7,Liguria,Liguria,1550640,91372,5.89,0.04
686,2021-02-02,LIG,2668,1005,1663,1974,216,464,2,2,0,0,0,0,10,134,2534,ITC,ITC3,7,Liguria,Liguria,1550640,94040,6.06,0.17
687,2021-04-07,LIG,12981,5761,7220,426,294,105,571,463,3900,4146,2592,146,338,10831,2150,ITC,ITC3,7,Liguria,Liguria,1550640,107021,6.9,0.84
688,2021-01-28,LIG,2841,969,1872,2239,270,310,5,0,0,1,0,1,15,39,2802,ITC,ITC3,7,Liguria,Liguria,1550640,109862,7.08,0.18
689,2021-01-02,LIG,691,245,446,595,95,0,0,0,0,0,0,0,1,691,0,ITC,ITC3,7,Liguria,Liguria,1550640,110553,7.13,0.04
690,2021-04-09,LIG,11949,5367,6582,525,353,79,580,433,3879,3500,2229,61,310,10342,1607,ITC,ITC3,7,Liguria,Liguria,1550640,122502,7.9,0.77
691,2021-01-11,LIG,2653,990,1663,1991,314,316,1,7,0,0,0,0,24,2653,0,ITC,ITC3,7,Liguria,Liguria,1550640,125155,8.07,0.17
692,2021-01-14,LIG,2982,1056,1926,1872,524,553,1,5,0,0,0,2,25,2982,0,ITC,ITC3,7,Liguria,Liguria,1550640,128137,8.26,0.19
693,2021-03-03,LIG,4578,1846,2732,1039,202,308,4,4,5,2982,0,4,30,3555,1023,ITC,ITC3,7,Liguria,Liguria,1550640,132715,8.56,0.3
694,2021-01-09,LIG,1335,481,854,999,131,188,2,4,0,0,0,1,10,1335,0,ITC,ITC3,7,Liguria,Liguria,1550640,134050,8.64,0.09
695,2021-02-16,LIG,2392,949,1443,982,237,283,2,19,4,704,12,0,149,1999,393,ITC,ITC3,7,Liguria,Liguria,1550640,136442,8.8,0.15
696,2021-04-18,LIG,2425,1078,1347,216,93,44,1,15,667,506,878,0,5,1957,468,ITC,ITC3,7,Liguria,Liguria,1550640,138867,8.96,0.16
697,2021-02-10,LIG,2275,827,1448,1350,391,496,5,6,2,5,0,0,20,1014,1261,ITC,ITC3,7,Liguria,Liguria,1550640,141142,9.1,0.15
698,2021-01-31,LIG,624,270,354,418,71,135,0,0,0,0,0,0,0,9,615,ITC,ITC3,7,Liguria,Liguria,1550640,141766,9.14,0.04
699,2021-02-20,LIG,1334,636,698,159,107,122,0,34,5,589,0,4,314,1333,1,ITC,ITC3,7,Liguria,Liguria,1550640,143100,9.23,0.09
700,2021-01-21,LIG,1102,385,717,584,159,332,0,2,2,1,0,0,22,672,430,ITC,ITC3,7,Liguria,Liguria,1550640,144202,9.3,0.07
701,2021-02-23,LIG,3803,1559,2244,686,163,116,1,5,5,2749,42,4,32,3694,109,ITC,ITC3,7,Liguria,Liguria,1550640,148005,9.54,0.25
702,2021-02-26,LIG,3760,1521,2239,782,147,168,2,16,26,2604,0,0,15,3433,327,ITC,ITC3,7,Liguria,Liguria,1550640,151765,9.79,0.24
703,2021-04-11,LIG,4204,1912,2292,66,57,24,73,66,2077,624,1168,10,39,3955,249,ITC,ITC3,7,Liguria,Liguria,1550640,155969,10.06,0.27
704,2021-02-13,LIG,1080,508,572,543,80,148,0,0,0,257,0,2,50,800,280,ITC,ITC3,7,Liguria,Liguria,1550640,157049,10.13,0.07
705,2021-02-24,LIG,3758,1557,2201,804,193,154,1,2,5,2580,1,0,18,3499,259,ITC,ITC3,7,Liguria,Liguria,1550640,160807,10.37,0.24
706,2021-03-20,LIG,2316,995,1321,224,81,0,0,12,44,1857,12,67,19,1142,1174,ITC,ITC3,7,Liguria,Liguria,1550640,163123,10.52,0.15
707,2021-02-17,LIG,2623,1165,1458,883,202,262,1,15,8,1121,0,8,123,2260,363,ITC,ITC3,7,Liguria,Liguria,1550640,165746,10.69,0.17
708,2021-03-06,LIG,3302,1841,1461,377,151,120,1,58,6,1537,0,559,493,2597,705,ITC,ITC3,7,Liguria,Liguria,1550640,169048,10.9,0.21
709,2021-01-25,LIG,2717,888,1829,2208,175,317,2,5,1,0,0,0,9,471,2246,ITC,ITC3,7,Liguria,Liguria,1550640,171765,11.08,0.18
710,2021-04-12,LIG,11945,5278,6667,498,199,107,45,530,3980,4044,2149,68,325,10123,1822,ITC,ITC3,7,Liguria,Liguria,1550640,183710,11.85,0.77
711,2021-02-12,LIG,1913,684,1229,866,203,393,1,2,1,431,0,7,9,895,1018,ITC,ITC3,7,Liguria,Liguria,1550640,185623,11.97,0.12
712,2021-03-10,LIG,5756,2782,2974,823,353,95,1,23,28,3633,43,610,147,3852,1904,ITC,ITC3,7,Liguria,Liguria,1550640,191379,12.34,0.37
713,2021-03-27,LIG,3920,1538,2382,176,175,36,706,26,90,2057,502,92,60,2525,1395,ITC,ITC3,7,Liguria,Liguria,1550640,195299,12.59,0.25
714,2021-03-31,LIG,11386,4988,6398,522,178,86,872,343,2227,4207,2425,218,308,8624,2762,ITC,ITC3,7,Liguria,Liguria,1550640,206685,13.33,0.73
715,2021-04-08,LIG,9550,4326,5224,442,202,74,348,364,2971,2798,2010,52,289,8049,1501,ITC,ITC3,7,Liguria,Liguria,1550640,216235,13.94,0.62
716,2021-03-02,LIG,4073,1688,2385,726,93,76,4,8,17,3088,42,3,16,3763,310,ITC,ITC3,7,Liguria,Liguria,1550640,220308,14.21,0.26
717,2021-03-01,LIG,3498,1425,2073,528,81,105,1,4,6,2750,0,0,23,3376,122,ITC,ITC3,7,Liguria,Liguria,1550640,223806,14.43,0.23
718,2021-03-30,LIG,11700,5170,6530,485,253,152,845,314,1988,4296,2802,280,285,8311,3389,ITC,ITC3,7,Liguria,Liguria,1550640,235506,15.19,0.75
719,2021-03-08,LIG,5619,2456,3163,1122,319,80,7,35,15,3569,11,384,77,3935,1684,ITC,ITC3,7,Liguria,Liguria,1550640,241125,15.55,0.36
720,2021-04-17,LIG,6808,2980,3828,153,138,68,3,1133,2371,1474,1300,8,160,6085,723,ITC,ITC3,7,Liguria,Liguria,1550640,247933,15.99,0.44
721,2021-03-17,LIG,5521,2356,3165,781,146,76,7,20,73,4258,109,4,47,2463,3058,ITC,ITC3,7,Liguria,Liguria,1550640,253454,16.35,0.36
722,2021-02-04,LIG,2814,985,1829,1866,460,471,8,0,0,0,0,1,8,179,2635,ITC,ITC3,7,Liguria,Liguria,1550640,256268,16.53,0.18
723,2021-01-23,LIG,809,295,514,633,129,43,1,2,1,0,0,0,0,153,656,ITC,ITC3,7,Liguria,Liguria,1550640,257077,16.58,0.05
724,2021-04-06,LIG,12472,5543,6929,538,264,207,550,348,3631,4007,2437,134,356,10367,2105,ITC,ITC3,7,Liguria,Liguria,1550640,269549,17.38,0.8
725,2021-02-15,LIG,2259,838,1421,1086,217,241,2,13,1,663,0,1,35,1862,397,ITC,ITC3,7,Liguria,Liguria,1550640,271808,17.53,0.15
726,2021-02-28,LIG,1060,581,479,12,2,4,0,63,7,474,0,0,498,1051,9,ITC,ITC3,7,Liguria,Liguria,1550640,272868,17.6,0.07
727,2020-12-30,LIG,12,5,7,12,0,0,0,0,0,0,0,0,0,12,0,ITC,ITC3,7,Liguria,Liguria,1550640,272880,17.6,0.0
728,2021-02-09,LIG,1904,683,1221,1087,325,455,22,2,0,0,0,0,13,256,1648,ITC,ITC3,7,Liguria,Liguria,1550640,274784,17.72,0.12
729,2021-03-22,LIG,7367,3277,4090,578,192,82,874,122,95,3827,1086,371,140,4524,2843,ITC,ITC3,7,Liguria,Liguria,1550640,282151,18.2,0.48
730,2021-01-17,LIG,861,300,561,516,30,262,1,4,2,0,0,0,46,861,0,ITC,ITC3,7,Liguria,Liguria,1550640,283012,18.25,0.06
731,2021-02-07,LIG,407,153,254,191,18,187,0,0,0,0,9,0,2,2,405,ITC,ITC3,7,Liguria,Liguria,1550640,283419,18.28,0.03
732,2021-03-11,LIG,6213,2987,3226,1144,169,261,2,42,38,3679,90,711,77,4211,2002,ITC,ITC3,7,Liguria,Liguria,1550640,289632,18.68,0.4
733,2021-04-05,LIG,3970,1748,2222,190,45,10,10,154,939,2212,286,5,119,2321,1649,ITC,ITC3,7,Liguria,Liguria,1550640,293602,18.93,0.26
734,2021-01-04,LIG,2615,854,1761,2197,158,176,3,22,3,0,1,0,55,2615,0,ITC,ITC3,7,Liguria,Liguria,1550640,296217,19.1,0.17
735,2020-12-31,LIG,989,354,635,751,34,155,0,4,10,28,0,0,7,989,0,ITC,ITC3,7,Liguria,Liguria,1550640,297206,19.17,0.06
736,2021-03-15,LIG,7298,3072,4226,819,338,106,962,126,83,3779,628,304,153,4596,2702,ITC,ITC3,7,Liguria,Liguria,1550640,304504,19.64,0.47
737,2021-02-21,LIG,869,491,378,183,21,102,0,38,4,267,0,0,254,865,4,ITC,ITC3,7,Liguria,Liguria,1550640,305373,19.69,0.06
738,2021-02-06,LIG,1891,767,1124,1309,186,375,1,0,1,0,0,0,19,145,1746,ITC,ITC3,7,Liguria,Liguria,1550640,307264,19.82,0.12
739,2021-01-13,LIG,2755,1013,1742,1913,307,487,4,8,7,1,0,0,28,2755,0,ITC,ITC3,7,Liguria,Liguria,1550640,310019,19.99,0.18
740,2021-04-13,LIG,12481,5587,6894,512,227,111,103,557,4244,4239,2133,87,268,10575,1906,ITC,ITC3,7,Liguria,Liguria,1550640,322500,20.8,0.8
741,2021-01-03,LIG,734,230,504,658,62,0,1,2,0,0,0,0,11,734,0,ITC,ITC3,7,Liguria,Liguria,1550640,323234,20.85,0.05
742,2021-04-16,LIG,11572,5094,6478,478,233,69,42,1819,3163,3442,2030,77,219,9781,1791,ITC,ITC3,7,Liguria,Liguria,1550640,334806,21.59,0.75
743,2021-01-19,LIG,1364,433,931,714,312,328,3,1,0,0,0,0,6,1274,90,ITC,ITC3,7,Liguria,Liguria,1550640,336170,21.68,0.09
744,2021-01-30,LIG,1661,567,1094,1261,121,257,2,6,0,0,0,0,14,25,1636,ITC,ITC3,7,Liguria,Liguria,1550640,337831,21.79,0.11
745,2021-02-05,LIG,2673,986,1687,1743,417,494,4,1,1,0,0,0,13,304,2369,ITC,ITC3,7,Liguria,Liguria,1550640,340504,21.96,0.17
746,2021-02-03,LIG,2315,791,1524,1626,225,416,1,7,4,0,0,0,36,55,2260,ITC,ITC3,7,Liguria,Liguria,1550640,342819,22.11,0.15
747,2021-02-25,LIG,3439,1348,2091,550,134,88,1,7,1,2586,42,2,28,3310,129,ITC,ITC3,7,Liguria,Liguria,1550640,346258,22.33,0.22
748,2020-12-28,LIG,80,30,50,77,0,0,0,1,0,1,0,0,1,80,0,ITC,ITC3,7,Liguria,Liguria,1550640,346338,22.34,0.01
749,2021-01-24,LIG,755,236,519,632,60,60,0,0,0,0,0,0,3,113,642,ITC,ITC3,7,Liguria,Liguria,1550640,347093,22.38,0.05
750,2021-03-25,LIG,9505,4046,5459,648,265,172,1613,149,259,3680,2048,523,148,6116,3389,ITC,ITC3,7,Liguria,Liguria,1550640,356598,23.0,0.61
751,2021-03-24,LIG,8787,3766,5021,522,235,103,1337,154,140,4225,1366,551,154,5499,3288,ITC,ITC3,7,Liguria,Liguria,1550640,365385,23.56,0.57
752,2021-03-07,LIG,1858,1085,773,184,200,258,1,29,3,509,0,405,269,1557,301,ITC,ITC3,7,Liguria,Liguria,1550640,367243,23.68,0.12
753,2021-03-23,LIG,8798,3986,4812,638,211,56,1311,147,102,3932,1654,583,164,5592,3206,ITC,ITC3,7,Liguria,Liguria,1550640,376041,24.25,0.57
754,2021-04-14,LIG,12388,5404,6984,447,290,74,61,535,4401,4206,2110,38,226,10370,2018,ITC,ITC3,7,Liguria,Liguria,1550640,388429,25.05,0.8
755,2020-12-27,LIG,135,56,79,88,0,45,0,0,0,0,0,0,2,135,0,ITC,ITC3,7,Liguria,Liguria,1550640,388564,25.06,0.01
756,2021-01-27,LIG,1745,604,1141,1338,169,227,1,0,0,0,0,0,10,142,1603,ITC,ITC3,7,Liguria,Liguria,1550640,390309,25.17,0.11
757,2021-04-19,LIG,6500,2809,3691,246,73,32,111,1183,1605,2053,1075,22,100,4266,2234,ITC,ITC3,7,Liguria,Liguria,1550640,396809,25.59,0.42
758,2021-03-04,LIG,4734,2117,2617,920,171,289,4,3,8,2922,42,327,48,3891,843,ITC,ITC3,7,Liguria,Liguria,1550640,401543,25.9,0.31
759,2021-03-09,LIG,5804,2701,3103,1031,323,132,0,51,45,3465,42,629,86,4379,1425,ITC,ITC3,7,Liguria,Liguria,1550640,407347,26.27,0.37
760,2021-03-14,LIG,1658,752,906,66,68,176,431,70,13,577,3,52,202,1054,604,ITC,ITC3,7,Liguria,Liguria,1550640,409005,26.38,0.11
761,2021-02-14,LIG,233,122,111,31,0,112,0,0,0,60,0,0,30,233,0,ITC,ITC3,7,Liguria,Liguria,1550640,409238,26.39,0.02
762,2021-01-26,LIG,2483,803,1680,1964,253,252,5,1,0,0,1,0,7,13,2470,ITC,ITC3,7,Liguria,Liguria,1550640,411721,26.55,0.16
763,2021-03-29,LIG,10384,4487,5897,463,258,117,883,253,1558,3926,2394,205,327,7255,3129,ITC,ITC3,7,Liguria,Liguria,1550640,422105,27.22,0.67
764,2021-01-12,LIG,2460,886,1574,1750,250,439,2,2,1,0,0,1,15,2460,0,ITC,ITC3,7,Liguria,Liguria,1550640,424565,27.38,0.16
765,2021-03-28,LIG,1141,510,631,135,92,145,0,25,85,532,86,2,39,390,751,ITC,ITC3,7,Liguria,Liguria,1550640,425706,27.45,0.07
766,2021-02-01,LIG,2551,917,1634,1945,202,380,1,6,0,0,1,0,16,85,2466,ITC,ITC3,7,Liguria,Liguria,1550640,428257,27.62,0.16
767,2021-04-15,LIG,11248,4952,6296,478,257,136,58,447,3548,3654,2395,75,200,9453,1795,ITC,ITC3,7,Liguria,Liguria,1550640,439505,28.34,0.73
768,2021-02-08,LIG,1977,742,1235,1256,368,311,7,10,4,1,0,0,20,306,1671,ITC,ITC3,7,Liguria,Liguria,1550640,441482,28.47,0.13
769,2021-03-19,LIG,5280,2229,3051,734,202,137,83,54,79,3689,165,88,49,2149,3131,ITC,ITC3,7,Liguria,Liguria,1550640,446762,28.81,0.34
770,2021-03-21,LIG,552,221,331,7,3,0,0,0,13,525,1,0,3,69,483,ITC,ITC3,7,Liguria,Liguria,1550640,447314,28.85,0.04
771,2021-01-29,LIG,3077,1064,2013,2312,300,441,2,4,0,0,0,0,18,67,3010,ITC,ITC3,7,Liguria,Liguria,1550640,450391,29.05,0.2
772,2021-02-27,LIG,1888,921,967,139,18,5,0,61,0,1205,0,0,460,1759,129,ITC,ITC3,7,Liguria,Liguria,1550640,452279,29.17,0.12
773,2021-01-22,LIG,1814,603,1211,1065,175,565,0,2,0,1,1,0,5,1328,486,ITC,ITC3,7,Liguria,Liguria,1550640,454093,29.28,0.12
774,2021-03-18,LIG,4987,2125,2862,634,87,98,5,63,79,3701,217,6,97,2017,2970,ITC,ITC3,7,Liguria,Liguria,1550640,459080,29.61,0.32
775,2021-03-05,LIG,4861,2147,2714,795,220,81,5,5,8,3339,6,365,37,3737,1124,ITC,ITC3,7,Liguria,Liguria,1550640,463941,29.92,0.31
776,2020-12-31,EMR,2205,777,1428,1676,96,328,0,9,5,13,0,0,78,2205,0,ITH,ITH5,8,Emilia-Romagna,Emilia-Romagna,4459477,2205,0.05,0.05
777,2021-04-12,EMR,18982,8891,10091,437,169,305,62,392,4512,6623,6351,95,36,14617,4365,ITH,ITH5,8,Emilia-Romagna,Emilia-Romagna,4459477,21187,0.48,0.43
778,2021-02-07,EMR,4787,1535,3252,3686,565,444,3,8,1,10,0,0,70,1728,3059,ITH,ITH5,8,Emilia-Romagna,Emilia-Romagna,4459477,25974,0.58,0.11
779,2021-03-28,EMR,12561,5594,6967,277,139,48,326,60,3969,4852,2571,245,74,9073,3488,ITH,ITH5,8,Emilia-Romagna,Emilia-Romagna,4459477,38535,0.86,0.28
780,2021-01-17,EMR,2890,887,2003,1914,378,547,4,14,5,2,0,0,26,2644,246,ITH,ITH5,8,Emilia-Romagna,Emilia-Romagna,4459477,41425,0.93,0.06
781,2021-03-19,EMR,15259,6625,8634,1125,555,118,336,78,844,10479,886,710,128,7499,7760,ITH,ITH5,8,Emilia-Romagna,Emilia-Romagna,4459477,56684,1.27,0.34
782,2021-03-20,EMR,16027,6799,9228,702,385,98,831,58,2956,9338,937,567,155,9093,6934,ITH,ITH5,8,Emilia-Romagna,Emilia-Romagna,4459477,72711,1.63,0.36
783,2021-04-06,EMR,24569,11092,13477,637,200,187,410,242,5963,11509,5179,86,156,19840,4729,ITH,ITH5,8,Emilia-Romagna,Emilia-Romagna,4459477,97280,2.18,0.55
784,2021-03-05,EMR,17600,5726,11874,3079,855,265,5940,59,40,6387,108,544,323,14189,3411,ITH,ITH5,8,Emilia-Romagna,Emilia-Romagna,4459477,114880,2.58,0.39
785,2021-01-11,EMR,9330,3269,6061,6578,1347,1267,0,25,5,4,0,0,104,9330,0,ITH,ITH5,8,Emilia-Romagna,Emilia-Romagna,4459477,124210,2.79,0.21
786,2021-01-25,EMR,6418,2129,4289,5237,316,678,0,21,2,3,0,0,161,202,6216,ITH,ITH5,8,Emilia-Romagna,Emilia-Romagna,4459477,130628,2.93,0.14
787,2021-04-11,EMR,15058,6836,8222,405,135,104,59,355,2368,6814,4622,77,119,12039,3019,ITH,ITH5,8,Emilia-Romagna,Emilia-Romagna,4459477,145686,3.27,0.34
788,2021-01-30,EMR,10068,3516,6552,7564,1400,796,0,45,5,2,0,0,256,142,9926,ITH,ITH5,8,Emilia-Romagna,Emilia-Romagna,4459477,155754,3.49,0.23
789,2021-01-21,EMR,2154,726,1428,1285,156,653,0,9,1,0,0,0,50,809,1345,ITH,ITH5,8,Emilia-Romagna,Emilia-Romagna,4459477,157908,3.54,0.05
790,2021-04-17,EMR,26086,12482,13604,387,148,65,53,337,8319,4103,12591,23,60,17209,8877,ITH,ITH5,8,Emilia-Romagna,Emilia-Romagna,4459477,183994,4.13,0.58
791,2021-03-10,EMR,18653,7642,11011,1314,585,143,4529,28,66,10045,284,1591,68,13017,5636,ITH,ITH5,8,Emilia-Romagna,Emilia-Romagna,4459477,202647,4.54,0.42
792,2021-04-18,EMR,16786,8051,8735,263,160,152,26,203,6246,2326,7376,14,20,12313,4473,ITH,ITH5,8,Emilia-Romagna,Emilia-Romagna,4459477,219433,4.92,0.38
793,2021-03-06,EMR,20493,5861,14632,2714,409,49,10345,65,46,5920,109,565,271,17770,2723,ITH,ITH5,8,Emilia-Romagna,Emilia-Romagna,4459477,239926,5.38,0.46
794,2021-04-04,EMR,9867,4709,5158,188,112,0,57,147,1630,4651,2865,54,163,7598,2269,ITH,ITH5,8,Emilia-Romagna,Emilia-Romagna,4459477,249793,5.6,0.22
795,2021-03-16,EMR,12200,5002,7198,418,92,115,123,34,113,10876,390,9,30,4931,7269,ITH,ITH5,8,Emilia-Romagna,Emilia-Romagna,4459477,261993,5.87,0.27
796,2021-01-22,EMR,1828,477,1351,942,66,722,0,19,1,10,0,0,68,1088,740,ITH,ITH5,8,Emilia-Romagna,Emilia-Romagna,4459477,263821,5.92,0.04
797,2021-04-13,EMR,23321,10930,12391,466,142,187,51,346,10327,6082,5599,49,72,19113,4208,ITH,ITH5,8,Emilia-Romagna,Emilia-Romagna,4459477,287142,6.44,0.52
798,2021-02-02,EMR,9461,3039,6422,6237,1347,1632,1,27,4,117,6,0,90,517,8944,ITH,ITH5,8,Emilia-Romagna,Emilia-Romagna,4459477,296603,6.65,0.21
799,2021-03-14,EMR,8690,3742,4948,728,212,69,926,16,66,5528,650,407,88,4895,3795,ITH,ITH5,8,Emilia-Romagna,Emilia-Romagna,4459477,305293,6.85,0.19
800,2021-01-31,EMR,7695,2761,4934,6174,1124,263,0,16,12,32,0,0,74,242,7453,ITH,ITH5,8,Emilia-Romagna,Emilia-Romagna,4459477,312988,7.02,0.17
801,2021-03-17,EMR,13679,5682,7997,361,137,108,19,52,398,11860,667,1,76,5861,7818,ITH,ITH5,8,Emilia-Romagna,Emilia-Romagna,4459477,326667,7.33,0.31
802,2021-01-06,EMR,8262,2942,5320,6852,641,648,0,13,9,44,0,1,54,8262,0,ITH,ITH5,8,Emilia-Romagna,Emilia-Romagna,4459477,334929,7.51,0.19
803,2021-04-03,EMR,19897,8748,11149,374,189,39,426,197,2861,10570,5050,76,115,16168,3729,ITH,ITH5,8,Emilia-Romagna,Emilia-Romagna,4459477,354826,7.96,0.45
804,2021-02-25,EMR,9212,3491,5721,797,187,156,95,47,41,7659,30,0,200,8257,955,ITH,ITH5,8,Emilia-Romagna,Emilia-Romagna,4459477,364038,8.16,0.21
805,2021-01-26,EMR,8330,3000,5330,6605,537,1032,0,22,2,4,0,0,128,215,8115,ITH,ITH5,8,Emilia-Romagna,Emilia-Romagna,4459477,372368,8.35,0.19
806,2021-02-04,EMR,9924,3200,6724,6434,1461,1674,0,39,11,160,5,0,140,1250,8674,ITH,ITH5,8,Emilia-Romagna,Emilia-Romagna,4459477,382292,8.57,0.22
807,2021-03-15,EMR,13168,6040,7128,799,457,190,529,25,101,9127,812,1073,55,6718,6450,ITH,ITH5,8,Emilia-Romagna,Emilia-Romagna,4459477,395460,8.87,0.3
808,2021-03-29,EMR,21067,9382,11685,691,189,118,618,127,5487,9289,4230,203,115,16463,4604,ITH,ITH5,8,Emilia-Romagna,Emilia-Romagna,4459477,416527,9.34,0.47
809,2021-01-12,EMR,9408,3111,6297,6376,1182,1690,0,31,2,32,0,0,95,9408,0,ITH,ITH5,8,Emilia-Romagna,Emilia-Romagna,4459477,425935,9.55,0.21
810,2021-01-10,EMR,7129,2664,4465,5646,952,499,1,4,1,7,0,0,19,7129,0,ITH,ITH5,8,Emilia-Romagna,Emilia-Romagna,4459477,433064,9.71,0.16
811,2021-03-21,EMR,11901,5260,6641,566,356,114,587,31,2734,6114,802,492,105,7297,4604,ITH,ITH5,8,Emilia-Romagna,Emilia-Romagna,4459477,444965,9.98,0.27
812,2021-01-13,EMR,9068,2939,6129,6010,914,1744,1,39,12,91,0,0,257,9068,0,ITH,ITH5,8,Emilia-Romagna,Emilia-Romagna,4459477,454033,10.18,0.2
813,2021-02-06,EMR,7540,2387,5153,5363,862,1181,0,13,4,51,0,0,66,2123,5417,ITH,ITH5,8,Emilia-Romagna,Emilia-Romagna,4459477,461573,10.35,0.17
814,2021-02-26,EMR,7806,2967,4839,1058,360,244,312,24,28,5566,60,0,154,6760,1046,ITH,ITH5,8,Emilia-Romagna,Emilia-Romagna,4459477,469379,10.53,0.18
815,2021-04-16,EMR,27961,13172,14789,607,146,85,71,357,10318,5769,10471,34,103,19439,8522,ITH,ITH5,8,Emilia-Romagna,Emilia-Romagna,4459477,497340,11.15,0.63
816,2021-02-05,EMR,9309,2964,6345,6214,1148,1610,1,19,9,223,3,0,82,1636,7673,ITH,ITH5,8,Emilia-Romagna,Emilia-Romagna,4459477,506649,11.36,0.21
817,2021-01-24,EMR,2443,885,1558,2080,93,249,0,5,1,0,0,0,15,299,2144,ITH,ITH5,8,Emilia-Romagna,Emilia-Romagna,4459477,509092,11.42,0.05
818,2021-04-02,EMR,23161,10426,12735,717,312,104,932,342,3803,10951,5678,226,96,18705,4456,ITH,ITH5,8,Emilia-Romagna,Emilia-Romagna,4459477,532253,11.94,0.52
819,2021-02-13,EMR,3617,1082,2535,2783,382,144,0,8,7,244,0,0,49,3019,598,ITH,ITH5,8,Emilia-Romagna,Emilia-Romagna,4459477,535870,12.02,0.08
820,2021-03-23,EMR,18664,8052,10612,1125,482,196,1351,80,3704,9338,1854,436,98,11978,6686,ITH,ITH5,8,Emilia-Romagna,Emilia-Romagna,4459477,554534,12.43,0.42
821,2021-03-04,EMR,16388,5337,11051,2609,604,254,5436,50,55,6405,160,511,304,13387,3001,ITH,ITH5,8,Emilia-Romagna,Emilia-Romagna,4459477,570922,12.8,0.37
822,2021-03-22,EMR,17433,7632,9801,1135,425,164,600,51,3596,9564,1244,579,75,10571,6862,ITH,ITH5,8,Emilia-Romagna,Emilia-Romagna,4459477,588355,13.19,0.39
823,2021-04-10,EMR,20710,9194,11516,507,209,88,189,191,4084,8924,6420,24,74,16606,4104,ITH,ITH5,8,Emilia-Romagna,Emilia-Romagna,4459477,609065,13.66,0.46
824,2021-03-24,EMR,20926,9232,11694,1214,370,123,1695,273,3434,10610,2669,384,154,13571,7355,ITH,ITH5,8,Emilia-Romagna,Emilia-Romagna,4459477,629991,14.13,0.47
825,2021-02-08,EMR,5220,1527,3693,2840,577,1478,1,10,8,247,0,0,59,2313,2907,ITH,ITH5,8,Emilia-Romagna,Emilia-Romagna,4459477,635211,14.24,0.12
826,2021-04-08,EMR,30458,13961,16497,2473,572,222,310,400,6645,11012,8454,135,235,25193,5265,ITH,ITH5,8,Emilia-Romagna,Emilia-Romagna,4459477,665669,14.93,0.68
827,2021-02-22,EMR,7481,3091,4390,389,110,129,0,12,25,6798,9,0,9,7205,276,ITH,ITH5,8,Emilia-Romagna,Emilia-Romagna,4459477,673150,15.09,0.17
828,2021-04-19,EMR,12670,5997,6673,187,52,68,10,67,5157,2201,4891,15,22,8554,4116,ITH,ITH5,8,Emilia-Romagna,Emilia-Romagna,4459477,685820,15.38,0.28
829,2021-02-01,EMR,10300,3602,6698,7455,1502,1260,0,13,7,0,0,0,63,366,9934,ITH,ITH5,8,Emilia-Romagna,Emilia-Romagna,4459477,696120,15.61,0.23
830,2021-02-03,EMR,9296,2983,6313,6232,1177,1618,0,29,15,126,6,1,92,973,8323,ITH,ITH5,8,Emilia-Romagna,Emilia-Romagna,4459477,705416,15.82,0.21
831,2021-01-16,EMR,5592,1717,3875,3687,691,1108,1,18,2,0,0,3,82,5592,0,ITH,ITH5,8,Emilia-Romagna,Emilia-Romagna,4459477,711008,15.94,0.13
832,2021-03-12,EMR,18065,7525,10540,1584,898,311,3024,47,73,9901,462,1552,213,11349,6716,ITH,ITH5,8,Emilia-Romagna,Emilia-Romagna,4459477,729073,16.35,0.41
833,2021-04-01,EMR,23716,10673,13043,1009,258,117,990,220,4254,11281,5296,171,120,19252,4464,ITH,ITH5,8,Emilia-Romagna,Emilia-Romagna,4459477,752789,16.88,0.53
834,2021-01-19,EMR,2033,500,1533,745,131,1153,0,0,0,0,0,0,4,2016,17,ITH,ITH5,8,Emilia-Romagna,Emilia-Romagna,4459477,754822,16.93,0.05
835,2021-01-18,EMR,3126,879,2247,1681,239,1129,0,12,0,3,0,0,62,2449,677,ITH,ITH5,8,Emilia-Romagna,Emilia-Romagna,4459477,757948,17.0,0.07
836,2021-01-03,EMR,2753,941,1812,2503,61,170,0,3,0,0,0,0,16,2753,0,ITH,ITH5,8,Emilia-Romagna,Emilia-Romagna,4459477,760701,17.06,0.06
837,2021-01-04,EMR,7267,2513,4754,6172,347,578,0,16,9,43,0,1,101,7267,0,ITH,ITH5,8,Emilia-Romagna,Emilia-Romagna,4459477,767968,17.22,0.16
838,2021-03-08,EMR,11986,4951,7035,2303,609,322,2339,19,39,4321,82,1807,145,9319,2667,ITH,ITH5,8,Emilia-Romagna,Emilia-Romagna,4459477,779954,17.49,0.27
839,2021-01-15,EMR,7703,2394,5309,5300,942,1318,1,15,3,37,0,0,87,7703,0,ITH,ITH5,8,Emilia-Romagna,Emilia-Romagna,4459477,787657,17.66,0.17
840,2021-03-30,EMR,23234,10275,12959,868,244,163,1175,130,5433,10701,4254,140,126,18197,5037,ITH,ITH5,8,Emilia-Romagna,Emilia-Romagna,4459477,810891,18.18,0.52
841,2021-01-29,EMR,10403,3494,6909,8104,1084,1058,0,32,7,11,0,0,107,291,10112,ITH,ITH5,8,Emilia-Romagna,Emilia-Romagna,4459477,821294,18.42,0.23
842,2021-02-12,EMR,5314,1676,3638,3395,772,704,0,10,19,358,11,0,45,3912,1402,ITH,ITH5,8,Emilia-Romagna,Emilia-Romagna,4459477,826608,18.54,0.12
843,2021-04-09,EMR,25211,11431,13780,1353,283,168,434,263,4858,10642,7096,83,31,19626,5585,ITH,ITH5,8,Emilia-Romagna,Emilia-Romagna,4459477,851819,19.1,0.57
844,2021-04-15,EMR,28276,13466,14810,912,204,113,46,297,9866,5771,10909,34,124,18893,9383,ITH,ITH5,8,Emilia-Romagna,Emilia-Romagna,4459477,880095,19.74,0.63
845,2021-03-01,EMR,10050,3569,6481,1824,324,431,1253,25,37,5617,65,311,163,7805,2245,ITH,ITH5,8,Emilia-Romagna,Emilia-Romagna,4459477,890145,19.96,0.23
846,2021-02-18,EMR,7039,2892,4147,894,180,236,0,4,13,5672,26,1,13,6456,583,ITH,ITH5,8,Emilia-Romagna,Emilia-Romagna,4459477,897184,20.12,0.16
847,2021-03-31,EMR,24901,10848,14053,1169,284,122,1286,188,4673,12348,4533,160,138,19487,5414,ITH,ITH5,8,Emilia-Romagna,Emilia-Romagna,4459477,922085,20.68,0.56
848,2021-01-09,EMR,9935,3438,6497,7860,1066,889,0,18,2,2,0,0,98,9935,0,ITH,ITH5,8,Emilia-Romagna,Emilia-Romagna,4459477,932020,20.9,0.22
849,2021-02-17,EMR,6537,2764,3773,803,258,404,0,10,15,4990,24,0,33,5764,773,ITH,ITH5,8,Emilia-Romagna,Emilia-Romagna,4459477,938557,21.05,0.15
850,2021-02-16,EMR,5734,2431,3303,742,339,437,0,8,7,4178,8,2,13,5204,530,ITH,ITH5,8,Emilia-Romagna,Emilia-Romagna,4459477,944291,21.17,0.13
851,2021-01-08,EMR,10826,3566,7260,8463,1131,1088,0,25,3,5,0,1,110,10826,0,ITH,ITH5,8,Emilia-Romagna,Emilia-Romagna,4459477,955117,21.42,0.24
852,2021-02-24,EMR,9295,3544,5751,651,153,228,63,50,29,7833,18,0,270,8419,876,ITH,ITH5,8,Emilia-Romagna,Emilia-Romagna,4459477,964412,21.63,0.21
853,2021-02-27,EMR,10950,3992,6958,1726,244,114,940,37,30,7755,8,0,96,9218,1732,ITH,ITH5,8,Emilia-Romagna,Emilia-Romagna,4459477,975362,21.87,0.25
854,2021-02-19,EMR,7321,3010,4311,820,214,257,0,4,18,5955,32,0,21,6808,513,ITH,ITH5,8,Emilia-Romagna,Emilia-Romagna,4459477,982683,22.04,0.16
855,2021-04-05,EMR,14776,6770,8006,280,82,6,243,75,2907,7536,3570,28,49,11894,2882,ITH,ITH5,8,Emilia-Romagna,Emilia-Romagna,4459477,997459,22.37,0.33
856,2021-02-21,EMR,4425,1700,2725,395,107,190,0,4,11,3685,18,0,15,3985,440,ITH,ITH5,8,Emilia-Romagna,Emilia-Romagna,4459477,1001884,22.47,0.1
857,2021-02-14,EMR,1400,378,1022,859,363,39,0,19,5,19,1,0,95,1280,120,ITH,ITH5,8,Emilia-Romagna,Emilia-Romagna,4459477,1003284,22.5,0.03
858,2021-02-28,EMR,6822,2527,4295,1775,248,53,304,29,17,4251,8,4,133,4977,1845,ITH,ITH5,8,Emilia-Romagna,Emilia-Romagna,4459477,1010106,22.65,0.15
859,2021-03-26,EMR,23338,9869,13469,1416,592,218,2628,175,4777,9334,3781,276,141,16927,6411,ITH,ITH5,8,Emilia-Romagna,Emilia-Romagna,4459477,1033444,23.17,0.52
860,2021-02-09,EMR,4150,1245,2905,2218,376,1198,0,2,15,278,0,0,63,2305,1845,ITH,ITH5,8,Emilia-Romagna,Emilia-Romagna,4459477,1037594,23.27,0.09
861,2021-01-20,EMR,1321,269,1052,391,131,787,0,0,0,1,0,0,11,1320,1,ITH,ITH5,8,Emilia-Romagna,Emilia-Romagna,4459477,1038915,23.3,0.03
862,2021-01-02,EMR,2352,905,1447,2074,57,198,0,3,0,2,0,0,18,2352,0,ITH,ITH5,8,Emilia-Romagna,Emilia-Romagna,4459477,1041267,23.35,0.05
863,2020-12-27,EMR,969,372,597,824,5,26,0,24,1,0,0,0,89,969,0,ITH,ITH5,8,Emilia-Romagna,Emilia-Romagna,4459477,1042236,23.37,0.02
864,2021-01-05,EMR,9346,3167,6179,7927,552,770,0,18,4,0,1,0,74,9346,0,ITH,ITH5,8,Emilia-Romagna,Emilia-Romagna,4459477,1051582,23.58,0.21
865,2021-03-11,EMR,17190,7106,10084,1133,836,319,3815,35,52,8851,425,1530,194,11339,5851,ITH,ITH5,8,Emilia-Romagna,Emilia-Romagna,4459477,1068772,23.97,0.39
866,2021-03-18,EMR,13650,5797,7853,448,150,93,49,47,475,10842,1350,5,191,5654,7996,ITH,ITH5,8,Emilia-Romagna,Emilia-Romagna,4459477,1082422,24.27,0.31
867,2021-01-07,EMR,10215,3384,6831,8187,855,1068,0,20,5,3,0,0,77,10215,0,ITH,ITH5,8,Emilia-Romagna,Emilia-Romagna,4459477,1092637,24.5,0.23
868,2021-02-23,EMR,8214,3218,4996,409,147,113,1,24,22,7455,23,0,20,7828,386,ITH,ITH5,8,Emilia-Romagna,Emilia-Romagna,4459477,1100851,24.69,0.18
869,2021-04-07,EMR,25601,11636,13965,661,186,141,360,392,5654,12949,5078,78,102,19633,5968,ITH,ITH5,8,Emilia-Romagna,Emilia-Romagna,4459477,1126452,25.26,0.57
870,2021-01-28,EMR,10233,3333,6900,8071,860,1124,0,27,10,0,0,0,141,352,9881,ITH,ITH5,8,Emilia-Romagna,Emilia-Romagna,4459477,1136685,25.49,0.23
871,2021-03-03,EMR,15753,5226,10527,2530,524,154,4809,50,48,6847,96,341,354,13295,2458,ITH,ITH5,8,Emilia-Romagna,Emilia-Romagna,4459477,1152438,25.84,0.35
872,2021-03-07,EMR,6847,2633,4214,1459,338,22,1249,10,14,2597,565,557,36,5330,1517,ITH,ITH5,8,Emilia-Romagna,Emilia-Romagna,4459477,1159285,26.0,0.15
873,2021-01-23,EMR,2446,870,1576,1902,86,430,0,5,1,2,0,0,20,443,2003,ITH,ITH5,8,Emilia-Romagna,Emilia-Romagna,4459477,1161731,26.05,0.05
874,2021-03-02,EMR,11732,3871,7861,1959,364,224,3046,42,40,5405,41,373,238,9732,2000,ITH,ITH5,8,Emilia-Romagna,Emilia-Romagna,4459477,1173463,26.31,0.26
875,2021-01-14,EMR,8093,2576,5517,5398,918,1606,0,39,7,5,1,1,118,8093,0,ITH,ITH5,8,Emilia-Romagna,Emilia-Romagna,4459477,1181556,26.5,0.18
876,2021-02-11,EMR,4245,1414,2831,2528,528,719,2,15,18,374,3,0,58,3406,839,ITH,ITH5,8,Emilia-Romagna,Emilia-Romagna,4459477,1185801,26.59,0.1
877,2021-04-14,EMR,26440,12567,13873,652,192,137,61,523,9950,7333,7515,54,23,20491,5949,ITH,ITH5,8,Emilia-Romagna,Emilia-Romagna,4459477,1212241,27.18,0.59
878,2021-03-13,EMR,16038,6298,9740,1250,479,81,3990,49,55,8275,567,1123,169,10728,5310,ITH,ITH5,8,Emilia-Romagna,Emilia-Romagna,4459477,1228279,27.54,0.36
879,2021-03-25,EMR,21297,9312,11985,1094,346,165,2085,156,3063,9918,3588,717,165,14358,6939,ITH,ITH5,8,Emilia-Romagna,Emilia-Romagna,4459477,1249576,28.02,0.48
880,2021-03-27,EMR,21509,9003,12506,752,290,48,2335,116,4193,9565,3813,237,160,14617,6892,ITH,ITH5,8,Emilia-Romagna,Emilia-Romagna,4459477,1271085,28.5,0.48
881,2021-03-09,EMR,14588,5932,8656,1024,456,227,3566,21,56,7680,184,1331,43,10636,3952,ITH,ITH5,8,Emilia-Romagna,Emilia-Romagna,4459477,1285673,28.83,0.33
882,2021-02-10,EMR,3998,1374,2624,2393,357,768,0,23,15,317,9,0,116,2756,1242,ITH,ITH5,8,Emilia-Romagna,Emilia-Romagna,4459477,1289671,28.92,0.09
883,2021-01-27,EMR,8355,2945,5410,6903,653,672,0,26,4,2,0,1,94,464,7891,ITH,ITH5,8,Emilia-Romagna,Emilia-Romagna,4459477,1298026,29.11,0.19
884,2021-02-20,EMR,5298,2087,3211,408,116,155,0,7,21,4572,5,0,14,5034,264,ITH,ITH5,8,Emilia-Romagna,Emilia-Romagna,4459477,1303324,29.23,0.12
885,2021-02-15,EMR,2895,847,2048,1983,369,157,0,3,9,326,18,0,30,2769,126,ITH,ITH5,8,Emilia-Romagna,Emilia-Romagna,4459477,1306219,29.29,0.06
886,2021-01-17,ABR,187,59,128,136,44,0,0,0,0,0,0,0,7,180,7,ITF,ITF1,13,Abruzzo,Abruzzo,1304970,187,0.01,0.01
887,2021-03-17,ABR,4545,1876,2669,285,102,144,11,19,33,3876,16,36,23,2802,1743,ITF,ITF1,13,Abruzzo,Abruzzo,1304970,4732,0.36,0.35
888,2021-02-28,ABR,1708,511,1197,23,6,0,1423,8,1,79,0,149,19,1706,2,ITF,ITF1,13,Abruzzo,Abruzzo,1304970,6440,0.49,0.13
889,2021-02-09,ABR,908,311,597,612,161,131,0,1,1,1,0,0,1,499,409,ITF,ITF1,13,Abruzzo,Abruzzo,1304970,7348,0.56,0.07
890,2021-02-04,ABR,1682,617,1065,1168,415,57,0,5,0,0,0,0,37,609,1073,ITF,ITF1,13,Abruzzo,Abruzzo,1304970,9030,0.69,0.13
891,2021-04-06,ABR,7687,3582,4105,433,98,44,54,115,499,2349,3943,46,106,5367,2320,ITF,ITF1,13,Abruzzo,Abruzzo,1304970,16717,1.28,0.59
892,2021-01-23,ABR,264,114,150,224,14,26,0,0,0,0,0,0,0,57,207,ITF,ITF1,13,Abruzzo,Abruzzo,1304970,16981,1.3,0.02
893,2021-03-22,ABR,4400,1959,2441,385,389,56,442,32,19,2578,10,346,143,2430,1970,ITF,ITF1,13,Abruzzo,Abruzzo,1304970,21381,1.64,0.34
894,2021-01-21,ABR,157,47,110,10,6,141,0,0,0,0,0,0,0,157,0,ITF,ITF1,13,Abruzzo,Abruzzo,1304970,21538,1.65,0.01
895,2021-03-28,ABR,2418,1019,1399,247,130,1,175,106,54,896,421,242,146,2046,372,ITF,ITF1,13,Abruzzo,Abruzzo,1304970,23956,1.84,0.19
896,2021-02-07,ABR,777,307,470,646,111,1,0,3,0,0,0,0,16,201,576,ITF,ITF1,13,Abruzzo,Abruzzo,1304970,24733,1.9,0.06
897,2021-03-29,ABR,5626,2525,3101,463,54,49,195,71,73,3615,907,63,136,2986,2640,ITF,ITF1,13,Abruzzo,Abruzzo,1304970,30359,2.33,0.43
898,2021-03-19,ABR,5796,2584,3212,755,280,118,13,14,42,4400,19,103,52,2775,3021,ITF,ITF1,13,Abruzzo,Abruzzo,1304970,36155,2.77,0.44
899,2021-02-15,ABR,1796,831,965,625,258,221,0,0,10,395,0,261,26,1754,42,ITF,ITF1,13,Abruzzo,Abruzzo,1304970,37951,2.91,0.14
900,2021-02-21,ABR,1221,551,670,2,0,3,0,0,2,1210,0,2,2,1220,1,ITF,ITF1,13,Abruzzo,Abruzzo,1304970,39172,3.0,0.09
901,2021-01-22,ABR,118,57,61,2,1,112,0,1,0,0,0,0,2,118,0,ITF,ITF1,13,Abruzzo,Abruzzo,1304970,39290,3.01,0.01
902,2021-02-26,ABR,3920,1671,2249,1025,336,160,262,64,11,1651,6,270,135,2951,969,ITF,ITF1,13,Abruzzo,Abruzzo,1304970,43210,3.31,0.3
903,2021-02-12,ABR,968,319,649,438,151,310,0,1,0,66,0,0,2,779,189,ITF,ITF1,13,Abruzzo,Abruzzo,1304970,44178,3.39,0.07
904,2021-03-06,ABR,4174,1354,2820,432,187,52,1559,29,8,1748,0,15,144,3604,570,ITF,ITF1,13,Abruzzo,Abruzzo,1304970,48352,3.71,0.32
905,2021-01-12,ABR,1804,666,1138,1470,190,0,0,23,33,28,0,0,60,1804,0,ITF,ITF1,13,Abruzzo,Abruzzo,1304970,50156,3.84,0.14
906,2021-03-21,ABR,2135,913,1222,9,0,1,130,7,9,1923,13,34,9,844,1291,ITF,ITF1,13,Abruzzo,Abruzzo,1304970,52291,4.01,0.16
907,2021-03-05,ABR,5262,1938,3324,561,218,108,1352,77,4,2582,2,232,126,4564,698,ITF,ITF1,13,Abruzzo,Abruzzo,1304970,57553,4.41,0.4
908,2021-03-18,ABR,3896,1651,2245,281,135,20,7,21,33,3297,4,68,30,2065,1831,ITF,ITF1,13,Abruzzo,Abruzzo,1304970,61449,4.71,0.3
909,2021-02-13,ABR,849,384,465,552,207,72,0,1,1,8,0,0,8,437,412,ITF,ITF1,13,Abruzzo,Abruzzo,1304970,62298,4.77,0.07
910,2021-03-01,ABR,3490,1393,2097,698,176,174,282,18,10,1915,2,131,84,2725,765,ITF,ITF1,13,Abruzzo,Abruzzo,1304970,65788,5.04,0.27
911,2021-03-03,ABR,4629,1883,2746,1222,211,105,855,28,0,1587,3,385,233,3723,906,ITF,ITF1,13,Abruzzo,Abruzzo,1304970,70417,5.4,0.35
912,2021-04-17,ABR,6642,3076,3566,347,212,21,62,169,323,1882,3555,27,44,4028,2614,ITF,ITF1,13,Abruzzo,Abruzzo,1304970,77059,5.91,0.51
913,2020-12-27,ABR,37,19,18,34,1,2,0,0,0,0,0,0,0,37,0,ITF,ITF1,13,Abruzzo,Abruzzo,1304970,77096,5.91,0.0
914,2021-03-08,ABR,5128,1670,3458,1190,280,116,2195,51,3,1032,0,105,156,4153,975,ITF,ITF1,13,Abruzzo,Abruzzo,1304970,82224,6.3,0.39
915,2021-03-31,ABR,6655,2882,3773,446,279,80,245,54,83,3258,2047,30,133,4587,2068,ITF,ITF1,13,Abruzzo,Abruzzo,1304970,88879,6.81,0.51
916,2021-03-10,ABR,4951,1640,3311,736,300,248,1872,27,4,1520,11,130,103,3994,957,ITF,ITF1,13,Abruzzo,Abruzzo,1304970,93830,7.19,0.38
917,2021-02-23,ABR,2784,1274,1510,324,184,217,100,4,8,1491,2,287,167,2773,11,ITF,ITF1,13,Abruzzo,Abruzzo,1304970,96614,7.4,0.21
918,2021-04-19,ABR,3838,1767,2071,49,60,35,10,47,1305,806,1440,21,65,2385,1453,ITF,ITF1,13,Abruzzo,Abruzzo,1304970,100452,7.7,0.29
919,2021-04-18,ABR,5305,2492,2813,148,59,21,19,57,128,660,4186,10,17,4646,659,ITF,ITF1,13,Abruzzo,Abruzzo,1304970,105757,8.1,0.41
920,2021-03-04,ABR,5937,2359,3578,1171,322,93,818,39,12,2992,5,329,156,5015,922,ITF,ITF1,13,Abruzzo,Abruzzo,1304970,111694,8.56,0.45
921,2021-03-23,ABR,4852,2210,2642,180,183,183,400,14,23,3356,13,422,78,2283,2569,ITF,ITF1,13,Abruzzo,Abruzzo,1304970,116546,8.93,0.37
922,2021-01-24,ABR,50,22,28,49,1,0,0,0,0,0,0,0,0,6,44,ITF,ITF1,13,Abruzzo,Abruzzo,1304970,116596,8.93,0.0
923,2021-01-31,ABR,1502,488,1014,1154,236,103,0,1,0,0,0,0,8,287,1215,ITF,ITF1,13,Abruzzo,Abruzzo,1304970,118098,9.05,0.12
924,2021-01-27,ABR,1364,515,849,1301,61,0,0,1,0,0,0,0,1,39,1325,ITF,ITF1,13,Abruzzo,Abruzzo,1304970,119462,9.15,0.1
925,2021-03-09,ABR,5172,1796,3376,990,311,86,2046,31,3,1320,69,214,102,4233,939,ITF,ITF1,13,Abruzzo,Abruzzo,1304970,124634,9.55,0.4
926,2021-01-04,ABR,1401,575,826,1396,5,0,0,0,0,0,0,0,0,1401,0,ITF,ITF1,13,Abruzzo,Abruzzo,1304970,126035,9.66,0.11
927,2021-03-11,ABR,5430,2191,3239,1328,265,241,1565,50,20,1539,16,247,159,4291,1139,ITF,ITF1,13,Abruzzo,Abruzzo,1304970,131465,10.07,0.42
928,2021-02-01,ABR,1632,573,1059,1384,228,1,0,3,0,0,0,0,16,271,1361,ITF,ITF1,13,Abruzzo,Abruzzo,1304970,133097,10.2,0.13
929,2021-01-20,ABR,447,156,291,147,73,204,0,12,0,0,0,0,11,445,2,ITF,ITF1,13,Abruzzo,Abruzzo,1304970,133544,10.23,0.03
930,2021-04-05,ABR,2696,1150,1546,136,205,4,16,31,41,1372,845,11,35,1816,880,ITF,ITF1,13,Abruzzo,Abruzzo,1304970,136240,10.44,0.21
931,2021-01-03,ABR,471,185,286,464,7,0,0,0,0,0,0,0,0,471,0,ITF,ITF1,13,Abruzzo,Abruzzo,1304970,136711,10.48,0.04
932,2021-03-15,ABR,3640,1399,2241,657,358,79,330,27,41,1964,2,55,127,1824,1816,ITF,ITF1,13,Abruzzo,Abruzzo,1304970,140351,10.76,0.28
933,2021-04-13,ABR,5726,2670,3056,92,61,78,149,83,402,1255,3527,31,48,4526,1200,ITF,ITF1,13,Abruzzo,Abruzzo,1304970,146077,11.19,0.44
934,2021-04-09,ABR,8681,4084,4597,312,120,32,45,101,805,3239,3892,40,95,6198,2483,ITF,ITF1,13,Abruzzo,Abruzzo,1304970,154758,11.86,0.67
935,2021-04-07,ABR,7121,3283,3838,187,214,82,15,69,106,3219,3056,96,77,4395,2726,ITF,ITF1,13,Abruzzo,Abruzzo,1304970,161879,12.4,0.55
936,2021-01-28,ABR,1433,495,938,1370,61,1,0,0,1,0,0,0,0,12,1421,ITF,ITF1,13,Abruzzo,Abruzzo,1304970,163312,12.51,0.11
937,2021-02-03,ABR,2061,717,1344,1541,362,118,0,4,0,0,0,0,36,419,1642,ITF,ITF1,13,Abruzzo,Abruzzo,1304970,165373,12.67,0.16
938,2021-01-19,ABR,111,55,56,27,3,50,0,8,0,0,0,0,23,91,20,ITF,ITF1,13,Abruzzo,Abruzzo,1304970,165484,12.68,0.01
939,2021-03-27,ABR,6119,2619,3500,189,229,48,216,87,157,4263,736,77,117,3640,2479,ITF,ITF1,13,Abruzzo,Abruzzo,1304970,171603,13.15,0.47
940,2021-01-13,ABR,1253,440,813,1103,99,0,0,7,1,7,0,0,36,1253,0,ITF,ITF1,13,Abruzzo,Abruzzo,1304970,172856,13.25,0.1
941,2021-03-07,ABR,2523,630,1893,28,99,4,1823,68,10,463,0,1,27,2523,0,ITF,ITF1,13,Abruzzo,Abruzzo,1304970,175379,13.44,0.19
942,2021-03-24,ABR,6424,2831,3593,485,300,231,430,108,230,3409,541,415,275,4168,2256,ITF,ITF1,13,Abruzzo,Abruzzo,1304970,181803,13.93,0.49
943,2021-03-30,ABR,5059,2199,2860,211,205,38,286,52,57,2744,1327,51,88,3234,1825,ITF,ITF1,13,Abruzzo,Abruzzo,1304970,186862,14.32,0.39
944,2021-03-25,ABR,5689,2563,3126,249,211,40,448,59,102,3823,239,311,207,3073,2616,ITF,ITF1,13,Abruzzo,Abruzzo,1304970,192551,14.76,0.44
945,2021-04-14,ABR,6133,2714,3419,334,93,119,59,77,410,1305,3680,13,43,4222,1911,ITF,ITF1,13,Abruzzo,Abruzzo,1304970,198684,15.23,0.47
946,2021-03-13,ABR,4254,1460,2794,539,624,138,1061,82,36,1468,6,106,194,3178,1076,ITF,ITF1,13,Abruzzo,Abruzzo,1304970,202938,15.55,0.33
947,2021-04-04,ABR,1625,766,859,94,57,2,4,8,280,446,717,2,15,1496,129,ITF,ITF1,13,Abruzzo,Abruzzo,1304970,204563,15.68,0.12
948,2021-03-26,ABR,5303,2269,3034,264,213,37,449,75,122,3389,357,252,145,3242,2061,ITF,ITF1,13,Abruzzo,Abruzzo,1304970,209866,16.08,0.41
949,2021-02-22,ABR,2644,1175,1469,477,275,46,251,4,4,1094,0,419,74,2614,30,ITF,ITF1,13,Abruzzo,Abruzzo,1304970,212510,16.28,0.2
950,2021-03-12,ABR,6024,1990,4034,1006,593,138,2189,46,11,1727,1,144,169,4441,1583,ITF,ITF1,13,Abruzzo,Abruzzo,1304970,218534,16.75,0.46
951,2021-04-02,ABR,6684,3094,3590,184,610,26,94,76,215,3306,2043,79,51,5197,1487,ITF,ITF1,13,Abruzzo,Abruzzo,1304970,225218,17.26,0.51
952,2021-01-16,ABR,927,428,499,710,188,15,0,4,0,0,0,0,10,927,0,ITF,ITF1,13,Abruzzo,Abruzzo,1304970,226145,17.33,0.07
953,2021-04-10,ABR,8275,3801,4474,389,300,12,147,222,957,2846,3228,30,144,5767,2508,ITF,ITF1,13,Abruzzo,Abruzzo,1304970,234420,17.96,0.63
954,2021-02-11,ABR,816,262,554,473,184,154,0,0,0,0,0,0,5,773,43,ITF,ITF1,13,Abruzzo,Abruzzo,1304970,235236,18.03,0.06
955,2021-03-16,ABR,3486,1453,2033,284,74,169,12,19,44,2850,6,8,20,1831,1655,ITF,ITF1,13,Abruzzo,Abruzzo,1304970,238722,18.29,0.27
956,2021-04-15,ABR,7373,3427,3946,200,91,88,52,84,301,1391,5091,22,53,5705,1668,ITF,ITF1,13,Abruzzo,Abruzzo,1304970,246095,18.86,0.56
957,2021-01-06,ABR,1830,664,1166,1546,148,133,0,0,0,0,0,0,3,1830,0,ITF,ITF1,13,Abruzzo,Abruzzo,1304970,247925,19.0,0.14
958,2021-04-03,ABR,5073,2213,2860,174,91,28,84,73,112,2401,1958,62,90,3479,1594,ITF,ITF1,13,Abruzzo,Abruzzo,1304970,252998,19.39,0.39
959,2021-01-05,ABR,1614,604,1010,1604,10,0,0,0,0,0,0,0,0,1614,0,ITF,ITF1,13,Abruzzo,Abruzzo,1304970,254612,19.51,0.12
960,2021-02-08,ABR,1201,398,803,710,218,264,0,1,0,0,0,0,8,491,710,ITF,ITF1,13,Abruzzo,Abruzzo,1304970,255813,19.6,0.09
961,2021-01-18,ABR,122,48,74,106,8,2,0,3,0,0,0,0,3,46,76,ITF,ITF1,13,Abruzzo,Abruzzo,1304970,255935,19.61,0.01
962,2021-04-01,ABR,5530,2450,3080,274,117,57,153,153,156,2912,1527,48,133,3441,2089,ITF,ITF1,13,Abruzzo,Abruzzo,1304970,261465,20.04,0.42
963,2021-01-15,ABR,379,149,230,223,79,35,0,7,2,0,0,0,33,379,0,ITF,ITF1,13,Abruzzo,Abruzzo,1304970,261844,20.07,0.03
964,2021-02-27,ABR,2809,1337,1472,253,84,125,874,17,6,732,1,656,61,2543,266,ITF,ITF1,13,Abruzzo,Abruzzo,1304970,264653,20.28,0.22
965,2021-02-24,ABR,3304,1440,1864,391,180,248,131,13,12,1969,4,247,109,3128,176,ITF,ITF1,13,Abruzzo,Abruzzo,1304970,267957,20.53,0.25
966,2021-01-29,ABR,1386,449,937,1290,95,0,0,1,0,0,0,0,0,74,1312,ITF,ITF1,13,Abruzzo,Abruzzo,1304970,269343,20.64,0.11
967,2021-04-11,ABR,5073,2461,2612,15,8,7,5,92,611,777,3501,6,51,4590,483,ITF,ITF1,13,Abruzzo,Abruzzo,1304970,274416,21.03,0.39
968,2021-01-25,ABR,1604,633,971,1584,19,0,0,0,0,0,0,0,1,20,1584,ITF,ITF1,13,Abruzzo,Abruzzo,1304970,276020,21.15,0.12
969,2021-02-17,ABR,2077,952,1125,512,144,394,1,0,22,718,0,210,76,1794,283,ITF,ITF1,13,Abruzzo,Abruzzo,1304970,278097,21.31,0.16
970,2021-03-20,ABR,4733,2159,2574,318,206,63,97,50,99,3653,45,99,103,2569,2164,ITF,ITF1,13,Abruzzo,Abruzzo,1304970,282830,21.67,0.36
971,2021-04-12,ABR,6093,2879,3214,216,66,46,36,194,505,1253,3677,19,81,4974,1119,ITF,ITF1,13,Abruzzo,Abruzzo,1304970,288923,22.14,0.47
972,2021-01-07,ABR,1603,552,1051,1566,37,0,0,0,0,0,0,0,0,1603,0,ITF,ITF1,13,Abruzzo,Abruzzo,1304970,290526,22.26,0.12
973,2021-01-09,ABR,1483,565,918,1430,50,0,0,1,0,0,0,0,2,1483,0,ITF,ITF1,13,Abruzzo,Abruzzo,1304970,292009,22.38,0.11
974,2021-01-08,ABR,1525,507,1018,1487,36,0,0,1,1,0,0,0,0,1525,0,ITF,ITF1,13,Abruzzo,Abruzzo,1304970,293534,22.49,0.12
975,2021-02-18,ABR,2291,934,1357,670,297,417,0,3,5,612,0,215,72,2161,130,ITF,ITF1,13,Abruzzo,Abruzzo,1304970,295825,22.67,0.18
976,2021-02-19,ABR,3301,1552,1749,990,346,371,8,10,9,1113,1,402,51,3201,100,ITF,ITF1,13,Abruzzo,Abruzzo,1304970,299126,22.92,0.25
977,2021-02-16,ABR,1978,869,1109,841,278,139,0,4,2,561,0,75,78,1966,12,ITF,ITF1,13,Abruzzo,Abruzzo,1304970,301104,23.07,0.15
978,2021-01-14,ABR,530,189,341,364,114,0,0,4,5,34,0,0,9,530,0,ITF,ITF1,13,Abruzzo,Abruzzo,1304970,301634,23.11,0.04
979,2021-01-26,ABR,1542,567,975,1513,29,0,0,0,0,0,0,0,0,29,1513,ITF,ITF1,13,Abruzzo,Abruzzo,1304970,303176,23.23,0.12
980,2021-02-25,ABR,3086,1347,1739,615,398,57,126,28,6,1508,2,262,84,2558,528,ITF,ITF1,13,Abruzzo,Abruzzo,1304970,306262,23.47,0.24
981,2021-02-10,ABR,948,313,635,622,182,116,0,5,0,0,0,0,23,504,444,ITF,ITF1,13,Abruzzo,Abruzzo,1304970,307210,23.54,0.07
982,2021-02-20,ABR,4782,1843,2939,310,444,193,1887,5,12,1417,1,406,107,4706,76,ITF,ITF1,13,Abruzzo,Abruzzo,1304970,311992,23.91,0.37
983,2021-01-10,ABR,1139,409,730,1091,44,0,0,0,0,0,0,0,4,1139,0,ITF,ITF1,13,Abruzzo,Abruzzo,1304970,313131,24.0,0.09
984,2021-03-14,ABR,1895,733,1162,8,3,0,249,20,7,1489,0,2,117,1228,667,ITF,ITF1,13,Abruzzo,Abruzzo,1304970,315026,24.14,0.15
985,2021-02-05,ABR,1536,521,1015,1188,188,107,0,9,0,0,0,0,44,789,747,ITF,ITF1,13,Abruzzo,Abruzzo,1304970,316562,24.26,0.12
986,2021-04-16,ABR,7157,3300,3857,156,74,45,32,166,249,1431,4952,11,41,5490,1667,ITF,ITF1,13,Abruzzo,Abruzzo,1304970,323719,24.81,0.55
987,2021-01-30,ABR,1510,567,943,1349,112,47,0,0,0,0,0,0,2,69,1441,ITF,ITF1,13,Abruzzo,Abruzzo,1304970,325229,24.92,0.12
988,2021-01-02,ABR,548,218,330,540,5,0,0,0,0,0,0,0,3,548,0,ITF,ITF1,13,Abruzzo,Abruzzo,1304970,325777,24.96,0.04
989,2021-02-06,ABR,1611,742,869,1168,278,72,0,14,7,2,0,0,70,602,1009,ITF,ITF1,13,Abruzzo,Abruzzo,1304970,327388,25.09,0.12
990,2021-01-11,ABR,1551,557,994,1337,152,48,0,3,0,0,0,0,11,1551,0,ITF,ITF1,13,Abruzzo,Abruzzo,1304970,328939,25.21,0.12
991,2021-03-02,ABR,3964,1676,2288,934,220,53,405,82,3,1857,2,299,109,3280,684,ITF,ITF1,13,Abruzzo,Abruzzo,1304970,332903,25.51,0.3
992,2021-04-08,ABR,7350,3321,4029,156,83,73,203,70,409,2633,3627,45,51,5069,2281,ITF,ITF1,13,Abruzzo,Abruzzo,1304970,340253,26.07,0.56
993,2021-02-02,ABR,1798,677,1121,1243,404,142,0,1,0,0,0,0,8,241,1557,ITF,ITF1,13,Abruzzo,Abruzzo,1304970,342051,26.21,0.14
994,2021-01-30,PAT,386,132,254,346,7,32,1,0,0,0,0,0,0,152,234,ITH,ITH2,4,Provincia Autonoma Trento,P.A. Trento,541380,386,0.07,0.07
995,2021-03-05,PAT,2226,700,1526,126,70,102,774,5,24,956,1,158,10,1661,565,ITH,ITH2,4,Provincia Autonoma Trento,P.A. Trento,541380,2612,0.48,0.41
996,2021-01-14,PAT,699,203,496,482,6,208,0,0,0,0,0,0,3,699,0,ITH,ITH2,4,Provincia Autonoma Trento,P.A. Trento,541380,3311,0.61,0.13
997,2021-01-24,PAT,547,276,271,535,12,0,0,0,0,0,0,0,0,224,323,ITH,ITH2,4,Provincia Autonoma Trento,P.A. Trento,541380,3858,0.71,0.1
998,2021-03-15,PAT,1399,540,859,58,128,26,175,2,283,618,15,54,40,942,457,ITH,ITH2,4,Provincia Autonoma Trento,P.A. Trento,541380,5257,0.97,0.26
999,2021-01-21,PAT,351,94,257,320,13,16,0,0,0,0,0,0,2,228,123,ITH,ITH2,4,Provincia Autonoma Trento,P.A. Trento,541380,5608,1.04,0.06
1000,2021-03-04,PAT,2351,790,1561,161,24,23,347,14,12,1727,0,19,24,1572,779,ITH,ITH2,4,Provincia Autonoma Trento,P.A. Trento,541380,7959,1.47,0.43
1001,2021-03-21,PAT,129,69,60,34,1,0,18,2,18,0,56,0,0,129,0,ITH,ITH2,4,Provincia Autonoma Trento,P.A. Trento,541380,8088,1.49,0.02
1002,2021-04-14,PAT,3088,1458,1630,115,50,6,7,97,1484,1004,308,2,15,2363,725,ITH,ITH2,4,Provincia Autonoma Trento,P.A. Trento,541380,11176,2.06,0.57
1003,2021-03-03,PAT,1653,621,1032,74,11,59,203,4,5,1267,2,19,9,1136,517,ITH,ITH2,4,Provincia Autonoma Trento,P.A. Trento,541380,12829,2.37,0.31
1004,2021-04-05,PAT,33,16,17,0,0,0,1,21,11,0,0,0,0,33,0,ITH,ITH2,4,Provincia Autonoma Trento,P.A. Trento,541380,12862,2.38,0.01
1005,2021-04-19,PAT,2037,947,1090,27,9,0,2,457,719,258,543,1,21,2014,23,ITH,ITH2,4,Provincia Autonoma Trento,P.A. Trento,541380,14899,2.75,0.38
1006,2021-02-23,PAT,1108,395,713,272,13,17,50,1,0,751,0,3,1,897,211,ITH,ITH2,4,Provincia Autonoma Trento,P.A. Trento,541380,16007,2.96,0.2
1007,2021-01-13,PAT,421,123,298,392,6,23,0,0,0,0,0,0,0,421,0,ITH,ITH2,4,Provincia Autonoma Trento,P.A. Trento,541380,16428,3.03,0.08
1008,2021-03-07,PAT,22,6,16,0,0,0,22,0,0,0,0,0,0,22,0,ITH,ITH2,4,Provincia Autonoma Trento,P.A. Trento,541380,16450,3.04,0.0
1009,2021-01-27,PAT,802,277,525,463,33,304,0,0,0,1,0,0,1,91,711,ITH,ITH2,4,Provincia Autonoma Trento,P.A. Trento,541380,17252,3.19,0.15
1010,2021-01-29,PAT,1352,331,1021,724,74,542,0,0,0,3,0,0,9,55,1297,ITH,ITH2,4,Provincia Autonoma Trento,P.A. Trento,541380,18604,3.44,0.25
1011,2021-04-15,PAT,3094,1406,1688,179,111,16,3,129,1508,452,679,1,16,2974,120,ITH,ITH2,4,Provincia Autonoma Trento,P.A. Trento,541380,21698,4.01,0.57
1012,2021-03-18,PAT,2275,944,1331,63,1,2,3,9,530,1640,16,2,9,1202,1073,ITH,ITH2,4,Provincia Autonoma Trento,P.A. Trento,541380,23973,4.43,0.42
1013,2021-02-13,PAT,536,333,203,373,4,0,0,1,0,158,0,0,0,171,365,ITH,ITH2,4,Provincia Autonoma Trento,P.A. Trento,541380,24509,4.53,0.1
1014,2021-03-27,PAT,1609,705,904,270,362,0,164,12,351,61,227,135,27,1357,252,ITH,ITH2,4,Provincia Autonoma Trento,P.A. Trento,541380,26118,4.82,0.3
1015,2021-02-12,PAT,1010,340,670,335,54,55,0,2,9,553,0,0,2,589,421,ITH,ITH2,4,Provincia Autonoma Trento,P.A. Trento,541380,27128,5.01,0.19
1016,2021-03-20,PAT,868,399,469,154,97,0,69,0,341,77,127,0,3,667,201,ITH,ITH2,4,Provincia Autonoma Trento,P.A. Trento,541380,27996,5.17,0.16
1017,2021-03-10,PAT,2398,925,1473,354,36,25,316,4,10,1421,2,221,9,1477,921,ITH,ITH2,4,Provincia Autonoma Trento,P.A. Trento,541380,30394,5.61,0.44
1018,2021-01-09,PAT,190,40,150,146,13,31,0,0,0,0,0,0,0,190,0,ITH,ITH2,4,Provincia Autonoma Trento,P.A. Trento,541380,30584,5.65,0.04
1019,2021-03-08,PAT,1397,433,964,65,15,0,277,2,6,1016,1,7,8,1044,353,ITH,ITH2,4,Provincia Autonoma Trento,P.A. Trento,541380,31981,5.91,0.26
1020,2021-03-29,PAT,2429,953,1476,93,30,5,91,32,800,990,99,4,285,1695,734,ITH,ITH2,4,Provincia Autonoma Trento,P.A. Trento,541380,34410,6.36,0.45
1021,2021-04-17,PAT,2200,1118,1082,13,2,0,0,146,1502,77,449,0,11,2143,57,ITH,ITH2,4,Provincia Autonoma Trento,P.A. Trento,541380,36610,6.76,0.41
1022,2021-01-22,PAT,1668,433,1235,904,121,631,3,3,5,1,0,0,0,329,1339,ITH,ITH2,4,Provincia Autonoma Trento,P.A. Trento,541380,38278,7.07,0.31
1023,2021-02-16,PAT,663,244,419,73,2,3,10,0,8,563,0,0,4,658,5,ITH,ITH2,4,Provincia Autonoma Trento,P.A. Trento,541380,38941,7.19,0.12
1024,2021-02-24,PAT,1318,523,795,236,5,29,66,4,2,974,1,1,0,922,396,ITH,ITH2,4,Provincia Autonoma Trento,P.A. Trento,541380,40259,7.44,0.24
1025,2021-01-23,PAT,577,334,243,487,2,88,0,0,0,0,0,0,0,388,189,ITH,ITH2,4,Provincia Autonoma Trento,P.A. Trento,541380,40836,7.54,0.11
1026,2021-03-17,PAT,2064,792,1272,399,15,55,10,4,279,1259,23,1,19,1191,873,ITH,ITH2,4,Provincia Autonoma Trento,P.A. Trento,541380,42900,7.92,0.38
1027,2021-03-02,PAT,1301,440,861,137,16,55,146,4,9,925,1,1,7,925,376,ITH,ITH2,4,Provincia Autonoma Trento,P.A. Trento,541380,44201,8.16,0.24
1028,2021-02-26,PAT,1218,435,783,250,12,19,105,3,2,823,0,1,3,923,295,ITH,ITH2,4,Provincia Autonoma Trento,P.A. Trento,541380,45419,8.39,0.22
1029,2021-04-07,PAT,2548,999,1549,258,27,29,101,19,630,1330,130,9,15,1631,917,ITH,ITH2,4,Provincia Autonoma Trento,P.A. Trento,541380,47967,8.86,0.47
1030,2021-04-08,PAT,3068,1280,1788,182,25,46,38,57,1020,1373,307,3,17,1981,1087,ITH,ITH2,4,Provincia Autonoma Trento,P.A. Trento,541380,51035,9.43,0.57
1031,2021-03-13,PAT,829,380,449,203,15,30,259,0,0,44,0,278,0,781,48,ITH,ITH2,4,Provincia Autonoma Trento,P.A. Trento,541380,51864,9.58,0.15
1032,2021-01-08,PAT,1449,313,1136,775,128,530,0,0,7,7,0,0,2,1449,0,ITH,ITH2,4,Provincia Autonoma Trento,P.A. Trento,541380,53313,9.85,0.27
1033,2021-04-11,PAT,2332,1131,1201,45,57,8,175,26,1754,21,233,7,6,2241,91,ITH,ITH2,4,Provincia Autonoma Trento,P.A. Trento,541380,55645,10.28,0.43
1034,2020-12-31,PAT,1624,449,1175,841,105,676,0,0,1,1,0,0,0,1624,0,ITH,ITH2,4,Provincia Autonoma Trento,P.A. Trento,541380,57269,10.58,0.3
1035,2021-02-15,PAT,533,187,346,145,21,27,11,1,1,322,0,0,5,419,114,ITH,ITH2,4,Provincia Autonoma Trento,P.A. Trento,541380,57802,10.68,0.1
1036,2021-03-01,PAT,1237,454,783,74,1,10,95,5,8,1037,0,3,4,942,295,ITH,ITH2,4,Provincia Autonoma Trento,P.A. Trento,541380,59039,10.91,0.23
1037,2021-02-09,PAT,914,287,627,447,8,73,0,2,1,381,0,0,2,441,473,ITH,ITH2,4,Provincia Autonoma Trento,P.A. Trento,541380,59953,11.07,0.17
1038,2021-03-06,PAT,773,277,496,362,11,0,195,3,0,195,0,5,2,622,151,ITH,ITH2,4,Provincia Autonoma Trento,P.A. Trento,541380,60726,11.22,0.14
1039,2021-01-06,PAT,42,13,29,42,0,0,0,0,0,0,0,0,0,42,0,ITH,ITH2,4,Provincia Autonoma Trento,P.A. Trento,541380,60768,11.22,0.01
1040,2021-01-18,PAT,642,154,488,528,35,73,0,1,0,1,0,0,4,587,55,ITH,ITH2,4,Provincia Autonoma Trento,P.A. Trento,541380,61410,11.34,0.12
1041,2021-01-05,PAT,709,232,477,495,46,162,0,1,1,0,0,0,4,709,0,ITH,ITH2,4,Provincia Autonoma Trento,P.A. Trento,541380,62119,11.47,0.13
1042,2021-03-26,PAT,3136,1222,1914,136,178,108,553,30,1094,890,63,46,38,2548,588,ITH,ITH2,4,Provincia Autonoma Trento,P.A. Trento,541380,65255,12.05,0.58
1043,2021-02-06,PAT,574,298,276,179,0,0,0,1,0,391,0,0,3,433,141,ITH,ITH2,4,Provincia Autonoma Trento,P.A. Trento,541380,65829,12.16,0.11
1044,2021-02-21,PAT,155,92,63,154,0,0,1,0,0,0,0,0,0,43,112,ITH,ITH2,4,Provincia Autonoma Trento,P.A. Trento,541380,65984,12.19,0.03
1045,2021-01-20,PAT,290,72,218,231,10,48,0,0,0,0,0,0,1,278,12,ITH,ITH2,4,Provincia Autonoma Trento,P.A. Trento,541380,66274,12.24,0.05
1046,2021-01-02,PAT,502,143,359,336,21,141,0,0,0,3,0,0,1,502,0,ITH,ITH2,4,Provincia Autonoma Trento,P.A. Trento,541380,66776,12.33,0.09
1047,2021-04-01,PAT,2870,1223,1647,192,137,8,125,35,501,1623,120,24,105,1796,1074,ITH,ITH2,4,Provincia Autonoma Trento,P.A. Trento,541380,69646,12.86,0.53
1048,2021-03-11,PAT,2282,847,1435,105,50,41,391,8,13,1576,22,59,17,1470,812,ITH,ITH2,4,Provincia Autonoma Trento,P.A. Trento,541380,71928,13.29,0.42
1049,2021-02-02,PAT,907,240,667,507,33,189,0,2,5,170,0,0,1,190,717,ITH,ITH2,4,Provincia Autonoma Trento,P.A. Trento,541380,72835,13.45,0.17
1050,2021-01-11,PAT,729,221,508,522,49,153,0,1,0,0,0,0,4,729,0,ITH,ITH2,4,Provincia Autonoma Trento,P.A. Trento,541380,73564,13.59,0.13
1051,2021-04-18,PAT,1851,843,1008,10,53,4,3,1025,508,23,217,0,8,1843,8,ITH,ITH2,4,Provincia Autonoma Trento,P.A. Trento,541380,75415,13.93,0.34
1052,2021-01-15,PAT,594,131,463,463,18,111,0,0,1,0,0,0,1,594,0,ITH,ITH2,4,Provincia Autonoma Trento,P.A. Trento,541380,76009,14.04,0.11
1053,2021-02-17,PAT,1110,425,685,326,9,35,12,3,11,709,0,3,2,1020,90,ITH,ITH2,4,Provincia Autonoma Trento,P.A. Trento,541380,77119,14.24,0.21
1054,2021-03-23,PAT,2426,938,1488,145,111,71,162,7,843,1002,35,34,16,1695,731,ITH,ITH2,4,Provincia Autonoma Trento,P.A. Trento,541380,79545,14.69,0.45
1055,2021-03-24,PAT,2360,935,1425,206,89,42,224,6,236,1440,65,42,10,1541,819,ITH,ITH2,4,Provincia Autonoma Trento,P.A. Trento,541380,81905,15.13,0.44
1056,2020-12-27,PAT,103,40,63,76,4,21,0,0,0,0,0,0,2,103,0,ITH,ITH2,4,Provincia Autonoma Trento,P.A. Trento,541380,82008,15.15,0.02
1057,2021-03-14,PAT,107,65,42,102,0,0,5,0,0,0,0,0,0,20,87,ITH,ITH2,4,Provincia Autonoma Trento,P.A. Trento,541380,82115,15.17,0.02
1058,2021-01-10,PAT,84,19,65,54,18,12,0,0,0,0,0,0,0,84,0,ITH,ITH2,4,Provincia Autonoma Trento,P.A. Trento,541380,82199,15.18,0.02
1059,2021-01-31,PAT,75,15,60,55,13,6,0,1,0,0,0,0,0,1,74,ITH,ITH2,4,Provincia Autonoma Trento,P.A. Trento,541380,82274,15.2,0.01
1060,2021-02-10,PAT,850,290,560,310,7,51,0,1,0,481,0,0,0,509,341,ITH,ITH2,4,Provincia Autonoma Trento,P.A. Trento,541380,83124,15.35,0.16
1061,2021-04-02,PAT,2741,1132,1609,148,65,44,292,58,1165,668,133,15,153,2096,645,ITH,ITH2,4,Provincia Autonoma Trento,P.A. Trento,541380,85865,15.86,0.51
1062,2021-01-12,PAT,504,158,346,418,25,61,0,0,0,0,0,0,0,504,0,ITH,ITH2,4,Provincia Autonoma Trento,P.A. Trento,541380,86369,15.95,0.09
1063,2021-01-01,PAT,213,50,163,114,11,88,0,0,0,0,0,0,0,213,0,ITH,ITH2,4,Provincia Autonoma Trento,P.A. Trento,541380,86582,15.99,0.04
1064,2021-02-11,PAT,1132,365,767,332,3,48,0,0,5,739,0,0,5,796,336,ITH,ITH2,4,Provincia Autonoma Trento,P.A. Trento,541380,87714,16.2,0.21
1065,2021-03-09,PAT,1568,584,984,98,44,31,199,2,8,1092,1,92,1,934,634,ITH,ITH2,4,Provincia Autonoma Trento,P.A. Trento,541380,89282,16.49,0.29
1066,2021-04-12,PAT,3025,1379,1646,135,29,27,364,74,1314,724,316,12,30,2540,485,ITH,ITH2,4,Provincia Autonoma Trento,P.A. Trento,541380,92307,17.05,0.56
1067,2021-02-01,PAT,1220,335,885,767,70,375,0,1,1,0,0,0,6,92,1128,ITH,ITH2,4,Provincia Autonoma Trento,P.A. Trento,541380,93527,17.28,0.23
1068,2021-03-12,PAT,2476,927,1549,207,253,106,552,9,26,1109,5,203,6,1672,804,ITH,ITH2,4,Provincia Autonoma Trento,P.A. Trento,541380,96003,17.73,0.46
1069,2021-01-07,PAT,1270,310,960,649,46,557,0,1,4,13,0,0,0,1270,0,ITH,ITH2,4,Provincia Autonoma Trento,P.A. Trento,541380,97273,17.97,0.23
1070,2021-02-27,PAT,1024,455,569,459,5,2,113,0,2,434,0,4,5,604,420,ITH,ITH2,4,Provincia Autonoma Trento,P.A. Trento,541380,98297,18.16,0.19
1071,2021-02-20,PAT,406,245,161,330,10,30,31,0,0,1,0,3,1,122,284,ITH,ITH2,4,Provincia Autonoma Trento,P.A. Trento,541380,98703,18.23,0.07
1072,2021-01-25,PAT,817,215,602,524,27,263,0,0,0,2,0,0,1,23,794,ITH,ITH2,4,Provincia Autonoma Trento,P.A. Trento,541380,99520,18.38,0.15
1073,2021-02-08,PAT,1150,318,832,550,53,237,1,1,4,303,0,0,1,342,808,ITH,ITH2,4,Provincia Autonoma Trento,P.A. Trento,541380,100670,18.6,0.21
1074,2021-03-31,PAT,2547,983,1564,142,34,5,227,26,480,1474,101,6,52,1690,857,ITH,ITH2,4,Provincia Autonoma Trento,P.A. Trento,541380,103217,19.07,0.47
1075,2021-02-04,PAT,972,304,668,543,10,89,0,1,2,325,0,0,2,420,552,ITH,ITH2,4,Provincia Autonoma Trento,P.A. Trento,541380,104189,19.25,0.18
1076,2021-02-05,PAT,802,271,531,467,19,66,0,1,0,248,0,0,1,283,519,ITH,ITH2,4,Provincia Autonoma Trento,P.A. Trento,541380,104991,19.39,0.15
1077,2021-04-10,PAT,2788,1304,1484,21,8,1,187,42,2183,67,257,11,11,1994,794,ITH,ITH2,4,Provincia Autonoma Trento,P.A. Trento,541380,107779,19.91,0.51
1078,2021-03-22,PAT,2282,969,1313,82,132,8,103,11,849,972,61,38,26,1407,875,ITH,ITH2,4,Provincia Autonoma Trento,P.A. Trento,541380,110061,20.33,0.42
1079,2021-01-17,PAT,251,195,56,251,0,0,0,0,0,0,0,0,0,251,0,ITH,ITH2,4,Provincia Autonoma Trento,P.A. Trento,541380,110312,20.38,0.05
1080,2021-04-16,PAT,2732,1291,1441,79,28,22,8,222,1227,350,765,2,29,2595,137,ITH,ITH2,4,Provincia Autonoma Trento,P.A. Trento,541380,113044,20.88,0.5
1081,2021-01-16,PAT,319,148,171,304,0,15,0,0,0,0,0,0,0,319,0,ITH,ITH2,4,Provincia Autonoma Trento,P.A. Trento,541380,113363,20.94,0.06
1082,2021-02-18,PAT,1205,426,779,300,25,35,55,2,3,782,0,3,0,1143,62,ITH,ITH2,4,Provincia Autonoma Trento,P.A. Trento,541380,114568,21.16,0.22
1083,2021-02-28,PAT,242,121,121,231,0,0,11,0,0,0,0,0,0,242,0,ITH,ITH2,4,Provincia Autonoma Trento,P.A. Trento,541380,114810,21.21,0.04
1084,2021-04-06,PAT,2241,945,1296,39,6,9,101,11,850,1055,138,18,14,1488,753,ITH,ITH2,4,Provincia Autonoma Trento,P.A. Trento,541380,117051,21.62,0.41
1085,2021-03-28,PAT,746,290,456,18,413,0,2,9,18,8,167,107,4,743,3,ITH,ITH2,4,Provincia Autonoma Trento,P.A. Trento,541380,117797,21.76,0.14
1086,2021-04-03,PAT,1130,470,660,141,266,0,31,9,146,60,365,107,5,965,165,ITH,ITH2,4,Provincia Autonoma Trento,P.A. Trento,541380,118927,21.97,0.21
1087,2021-02-22,PAT,745,259,486,119,4,70,45,1,4,501,0,0,1,661,84,ITH,ITH2,4,Provincia Autonoma Trento,P.A. Trento,541380,119672,22.1,0.14
1088,2021-03-19,PAT,2410,911,1499,320,70,53,68,17,756,1055,50,2,19,1571,839,ITH,ITH2,4,Provincia Autonoma Trento,P.A. Trento,541380,122082,22.55,0.45
1089,2021-02-19,PAT,927,358,569,170,37,93,28,5,11,582,0,1,0,869,58,ITH,ITH2,4,Provincia Autonoma Trento,P.A. Trento,541380,123009,22.72,0.17
1090,2021-01-28,PAT,530,147,383,390,29,107,0,1,1,2,0,0,0,48,482,ITH,ITH2,4,Provincia Autonoma Trento,P.A. Trento,541380,123539,22.82,0.1
1091,2021-03-16,PAT,1390,505,885,221,7,36,4,1,24,1073,11,0,13,607,783,ITH,ITH2,4,Provincia Autonoma Trento,P.A. Trento,541380,124929,23.08,0.26
1092,2021-01-04,PAT,870,227,643,486,41,336,0,2,4,1,0,0,0,870,0,ITH,ITH2,4,Provincia Autonoma Trento,P.A. Trento,541380,125799,23.24,0.16
1093,2021-04-09,PAT,2671,1132,1539,86,27,27,195,60,1290,864,111,4,7,1504,1167,ITH,ITH2,4,Provincia Autonoma Trento,P.A. Trento,541380,128470,23.73,0.49
1094,2021-02-25,PAT,1639,642,997,120,9,32,93,2,3,1377,0,1,2,1199,440,ITH,ITH2,4,Provincia Autonoma Trento,P.A. Trento,541380,130109,24.03,0.3
1095,2021-01-03,PAT,492,160,332,419,9,63,0,0,0,0,0,0,1,492,0,ITH,ITH2,4,Provincia Autonoma Trento,P.A. Trento,541380,130601,24.12,0.09
1096,2021-01-19,PAT,405,77,328,365,3,36,0,0,0,0,0,0,1,405,0,ITH,ITH2,4,Provincia Autonoma Trento,P.A. Trento,541380,131006,24.2,0.07
1097,2021-02-03,PAT,846,314,532,356,13,73,0,1,2,400,0,0,1,414,432,ITH,ITH2,4,Provincia Autonoma Trento,P.A. Trento,541380,131852,24.35,0.16
1098,2021-02-14,PAT,246,186,60,246,0,0,0,0,0,0,0,0,0,11,235,ITH,ITH2,4,Provincia Autonoma Trento,P.A. Trento,541380,132098,24.4,0.05
1099,2021-04-13,PAT,2522,1041,1481,25,12,1,387,40,1217,677,141,2,20,2015,507,ITH,ITH2,4,Provincia Autonoma Trento,P.A. Trento,541380,134620,24.87,0.47
1100,2020-12-30,PAT,7,3,4,4,1,2,0,0,0,0,0,0,0,7,0,ITH,ITH2,4,Provincia Autonoma Trento,P.A. Trento,541380,134627,24.87,0.0
1101,2021-03-25,PAT,2846,1098,1748,183,140,28,357,33,630,1306,81,25,63,1798,1048,ITH,ITH2,4,Provincia Autonoma Trento,P.A. Trento,541380,137473,25.39,0.53
1102,2021-03-30,PAT,2379,970,1409,71,60,53,176,18,792,1048,94,9,58,1742,637,ITH,ITH2,4,Provincia Autonoma Trento,P.A. Trento,541380,139852,25.83,0.44
1103,2021-01-26,PAT,542,154,388,441,16,84,0,0,0,0,0,0,1,27,515,ITH,ITH2,4,Provincia Autonoma Trento,P.A. Trento,541380,140394,25.93,0.1
1104,2021-04-10,CAM,28337,13486,14851,259,61,90,734,333,7069,6314,12855,211,411,23422,4915,ITF,ITF3,15,Campania,Campania,5801692,28337,0.49,0.49
1105,2021-04-04,CAM,7941,4001,3940,177,28,6,73,46,1210,1996,4043,63,299,6898,1043,ITF,ITF3,15,Campania,Campania,5801692,36278,0.63,0.14
1106,2021-01-12,CAM,5214,2563,2651,3439,722,340,0,104,29,7,0,0,573,5214,0,ITF,ITF3,15,Campania,Campania,5801692,41492,0.72,0.09
1107,2021-04-02,CAM,21746,10412,11334,263,48,108,1063,138,6341,3980,8557,515,733,19428,2318,ITF,ITF3,15,Campania,Campania,5801692,63238,1.09,0.37
1108,2021-02-19,CAM,9555,3556,5999,1663,169,161,2193,103,35,4457,0,0,774,8905,650,ITF,ITF3,15,Campania,Campania,5801692,72793,1.25,0.16
1109,2021-01-01,CAM,919,506,413,831,85,0,0,2,0,0,0,0,1,919,0,ITF,ITF3,15,Campania,Campania,5801692,73712,1.27,0.02
1110,2021-03-26,CAM,19454,8929,10525,363,40,142,1635,100,3153,7624,5465,464,468,15644,3810,ITF,ITF3,15,Campania,Campania,5801692,93166,1.61,0.34
1111,2021-02-11,CAM,6278,2704,3574,1861,279,129,0,238,90,2410,0,0,1271,6212,66,ITF,ITF3,15,Campania,Campania,5801692,99444,1.71,0.11
1112,2021-01-18,CAM,957,399,558,576,93,187,0,12,4,17,0,0,68,713,244,ITF,ITF3,15,Campania,Campania,5801692,100401,1.73,0.02
1113,2021-02-22,CAM,10662,3291,7371,544,60,142,5542,63,38,3899,0,0,374,10399,263,ITF,ITF3,15,Campania,Campania,5801692,111063,1.91,0.18
1114,2021-04-03,CAM,21129,10321,10808,203,50,185,558,106,5971,4547,8847,207,455,18754,2375,ITF,ITF3,15,Campania,Campania,5801692,132192,2.28,0.36
1115,2021-02-08,CAM,5112,2449,2663,1387,320,226,0,327,180,1436,0,0,1236,4310,802,ITF,ITF3,15,Campania,Campania,5801692,137304,2.37,0.09
1116,2021-01-16,CAM,3369,1675,1694,1355,230,373,0,231,63,32,0,0,1085,3369,0,ITF,ITF3,15,Campania,Campania,5801692,140673,2.42,0.06
1117,2021-04-01,CAM,24304,11665,12639,416,63,83,1625,170,4315,7021,9396,572,643,20174,4130,ITF,ITF3,15,Campania,Campania,5801692,164977,2.84,0.42
1118,2021-03-13,CAM,14254,6793,7461,404,136,193,3686,84,27,6718,0,2322,684,8969,5285,ITF,ITF3,15,Campania,Campania,5801692,179231,3.09,0.25
1119,2021-01-06,CAM,7652,3749,3903,5781,838,300,0,116,29,4,0,0,584,7652,0,ITF,ITF3,15,Campania,Campania,5801692,186883,3.22,0.13
1120,2021-03-16,CAM,8087,3519,4568,289,61,60,114,47,85,6875,235,29,292,3772,4315,ITF,ITF3,15,Campania,Campania,5801692,194970,3.36,0.14
1121,2021-03-12,CAM,14247,7095,7152,1022,156,82,2802,114,56,6606,0,2438,971,8164,6083,ITF,ITF3,15,Campania,Campania,5801692,209217,3.61,0.25
1122,2021-04-15,CAM,34247,16627,17620,312,46,21,311,4260,7003,6145,15594,120,435,24375,9872,ITF,ITF3,15,Campania,Campania,5801692,243464,4.2,0.59
1123,2020-12-27,CAM,720,422,298,703,14,0,0,0,1,0,0,0,2,720,0,ITF,ITF3,15,Campania,Campania,5801692,244184,4.21,0.01
1124,2021-04-18,CAM,27152,13258,13894,108,23,7,240,3939,5517,5342,11734,84,158,18258,8894,ITF,ITF3,15,Campania,Campania,5801692,271336,4.68,0.47
1125,2021-01-29,CAM,10052,4812,5240,6405,1052,259,0,307,75,19,0,0,1935,47,10005,ITF,ITF3,15,Campania,Campania,5801692,281388,4.85,0.17
1126,2021-04-12,CAM,23306,10922,12384,149,64,70,217,1027,10306,3271,7762,129,311,20268,3038,ITF,ITF3,15,Campania,Campania,5801692,304694,5.25,0.4
1127,2021-02-17,CAM,7388,3210,4178,1013,208,38,362,129,70,4913,0,0,655,6328,1060,ITF,ITF3,15,Campania,Campania,5801692,312082,5.38,0.13
1128,2021-02-16,CAM,5435,2410,3025,983,276,169,1,118,43,3189,0,0,656,4664,771,ITF,ITF3,15,Campania,Campania,5801692,317517,5.47,0.09
1129,2021-01-25,CAM,5744,2926,2818,4743,644,56,0,46,13,2,0,0,240,164,5580,ITF,ITF3,15,Campania,Campania,5801692,323261,5.57,0.1
1130,2021-02-27,CAM,13943,4471,9472,825,290,82,8311,245,112,3184,0,0,894,12301,1642,ITF,ITF3,15,Campania,Campania,5801692,337204,5.81,0.24
1131,2021-01-09,CAM,10566,5024,5542,6759,1256,269,0,253,64,21,0,0,1944,10566,0,ITF,ITF3,15,Campania,Campania,5801692,347770,5.99,0.18
1132,2021-02-18,CAM,9079,3811,5268,1752,241,89,438,142,57,5561,0,1,798,8371,708,ITF,ITF3,15,Campania,Campania,5801692,356849,6.15,0.16
1133,2021-01-08,CAM,10456,4969,5487,6715,1147,212,0,309,80,18,0,0,1975,10456,0,ITF,ITF3,15,Campania,Campania,5801692,367305,6.33,0.18
1134,2021-04-11,CAM,17521,8606,8915,116,34,2,203,313,5115,1834,9596,82,226,15443,2078,ITF,ITF3,15,Campania,Campania,5801692,384826,6.63,0.3
1135,2021-02-25,CAM,12422,4479,7943,803,119,124,4805,144,81,5692,0,0,654,11234,1188,ITF,ITF3,15,Campania,Campania,5801692,397248,6.85,0.21
1136,2021-01-14,CAM,7073,2977,4096,3707,1264,350,0,206,61,14,0,0,1471,7073,0,ITF,ITF3,15,Campania,Campania,5801692,404321,6.97,0.12
1137,2021-02-20,CAM,8564,3079,5485,1023,158,145,1966,57,13,4588,0,0,614,8261,303,ITF,ITF3,15,Campania,Campania,5801692,412885,7.12,0.15
1138,2021-01-26,CAM,7340,3726,3614,5775,847,231,0,87,27,5,0,0,368,352,6988,ITF,ITF3,15,Campania,Campania,5801692,420225,7.24,0.13
1139,2021-02-14,CAM,3924,1921,2003,626,102,15,0,130,122,2472,0,0,457,3890,34,ITF,ITF3,15,Campania,Campania,5801692,424149,7.31,0.07
1140,2021-04-13,CAM,26589,12673,13916,226,69,97,244,2698,11286,4199,7135,135,500,21062,5527,ITF,ITF3,15,Campania,Campania,5801692,450738,7.77,0.46
1141,2021-03-14,CAM,8505,3721,4784,328,115,2,2018,56,27,4563,0,975,421,4367,4138,ITF,ITF3,15,Campania,Campania,5801692,459243,7.92,0.15
1142,2021-02-10,CAM,6904,3413,3491,1945,284,98,0,448,235,2218,0,0,1676,6728,176,ITF,ITF3,15,Campania,Campania,5801692,466147,8.03,0.12
1143,2021-02-06,CAM,5341,2665,2676,1990,520,459,0,427,176,58,0,0,1711,2103,3238,ITF,ITF3,15,Campania,Campania,5801692,471488,8.13,0.09
1144,2021-01-10,CAM,8165,3736,4429,5179,1010,97,0,232,62,13,0,0,1572,8165,0,ITF,ITF3,15,Campania,Campania,5801692,479653,8.27,0.14
1145,2021-01-05,CAM,7237,3638,3599,5810,923,106,0,68,20,4,0,0,306,7237,0,ITF,ITF3,15,Campania,Campania,5801692,486890,8.39,0.12
1146,2021-01-30,CAM,10721,5079,5642,6930,1278,227,0,251,68,18,0,0,1949,39,10682,ITF,ITF3,15,Campania,Campania,5801692,497611,8.58,0.18
1147,2021-02-05,CAM,7261,3463,3798,3447,995,308,0,348,140,35,0,0,1988,2133,5128,ITF,ITF3,15,Campania,Campania,5801692,504872,8.7,0.13
1148,2021-01-11,CAM,4072,1871,2201,2386,681,252,0,111,28,14,0,0,600,4072,0,ITF,ITF3,15,Campania,Campania,5801692,508944,8.77,0.07
1149,2021-04-16,CAM,34281,16549,17732,236,50,108,313,3196,6274,6625,16834,277,368,23628,10653,ITF,ITF3,15,Campania,Campania,5801692,543225,9.36,0.59
1150,2021-03-27,CAM,21253,10021,11232,356,39,63,1956,88,4052,7125,6933,210,431,17390,3863,ITF,ITF3,15,Campania,Campania,5801692,564478,9.73,0.37
1151,2021-03-22,CAM,12745,5922,6823,309,762,72,2471,80,3639,3502,588,922,400,10707,2038,ITF,ITF3,15,Campania,Campania,5801692,577223,9.95,0.22
1152,2021-03-17,CAM,11585,5096,6489,490,133,49,137,55,158,10009,141,43,370,5006,6579,ITF,ITF3,15,Campania,Campania,5801692,588808,10.15,0.2
1153,2021-03-01,CAM,12122,4245,7877,1153,319,147,5786,304,181,3104,0,0,1128,8011,4111,ITF,ITF3,15,Campania,Campania,5801692,600930,10.36,0.21
1154,2021-02-04,CAM,7943,3429,4514,3965,1245,292,0,328,140,25,0,0,1948,1308,6635,ITF,ITF3,15,Campania,Campania,5801692,608873,10.49,0.14
1155,2021-03-31,CAM,22666,10896,11770,340,85,111,1164,143,7470,5166,7334,307,546,19228,3438,ITF,ITF3,15,Campania,Campania,5801692,631539,10.89,0.39
1156,2021-03-02,CAM,12745,4550,8195,1294,197,147,5899,365,225,3279,0,2,1337,8401,4344,ITF,ITF3,15,Campania,Campania,5801692,644284,11.11,0.22
1157,2021-01-23,CAM,3838,2028,1810,3161,343,69,0,40,8,0,0,0,217,273,3565,ITF,ITF3,15,Campania,Campania,5801692,648122,11.17,0.07
1158,2021-02-09,CAM,4643,2202,2441,1148,178,6,0,356,211,1381,0,0,1363,4391,252,ITF,ITF3,15,Campania,Campania,5801692,652765,11.25,0.08
1159,2021-02-15,CAM,5469,2515,2954,987,238,94,1,98,64,3402,1,1,583,5296,173,ITF,ITF3,15,Campania,Campania,5801692,658234,11.35,0.09
1160,2021-03-28,CAM,15549,7498,8051,79,156,18,679,55,3590,5103,5532,165,172,13926,1623,ITF,ITF3,15,Campania,Campania,5801692,673783,11.61,0.27
1161,2021-02-24,CAM,11767,4146,7621,845,194,145,4189,45,24,5963,1,0,361,11079,688,ITF,ITF3,15,Campania,Campania,5801692,685550,11.82,0.2
1162,2021-04-06,CAM,24345,11410,12935,302,113,123,1555,99,10172,5369,5992,208,412,19830,4515,ITF,ITF3,15,Campania,Campania,5801692,709895,12.24,0.42
1163,2021-02-28,CAM,10411,3206,7205,496,116,22,5496,302,139,2261,0,0,1579,8511,1900,ITF,ITF3,15,Campania,Campania,5801692,720306,12.42,0.18
1164,2021-02-07,CAM,2929,1382,1547,706,189,225,0,260,155,342,0,0,1052,2158,771,ITF,ITF3,15,Campania,Campania,5801692,723235,12.47,0.05
1165,2020-12-31,CAM,1490,811,679,1273,150,1,0,11,2,0,0,0,53,1490,0,ITF,ITF3,15,Campania,Campania,5801692,724725,12.49,0.03
1166,2021-03-20,CAM,13894,6433,7461,295,43,35,2883,76,1677,6516,772,1020,577,10155,3739,ITF,ITF3,15,Campania,Campania,5801692,738619,12.73,0.24
1167,2021-01-17,CAM,1155,551,604,718,54,151,0,22,7,3,0,0,200,702,453,ITF,ITF3,15,Campania,Campania,5801692,739774,12.75,0.02
1168,2021-02-21,CAM,5833,2239,3594,780,45,22,508,56,14,3871,0,0,537,5608,225,ITF,ITF3,15,Campania,Campania,5801692,745607,12.85,0.1
1169,2021-03-19,CAM,11030,4868,6162,392,68,21,853,70,134,8441,474,138,439,7161,3869,ITF,ITF3,15,Campania,Campania,5801692,756637,13.04,0.19
1170,2021-01-21,CAM,2093,1116,977,1379,153,75,0,95,32,22,0,0,337,677,1416,ITF,ITF3,15,Campania,Campania,5801692,758730,13.08,0.04
1171,2021-03-29,CAM,18952,9136,9816,362,51,129,1204,83,4481,5041,6847,304,450,17408,1544,ITF,ITF3,15,Campania,Campania,5801692,777682,13.4,0.33
1172,2021-02-26,CAM,13327,4228,9099,951,127,220,7829,130,65,3422,0,1,582,11992,1335,ITF,ITF3,15,Campania,Campania,5801692,791009,13.63,0.23
1173,2021-03-18,CAM,12163,5376,6787,460,79,34,459,72,260,9973,231,99,496,5975,6188,ITF,ITF3,15,Campania,Campania,5801692,803172,13.84,0.21
1174,2021-03-05,CAM,16474,6346,10128,1682,243,64,5787,320,141,6364,0,4,1869,9814,6660,ITF,ITF3,15,Campania,Campania,5801692,819646,14.13,0.28
1175,2021-01-07,CAM,8910,4166,4744,6313,1087,332,0,193,29,11,0,0,945,8910,0,ITF,ITF3,15,Campania,Campania,5801692,828556,14.28,0.15
1176,2021-03-06,CAM,16303,6749,9554,993,135,172,5486,250,170,7145,0,1105,847,10636,5667,ITF,ITF3,15,Campania,Campania,5801692,844859,14.56,0.28
1177,2021-03-03,CAM,13916,5492,8424,2088,240,156,4232,469,251,4809,0,4,1667,7287,6629,ITF,ITF3,15,Campania,Campania,5801692,858775,14.8,0.24
1178,2021-04-17,CAM,36121,17483,18638,217,41,7,430,4707,6964,6324,16951,140,340,24601,11520,ITF,ITF3,15,Campania,Campania,5801692,894896,15.42,0.62
1179,2021-03-10,CAM,15240,7374,7866,704,246,26,2468,121,44,8441,1,2345,844,8411,6829,ITF,ITF3,15,Campania,Campania,5801692,910136,15.69,0.26
1180,2021-03-21,CAM,9984,4593,5391,168,28,17,1677,46,3789,2935,762,383,179,7595,2389,ITF,ITF3,15,Campania,Campania,5801692,920120,15.86,0.17
1181,2021-03-08,CAM,14536,6715,7821,888,248,70,4957,156,78,4874,0,2275,990,9760,4776,ITF,ITF3,15,Campania,Campania,5801692,934656,16.11,0.25
1182,2021-02-23,CAM,10989,3384,7605,520,87,289,5939,57,30,3760,0,0,307,10463,526,ITF,ITF3,15,Campania,Campania,5801692,945645,16.3,0.19
1183,2021-01-22,CAM,1523,775,748,970,120,209,0,28,6,4,0,0,186,673,850,ITF,ITF3,15,Campania,Campania,5801692,947168,16.33,0.03
1184,2021-02-12,CAM,6528,2860,3668,1885,306,208,4,160,69,3062,0,0,834,6342,186,ITF,ITF3,15,Campania,Campania,5801692,953696,16.44,0.11
1185,2021-03-04,CAM,14649,5349,9300,1901,305,136,4836,302,98,5595,0,1,1475,8756,5893,ITF,ITF3,15,Campania,Campania,5801692,968345,16.69,0.25
1186,2021-03-23,CAM,15334,7058,8276,359,491,181,3293,160,2744,4739,2114,577,676,12829,2505,ITF,ITF3,15,Campania,Campania,5801692,983679,16.96,0.26
1187,2021-03-24,CAM,17619,8081,9538,410,99,70,2443,111,1943,6725,4802,621,395,14668,2951,ITF,ITF3,15,Campania,Campania,5801692,1001298,17.26,0.3
1188,2021-01-24,CAM,4128,2123,2005,3140,410,166,0,46,10,0,0,0,356,383,3745,ITF,ITF3,15,Campania,Campania,5801692,1005426,17.33,0.07
1189,2021-03-25,CAM,19996,9340,10656,308,52,8,2484,124,2562,7454,6029,396,579,16493,3503,ITF,ITF3,15,Campania,Campania,5801692,1025422,17.67,0.34
1190,2021-02-13,CAM,5509,2550,2959,960,114,131,2,160,127,3622,0,0,393,5292,217,ITF,ITF3,15,Campania,Campania,5801692,1030931,17.77,0.09
1191,2021-04-19,CAM,18030,8841,9189,127,44,44,181,2971,3320,3273,7827,78,165,8789,9241,ITF,ITF3,15,Campania,Campania,5801692,1048961,18.08,0.31
1192,2021-02-01,CAM,3985,1813,2172,2504,656,152,0,102,26,14,0,0,531,110,3875,ITF,ITF3,15,Campania,Campania,5801692,1052946,18.15,0.07
1193,2021-01-02,CAM,3673,1962,1711,3167,340,0,0,22,8,0,0,0,136,3673,0,ITF,ITF3,15,Campania,Campania,5801692,1056619,18.21,0.06
1194,2021-01-20,CAM,1257,650,607,395,146,101,0,101,100,17,0,0,397,1257,0,ITF,ITF3,15,Campania,Campania,5801692,1057876,18.23,0.02
1195,2021-03-09,CAM,13839,6619,7220,797,276,184,4187,177,49,4513,1,2515,1140,10058,3781,ITF,ITF3,15,Campania,Campania,5801692,1071715,18.47,0.24
1196,2021-04-05,CAM,11636,5541,6095,141,23,6,432,31,2456,2878,5306,111,252,9215,2421,ITF,ITF3,15,Campania,Campania,5801692,1083351,18.67,0.2
1197,2021-01-27,CAM,7738,3820,3918,5839,875,270,0,118,32,4,0,0,600,163,7575,ITF,ITF3,15,Campania,Campania,5801692,1091089,18.81,0.13
1198,2021-01-31,CAM,8066,3711,4355,5106,1012,67,0,238,61,12,0,0,1570,23,8043,ITF,ITF3,15,Campania,Campania,5801692,1099155,18.95,0.14
1199,2021-01-19,CAM,1095,474,621,534,129,171,0,36,7,1,0,0,217,1092,3,ITF,ITF3,15,Campania,Campania,5801692,1100250,18.96,0.02
1200,2021-03-11,CAM,17575,8666,8909,1049,295,105,2836,180,87,8955,0,2956,1112,10299,7276,ITF,ITF3,15,Campania,Campania,5801692,1117825,19.27,0.3
1201,2021-01-28,CAM,8833,4122,4711,6216,1094,347,0,190,32,12,0,0,942,135,8698,ITF,ITF3,15,Campania,Campania,5801692,1126658,19.42,0.15
1202,2021-01-04,CAM,5826,2963,2863,4850,679,0,0,45,5,1,0,0,246,5826,0,ITF,ITF3,15,Campania,Campania,5801692,1132484,19.52,0.1
1203,2021-04-09,CAM,29807,13947,15860,261,75,39,958,183,9290,7320,10727,353,601,23690,6117,ITF,ITF3,15,Campania,Campania,5801692,1162291,20.03,0.51
1204,2021-02-02,CAM,5722,2804,2918,3640,828,354,0,140,50,22,0,0,688,443,5279,ITF,ITF3,15,Campania,Campania,5801692,1168013,20.13,0.1
1205,2021-03-15,CAM,12912,6081,6831,808,142,75,2561,81,1445,6283,12,1065,440,8192,4720,ITF,ITF3,15,Campania,Campania,5801692,1180925,20.35,0.22
1206,2021-02-03,CAM,8902,4002,4900,4736,1101,714,0,295,74,34,0,0,1948,878,8024,ITF,ITF3,15,Campania,Campania,5801692,1189827,20.51,0.15
1207,2021-04-08,CAM,28261,13633,14628,283,130,58,1041,135,6669,7222,11877,401,445,22427,5834,ITF,ITF3,15,Campania,Campania,5801692,1218088,21.0,0.49
1208,2021-01-15,CAM,4980,2381,2599,2740,832,191,0,159,72,22,0,0,964,4980,0,ITF,ITF3,15,Campania,Campania,5801692,1223068,21.08,0.09
1209,2021-04-14,CAM,27623,13319,14304,268,55,22,268,3203,11160,5107,7058,133,349,19059,8564,ITF,ITF3,15,Campania,Campania,5801692,1250691,21.56,0.48
1210,2021-01-03,CAM,3837,2009,1828,3191,401,0,0,31,6,0,0,0,208,3837,0,ITF,ITF3,15,Campania,Campania,5801692,1254528,21.62,0.07
1211,2021-03-07,CAM,11911,5344,6567,533,110,85,4351,158,134,4030,0,1953,557,8070,3841,ITF,ITF3,15,Campania,Campania,5801692,1266439,21.83,0.21
1212,2021-03-30,CAM,21667,10253,11414,278,47,165,1836,148,5857,5659,6764,284,629,18712,2955,ITF,ITF3,15,Campania,Campania,5801692,1288106,22.2,0.37
1213,2021-01-13,CAM,8019,3665,4354,4350,1031,587,0,267,65,30,0,0,1689,8019,0,ITF,ITF3,15,Campania,Campania,5801692,1296125,22.34,0.14
1214,2021-04-07,CAM,24739,11772,12967,348,206,62,1043,135,7508,6621,8002,274,540,20017,4722,ITF,ITF3,15,Campania,Campania,5801692,1320864,22.77,0.43
1215,2021-01-31,LAZ,4297,1791,2506,3572,142,244,0,36,40,153,0,0,110,314,3983,ITI,ITI4,12,Lazio,Lazio,5879082,4297,0.07,0.07
1216,2021-01-26,LAZ,7650,2929,4721,6592,219,631,0,2,27,154,0,0,25,419,7231,ITI,ITI4,12,Lazio,Lazio,5879082,11947,0.2,0.13
1217,2021-02-13,LAZ,6354,2472,3882,2123,100,280,0,21,60,3710,0,0,60,6187,167,ITI,ITI4,12,Lazio,Lazio,5879082,18301,0.31,0.11
1218,2021-03-18,LAZ,14180,6059,8121,1767,94,330,6,147,860,9455,1251,15,255,7805,6375,ITI,ITI4,12,Lazio,Lazio,5879082,32481,0.55,0.24
1219,2021-04-13,LAZ,24852,11537,13315,2349,107,289,54,4470,7724,7342,2332,23,162,17256,7596,ITI,ITI4,12,Lazio,Lazio,5879082,57333,0.98,0.42
1220,2021-01-27,LAZ,5799,2188,3611,4797,228,457,0,23,37,148,0,0,109,682,5117,ITI,ITI4,12,Lazio,Lazio,5879082,63132,1.07,0.1
1221,2021-02-10,LAZ,7832,3143,4689,2647,276,634,0,36,72,4044,0,0,123,4841,2991,ITI,ITI4,12,Lazio,Lazio,5879082,70964,1.21,0.13
1222,2021-02-25,LAZ,12639,5514,7125,1754,440,489,2611,139,117,5222,1,1423,443,11591,1048,ITI,ITI4,12,Lazio,Lazio,5879082,83603,1.42,0.21
1223,2021-03-08,LAZ,19897,8230,11667,2452,135,380,4709,118,257,9166,906,1102,672,14632,5265,ITI,ITI4,12,Lazio,Lazio,5879082,103500,1.76,0.34
1224,2021-04-08,LAZ,26145,11921,14224,4592,83,186,52,2682,8429,7627,1778,159,557,18520,7625,ITI,ITI4,12,Lazio,Lazio,5879082,129645,2.21,0.44
1225,2021-03-02,LAZ,16635,7202,9433,1811,362,229,3754,111,88,8217,328,1278,457,12705,3930,ITI,ITI4,12,Lazio,Lazio,5879082,146280,2.49,0.28
1226,2021-01-10,LAZ,4039,1700,2339,3424,160,252,0,35,27,24,0,0,117,4039,0,ITI,ITI4,12,Lazio,Lazio,5879082,150319,2.56,0.07
1227,2021-01-20,LAZ,4449,1687,2762,3280,233,427,0,23,50,367,0,0,69,2908,1541,ITI,ITI4,12,Lazio,Lazio,5879082,154768,2.63,0.08
1228,2021-01-24,LAZ,5546,2149,3397,4945,132,134,0,27,94,166,0,0,48,464,5082,ITI,ITI4,12,Lazio,Lazio,5879082,160314,2.73,0.09
1229,2021-03-15,LAZ,19219,8309,10910,2308,136,411,2526,178,1605,9679,813,964,599,12489,6730,ITI,ITI4,12,Lazio,Lazio,5879082,179533,3.05,0.33
1230,2021-01-28,LAZ,7973,3006,4967,6811,381,514,0,25,28,146,0,0,68,477,7496,ITI,ITI4,12,Lazio,Lazio,5879082,187506,3.19,0.14
1231,2021-04-07,LAZ,24529,11124,13405,2922,79,189,93,2304,8475,7817,1820,117,713,17432,7097,ITI,ITI4,12,Lazio,Lazio,5879082,212035,3.61,0.42
1232,2021-01-30,LAZ,6677,2745,3932,5298,283,651,0,64,58,184,0,0,139,476,6201,ITI,ITI4,12,Lazio,Lazio,5879082,218712,3.72,0.11
1233,2021-04-14,LAZ,28431,12985,15446,3307,82,148,79,4593,9168,8185,2675,13,181,18456,9975,ITI,ITI4,12,Lazio,Lazio,5879082,247143,4.2,0.48
1234,2021-01-11,LAZ,5525,2103,3422,4553,311,569,0,12,9,14,0,0,57,5525,0,ITI,ITI4,12,Lazio,Lazio,5879082,252668,4.3,0.09
1235,2021-03-07,LAZ,14059,5419,8640,1201,27,148,3533,130,128,7452,405,696,339,10470,3589,ITI,ITI4,12,Lazio,Lazio,5879082,266727,4.54,0.24
1236,2021-04-19,LAZ,23943,10901,13042,472,89,100,34,5486,8033,6799,2617,36,277,15283,8660,ITI,ITI4,12,Lazio,Lazio,5879082,290670,4.94,0.41
1237,2021-01-13,LAZ,5572,2072,3500,4146,273,1009,0,18,12,26,0,0,88,5572,0,ITI,ITI4,12,Lazio,Lazio,5879082,296242,5.04,0.09
1238,2021-02-22,LAZ,11427,4977,6450,1779,130,473,2222,36,30,5270,0,1390,97,10926,501,ITI,ITI4,12,Lazio,Lazio,5879082,307669,5.23,0.19
1239,2021-02-24,LAZ,12025,5190,6835,1798,434,337,2400,75,64,5244,0,1327,346,11034,991,ITI,ITI4,12,Lazio,Lazio,5879082,319694,5.44,0.2
1240,2021-04-10,LAZ,23551,10234,13317,3200,49,111,78,3352,6762,7215,2567,29,188,16408,7143,ITI,ITI4,12,Lazio,Lazio,5879082,343245,5.84,0.4
1241,2021-03-22,LAZ,21385,8895,12490,1532,76,245,3861,124,4223,9231,1294,558,241,14949,6436,ITI,ITI4,12,Lazio,Lazio,5879082,364630,6.2,0.36
1242,2021-03-16,LAZ,13496,5718,7778,1504,70,280,5,151,772,9575,816,9,314,7063,6433,ITI,ITI4,12,Lazio,Lazio,5879082,378126,6.43,0.23
1243,2020-12-30,LAZ,1630,629,1001,1603,0,27,0,0,0,0,0,0,0,1630,0,ITI,ITI4,12,Lazio,Lazio,5879082,379756,6.46,0.03
1244,2021-01-17,LAZ,4673,1896,2777,3243,148,177,0,23,72,896,0,0,114,4461,212,ITI,ITI4,12,Lazio,Lazio,5879082,384429,6.54,0.08
1245,2021-04-09,LAZ,26789,12016,14773,4707,135,162,65,3239,7993,7704,2181,153,450,18648,8141,ITI,ITI4,12,Lazio,Lazio,5879082,411218,6.99,0.46
1246,2021-04-02,LAZ,27811,12991,14820,5762,95,166,184,2140,8154,8537,2144,290,339,20550,7261,ITI,ITI4,12,Lazio,Lazio,5879082,439029,7.47,0.47
1247,2021-03-20,LAZ,18144,6787,11357,1840,139,360,3047,122,1912,8882,1308,213,321,12308,5836,ITI,ITI4,12,Lazio,Lazio,5879082,457173,7.78,0.31
1248,2020-12-29,LAZ,488,176,312,486,2,0,0,0,0,0,0,0,0,488,0,ITI,ITI4,12,Lazio,Lazio,5879082,457661,7.78,0.01
1249,2021-03-28,LAZ,18786,7525,11261,1062,19,77,2606,1182,4161,8447,904,139,189,13489,5297,ITI,ITI4,12,Lazio,Lazio,5879082,476447,8.1,0.32
1250,2021-01-09,LAZ,6293,2560,3733,5115,240,620,0,61,41,39,0,0,177,6293,0,ITI,ITI4,12,Lazio,Lazio,5879082,482740,8.21,0.11
1251,2021-01-05,LAZ,7370,2802,4568,6690,98,577,0,1,1,1,0,1,1,7370,0,ITI,ITI4,12,Lazio,Lazio,5879082,490110,8.34,0.13
1252,2021-03-19,LAZ,17026,7274,9752,2123,148,389,1006,110,1803,9422,1460,266,299,10725,6301,ITI,ITI4,12,Lazio,Lazio,5879082,507136,8.63,0.29
1253,2020-12-28,LAZ,959,412,547,957,2,0,0,0,0,0,0,0,0,959,0,ITI,ITI4,12,Lazio,Lazio,5879082,508095,8.64,0.02
1254,2021-02-07,LAZ,4774,1917,2857,3252,139,218,1,54,87,893,0,0,130,383,4391,ITI,ITI4,12,Lazio,Lazio,5879082,512869,8.72,0.08
1255,2021-02-08,LAZ,9416,3923,5493,3789,430,918,0,79,92,3826,0,0,282,4492,4924,ITI,ITI4,12,Lazio,Lazio,5879082,522285,8.88,0.16
1256,2021-03-29,LAZ,23661,10624,13037,2062,88,143,797,1150,7211,9516,2073,366,255,16766,6895,ITI,ITI4,12,Lazio,Lazio,5879082,545946,9.29,0.4
1257,2021-02-27,LAZ,11381,4249,7132,1359,403,515,2703,83,103,4884,12,1120,199,10427,954,ITI,ITI4,12,Lazio,Lazio,5879082,557327,9.48,0.19
1258,2021-01-22,LAZ,3716,1468,2248,3380,76,70,0,3,15,165,0,0,7,201,3515,ITI,ITI4,12,Lazio,Lazio,5879082,561043,9.54,0.06
1259,2021-03-05,LAZ,18528,7816,10712,2729,180,256,3969,126,169,8560,561,1323,655,13805,4723,ITI,ITI4,12,Lazio,Lazio,5879082,579571,9.86,0.32
1260,2021-04-18,LAZ,23423,10412,13011,443,23,37,26,6102,7863,6935,1819,11,164,15912,7511,ITI,ITI4,12,Lazio,Lazio,5879082,602994,10.26,0.4
1261,2021-03-21,LAZ,17804,6817,10987,1239,33,111,3436,84,3145,8225,1233,118,180,12782,5022,ITI,ITI4,12,Lazio,Lazio,5879082,620798,10.56,0.3
1262,2021-02-04,LAZ,6089,2309,3780,4460,358,892,0,69,67,119,0,0,124,950,5139,ITI,ITI4,12,Lazio,Lazio,5879082,626887,10.66,0.1
1263,2021-04-06,LAZ,23530,10537,12993,2204,85,94,164,2351,8350,7715,1709,234,624,16537,6993,ITI,ITI4,12,Lazio,Lazio,5879082,650417,11.06,0.4
1264,2021-03-10,LAZ,21871,9412,12459,4077,177,452,4617,223,493,9021,913,1179,719,16234,5637,ITI,ITI4,12,Lazio,Lazio,5879082,672288,11.44,0.37
1265,2021-02-18,LAZ,9694,4807,4887,2162,111,473,1,85,52,4980,0,1665,165,9180,514,ITI,ITI4,12,Lazio,Lazio,5879082,681982,11.6,0.16
1266,2021-02-19,LAZ,9731,4906,4825,2170,105,408,34,43,85,5132,0,1636,118,9201,530,ITI,ITI4,12,Lazio,Lazio,5879082,691713,11.77,0.17
1267,2021-04-17,LAZ,31472,13828,17644,819,99,215,53,7052,9205,9087,4204,10,728,19927,11545,ITI,ITI4,12,Lazio,Lazio,5879082,723185,12.3,0.54
1268,2021-02-14,LAZ,5617,2286,3331,1645,38,127,0,45,118,3498,0,0,146,5291,326,ITI,ITI4,12,Lazio,Lazio,5879082,728802,12.4,0.1
1269,2021-01-14,LAZ,5269,1985,3284,3887,306,811,0,33,35,105,0,0,92,5269,0,ITI,ITI4,12,Lazio,Lazio,5879082,734071,12.49,0.09
1270,2021-01-02,LAZ,6705,2630,4075,6269,77,358,0,0,0,0,0,0,1,6705,0,ITI,ITI4,12,Lazio,Lazio,5879082,740776,12.6,0.11
1271,2021-03-09,LAZ,20823,8921,11902,3381,113,338,4617,132,300,9052,1060,1230,600,15629,5194,ITI,ITI4,12,Lazio,Lazio,5879082,761599,12.95,0.35
1272,2021-03-04,LAZ,18269,7775,10494,2800,216,507,3905,154,130,8269,428,1315,545,13256,5013,ITI,ITI4,12,Lazio,Lazio,5879082,779868,13.27,0.31
1273,2021-01-04,LAZ,7478,2907,4571,7075,86,316,1,0,0,0,0,0,0,7478,0,ITI,ITI4,12,Lazio,Lazio,5879082,787346,13.39,0.13
1274,2021-02-01,LAZ,5669,2173,3496,4784,192,559,0,17,27,30,0,0,60,353,5316,ITI,ITI4,12,Lazio,Lazio,5879082,793015,13.49,0.1
1275,2021-03-11,LAZ,23668,10522,13146,4849,132,440,4437,197,646,9340,1071,1892,664,17444,6224,ITI,ITI4,12,Lazio,Lazio,5879082,816683,13.89,0.4
1276,2021-01-07,LAZ,7743,2901,4842,6898,182,566,0,16,10,9,0,0,62,7743,0,ITI,ITI4,12,Lazio,Lazio,5879082,824426,14.02,0.13
1277,2021-02-20,LAZ,8852,4108,4744,1942,123,298,22,64,104,4854,0,1310,135,8409,443,ITI,ITI4,12,Lazio,Lazio,5879082,833278,14.17,0.15
1278,2021-04-05,LAZ,19693,8960,10733,538,36,28,63,1804,8145,7532,1245,20,282,13549,6144,ITI,ITI4,12,Lazio,Lazio,5879082,852971,14.51,0.33
1279,2021-01-03,LAZ,5250,1972,3278,5125,50,65,0,1,4,1,0,0,4,5250,0,ITI,ITI4,12,Lazio,Lazio,5879082,858221,14.6,0.09
1280,2021-02-06,LAZ,5171,2075,3096,3279,217,680,0,98,143,606,0,0,148,803,4368,ITI,ITI4,12,Lazio,Lazio,5879082,863392,14.69,0.09
1281,2021-04-16,LAZ,33268,15235,18033,680,138,335,85,6692,10306,9335,4800,52,845,21589,11679,ITI,ITI4,12,Lazio,Lazio,5879082,896660,15.25,0.57
1282,2021-02-05,LAZ,6959,2747,4212,5095,380,995,0,49,85,252,0,0,103,1145,5814,ITI,ITI4,12,Lazio,Lazio,5879082,903619,15.37,0.12
1283,2021-03-13,LAZ,21344,8379,12965,5143,117,330,3739,154,939,9030,716,856,320,15451,5893,ITI,ITI4,12,Lazio,Lazio,5879082,924963,15.73,0.36
1284,2021-02-03,LAZ,6309,2359,3950,4621,342,1078,0,34,36,83,0,0,115,910,5399,ITI,ITI4,12,Lazio,Lazio,5879082,931272,15.84,0.11
1285,2021-03-24,LAZ,25626,11153,14473,3773,93,107,3599,166,6083,9459,1552,278,516,19515,6111,ITI,ITI4,12,Lazio,Lazio,5879082,956898,16.28,0.44
1286,2021-03-23,LAZ,23148,10007,13141,2491,101,181,3856,156,4696,9234,1261,640,532,16852,6296,ITI,ITI4,12,Lazio,Lazio,5879082,980046,16.67,0.39
1287,2021-01-19,LAZ,4449,1729,2720,2968,222,424,0,49,111,454,0,0,221,3995,454,ITI,ITI4,12,Lazio,Lazio,5879082,984495,16.75,0.08
1288,2021-01-18,LAZ,5919,2323,3596,3905,388,725,0,60,69,512,0,0,260,4941,978,ITI,ITI4,12,Lazio,Lazio,5879082,990414,16.85,0.1
1289,2021-03-30,LAZ,24962,11447,13515,3782,90,248,288,1467,7369,9179,1800,375,364,17868,7094,ITI,ITI4,12,Lazio,Lazio,5879082,1015376,17.27,0.42
1290,2021-04-15,LAZ,30819,13873,16946,3836,109,332,75,4767,9620,8760,2865,43,412,20235,10584,ITI,ITI4,12,Lazio,Lazio,5879082,1046195,17.8,0.52
1291,2021-03-25,LAZ,26405,11264,15141,4807,88,318,3484,169,6026,9548,1384,232,349,20091,6314,ITI,ITI4,12,Lazio,Lazio,5879082,1072600,18.24,0.45
1292,2021-03-27,LAZ,25661,10236,15425,5589,106,290,3455,240,4714,9243,1464,203,357,19396,6265,ITI,ITI4,12,Lazio,Lazio,5879082,1098261,18.68,0.44
1293,2021-01-29,LAZ,7628,2879,4749,6373,262,704,0,39,37,130,0,0,83,510,7118,ITI,ITI4,12,Lazio,Lazio,5879082,1105889,18.81,0.13
1294,2021-02-11,LAZ,6702,2809,3893,2197,179,500,0,30,35,3674,0,0,87,6463,239,ITI,ITI4,12,Lazio,Lazio,5879082,1112591,18.92,0.11
1295,2021-02-28,LAZ,10224,3996,6228,1601,265,77,2599,88,45,4669,5,682,193,9710,514,ITI,ITI4,12,Lazio,Lazio,5879082,1122815,19.1,0.17
1296,2021-01-01,LAZ,3554,1382,2172,3483,2,68,0,0,0,0,0,0,1,3554,0,ITI,ITI4,12,Lazio,Lazio,5879082,1126369,19.16,0.06
1297,2021-03-26,LAZ,27733,12027,15706,5372,101,330,3249,215,5971,9661,1658,307,869,21120,6613,ITI,ITI4,12,Lazio,Lazio,5879082,1154102,19.63,0.47
1298,2021-03-12,LAZ,22682,10027,12655,4709,185,400,3948,168,1005,9508,912,1191,656,16370,6312,ITI,ITI4,12,Lazio,Lazio,5879082,1176784,20.02,0.39
1299,2021-01-23,LAZ,6963,2718,4245,6063,255,417,0,3,40,170,0,0,15,335,6628,ITI,ITI4,12,Lazio,Lazio,5879082,1183747,20.13,0.12
1300,2021-04-04,LAZ,17368,8006,9362,397,39,11,42,1795,7353,6715,836,17,163,12137,5231,ITI,ITI4,12,Lazio,Lazio,5879082,1201115,20.43,0.3
1301,2021-01-12,LAZ,5391,1974,3417,4343,344,584,0,21,11,10,0,0,78,5391,0,ITI,ITI4,12,Lazio,Lazio,5879082,1206506,20.52,0.09
1302,2021-01-16,LAZ,5427,2127,3300,3358,246,1064,0,34,80,545,0,0,100,5427,0,ITI,ITI4,12,Lazio,Lazio,5879082,1211933,20.61,0.09
1303,2021-01-15,LAZ,6281,2498,3783,4498,423,988,0,35,60,194,0,0,83,6281,0,ITI,ITI4,12,Lazio,Lazio,5879082,1218214,20.72,0.11
1304,2021-01-21,LAZ,5296,2133,3163,4780,92,232,0,3,13,167,0,0,9,245,5051,ITI,ITI4,12,Lazio,Lazio,5879082,1223510,20.81,0.09
1305,2021-02-02,LAZ,5793,2146,3647,4712,368,571,0,33,33,33,0,0,43,522,5271,ITI,ITI4,12,Lazio,Lazio,5879082,1229303,20.91,0.1
1306,2021-02-21,LAZ,6821,3111,3710,1245,65,51,16,65,90,4579,0,607,103,6520,301,ITI,ITI4,12,Lazio,Lazio,5879082,1236124,21.03,0.12
1307,2021-04-01,LAZ,27749,12739,15010,5798,93,284,248,1751,8237,8740,1917,339,342,20652,7097,ITI,ITI4,12,Lazio,Lazio,5879082,1263873,21.5,0.47
1308,2020-12-27,LAZ,272,131,141,272,0,0,0,0,0,0,0,0,0,272,0,ITI,ITI4,12,Lazio,Lazio,5879082,1264145,21.5,0.0
1309,2021-02-15,LAZ,7791,3414,4377,2447,377,379,0,36,73,4288,0,8,183,7430,361,ITI,ITI4,12,Lazio,Lazio,5879082,1271936,21.63,0.13
1310,2021-04-03,LAZ,24134,10792,13342,4690,68,111,207,2084,7401,7843,1378,43,309,17493,6641,ITI,ITI4,12,Lazio,Lazio,5879082,1296070,22.05,0.41
1311,2021-02-26,LAZ,12923,5620,7303,1909,542,352,2740,94,90,5244,4,1385,563,11679,1244,ITI,ITI4,12,Lazio,Lazio,5879082,1308993,22.27,0.22
1312,2021-02-17,LAZ,8845,4392,4453,2282,244,499,1,43,49,4275,0,1345,107,8283,562,ITI,ITI4,12,Lazio,Lazio,5879082,1317838,22.42,0.15
1313,2021-02-12,LAZ,6543,2668,3875,1995,183,302,0,32,34,3833,0,0,164,6417,126,ITI,ITI4,12,Lazio,Lazio,5879082,1324381,22.53,0.11
1314,2021-01-25,LAZ,7828,3078,4750,7006,218,363,0,9,55,139,0,0,38,488,7340,ITI,ITI4,12,Lazio,Lazio,5879082,1332209,22.66,0.13
1315,2021-03-06,LAZ,18032,6925,11107,3700,119,327,3772,95,119,7980,583,932,405,13778,4254,ITI,ITI4,12,Lazio,Lazio,5879082,1350241,22.97,0.31
1316,2021-04-11,LAZ,18934,8375,10559,490,29,50,31,3764,6082,6425,1977,14,72,13069,5865,ITI,ITI4,12,Lazio,Lazio,5879082,1369175,23.29,0.32
1317,2021-04-12,LAZ,23174,10405,12769,1465,72,101,72,3900,7427,7467,2357,107,206,16339,6835,ITI,ITI4,12,Lazio,Lazio,5879082,1392349,23.68,0.39
1318,2021-03-17,LAZ,13568,5787,7781,1511,92,255,14,149,821,9490,953,7,276,7337,6231,ITI,ITI4,12,Lazio,Lazio,5879082,1405917,23.91,0.23
1319,2021-03-14,LAZ,17053,6598,10455,1362,95,81,3446,294,1086,8421,543,565,1160,11899,5154,ITI,ITI4,12,Lazio,Lazio,5879082,1422970,24.2,0.29
1320,2021-03-01,LAZ,16723,7143,9580,1555,531,385,3579,124,127,8170,390,1406,456,12865,3858,ITI,ITI4,12,Lazio,Lazio,5879082,1439693,24.49,0.28
1321,2021-02-16,LAZ,8091,3886,4205,2058,125,261,1,52,74,4258,0,951,311,7791,300,ITI,ITI4,12,Lazio,Lazio,5879082,1447784,24.63,0.14
1322,2021-01-08,LAZ,7726,2894,4832,6519,196,798,0,36,32,32,0,0,113,7726,0,ITI,ITI4,12,Lazio,Lazio,5879082,1455510,24.76,0.13
1323,2021-03-03,LAZ,17117,7226,9891,2111,211,379,3937,134,115,8180,259,1249,542,12827,4290,ITI,ITI4,12,Lazio,Lazio,5879082,1472627,25.05,0.29
1324,2021-01-06,LAZ,5119,1960,3159,4619,154,320,1,1,4,8,5,1,6,5119,0,ITI,ITI4,12,Lazio,Lazio,5879082,1477746,25.14,0.09
1325,2021-02-23,LAZ,10947,4699,6248,1897,119,309,1910,41,52,5215,0,1015,389,10302,645,ITI,ITI4,12,Lazio,Lazio,5879082,1488693,25.32,0.19
1326,2021-03-31,LAZ,25707,11836,13871,4262,84,135,246,1389,7506,9044,2215,367,459,18728,6979,ITI,ITI4,12,Lazio,Lazio,5879082,1514400,25.76,0.44
1327,2021-02-09,LAZ,8480,3541,4939,3258,245,548,0,50,112,4058,0,0,209,4575,3905,ITI,ITI4,12,Lazio,Lazio,5879082,1522880,25.9,0.14
1328,2020-12-31,LAZ,5291,2121,3170,4987,20,279,0,1,0,0,0,0,4,5291,0,ITI,ITI4,12,Lazio,Lazio,5879082,1528171,25.99,0.09
1329,2021-01-07,PAB,916,327,589,617,107,0,0,25,16,61,0,0,90,916,0,ITH,ITH1,4,Provincia Autonoma Bolzano / Bozen,P.A. Bolzano,533050,916,0.17,0.17
1330,2021-01-04,PAB,508,201,307,420,49,4,0,6,6,0,0,0,23,508,0,ITH,ITH1,4,Provincia Autonoma Bolzano / Bozen,P.A. Bolzano,533050,1424,0.27,0.1
1331,2021-02-20,PAB,1502,471,1031,196,53,24,729,5,6,477,0,1,11,1484,18,ITH,ITH1,4,Provincia Autonoma Bolzano / Bozen,P.A. Bolzano,533050,2926,0.55,0.28
1332,2021-03-11,PAB,1681,823,858,89,309,79,335,3,14,370,88,379,15,1143,538,ITH,ITH1,4,Provincia Autonoma Bolzano / Bozen,P.A. Bolzano,533050,4607,0.86,0.32
1333,2021-02-01,PAB,1449,439,1010,772,314,296,1,6,0,2,0,1,57,12,1437,ITH,ITH1,4,Provincia Autonoma Bolzano / Bozen,P.A. Bolzano,533050,6056,1.14,0.27
1334,2021-04-05,PAB,301,144,157,5,3,0,1,0,28,70,187,7,0,23,278,ITH,ITH1,4,Provincia Autonoma Bolzano / Bozen,P.A. Bolzano,533050,6357,1.19,0.06
1335,2021-02-05,PAB,3192,1179,2013,760,504,441,0,21,12,1380,0,0,74,8,3184,ITH,ITH1,4,Provincia Autonoma Bolzano / Bozen,P.A. Bolzano,533050,9549,1.79,0.6
1336,2021-04-10,PAB,5389,2664,2725,146,54,3,22,183,3272,552,938,197,22,4801,588,ITH,ITH1,4,Provincia Autonoma Bolzano / Bozen,P.A. Bolzano,533050,14938,2.8,1.01
1337,2021-02-06,PAB,2626,1171,1455,452,43,6,1,28,76,1932,0,0,88,18,2608,ITH,ITH1,4,Provincia Autonoma Bolzano / Bozen,P.A. Bolzano,533050,17564,3.3,0.49
1338,2021-02-26,PAB,1393,496,897,62,32,2,333,4,1,920,1,0,38,1363,30,ITH,ITH1,4,Provincia Autonoma Bolzano / Bozen,P.A. Bolzano,533050,18957,3.56,0.26
1339,2021-03-06,PAB,3967,2079,1888,479,164,7,381,10,19,1979,48,859,21,3756,211,ITH,ITH1,4,Provincia Autonoma Bolzano / Bozen,P.A. Bolzano,533050,22924,4.3,0.74
1340,2021-01-22,PAB,243,139,104,131,8,85,1,4,0,3,0,0,11,124,119,ITH,ITH1,4,Provincia Autonoma Bolzano / Bozen,P.A. Bolzano,533050,23167,4.35,0.05
1341,2021-04-17,PAB,5225,2596,2629,69,12,36,75,2787,1237,99,733,161,16,5177,48,ITH,ITH1,4,Provincia Autonoma Bolzano / Bozen,P.A. Bolzano,533050,28392,5.33,0.98
1342,2021-02-03,PAB,1503,478,1025,666,341,321,0,12,5,72,1,0,85,5,1498,ITH,ITH1,4,Provincia Autonoma Bolzano / Bozen,P.A. Bolzano,533050,29895,5.61,0.28
1343,2021-04-16,PAB,2948,1418,1530,194,36,5,38,1420,615,115,421,98,6,2437,511,ITH,ITH1,4,Provincia Autonoma Bolzano / Bozen,P.A. Bolzano,533050,32843,6.16,0.55
1344,2021-03-13,PAB,2885,1459,1426,168,59,1,20,11,879,1295,58,381,13,2784,101,ITH,ITH1,4,Provincia Autonoma Bolzano / Bozen,P.A. Bolzano,533050,35728,6.7,0.54
1345,2021-01-19,PAB,853,371,482,174,55,0,0,7,6,579,1,0,31,723,130,ITH,ITH1,4,Provincia Autonoma Bolzano / Bozen,P.A. Bolzano,533050,36581,6.86,0.16
1346,2021-04-03,PAB,831,364,467,9,6,0,0,1,12,799,0,4,0,22,809,ITH,ITH1,4,Provincia Autonoma Bolzano / Bozen,P.A. Bolzano,533050,37412,7.02,0.16
1347,2021-03-01,PAB,917,220,697,18,2,5,735,18,0,0,0,0,139,917,0,ITH,ITH1,4,Provincia Autonoma Bolzano / Bozen,P.A. Bolzano,533050,38329,7.19,0.17
1348,2021-02-16,PAB,529,205,324,10,1,0,0,0,0,517,1,0,0,529,0,ITH,ITH1,4,Provincia Autonoma Bolzano / Bozen,P.A. Bolzano,533050,38858,7.29,0.1
1349,2021-01-06,PAB,59,18,41,59,0,0,0,0,0,0,0,0,0,59,0,ITH,ITH1,4,Provincia Autonoma Bolzano / Bozen,P.A. Bolzano,533050,38917,7.3,0.01
1350,2021-03-10,PAB,1261,524,737,659,102,0,118,4,6,134,14,133,91,1118,143,ITH,ITH1,4,Provincia Autonoma Bolzano / Bozen,P.A. Bolzano,533050,40178,7.54,0.24
1351,2021-01-02,PAB,91,48,43,69,1,0,0,5,1,0,0,0,15,91,0,ITH,ITH1,4,Provincia Autonoma Bolzano / Bozen,P.A. Bolzano,533050,40269,7.55,0.02
1352,2020-12-30,PAB,387,181,206,342,41,0,0,0,0,0,0,0,4,387,0,ITH,ITH1,4,Provincia Autonoma Bolzano / Bozen,P.A. Bolzano,533050,40656,7.63,0.07
1353,2021-01-11,PAB,1567,513,1054,585,283,175,0,55,41,161,0,0,267,1567,0,ITH,ITH1,4,Provincia Autonoma Bolzano / Bozen,P.A. Bolzano,533050,42223,7.92,0.29
1354,2021-04-09,PAB,2922,1289,1633,337,111,102,14,47,635,279,1358,14,25,2193,729,ITH,ITH1,4,Provincia Autonoma Bolzano / Bozen,P.A. Bolzano,533050,45145,8.47,0.55
1355,2021-02-08,PAB,2,1,1,0,0,0,0,0,0,1,0,0,1,1,1,ITH,ITH1,4,Provincia Autonoma Bolzano / Bozen,P.A. Bolzano,533050,45147,8.47,0.0
1356,2021-02-02,PAB,1745,506,1239,630,370,605,0,9,10,11,0,0,110,8,1737,ITH,ITH1,4,Provincia Autonoma Bolzano / Bozen,P.A. Bolzano,533050,46892,8.8,0.33
1357,2021-01-14,PAB,1905,567,1338,520,430,290,0,63,40,326,0,0,236,1905,0,ITH,ITH1,4,Provincia Autonoma Bolzano / Bozen,P.A. Bolzano,533050,48797,9.15,0.36
1358,2021-01-15,PAB,3276,1226,2050,607,307,342,0,80,29,1446,0,0,465,3276,0,ITH,ITH1,4,Provincia Autonoma Bolzano / Bozen,P.A. Bolzano,533050,52073,9.77,0.61
1359,2021-01-09,PAB,612,326,286,76,28,74,0,66,19,14,0,0,335,612,0,ITH,ITH1,4,Provincia Autonoma Bolzano / Bozen,P.A. Bolzano,533050,52685,9.88,0.11
1360,2021-03-29,PAB,989,423,566,10,2,0,13,0,157,711,67,26,3,230,759,ITH,ITH1,4,Provincia Autonoma Bolzano / Bozen,P.A. Bolzano,533050,53674,10.07,0.19
1361,2021-03-15,PAB,848,295,553,293,97,13,4,16,216,66,66,4,73,366,482,ITH,ITH1,4,Provincia Autonoma Bolzano / Bozen,P.A. Bolzano,533050,54522,10.23,0.16
1362,2021-03-19,PAB,1903,772,1131,158,58,15,14,9,138,1182,311,0,18,797,1106,ITH,ITH1,4,Provincia Autonoma Bolzano / Bozen,P.A. Bolzano,533050,56425,10.59,0.36
1363,2021-03-05,PAB,1802,613,1189,337,98,59,240,8,2,860,125,9,64,1360,442,ITH,ITH1,4,Provincia Autonoma Bolzano / Bozen,P.A. Bolzano,533050,58227,10.92,0.34
1364,2021-04-18,PAB,3110,1607,1503,28,14,2,27,1916,524,134,188,273,4,2100,1010,ITH,ITH1,4,Provincia Autonoma Bolzano / Bozen,P.A. Bolzano,533050,61337,11.51,0.58
1365,2021-03-21,PAB,768,285,483,165,17,1,3,3,9,568,0,0,2,14,754,ITH,ITH1,4,Provincia Autonoma Bolzano / Bozen,P.A. Bolzano,533050,62105,11.65,0.14
1366,2021-01-13,PAB,1691,557,1134,446,310,270,0,66,30,175,0,0,394,1691,0,ITH,ITH1,4,Provincia Autonoma Bolzano / Bozen,P.A. Bolzano,533050,63796,11.97,0.32
1367,2021-03-30,PAB,1298,532,766,51,7,153,27,0,121,924,1,11,3,218,1080,ITH,ITH1,4,Provincia Autonoma Bolzano / Bozen,P.A. Bolzano,533050,65094,12.21,0.24
1368,2021-01-18,PAB,1769,686,1083,388,102,7,0,32,56,1020,0,0,164,1764,5,ITH,ITH1,4,Provincia Autonoma Bolzano / Bozen,P.A. Bolzano,533050,66863,12.54,0.33
1369,2021-03-27,PAB,3047,1552,1495,322,36,0,46,31,481,1440,360,305,26,1541,1506,ITH,ITH1,4,Provincia Autonoma Bolzano / Bozen,P.A. Bolzano,533050,69910,13.12,0.57
1370,2021-03-07,PAB,114,13,101,59,50,0,1,0,0,3,0,0,1,9,105,ITH,ITH1,4,Provincia Autonoma Bolzano / Bozen,P.A. Bolzano,533050,70024,13.14,0.02
1371,2021-04-14,PAB,3588,1643,1945,417,139,20,30,1094,829,124,845,80,10,3496,92,ITH,ITH1,4,Provincia Autonoma Bolzano / Bozen,P.A. Bolzano,533050,73612,13.81,0.67
1372,2021-04-02,PAB,2077,837,1240,189,66,60,17,5,253,935,532,11,9,720,1357,ITH,ITH1,4,Provincia Autonoma Bolzano / Bozen,P.A. Bolzano,533050,75689,14.2,0.39
1373,2021-04-12,PAB,2101,943,1158,32,11,1,2,159,1652,93,142,3,6,2095,6,ITH,ITH1,4,Provincia Autonoma Bolzano / Bozen,P.A. Bolzano,533050,77790,14.59,0.39
1374,2021-03-20,PAB,1757,848,909,115,48,9,1,7,265,967,238,99,8,1132,625,ITH,ITH1,4,Provincia Autonoma Bolzano / Bozen,P.A. Bolzano,533050,79547,14.92,0.33
1375,2021-02-12,PAB,730,217,513,322,71,106,0,10,6,141,0,2,72,482,248,ITH,ITH1,4,Provincia Autonoma Bolzano / Bozen,P.A. Bolzano,533050,80277,15.06,0.14
1376,2021-02-22,PAB,526,143,383,342,68,0,10,15,4,5,0,1,81,514,12,ITH,ITH1,4,Provincia Autonoma Bolzano / Bozen,P.A. Bolzano,533050,80803,15.16,0.1
1377,2021-03-04,PAB,1703,998,705,301,80,39,262,11,5,173,72,709,51,1474,229,ITH,ITH1,4,Provincia Autonoma Bolzano / Bozen,P.A. Bolzano,533050,82506,15.48,0.32
1378,2021-02-13,PAB,318,79,239,126,57,7,0,0,0,126,0,0,2,312,6,ITH,ITH1,4,Provincia Autonoma Bolzano / Bozen,P.A. Bolzano,533050,82824,15.54,0.06
1379,2021-02-24,PAB,1365,405,960,10,3,0,1344,0,0,0,0,8,0,1353,12,ITH,ITH1,4,Provincia Autonoma Bolzano / Bozen,P.A. Bolzano,533050,84189,15.79,0.26
1380,2021-03-09,PAB,1194,543,651,29,81,22,47,0,1,930,0,80,4,1192,2,ITH,ITH1,4,Provincia Autonoma Bolzano / Bozen,P.A. Bolzano,533050,85383,16.02,0.22
1381,2021-01-27,PAB,84,28,56,54,26,0,0,1,0,0,0,0,3,1,83,ITH,ITH1,4,Provincia Autonoma Bolzano / Bozen,P.A. Bolzano,533050,85467,16.03,0.02
1382,2021-03-31,PAB,1831,693,1138,420,304,22,16,15,159,431,424,19,21,818,1013,ITH,ITH1,4,Provincia Autonoma Bolzano / Bozen,P.A. Bolzano,533050,87298,16.38,0.34
1383,2021-03-08,PAB,1200,526,674,23,10,166,3,25,38,755,162,0,18,1173,27,ITH,ITH1,4,Provincia Autonoma Bolzano / Bozen,P.A. Bolzano,533050,88498,16.6,0.23
1384,2021-01-10,PAB,2,2,0,1,0,0,0,0,0,0,0,0,1,2,0,ITH,ITH1,4,Provincia Autonoma Bolzano / Bozen,P.A. Bolzano,533050,88500,16.6,0.0
1385,2021-04-08,PAB,2746,1334,1412,47,32,118,2,17,2010,83,309,91,37,2549,197,ITH,ITH1,4,Provincia Autonoma Bolzano / Bozen,P.A. Bolzano,533050,91246,17.12,0.52
1386,2021-03-02,PAB,684,194,490,1,0,0,676,0,0,0,0,7,0,684,0,ITH,ITH1,4,Provincia Autonoma Bolzano / Bozen,P.A. Bolzano,533050,91930,17.25,0.13
1387,2021-01-20,PAB,617,252,365,287,51,0,0,6,3,257,0,0,13,409,208,ITH,ITH1,4,Provincia Autonoma Bolzano / Bozen,P.A. Bolzano,533050,92547,17.36,0.12
1388,2021-01-23,PAB,197,117,80,191,0,0,0,2,0,0,0,0,4,0,197,ITH,ITH1,4,Provincia Autonoma Bolzano / Bozen,P.A. Bolzano,533050,92744,17.4,0.04
1389,2021-04-06,PAB,2042,1024,1018,107,46,130,3,10,826,83,805,16,16,1940,102,ITH,ITH1,4,Provincia Autonoma Bolzano / Bozen,P.A. Bolzano,533050,94786,17.78,0.38
1390,2021-01-17,PAB,2328,1044,1284,56,38,37,0,57,46,1989,0,0,105,2317,11,ITH,ITH1,4,Provincia Autonoma Bolzano / Bozen,P.A. Bolzano,533050,97114,18.22,0.44
1391,2021-02-04,PAB,1927,587,1340,650,505,433,0,22,24,232,0,0,61,8,1919,ITH,ITH1,4,Provincia Autonoma Bolzano / Bozen,P.A. Bolzano,533050,99041,18.58,0.36
1392,2021-04-11,PAB,2719,1291,1428,46,17,3,63,350,1671,84,222,257,6,2541,178,ITH,ITH1,4,Provincia Autonoma Bolzano / Bozen,P.A. Bolzano,533050,101760,19.09,0.51
1393,2021-01-28,PAB,868,307,561,584,186,69,0,8,0,0,0,2,19,10,858,ITH,ITH1,4,Provincia Autonoma Bolzano / Bozen,P.A. Bolzano,533050,102628,19.25,0.16
1394,2021-03-22,PAB,1133,514,619,2,0,0,0,6,900,192,13,15,5,1129,4,ITH,ITH1,4,Provincia Autonoma Bolzano / Bozen,P.A. Bolzano,533050,103761,19.47,0.21
1395,2021-02-27,PAB,2457,759,1698,202,87,8,1233,8,13,885,0,3,18,2447,10,ITH,ITH1,4,Provincia Autonoma Bolzano / Bozen,P.A. Bolzano,533050,106218,19.93,0.46
1396,2021-01-25,PAB,487,183,304,401,68,0,1,4,0,1,0,2,10,3,484,ITH,ITH1,4,Provincia Autonoma Bolzano / Bozen,P.A. Bolzano,533050,106705,20.02,0.09
1397,2021-04-07,PAB,1777,802,975,128,81,57,2,6,908,459,26,100,10,1238,539,ITH,ITH1,4,Provincia Autonoma Bolzano / Bozen,P.A. Bolzano,533050,108482,20.35,0.33
1398,2021-02-09,PAB,317,126,191,64,17,2,2,1,0,228,0,0,3,1,316,ITH,ITH1,4,Provincia Autonoma Bolzano / Bozen,P.A. Bolzano,533050,108799,20.41,0.06
1399,2021-03-17,PAB,580,213,367,11,6,46,0,0,16,491,0,0,10,579,1,ITH,ITH1,4,Provincia Autonoma Bolzano / Bozen,P.A. Bolzano,533050,109379,20.52,0.11
1400,2021-03-03,PAB,1166,391,775,12,5,6,738,3,0,349,0,51,2,1153,13,ITH,ITH1,4,Provincia Autonoma Bolzano / Bozen,P.A. Bolzano,533050,110545,20.74,0.22
1401,2021-01-08,PAB,1514,476,1038,787,167,168,0,51,29,104,0,0,208,1514,0,ITH,ITH1,4,Provincia Autonoma Bolzano / Bozen,P.A. Bolzano,533050,112059,21.02,0.28
1402,2021-02-19,PAB,1969,450,1519,121,142,80,1511,3,3,86,6,0,17,1958,11,ITH,ITH1,4,Provincia Autonoma Bolzano / Bozen,P.A. Bolzano,533050,114028,21.39,0.37
1403,2021-02-18,PAB,1646,401,1245,23,44,21,1285,1,1,261,0,0,10,1642,4,ITH,ITH1,4,Provincia Autonoma Bolzano / Bozen,P.A. Bolzano,533050,115674,21.7,0.31
1404,2021-02-25,PAB,1498,549,949,22,5,0,405,2,1,1041,0,0,22,1497,1,ITH,ITH1,4,Provincia Autonoma Bolzano / Bozen,P.A. Bolzano,533050,117172,21.98,0.28
1405,2020-12-31,PAB,911,518,393,477,61,0,0,47,9,1,0,0,316,911,0,ITH,ITH1,4,Provincia Autonoma Bolzano / Bozen,P.A. Bolzano,533050,118083,22.15,0.17
1406,2021-01-03,PAB,41,16,25,33,5,0,0,0,0,1,0,0,2,41,0,ITH,ITH1,4,Provincia Autonoma Bolzano / Bozen,P.A. Bolzano,533050,118124,22.16,0.01
1407,2021-01-26,PAB,810,291,519,673,129,0,0,3,1,0,0,0,4,1,809,ITH,ITH1,4,Provincia Autonoma Bolzano / Bozen,P.A. Bolzano,533050,118934,22.31,0.15
1408,2021-03-26,PAB,1631,716,915,20,14,68,1,8,132,917,424,0,47,509,1122,ITH,ITH1,4,Provincia Autonoma Bolzano / Bozen,P.A. Bolzano,533050,120565,22.62,0.31
1409,2021-03-16,PAB,776,308,468,25,31,48,0,4,14,645,6,2,1,123,653,ITH,ITH1,4,Provincia Autonoma Bolzano / Bozen,P.A. Bolzano,533050,121341,22.76,0.15
1410,2021-04-01,PAB,2782,1405,1377,238,104,44,65,20,509,607,731,446,18,2638,144,ITH,ITH1,4,Provincia Autonoma Bolzano / Bozen,P.A. Bolzano,533050,124123,23.29,0.52
1411,2021-04-13,PAB,2391,1130,1261,23,4,1,6,1246,932,30,93,55,1,2383,8,ITH,ITH1,4,Provincia Autonoma Bolzano / Bozen,P.A. Bolzano,533050,126514,23.73,0.45
1412,2021-01-16,PAB,2820,1253,1567,435,93,77,1,52,97,1969,0,0,96,2820,0,ITH,ITH1,4,Provincia Autonoma Bolzano / Bozen,P.A. Bolzano,533050,129334,24.26,0.53
1413,2021-02-07,PAB,2361,1057,1304,102,75,68,0,51,44,1951,0,0,70,14,2347,ITH,ITH1,4,Provincia Autonoma Bolzano / Bozen,P.A. Bolzano,533050,131695,24.71,0.44
1414,2021-01-21,PAB,952,442,510,750,88,68,0,1,0,28,0,5,12,139,813,ITH,ITH1,4,Provincia Autonoma Bolzano / Bozen,P.A. Bolzano,533050,132647,24.88,0.18
1415,2021-03-25,PAB,2123,1053,1070,215,72,32,46,22,843,304,295,267,27,1696,427,ITH,ITH1,4,Provincia Autonoma Bolzano / Bozen,P.A. Bolzano,533050,134770,25.28,0.4
1416,2021-03-23,PAB,1552,759,793,0,1,0,34,5,1156,215,58,68,15,1551,1,ITH,ITH1,4,Provincia Autonoma Bolzano / Bozen,P.A. Bolzano,533050,136322,25.57,0.29
1417,2021-03-24,PAB,2040,977,1063,13,16,7,29,6,1361,248,278,61,21,2027,13,ITH,ITH1,4,Provincia Autonoma Bolzano / Bozen,P.A. Bolzano,533050,138362,25.96,0.38
1418,2021-01-05,PAB,830,286,544,734,62,0,0,8,2,0,0,0,24,830,0,ITH,ITH1,4,Provincia Autonoma Bolzano / Bozen,P.A. Bolzano,533050,139192,26.11,0.16
1419,2020-12-27,PAB,144,65,79,139,2,0,0,0,0,1,0,0,2,144,0,ITH,ITH1,4,Provincia Autonoma Bolzano / Bozen,P.A. Bolzano,533050,139336,26.14,0.03
1420,2021-03-14,PAB,758,336,422,130,11,33,0,3,7,562,1,2,9,25,733,ITH,ITH1,4,Provincia Autonoma Bolzano / Bozen,P.A. Bolzano,533050,140094,26.28,0.14
1421,2021-01-30,PAB,498,245,253,217,46,101,0,29,2,0,0,0,103,4,494,ITH,ITH1,4,Provincia Autonoma Bolzano / Bozen,P.A. Bolzano,533050,140592,26.38,0.09
1422,2021-01-24,PAB,12,10,2,1,0,0,0,2,1,0,0,0,8,0,12,ITH,ITH1,4,Provincia Autonoma Bolzano / Bozen,P.A. Bolzano,533050,140604,26.38,0.0
1423,2021-02-17,PAB,4,1,3,1,0,0,0,0,0,2,1,0,0,2,2,ITH,ITH1,4,Provincia Autonoma Bolzano / Bozen,P.A. Bolzano,533050,140608,26.38,0.0
1424,2021-02-23,PAB,768,323,445,0,0,0,85,2,1,672,0,0,8,762,6,ITH,ITH1,4,Provincia Autonoma Bolzano / Bozen,P.A. Bolzano,533050,141376,26.52,0.14
1425,2021-04-19,PAB,1811,828,983,44,22,1,11,985,297,165,268,8,10,1629,182,ITH,ITH1,4,Provincia Autonoma Bolzano / Bozen,P.A. Bolzano,533050,143187,26.86,0.34
1426,2021-04-15,PAB,4394,2305,2089,119,48,38,118,1386,735,174,1259,492,25,4131,263,ITH,ITH1,4,Provincia Autonoma Bolzano / Bozen,P.A. Bolzano,533050,147581,27.69,0.82
1427,2021-03-28,PAB,569,212,357,45,38,0,2,6,5,470,2,0,1,11,558,ITH,ITH1,4,Provincia Autonoma Bolzano / Bozen,P.A. Bolzano,533050,148150,27.79,0.11
1428,2021-01-12,PAB,1709,459,1250,369,228,479,0,54,43,134,0,0,402,1709,0,ITH,ITH1,4,Provincia Autonoma Bolzano / Bozen,P.A. Bolzano,533050,149859,28.11,0.32
1429,2021-02-11,PAB,1091,431,660,213,92,104,0,4,2,590,56,0,30,239,852,ITH,ITH1,4,Provincia Autonoma Bolzano / Bozen,P.A. Bolzano,533050,150950,28.32,0.2
1430,2021-02-10,PAB,1635,604,1031,489,166,1,0,18,5,872,0,1,83,26,1609,ITH,ITH1,4,Provincia Autonoma Bolzano / Bozen,P.A. Bolzano,533050,152585,28.62,0.31
1431,2021-01-01,PAB,2,2,0,2,0,0,0,0,0,0,0,0,0,2,0,ITH,ITH1,4,Provincia Autonoma Bolzano / Bozen,P.A. Bolzano,533050,152587,28.63,0.0
1432,2021-01-29,PAB,1496,510,986,882,282,295,4,6,1,4,0,0,22,23,1473,ITH,ITH1,4,Provincia Autonoma Bolzano / Bozen,P.A. Bolzano,533050,154083,28.91,0.28
1433,2021-03-18,PAB,1299,530,769,50,15,49,0,10,14,1056,70,0,35,223,1076,ITH,ITH1,4,Provincia Autonoma Bolzano / Bozen,P.A. Bolzano,533050,155382,29.15,0.24
1434,2021-03-12,PAB,1658,734,924,149,172,78,101,9,268,524,134,204,19,1251,407,ITH,ITH1,4,Provincia Autonoma Bolzano / Bozen,P.A. Bolzano,533050,157040,29.46,0.31
1435,2021-02-15,PAB,72,42,30,17,2,40,0,0,1,7,0,0,5,26,46,ITH,ITH1,4,Provincia Autonoma Bolzano / Bozen,P.A. Bolzano,533050,157112,29.47,0.01
1436,2021-03-29,VEN,31231,13499,17732,606,435,466,442,1024,5823,17189,3322,814,1110,27380,3851,ITH,ITH3,5,Veneto,Veneto,4905854,31231,0.64,0.64
1437,2021-01-02,VEN,5742,1765,3977,4801,233,544,3,24,2,3,0,0,132,5742,0,ITH,ITH3,5,Veneto,Veneto,4905854,36973,0.75,0.12
1438,2021-03-15,VEN,16520,7192,9328,1386,772,372,1969,145,599,9248,1042,651,336,11305,5215,ITH,ITH3,5,Veneto,Veneto,4905854,53493,1.09,0.34
1439,2021-03-09,VEN,16430,7370,9060,1288,345,741,2948,109,60,8547,655,1116,621,10144,6286,ITH,ITH3,5,Veneto,Veneto,4905854,69923,1.43,0.33
1440,2021-02-05,VEN,8367,2533,5834,4298,1437,2163,13,66,20,8,1,6,355,1423,6944,ITH,ITH3,5,Veneto,Veneto,4905854,78290,1.6,0.17
1441,2021-01-07,VEN,8359,2318,6041,5470,852,1804,2,41,18,35,0,0,137,8359,0,ITH,ITH3,5,Veneto,Veneto,4905854,86649,1.77,0.17
1442,2021-03-18,VEN,12582,5128,7454,1472,691,495,855,105,140,7505,1028,36,255,7359,5223,ITH,ITH3,5,Veneto,Veneto,4905854,99231,2.02,0.26
1443,2021-02-26,VEN,8274,3262,5012,1781,520,742,315,65,30,4379,143,91,208,7022,1252,ITH,ITH3,5,Veneto,Veneto,4905854,107505,2.19,0.17
1444,2021-01-13,VEN,5986,1607,4379,2795,1123,1888,2,21,6,3,0,1,147,5986,0,ITH,ITH3,5,Veneto,Veneto,4905854,113491,2.31,0.12
1445,2021-03-21,VEN,11977,4753,7224,1571,1125,42,2529,132,201,4243,1618,179,337,8518,3459,ITH,ITH3,5,Veneto,Veneto,4905854,125468,2.56,0.24
1446,2021-03-11,VEN,19576,8667,10909,1653,1109,888,3686,193,72,9323,705,1184,763,13994,5582,ITH,ITH3,5,Veneto,Veneto,4905854,145044,2.96,0.4
1447,2021-02-23,VEN,7364,3243,4121,1020,202,245,183,48,21,5343,49,69,184,7104,260,ITH,ITH3,5,Veneto,Veneto,4905854,152408,3.11,0.15
1448,2021-03-01,VEN,9386,3710,5676,2047,403,954,2519,106,21,2610,161,272,293,7564,1822,ITH,ITH3,5,Veneto,Veneto,4905854,161794,3.3,0.19
1449,2021-02-16,VEN,6631,2868,3763,726,240,478,3,18,14,5020,34,2,96,6452,179,ITH,ITH3,5,Veneto,Veneto,4905854,168425,3.43,0.14
1450,2021-02-17,VEN,6020,2771,3249,423,156,361,4,23,11,4946,24,5,67,5926,94,ITH,ITH3,5,Veneto,Veneto,4905854,174445,3.56,0.12
1451,2021-03-06,VEN,10525,4260,6265,3176,839,1491,1328,63,26,1971,1275,128,228,7325,3200,ITH,ITH3,5,Veneto,Veneto,4905854,184970,3.77,0.21
1452,2021-01-22,VEN,1080,332,748,947,52,57,3,1,0,0,0,0,20,25,1055,ITH,ITH3,5,Veneto,Veneto,4905854,186050,3.79,0.02
1453,2021-04-17,VEN,21738,8832,12906,795,222,130,86,462,3251,10048,6426,16,302,14494,7244,ITH,ITH3,5,Veneto,Veneto,4905854,207788,4.24,0.44
1454,2021-01-29,VEN,9007,2783,6224,6050,1194,1435,6,64,18,3,0,2,235,368,8639,ITH,ITH3,5,Veneto,Veneto,4905854,216795,4.42,0.18
1455,2021-03-03,VEN,11984,4547,7437,3339,676,1236,2342,101,41,3377,144,400,328,8490,3494,ITH,ITH3,5,Veneto,Veneto,4905854,228779,4.66,0.24
1456,2021-03-31,VEN,38052,15897,22155,1614,680,807,405,1390,9390,18884,3065,343,1474,30607,7445,ITH,ITH3,5,Veneto,Veneto,4905854,266831,5.44,0.78
1457,2021-02-28,VEN,4136,1389,2747,1741,942,15,15,22,1,992,301,76,31,3299,837,ITH,ITH3,5,Veneto,Veneto,4905854,270967,5.52,0.08
1458,2021-02-04,VEN,7317,2015,5302,3465,1101,2380,6,34,15,20,1,0,295,553,6764,ITH,ITH3,5,Veneto,Veneto,4905854,278284,5.67,0.15
1459,2021-03-10,VEN,18879,8585,10294,1484,839,560,4149,189,86,9048,645,1269,610,13196,5683,ITH,ITH3,5,Veneto,Veneto,4905854,297163,6.06,0.38
1460,2021-01-31,VEN,4766,1561,3205,3713,556,377,4,16,2,5,2,12,79,393,4373,ITH,ITH3,5,Veneto,Veneto,4905854,301929,6.15,0.1
1461,2021-02-09,VEN,5175,1876,3299,3099,636,1201,6,41,10,20,0,1,161,3444,1731,ITH,ITH3,5,Veneto,Veneto,4905854,307104,6.26,0.11
1462,2021-02-21,VEN,4624,1204,3420,495,1,18,3685,0,0,417,0,2,6,4619,5,ITH,ITH3,5,Veneto,Veneto,4905854,311728,6.35,0.09
1463,2021-01-26,VEN,6914,2089,4825,5347,521,976,5,9,3,0,0,1,52,154,6760,ITH,ITH3,5,Veneto,Veneto,4905854,318642,6.5,0.14
1464,2021-03-17,VEN,14596,5961,8635,1968,743,300,700,127,192,8779,1379,26,382,7831,6765,ITH,ITH3,5,Veneto,Veneto,4905854,333238,6.79,0.3
1465,2021-01-09,VEN,7931,2538,5393,5201,938,1573,6,38,4,3,22,11,135,7931,0,ITH,ITH3,5,Veneto,Veneto,4905854,341169,6.95,0.16
1466,2021-04-13,VEN,13742,6209,7533,710,194,287,66,343,2170,5137,4407,26,402,8304,5438,ITH,ITH3,5,Veneto,Veneto,4905854,354911,7.23,0.28
1467,2021-03-14,VEN,15142,5913,9229,2399,2025,100,3659,156,1442,3751,983,255,372,14246,896,ITH,ITH3,5,Veneto,Veneto,4905854,370053,7.54,0.31
1468,2021-02-07,VEN,2314,861,1453,1972,238,50,2,14,3,2,0,7,26,714,1600,ITH,ITH3,5,Veneto,Veneto,4905854,372367,7.59,0.05
1469,2021-01-04,VEN,6729,2030,4699,5251,424,913,6,14,2,1,0,0,118,6729,0,ITH,ITH3,5,Veneto,Veneto,4905854,379096,7.73,0.14
1470,2021-01-18,VEN,2763,777,1986,1224,469,992,1,11,4,8,0,1,53,2564,199,ITH,ITH3,5,Veneto,Veneto,4905854,381859,7.78,0.06
1471,2020-12-30,VEN,699,245,454,598,52,39,2,0,0,0,0,0,8,699,0,ITH,ITH3,5,Veneto,Veneto,4905854,382558,7.8,0.01
1472,2021-02-01,VEN,8518,2490,6028,4216,1534,2105,10,67,25,265,0,0,296,161,8357,ITH,ITH3,5,Veneto,Veneto,4905854,391076,7.97,0.17
1473,2021-01-19,VEN,1309,472,837,726,214,326,0,6,3,7,0,0,27,1160,149,ITH,ITH3,5,Veneto,Veneto,4905854,392385,8.0,0.03
1474,2021-03-12,VEN,18539,8108,10431,2010,1296,755,3509,213,121,8048,804,1009,774,11821,6718,ITH,ITH3,5,Veneto,Veneto,4905854,410924,8.38,0.38
1475,2020-12-31,VEN,3218,1042,2176,2700,94,252,2,23,0,0,0,0,147,3218,0,ITH,ITH3,5,Veneto,Veneto,4905854,414142,8.44,0.07
1476,2021-04-05,VEN,19138,8372,10766,622,428,327,176,343,9880,5517,1675,22,148,13687,5451,ITH,ITH3,5,Veneto,Veneto,4905854,433280,8.83,0.39
1477,2021-01-03,VEN,5159,1563,3596,4601,255,249,2,13,1,0,0,0,38,5159,0,ITH,ITH3,5,Veneto,Veneto,4905854,438439,8.94,0.11
1478,2021-01-21,VEN,2290,719,1571,1986,74,141,3,11,0,0,0,0,75,21,2269,ITH,ITH3,5,Veneto,Veneto,4905854,440729,8.98,0.05
1479,2021-03-30,VEN,35647,15101,20546,775,409,580,471,1660,8728,17175,3820,489,1540,30392,5255,ITH,ITH3,5,Veneto,Veneto,4905854,476376,9.71,0.73
1480,2021-02-03,VEN,5935,1661,4274,2854,1124,1746,6,23,7,3,0,0,172,481,5454,ITH,ITH3,5,Veneto,Veneto,4905854,482311,9.83,0.12
1481,2021-01-30,VEN,8745,2671,6074,6288,971,1234,9,53,4,4,2,12,168,694,8051,ITH,ITH3,5,Veneto,Veneto,4905854,491056,10.01,0.18
1482,2021-02-13,VEN,3267,1474,1793,1592,198,1438,1,11,2,3,1,1,20,3247,20,ITH,ITH3,5,Veneto,Veneto,4905854,494323,10.08,0.07
1483,2021-02-06,VEN,4091,1352,2739,3095,520,367,4,19,5,3,0,1,77,709,3382,ITH,ITH3,5,Veneto,Veneto,4905854,498414,10.16,0.08
1484,2021-01-24,VEN,4117,1219,2898,3755,94,222,4,5,1,1,0,0,35,28,4089,ITH,ITH3,5,Veneto,Veneto,4905854,502531,10.24,0.08
1485,2021-04-16,VEN,23697,10195,13502,716,300,398,123,527,5696,9836,5542,36,523,11857,11840,ITH,ITH3,5,Veneto,Veneto,4905854,526228,10.73,0.48
1486,2021-03-22,VEN,18071,8124,9947,1195,1333,549,2493,216,2776,6708,1569,782,450,13027,5044,ITH,ITH3,5,Veneto,Veneto,4905854,544299,11.09,0.37
1487,2021-03-23,VEN,22027,10144,11883,1114,1111,671,2867,284,5281,6685,2332,1045,637,17385,4642,ITH,ITH3,5,Veneto,Veneto,4905854,566326,11.54,0.45
1488,2021-03-24,VEN,21921,9420,12501,1190,1024,806,3099,277,1502,10424,2203,900,496,15115,6806,ITH,ITH3,5,Veneto,Veneto,4905854,588247,11.99,0.45
1489,2021-04-10,VEN,27194,11851,15343,581,314,407,115,444,9292,10832,4848,13,348,18717,8477,ITH,ITH3,5,Veneto,Veneto,4905854,615441,12.55,0.55
1490,2021-04-02,VEN,23598,10373,13225,1090,541,365,298,673,7333,9862,2691,150,595,17275,6323,ITH,ITH3,5,Veneto,Veneto,4905854,639039,13.03,0.48
1491,2021-03-04,VEN,12793,4743,8050,3163,816,1417,2832,91,56,3414,315,431,258,9374,3419,ITH,ITH3,5,Veneto,Veneto,4905854,651832,13.29,0.26
1492,2021-04-19,VEN,15856,6595,9261,605,194,238,171,320,2091,8793,3213,9,222,2815,13041,ITH,ITH3,5,Veneto,Veneto,4905854,667688,13.61,0.32
1493,2021-02-22,VEN,6988,3028,3960,754,135,342,243,26,15,5400,38,1,34,6601,387,ITH,ITH3,5,Veneto,Veneto,4905854,674676,13.75,0.14
1494,2021-02-08,VEN,4973,1540,3433,2820,771,1177,4,37,8,12,1,0,143,1930,3043,ITH,ITH3,5,Veneto,Veneto,4905854,679649,13.85,0.1
1495,2021-01-01,VEN,1527,471,1056,1496,7,1,3,0,0,0,0,0,20,1527,0,ITH,ITH3,5,Veneto,Veneto,4905854,681176,13.88,0.03
1496,2021-01-27,VEN,7140,2065,5075,5211,718,879,9,89,23,2,0,0,209,245,6895,ITH,ITH3,5,Veneto,Veneto,4905854,688316,14.03,0.15
1497,2021-01-05,VEN,7332,2184,5148,5419,658,1122,5,23,2,1,0,2,100,7332,0,ITH,ITH3,5,Veneto,Veneto,4905854,695648,14.18,0.15
1498,2021-01-20,VEN,1038,368,670,695,116,213,1,5,1,2,0,0,5,386,652,ITH,ITH3,5,Veneto,Veneto,4905854,696686,14.2,0.02
1499,2021-02-02,VEN,6403,1843,4560,2974,1134,1994,3,25,6,153,1,0,113,390,6013,ITH,ITH3,5,Veneto,Veneto,4905854,703089,14.33,0.13
1500,2021-04-18,VEN,17227,7149,10078,503,166,66,110,374,2229,7269,6210,14,286,9682,7545,ITH,ITH3,5,Veneto,Veneto,4905854,720316,14.68,0.35
1501,2020-12-27,VEN,880,395,485,875,1,0,1,0,1,0,0,0,2,880,0,ITH,ITH3,5,Veneto,Veneto,4905854,721196,14.7,0.02
1502,2021-04-03,VEN,21700,9508,12192,1345,793,150,129,506,6345,8541,3251,27,613,13967,7733,ITH,ITH3,5,Veneto,Veneto,4905854,742896,15.14,0.44
1503,2021-01-28,VEN,9206,2662,6544,6487,1070,1451,5,40,3,7,1,0,142,175,9031,ITH,ITH3,5,Veneto,Veneto,4905854,752102,15.33,0.19
1504,2021-04-08,VEN,31764,14069,17695,849,672,579,441,936,10920,10208,6438,110,611,23935,7829,ITH,ITH3,5,Veneto,Veneto,4905854,783866,15.98,0.65
1505,2021-01-10,VEN,5031,1670,3361,3855,563,462,1,10,2,4,0,2,132,5031,0,ITH,ITH3,5,Veneto,Veneto,4905854,788897,16.08,0.1
1506,2021-02-18,VEN,5792,2444,3348,956,245,667,8,33,14,3798,2,1,68,5728,64,ITH,ITH3,5,Veneto,Veneto,4905854,794689,16.2,0.12
1507,2021-02-27,VEN,8987,2691,6296,2314,163,64,4128,44,14,1963,32,86,179,8137,850,ITH,ITH3,5,Veneto,Veneto,4905854,803676,16.38,0.18
1508,2021-04-04,VEN,7765,3524,4241,23,41,1,13,139,4979,1325,1194,2,48,6615,1150,ITH,ITH3,5,Veneto,Veneto,4905854,811441,16.54,0.16
1509,2021-03-16,VEN,12466,5331,7135,1394,382,485,129,125,112,7720,1751,21,347,6856,5610,ITH,ITH3,5,Veneto,Veneto,4905854,823907,16.79,0.25
1510,2021-02-25,VEN,7896,3339,4557,1541,348,473,297,34,35,4937,20,109,102,7294,602,ITH,ITH3,5,Veneto,Veneto,4905854,831803,16.96,0.16
1511,2021-03-26,VEN,29378,12992,16386,1273,1696,1218,1923,455,8109,9832,3138,937,797,23894,5484,ITH,ITH3,5,Veneto,Veneto,4905854,861181,17.55,0.6
1512,2021-02-19,VEN,7297,3124,4173,1545,554,665,9,35,15,4366,4,4,100,7095,202,ITH,ITH3,5,Veneto,Veneto,4905854,868478,17.7,0.15
1513,2021-01-06,VEN,8133,2386,5747,6351,672,808,10,83,24,2,2,2,179,8133,0,ITH,ITH3,5,Veneto,Veneto,4905854,876611,17.87,0.17
1514,2021-02-14,VEN,125,56,69,97,22,0,0,2,0,0,0,0,4,112,13,ITH,ITH3,5,Veneto,Veneto,4905854,876736,17.87,0.0
1515,2021-01-08,VEN,9402,2834,6568,5988,1287,1807,12,65,18,3,1,1,220,9402,0,ITH,ITH3,5,Veneto,Veneto,4905854,886138,18.06,0.19
1516,2021-01-16,VEN,4607,1542,3065,3194,670,657,0,14,6,0,0,1,65,4607,0,ITH,ITH3,5,Veneto,Veneto,4905854,890745,18.16,0.09
1517,2021-03-20,VEN,12899,5327,7572,697,242,320,2372,153,1612,4729,2093,219,462,10803,2096,ITH,ITH3,5,Veneto,Veneto,4905854,903644,18.42,0.26
1518,2021-04-01,VEN,24161,10512,13649,951,609,584,152,908,6908,10077,2974,201,797,17792,6369,ITH,ITH3,5,Veneto,Veneto,4905854,927805,18.91,0.49
1519,2021-03-19,VEN,13775,5663,8112,1949,1037,512,727,160,129,7562,1219,55,425,7681,6094,ITH,ITH3,5,Veneto,Veneto,4905854,941580,19.19,0.28
1520,2021-01-17,VEN,1932,780,1152,1588,193,120,2,3,1,3,0,0,22,1583,349,ITH,ITH3,5,Veneto,Veneto,4905854,943512,19.23,0.04
1521,2021-04-06,VEN,28034,12872,15162,425,205,387,103,544,16110,5432,4523,59,246,22966,5068,ITH,ITH3,5,Veneto,Veneto,4905854,971546,19.8,0.57
1522,2021-02-24,VEN,8611,3677,4934,1586,389,521,14,35,28,5592,37,273,136,8126,485,ITH,ITH3,5,Veneto,Veneto,4905854,980157,19.98,0.18
1523,2021-03-28,VEN,31284,13597,17687,1452,1433,172,2441,1202,8635,9309,3746,56,2838,27598,3686,ITH,ITH3,5,Veneto,Veneto,4905854,1011441,20.62,0.64
1524,2021-02-12,VEN,4313,1447,2866,2768,439,692,8,43,14,6,0,4,339,3741,572,ITH,ITH3,5,Veneto,Veneto,4905854,1015754,20.7,0.09
1525,2021-01-25,VEN,6467,2075,4392,5065,377,904,2,13,2,6,0,0,98,167,6300,ITH,ITH3,5,Veneto,Veneto,4905854,1022221,20.84,0.13
1526,2021-03-05,VEN,13175,4910,8265,3547,674,1466,2954,109,50,3091,473,323,488,9592,3583,ITH,ITH3,5,Veneto,Veneto,4905854,1035396,21.11,0.27
1527,2021-01-11,VEN,7237,2100,5137,3500,1160,1956,8,58,21,252,0,0,282,7237,0,ITH,ITH3,5,Veneto,Veneto,4905854,1042633,21.25,0.15
1528,2021-01-15,VEN,5862,1818,4044,2981,993,1565,4,46,18,9,0,5,241,5862,0,ITH,ITH3,5,Veneto,Veneto,4905854,1048495,21.37,0.12
1529,2021-04-11,VEN,20856,8808,12048,1003,1025,83,345,313,4261,8206,5301,11,308,14549,6307,ITH,ITH3,5,Veneto,Veneto,4905854,1069351,21.8,0.43
1530,2021-04-12,VEN,14631,6205,8426,492,306,122,939,323,2110,6035,3922,18,364,6516,8115,ITH,ITH3,5,Veneto,Veneto,4905854,1083982,22.1,0.3
1531,2021-03-08,VEN,13489,6153,7336,713,200,384,2947,84,54,7166,466,1119,356,9430,4059,ITH,ITH3,5,Veneto,Veneto,4905854,1097471,22.37,0.27
1532,2021-04-15,VEN,20138,8318,11820,624,327,467,686,423,3476,8677,5017,8,433,9358,10780,ITH,ITH3,5,Veneto,Veneto,4905854,1117609,22.78,0.41
1533,2021-01-14,VEN,7061,1924,5137,3240,1065,2491,4,26,7,17,1,0,210,7061,0,ITH,ITH3,5,Veneto,Veneto,4905854,1124670,22.93,0.14
1534,2021-04-07,VEN,35208,15792,19416,1591,1020,718,357,1038,17983,5592,5576,82,1251,27889,7319,ITH,ITH3,5,Veneto,Veneto,4905854,1159878,23.64,0.72
1535,2021-04-14,VEN,14951,6486,8465,770,268,181,131,384,3345,5276,4158,22,416,8575,6376,ITH,ITH3,5,Veneto,Veneto,4905854,1174829,23.95,0.3
1536,2021-02-11,VEN,4014,1240,2774,2663,390,803,8,20,8,10,6,1,105,3384,630,ITH,ITH3,5,Veneto,Veneto,4905854,1178843,24.03,0.08
1537,2021-01-12,VEN,5230,1516,3714,2250,852,1753,5,29,16,176,0,0,149,5230,0,ITH,ITH3,5,Veneto,Veneto,4905854,1184073,24.14,0.11
1538,2021-03-07,VEN,4453,1742,2711,1747,356,23,831,24,4,982,388,39,59,3900,553,ITH,ITH3,5,Veneto,Veneto,4905854,1188526,24.23,0.09
1539,2021-03-02,VEN,11441,4611,6830,2841,769,1197,1868,95,32,3287,465,468,419,8166,3275,ITH,ITH3,5,Veneto,Veneto,4905854,1199967,24.46,0.23
1540,2021-01-23,VEN,4051,1247,2804,3406,172,437,3,3,2,1,1,0,26,34,4017,ITH,ITH3,5,Veneto,Veneto,4905854,1204018,24.54,0.08
1541,2021-04-09,VEN,30848,13587,17261,1429,1209,580,198,968,8461,9948,6846,93,1116,22536,8312,ITH,ITH3,5,Veneto,Veneto,4905854,1234866,25.17,0.63
1542,2021-03-27,VEN,31893,13898,17995,2027,1562,169,1549,753,6986,12294,3830,219,2504,26061,5832,ITH,ITH3,5,Veneto,Veneto,4905854,1266759,25.82,0.65
1543,2021-03-13,VEN,17155,7235,9920,2586,1732,109,4042,277,210,4813,2094,439,853,14048,3107,ITH,ITH3,5,Veneto,Veneto,4905854,1283914,26.17,0.35
1544,2021-02-10,VEN,4750,1587,3163,3173,546,782,2,50,19,6,0,0,172,3697,1053,ITH,ITH3,5,Veneto,Veneto,4905854,1288664,26.27,0.1
1545,2021-02-15,VEN,4386,1821,2565,485,83,383,2,19,9,3273,54,14,64,4145,241,ITH,ITH3,5,Veneto,Veneto,4905854,1293050,26.36,0.09
1546,2021-03-25,VEN,25689,10882,14807,1395,1491,1019,2259,369,5633,9923,2125,841,634,19627,6062,ITH,ITH3,5,Veneto,Veneto,4905854,1318739,26.88,0.52
1547,2021-02-20,VEN,6419,2013,4406,1905,113,100,3243,30,10,968,3,6,41,6350,69,ITH,ITH3,5,Veneto,Veneto,4905854,1325158,27.01,0.13
1548,2021-04-07,FVG,7439,3303,4136,335,296,114,32,5,2714,2088,1828,12,15,6654,785,ITH,ITH4,6,Friuli-Venezia Giulia,Friuli Venezia Giulia,1215220,7439,0.61,0.61
1549,2021-02-27,FVG,3424,1178,2246,203,140,4,1501,1,0,1523,27,25,0,3423,1,ITH,ITH4,6,Friuli-Venezia Giulia,Friuli Venezia Giulia,1215220,10863,0.89,0.28
1550,2021-01-02,FVG,1217,471,746,1150,67,0,0,0,0,0,0,0,0,1217,0,ITH,ITH4,6,Friuli-Venezia Giulia,Friuli Venezia Giulia,1215220,12080,0.99,0.1
1551,2021-01-24,FVG,305,119,186,277,27,1,0,0,0,0,0,0,0,1,304,ITH,ITH4,6,Friuli-Venezia Giulia,Friuli Venezia Giulia,1215220,12385,1.02,0.03
1552,2021-01-14,FVG,2588,789,1799,1608,550,430,0,0,0,0,0,0,0,2588,0,ITH,ITH4,6,Friuli-Venezia Giulia,Friuli Venezia Giulia,1215220,14973,1.23,0.21
1553,2021-01-07,FVG,2092,718,1374,1760,222,110,0,0,0,0,0,0,0,2092,0,ITH,ITH4,6,Friuli-Venezia Giulia,Friuli Venezia Giulia,1215220,17065,1.4,0.17
1554,2021-03-04,FVG,3425,1591,1834,357,216,96,402,1,1,1815,33,504,0,2783,642,ITH,ITH4,6,Friuli-Venezia Giulia,Friuli Venezia Giulia,1215220,20490,1.69,0.28
1555,2021-01-08,FVG,2322,747,1575,1680,242,396,0,1,0,0,0,0,3,2322,0,ITH,ITH4,6,Friuli-Venezia Giulia,Friuli Venezia Giulia,1215220,22812,1.88,0.19
1556,2021-03-26,FVG,5766,2412,3354,496,210,234,751,21,648,2050,1237,87,32,3751,2015,ITH,ITH4,6,Friuli-Venezia Giulia,Friuli Venezia Giulia,1215220,28578,2.35,0.47
1557,2021-04-19,FVG,3176,1584,1592,76,53,3,10,84,493,727,1726,2,2,1264,1912,ITH,ITH4,6,Friuli-Venezia Giulia,Friuli Venezia Giulia,1215220,31754,2.61,0.26
1558,2021-02-18,FVG,3212,1489,1723,229,122,331,978,0,0,1502,16,34,0,2806,406,ITH,ITH4,6,Friuli-Venezia Giulia,Friuli Venezia Giulia,1215220,34966,2.88,0.26
1559,2021-02-19,FVG,3254,1290,1964,568,309,315,426,0,0,1589,11,35,1,2825,429,ITH,ITH4,6,Friuli-Venezia Giulia,Friuli Venezia Giulia,1215220,38220,3.15,0.27
1560,2021-02-20,FVG,2068,933,1135,11,1,148,306,0,2,1584,16,0,0,1924,144,ITH,ITH4,6,Friuli-Venezia Giulia,Friuli Venezia Giulia,1215220,40288,3.32,0.17
1561,2021-03-12,FVG,3936,1542,2394,177,63,47,589,1,5,2865,86,101,2,2556,1380,ITH,ITH4,6,Friuli-Venezia Giulia,Friuli Venezia Giulia,1215220,44224,3.64,0.32
1562,2021-02-01,FVG,2095,688,1407,1589,371,135,0,0,0,0,0,0,0,15,2080,ITH,ITH4,6,Friuli-Venezia Giulia,Friuli Venezia Giulia,1215220,46319,3.81,0.17
1563,2021-02-13,FVG,567,179,388,337,230,0,0,0,0,0,0,0,0,561,6,ITH,ITH4,6,Friuli-Venezia Giulia,Friuli Venezia Giulia,1215220,46886,3.86,0.05
1564,2021-02-08,FVG,2357,694,1663,1401,521,435,0,0,0,0,0,0,0,92,2265,ITH,ITH4,6,Friuli-Venezia Giulia,Friuli Venezia Giulia,1215220,49243,4.05,0.19
1565,2021-01-18,FVG,1962,607,1355,1360,492,110,0,0,0,0,0,0,0,1868,94,ITH,ITH4,6,Friuli-Venezia Giulia,Friuli Venezia Giulia,1215220,51205,4.21,0.16
1566,2021-01-27,FVG,1272,425,847,851,357,64,0,0,0,0,0,0,0,450,822,ITH,ITH4,6,Friuli-Venezia Giulia,Friuli Venezia Giulia,1215220,52477,4.32,0.1
1567,2021-02-12,FVG,1200,428,772,674,393,128,1,0,1,2,1,0,0,1150,50,ITH,ITH4,6,Friuli-Venezia Giulia,Friuli Venezia Giulia,1215220,53677,4.42,0.1
1568,2021-04-15,FVG,5279,2363,2916,186,55,82,4,61,988,1649,2246,0,8,4155,1124,ITH,ITH4,6,Friuli-Venezia Giulia,Friuli Venezia Giulia,1215220,58956,4.85,0.43
1569,2021-03-08,FVG,4041,1574,2467,694,511,140,436,0,7,2190,22,39,2,1953,2088,ITH,ITH4,6,Friuli-Venezia Giulia,Friuli Venezia Giulia,1215220,62997,5.18,0.33
1570,2021-04-10,FVG,4939,2135,2804,157,185,80,76,19,736,2075,1582,13,16,3718,1221,ITH,ITH4,6,Friuli-Venezia Giulia,Friuli Venezia Giulia,1215220,67936,5.59,0.41
1571,2021-03-01,FVG,2958,1042,1916,93,81,176,949,1,1,1636,17,4,0,2905,53,ITH,ITH4,6,Friuli-Venezia Giulia,Friuli Venezia Giulia,1215220,70894,5.83,0.24
1572,2021-01-29,FVG,2413,813,1600,1855,321,237,0,0,0,0,0,0,0,264,2149,ITH,ITH4,6,Friuli-Venezia Giulia,Friuli Venezia Giulia,1215220,73307,6.03,0.2
1573,2021-03-22,FVG,3520,1336,2184,149,87,206,463,0,1,2471,133,6,4,1566,1954,ITH,ITH4,6,Friuli-Venezia Giulia,Friuli Venezia Giulia,1215220,76827,6.32,0.29
1574,2021-03-31,FVG,7979,3475,4504,168,108,296,879,4,2347,2157,1904,112,4,7130,849,ITH,ITH4,6,Friuli-Venezia Giulia,Friuli Venezia Giulia,1215220,84806,6.98,0.66
1575,2021-04-02,FVG,6431,2855,3576,356,237,76,3,1,610,3094,2014,15,25,4612,1819,ITH,ITH4,6,Friuli-Venezia Giulia,Friuli Venezia Giulia,1215220,91237,7.51,0.53
1576,2021-02-22,FVG,2493,1196,1297,431,312,115,5,1,0,1369,14,246,0,2075,418,ITH,ITH4,6,Friuli-Venezia Giulia,Friuli Venezia Giulia,1215220,93730,7.71,0.21
1577,2021-02-28,FVG,2669,989,1680,234,162,0,1488,0,0,405,1,379,0,2274,395,ITH,ITH4,6,Friuli-Venezia Giulia,Friuli Venezia Giulia,1215220,96399,7.93,0.22
1578,2021-02-25,FVG,3075,1607,1468,22,5,299,743,0,1,1557,12,436,0,3050,25,ITH,ITH4,6,Friuli-Venezia Giulia,Friuli Venezia Giulia,1215220,99474,8.19,0.25
1579,2021-02-21,FVG,800,281,519,213,166,27,1,0,0,382,10,1,0,423,377,ITH,ITH4,6,Friuli-Venezia Giulia,Friuli Venezia Giulia,1215220,100274,8.25,0.07
1580,2021-03-15,FVG,3762,1634,2128,328,256,180,234,1,1,2426,101,234,1,1442,2320,ITH,ITH4,6,Friuli-Venezia Giulia,Friuli Venezia Giulia,1215220,104036,8.56,0.31
1581,2021-04-03,FVG,3973,1966,2007,34,579,4,149,2,3,2244,918,36,4,2647,1326,ITH,ITH4,6,Friuli-Venezia Giulia,Friuli Venezia Giulia,1215220,108009,8.89,0.33
1582,2021-01-04,FVG,1510,559,951,1392,118,0,0,0,0,0,0,0,0,1510,0,ITH,ITH4,6,Friuli-Venezia Giulia,Friuli Venezia Giulia,1215220,109519,9.01,0.12
1583,2021-01-19,FVG,7,2,5,5,0,2,0,0,0,0,0,0,0,7,0,ITH,ITH4,6,Friuli-Venezia Giulia,Friuli Venezia Giulia,1215220,109526,9.01,0.0
1584,2021-04-05,FVG,2862,1425,1437,34,221,13,121,3,612,465,1365,27,1,2846,16,ITH,ITH4,6,Friuli-Venezia Giulia,Friuli Venezia Giulia,1215220,112388,9.25,0.24
1585,2020-12-30,FVG,630,246,384,601,29,0,0,0,0,0,0,0,0,630,0,ITH,ITH4,6,Friuli-Venezia Giulia,Friuli Venezia Giulia,1215220,113018,9.3,0.05
1586,2020-12-31,FVG,1053,384,669,1011,42,0,0,0,0,0,0,0,0,1053,0,ITH,ITH4,6,Friuli-Venezia Giulia,Friuli Venezia Giulia,1215220,114071,9.39,0.09
1587,2021-02-07,FVG,1561,483,1078,866,693,2,0,0,0,0,0,0,0,386,1175,ITH,ITH4,6,Friuli-Venezia Giulia,Friuli Venezia Giulia,1215220,115632,9.52,0.13
1588,2021-01-03,FVG,312,122,190,285,26,1,0,0,0,0,0,0,0,312,0,ITH,ITH4,6,Friuli-Venezia Giulia,Friuli Venezia Giulia,1215220,115944,9.54,0.03
1589,2021-02-05,FVG,2613,784,1829,1612,511,490,0,0,0,0,0,0,0,90,2523,ITH,ITH4,6,Friuli-Venezia Giulia,Friuli Venezia Giulia,1215220,118557,9.76,0.22
1590,2021-04-13,FVG,5794,2590,3204,267,225,155,18,75,1817,1843,1383,5,6,4673,1121,ITH,ITH4,6,Friuli-Venezia Giulia,Friuli Venezia Giulia,1215220,124351,10.23,0.48
1591,2021-03-30,FVG,7039,3116,3923,416,328,404,140,2,1989,1934,1769,54,3,6119,920,ITH,ITH4,6,Friuli-Venezia Giulia,Friuli Venezia Giulia,1215220,131390,10.81,0.58
1592,2021-01-30,FVG,2271,744,1527,1475,354,442,0,0,0,0,0,0,0,270,2001,ITH,ITH4,6,Friuli-Venezia Giulia,Friuli Venezia Giulia,1215220,133661,11.0,0.19
1593,2021-02-03,FVG,2646,790,1856,1701,558,386,0,0,0,1,0,0,0,23,2623,ITH,ITH4,6,Friuli-Venezia Giulia,Friuli Venezia Giulia,1215220,136307,11.22,0.22
1594,2021-01-10,FVG,2941,919,2022,1745,951,245,0,0,0,0,0,0,0,2941,0,ITH,ITH4,6,Friuli-Venezia Giulia,Friuli Venezia Giulia,1215220,139248,11.46,0.24
1595,2021-01-13,FVG,2651,834,1817,1822,599,230,0,0,0,0,0,0,0,2651,0,ITH,ITH4,6,Friuli-Venezia Giulia,Friuli Venezia Giulia,1215220,141899,11.68,0.22
1596,2021-02-02,FVG,2467,806,1661,1658,393,416,0,0,0,0,0,0,0,217,2250,ITH,ITH4,6,Friuli-Venezia Giulia,Friuli Venezia Giulia,1215220,144366,11.88,0.2
1597,2021-03-06,FVG,3491,1194,2297,182,249,5,1464,0,0,1565,6,20,0,3165,326,ITH,ITH4,6,Friuli-Venezia Giulia,Friuli Venezia Giulia,1215220,147857,12.17,0.29
1598,2021-04-16,FVG,6146,2682,3464,274,175,169,14,162,906,1919,2504,0,23,4411,1735,ITH,ITH4,6,Friuli-Venezia Giulia,Friuli Venezia Giulia,1215220,154003,12.67,0.51
1599,2021-03-24,FVG,3737,1518,2219,182,183,148,427,1,21,2318,389,62,6,2255,1482,ITH,ITH4,6,Friuli-Venezia Giulia,Friuli Venezia Giulia,1215220,157740,12.98,0.31
1600,2021-04-18,FVG,5300,2457,2843,252,33,81,2,380,1413,658,2466,0,15,4894,406,ITH,ITH4,6,Friuli-Venezia Giulia,Friuli Venezia Giulia,1215220,163040,13.42,0.44
1601,2021-03-23,FVG,3747,1555,2192,321,303,245,241,0,3,2448,156,29,1,1605,2142,ITH,ITH4,6,Friuli-Venezia Giulia,Friuli Venezia Giulia,1215220,166787,13.72,0.31
1602,2021-03-03,FVG,3642,1628,2014,750,546,104,427,0,0,1331,15,469,0,2364,1278,ITH,ITH4,6,Friuli-Venezia Giulia,Friuli Venezia Giulia,1215220,170429,14.02,0.3
1603,2020-12-27,FVG,262,149,113,259,3,0,0,0,0,0,0,0,0,262,0,ITH,ITH4,6,Friuli-Venezia Giulia,Friuli Venezia Giulia,1215220,170691,14.05,0.02
1604,2021-04-17,FVG,6437,2807,3630,250,68,1,3,506,497,2206,2885,2,19,5115,1322,ITH,ITH4,6,Friuli-Venezia Giulia,Friuli Venezia Giulia,1215220,177128,14.58,0.53
1605,2021-02-06,FVG,1154,338,816,755,208,191,0,0,0,0,0,0,0,22,1132,ITH,ITH4,6,Friuli-Venezia Giulia,Friuli Venezia Giulia,1215220,178282,14.67,0.09
1606,2021-01-22,FVG,90,30,60,89,1,0,0,0,0,0,0,0,0,0,90,ITH,ITH4,6,Friuli-Venezia Giulia,Friuli Venezia Giulia,1215220,178372,14.68,0.01
1607,2021-01-31,FVG,2715,836,1879,1693,1004,18,0,0,0,0,0,0,0,385,2330,ITH,ITH4,6,Friuli-Venezia Giulia,Friuli Venezia Giulia,1215220,181087,14.9,0.22
1608,2021-03-17,FVG,3221,1260,1961,429,219,200,6,0,1,2246,117,3,0,728,2493,ITH,ITH4,6,Friuli-Venezia Giulia,Friuli Venezia Giulia,1215220,184308,15.17,0.27
1609,2021-03-10,FVG,3362,1494,1868,306,301,209,195,0,1,1973,67,309,1,1570,1792,ITH,ITH4,6,Friuli-Venezia Giulia,Friuli Venezia Giulia,1215220,187670,15.44,0.28
1610,2021-03-27,FVG,4979,2557,2422,60,810,1,98,3,906,1989,1094,16,2,3568,1411,ITH,ITH4,6,Friuli-Venezia Giulia,Friuli Venezia Giulia,1215220,192649,15.85,0.41
1611,2021-03-14,FVG,1396,548,848,0,1,0,797,0,0,247,16,335,0,1144,252,ITH,ITH4,6,Friuli-Venezia Giulia,Friuli Venezia Giulia,1215220,194045,15.97,0.11
1612,2021-02-10,FVG,1352,496,856,745,487,119,1,0,0,0,0,0,0,1266,86,ITH,ITH4,6,Friuli-Venezia Giulia,Friuli Venezia Giulia,1215220,195397,16.08,0.11
1613,2021-04-08,FVG,7051,2958,4093,242,136,237,33,3,1538,2943,1907,4,8,5137,1914,ITH,ITH4,6,Friuli-Venezia Giulia,Friuli Venezia Giulia,1215220,202448,16.66,0.58
1614,2021-01-26,FVG,1974,647,1327,1441,152,381,0,0,0,0,0,0,0,214,1760,ITH,ITH4,6,Friuli-Venezia Giulia,Friuli Venezia Giulia,1215220,204422,16.82,0.16
1615,2021-03-29,FVG,6839,2991,3848,237,210,161,311,10,2112,2406,1328,48,16,5259,1580,ITH,ITH4,6,Friuli-Venezia Giulia,Friuli Venezia Giulia,1215220,211261,17.38,0.56
1616,2021-01-12,FVG,2259,712,1547,1528,370,361,0,0,0,0,0,0,0,2259,0,ITH,ITH4,6,Friuli-Venezia Giulia,Friuli Venezia Giulia,1215220,213520,17.57,0.19
1617,2021-03-09,FVG,3863,1590,2273,657,480,200,424,2,4,2005,28,60,3,1110,2753,ITH,ITH4,6,Friuli-Venezia Giulia,Friuli Venezia Giulia,1215220,217383,17.89,0.32
1618,2021-03-28,FVG,4806,2271,2535,13,745,5,1306,7,1528,425,658,111,8,4666,140,ITH,ITH4,6,Friuli-Venezia Giulia,Friuli Venezia Giulia,1215220,222189,18.28,0.4
1619,2021-03-19,FVG,3221,1335,1886,106,47,292,134,0,0,2513,128,0,1,1288,1933,ITH,ITH4,6,Friuli-Venezia Giulia,Friuli Venezia Giulia,1215220,225410,18.55,0.27
1620,2021-01-17,FVG,1720,524,1196,674,560,486,0,0,0,0,0,0,0,1720,0,ITH,ITH4,6,Friuli-Venezia Giulia,Friuli Venezia Giulia,1215220,227130,18.69,0.14
1621,2021-01-25,FVG,1583,567,1016,1370,141,72,0,0,0,0,0,0,0,194,1389,ITH,ITH4,6,Friuli-Venezia Giulia,Friuli Venezia Giulia,1215220,228713,18.82,0.13
1622,2021-02-23,FVG,2615,1252,1363,104,44,247,1,0,2,1943,19,254,1,2437,178,ITH,ITH4,6,Friuli-Venezia Giulia,Friuli Venezia Giulia,1215220,231328,19.04,0.22
1623,2021-02-26,FVG,3740,2094,1646,75,26,561,299,0,2,1739,5,1033,0,3593,147,ITH,ITH4,6,Friuli-Venezia Giulia,Friuli Venezia Giulia,1215220,235068,19.34,0.31
1624,2021-04-12,FVG,7112,3132,3980,274,177,230,20,92,1760,2066,2464,4,25,6026,1086,ITH,ITH4,6,Friuli-Venezia Giulia,Friuli Venezia Giulia,1215220,242180,19.93,0.59
1625,2021-03-21,FVG,2600,937,1663,6,9,88,1119,0,0,1333,3,27,15,2192,408,ITH,ITH4,6,Friuli-Venezia Giulia,Friuli Venezia Giulia,1215220,244780,20.14,0.21
1626,2021-01-21,FVG,895,345,550,864,31,0,0,0,0,0,0,0,0,1,894,ITH,ITH4,6,Friuli-Venezia Giulia,Friuli Venezia Giulia,1215220,245675,20.22,0.07
1627,2021-04-11,FVG,3427,1516,1911,235,99,7,28,10,530,1222,1275,7,14,2521,906,ITH,ITH4,6,Friuli-Venezia Giulia,Friuli Venezia Giulia,1215220,249102,20.5,0.28
1628,2021-03-18,FVG,3362,1420,1942,60,23,168,4,1,1,2864,241,0,0,1680,1682,ITH,ITH4,6,Friuli-Venezia Giulia,Friuli Venezia Giulia,1215220,252464,20.78,0.28
1629,2021-03-05,FVG,3741,1481,2260,1050,654,77,146,0,8,1735,25,46,0,2668,1073,ITH,ITH4,6,Friuli-Venezia Giulia,Friuli Venezia Giulia,1215220,256205,21.08,0.31
1630,2021-01-23,FVG,816,324,492,768,48,0,0,0,0,0,0,0,0,4,812,ITH,ITH4,6,Friuli-Venezia Giulia,Friuli Venezia Giulia,1215220,257021,21.15,0.07
1631,2021-03-07,FVG,2537,926,1611,1,5,153,1782,0,0,143,0,453,0,2536,1,ITH,ITH4,6,Friuli-Venezia Giulia,Friuli Venezia Giulia,1215220,259558,21.36,0.21
1632,2021-03-02,FVG,4220,1518,2702,1163,658,203,634,0,1,1538,17,5,1,2717,1503,ITH,ITH4,6,Friuli-Venezia Giulia,Friuli Venezia Giulia,1215220,263778,21.71,0.35
1633,2021-04-09,FVG,7525,3441,4084,287,169,71,22,43,1276,2586,3057,0,14,6342,1183,ITH,ITH4,6,Friuli-Venezia Giulia,Friuli Venezia Giulia,1215220,271303,22.33,0.62
1634,2021-02-24,FVG,2518,1082,1436,23,5,312,297,1,0,1835,15,0,30,2500,18,ITH,ITH4,6,Friuli-Venezia Giulia,Friuli Venezia Giulia,1215220,273821,22.53,0.21
1635,2021-04-14,FVG,5893,2570,3323,326,216,73,3,105,988,1858,2312,2,10,4534,1359,ITH,ITH4,6,Friuli-Venezia Giulia,Friuli Venezia Giulia,1215220,279714,23.02,0.48
1636,2021-02-11,FVG,1935,665,1270,1134,566,230,0,0,1,3,0,1,0,1742,193,ITH,ITH4,6,Friuli-Venezia Giulia,Friuli Venezia Giulia,1215220,281649,23.18,0.16
1637,2021-03-20,FVG,3346,1353,1993,412,279,10,66,2,1,2381,14,179,2,1252,2094,ITH,ITH4,6,Friuli-Venezia Giulia,Friuli Venezia Giulia,1215220,284995,23.45,0.28
1638,2021-02-17,FVG,2352,998,1354,328,178,230,0,0,0,1555,14,46,1,1873,479,ITH,ITH4,6,Friuli-Venezia Giulia,Friuli Venezia Giulia,1215220,287347,23.65,0.19
1639,2021-02-16,FVG,2516,1135,1381,260,244,221,0,0,3,1760,28,0,0,2400,116,ITH,ITH4,6,Friuli-Venezia Giulia,Friuli Venezia Giulia,1215220,289863,23.85,0.21
1640,2021-03-16,FVG,3142,1283,1859,327,256,245,1,0,3,2203,104,0,3,1062,2080,ITH,ITH4,6,Friuli-Venezia Giulia,Friuli Venezia Giulia,1215220,293005,24.11,0.26
1641,2021-02-09,FVG,1848,556,1292,1053,509,286,0,0,0,0,0,0,0,1559,289,ITH,ITH4,6,Friuli-Venezia Giulia,Friuli Venezia Giulia,1215220,294853,24.26,0.15
1642,2021-03-25,FVG,5289,2249,3040,53,57,303,835,3,958,2057,965,53,5,3155,2134,ITH,ITH4,6,Friuli-Venezia Giulia,Friuli Venezia Giulia,1215220,300142,24.7,0.44
1643,2021-02-15,FVG,2454,909,1545,700,390,316,0,0,4,1034,10,0,0,2204,250,ITH,ITH4,6,Friuli-Venezia Giulia,Friuli Venezia Giulia,1215220,302596,24.9,0.2
1644,2021-01-09,FVG,2518,841,1677,1519,406,593,0,0,0,0,0,0,0,2518,0,ITH,ITH4,6,Friuli-Venezia Giulia,Friuli Venezia Giulia,1215220,305114,25.11,0.21
1645,2021-03-13,FVG,2934,1119,1815,12,4,86,723,1,2,2058,9,39,0,1661,1273,ITH,ITH4,6,Friuli-Venezia Giulia,Friuli Venezia Giulia,1215220,308048,25.35,0.24
1646,2021-01-20,FVG,751,323,428,719,32,0,0,0,0,0,0,0,0,12,739,ITH,ITH4,6,Friuli-Venezia Giulia,Friuli Venezia Giulia,1215220,308799,25.41,0.06
1647,2021-01-05,FVG,1680,551,1129,1350,133,197,0,0,0,0,0,0,0,1680,0,ITH,ITH4,6,Friuli-Venezia Giulia,Friuli Venezia Giulia,1215220,310479,25.55,0.14
1648,2021-02-04,FVG,2731,807,1924,1723,543,465,0,0,0,0,0,0,0,36,2695,ITH,ITH4,6,Friuli-Venezia Giulia,Friuli Venezia Giulia,1215220,313210,25.77,0.22
1649,2021-04-06,FVG,6125,2710,3415,247,196,132,29,4,1100,2669,1726,19,3,5007,1118,ITH,ITH4,6,Friuli-Venezia Giulia,Friuli Venezia Giulia,1215220,319335,26.28,0.5
1650,2021-01-16,FVG,1231,360,871,771,212,248,0,0,0,0,0,0,0,1231,0,ITH,ITH4,6,Friuli-Venezia Giulia,Friuli Venezia Giulia,1215220,320566,26.38,0.1
1651,2021-04-01,FVG,6264,2968,3296,170,113,199,94,1,1174,2052,2389,57,15,5250,1014,ITH,ITH4,6,Friuli-Venezia Giulia,Friuli Venezia Giulia,1215220,326830,26.89,0.52
1652,2021-01-06,FVG,710,264,446,515,195,0,0,0,0,0,0,0,0,710,0,ITH,ITH4,6,Friuli-Venezia Giulia,Friuli Venezia Giulia,1215220,327540,26.95,0.06
1653,2021-03-11,FVG,3327,1393,1934,262,114,289,504,1,2,2014,35,104,2,1578,1749,ITH,ITH4,6,Friuli-Venezia Giulia,Friuli Venezia Giulia,1215220,330867,27.23,0.27
1654,2021-01-28,FVG,2236,792,1444,1755,287,194,0,0,0,0,0,0,0,354,1882,ITH,ITH4,6,Friuli-Venezia Giulia,Friuli Venezia Giulia,1215220,333103,27.41,0.18
1655,2021-01-15,FVG,2028,606,1422,1283,370,375,0,0,0,0,0,0,0,2028,0,ITH,ITH4,6,Friuli-Venezia Giulia,Friuli Venezia Giulia,1215220,335131,27.58,0.17
1656,2021-01-11,FVG,1883,609,1274,1501,336,46,0,0,0,0,0,0,0,1883,0,ITH,ITH4,6,Friuli-Venezia Giulia,Friuli Venezia Giulia,1215220,337014,27.73,0.15
1657,2021-04-18,SIC,19739,9874,9865,243,83,105,94,5985,1811,2656,8666,15,81,15352,4387,ITG,ITG1,19,Sicilia,Sicilia,4999891,19739,0.39,0.39
1658,2021-01-31,SIC,4113,1959,2154,2602,835,295,0,61,26,26,0,0,268,114,3999,ITG,ITG1,19,Sicilia,Sicilia,4999891,23852,0.48,0.08
1659,2021-02-10,SIC,4433,1819,2614,1975,1153,741,0,59,33,18,0,0,454,4008,425,ITG,ITG1,19,Sicilia,Sicilia,4999891,28285,0.57,0.09
1660,2021-02-17,SIC,5434,3294,2140,1531,719,887,2,39,8,10,0,1999,239,4760,674,ITG,ITG1,19,Sicilia,Sicilia,4999891,33719,0.67,0.11
1661,2021-03-23,SIC,21058,10105,10953,880,417,387,1647,184,3536,5908,7394,405,300,15450,5608,ITG,ITG1,19,Sicilia,Sicilia,4999891,54777,1.1,0.42
1662,2021-03-14,SIC,8825,3947,4878,569,411,180,678,146,1691,4351,148,67,584,4967,3858,ITG,ITG1,19,Sicilia,Sicilia,4999891,63602,1.27,0.18
1663,2021-01-10,SIC,3618,1615,2003,2126,552,464,0,42,22,92,0,0,320,3618,0,ITG,ITG1,19,Sicilia,Sicilia,4999891,67220,1.34,0.07
1664,2021-03-15,SIC,10765,4725,6040,1241,459,676,1154,60,1533,4919,132,308,283,5692,5073,ITG,ITG1,19,Sicilia,Sicilia,4999891,77985,1.56,0.22
1665,2021-01-28,SIC,9330,4400,4930,7466,1371,295,0,35,11,4,0,0,148,414,8916,ITG,ITG1,19,Sicilia,Sicilia,4999891,87315,1.75,0.19
1666,2021-02-14,SIC,1057,402,655,433,300,236,0,9,3,4,0,0,72,917,140,ITG,ITG1,19,Sicilia,Sicilia,4999891,88372,1.77,0.02
1667,2021-03-16,SIC,10171,4464,5707,1663,549,850,218,59,128,5733,620,75,276,4019,6152,ITG,ITG1,19,Sicilia,Sicilia,4999891,98543,1.97,0.2
1668,2021-01-02,SIC,4872,2533,2339,4311,144,0,0,87,7,2,0,0,321,4872,0,ITG,ITG1,19,Sicilia,Sicilia,4999891,103415,2.07,0.1
1669,2021-02-02,SIC,5541,2623,2918,3156,1562,429,0,50,7,21,0,0,316,633,4908,ITG,ITG1,19,Sicilia,Sicilia,4999891,108956,2.18,0.11
1670,2020-12-28,SIC,207,124,83,205,2,0,0,0,0,0,0,0,0,207,0,ITG,ITG1,19,Sicilia,Sicilia,4999891,109163,2.18,0.0
1671,2021-01-15,SIC,5079,2233,2846,2824,1047,479,0,67,19,2,0,0,641,5079,0,ITG,ITG1,19,Sicilia,Sicilia,4999891,114242,2.28,0.1
1672,2021-03-11,SIC,15503,6546,8957,1611,1275,1026,3324,200,2112,4052,158,993,752,12929,2574,ITG,ITG1,19,Sicilia,Sicilia,4999891,129745,2.59,0.31
1673,2021-01-11,SIC,5905,2591,3314,3923,1014,382,0,83,17,89,0,0,397,5905,0,ITG,ITG1,19,Sicilia,Sicilia,4999891,135650,2.71,0.12
1674,2021-03-24,SIC,21152,9897,11255,956,492,605,1462,345,3222,5949,7609,200,312,15264,5888,ITG,ITG1,19,Sicilia,Sicilia,4999891,156802,3.14,0.42
1675,2021-03-07,SIC,9280,3465,5815,968,558,463,3299,88,12,3462,18,226,186,8196,1084,ITG,ITG1,19,Sicilia,Sicilia,4999891,166082,3.32,0.19
1676,2021-03-26,SIC,17897,8329,9568,1071,571,338,1308,225,2835,5579,5604,124,242,12378,5519,ITG,ITG1,19,Sicilia,Sicilia,4999891,183979,3.68,0.36
1677,2021-02-28,SIC,7181,3072,4109,871,410,112,1359,90,7,3359,2,268,703,6551,630,ITG,ITG1,19,Sicilia,Sicilia,4999891,191160,3.82,0.14
1678,2021-04-07,SIC,15753,7762,7991,764,386,473,182,243,1684,4449,7153,81,338,8585,7168,ITG,ITG1,19,Sicilia,Sicilia,4999891,206913,4.14,0.32
1679,2021-01-16,SIC,2776,1195,1581,1329,561,298,0,24,15,6,0,0,543,2776,0,ITG,ITG1,19,Sicilia,Sicilia,4999891,209689,4.19,0.06
1680,2021-04-04,SIC,6982,3379,3603,192,106,184,44,114,854,2488,2891,17,92,5689,1293,ITG,ITG1,19,Sicilia,Sicilia,4999891,216671,4.33,0.14
1681,2021-01-23,SIC,4151,2149,2002,3914,198,16,0,1,2,0,0,0,20,225,3926,ITG,ITG1,19,Sicilia,Sicilia,4999891,220822,4.42,0.08
1682,2021-02-11,SIC,5332,2103,3229,2458,1442,890,0,77,25,7,0,0,433,4868,464,ITG,ITG1,19,Sicilia,Sicilia,4999891,226154,4.52,0.11
1683,2021-04-06,SIC,18171,8720,9451,804,275,602,188,279,1950,5483,8032,105,453,13848,4323,ITG,ITG1,19,Sicilia,Sicilia,4999891,244325,4.89,0.36
1684,2021-03-13,SIC,12464,5492,6972,1174,771,513,1768,210,2143,4706,133,202,844,7858,4606,ITG,ITG1,19,Sicilia,Sicilia,4999891,256789,5.14,0.25
1685,2021-02-04,SIC,6908,3174,3734,4429,1438,540,0,49,13,18,0,0,421,1460,5448,ITG,ITG1,19,Sicilia,Sicilia,4999891,263697,5.27,0.14
1686,2021-02-15,SIC,3951,1862,2089,1700,987,628,26,28,10,14,5,351,202,3382,569,ITG,ITG1,19,Sicilia,Sicilia,4999891,267648,5.35,0.08
1687,2021-04-01,SIC,14465,6695,7770,624,238,520,191,129,2244,5112,4861,405,141,9739,4726,ITG,ITG1,19,Sicilia,Sicilia,4999891,282113,5.64,0.29
1688,2021-02-19,SIC,5163,2758,2405,1488,846,602,239,31,13,83,2,1541,318,4592,571,ITG,ITG1,19,Sicilia,Sicilia,4999891,287276,5.75,0.1
1689,2021-02-18,SIC,5497,3174,2323,1636,884,834,96,21,8,10,5,1836,167,5065,432,ITG,ITG1,19,Sicilia,Sicilia,4999891,292773,5.86,0.11
1690,2021-02-21,SIC,5178,2508,2670,379,165,174,153,38,6,3920,3,174,166,5070,108,ITG,ITG1,19,Sicilia,Sicilia,4999891,297951,5.96,0.1
1691,2021-01-18,SIC,1576,657,919,721,166,229,0,22,11,0,0,0,427,1432,144,ITG,ITG1,19,Sicilia,Sicilia,4999891,299527,5.99,0.03
1692,2021-04-03,SIC,15846,7536,8310,438,166,237,192,856,4031,4978,4556,36,356,13003,2843,ITG,ITG1,19,Sicilia,Sicilia,4999891,315373,6.31,0.32
1693,2021-03-27,SIC,15807,7461,8346,650,409,365,742,248,1826,5663,5575,56,273,10887,4920,ITG,ITG1,19,Sicilia,Sicilia,4999891,331180,6.62,0.32
1694,2021-02-12,SIC,4747,1853,2894,2301,1398,644,0,45,17,10,0,0,332,4416,331,ITG,ITG1,19,Sicilia,Sicilia,4999891,335927,6.72,0.09
1695,2021-01-27,SIC,7534,3838,3696,6330,819,152,0,44,11,7,0,0,171,189,7345,ITG,ITG1,19,Sicilia,Sicilia,4999891,343461,6.87,0.15
1696,2021-04-02,SIC,14038,6608,7430,633,217,377,204,130,2130,5216,4891,79,161,9251,4787,ITG,ITG1,19,Sicilia,Sicilia,4999891,357499,7.15,0.28
1697,2021-02-13,SIC,3107,1168,1939,1296,921,570,0,36,19,13,0,0,252,2850,257,ITG,ITG1,19,Sicilia,Sicilia,4999891,360606,7.21,0.06
1698,2021-01-25,SIC,7514,3698,3816,6635,577,70,0,21,7,44,0,0,160,322,7192,ITG,ITG1,19,Sicilia,Sicilia,4999891,368120,7.36,0.15
1699,2021-04-12,SIC,19081,9289,9792,423,152,397,118,1392,1673,3665,11040,27,194,11726,7355,ITG,ITG1,19,Sicilia,Sicilia,4999891,387201,7.74,0.38
1700,2021-03-20,SIC,18940,9091,9849,836,316,434,1219,191,2527,5565,7306,113,433,13550,5390,ITG,ITG1,19,Sicilia,Sicilia,4999891,406141,8.12,0.38
1701,2021-04-11,SIC,15500,7626,7874,220,102,188,97,793,1032,3250,9686,15,117,8470,7030,ITG,ITG1,19,Sicilia,Sicilia,4999891,421641,8.43,0.31
1702,2021-03-09,SIC,13244,5633,7611,1595,1210,713,3699,112,19,4035,217,1138,506,10868,2376,ITG,ITG1,19,Sicilia,Sicilia,4999891,434885,8.7,0.26
1703,2021-02-24,SIC,9601,4870,4731,1423,755,504,923,25,23,4101,1,1618,228,9005,596,ITG,ITG1,19,Sicilia,Sicilia,4999891,444486,8.89,0.19
1704,2021-02-08,SIC,4086,1759,2327,2346,1028,397,0,37,5,16,0,0,257,2128,1958,ITG,ITG1,19,Sicilia,Sicilia,4999891,448572,8.97,0.08
1705,2021-01-07,SIC,9173,4239,4934,7694,974,210,0,64,8,2,0,0,221,9173,0,ITG,ITG1,19,Sicilia,Sicilia,4999891,457745,9.16,0.18
1706,2021-02-16,SIC,4414,2300,2114,1465,976,818,1,35,9,27,8,878,197,3947,467,ITG,ITG1,19,Sicilia,Sicilia,4999891,462159,9.24,0.09
1707,2021-01-09,SIC,7326,3424,3902,5034,1070,456,0,117,36,41,0,0,572,7326,0,ITG,ITG1,19,Sicilia,Sicilia,4999891,469485,9.39,0.15
1708,2021-03-31,SIC,14593,6732,7861,646,298,537,189,140,2229,5244,5029,106,175,9565,5028,ITG,ITG1,19,Sicilia,Sicilia,4999891,484078,9.68,0.29
1709,2021-03-08,SIC,13583,5848,7735,2013,1127,713,4001,135,24,3935,73,1025,537,10769,2814,ITG,ITG1,19,Sicilia,Sicilia,4999891,497661,9.95,0.27
1710,2021-03-29,SIC,14995,7036,7959,877,348,341,304,127,2531,5026,5159,104,178,10477,4518,ITG,ITG1,19,Sicilia,Sicilia,4999891,512656,10.25,0.3
1711,2021-01-30,SIC,7838,3569,4269,5451,1611,475,0,47,12,4,0,0,238,175,7663,ITG,ITG1,19,Sicilia,Sicilia,4999891,520494,10.41,0.16
1712,2021-01-14,SIC,5250,2514,2736,3046,1278,259,0,106,34,90,0,0,437,5250,0,ITG,ITG1,19,Sicilia,Sicilia,4999891,525744,10.52,0.11
1713,2021-03-21,SIC,15224,7336,7888,489,228,75,958,161,2141,4572,6219,112,269,11250,3974,ITG,ITG1,19,Sicilia,Sicilia,4999891,540968,10.82,0.3
1714,2021-01-13,SIC,5204,2462,2742,3033,1165,441,0,92,28,27,0,0,418,5204,0,ITG,ITG1,19,Sicilia,Sicilia,4999891,546172,10.92,0.1
1715,2021-03-04,SIC,15213,6559,8654,2811,1838,750,3830,117,36,4034,27,1207,563,11009,4204,ITG,ITG1,19,Sicilia,Sicilia,4999891,561385,11.23,0.3
1716,2021-03-05,SIC,15947,6877,9070,3192,1697,757,4085,94,30,4081,106,1489,416,11622,4325,ITG,ITG1,19,Sicilia,Sicilia,4999891,577332,11.55,0.32
1717,2021-01-24,SIC,4338,2264,2074,3993,265,3,0,12,6,37,0,0,22,148,4190,ITG,ITG1,19,Sicilia,Sicilia,4999891,581670,11.63,0.09
1718,2021-02-23,SIC,8949,4689,4260,1267,736,535,581,16,9,4076,2,1486,241,8459,490,ITG,ITG1,19,Sicilia,Sicilia,4999891,590619,11.81,0.18
1719,2021-04-19,SIC,13330,6362,6968,513,334,249,66,632,824,2564,8044,22,82,8402,4928,ITG,ITG1,19,Sicilia,Sicilia,4999891,603949,12.08,0.27
1720,2021-01-04,SIC,8373,4172,4201,7595,547,6,0,26,8,2,0,0,189,8373,0,ITG,ITG1,19,Sicilia,Sicilia,4999891,612322,12.25,0.17
1721,2021-03-03,SIC,14705,6545,8160,2408,1519,515,3833,68,15,4374,44,1427,502,11620,3085,ITG,ITG1,19,Sicilia,Sicilia,4999891,627027,12.54,0.29
1722,2021-04-05,SIC,8191,4033,4158,232,72,177,56,116,964,2926,3581,5,62,6750,1441,ITG,ITG1,19,Sicilia,Sicilia,4999891,635218,12.7,0.16
1723,2021-02-25,SIC,10161,5277,4884,1771,923,518,672,30,7,4058,26,1743,413,8981,1180,ITG,ITG1,19,Sicilia,Sicilia,4999891,645379,12.91,0.2
1724,2021-02-01,SIC,6078,2684,3394,4168,1237,318,0,47,13,44,0,0,251,304,5774,ITG,ITG1,19,Sicilia,Sicilia,4999891,651457,13.03,0.12
1725,2021-04-14,SIC,20659,9934,10725,599,191,393,100,1632,1626,4178,11755,29,156,11831,8828,ITG,ITG1,19,Sicilia,Sicilia,4999891,672116,13.44,0.41
1726,2021-01-26,SIC,9528,4685,4843,8391,768,254,0,21,7,2,0,0,85,265,9263,ITG,ITG1,19,Sicilia,Sicilia,4999891,681644,13.63,0.19
1727,2021-04-09,SIC,20638,10075,10563,740,350,368,285,914,1932,4397,11325,88,239,11471,9167,ITG,ITG1,19,Sicilia,Sicilia,4999891,702282,14.05,0.41
1728,2021-01-03,SIC,4694,2454,2240,4362,206,0,0,34,3,1,0,0,88,4694,0,ITG,ITG1,19,Sicilia,Sicilia,4999891,706976,14.14,0.09
1729,2021-02-06,SIC,5068,2227,2841,2535,1496,592,0,36,12,5,0,0,392,1488,3580,ITG,ITG1,19,Sicilia,Sicilia,4999891,712044,14.24,0.1
1730,2021-01-19,SIC,1271,521,750,521,125,238,0,20,13,17,0,0,337,1093,178,ITG,ITG1,19,Sicilia,Sicilia,4999891,713315,14.27,0.03
1731,2021-02-03,SIC,6104,2858,3246,3359,1498,624,0,91,20,11,0,0,501,756,5348,ITG,ITG1,19,Sicilia,Sicilia,4999891,719419,14.39,0.12
1732,2021-04-13,SIC,20034,9781,10253,665,179,272,127,1594,1865,3808,11348,41,135,11283,8751,ITG,ITG1,19,Sicilia,Sicilia,4999891,739453,14.79,0.4
1733,2021-04-16,SIC,28691,14408,14283,744,330,661,107,8305,2376,4220,11737,33,178,20355,8336,ITG,ITG1,19,Sicilia,Sicilia,4999891,768144,15.36,0.57
1734,2021-02-07,SIC,2349,997,1352,1611,435,157,0,16,9,1,0,0,120,675,1674,ITG,ITG1,19,Sicilia,Sicilia,4999891,770493,15.41,0.05
1735,2021-04-08,SIC,17012,8389,8623,699,430,483,158,231,1581,3872,9151,132,275,8494,8518,ITG,ITG1,19,Sicilia,Sicilia,4999891,787505,15.75,0.34
1736,2021-03-02,SIC,14957,6389,8568,2383,1211,525,4334,50,5,4535,57,1411,446,12132,2825,ITG,ITG1,19,Sicilia,Sicilia,4999891,802462,16.05,0.3
1737,2021-03-25,SIC,20495,9539,10956,1325,529,607,1380,256,3204,5606,7165,195,228,14954,5541,ITG,ITG1,19,Sicilia,Sicilia,4999891,822957,16.46,0.41
1738,2021-03-30,SIC,14567,6757,7810,715,395,386,255,149,2527,5110,4694,171,165,9739,4828,ITG,ITG1,19,Sicilia,Sicilia,4999891,837524,16.75,0.29
1739,2021-01-20,SIC,808,410,398,422,59,192,0,20,2,0,0,0,113,573,235,ITG,ITG1,19,Sicilia,Sicilia,4999891,838332,16.77,0.02
1740,2021-01-17,SIC,1295,584,711,619,319,160,0,10,8,3,0,0,176,1245,50,ITG,ITG1,19,Sicilia,Sicilia,4999891,839627,16.79,0.03
1741,2020-12-29,SIC,235,146,89,235,0,0,0,0,0,0,0,0,0,235,0,ITG,ITG1,19,Sicilia,Sicilia,4999891,839862,16.8,0.0
1742,2021-03-06,SIC,12951,5183,7768,2003,1210,878,3650,106,20,3963,64,704,353,10045,2906,ITG,ITG1,19,Sicilia,Sicilia,4999891,852813,17.06,0.26
1743,2021-03-22,SIC,16837,7929,8908,915,357,365,1230,150,2152,5643,5676,121,228,11291,5546,ITG,ITG1,19,Sicilia,Sicilia,4999891,869650,17.39,0.34
1744,2021-04-10,SIC,20629,10074,10555,486,196,367,240,1393,1766,4220,11715,44,202,11594,9035,ITG,ITG1,19,Sicilia,Sicilia,4999891,890279,17.81,0.41
1745,2021-02-05,SIC,7216,3232,3984,3618,1902,856,0,74,32,109,0,0,625,2132,5084,ITG,ITG1,19,Sicilia,Sicilia,4999891,897495,17.95,0.14
1746,2020-12-30,SIC,173,101,72,156,11,0,0,0,0,0,0,0,6,173,0,ITG,ITG1,19,Sicilia,Sicilia,4999891,897668,17.95,0.0
1747,2021-02-26,SIC,12247,5977,6270,1837,1123,399,2453,47,18,3954,1,1854,561,10558,1689,ITG,ITG1,19,Sicilia,Sicilia,4999891,909915,18.2,0.24
1748,2021-02-09,SIC,4371,1831,2540,2241,871,640,0,59,27,15,0,0,518,3365,1006,ITG,ITG1,19,Sicilia,Sicilia,4999891,914286,18.29,0.09
1749,2021-03-17,SIC,15420,7568,7852,1402,538,665,306,158,206,5778,6048,73,246,9474,5946,ITG,ITG1,19,Sicilia,Sicilia,4999891,929706,18.59,0.31
1750,2021-02-22,SIC,8039,4162,3877,1107,452,561,322,30,10,4149,0,1153,255,7547,492,ITG,ITG1,19,Sicilia,Sicilia,4999891,937745,18.76,0.16
1751,2021-03-19,SIC,16504,8124,8380,1262,570,601,456,149,579,5433,7119,52,283,10776,5728,ITG,ITG1,19,Sicilia,Sicilia,4999891,954249,19.09,0.33
1752,2021-01-06,SIC,6471,3402,3069,5717,434,2,0,51,31,15,0,0,221,6471,0,ITG,ITG1,19,Sicilia,Sicilia,4999891,960720,19.21,0.13
1753,2021-04-15,SIC,21369,10395,10974,800,448,345,112,1744,1530,4185,11973,34,198,11799,9570,ITG,ITG1,19,Sicilia,Sicilia,4999891,982089,19.64,0.43
1754,2021-01-08,SIC,8328,3864,4464,6591,942,213,0,78,33,23,0,0,448,8328,0,ITG,ITG1,19,Sicilia,Sicilia,4999891,990417,19.81,0.17
1755,2021-03-01,SIC,12981,6130,6851,1558,1041,395,3153,58,18,4376,34,1859,489,11322,1659,ITG,ITG1,19,Sicilia,Sicilia,4999891,1003398,20.07,0.26
1756,2021-03-28,SIC,11003,5166,5837,535,300,171,187,90,947,4520,4083,28,142,6989,4014,ITG,ITG1,19,Sicilia,Sicilia,4999891,1014401,20.29,0.22
1757,2021-01-12,SIC,4543,2235,2308,2863,1177,195,0,61,14,29,0,0,204,4543,0,ITG,ITG1,19,Sicilia,Sicilia,4999891,1018944,20.38,0.09
1758,2020-12-31,SIC,878,470,408,828,6,0,0,4,0,0,0,0,40,878,0,ITG,ITG1,19,Sicilia,Sicilia,4999891,1019822,20.4,0.02
1759,2021-01-05,SIC,10527,5159,5368,9074,915,207,0,47,7,4,0,0,273,10527,0,ITG,ITG1,19,Sicilia,Sicilia,4999891,1030349,20.61,0.21
1760,2021-01-22,SIC,1235,625,610,1035,59,118,0,3,0,0,0,0,20,242,993,ITG,ITG1,19,Sicilia,Sicilia,4999891,1031584,20.63,0.02
1761,2021-01-01,SIC,815,437,378,740,29,0,0,10,0,0,0,0,36,815,0,ITG,ITG1,19,Sicilia,Sicilia,4999891,1032399,20.65,0.02
1762,2021-01-29,SIC,9363,4323,5040,7154,1601,305,0,27,8,79,0,0,189,432,8931,ITG,ITG1,19,Sicilia,Sicilia,4999891,1041762,20.84,0.19
1763,2021-03-18,SIC,15628,7784,7844,1284,485,617,37,162,191,5468,7020,73,291,9916,5712,ITG,ITG1,19,Sicilia,Sicilia,4999891,1057390,21.15,0.31
1764,2021-03-12,SIC,13124,5620,7504,1387,866,741,2407,238,1989,3884,158,627,827,10900,2224,ITG,ITG1,19,Sicilia,Sicilia,4999891,1070514,21.41,0.26
1765,2021-02-27,SIC,12450,5570,6880,1515,777,280,3371,149,11,3976,2,1146,1223,11239,1211,ITG,ITG1,19,Sicilia,Sicilia,4999891,1082964,21.66,0.25
1766,2021-03-10,SIC,13987,5975,8012,1481,1361,983,3766,148,24,4187,154,1120,763,11596,2391,ITG,ITG1,19,Sicilia,Sicilia,4999891,1096951,21.94,0.28
1767,2021-01-21,SIC,1331,649,682,1003,124,138,0,11,4,0,0,0,51,500,831,ITG,ITG1,19,Sicilia,Sicilia,4999891,1098282,21.97,0.03
1768,2021-04-17,SIC,26119,13208,12911,324,100,212,89,7809,2365,3862,11170,31,157,18970,7149,ITG,ITG1,19,Sicilia,Sicilia,4999891,1124401,22.49,0.52
1769,2020-12-27,SIC,90,54,36,62,1,26,0,0,0,0,0,0,1,90,0,ITG,ITG1,19,Sicilia,Sicilia,4999891,1124491,22.49,0.0
1770,2021-02-20,SIC,7285,3737,3548,848,712,561,175,39,14,3987,9,730,210,7033,252,ITG,ITG1,19,Sicilia,Sicilia,4999891,1131776,22.64,0.15
1771,2021-01-26,BAS,793,350,443,622,70,35,0,18,0,0,0,0,48,101,692,ITF,ITF5,17,Basilicata,Basilicata,559084,793,0.14,0.14
1772,2021-01-31,BAS,77,24,53,75,2,0,0,0,0,0,0,0,0,0,77,ITF,ITF5,17,Basilicata,Basilicata,559084,870,0.16,0.01
1773,2021-02-10,BAS,547,237,310,176,153,127,1,0,0,90,0,0,0,495,52,ITF,ITF5,17,Basilicata,Basilicata,559084,1417,0.25,0.1
1774,2021-04-13,BAS,2131,1059,1072,147,15,1,73,420,443,818,177,6,31,1303,828,ITF,ITF5,17,Basilicata,Basilicata,559084,3548,0.63,0.38
1775,2021-03-27,BAS,2024,747,1277,17,33,0,378,10,17,1546,13,0,10,1710,314,ITF,ITF5,17,Basilicata,Basilicata,559084,5572,1.0,0.36
1776,2021-04-15,BAS,3454,1675,1779,115,37,1,35,243,207,738,2038,6,34,2645,809,ITF,ITF5,17,Basilicata,Basilicata,559084,9026,1.61,0.62
1777,2021-03-10,BAS,1650,814,836,101,57,33,273,1,4,877,2,300,2,811,839,ITF,ITF5,17,Basilicata,Basilicata,559084,10676,1.91,0.3
1778,2021-03-08,BAS,1450,707,743,221,158,38,273,7,12,410,2,299,30,840,610,ITF,ITF5,17,Basilicata,Basilicata,559084,12126,2.17,0.26
1779,2021-03-28,BAS,2147,745,1402,92,6,8,712,3,8,1279,7,2,30,2125,22,ITF,ITF5,17,Basilicata,Basilicata,559084,14273,2.55,0.38
1780,2021-03-20,BAS,1286,566,720,45,69,0,178,0,8,950,30,5,1,275,1011,ITF,ITF5,17,Basilicata,Basilicata,559084,15559,2.78,0.23
1781,2021-04-06,BAS,1397,478,919,205,70,7,588,29,8,343,60,27,60,1201,196,ITF,ITF5,17,Basilicata,Basilicata,559084,16956,3.03,0.25
1782,2021-03-19,BAS,2284,988,1296,58,96,0,142,1,8,1950,2,22,5,261,2023,ITF,ITF5,17,Basilicata,Basilicata,559084,19240,3.44,0.41
1783,2021-01-29,BAS,613,229,384,398,38,70,0,41,2,16,0,0,48,63,550,ITF,ITF5,17,Basilicata,Basilicata,559084,19853,3.55,0.11
1784,2021-02-24,BAS,1803,743,1060,85,14,2,0,4,8,1686,0,1,3,1734,69,ITF,ITF5,17,Basilicata,Basilicata,559084,21656,3.87,0.32
1785,2021-02-07,BAS,373,159,214,259,74,40,0,0,0,0,0,0,0,49,324,ITF,ITF5,17,Basilicata,Basilicata,559084,22029,3.94,0.07
1786,2021-01-17,BAS,328,133,195,233,12,54,0,5,1,0,0,0,23,327,1,ITF,ITF5,17,Basilicata,Basilicata,559084,22357,4.0,0.06
1787,2021-04-11,BAS,847,330,517,74,3,9,225,3,5,47,473,3,5,786,61,ITF,ITF5,17,Basilicata,Basilicata,559084,23204,4.15,0.15
1788,2021-01-21,BAS,30,10,20,0,0,0,0,2,0,4,0,0,24,30,0,ITF,ITF5,17,Basilicata,Basilicata,559084,23234,4.16,0.01
1789,2021-04-12,BAS,2249,1086,1163,227,24,31,102,719,440,523,157,14,12,1675,574,ITF,ITF5,17,Basilicata,Basilicata,559084,25483,4.56,0.4
1790,2021-02-23,BAS,1901,771,1130,159,24,35,0,4,15,1658,0,0,6,1763,138,ITF,ITF5,17,Basilicata,Basilicata,559084,27384,4.9,0.34
1791,2021-02-26,BAS,2148,904,1244,88,94,1,0,2,6,1954,0,0,3,2069,79,ITF,ITF5,17,Basilicata,Basilicata,559084,29532,5.28,0.38
1792,2021-01-25,BAS,1020,427,593,828,80,1,0,33,2,0,0,0,76,74,946,ITF,ITF5,17,Basilicata,Basilicata,559084,30552,5.46,0.18
1793,2021-03-21,BAS,1045,480,565,32,1,0,159,2,9,803,0,0,39,352,693,ITF,ITF5,17,Basilicata,Basilicata,559084,31597,5.65,0.19
1794,2021-03-05,BAS,1849,855,994,298,157,72,309,6,12,689,2,296,8,1104,745,ITF,ITF5,17,Basilicata,Basilicata,559084,33446,5.98,0.33
1795,2021-01-07,BAS,640,319,321,556,8,29,0,16,0,0,0,0,31,640,0,ITF,ITF5,17,Basilicata,Basilicata,559084,34086,6.1,0.11
1796,2021-04-04,BAS,543,215,328,9,8,0,88,7,0,406,20,4,1,130,413,ITF,ITF5,17,Basilicata,Basilicata,559084,34629,6.19,0.1
1797,2021-04-17,BAS,3453,1654,1799,53,7,0,10,13,17,1232,2104,12,5,2191,1262,ITF,ITF5,17,Basilicata,Basilicata,559084,38082,6.81,0.62
1798,2021-03-03,BAS,1740,813,927,191,298,99,244,3,3,590,58,253,1,1184,556,ITF,ITF5,17,Basilicata,Basilicata,559084,39822,7.12,0.31
1799,2021-03-06,BAS,1351,535,816,296,140,57,259,0,2,383,0,212,2,757,594,ITF,ITF5,17,Basilicata,Basilicata,559084,41173,7.36,0.24
1800,2021-01-22,BAS,67,24,43,6,0,0,0,13,10,19,0,0,19,67,0,ITF,ITF5,17,Basilicata,Basilicata,559084,41240,7.38,0.01
1801,2021-03-25,BAS,1721,575,1146,38,52,11,637,4,12,915,25,24,3,1409,312,ITF,ITF5,17,Basilicata,Basilicata,559084,42961,7.68,0.31
1802,2021-03-16,BAS,1899,799,1100,103,30,0,62,4,13,1671,2,6,8,228,1671,ITF,ITF5,17,Basilicata,Basilicata,559084,44860,8.02,0.34
1803,2021-01-09,BAS,557,160,397,386,55,67,1,7,0,0,0,0,41,557,0,ITF,ITF5,17,Basilicata,Basilicata,559084,45417,8.12,0.1
1804,2021-02-15,BAS,621,232,389,191,134,46,0,0,3,246,0,1,0,580,41,ITF,ITF5,17,Basilicata,Basilicata,559084,46038,8.23,0.11
1805,2021-03-13,BAS,1794,888,906,82,325,46,213,2,6,864,1,245,10,749,1045,ITF,ITF5,17,Basilicata,Basilicata,559084,47832,8.56,0.32
1806,2021-02-09,BAS,491,213,278,200,237,54,0,0,0,0,0,0,0,316,175,ITF,ITF5,17,Basilicata,Basilicata,559084,48323,8.64,0.09
1807,2020-12-27,BAS,106,41,65,104,0,0,0,0,0,0,0,0,2,106,0,ITF,ITF5,17,Basilicata,Basilicata,559084,48429,8.66,0.02
1808,2021-01-27,BAS,411,175,236,299,17,26,0,12,9,25,0,0,23,113,298,ITF,ITF5,17,Basilicata,Basilicata,559084,48840,8.74,0.07
1809,2021-01-02,BAS,949,380,569,855,43,0,3,9,0,0,0,0,39,949,0,ITF,ITF5,17,Basilicata,Basilicata,559084,49789,8.91,0.17
1810,2021-01-05,BAS,945,409,536,861,44,0,0,12,0,0,0,0,28,945,0,ITF,ITF5,17,Basilicata,Basilicata,559084,50734,9.07,0.17
1811,2021-01-20,BAS,84,22,62,0,0,0,0,10,8,43,0,0,23,84,0,ITF,ITF5,17,Basilicata,Basilicata,559084,50818,9.09,0.02
1812,2021-03-09,BAS,1391,706,685,222,51,33,238,2,2,545,0,292,6,787,604,ITF,ITF5,17,Basilicata,Basilicata,559084,52209,9.34,0.25
1813,2021-03-23,BAS,1192,490,702,48,5,2,277,5,2,824,5,21,3,1085,107,ITF,ITF5,17,Basilicata,Basilicata,559084,53401,9.55,0.21
1814,2021-01-15,BAS,813,350,463,578,21,174,0,5,1,1,0,0,33,813,0,ITF,ITF5,17,Basilicata,Basilicata,559084,54214,9.7,0.15
1815,2021-04-19,BAS,2750,1230,1520,37,16,3,109,9,24,1192,1331,6,23,1499,1251,ITF,ITF5,17,Basilicata,Basilicata,559084,56964,10.19,0.49
1816,2021-04-08,BAS,879,405,474,260,57,0,188,16,9,82,199,37,31,870,9,ITF,ITF5,17,Basilicata,Basilicata,559084,57843,10.35,0.16
1817,2021-01-11,BAS,183,66,117,107,21,41,0,4,0,0,0,0,10,183,0,ITF,ITF5,17,Basilicata,Basilicata,559084,58026,10.38,0.03
1818,2021-01-28,BAS,903,401,502,717,24,81,0,30,0,1,0,0,50,119,784,ITF,ITF5,17,Basilicata,Basilicata,559084,58929,10.54,0.16
1819,2021-03-11,BAS,1783,919,864,163,83,77,223,5,5,905,3,289,30,824,959,ITF,ITF5,17,Basilicata,Basilicata,559084,60712,10.86,0.32
1820,2021-03-02,BAS,791,381,410,110,33,5,213,5,4,184,0,237,0,656,135,ITF,ITF5,17,Basilicata,Basilicata,559084,61503,11.0,0.14
1821,2021-02-11,BAS,951,401,550,200,158,107,0,0,6,472,0,4,4,868,83,ITF,ITF5,17,Basilicata,Basilicata,559084,62454,11.17,0.17
1822,2021-04-14,BAS,2076,1008,1068,34,4,2,92,295,602,671,337,14,25,1391,685,ITF,ITF5,17,Basilicata,Basilicata,559084,64530,11.54,0.37
1823,2021-01-12,BAS,217,88,129,87,22,99,0,1,0,0,0,0,8,217,0,ITF,ITF5,17,Basilicata,Basilicata,559084,64747,11.58,0.04
1824,2021-01-23,BAS,707,299,408,592,38,1,0,18,2,8,0,0,48,33,674,ITF,ITF5,17,Basilicata,Basilicata,559084,65454,11.71,0.13
1825,2021-04-09,BAS,1146,351,795,142,16,1,618,12,12,137,126,50,32,1079,67,ITF,ITF5,17,Basilicata,Basilicata,559084,66600,11.91,0.2
1826,2021-01-14,BAS,969,413,556,504,112,323,0,6,0,0,0,0,24,969,0,ITF,ITF5,17,Basilicata,Basilicata,559084,67569,12.09,0.17
1827,2021-03-07,BAS,882,308,574,39,12,4,471,2,0,328,0,22,4,844,38,ITF,ITF5,17,Basilicata,Basilicata,559084,68451,12.24,0.16
1828,2021-01-18,BAS,463,157,306,364,52,45,0,0,0,0,0,0,2,364,99,ITF,ITF5,17,Basilicata,Basilicata,559084,68914,12.33,0.08
1829,2021-04-07,BAS,1396,579,817,268,21,20,583,8,10,103,340,23,20,1361,35,ITF,ITF5,17,Basilicata,Basilicata,559084,70310,12.58,0.25
1830,2021-03-04,BAS,1872,889,983,217,151,66,241,1,5,843,41,302,5,1079,793,ITF,ITF5,17,Basilicata,Basilicata,559084,72182,12.91,0.33
1831,2021-02-20,BAS,1160,530,630,77,170,80,0,0,9,810,11,0,3,1043,117,ITF,ITF5,17,Basilicata,Basilicata,559084,73342,13.12,0.21
1832,2021-04-05,BAS,437,166,271,2,3,0,71,2,1,338,15,4,1,135,302,ITF,ITF5,17,Basilicata,Basilicata,559084,73779,13.2,0.08
1833,2021-02-14,BAS,151,48,103,55,12,65,0,0,1,18,0,0,0,151,0,ITF,ITF5,17,Basilicata,Basilicata,559084,73930,13.22,0.03
1834,2021-02-19,BAS,1622,737,885,219,360,66,0,1,13,962,0,0,1,1560,62,ITF,ITF5,17,Basilicata,Basilicata,559084,75552,13.51,0.29
1835,2021-03-26,BAS,1927,697,1230,195,8,3,475,10,7,1188,21,8,12,1665,262,ITF,ITF5,17,Basilicata,Basilicata,559084,77479,13.86,0.34
1836,2021-01-08,BAS,554,219,335,383,33,59,0,36,0,0,0,0,43,554,0,ITF,ITF5,17,Basilicata,Basilicata,559084,78033,13.96,0.1
1837,2021-02-01,BAS,242,91,151,156,24,48,0,4,1,0,0,0,9,46,196,ITF,ITF5,17,Basilicata,Basilicata,559084,78275,14.0,0.04
1838,2021-01-16,BAS,721,304,417,466,17,161,2,17,0,1,0,0,57,721,0,ITF,ITF5,17,Basilicata,Basilicata,559084,78996,14.13,0.13
1839,2021-03-12,BAS,1896,975,921,266,64,37,258,1,8,985,0,274,3,798,1098,ITF,ITF5,17,Basilicata,Basilicata,559084,80892,14.47,0.34
1840,2021-01-19,BAS,199,84,115,78,48,44,0,3,6,8,0,0,12,199,0,ITF,ITF5,17,Basilicata,Basilicata,559084,81091,14.5,0.04
1841,2021-01-04,BAS,607,271,336,550,49,0,2,1,0,0,0,0,5,607,0,ITF,ITF5,17,Basilicata,Basilicata,559084,81698,14.61,0.11
1842,2021-04-01,BAS,2826,1145,1681,79,33,24,288,15,23,2175,103,17,69,2112,714,ITF,ITF5,17,Basilicata,Basilicata,559084,84524,15.12,0.51
1843,2021-03-14,BAS,1008,477,531,41,110,8,249,0,3,516,0,79,2,539,469,ITF,ITF5,17,Basilicata,Basilicata,559084,85532,15.3,0.18
1844,2021-03-17,BAS,1448,606,842,22,12,0,2,6,9,1390,0,5,2,27,1421,ITF,ITF5,17,Basilicata,Basilicata,559084,86980,15.56,0.26
1845,2021-02-12,BAS,775,332,443,288,192,90,0,3,4,192,0,6,0,744,31,ITF,ITF5,17,Basilicata,Basilicata,559084,87755,15.7,0.14
1846,2021-02-16,BAS,905,377,528,250,93,67,0,1,1,492,0,1,0,807,98,ITF,ITF5,17,Basilicata,Basilicata,559084,88660,15.86,0.16
1847,2021-02-27,BAS,1986,856,1130,103,123,21,0,16,6,1678,4,0,35,1822,164,ITF,ITF5,17,Basilicata,Basilicata,559084,90646,16.21,0.36
1848,2021-02-17,BAS,1135,493,642,123,53,57,1,0,12,885,0,1,3,1059,76,ITF,ITF5,17,Basilicata,Basilicata,559084,91781,16.42,0.2
1849,2021-02-04,BAS,1092,440,652,636,106,281,0,26,0,3,0,0,40,63,1029,ITF,ITF5,17,Basilicata,Basilicata,559084,92873,16.61,0.2
1850,2021-03-31,BAS,3238,1288,1950,68,46,0,231,20,13,2664,129,21,46,2454,784,ITF,ITF5,17,Basilicata,Basilicata,559084,96111,17.19,0.58
1851,2021-01-06,BAS,294,129,165,229,9,36,0,6,0,0,0,0,14,294,0,ITF,ITF5,17,Basilicata,Basilicata,559084,96405,17.24,0.05
1852,2021-03-01,BAS,540,279,261,121,107,4,50,1,1,169,0,86,1,376,164,ITF,ITF5,17,Basilicata,Basilicata,559084,96945,17.34,0.1
1853,2021-02-18,BAS,1070,401,669,270,59,150,0,0,0,588,0,0,3,855,215,ITF,ITF5,17,Basilicata,Basilicata,559084,98015,17.53,0.19
1854,2021-03-18,BAS,1346,561,785,30,0,0,0,1,7,1306,0,0,2,22,1324,ITF,ITF5,17,Basilicata,Basilicata,559084,99361,17.77,0.24
1855,2021-02-28,BAS,802,342,460,32,29,0,0,0,0,740,0,0,1,774,28,ITF,ITF5,17,Basilicata,Basilicata,559084,100163,17.92,0.14
1856,2021-02-21,BAS,284,113,171,16,1,11,1,0,1,254,0,0,0,284,0,ITF,ITF5,17,Basilicata,Basilicata,559084,100447,17.97,0.05
1857,2021-02-25,BAS,1787,736,1051,67,3,0,0,1,6,1705,0,1,4,1741,46,ITF,ITF5,17,Basilicata,Basilicata,559084,102234,18.29,0.32
1858,2021-02-22,BAS,1790,773,1017,125,23,2,0,2,7,1627,0,0,4,1737,53,ITF,ITF5,17,Basilicata,Basilicata,559084,104024,18.61,0.32
1859,2021-02-08,BAS,557,193,364,436,72,49,0,0,0,0,0,0,0,151,406,ITF,ITF5,17,Basilicata,Basilicata,559084,104581,18.71,0.1
1860,2021-04-18,BAS,3718,1845,1873,29,6,0,16,44,214,1341,2050,15,3,2351,1367,ITF,ITF5,17,Basilicata,Basilicata,559084,108299,19.37,0.67
1861,2021-04-03,BAS,1805,751,1054,39,3,0,314,12,8,1105,288,14,22,1469,336,ITF,ITF5,17,Basilicata,Basilicata,559084,110104,19.69,0.32
1862,2021-03-29,BAS,2683,986,1697,71,20,1,674,15,10,1782,60,8,42,2343,340,ITF,ITF5,17,Basilicata,Basilicata,559084,112787,20.17,0.48
1863,2021-03-15,BAS,2347,981,1366,78,30,0,266,3,6,1934,1,23,6,520,1827,ITF,ITF5,17,Basilicata,Basilicata,559084,115134,20.59,0.42
1864,2021-02-02,BAS,365,141,224,212,15,102,0,9,1,0,0,0,26,175,190,ITF,ITF5,17,Basilicata,Basilicata,559084,115499,20.66,0.07
1865,2021-01-30,BAS,703,226,477,424,81,126,0,20,0,0,0,0,52,127,576,ITF,ITF5,17,Basilicata,Basilicata,559084,116202,20.78,0.13
1866,2021-02-03,BAS,666,300,366,425,15,172,0,40,1,0,0,0,13,32,634,ITF,ITF5,17,Basilicata,Basilicata,559084,116868,20.9,0.12
1867,2021-01-03,BAS,900,344,556,790,53,0,2,7,0,0,0,0,48,900,0,ITF,ITF5,17,Basilicata,Basilicata,559084,117768,21.06,0.16
1868,2021-01-10,BAS,77,24,53,9,2,0,0,7,4,0,0,0,55,77,0,ITF,ITF5,17,Basilicata,Basilicata,559084,117845,21.08,0.01
1869,2021-03-30,BAS,2897,1181,1716,37,15,0,512,8,14,2193,80,13,25,2552,345,ITF,ITF5,17,Basilicata,Basilicata,559084,120742,21.6,0.52
1870,2021-02-05,BAS,983,443,540,611,37,191,0,23,8,5,0,0,108,64,919,ITF,ITF5,17,Basilicata,Basilicata,559084,121725,21.77,0.18
1871,2021-01-13,BAS,916,387,529,699,11,148,1,37,1,1,0,0,18,916,0,ITF,ITF5,17,Basilicata,Basilicata,559084,122641,21.94,0.16
1872,2021-03-24,BAS,1542,626,916,67,24,0,417,2,8,955,5,45,19,1189,353,ITF,ITF5,17,Basilicata,Basilicata,559084,124183,22.21,0.28
1873,2021-04-02,BAS,2308,1043,1265,97,34,2,25,18,33,1729,269,42,59,1701,607,ITF,ITF5,17,Basilicata,Basilicata,559084,126491,22.62,0.41
1874,2021-01-24,BAS,834,299,535,706,46,1,0,13,0,0,0,0,68,58,776,ITF,ITF5,17,Basilicata,Basilicata,559084,127325,22.77,0.15
1875,2021-02-06,BAS,902,367,535,546,186,168,1,1,0,0,0,0,0,146,756,ITF,ITF5,17,Basilicata,Basilicata,559084,128227,22.94,0.16
1876,2021-04-16,BAS,3353,1646,1707,32,21,1,70,19,35,885,2269,6,15,2439,914,ITF,ITF5,17,Basilicata,Basilicata,559084,131580,23.53,0.6
1877,2021-03-22,BAS,1172,529,643,46,68,0,385,2,4,642,7,16,2,626,546,ITF,ITF5,17,Basilicata,Basilicata,559084,132752,23.74,0.21
1878,2021-04-10,BAS,1036,383,653,64,12,8,486,5,4,147,282,21,7,954,82,ITF,ITF5,17,Basilicata,Basilicata,559084,133788,23.93,0.19
1879,2021-02-13,BAS,799,313,486,279,155,115,0,5,14,201,0,2,28,738,61,ITF,ITF5,17,Basilicata,Basilicata,559084,134587,24.07,0.14
1880,2021-04-09,VDA,233,110,123,0,0,7,0,154,32,29,8,0,3,200,33,ITC,ITC2,2,Valle d'Aosta / Vallée d'Aoste,Valle d'Aosta,125666,233,0.19,0.19
1881,2021-01-29,VDA,316,138,178,259,32,16,0,6,3,0,0,0,0,2,314,ITC,ITC2,2,Valle d'Aosta / Vallée d'Aoste,Valle d'Aosta,125666,549,0.44,0.25
1882,2021-03-20,VDA,205,85,120,5,4,15,1,86,46,14,1,27,6,170,35,ITC,ITC2,2,Valle d'Aosta / Vallée d'Aoste,Valle d'Aosta,125666,754,0.6,0.16
1883,2021-02-24,VDA,183,82,101,30,9,13,7,0,4,66,0,54,0,164,19,ITC,ITC2,2,Valle d'Aosta / Vallée d'Aoste,Valle d'Aosta,125666,937,0.75,0.15
1884,2021-01-09,VDA,443,199,244,225,183,22,0,7,6,0,0,0,0,443,0,ITC,ITC2,2,Valle d'Aosta / Vallée d'Aoste,Valle d'Aosta,125666,1380,1.1,0.35
1885,2021-02-07,VDA,292,120,172,110,63,0,3,1,1,105,7,2,0,190,102,ITC,ITC2,2,Valle d'Aosta / Vallée d'Aoste,Valle d'Aosta,125666,1672,1.33,0.23
1886,2021-03-29,VDA,489,232,257,6,5,18,0,50,171,209,23,1,6,450,39,ITC,ITC2,2,Valle d'Aosta / Vallée d'Aoste,Valle d'Aosta,125666,2161,1.72,0.39
1887,2021-02-16,VDA,325,53,272,10,0,14,236,11,8,32,0,4,10,320,5,ITC,ITC2,2,Valle d'Aosta / Vallée d'Aoste,Valle d'Aosta,125666,2486,1.98,0.26
1888,2021-01-21,VDA,33,12,21,0,0,33,0,0,0,0,0,0,0,33,0,ITC,ITC2,2,Valle d'Aosta / Vallée d'Aoste,Valle d'Aosta,125666,2519,2.0,0.03
1889,2021-02-21,VDA,18,3,15,0,0,18,0,0,0,0,0,0,0,0,18,ITC,ITC2,2,Valle d'Aosta / Vallée d'Aoste,Valle d'Aosta,125666,2537,2.02,0.01
1890,2021-03-25,VDA,386,154,232,10,0,1,1,8,57,287,14,0,8,377,9,ITC,ITC2,2,Valle d'Aosta / Vallée d'Aoste,Valle d'Aosta,125666,2923,2.33,0.31
1891,2021-03-15,VDA,361,122,239,20,4,10,65,8,16,217,14,7,0,159,202,ITC,ITC2,2,Valle d'Aosta / Vallée d'Aoste,Valle d'Aosta,125666,3284,2.61,0.29
1892,2021-01-30,VDA,437,202,235,232,181,12,0,7,4,0,0,0,1,14,423,ITC,ITC2,2,Valle d'Aosta / Vallée d'Aoste,Valle d'Aosta,125666,3721,2.96,0.35
1893,2021-01-14,VDA,237,69,168,151,62,0,0,16,6,2,0,0,0,237,0,ITC,ITC2,2,Valle d'Aosta / Vallée d'Aoste,Valle d'Aosta,125666,3958,3.15,0.19
1894,2021-04-19,VDA,426,177,249,5,0,2,0,37,63,241,73,0,5,219,207,ITC,ITC2,2,Valle d'Aosta / Vallée d'Aoste,Valle d'Aosta,125666,4384,3.49,0.34
1895,2021-02-22,VDA,316,94,222,62,10,39,67,0,15,111,0,6,6,213,103,ITC,ITC2,2,Valle d'Aosta / Vallée d'Aoste,Valle d'Aosta,125666,4700,3.74,0.25
1896,2021-03-04,VDA,291,139,152,56,19,2,2,3,10,160,2,14,23,42,249,ITC,ITC2,2,Valle d'Aosta / Vallée d'Aoste,Valle d'Aosta,125666,4991,3.97,0.23
1897,2021-01-13,VDA,337,110,227,166,138,28,0,3,2,0,0,0,0,337,0,ITC,ITC2,2,Valle d'Aosta / Vallée d'Aoste,Valle d'Aosta,125666,5328,4.24,0.27
1898,2021-04-10,VDA,401,189,212,2,2,1,0,109,223,22,30,0,12,396,5,ITC,ITC2,2,Valle d'Aosta / Vallée d'Aoste,Valle d'Aosta,125666,5729,4.56,0.32
1899,2021-02-05,VDA,294,102,192,159,52,0,0,14,16,53,0,0,0,101,193,ITC,ITC2,2,Valle d'Aosta / Vallée d'Aoste,Valle d'Aosta,125666,6023,4.79,0.23
1900,2021-04-16,VDA,596,261,335,63,10,2,0,235,79,25,172,0,10,594,2,ITC,ITC2,2,Valle d'Aosta / Vallée d'Aoste,Valle d'Aosta,125666,6619,5.27,0.47
1901,2021-03-13,VDA,142,84,58,2,11,0,3,80,0,0,0,24,22,142,0,ITC,ITC2,2,Valle d'Aosta / Vallée d'Aoste,Valle d'Aosta,125666,6761,5.38,0.11
1902,2021-04-14,VDA,933,424,509,16,3,0,1,83,257,403,150,3,17,711,222,ITC,ITC2,2,Valle d'Aosta / Vallée d'Aoste,Valle d'Aosta,125666,7694,6.12,0.74
1903,2021-04-15,VDA,806,375,431,30,1,0,1,232,134,241,153,2,12,667,139,ITC,ITC2,2,Valle d'Aosta / Vallée d'Aoste,Valle d'Aosta,125666,8500,6.76,0.64
1904,2021-03-27,VDA,332,164,168,23,12,14,1,111,72,66,4,21,8,301,31,ITC,ITC2,2,Valle d'Aosta / Vallée d'Aoste,Valle d'Aosta,125666,8832,7.03,0.26
1905,2021-03-07,VDA,64,30,34,16,3,0,1,1,4,26,0,2,11,11,53,ITC,ITC2,2,Valle d'Aosta / Vallée d'Aoste,Valle d'Aosta,125666,8896,7.08,0.05
1906,2021-01-18,VDA,213,74,139,29,7,27,0,104,0,46,0,0,0,213,0,ITC,ITC2,2,Valle d'Aosta / Vallée d'Aoste,Valle d'Aosta,125666,9109,7.25,0.17
1907,2021-02-27,VDA,230,84,146,69,8,2,0,10,4,128,0,4,5,124,106,ITC,ITC2,2,Valle d'Aosta / Vallée d'Aoste,Valle d'Aosta,125666,9339,7.43,0.18
1908,2021-01-02,VDA,6,5,1,0,0,6,0,0,0,0,0,0,0,6,0,ITC,ITC2,2,Valle d'Aosta / Vallée d'Aoste,Valle d'Aosta,125666,9345,7.44,0.0
1909,2021-03-18,VDA,134,43,91,4,0,25,0,0,2,101,1,1,0,98,36,ITC,ITC2,2,Valle d'Aosta / Vallée d'Aoste,Valle d'Aosta,125666,9479,7.54,0.11
1910,2021-01-22,VDA,56,21,35,36,0,20,0,0,0,0,0,0,0,20,36,ITC,ITC2,2,Valle d'Aosta / Vallée d'Aoste,Valle d'Aosta,125666,9535,7.59,0.04
1911,2021-02-06,VDA,289,104,185,170,36,0,0,1,2,74,5,1,0,92,197,ITC,ITC2,2,Valle d'Aosta / Vallée d'Aoste,Valle d'Aosta,125666,9824,7.82,0.23
1912,2021-03-10,VDA,436,182,254,9,0,17,0,1,19,361,20,7,2,225,211,ITC,ITC2,2,Valle d'Aosta / Vallée d'Aoste,Valle d'Aosta,125666,10260,8.16,0.35
1913,2021-03-02,VDA,339,166,173,17,9,39,5,34,1,145,0,65,24,336,3,ITC,ITC2,2,Valle d'Aosta / Vallée d'Aoste,Valle d'Aosta,125666,10599,8.43,0.27
1914,2021-01-20,VDA,23,8,15,0,0,6,0,0,0,17,0,0,0,23,0,ITC,ITC2,2,Valle d'Aosta / Vallée d'Aoste,Valle d'Aosta,125666,10622,8.45,0.02
1915,2021-03-11,VDA,192,72,120,2,0,7,2,1,10,167,1,1,1,64,128,ITC,ITC2,2,Valle d'Aosta / Vallée d'Aoste,Valle d'Aosta,125666,10814,8.61,0.15
1916,2021-02-20,VDA,251,210,41,6,17,11,9,3,2,8,0,183,12,241,10,ITC,ITC2,2,Valle d'Aosta / Vallée d'Aoste,Valle d'Aosta,125666,11065,8.81,0.2
1917,2021-04-08,VDA,582,282,300,6,0,4,2,50,146,281,80,0,13,438,144,ITC,ITC2,2,Valle d'Aosta / Vallée d'Aoste,Valle d'Aosta,125666,11647,9.27,0.46
1918,2021-01-11,VDA,325,112,213,238,50,30,0,3,3,0,0,0,1,325,0,ITC,ITC2,2,Valle d'Aosta / Vallée d'Aoste,Valle d'Aosta,125666,11972,9.53,0.26
1919,2021-04-17,VDA,635,405,230,8,8,0,2,158,197,46,206,0,10,633,2,ITC,ITC2,2,Valle d'Aosta / Vallée d'Aoste,Valle d'Aosta,125666,12607,10.03,0.51
1920,2021-04-11,VDA,476,207,269,2,3,0,3,265,142,5,47,0,9,476,0,ITC,ITC2,2,Valle d'Aosta / Vallée d'Aoste,Valle d'Aosta,125666,13083,10.41,0.38
1921,2021-02-23,VDA,216,123,93,0,1,0,16,0,0,0,0,46,153,216,0,ITC,ITC2,2,Valle d'Aosta / Vallée d'Aoste,Valle d'Aosta,125666,13299,10.58,0.17
1922,2021-03-17,VDA,430,185,245,35,4,15,7,14,23,253,9,42,28,270,160,ITC,ITC2,2,Valle d'Aosta / Vallée d'Aoste,Valle d'Aosta,125666,13729,10.92,0.34
1923,2021-02-09,VDA,251,84,167,78,16,14,53,8,3,75,2,1,1,68,183,ITC,ITC2,2,Valle d'Aosta / Vallée d'Aoste,Valle d'Aosta,125666,13980,11.12,0.2
1924,2021-02-17,VDA,327,144,183,25,1,30,0,0,16,237,0,17,1,227,100,ITC,ITC2,2,Valle d'Aosta / Vallée d'Aoste,Valle d'Aosta,125666,14307,11.38,0.26
1925,2021-03-06,VDA,22,4,18,13,0,5,0,0,0,4,0,0,0,22,0,ITC,ITC2,2,Valle d'Aosta / Vallée d'Aoste,Valle d'Aosta,125666,14329,11.4,0.02
1926,2021-02-26,VDA,206,57,149,67,8,6,1,6,6,102,1,4,5,122,84,ITC,ITC2,2,Valle d'Aosta / Vallée d'Aoste,Valle d'Aosta,125666,14535,11.57,0.16
1927,2021-01-05,VDA,150,54,96,127,11,11,0,0,1,0,0,0,0,150,0,ITC,ITC2,2,Valle d'Aosta / Vallée d'Aoste,Valle d'Aosta,125666,14685,11.69,0.12
1928,2021-01-08,VDA,299,130,169,240,35,16,0,5,3,0,0,0,0,299,0,ITC,ITC2,2,Valle d'Aosta / Vallée d'Aoste,Valle d'Aosta,125666,14984,11.92,0.24
1929,2020-12-31,VDA,18,4,14,16,2,0,0,0,0,0,0,0,0,18,0,ITC,ITC2,2,Valle d'Aosta / Vallée d'Aoste,Valle d'Aosta,125666,15002,11.94,0.01
1930,2021-03-14,VDA,390,200,190,6,21,0,52,205,1,0,0,34,71,390,0,ITC,ITC2,2,Valle d'Aosta / Vallée d'Aoste,Valle d'Aosta,125666,15392,12.25,0.31
1931,2021-03-01,VDA,181,66,115,19,8,29,0,0,3,116,2,2,2,147,34,ITC,ITC2,2,Valle d'Aosta / Vallée d'Aoste,Valle d'Aosta,125666,15573,12.39,0.14
1932,2021-01-10,VDA,220,71,149,172,25,19,0,4,0,0,0,0,0,220,0,ITC,ITC2,2,Valle d'Aosta / Vallée d'Aoste,Valle d'Aosta,125666,15793,12.57,0.18
1933,2021-03-03,VDA,255,118,137,9,11,1,4,4,9,208,6,1,2,186,69,ITC,ITC2,2,Valle d'Aosta / Vallée d'Aoste,Valle d'Aosta,125666,16048,12.77,0.2
1934,2021-01-06,VDA,65,33,32,29,8,18,0,7,3,0,0,0,0,65,0,ITC,ITC2,2,Valle d'Aosta / Vallée d'Aoste,Valle d'Aosta,125666,16113,12.82,0.05
1935,2021-04-02,VDA,868,343,525,61,9,12,177,88,167,195,74,11,74,645,223,ITC,ITC2,2,Valle d'Aosta / Vallée d'Aoste,Valle d'Aosta,125666,16981,13.51,0.69
1936,2021-03-12,VDA,529,175,354,14,8,7,255,44,21,148,8,2,22,303,226,ITC,ITC2,2,Valle d'Aosta / Vallée d'Aoste,Valle d'Aosta,125666,17510,13.93,0.42
1937,2021-01-12,VDA,302,72,230,242,34,11,0,14,1,0,0,0,0,302,0,ITC,ITC2,2,Valle d'Aosta / Vallée d'Aoste,Valle d'Aosta,125666,17812,14.17,0.24
1938,2021-03-16,VDA,176,36,140,2,0,13,0,15,14,119,0,0,13,115,61,ITC,ITC2,2,Valle d'Aosta / Vallée d'Aoste,Valle d'Aosta,125666,17988,14.31,0.14
1939,2021-04-04,VDA,569,251,318,1,8,0,94,270,155,22,5,4,10,568,1,ITC,ITC2,2,Valle d'Aosta / Vallée d'Aoste,Valle d'Aosta,125666,18557,14.77,0.45
1940,2021-02-11,VDA,231,107,124,53,21,0,0,2,10,128,1,13,3,222,9,ITC,ITC2,2,Valle d'Aosta / Vallée d'Aoste,Valle d'Aosta,125666,18788,14.95,0.18
1941,2021-03-26,VDA,494,203,291,4,2,0,226,54,78,99,3,3,25,487,7,ITC,ITC2,2,Valle d'Aosta / Vallée d'Aoste,Valle d'Aosta,125666,19282,15.34,0.39
1942,2021-01-15,VDA,218,82,136,116,32,28,0,18,17,6,0,0,1,218,0,ITC,ITC2,2,Valle d'Aosta / Vallée d'Aoste,Valle d'Aosta,125666,19500,15.52,0.17
1943,2021-03-24,VDA,512,230,282,8,5,0,1,16,34,420,18,3,7,257,255,ITC,ITC2,2,Valle d'Aosta / Vallée d'Aoste,Valle d'Aosta,125666,20012,15.92,0.41
1944,2020-12-27,VDA,20,9,11,20,0,0,0,0,0,0,0,0,0,20,0,ITC,ITC2,2,Valle d'Aosta / Vallée d'Aoste,Valle d'Aosta,125666,20032,15.94,0.02
1945,2021-04-01,VDA,770,391,379,1,1,0,0,205,303,200,53,0,7,759,11,ITC,ITC2,2,Valle d'Aosta / Vallée d'Aoste,Valle d'Aosta,125666,20802,16.55,0.61
1946,2021-02-08,VDA,223,83,140,28,19,3,25,82,0,64,0,0,2,25,198,ITC,ITC2,2,Valle d'Aosta / Vallée d'Aoste,Valle d'Aosta,125666,21025,16.73,0.18
1947,2021-02-02,VDA,271,70,201,225,34,3,0,8,1,0,0,0,0,2,269,ITC,ITC2,2,Valle d'Aosta / Vallée d'Aoste,Valle d'Aosta,125666,21296,16.95,0.22
1948,2021-03-23,VDA,375,149,226,13,2,7,7,37,18,279,0,9,3,242,133,ITC,ITC2,2,Valle d'Aosta / Vallée d'Aoste,Valle d'Aosta,125666,21671,17.24,0.3
1949,2021-04-07,VDA,904,472,432,15,0,0,1,84,270,390,91,0,53,676,228,ITC,ITC2,2,Valle d'Aosta / Vallée d'Aoste,Valle d'Aosta,125666,22575,17.96,0.72
1950,2021-03-22,VDA,557,204,353,36,5,18,17,54,37,340,29,11,10,331,226,ITC,ITC2,2,Valle d'Aosta / Vallée d'Aoste,Valle d'Aosta,125666,23132,18.41,0.44
1951,2021-02-10,VDA,248,77,171,51,14,26,18,4,3,128,0,1,3,141,107,ITC,ITC2,2,Valle d'Aosta / Vallée d'Aoste,Valle d'Aosta,125666,23380,18.6,0.2
1952,2021-01-17,VDA,131,56,75,49,2,20,0,1,0,59,0,0,0,131,0,ITC,ITC2,2,Valle d'Aosta / Vallée d'Aoste,Valle d'Aosta,125666,23511,18.71,0.1
1953,2021-02-15,VDA,264,136,128,24,2,25,2,0,6,173,2,29,1,229,35,ITC,ITC2,2,Valle d'Aosta / Vallée d'Aoste,Valle d'Aosta,125666,23775,18.92,0.21
1954,2021-03-28,VDA,520,212,308,51,10,0,46,168,99,53,18,55,20,519,1,ITC,ITC2,2,Valle d'Aosta / Vallée d'Aoste,Valle d'Aosta,125666,24295,19.33,0.41
1955,2021-03-19,VDA,319,84,235,8,1,21,209,42,1,9,0,1,27,284,35,ITC,ITC2,2,Valle d'Aosta / Vallée d'Aoste,Valle d'Aosta,125666,24614,19.59,0.25
1956,2021-01-28,VDA,290,123,167,202,35,6,0,12,7,2,0,0,26,56,234,ITC,ITC2,2,Valle d'Aosta / Vallée d'Aoste,Valle d'Aosta,125666,24904,19.82,0.23
1957,2021-04-13,VDA,371,171,200,2,1,8,0,69,108,120,54,0,9,327,44,ITC,ITC2,2,Valle d'Aosta / Vallée d'Aoste,Valle d'Aosta,125666,25275,20.11,0.3
1958,2021-01-27,VDA,151,71,80,55,8,18,0,10,3,53,0,0,4,79,72,ITC,ITC2,2,Valle d'Aosta / Vallée d'Aoste,Valle d'Aosta,125666,25426,20.23,0.12
1959,2021-03-09,VDA,204,96,108,2,0,23,25,56,5,36,0,39,18,172,32,ITC,ITC2,2,Valle d'Aosta / Vallée d'Aoste,Valle d'Aosta,125666,25630,20.4,0.16
1960,2021-02-13,VDA,215,195,20,0,0,0,0,0,0,0,0,215,0,215,0,ITC,ITC2,2,Valle d'Aosta / Vallée d'Aoste,Valle d'Aosta,125666,25845,20.57,0.17
1961,2021-01-19,VDA,256,77,179,160,10,15,0,10,3,57,0,0,1,256,0,ITC,ITC2,2,Valle d'Aosta / Vallée d'Aoste,Valle d'Aosta,125666,26101,20.77,0.2
1962,2021-02-14,VDA,48,16,32,6,0,42,0,0,0,0,0,0,0,1,47,ITC,ITC2,2,Valle d'Aosta / Vallée d'Aoste,Valle d'Aosta,125666,26149,20.81,0.04
1963,2021-01-26,VDA,139,48,91,115,11,12,0,0,1,0,0,0,0,0,139,ITC,ITC2,2,Valle d'Aosta / Vallée d'Aoste,Valle d'Aosta,125666,26288,20.92,0.11
1964,2021-02-12,VDA,263,96,167,51,13,28,5,2,10,133,18,0,3,217,46,ITC,ITC2,2,Valle d'Aosta / Vallée d'Aoste,Valle d'Aosta,125666,26551,21.13,0.21
1965,2021-02-03,VDA,351,114,237,157,136,52,0,4,1,1,0,0,0,14,337,ITC,ITC2,2,Valle d'Aosta / Vallée d'Aoste,Valle d'Aosta,125666,26902,21.41,0.28
1966,2021-01-25,VDA,147,65,82,125,13,6,0,3,0,0,0,0,0,0,147,ITC,ITC2,2,Valle d'Aosta / Vallée d'Aoste,Valle d'Aosta,125666,27049,21.52,0.12
1967,2021-04-12,VDA,479,181,298,8,8,22,2,88,60,227,61,0,3,319,160,ITC,ITC2,2,Valle d'Aosta / Vallée d'Aoste,Valle d'Aosta,125666,27528,21.91,0.38
1968,2021-02-01,VDA,403,127,276,268,56,70,0,2,2,3,0,0,2,87,316,ITC,ITC2,2,Valle d'Aosta / Vallée d'Aoste,Valle d'Aosta,125666,27931,22.23,0.32
1969,2021-03-31,VDA,550,300,250,6,0,0,0,22,307,202,6,0,7,525,25,ITC,ITC2,2,Valle d'Aosta / Vallée d'Aoste,Valle d'Aosta,125666,28481,22.66,0.44
1970,2021-01-07,VDA,275,111,164,224,38,5,0,3,2,0,0,0,3,275,0,ITC,ITC2,2,Valle d'Aosta / Vallée d'Aoste,Valle d'Aosta,125666,28756,22.88,0.22
1971,2021-03-08,VDA,481,231,250,28,1,13,1,6,25,365,7,28,7,237,244,ITC,ITC2,2,Valle d'Aosta / Vallée d'Aoste,Valle d'Aosta,125666,29237,23.27,0.38
1972,2021-03-30,VDA,399,221,178,9,2,5,5,32,180,124,27,9,6,380,19,ITC,ITC2,2,Valle d'Aosta / Vallée d'Aoste,Valle d'Aosta,125666,29636,23.58,0.32
1973,2021-04-18,VDA,513,251,262,9,6,3,4,202,82,12,182,0,13,509,4,ITC,ITC2,2,Valle d'Aosta / Vallée d'Aoste,Valle d'Aosta,125666,30149,23.99,0.41
1974,2021-03-05,VDA,275,124,151,51,10,13,5,4,10,138,18,0,26,53,222,ITC,ITC2,2,Valle d'Aosta / Vallée d'Aoste,Valle d'Aosta,125666,30424,24.21,0.22
1975,2021-01-16,VDA,236,80,156,127,32,22,0,2,2,51,0,0,0,236,0,ITC,ITC2,2,Valle d'Aosta / Vallée d'Aoste,Valle d'Aosta,125666,30660,24.4,0.19
1976,2021-04-06,VDA,739,379,360,24,4,1,0,55,192,239,158,14,52,627,112,ITC,ITC2,2,Valle d'Aosta / Vallée d'Aoste,Valle d'Aosta,125666,31399,24.99,0.59
1977,2021-02-04,VDA,294,86,208,168,76,34,0,12,3,1,0,0,0,8,286,ITC,ITC2,2,Valle d'Aosta / Vallée d'Aoste,Valle d'Aosta,125666,31693,25.22,0.23
1978,2021-02-28,VDA,260,86,174,78,36,24,4,7,10,94,0,3,4,77,183,ITC,ITC2,2,Valle d'Aosta / Vallée d'Aoste,Valle d'Aosta,125666,31953,25.43,0.21
1979,2021-03-21,VDA,353,164,189,2,5,0,28,208,57,1,0,27,25,353,0,ITC,ITC2,2,Valle d'Aosta / Vallée d'Aoste,Valle d'Aosta,125666,32306,25.71,0.28
1980,2021-01-31,VDA,290,90,200,231,33,18,0,5,0,0,0,0,3,58,232,ITC,ITC2,2,Valle d'Aosta / Vallée d'Aoste,Valle d'Aosta,125666,32596,25.94,0.23
1981,2021-04-05,VDA,458,221,237,18,3,0,34,186,117,8,84,0,8,455,3,ITC,ITC2,2,Valle d'Aosta / Vallée d'Aoste,Valle d'Aosta,125666,33054,26.3,0.36
1982,2021-02-18,VDA,349,153,196,61,9,45,8,6,17,184,0,16,3,261,88,ITC,ITC2,2,Valle d'Aosta / Vallée d'Aoste,Valle d'Aosta,125666,33403,26.58,0.28
1983,2021-02-19,VDA,292,102,190,17,1,35,65,3,16,154,0,0,1,268,24,ITC,ITC2,2,Valle d'Aosta / Vallée d'Aoste,Valle d'Aosta,125666,33695,26.81,0.23
1984,2021-01-04,VDA,142,59,83,126,14,0,0,2,0,0,0,0,0,142,0,ITC,ITC2,2,Valle d'Aosta / Vallée d'Aoste,Valle d'Aosta,125666,33837,26.93,0.11
1985,2021-02-25,VDA,201,101,100,6,4,12,2,84,1,0,0,27,65,194,7,ITC,ITC2,2,Valle d'Aosta / Vallée d'Aoste,Valle d'Aosta,125666,34038,27.09,0.16
1986,2021-04-03,VDA,673,339,334,13,11,4,1,117,333,58,69,5,62,658,15,ITC,ITC2,2,Valle d'Aosta / Vallée d'Aoste,Valle d'Aosta,125666,34711,27.62,0.54
1987,2021-04-14,CAL,8002,3870,4132,172,185,141,175,208,1539,1570,3825,74,113,6536,1466,ITF,ITF6,18,Calabria,Calabria,1947131,8002,0.41,0.41
1988,2021-01-30,CAL,2173,1147,1026,1974,189,0,0,3,0,1,0,0,6,358,1815,ITF,ITF6,18,Calabria,Calabria,1947131,10175,0.52,0.11
1989,2021-01-12,CAL,2058,1017,1041,1706,237,29,0,21,1,19,0,0,45,2058,0,ITF,ITF6,18,Calabria,Calabria,1947131,12233,0.63,0.11
1990,2021-04-02,CAL,8078,3689,4389,361,135,605,1154,115,177,2800,2246,198,287,4215,3863,ITF,ITF6,18,Calabria,Calabria,1947131,20311,1.04,0.41
1991,2021-04-04,CAL,1735,875,860,34,23,22,67,249,265,504,516,2,53,1236,499,ITF,ITF6,18,Calabria,Calabria,1947131,22046,1.13,0.09
1992,2021-02-25,CAL,2821,1519,1302,736,228,235,4,41,15,971,36,425,130,2242,579,ITF,ITF6,18,Calabria,Calabria,1947131,24867,1.28,0.14
1993,2021-02-11,CAL,2341,1043,1298,1464,372,241,0,25,18,156,0,0,65,1081,1260,ITF,ITF6,18,Calabria,Calabria,1947131,27208,1.4,0.12
1994,2021-03-07,CAL,3131,1561,1570,105,33,348,2,10,31,1741,474,363,24,3042,89,ITF,ITF6,18,Calabria,Calabria,1947131,30339,1.56,0.16
1995,2021-03-16,CAL,3777,1850,1927,460,203,22,30,49,79,2137,594,68,135,2179,1598,ITF,ITF6,18,Calabria,Calabria,1947131,34116,1.75,0.19
1996,2020-12-27,CAL,275,150,125,274,1,0,0,0,0,0,0,0,0,275,0,ITF,ITF6,18,Calabria,Calabria,1947131,34391,1.77,0.01
1997,2021-03-18,CAL,4246,1979,2267,360,210,232,45,65,114,2311,753,60,96,2277,1969,ITF,ITF6,18,Calabria,Calabria,1947131,38637,1.98,0.22
1998,2021-03-19,CAL,4186,1947,2239,486,121,295,102,64,114,2010,883,12,99,1900,2286,ITF,ITF6,18,Calabria,Calabria,1947131,42823,2.2,0.21
1999,2021-03-08,CAL,5323,2822,2501,708,245,453,3,49,65,1553,1138,849,260,4265,1058,ITF,ITF6,18,Calabria,Calabria,1947131,48146,2.47,0.27
2000,2021-01-29,CAL,2048,984,1064,1752,231,49,0,3,3,1,0,0,9,234,1814,ITF,ITF6,18,Calabria,Calabria,1947131,50194,2.58,0.11
2001,2021-01-27,CAL,1457,734,723,1226,201,23,0,4,0,0,0,0,3,396,1061,ITF,ITF6,18,Calabria,Calabria,1947131,51651,2.65,0.07
2002,2021-03-31,CAL,8824,4006,4818,378,283,653,2052,145,193,2693,1987,118,322,4884,3940,ITF,ITF6,18,Calabria,Calabria,1947131,60475,3.11,0.45
2003,2021-02-08,CAL,1847,733,1114,1214,406,121,0,14,1,0,0,0,91,661,1186,ITF,ITF6,18,Calabria,Calabria,1947131,62322,3.2,0.09
2004,2021-03-20,CAL,6482,2982,3500,432,100,408,466,72,124,3574,1022,74,210,4094,2388,ITF,ITF6,18,Calabria,Calabria,1947131,68804,3.53,0.33
2005,2021-02-24,CAL,1843,940,903,658,108,115,4,15,10,754,84,47,48,1368,475,ITF,ITF6,18,Calabria,Calabria,1947131,70647,3.63,0.09
2006,2021-01-22,CAL,656,274,382,298,146,110,0,37,29,4,0,0,32,654,2,ITF,ITF6,18,Calabria,Calabria,1947131,71303,3.66,0.03
2007,2021-01-09,CAL,1916,1036,880,1529,315,0,0,26,2,1,0,0,43,1916,0,ITF,ITF6,18,Calabria,Calabria,1947131,73219,3.76,0.1
2008,2021-01-21,CAL,958,444,514,735,82,115,0,4,2,0,0,0,20,929,29,ITF,ITF6,18,Calabria,Calabria,1947131,74177,3.81,0.05
2009,2021-03-14,CAL,2543,1018,1525,322,103,312,722,15,30,811,128,30,70,2143,400,ITF,ITF6,18,Calabria,Calabria,1947131,76720,3.94,0.13
2010,2021-04-11,CAL,4082,1860,2222,136,49,51,167,59,209,1725,1618,12,56,2142,1940,ITF,ITF6,18,Calabria,Calabria,1947131,80802,4.15,0.21
2011,2021-03-05,CAL,6171,3565,2606,696,257,711,5,46,61,2014,879,1405,97,5595,576,ITF,ITF6,18,Calabria,Calabria,1947131,86973,4.47,0.32
2012,2021-04-18,CAL,5767,2757,3010,148,89,102,79,130,1432,1201,2527,12,47,4888,879,ITF,ITF6,18,Calabria,Calabria,1947131,92740,4.76,0.3
2013,2021-02-28,CAL,2168,983,1185,113,39,190,0,10,24,1707,28,6,51,2017,151,ITF,ITF6,18,Calabria,Calabria,1947131,94908,4.87,0.11
2014,2021-02-09,CAL,2147,904,1243,1422,394,231,0,20,5,0,0,0,75,948,1199,ITF,ITF6,18,Calabria,Calabria,1947131,97055,4.98,0.11
2015,2021-02-06,CAL,2910,1338,1572,2095,368,248,0,45,9,10,0,0,135,442,2468,ITF,ITF6,18,Calabria,Calabria,1947131,99965,5.13,0.15
2016,2021-02-05,CAL,3796,1709,2087,2327,745,554,0,41,8,3,0,0,118,488,3308,ITF,ITF6,18,Calabria,Calabria,1947131,103761,5.33,0.19
2017,2021-03-03,CAL,4871,2655,2216,631,351,917,4,38,43,1408,462,935,82,3808,1063,ITF,ITF6,18,Calabria,Calabria,1947131,108632,5.58,0.25
2018,2021-04-06,CAL,7202,3230,3972,376,163,453,804,103,241,2457,2365,51,189,4134,3068,ITF,ITF6,18,Calabria,Calabria,1947131,115834,5.95,0.37
2019,2021-02-04,CAL,3391,1623,1768,2560,505,222,0,23,6,7,0,0,68,644,2747,ITF,ITF6,18,Calabria,Calabria,1947131,119225,6.12,0.17
2020,2021-04-17,CAL,10601,4975,5626,211,137,218,118,301,2655,2145,4523,98,195,8921,1680,ITF,ITF6,18,Calabria,Calabria,1947131,129826,6.67,0.54
2021,2021-01-17,CAL,867,418,449,527,121,48,0,17,4,33,0,0,117,801,66,ITF,ITF6,18,Calabria,Calabria,1947131,130693,6.71,0.04
2022,2021-04-16,CAL,10131,4955,5176,332,213,288,233,254,2333,1094,5020,133,231,8532,1599,ITF,ITF6,18,Calabria,Calabria,1947131,140824,7.23,0.52
2023,2021-02-27,CAL,3680,1913,1767,421,193,396,2,24,41,2075,96,348,84,3302,378,ITF,ITF6,18,Calabria,Calabria,1947131,144504,7.42,0.19
2024,2021-03-04,CAL,5389,3111,2278,646,252,744,2,63,46,1636,630,1237,133,4593,796,ITF,ITF6,18,Calabria,Calabria,1947131,149893,7.7,0.28
2025,2021-01-31,CAL,1108,554,554,765,282,58,0,1,0,0,0,0,2,155,953,ITF,ITF6,18,Calabria,Calabria,1947131,151001,7.76,0.06
2026,2021-03-28,CAL,2535,1172,1363,127,109,31,412,74,67,785,739,15,176,1405,1130,ITF,ITF6,18,Calabria,Calabria,1947131,153536,7.89,0.13
2027,2021-02-13,CAL,1331,583,748,731,144,111,0,31,9,167,0,0,138,968,363,ITF,ITF6,18,Calabria,Calabria,1947131,154867,7.95,0.07
2028,2021-02-18,CAL,1801,804,997,586,369,299,61,7,6,388,11,0,74,1578,223,ITF,ITF6,18,Calabria,Calabria,1947131,156668,8.05,0.09
2029,2021-01-25,CAL,1065,512,553,1022,35,0,0,0,1,0,0,0,7,156,909,ITF,ITF6,18,Calabria,Calabria,1947131,157733,8.1,0.05
2030,2021-03-10,CAL,6445,3280,3165,743,516,586,64,79,53,2233,1023,797,351,5252,1193,ITF,ITF6,18,Calabria,Calabria,1947131,164178,8.43,0.33
2031,2021-04-15,CAL,7392,3624,3768,160,153,162,199,144,1667,1063,3694,34,116,5788,1604,ITF,ITF6,18,Calabria,Calabria,1947131,171570,8.81,0.38
2032,2021-02-19,CAL,1461,652,809,544,208,195,0,9,9,422,57,1,16,1200,261,ITF,ITF6,18,Calabria,Calabria,1947131,173031,8.89,0.08
2033,2021-04-12,CAL,6694,3262,3432,219,136,276,104,105,858,1435,3432,37,92,5092,1602,ITF,ITF6,18,Calabria,Calabria,1947131,179725,9.23,0.34
2034,2021-02-12,CAL,1711,669,1042,815,300,136,0,64,32,210,0,0,154,943,768,ITF,ITF6,18,Calabria,Calabria,1947131,181436,9.32,0.09
2035,2021-01-11,CAL,2154,1040,1114,1759,301,3,0,17,4,39,0,0,31,2154,0,ITF,ITF6,18,Calabria,Calabria,1947131,183590,9.43,0.11
2036,2021-03-02,CAL,4136,2395,1741,705,202,430,2,26,24,1451,222,1002,72,3427,709,ITF,ITF6,18,Calabria,Calabria,1947131,187726,9.64,0.21
2037,2021-01-04,CAL,997,492,505,969,28,0,0,0,0,0,0,0,0,997,0,ITF,ITF6,18,Calabria,Calabria,1947131,188723,9.69,0.05
2038,2021-04-09,CAL,7819,3664,4155,342,138,470,306,151,506,2172,3494,31,209,4906,2913,ITF,ITF6,18,Calabria,Calabria,1947131,196542,10.09,0.4
2039,2021-03-15,CAL,3508,1675,1833,542,166,140,587,56,81,1183,431,177,145,2079,1429,ITF,ITF6,18,Calabria,Calabria,1947131,200050,10.27,0.18
2040,2021-02-02,CAL,2289,1112,1177,1863,341,75,0,1,1,1,0,0,7,177,2112,ITF,ITF6,18,Calabria,Calabria,1947131,202339,10.39,0.12
2041,2021-01-14,CAL,2557,1214,1343,1962,349,3,0,61,24,47,0,0,111,2557,0,ITF,ITF6,18,Calabria,Calabria,1947131,204896,10.52,0.13
2042,2021-04-05,CAL,3445,1627,1818,133,22,149,134,286,439,1181,1029,18,54,2544,901,ITF,ITF6,18,Calabria,Calabria,1947131,208341,10.7,0.18
2043,2021-01-10,CAL,929,524,405,830,99,0,0,0,0,0,0,0,0,929,0,ITF,ITF6,18,Calabria,Calabria,1947131,209270,10.75,0.05
2044,2021-02-07,CAL,860,428,432,567,121,81,0,10,0,0,0,0,81,147,713,ITF,ITF6,18,Calabria,Calabria,1947131,210130,10.79,0.04
2045,2021-01-23,CAL,400,186,214,325,25,23,0,2,0,1,0,0,24,358,42,ITF,ITF6,18,Calabria,Calabria,1947131,210530,10.81,0.02
2046,2021-03-25,CAL,7001,3315,3686,291,362,564,1100,112,124,2270,1839,80,259,4484,2517,ITF,ITF6,18,Calabria,Calabria,1947131,217531,11.17,0.36
2047,2021-02-10,CAL,2463,1074,1389,1469,340,357,0,56,25,72,0,0,144,839,1624,ITF,ITF6,18,Calabria,Calabria,1947131,219994,11.3,0.13
2048,2021-02-15,CAL,1137,538,599,499,121,164,1,11,20,294,4,0,23,989,148,ITF,ITF6,18,Calabria,Calabria,1947131,221131,11.36,0.06
2049,2021-02-03,CAL,2763,1428,1335,2170,393,103,0,18,4,2,0,0,73,583,2180,ITF,ITF6,18,Calabria,Calabria,1947131,223894,11.5,0.14
2050,2021-01-13,CAL,2028,1022,1006,1800,152,34,0,14,4,4,0,0,20,2028,0,ITF,ITF6,18,Calabria,Calabria,1947131,225922,11.6,0.1
2051,2021-03-13,CAL,6657,2933,3724,425,156,340,685,95,43,3805,749,123,236,5683,974,ITF,ITF6,18,Calabria,Calabria,1947131,232579,11.94,0.34
2052,2021-01-19,CAL,1109,488,621,853,105,76,0,11,11,14,0,0,39,1098,11,ITF,ITF6,18,Calabria,Calabria,1947131,233688,12.0,0.06
2053,2021-03-01,CAL,2689,1534,1155,399,156,258,3,10,11,1053,71,656,72,2239,450,ITF,ITF6,18,Calabria,Calabria,1947131,236377,12.14,0.14
2054,2021-02-17,CAL,1682,672,1010,674,239,285,81,7,6,354,2,0,34,1471,211,ITF,ITF6,18,Calabria,Calabria,1947131,238059,12.23,0.09
2055,2021-04-03,CAL,8822,3789,5033,363,123,358,622,88,214,4980,1904,57,113,4203,4619,ITF,ITF6,18,Calabria,Calabria,1947131,246881,12.68,0.45
2056,2021-01-06,CAL,926,500,426,822,90,0,0,5,0,0,0,0,9,926,0,ITF,ITF6,18,Calabria,Calabria,1947131,247807,12.73,0.05
2057,2021-02-16,CAL,1534,643,891,659,191,265,0,14,23,334,1,0,47,1255,279,ITF,ITF6,18,Calabria,Calabria,1947131,249341,12.81,0.08
2058,2021-02-21,CAL,608,286,322,36,46,48,0,2,2,374,28,30,42,531,77,ITF,ITF6,18,Calabria,Calabria,1947131,249949,12.84,0.03
2059,2021-03-29,CAL,5629,2381,3248,206,320,134,1580,134,161,1126,1670,71,227,3876,1753,ITF,ITF6,18,Calabria,Calabria,1947131,255578,13.13,0.29
2060,2021-03-09,CAL,5824,3032,2792,803,267,461,18,65,71,1925,1123,933,158,4847,977,ITF,ITF6,18,Calabria,Calabria,1947131,261402,13.42,0.3
2061,2021-03-12,CAL,5093,2438,2655,468,397,220,786,61,38,2148,412,403,160,4050,1043,ITF,ITF6,18,Calabria,Calabria,1947131,266495,13.69,0.26
2062,2021-02-20,CAL,1358,735,623,438,185,55,2,13,5,490,54,19,97,1043,315,ITF,ITF6,18,Calabria,Calabria,1947131,267853,13.76,0.07
2063,2021-02-01,CAL,2497,1192,1305,2044,359,43,0,14,2,1,0,0,34,248,2249,ITF,ITF6,18,Calabria,Calabria,1947131,270350,13.88,0.13
2064,2021-01-07,CAL,2180,1061,1119,1883,211,0,0,20,4,0,0,0,62,2180,0,ITF,ITF6,18,Calabria,Calabria,1947131,272530,14.0,0.11
2065,2021-03-21,CAL,4364,1883,2481,135,38,200,745,79,92,2129,694,83,169,2662,1702,ITF,ITF6,18,Calabria,Calabria,1947131,276894,14.22,0.22
2066,2021-02-23,CAL,1549,728,821,437,177,206,1,13,10,583,63,2,57,1434,115,ITF,ITF6,18,Calabria,Calabria,1947131,278443,14.3,0.08
2067,2021-01-18,CAL,1230,550,680,982,138,11,0,24,3,6,0,0,66,1040,190,ITF,ITF6,18,Calabria,Calabria,1947131,279673,14.36,0.06
2068,2021-03-06,CAL,7954,4060,3894,702,225,760,6,41,97,4059,1133,840,91,7198,756,ITF,ITF6,18,Calabria,Calabria,1947131,287627,14.77,0.41
2069,2021-01-28,CAL,2232,1107,1125,1920,284,0,0,2,1,0,0,0,25,84,2148,ITF,ITF6,18,Calabria,Calabria,1947131,289859,14.89,0.11
2070,2021-04-07,CAL,6177,2798,3379,193,70,399,539,109,179,2096,2430,32,130,3629,2548,ITF,ITF6,18,Calabria,Calabria,1947131,296036,15.2,0.32
2071,2021-03-17,CAL,3637,1623,2014,277,148,165,94,38,81,2179,582,31,42,1939,1698,ITF,ITF6,18,Calabria,Calabria,1947131,299673,15.39,0.19
2072,2021-02-26,CAL,3079,1631,1448,539,193,407,4,21,18,1362,84,370,81,2611,468,ITF,ITF6,18,Calabria,Calabria,1947131,302752,15.55,0.16
2073,2021-02-14,CAL,371,145,226,146,31,83,0,2,2,95,0,0,12,341,30,ITF,ITF6,18,Calabria,Calabria,1947131,303123,15.57,0.02
2074,2021-03-27,CAL,8292,3763,4529,306,389,148,1400,125,179,3391,1869,66,419,4458,3834,ITF,ITF6,18,Calabria,Calabria,1947131,311415,15.99,0.43
2075,2021-01-08,CAL,2109,1014,1095,1898,200,0,0,3,0,0,0,0,8,2109,0,ITF,ITF6,18,Calabria,Calabria,1947131,313524,16.1,0.11
2076,2021-01-26,CAL,1805,861,944,1571,149,70,0,1,0,0,0,0,14,285,1520,ITF,ITF6,18,Calabria,Calabria,1947131,315329,16.19,0.09
2077,2021-01-03,CAL,6,3,3,4,2,0,0,0,0,0,0,0,0,6,0,ITF,ITF6,18,Calabria,Calabria,1947131,315335,16.19,0.0
2078,2021-04-13,CAL,6489,3197,3292,245,92,40,106,103,1275,1273,3084,153,118,5231,1258,ITF,ITF6,18,Calabria,Calabria,1947131,321824,16.53,0.33
2079,2021-03-26,CAL,7644,3625,4019,511,371,217,1039,151,231,2561,2057,135,371,4531,3113,ITF,ITF6,18,Calabria,Calabria,1947131,329468,16.92,0.39
2080,2021-01-02,CAL,165,94,71,165,0,0,0,0,0,0,0,0,0,165,0,ITF,ITF6,18,Calabria,Calabria,1947131,329633,16.93,0.01
2081,2021-01-24,CAL,44,18,26,15,3,26,0,0,0,0,0,0,0,39,5,ITF,ITF6,18,Calabria,Calabria,1947131,329677,16.93,0.0
2082,2020-12-28,CAL,6,2,4,6,0,0,0,0,0,0,0,0,0,6,0,ITF,ITF6,18,Calabria,Calabria,1947131,329683,16.93,0.0
2083,2021-04-01,CAL,8350,3772,4578,455,247,680,1116,122,218,3069,1988,113,342,3848,4502,ITF,ITF6,18,Calabria,Calabria,1947131,338033,17.36,0.43
2084,2021-03-24,CAL,7366,3360,4006,386,289,699,1495,151,146,2584,1292,105,219,4190,3176,ITF,ITF6,18,Calabria,Calabria,1947131,345399,17.74,0.38
2085,2021-03-23,CAL,5207,2442,2765,280,145,55,1083,98,74,2046,1078,102,246,3409,1798,ITF,ITF6,18,Calabria,Calabria,1947131,350606,18.01,0.27
2086,2021-01-05,CAL,1350,618,732,1256,81,0,0,2,0,0,0,0,11,1350,0,ITF,ITF6,18,Calabria,Calabria,1947131,351956,18.08,0.07
2087,2021-01-16,CAL,2394,1120,1274,1664,264,241,0,49,12,9,0,0,155,2394,0,ITF,ITF6,18,Calabria,Calabria,1947131,354350,18.2,0.12
2088,2021-03-30,CAL,5788,2486,3302,166,103,210,1121,154,196,1991,1472,89,286,3195,2593,ITF,ITF6,18,Calabria,Calabria,1947131,360138,18.5,0.3
2089,2021-03-11,CAL,6877,3278,3599,934,474,574,600,122,88,2551,873,412,249,5621,1256,ITF,ITF6,18,Calabria,Calabria,1947131,367015,18.85,0.35
2090,2021-04-08,CAL,9373,4408,4965,451,178,537,304,216,581,3377,3456,44,229,5695,3678,ITF,ITF6,18,Calabria,Calabria,1947131,376388,19.33,0.48
2091,2021-04-10,CAL,11174,5032,6142,424,161,462,303,144,703,5598,3147,49,183,6343,4831,ITF,ITF6,18,Calabria,Calabria,1947131,387562,19.9,0.57
2092,2021-03-22,CAL,4708,2203,2505,194,125,148,1125,49,50,1994,804,77,142,3041,1667,ITF,ITF6,18,Calabria,Calabria,1947131,392270,20.15,0.24
2093,2021-01-15,CAL,2793,1258,1535,1690,349,412,0,54,19,44,0,0,225,2793,0,ITF,ITF6,18,Calabria,Calabria,1947131,395063,20.29,0.14
2094,2021-01-20,CAL,1395,622,773,864,127,179,0,41,14,25,0,0,145,1394,1,ITF,ITF6,18,Calabria,Calabria,1947131,396458,20.36,0.07
2095,2021-02-22,CAL,1997,1013,984,728,231,166,5,32,7,678,33,3,114,1441,556,ITF,ITF6,18,Calabria,Calabria,1947131,398455,20.46,0.1
2096,2021-04-19,CAL,2389,1088,1301,87,41,22,55,68,586,351,1132,20,27,1847,542,ITF,ITF6,18,Calabria,Calabria,1947131,400844,20.59,0.12
2097,2021-02-16,MAR,1292,475,817,737,434,92,0,3,2,0,0,0,24,1262,30,ITI,ITI3,11,Marche,Marche,1525271,1292,0.08,0.08
2098,2021-02-28,MAR,2841,1251,1590,19,6,0,2,2,3,2800,0,2,7,2835,6,ITI,ITI3,11,Marche,Marche,1525271,4133,0.27,0.19
2099,2021-03-25,MAR,6657,2774,3883,464,148,373,519,95,27,4383,258,122,268,3247,3410,ITI,ITI3,11,Marche,Marche,1525271,10790,0.71,0.44
2100,2021-01-23,MAR,557,190,367,440,53,63,0,0,0,0,0,0,1,123,434,ITI,ITI3,11,Marche,Marche,1525271,11347,0.74,0.04
2101,2021-03-22,MAR,5661,2378,3283,408,232,70,433,14,14,4183,19,238,50,2532,3129,ITI,ITI3,11,Marche,Marche,1525271,17008,1.12,0.37
2102,2021-02-21,MAR,377,142,235,204,62,57,1,11,1,0,0,0,41,376,1,ITI,ITI3,11,Marche,Marche,1525271,17385,1.14,0.02
2103,2021-03-29,MAR,5895,2586,3309,228,147,39,215,34,67,4279,730,75,81,3443,2452,ITI,ITI3,11,Marche,Marche,1525271,23280,1.53,0.39
2104,2021-03-09,MAR,5532,2375,3157,754,226,41,1070,20,4,2588,123,652,54,4643,889,ITI,ITI3,11,Marche,Marche,1525271,28812,1.89,0.36
2105,2021-01-02,MAR,453,139,314,444,9,0,0,0,0,0,0,0,0,453,0,ITI,ITI3,11,Marche,Marche,1525271,29265,1.92,0.03
2106,2021-02-15,MAR,973,413,560,544,390,1,0,4,1,1,12,0,20,960,13,ITI,ITI3,11,Marche,Marche,1525271,30238,1.98,0.06
2107,2021-02-03,MAR,2125,742,1383,1344,569,166,0,4,5,2,0,0,35,119,2006,ITI,ITI3,11,Marche,Marche,1525271,32363,2.12,0.14
2108,2021-01-15,MAR,1771,500,1271,985,357,366,0,9,3,0,0,0,51,1771,0,ITI,ITI3,11,Marche,Marche,1525271,34134,2.24,0.12
2109,2021-01-24,MAR,892,342,550,773,118,0,0,0,0,0,0,0,1,17,875,ITI,ITI3,11,Marche,Marche,1525271,35026,2.3,0.06
2110,2021-03-15,MAR,4513,2120,2393,300,81,11,242,38,8,3478,27,217,111,1423,3090,ITI,ITI3,11,Marche,Marche,1525271,39539,2.59,0.3
2111,2021-04-01,MAR,7593,3186,4407,390,239,46,284,37,157,4615,1682,70,73,4167,3426,ITI,ITI3,11,Marche,Marche,1525271,47132,3.09,0.5
2112,2021-01-03,MAR,896,348,548,759,130,0,0,1,0,0,0,0,6,896,0,ITI,ITI3,11,Marche,Marche,1525271,48028,3.15,0.06
2113,2021-01-04,MAR,1500,563,937,1290,194,11,0,1,0,0,0,0,4,1500,0,ITI,ITI3,11,Marche,Marche,1525271,49528,3.25,0.1
2114,2021-01-19,MAR,225,81,144,120,20,85,0,0,0,0,0,0,0,141,84,ITI,ITI3,11,Marche,Marche,1525271,49753,3.26,0.01
2115,2021-03-11,MAR,6832,2930,3902,1094,386,52,1148,25,9,3227,86,700,105,5461,1371,ITI,ITI3,11,Marche,Marche,1525271,56585,3.71,0.45
2116,2021-03-13,MAR,5877,2708,3169,664,168,58,237,26,10,4248,13,353,100,1916,3961,ITI,ITI3,11,Marche,Marche,1525271,62462,4.1,0.39
2117,2021-04-16,MAR,9996,4654,5342,319,142,76,513,228,3844,695,3949,21,209,9462,534,ITI,ITI3,11,Marche,Marche,1525271,72458,4.75,0.66
2118,2021-03-30,MAR,7445,3056,4389,524,321,276,367,44,113,4270,1385,80,65,4607,2838,ITI,ITI3,11,Marche,Marche,1525271,79903,5.24,0.49
2119,2021-01-13,MAR,2105,746,1359,1408,578,76,0,6,5,15,0,0,17,2105,0,ITI,ITI3,11,Marche,Marche,1525271,82008,5.38,0.14
2120,2021-02-06,MAR,2460,900,1560,1402,536,415,0,21,8,4,0,0,74,523,1937,ITI,ITI3,11,Marche,Marche,1525271,84468,5.54,0.16
2121,2021-02-05,MAR,2157,653,1504,1318,347,419,0,6,8,2,0,0,57,440,1717,ITI,ITI3,11,Marche,Marche,1525271,86625,5.68,0.14
2122,2021-04-19,MAR,6302,2930,3372,183,81,7,46,925,2697,789,1491,30,53,5069,1233,ITI,ITI3,11,Marche,Marche,1525271,92927,6.09,0.41
2123,2021-02-19,MAR,1971,716,1255,1273,405,203,2,7,4,2,13,0,62,1836,135,ITI,ITI3,11,Marche,Marche,1525271,94898,6.22,0.13
2124,2021-02-18,MAR,2104,746,1358,1150,501,402,1,14,4,1,0,0,31,1816,288,ITI,ITI3,11,Marche,Marche,1525271,97002,6.36,0.14
2125,2021-03-27,MAR,7419,3082,4337,278,170,144,711,77,107,4086,1535,133,178,5050,2369,ITI,ITI3,11,Marche,Marche,1525271,104421,6.85,0.49
2126,2021-01-31,MAR,1928,772,1156,1532,392,0,0,1,0,0,0,0,3,105,1823,ITI,ITI3,11,Marche,Marche,1525271,106349,6.97,0.13
2127,2021-01-14,MAR,2010,692,1318,1112,558,298,0,4,1,0,0,0,37,2010,0,ITI,ITI3,11,Marche,Marche,1525271,108359,7.1,0.13
2128,2021-02-10,MAR,1439,452,987,881,292,215,0,6,1,0,0,0,44,1080,359,ITI,ITI3,11,Marche,Marche,1525271,109798,7.2,0.09
2129,2021-04-17,MAR,11635,5275,6360,203,152,130,614,324,4107,921,5054,14,116,10560,1075,ITI,ITI3,11,Marche,Marche,1525271,121433,7.96,0.76
2130,2021-03-10,MAR,5783,2490,3293,721,411,114,1041,12,11,2675,100,652,46,4646,1137,ITI,ITI3,11,Marche,Marche,1525271,127216,8.34,0.38
2131,2021-01-18,MAR,673,230,443,370,116,132,0,5,8,30,0,0,12,547,126,ITI,ITI3,11,Marche,Marche,1525271,127889,8.38,0.04
2132,2020-12-30,MAR,17,5,12,14,3,0,0,0,0,0,0,0,0,17,0,ITI,ITI3,11,Marche,Marche,1525271,127906,8.39,0.0
2133,2021-02-24,MAR,3496,1518,1978,229,191,214,1,5,4,2823,22,3,4,3416,80,ITI,ITI3,11,Marche,Marche,1525271,131402,8.61,0.23
2134,2021-01-17,MAR,1598,682,916,964,366,46,0,50,30,4,0,0,138,1549,49,ITI,ITI3,11,Marche,Marche,1525271,133000,8.72,0.1
2135,2021-03-02,MAR,4966,1943,3023,589,184,259,538,12,3,3320,4,3,54,4400,566,ITI,ITI3,11,Marche,Marche,1525271,137966,9.05,0.33
2136,2021-02-20,MAR,4127,1708,2419,118,118,261,0,17,13,3581,0,3,16,4016,111,ITI,ITI3,11,Marche,Marche,1525271,142093,9.32,0.27
2137,2021-04-09,MAR,9618,4219,5399,270,72,103,1321,108,2334,1618,3629,70,93,9416,202,ITI,ITI3,11,Marche,Marche,1525271,151711,9.95,0.63
2138,2021-03-20,MAR,4146,1745,2401,181,63,114,89,10,4,3641,14,12,18,1054,3092,ITI,ITI3,11,Marche,Marche,1525271,155857,10.22,0.27
2139,2021-04-05,MAR,5693,2357,3336,253,84,103,758,54,1005,2268,1109,28,31,4424,1269,ITI,ITI3,11,Marche,Marche,1525271,161550,10.59,0.37
2140,2021-04-11,MAR,7134,3123,4011,282,97,10,783,47,2167,1233,2451,44,20,6848,286,ITI,ITI3,11,Marche,Marche,1525271,168684,11.06,0.47
2141,2021-03-28,MAR,4134,1744,2390,45,45,6,396,17,32,2667,873,11,42,2439,1695,ITI,ITI3,11,Marche,Marche,1525271,172818,11.33,0.27
2142,2021-01-09,MAR,1709,605,1104,1406,238,0,0,17,2,0,0,0,46,1709,0,ITI,ITI3,11,Marche,Marche,1525271,174527,11.44,0.11
2143,2021-04-12,MAR,8579,3779,4800,179,82,88,1157,107,2845,1315,2609,79,118,8092,487,ITI,ITI3,11,Marche,Marche,1525271,183106,12.0,0.56
2144,2021-01-25,MAR,1596,559,1037,1426,110,56,0,0,0,2,0,0,2,97,1499,ITI,ITI3,11,Marche,Marche,1525271,184702,12.11,0.1
2145,2021-01-07,MAR,1802,633,1169,1480,279,0,0,8,0,0,0,0,35,1802,0,ITI,ITI3,11,Marche,Marche,1525271,186504,12.23,0.12
2146,2021-03-19,MAR,3869,1604,2265,495,135,293,6,5,7,2837,63,13,15,343,3526,ITI,ITI3,11,Marche,Marche,1525271,190373,12.48,0.25
2147,2021-02-12,MAR,1583,618,965,815,423,88,0,32,14,3,0,0,208,1431,152,ITI,ITI3,11,Marche,Marche,1525271,191956,12.59,0.1
2148,2021-02-04,MAR,2342,810,1532,1406,602,275,0,11,3,1,0,0,44,112,2230,ITI,ITI3,11,Marche,Marche,1525271,194298,12.74,0.15
2149,2021-04-06,MAR,8883,3696,5187,310,185,161,1728,97,1740,1888,2580,98,96,8068,815,ITI,ITI3,11,Marche,Marche,1525271,203181,13.32,0.58
2150,2021-01-22,MAR,487,167,320,315,74,87,0,1,0,0,0,0,10,194,293,ITI,ITI3,11,Marche,Marche,1525271,203668,13.35,0.03
2151,2021-03-14,MAR,2517,1036,1481,442,58,1,456,4,3,1537,5,2,9,1919,598,ITI,ITI3,11,Marche,Marche,1525271,206185,13.52,0.17
2152,2021-03-05,MAR,6292,2955,3337,1128,324,144,803,52,27,2389,185,1114,126,4825,1467,ITI,ITI3,11,Marche,Marche,1525271,212477,13.93,0.41
2153,2021-02-09,MAR,125,42,83,78,21,26,0,0,0,0,0,0,0,47,78,ITI,ITI3,11,Marche,Marche,1525271,212602,13.94,0.01
2154,2021-03-01,MAR,3727,1489,2238,387,138,87,286,4,1,2793,4,5,22,3480,247,ITI,ITI3,11,Marche,Marche,1525271,216329,14.18,0.24
2155,2021-03-03,MAR,6761,3094,3667,818,374,256,783,36,12,3134,195,1055,98,5880,881,ITI,ITI3,11,Marche,Marche,1525271,223090,14.63,0.44
2156,2021-02-27,MAR,3374,1440,1934,186,142,161,1,6,1,2848,17,6,6,3165,209,ITI,ITI3,11,Marche,Marche,1525271,226464,14.85,0.22
2157,2021-01-06,MAR,2181,792,1389,1738,261,147,0,5,1,0,0,0,29,2181,0,ITI,ITI3,11,Marche,Marche,1525271,228645,14.99,0.14
2158,2021-02-23,MAR,3274,1400,1874,219,57,118,0,7,4,2826,0,8,35,3218,56,ITI,ITI3,11,Marche,Marche,1525271,231919,15.21,0.21
2159,2021-03-31,MAR,7370,3084,4286,473,327,162,257,31,103,4558,1294,87,78,4352,3018,ITI,ITI3,11,Marche,Marche,1525271,239289,15.69,0.48
2160,2021-04-14,MAR,10276,4594,5682,418,160,80,1013,182,3551,902,3793,41,136,9902,374,ITI,ITI3,11,Marche,Marche,1525271,249565,16.36,0.67
2161,2021-02-11,MAR,1988,658,1330,1155,370,212,0,32,22,32,0,0,165,1599,389,ITI,ITI3,11,Marche,Marche,1525271,251553,16.49,0.13
2162,2021-02-22,MAR,3414,1499,1915,326,89,77,2,7,0,2869,1,5,38,3339,75,ITI,ITI3,11,Marche,Marche,1525271,254967,16.72,0.22
2163,2021-04-10,MAR,10997,4655,6342,312,169,79,1102,209,2814,2228,3955,53,76,10678,319,ITI,ITI3,11,Marche,Marche,1525271,265964,17.44,0.72
2164,2021-03-16,MAR,3577,1549,2028,317,71,56,5,7,6,2931,46,111,27,394,3183,ITI,ITI3,11,Marche,Marche,1525271,269541,17.67,0.23
2165,2021-04-04,MAR,3826,1793,2033,189,117,7,84,10,632,2009,755,10,13,2655,1171,ITI,ITI3,11,Marche,Marche,1525271,273367,17.92,0.25
2166,2021-03-07,MAR,5183,2108,3075,607,167,32,896,13,2,3007,76,336,47,4430,753,ITI,ITI3,11,Marche,Marche,1525271,278550,18.26,0.34
2167,2021-04-02,MAR,6991,3031,3960,389,210,112,423,47,734,2698,2124,212,42,6248,743,ITI,ITI3,11,Marche,Marche,1525271,285541,18.72,0.46
2168,2021-01-12,MAR,1226,413,813,912,255,50,0,2,0,0,0,0,7,1226,0,ITI,ITI3,11,Marche,Marche,1525271,286767,18.8,0.08
2169,2021-02-02,MAR,1193,397,796,804,265,93,0,5,0,5,0,0,21,73,1120,ITI,ITI3,11,Marche,Marche,1525271,287960,18.88,0.08
2170,2021-02-08,MAR,833,258,575,408,133,262,0,6,3,4,0,0,17,371,462,ITI,ITI3,11,Marche,Marche,1525271,288793,18.93,0.05
2171,2021-02-25,MAR,3563,1447,2116,432,137,423,1,8,5,2493,27,3,34,3384,179,ITI,ITI3,11,Marche,Marche,1525271,292356,19.17,0.23
2172,2021-01-05,MAR,1562,586,976,1436,112,0,0,3,2,0,0,0,9,1562,0,ITI,ITI3,11,Marche,Marche,1525271,293918,19.27,0.1
2173,2021-01-27,MAR,2120,780,1340,1754,154,140,0,13,10,8,0,0,41,122,1998,ITI,ITI3,11,Marche,Marche,1525271,296038,19.41,0.14
2174,2021-04-03,MAR,7586,3209,4377,321,152,60,293,76,827,2952,2812,20,73,6915,671,ITI,ITI3,11,Marche,Marche,1525271,303624,19.91,0.5
2175,2020-12-27,MAR,200,97,103,184,12,4,0,0,0,0,0,0,0,200,0,ITI,ITI3,11,Marche,Marche,1525271,303824,19.92,0.01
2176,2021-03-18,MAR,3445,1514,1931,326,188,125,3,7,8,2653,23,98,14,216,3229,ITI,ITI3,11,Marche,Marche,1525271,307269,20.15,0.23
2177,2021-01-10,MAR,1737,699,1038,1462,253,0,0,5,1,0,0,0,16,1737,0,ITI,ITI3,11,Marche,Marche,1525271,309006,20.26,0.11
2178,2021-02-07,MAR,1871,735,1136,1156,480,46,0,41,20,4,0,0,124,344,1527,ITI,ITI3,11,Marche,Marche,1525271,310877,20.38,0.12
2179,2021-04-08,MAR,7523,3285,4238,273,95,96,715,82,2072,1333,2792,26,39,7192,331,ITI,ITI3,11,Marche,Marche,1525271,318400,20.87,0.49
2180,2021-03-23,MAR,5818,2538,3280,259,104,139,328,23,7,4639,27,220,72,2271,3547,ITI,ITI3,11,Marche,Marche,1525271,324218,21.26,0.38
2181,2021-03-24,MAR,7036,2982,4054,484,152,202,592,40,25,4814,321,159,247,3367,3669,ITI,ITI3,11,Marche,Marche,1525271,331254,21.72,0.46
2182,2021-01-20,MAR,398,99,299,146,56,190,0,2,0,1,0,0,3,386,12,ITI,ITI3,11,Marche,Marche,1525271,331652,21.74,0.03
2183,2021-04-07,MAR,7798,3432,4366,189,143,176,973,75,1887,1322,2896,30,107,7462,336,ITI,ITI3,11,Marche,Marche,1525271,339450,22.26,0.51
2184,2021-01-11,MAR,1176,411,765,1021,155,0,0,0,0,0,0,0,0,1176,0,ITI,ITI3,11,Marche,Marche,1525271,340626,22.33,0.08
2185,2021-01-28,MAR,1973,659,1314,1581,238,101,0,9,1,0,0,0,43,167,1806,ITI,ITI3,11,Marche,Marche,1525271,342599,22.46,0.13
2186,2021-01-30,MAR,1908,669,1239,1566,293,0,0,12,0,0,0,0,37,29,1879,ITI,ITI3,11,Marche,Marche,1525271,344507,22.59,0.13
2187,2020-12-31,MAR,383,178,205,370,13,0,0,0,0,0,0,0,0,383,0,ITI,ITI3,11,Marche,Marche,1525271,344890,22.61,0.03
2188,2021-02-14,MAR,738,301,437,578,109,0,0,10,0,0,0,0,41,738,0,ITI,ITI3,11,Marche,Marche,1525271,345628,22.66,0.05
2189,2021-01-08,MAR,1574,588,986,1226,323,0,0,5,0,0,0,0,20,1574,0,ITI,ITI3,11,Marche,Marche,1525271,347202,22.76,0.1
2190,2021-01-26,MAR,2016,746,1270,1736,152,86,0,15,4,1,0,0,22,92,1924,ITI,ITI3,11,Marche,Marche,1525271,349218,22.9,0.13
2191,2021-04-15,MAR,10371,4668,5703,503,138,128,932,192,3639,780,3823,55,181,9806,565,ITI,ITI3,11,Marche,Marche,1525271,359589,23.58,0.68
2192,2021-02-13,MAR,1064,455,609,457,311,90,0,25,10,16,0,0,155,1012,52,ITI,ITI3,11,Marche,Marche,1525271,360653,23.65,0.07
2193,2021-03-04,MAR,6625,2976,3649,1064,375,115,769,53,18,2806,222,1039,164,5231,1394,ITI,ITI3,11,Marche,Marche,1525271,367278,24.08,0.43
2194,2021-03-08,MAR,6366,2807,3559,768,228,220,1015,8,2,3102,147,828,48,5364,1002,ITI,ITI3,11,Marche,Marche,1525271,373644,24.5,0.42
2195,2021-01-29,MAR,1991,730,1261,1479,404,74,0,6,0,3,0,0,25,168,1823,ITI,ITI3,11,Marche,Marche,1525271,375635,24.63,0.13
2196,2021-01-16,MAR,2006,723,1283,1059,415,285,0,53,42,21,0,0,131,2006,0,ITI,ITI3,11,Marche,Marche,1525271,377641,24.76,0.13
2197,2021-03-12,MAR,4717,2020,2697,820,445,17,929,20,11,1907,3,487,78,3472,1245,ITI,ITI3,11,Marche,Marche,1525271,382358,25.07,0.31
2198,2021-03-26,MAR,6345,2614,3731,335,222,190,501,58,31,4092,396,204,316,3534,2811,ITI,ITI3,11,Marche,Marche,1525271,388703,25.48,0.42
2199,2021-02-01,MAR,1365,480,885,1057,200,81,0,5,0,0,0,0,22,98,1267,ITI,ITI3,11,Marche,Marche,1525271,390068,25.57,0.09
2200,2021-04-13,MAR,9860,4275,5585,203,105,60,1075,163,3748,955,3469,32,50,9619,241,ITI,ITI3,11,Marche,Marche,1525271,399928,26.22,0.65
2201,2021-03-21,MAR,4512,1878,2634,87,42,57,205,19,7,4047,9,13,26,1632,2880,ITI,ITI3,11,Marche,Marche,1525271,404440,26.52,0.3
2202,2021-01-21,MAR,896,253,643,460,83,336,0,1,0,3,0,0,13,585,311,ITI,ITI3,11,Marche,Marche,1525271,405336,26.57,0.06
2203,2021-04-18,MAR,8829,4131,4698,259,64,2,455,1076,2951,377,3611,11,23,7912,917,ITI,ITI3,11,Marche,Marche,1525271,414165,27.15,0.58
2204,2021-02-17,MAR,1791,664,1127,968,472,309,0,6,1,1,22,0,12,1672,119,ITI,ITI3,11,Marche,Marche,1525271,415956,27.27,0.12
2205,2021-03-06,MAR,5732,2647,3085,973,225,172,747,37,7,2400,221,864,86,4464,1268,ITI,ITI3,11,Marche,Marche,1525271,421688,27.65,0.38
2206,2021-03-17,MAR,3435,1497,1938,301,79,117,5,10,10,2822,61,7,23,111,3324,ITI,ITI3,11,Marche,Marche,1525271,425123,27.87,0.23
2207,2021-02-26,MAR,3635,1502,2133,449,178,389,39,8,4,2520,31,4,13,3159,476,ITI,ITI3,11,Marche,Marche,1525271,428758,28.11,0.24
2208,2021-03-29,SAR,4371,1541,2830,624,490,182,1411,22,116,1018,310,98,100,3785,586,ITG,ITG2,20,Sardegna,Sardegna,1639591,4371,0.27,0.27
2209,2021-01-02,SAR,60,21,39,60,0,0,0,0,0,0,0,0,0,60,0,ITG,ITG2,20,Sardegna,Sardegna,1639591,4431,0.27,0.0
2210,2021-03-09,SAR,5150,2371,2779,1056,567,287,310,9,33,2278,14,561,35,4421,729,ITG,ITG2,20,Sardegna,Sardegna,1639591,9581,0.58,0.31
2211,2021-03-15,SAR,2685,1216,1469,458,591,86,1019,7,10,325,8,170,11,2312,373,ITG,ITG2,20,Sardegna,Sardegna,1639591,12266,0.75,0.16
2212,2021-01-07,SAR,3111,1077,2034,2720,373,0,0,1,2,0,0,11,4,3111,0,ITG,ITG2,20,Sardegna,Sardegna,1639591,15377,0.94,0.19
2213,2021-02-26,SAR,2797,1107,1690,1224,877,221,5,20,16,289,5,98,42,2491,306,ITG,ITG2,20,Sardegna,Sardegna,1639591,18174,1.11,0.17
2214,2021-02-05,SAR,1897,749,1148,1214,511,164,0,0,0,1,1,3,3,433,1464,ITG,ITG2,20,Sardegna,Sardegna,1639591,20071,1.22,0.12
2215,2021-02-23,SAR,1519,1010,509,602,387,89,0,7,6,16,0,374,38,1285,234,ITG,ITG2,20,Sardegna,Sardegna,1639591,21590,1.32,0.09
2216,2020-12-28,SAR,65,25,40,65,0,0,0,0,0,0,0,0,0,65,0,ITG,ITG2,20,Sardegna,Sardegna,1639591,21655,1.32,0.0
2217,2021-01-13,SAR,573,178,395,494,79,0,0,0,0,0,0,0,0,573,0,ITG,ITG2,20,Sardegna,Sardegna,1639591,22228,1.36,0.03
2218,2021-03-21,SAR,4030,1809,2221,64,240,1,575,14,56,2890,17,107,66,2590,1440,ITG,ITG2,20,Sardegna,Sardegna,1639591,26258,1.6,0.25
2219,2021-03-11,SAR,6034,2725,3309,1011,567,418,102,51,98,2957,120,643,67,4834,1200,ITG,ITG2,20,Sardegna,Sardegna,1639591,32292,1.97,0.37
2220,2021-03-18,SAR,7249,3065,4184,1078,315,354,63,55,639,4240,429,12,64,5646,1603,ITG,ITG2,20,Sardegna,Sardegna,1639591,39541,2.41,0.44
2221,2021-03-31,SAR,10069,4030,6039,396,575,230,1378,148,701,4992,1431,31,187,7620,2449,ITG,ITG2,20,Sardegna,Sardegna,1639591,49610,3.03,0.61
2222,2021-04-17,SAR,8791,3946,4845,291,86,108,24,1309,2533,3328,944,3,165,4731,4060,ITG,ITG2,20,Sardegna,Sardegna,1639591,58401,3.56,0.54
2223,2021-01-29,SAR,2951,1067,1884,2580,366,3,0,0,0,0,0,0,2,48,2903,ITG,ITG2,20,Sardegna,Sardegna,1639591,61352,3.74,0.18
2224,2021-03-03,SAR,3834,2061,1773,1070,554,600,1,5,5,704,1,857,37,2607,1227,ITG,ITG2,20,Sardegna,Sardegna,1639591,65186,3.98,0.23
2225,2021-01-09,SAR,4026,1417,2609,3182,832,0,0,3,1,1,0,0,7,4026,0,ITG,ITG2,20,Sardegna,Sardegna,1639591,69212,4.22,0.25
2226,2021-03-01,SAR,2160,1054,1106,1135,341,141,1,8,19,104,10,391,10,1501,659,ITG,ITG2,20,Sardegna,Sardegna,1639591,71372,4.35,0.13
2227,2021-01-22,SAR,83,47,36,45,38,0,0,0,0,0,0,0,0,55,28,ITG,ITG2,20,Sardegna,Sardegna,1639591,71455,4.36,0.01
2228,2021-02-17,SAR,1406,576,830,689,338,313,0,1,0,0,1,33,31,1332,74,ITG,ITG2,20,Sardegna,Sardegna,1639591,72861,4.44,0.09
2229,2021-03-06,SAR,2638,1079,1559,1108,885,469,36,3,10,24,2,79,22,857,1781,ITG,ITG2,20,Sardegna,Sardegna,1639591,75499,4.6,0.16
2230,2021-02-16,SAR,700,289,411,376,211,112,0,0,0,0,0,0,1,673,27,ITG,ITG2,20,Sardegna,Sardegna,1639591,76199,4.65,0.04
2231,2021-03-10,SAR,6009,2917,3092,719,497,414,335,14,85,2986,29,902,28,5159,850,ITG,ITG2,20,Sardegna,Sardegna,1639591,82208,5.01,0.37
2232,2021-04-13,SAR,7418,3474,3944,216,62,45,15,486,3634,1472,1303,144,41,5643,1775,ITG,ITG2,20,Sardegna,Sardegna,1639591,89626,5.47,0.45
2233,2021-02-21,SAR,1589,710,879,67,28,59,0,0,7,1422,0,6,0,1559,30,ITG,ITG2,20,Sardegna,Sardegna,1639591,91215,5.56,0.1
2234,2021-02-28,SAR,368,169,199,245,76,47,0,0,0,0,0,0,0,142,226,ITG,ITG2,20,Sardegna,Sardegna,1639591,91583,5.59,0.02
2235,2021-01-26,SAR,1336,453,883,1296,39,0,1,0,0,0,0,0,0,27,1309,ITG,ITG2,20,Sardegna,Sardegna,1639591,92919,5.67,0.08
2236,2021-02-09,SAR,2286,837,1449,1308,471,497,1,4,0,1,2,0,2,1290,996,ITG,ITG2,20,Sardegna,Sardegna,1639591,95205,5.81,0.14
2237,2021-01-31,SAR,2121,750,1371,1544,555,0,0,6,0,1,1,0,14,48,2073,ITG,ITG2,20,Sardegna,Sardegna,1639591,97326,5.94,0.13
2238,2021-01-16,SAR,1492,525,967,1282,207,0,1,1,1,0,0,0,0,1492,0,ITG,ITG2,20,Sardegna,Sardegna,1639591,98818,6.03,0.09
2239,2021-02-24,SAR,2410,1292,1118,1193,521,301,0,6,2,7,0,366,14,2221,189,ITG,ITG2,20,Sardegna,Sardegna,1639591,101228,6.17,0.15
2240,2021-03-20,SAR,5190,2073,3117,696,307,127,855,19,91,2743,201,105,46,2914,2276,ITG,ITG2,20,Sardegna,Sardegna,1639591,106418,6.49,0.32
2241,2021-04-06,SAR,7093,2955,4138,656,252,226,455,101,1846,2507,577,35,438,4969,2124,ITG,ITG2,20,Sardegna,Sardegna,1639591,113511,6.92,0.43
2242,2021-03-28,SAR,4499,1773,2726,83,42,23,681,48,130,3198,176,13,105,4421,78,ITG,ITG2,20,Sardegna,Sardegna,1639591,118010,7.2,0.27
2243,2021-01-17,SAR,860,277,583,747,113,0,0,0,0,0,0,0,0,859,1,ITG,ITG2,20,Sardegna,Sardegna,1639591,118870,7.25,0.05
2244,2021-03-19,SAR,7213,3005,4208,1315,773,222,10,141,581,3506,277,247,141,5000,2213,ITG,ITG2,20,Sardegna,Sardegna,1639591,126083,7.69,0.44
2245,2021-04-01,SAR,9993,3981,6012,455,370,208,1251,169,893,4675,1457,203,312,6980,3013,ITG,ITG2,20,Sardegna,Sardegna,1639591,136076,8.3,0.61
2246,2021-04-12,SAR,6754,3063,3691,87,83,44,11,596,2738,2105,964,30,96,5182,1572,ITG,ITG2,20,Sardegna,Sardegna,1639591,142830,8.71,0.41
2247,2021-03-05,SAR,5030,2443,2587,1692,1153,669,10,31,14,646,14,745,56,2678,2352,ITG,ITG2,20,Sardegna,Sardegna,1639591,147860,9.02,0.31
2248,2021-03-08,SAR,4001,1785,2216,740,1025,650,153,8,7,854,46,505,13,2782,1219,ITG,ITG2,20,Sardegna,Sardegna,1639591,151861,9.26,0.24
2249,2021-01-11,SAR,1183,505,678,656,525,0,0,0,0,1,0,0,1,1183,0,ITG,ITG2,20,Sardegna,Sardegna,1639591,153044,9.33,0.07
2250,2021-01-25,SAR,588,212,376,553,34,0,0,0,0,0,0,0,1,22,566,ITG,ITG2,20,Sardegna,Sardegna,1639591,153632,9.37,0.04
2251,2021-04-09,SAR,11752,5195,6557,436,256,39,163,434,3474,4619,2079,37,215,7640,4112,ITG,ITG2,20,Sardegna,Sardegna,1639591,165384,10.09,0.72
2252,2021-02-12,SAR,2237,933,1304,986,720,501,0,4,0,1,4,0,21,2178,59,ITG,ITG2,20,Sardegna,Sardegna,1639591,167621,10.22,0.14
2253,2021-04-11,SAR,5353,2422,2931,62,16,1,20,24,3228,1858,123,9,12,4233,1120,ITG,ITG2,20,Sardegna,Sardegna,1639591,172974,10.55,0.33
2254,2021-01-15,SAR,1563,573,990,1170,384,0,0,0,0,0,6,3,0,1563,0,ITG,ITG2,20,Sardegna,Sardegna,1639591,174537,10.65,0.1
2255,2021-01-23,SAR,60,22,38,60,0,0,0,0,0,0,0,0,0,0,60,ITG,ITG2,20,Sardegna,Sardegna,1639591,174597,10.65,0.0
2256,2021-01-12,SAR,865,408,457,504,361,0,0,0,0,0,0,0,0,865,0,ITG,ITG2,20,Sardegna,Sardegna,1639591,175462,10.7,0.05
2257,2021-01-14,SAR,1105,426,679,885,220,0,0,0,0,0,0,0,0,1105,0,ITG,ITG2,20,Sardegna,Sardegna,1639591,176567,10.77,0.07
2258,2021-03-07,SAR,1657,750,907,323,230,78,2,4,1,1012,0,0,7,1117,540,ITG,ITG2,20,Sardegna,Sardegna,1639591,178224,10.87,0.1
2259,2021-03-02,SAR,2865,1459,1406,1067,608,381,2,8,10,324,1,461,3,1712,1153,ITG,ITG2,20,Sardegna,Sardegna,1639591,181089,11.04,0.17
2260,2021-02-11,SAR,1315,490,825,588,266,369,0,31,1,3,0,0,57,1204,111,ITG,ITG2,20,Sardegna,Sardegna,1639591,182404,11.12,0.08
2261,2021-04-07,SAR,13132,5838,7294,675,442,256,350,188,3322,5348,2308,72,171,7635,5497,ITG,ITG2,20,Sardegna,Sardegna,1639591,195536,11.93,0.8
2262,2021-04-14,SAR,7470,3498,3972,144,34,96,17,432,4459,763,1475,1,49,6350,1120,ITG,ITG2,20,Sardegna,Sardegna,1639591,203006,12.38,0.46
2263,2021-02-10,SAR,1959,765,1194,1169,299,488,1,0,1,0,0,0,1,1441,518,ITG,ITG2,20,Sardegna,Sardegna,1639591,204965,12.5,0.12
2264,2021-03-25,SAR,8338,3477,4861,815,311,189,1562,153,360,3606,861,343,138,7035,1303,ITG,ITG2,20,Sardegna,Sardegna,1639591,213303,13.01,0.51
2265,2021-02-20,SAR,2041,855,1186,484,150,195,1,2,4,1204,0,0,1,1707,334,ITG,ITG2,20,Sardegna,Sardegna,1639591,215344,13.13,0.12
2266,2021-02-15,SAR,958,349,609,440,231,279,0,2,0,0,3,0,3,927,31,ITG,ITG2,20,Sardegna,Sardegna,1639591,216302,13.19,0.06
2267,2021-03-13,SAR,2751,1072,1679,274,142,240,132,13,101,1765,22,43,19,2470,281,ITG,ITG2,20,Sardegna,Sardegna,1639591,219053,13.36,0.17
2268,2021-03-27,SAR,5496,2080,3416,331,322,217,1309,27,182,2496,448,83,81,5074,422,ITG,ITG2,20,Sardegna,Sardegna,1639591,224549,13.7,0.34
2269,2021-02-02,SAR,1482,655,827,988,475,0,0,0,0,0,0,0,19,241,1241,ITG,ITG2,20,Sardegna,Sardegna,1639591,226031,13.79,0.09
2270,2021-01-20,SAR,210,77,133,154,56,0,0,0,0,0,0,0,0,208,2,ITG,ITG2,20,Sardegna,Sardegna,1639591,226241,13.8,0.01
2271,2021-03-23,SAR,6085,2587,3498,1108,316,283,1140,34,164,2310,555,95,80,5008,1077,ITG,ITG2,20,Sardegna,Sardegna,1639591,232326,14.17,0.37
2272,2021-01-05,SAR,1327,446,881,1283,40,0,0,1,0,0,0,0,3,1327,0,ITG,ITG2,20,Sardegna,Sardegna,1639591,233653,14.25,0.08
2273,2021-04-03,SAR,4329,1673,2656,181,275,153,424,54,430,2520,171,23,98,2586,1743,ITG,ITG2,20,Sardegna,Sardegna,1639591,237982,14.51,0.26
2274,2020-12-27,SAR,65,34,31,65,0,0,0,0,0,0,0,0,0,65,0,ITG,ITG2,20,Sardegna,Sardegna,1639591,238047,14.52,0.0
2275,2021-04-18,SAR,5031,2189,2842,48,6,0,3,859,285,3397,413,11,9,2274,2757,ITG,ITG2,20,Sardegna,Sardegna,1639591,243078,14.83,0.31
2276,2021-01-27,SAR,1408,494,914,1303,103,0,0,0,0,0,0,0,2,79,1329,ITG,ITG2,20,Sardegna,Sardegna,1639591,244486,14.91,0.09
2277,2021-03-17,SAR,6553,2849,3704,1077,529,528,128,80,443,3342,367,5,54,4945,1608,ITG,ITG2,20,Sardegna,Sardegna,1639591,251039,15.31,0.4
2278,2021-01-28,SAR,2968,1044,1924,2554,400,0,0,1,0,0,0,11,2,69,2899,ITG,ITG2,20,Sardegna,Sardegna,1639591,254007,15.49,0.18
2279,2021-01-10,SAR,2183,750,1433,1632,548,0,0,0,0,0,0,0,3,2183,0,ITG,ITG2,20,Sardegna,Sardegna,1639591,256190,15.63,0.13
2280,2021-03-14,SAR,606,376,230,34,210,0,12,2,1,251,0,87,9,606,0,ITG,ITG2,20,Sardegna,Sardegna,1639591,256796,15.66,0.04
2281,2021-04-08,SAR,12949,5680,7269,714,193,77,287,356,2861,4758,3510,36,157,8081,4868,ITG,ITG2,20,Sardegna,Sardegna,1639591,269745,16.45,0.79
2282,2021-01-08,SAR,3257,1184,2073,2929,323,0,0,0,0,2,1,0,2,3257,0,ITG,ITG2,20,Sardegna,Sardegna,1639591,273002,16.65,0.2
2283,2021-02-18,SAR,1877,732,1145,1073,344,298,110,4,0,1,1,33,13,1813,64,ITG,ITG2,20,Sardegna,Sardegna,1639591,274879,16.77,0.11
2284,2021-02-27,SAR,1920,647,1273,1059,316,306,0,14,2,177,0,0,46,1365,555,ITG,ITG2,20,Sardegna,Sardegna,1639591,276799,16.88,0.12
2285,2021-04-04,SAR,1,0,1,0,0,0,0,0,0,1,0,0,0,0,1,ITG,ITG2,20,Sardegna,Sardegna,1639591,276800,16.88,0.0
2286,2021-02-04,SAR,2271,816,1455,1737,360,170,0,1,1,1,1,0,0,916,1355,ITG,ITG2,20,Sardegna,Sardegna,1639591,279071,17.02,0.14
2287,2021-02-19,SAR,1496,470,1026,677,388,387,0,4,4,1,13,1,21,1440,56,ITG,ITG2,20,Sardegna,Sardegna,1639591,280567,17.11,0.09
2288,2021-04-05,SAR,2030,781,1249,55,150,0,694,93,395,144,123,22,354,2028,2,ITG,ITG2,20,Sardegna,Sardegna,1639591,282597,17.24,0.12
2289,2020-12-29,SAR,57,32,25,56,1,0,0,0,0,0,0,0,0,57,0,ITG,ITG2,20,Sardegna,Sardegna,1639591,282654,17.24,0.0
2290,2021-03-16,SAR,4367,1945,2422,663,204,352,8,43,163,2542,336,1,55,3445,922,ITG,ITG2,20,Sardegna,Sardegna,1639591,287021,17.51,0.27
2291,2021-03-26,SAR,7993,3134,4859,842,564,414,1520,138,456,2735,948,227,149,6472,1521,ITG,ITG2,20,Sardegna,Sardegna,1639591,295014,17.99,0.49
2292,2021-02-14,SAR,539,263,276,286,188,57,0,1,0,3,0,0,4,537,2,ITG,ITG2,20,Sardegna,Sardegna,1639591,295553,18.03,0.03
2293,2021-01-06,SAR,1615,549,1066,1510,99,0,0,0,0,1,0,0,5,1615,0,ITG,ITG2,20,Sardegna,Sardegna,1639591,297168,18.12,0.1
2294,2021-02-25,SAR,2899,1255,1644,1474,611,466,9,6,2,242,2,74,13,2294,605,ITG,ITG2,20,Sardegna,Sardegna,1639591,300067,18.3,0.18
2295,2021-03-12,SAR,5755,2408,3347,1048,766,464,159,33,56,2572,83,468,106,4447,1308,ITG,ITG2,20,Sardegna,Sardegna,1639591,305822,18.65,0.35
2296,2021-01-04,SAR,591,217,374,565,20,0,0,0,0,1,0,0,5,591,0,ITG,ITG2,20,Sardegna,Sardegna,1639591,306413,18.69,0.04
2297,2020-12-31,SAR,32,16,16,28,4,0,0,0,0,0,0,0,0,32,0,ITG,ITG2,20,Sardegna,Sardegna,1639591,306445,18.69,0.0
2298,2021-02-01,SAR,1524,605,919,896,551,77,0,0,0,0,0,0,0,225,1299,ITG,ITG2,20,Sardegna,Sardegna,1639591,307969,18.78,0.09
2299,2021-01-19,SAR,747,270,477,423,163,160,1,0,0,0,0,0,0,692,55,ITG,ITG2,20,Sardegna,Sardegna,1639591,308716,18.83,0.05
2300,2021-02-07,SAR,1116,394,722,975,141,0,0,0,0,0,0,0,0,228,888,ITG,ITG2,20,Sardegna,Sardegna,1639591,309832,18.9,0.07
2301,2021-01-18,SAR,904,326,578,714,188,0,0,0,0,0,0,1,1,780,124,ITG,ITG2,20,Sardegna,Sardegna,1639591,310736,18.95,0.06
2302,2021-03-30,SAR,7871,3102,4769,649,511,237,1452,98,629,2942,1197,60,96,5892,1979,ITG,ITG2,20,Sardegna,Sardegna,1639591,318607,19.43,0.48
2303,2021-01-03,SAR,90,36,54,89,1,0,0,0,0,0,0,0,0,90,0,ITG,ITG2,20,Sardegna,Sardegna,1639591,318697,19.44,0.01
2304,2021-01-30,SAR,3862,1392,2470,2987,873,0,0,0,0,1,0,0,1,362,3500,ITG,ITG2,20,Sardegna,Sardegna,1639591,322559,19.67,0.24
2305,2021-01-21,SAR,126,60,66,60,66,0,0,0,0,0,0,0,0,94,32,ITG,ITG2,20,Sardegna,Sardegna,1639591,322685,19.68,0.01
2306,2021-02-03,SAR,1119,419,700,920,169,19,0,1,0,0,0,0,10,426,693,ITG,ITG2,20,Sardegna,Sardegna,1639591,323804,19.75,0.07
2307,2021-04-02,SAR,8680,3406,5274,524,680,176,1301,97,799,3944,901,70,188,5716,2964,ITG,ITG2,20,Sardegna,Sardegna,1639591,332484,20.28,0.53
2308,2021-04-16,SAR,13944,6265,7679,474,157,107,27,1997,4190,4220,2638,19,115,8766,5178,ITG,ITG2,20,Sardegna,Sardegna,1639591,346428,21.13,0.85
2309,2021-01-24,SAR,90,34,56,89,1,0,0,0,0,0,0,0,0,5,85,ITG,ITG2,20,Sardegna,Sardegna,1639591,346518,21.13,0.01
2310,2021-03-24,SAR,7031,2882,4149,739,253,397,1059,55,388,2988,728,330,94,5673,1358,ITG,ITG2,20,Sardegna,Sardegna,1639591,353549,21.56,0.43
2311,2021-03-22,SAR,3493,1323,2170,838,344,109,1135,15,39,781,105,105,22,2981,512,ITG,ITG2,20,Sardegna,Sardegna,1639591,357042,21.78,0.21
2312,2021-04-10,SAR,10101,4549,5552,153,91,11,218,488,4630,3566,765,11,168,8167,1934,ITG,ITG2,20,Sardegna,Sardegna,1639591,367143,22.39,0.62
2313,2021-02-06,SAR,1970,697,1273,1544,284,139,1,0,1,0,0,0,1,569,1401,ITG,ITG2,20,Sardegna,Sardegna,1639591,369113,22.51,0.12
2314,2021-02-13,SAR,1456,565,891,732,433,256,5,4,3,1,1,0,21,1454,2,ITG,ITG2,20,Sardegna,Sardegna,1639591,370569,22.6,0.09
2315,2021-02-08,SAR,1470,533,937,998,337,126,0,1,0,1,1,1,5,856,614,ITG,ITG2,20,Sardegna,Sardegna,1639591,372039,22.69,0.09
2316,2021-01-01,SAR,30,16,14,30,0,0,0,0,0,0,0,0,0,30,0,ITG,ITG2,20,Sardegna,Sardegna,1639591,372069,22.69,0.0
2317,2021-04-19,SAR,6869,3124,3745,145,70,73,35,2483,2071,992,974,6,20,5751,1118,ITG,ITG2,20,Sardegna,Sardegna,1639591,378938,23.11,0.42
2318,2021-03-04,SAR,4002,1953,2049,987,552,542,42,44,18,1153,1,581,82,2747,1255,ITG,ITG2,20,Sardegna,Sardegna,1639591,382940,23.36,0.24
2319,2021-02-22,SAR,1637,948,689,606,293,190,0,6,3,5,11,516,7,1409,228,ITG,ITG2,20,Sardegna,Sardegna,1639591,384577,23.46,0.1
2320,2021-04-15,SAR,11007,5124,5883,264,93,126,20,869,3610,3809,2069,29,118,6174,4833,ITG,ITG2,20,Sardegna,Sardegna,1639591,395584,24.13,0.67
