,data,area,Vaccinazioni giornaliere,sesso_maschile,sesso_femminile,prima_dose,seconda_dose,pregressa_infezione,codice_NUTS1,codice_NUTS2,codice_regione_ISTAT,nome_area,Regione,popolazione,Totale vaccinazioni,Totale vaccinazioni ogni cento ab,Vaccinazioni giornaliere ogni cento ab
0,2021-04-16,LAZ,34430,15697,18733,21965,12093,372,ITI,ITI4,12,Lazio,Lazio,5879082,34430,0.59,0.59
1,2021-01-23,LAZ,7214,2869,4345,585,6629,0,ITI,ITI4,12,Lazio,Lazio,5879082,41644,0.71,0.12
2,2021-01-06,LAZ,5123,1962,3161,5003,0,120,ITI,ITI4,12,Lazio,Lazio,5879082,46767,0.8,0.09
3,2021-02-25,LAZ,12679,5537,7142,11435,1078,166,ITI,ITI4,12,Lazio,Lazio,5879082,59446,1.01,0.22
4,2021-06-05,LAZ,65928,32514,33414,42564,22727,637,ITI,ITI4,12,Lazio,Lazio,5879082,125374,2.13,1.12
5,2021-06-26,LAZ,55936,26348,29588,24557,30815,564,ITI,ITI4,12,Lazio,Lazio,5879082,181310,3.08,0.95
6,2021-04-30,LAZ,41373,18327,23046,26498,14219,656,ITI,ITI4,12,Lazio,Lazio,5879082,222683,3.79,0.7
7,2021-06-19,LAZ,66210,31197,35013,35142,30305,763,ITI,ITI4,12,Lazio,Lazio,5879082,288893,4.91,1.13
8,2021-02-20,LAZ,9207,4274,4933,8369,771,67,ITI,ITI4,12,Lazio,Lazio,5879082,298100,5.07,0.16
9,2021-05-31,LAZ,51611,22961,28650,30784,19798,1029,ITI,ITI4,12,Lazio,Lazio,5879082,349711,5.95,0.88
10,2021-04-04,LAZ,17533,8106,9427,12158,5265,110,ITI,ITI4,12,Lazio,Lazio,5879082,367244,6.25,0.3
11,2021-05-17,LAZ,44505,20368,24137,35522,8571,412,ITI,ITI4,12,Lazio,Lazio,5879082,411749,7.0,0.76
12,2021-02-06,LAZ,6159,2492,3667,834,5319,6,ITI,ITI4,12,Lazio,Lazio,5879082,417908,7.11,0.1
13,2021-02-11,LAZ,7001,3013,3988,6445,533,23,ITI,ITI4,12,Lazio,Lazio,5879082,424909,7.23,0.12
14,2021-04-11,LAZ,19159,8472,10687,13116,5883,160,ITI,ITI4,12,Lazio,Lazio,5879082,444068,7.55,0.33
15,2021-03-30,LAZ,26826,12986,13840,19354,7149,323,ITI,ITI4,12,Lazio,Lazio,5879082,470894,8.01,0.46
16,2021-07-08,LAZ,25684,12409,13275,10998,14471,215,ITI,ITI4,12,Lazio,Lazio,5879082,496578,8.45,0.44
17,2021-04-18,LAZ,23809,10577,13232,15892,7650,267,ITI,ITI4,12,Lazio,Lazio,5879082,520387,8.85,0.4
18,2021-05-19,LAZ,47124,21632,25492,36402,10105,617,ITI,ITI4,12,Lazio,Lazio,5879082,567511,9.65,0.8
19,2021-03-16,LAZ,13544,5739,7805,7021,6444,79,ITI,ITI4,12,Lazio,Lazio,5879082,581055,9.88,0.23
20,2021-03-09,LAZ,21969,9917,12052,16447,5200,322,ITI,ITI4,12,Lazio,Lazio,5879082,603024,10.26,0.37
21,2021-01-11,LAZ,5542,2109,3433,5397,0,145,ITI,ITI4,12,Lazio,Lazio,5879082,608566,10.35,0.09
22,2021-05-26,LAZ,47480,21807,25673,34724,12102,654,ITI,ITI4,12,Lazio,Lazio,5879082,656046,11.16,0.81
23,2021-03-04,LAZ,19412,8720,10692,14180,5018,214,ITI,ITI4,12,Lazio,Lazio,5879082,675458,11.49,0.33
24,2021-06-12,LAZ,69771,32040,37731,39809,29352,610,ITI,ITI4,12,Lazio,Lazio,5879082,745229,12.68,1.19
25,2021-06-14,LAZ,62753,29415,33338,32093,30131,529,ITI,ITI4,12,Lazio,Lazio,5879082,807982,13.74,1.07
26,2021-03-21,LAZ,18229,7163,11066,13005,5051,173,ITI,ITI4,12,Lazio,Lazio,5879082,826211,14.05,0.31
27,2020-12-30,LAZ,1630,629,1001,1619,0,11,ITI,ITI4,12,Lazio,Lazio,5879082,827841,14.08,0.03
28,2021-07-01,LAZ,47915,22883,25032,7068,40657,190,ITI,ITI4,12,Lazio,Lazio,5879082,875756,14.9,0.82
29,2021-02-18,LAZ,10017,4974,5043,9109,811,97,ITI,ITI4,12,Lazio,Lazio,5879082,885773,15.07,0.17
30,2021-05-12,LAZ,47546,21577,25969,30261,16649,636,ITI,ITI4,12,Lazio,Lazio,5879082,933319,15.88,0.81
31,2021-02-01,LAZ,5675,2178,3497,353,5321,1,ITI,ITI4,12,Lazio,Lazio,5879082,938994,15.97,0.1
32,2021-01-13,LAZ,5694,2151,3543,5532,0,162,ITI,ITI4,12,Lazio,Lazio,5879082,944688,16.07,0.1
33,2021-04-23,LAZ,37696,18096,19600,21957,15277,462,ITI,ITI4,12,Lazio,Lazio,5879082,982384,16.71,0.64
34,2021-05-07,LAZ,48221,22605,25616,30100,17753,368,ITI,ITI4,12,Lazio,Lazio,5879082,1030605,17.53,0.82
35,2021-03-11,LAZ,25355,11951,13404,18816,6232,307,ITI,ITI4,12,Lazio,Lazio,5879082,1055960,17.96,0.43
36,2021-07-03,LAZ,52987,24946,28041,4605,48249,133,ITI,ITI4,12,Lazio,Lazio,5879082,1108947,18.86,0.9
37,2021-02-03,LAZ,6489,2488,4001,958,5524,7,ITI,ITI4,12,Lazio,Lazio,5879082,1115436,18.97,0.11
38,2021-01-20,LAZ,4812,1947,2865,3266,1543,3,ITI,ITI4,12,Lazio,Lazio,5879082,1120248,19.05,0.08
39,2021-05-14,LAZ,51487,23520,27967,32501,18322,664,ITI,ITI4,12,Lazio,Lazio,5879082,1171735,19.93,0.88
40,2021-03-28,LAZ,19130,7776,11354,13493,5310,327,ITI,ITI4,12,Lazio,Lazio,5879082,1190865,20.26,0.33
41,2021-06-09,LAZ,70113,33135,36978,35785,33708,620,ITI,ITI4,12,Lazio,Lazio,5879082,1260978,21.45,1.19
42,2021-02-13,LAZ,6611,2627,3984,6151,418,42,ITI,ITI4,12,Lazio,Lazio,5879082,1267589,21.56,0.11
43,2021-05-24,LAZ,43934,20135,23799,33502,9763,669,ITI,ITI4,12,Lazio,Lazio,5879082,1311523,22.31,0.75
44,2021-01-03,LAZ,5255,1973,3282,5196,0,59,ITI,ITI4,12,Lazio,Lazio,5879082,1316778,22.4,0.09
45,2021-04-13,LAZ,25775,11949,13826,17675,7717,383,ITI,ITI4,12,Lazio,Lazio,5879082,1342553,22.84,0.44
46,2021-01-08,LAZ,7731,2895,4836,7534,0,197,ITI,ITI4,12,Lazio,Lazio,5879082,1350284,22.97,0.13
47,2021-01-04,LAZ,7485,2909,4576,7381,0,104,ITI,ITI4,12,Lazio,Lazio,5879082,1357769,23.09,0.13
48,2021-06-24,LAZ,63546,30301,33245,28463,34454,629,ITI,ITI4,12,Lazio,Lazio,5879082,1421315,24.18,1.08
49,2021-06-07,LAZ,62232,29090,33142,32480,29174,578,ITI,ITI4,12,Lazio,Lazio,5879082,1483547,25.23,1.06
50,2021-06-21,LAZ,61418,28480,32938,28345,32495,578,ITI,ITI4,12,Lazio,Lazio,5879082,1544965,26.28,1.04
51,2021-03-13,LAZ,21805,8729,13076,15695,5894,216,ITI,ITI4,12,Lazio,Lazio,5879082,1566770,26.65,0.37
52,2021-01-25,LAZ,8111,3246,4865,770,7341,0,ITI,ITI4,12,Lazio,Lazio,5879082,1574881,26.79,0.14
53,2021-05-05,LAZ,46791,21467,25324,30397,15838,556,ITI,ITI4,12,Lazio,Lazio,5879082,1621672,27.58,0.8
54,2021-03-02,LAZ,17189,7608,9581,13100,3935,154,ITI,ITI4,12,Lazio,Lazio,5879082,1638861,27.88,0.29
55,2021-01-18,LAZ,6268,2558,3710,5164,978,126,ITI,ITI4,12,Lazio,Lazio,5879082,1645129,27.98,0.11
56,2021-04-28,LAZ,32931,15027,17904,20962,11573,396,ITI,ITI4,12,Lazio,Lazio,5879082,1678060,28.54,0.56
57,2021-03-27,LAZ,26359,10690,15669,19388,6475,496,ITI,ITI4,12,Lazio,Lazio,5879082,1704419,28.99,0.45
58,2021-07-05,LAZ,60918,29298,31620,25498,34419,1001,ITI,ITI4,12,Lazio,Lazio,5879082,1765337,30.03,1.04
59,2021-04-09,LAZ,27587,12518,15069,19059,8254,274,ITI,ITI4,12,Lazio,Lazio,5879082,1792924,30.5,0.47
60,2021-03-23,LAZ,25358,11895,13463,18451,6596,311,ITI,ITI4,12,Lazio,Lazio,5879082,1818282,30.93,0.43
61,2021-02-15,LAZ,8026,3540,4486,7317,632,77,ITI,ITI4,12,Lazio,Lazio,5879082,1826308,31.06,0.14
62,2021-01-29,LAZ,8044,3081,4963,812,7230,2,ITI,ITI4,12,Lazio,Lazio,5879082,1834352,31.2,0.14
63,2021-01-30,LAZ,7013,2895,4118,807,6205,1,ITI,ITI4,12,Lazio,Lazio,5879082,1841365,31.32,0.12
64,2021-01-15,LAZ,6583,2708,3875,6413,0,170,ITI,ITI4,12,Lazio,Lazio,5879082,1847948,31.43,0.11
65,2021-04-25,LAZ,24524,11251,13273,16417,7817,290,ITI,ITI4,12,Lazio,Lazio,5879082,1872472,31.85,0.42
66,2021-04-01,LAZ,29639,14040,15599,22137,7141,361,ITI,ITI4,12,Lazio,Lazio,5879082,1902111,32.35,0.5
67,2021-06-23,LAZ,62029,29174,32855,28336,33225,468,ITI,ITI4,12,Lazio,Lazio,5879082,1964140,33.41,1.06
68,2021-04-15,LAZ,31943,14312,17631,20692,10813,438,ITI,ITI4,12,Lazio,Lazio,5879082,1996083,33.95,0.54
69,2021-02-10,LAZ,8194,3405,4789,4844,3345,5,ITI,ITI4,12,Lazio,Lazio,5879082,2004277,34.09,0.14
70,2021-05-21,LAZ,51851,24879,26972,37171,13954,726,ITI,ITI4,12,Lazio,Lazio,5879082,2056128,34.97,0.88
71,2021-06-04,LAZ,61508,29992,31516,43175,17742,591,ITI,ITI4,12,Lazio,Lazio,5879082,2117636,36.02,1.05
72,2021-05-04,LAZ,39876,18344,21532,25886,13521,469,ITI,ITI4,12,Lazio,Lazio,5879082,2157512,36.7,0.68
73,2021-04-27,LAZ,30711,13865,16846,19455,10849,407,ITI,ITI4,12,Lazio,Lazio,5879082,2188223,37.22,0.52
74,2021-03-01,LAZ,17117,7368,9749,13018,3885,214,ITI,ITI4,12,Lazio,Lazio,5879082,2205340,37.51,0.29
75,2021-02-22,LAZ,11458,4990,6468,10837,502,119,ITI,ITI4,12,Lazio,Lazio,5879082,2216798,37.71,0.19
76,2021-06-02,LAZ,43240,21486,21754,31203,11499,538,ITI,ITI4,12,Lazio,Lazio,5879082,2260038,38.44,0.74
77,2021-06-11,LAZ,69270,32541,36729,36429,32254,587,ITI,ITI4,12,Lazio,Lazio,5879082,2329308,39.62,1.18
78,2021-05-06,LAZ,48742,22697,26045,30539,17550,653,ITI,ITI4,12,Lazio,Lazio,5879082,2378050,40.45,0.83
79,2021-01-17,LAZ,4893,2027,2866,4618,212,63,ITI,ITI4,12,Lazio,Lazio,5879082,2382943,40.53,0.08
80,2021-01-19,LAZ,4773,1959,2814,4316,454,3,ITI,ITI4,12,Lazio,Lazio,5879082,2387716,40.61,0.08
81,2021-04-29,LAZ,38665,17250,21415,24826,13235,604,ITI,ITI4,12,Lazio,Lazio,5879082,2426381,41.27,0.66
82,2021-01-01,LAZ,3555,1382,2173,3515,0,40,ITI,ITI4,12,Lazio,Lazio,5879082,2429936,41.33,0.06
83,2021-01-10,LAZ,4043,1702,2341,3976,0,67,ITI,ITI4,12,Lazio,Lazio,5879082,2433979,41.4,0.07
84,2021-06-16,LAZ,64293,30795,33498,31960,31728,605,ITI,ITI4,12,Lazio,Lazio,5879082,2498272,42.49,1.09
85,2021-04-20,LAZ,31083,14274,16809,19415,11300,368,ITI,ITI4,12,Lazio,Lazio,5879082,2529355,43.02,0.53
86,2021-03-08,LAZ,20865,9046,11819,15319,5273,273,ITI,ITI4,12,Lazio,Lazio,5879082,2550220,43.38,0.35
87,2021-02-08,LAZ,9740,4153,5587,4505,5233,2,ITI,ITI4,12,Lazio,Lazio,5879082,2559960,43.54,0.17
88,2021-05-02,LAZ,32637,14340,18297,22813,9363,461,ITI,ITI4,12,Lazio,Lazio,5879082,2592597,44.1,0.56
89,2021-01-22,LAZ,4006,1636,2370,491,3515,0,ITI,ITI4,12,Lazio,Lazio,5879082,2596603,44.17,0.07
90,2021-02-27,LAZ,11449,4285,7164,10344,978,127,ITI,ITI4,12,Lazio,Lazio,5879082,2608052,44.36,0.19
91,2021-05-20,LAZ,51515,24765,26750,37058,13731,726,ITI,ITI4,12,Lazio,Lazio,5879082,2659567,45.24,0.88
92,2021-06-20,LAZ,55325,25439,29886,29707,24900,718,ITI,ITI4,12,Lazio,Lazio,5879082,2714892,46.18,0.94
93,2021-06-06,LAZ,58046,27985,30061,34979,22499,568,ITI,ITI4,12,Lazio,Lazio,5879082,2772938,47.17,0.99
94,2021-02-26,LAZ,13119,5728,7391,11561,1395,163,ITI,ITI4,12,Lazio,Lazio,5879082,2786057,47.39,0.22
95,2021-05-01,LAZ,37971,17090,20881,25573,11968,430,ITI,ITI4,12,Lazio,Lazio,5879082,2824028,48.04,0.65
96,2021-03-18,LAZ,14225,6078,8147,7762,6391,72,ITI,ITI4,12,Lazio,Lazio,5879082,2838253,48.28,0.24
97,2021-03-25,LAZ,29149,13472,15677,22116,6609,424,ITI,ITI4,12,Lazio,Lazio,5879082,2867402,48.77,0.5
98,2021-01-27,LAZ,6116,2389,3727,999,5117,0,ITI,ITI4,12,Lazio,Lazio,5879082,2873518,48.88,0.1
99,2021-04-06,LAZ,24404,11124,13280,16982,7115,307,ITI,ITI4,12,Lazio,Lazio,5879082,2897922,49.29,0.42
100,2020-12-27,LAZ,274,132,142,274,0,0,ITI,ITI4,12,Lazio,Lazio,5879082,2898196,49.3,0.0
101,2021-03-20,LAZ,19190,7637,11553,13054,5885,251,ITI,ITI4,12,Lazio,Lazio,5879082,2917386,49.62,0.33
102,2021-06-30,LAZ,62661,29448,33213,29709,32434,518,ITI,ITI4,12,Lazio,Lazio,5879082,2980047,50.69,1.07
103,2021-04-08,LAZ,26740,12248,14492,18694,7698,348,ITI,ITI4,12,Lazio,Lazio,5879082,3006787,51.14,0.45
104,2021-07-02,LAZ,48042,23001,25041,6533,41338,171,ITI,ITI4,12,Lazio,Lazio,5879082,3054829,51.96,0.82
105,2021-04-22,LAZ,38877,19232,19645,23656,14621,600,ITI,ITI4,12,Lazio,Lazio,5879082,3093706,52.62,0.66
106,2021-03-10,LAZ,23330,10652,12678,17369,5647,314,ITI,ITI4,12,Lazio,Lazio,5879082,3117036,53.02,0.4
107,2021-01-12,LAZ,5413,1981,3432,5270,0,143,ITI,ITI4,12,Lazio,Lazio,5879082,3122449,53.11,0.09
108,2021-06-18,LAZ,63932,30725,33207,30149,33083,700,ITI,ITI4,12,Lazio,Lazio,5879082,3186381,54.2,1.09
109,2021-03-17,LAZ,13812,5914,7898,7453,6256,103,ITI,ITI4,12,Lazio,Lazio,5879082,3200193,54.43,0.23
110,2021-06-25,LAZ,62733,30192,32541,27935,34239,559,ITI,ITI4,12,Lazio,Lazio,5879082,3262926,55.5,1.07
111,2021-06-27,LAZ,47146,21540,25606,20580,26113,453,ITI,ITI4,12,Lazio,Lazio,5879082,3310072,56.3,0.8
112,2021-02-04,LAZ,6337,2506,3831,1020,5316,1,ITI,ITI4,12,Lazio,Lazio,5879082,3316409,56.41,0.11
113,2021-05-22,LAZ,55104,26994,28110,43504,10683,917,ITI,ITI4,12,Lazio,Lazio,5879082,3371513,57.35,0.94
114,2021-05-15,LAZ,57356,27402,29954,40024,16519,813,ITI,ITI4,12,Lazio,Lazio,5879082,3428869,58.32,0.98
115,2021-03-19,LAZ,17450,7566,9884,10996,6328,126,ITI,ITI4,12,Lazio,Lazio,5879082,3446319,58.62,0.3
116,2021-02-24,LAZ,12050,5209,6841,10945,995,110,ITI,ITI4,12,Lazio,Lazio,5879082,3458369,58.82,0.2
117,2021-07-07,LAZ,61284,30292,30992,28178,32575,531,ITI,ITI4,12,Lazio,Lazio,5879082,3519653,59.87,1.04
118,2021-03-29,LAZ,25255,11930,13325,17942,7037,276,ITI,ITI4,12,Lazio,Lazio,5879082,3544908,60.3,0.43
119,2021-03-15,LAZ,20943,9824,11119,13978,6743,222,ITI,ITI4,12,Lazio,Lazio,5879082,3565851,60.65,0.36
120,2021-04-17,LAZ,32376,14210,18166,20002,11976,398,ITI,ITI4,12,Lazio,Lazio,5879082,3598227,61.2,0.55
121,2021-03-12,LAZ,23987,11076,12911,17360,6317,310,ITI,ITI4,12,Lazio,Lazio,5879082,3622214,61.61,0.41
122,2021-02-09,LAZ,8806,3773,5033,4574,4225,7,ITI,ITI4,12,Lazio,Lazio,5879082,3631020,61.76,0.15
123,2021-02-23,LAZ,11095,4784,6311,10207,765,123,ITI,ITI4,12,Lazio,Lazio,5879082,3642115,61.95,0.19
124,2021-03-03,LAZ,17858,7865,9993,13344,4294,220,ITI,ITI4,12,Lazio,Lazio,5879082,3659973,62.25,0.3
125,2021-01-26,LAZ,7965,3129,4836,727,7238,0,ITI,ITI4,12,Lazio,Lazio,5879082,3667938,62.39,0.14
126,2021-04-02,LAZ,29329,14027,15302,21633,7338,358,ITI,ITI4,12,Lazio,Lazio,5879082,3697267,62.89,0.5
127,2021-01-28,LAZ,8280,3166,5114,782,7497,1,ITI,ITI4,12,Lazio,Lazio,5879082,3705547,63.03,0.14
128,2021-07-04,LAZ,46487,21627,24860,4073,42331,83,ITI,ITI4,12,Lazio,Lazio,5879082,3752034,63.82,0.79
129,2021-05-08,LAZ,45439,20740,24699,29369,15414,656,ITI,ITI4,12,Lazio,Lazio,5879082,3797473,64.59,0.77
130,2021-03-26,LAZ,30031,13835,16196,22775,6846,410,ITI,ITI4,12,Lazio,Lazio,5879082,3827504,65.1,0.51
131,2021-07-06,LAZ,61030,29611,31419,28042,32540,448,ITI,ITI4,12,Lazio,Lazio,5879082,3888534,66.14,1.04
132,2021-06-01,LAZ,48807,23549,25258,29868,18486,453,ITI,ITI4,12,Lazio,Lazio,5879082,3937341,66.97,0.83
133,2021-04-05,LAZ,19846,9065,10781,13518,6181,147,ITI,ITI4,12,Lazio,Lazio,5879082,3957187,67.31,0.34
134,2021-05-25,LAZ,47437,22247,25190,35155,11678,604,ITI,ITI4,12,Lazio,Lazio,5879082,4004624,68.12,0.81
135,2021-04-12,LAZ,23846,10749,13097,16671,6901,274,ITI,ITI4,12,Lazio,Lazio,5879082,4028470,68.52,0.41
136,2021-06-08,LAZ,66480,31723,34757,35957,29895,628,ITI,ITI4,12,Lazio,Lazio,5879082,4094950,69.65,1.13
137,2021-03-22,LAZ,23279,10492,12787,16296,6676,307,ITI,ITI4,12,Lazio,Lazio,5879082,4118229,70.05,0.4
138,2020-12-29,LAZ,488,176,312,484,0,4,ITI,ITI4,12,Lazio,Lazio,5879082,4118717,70.06,0.01
139,2021-06-13,LAZ,58362,26184,32178,33043,24827,492,ITI,ITI4,12,Lazio,Lazio,5879082,4177079,71.05,0.99
140,2021-03-07,LAZ,14133,5466,8667,10343,3593,197,ITI,ITI4,12,Lazio,Lazio,5879082,4191212,71.29,0.24
141,2021-06-15,LAZ,65634,31650,33984,33132,31965,537,ITI,ITI4,12,Lazio,Lazio,5879082,4256846,72.41,1.12
142,2021-03-24,LAZ,27816,13034,14782,21217,6237,362,ITI,ITI4,12,Lazio,Lazio,5879082,4284662,72.88,0.47
143,2021-05-29,LAZ,51972,23360,28612,40118,10982,872,ITI,ITI4,12,Lazio,Lazio,5879082,4336634,73.76,0.88
144,2021-05-10,LAZ,44437,20304,24133,30585,13415,437,ITI,ITI4,12,Lazio,Lazio,5879082,4381071,74.52,0.76
145,2021-05-27,LAZ,58119,26972,31147,43629,13692,798,ITI,ITI4,12,Lazio,Lazio,5879082,4439190,75.51,0.99
146,2021-03-05,LAZ,19568,8668,10900,14623,4734,211,ITI,ITI4,12,Lazio,Lazio,5879082,4458758,75.84,0.33
147,2021-02-16,LAZ,8359,4035,4324,7712,607,40,ITI,ITI4,12,Lazio,Lazio,5879082,4467117,75.98,0.14
148,2021-01-09,LAZ,6298,2562,3736,6186,0,112,ITI,ITI4,12,Lazio,Lazio,5879082,4473415,76.09,0.11
149,2021-04-19,LAZ,30105,13684,16421,19007,10683,415,ITI,ITI4,12,Lazio,Lazio,5879082,4503520,76.6,0.51
150,2021-02-21,LAZ,6989,3180,3809,6487,463,39,ITI,ITI4,12,Lazio,Lazio,5879082,4510509,76.72,0.12
151,2021-02-14,LAZ,5777,2372,3405,5276,471,30,ITI,ITI4,12,Lazio,Lazio,5879082,4516286,76.82,0.1
152,2021-02-28,LAZ,10263,4017,6246,9657,515,91,ITI,ITI4,12,Lazio,Lazio,5879082,4526549,76.99,0.17
153,2021-01-02,LAZ,6708,2631,4077,6628,0,80,ITI,ITI4,12,Lazio,Lazio,5879082,4533257,77.11,0.11
154,2021-01-05,LAZ,7375,2803,4572,7273,0,102,ITI,ITI4,12,Lazio,Lazio,5879082,4540632,77.23,0.13
155,2021-01-24,LAZ,5697,2229,3468,613,5084,0,ITI,ITI4,12,Lazio,Lazio,5879082,4546329,77.33,0.1
156,2021-02-07,LAZ,4944,2026,2918,386,4557,1,ITI,ITI4,12,Lazio,Lazio,5879082,4551273,77.41,0.08
157,2021-05-18,LAZ,44926,20545,24381,34813,9543,570,ITI,ITI4,12,Lazio,Lazio,5879082,4596199,78.18,0.76
158,2021-05-03,LAZ,39225,17708,21517,26037,12609,579,ITI,ITI4,12,Lazio,Lazio,5879082,4635424,78.85,0.67
159,2021-02-17,LAZ,9188,4608,4580,8246,877,65,ITI,ITI4,12,Lazio,Lazio,5879082,4644612,79.0,0.16
160,2021-05-28,LAZ,57030,26491,30539,42970,13262,798,ITI,ITI4,12,Lazio,Lazio,5879082,4701642,79.97,0.97
161,2021-03-06,LAZ,18357,7083,11274,13891,4257,209,ITI,ITI4,12,Lazio,Lazio,5879082,4719999,80.28,0.31
162,2021-01-21,LAZ,5603,2348,3255,550,5053,0,ITI,ITI4,12,Lazio,Lazio,5879082,4725602,80.38,0.1
163,2021-03-31,LAZ,27654,13347,14307,20243,7098,313,ITI,ITI4,12,Lazio,Lazio,5879082,4753256,80.85,0.47
164,2021-01-07,LAZ,7752,2904,4848,7595,0,157,ITI,ITI4,12,Lazio,Lazio,5879082,4761008,80.98,0.13
165,2021-06-22,LAZ,62488,28835,33653,28513,33305,670,ITI,ITI4,12,Lazio,Lazio,5879082,4823496,82.05,1.06
166,2021-03-14,LAZ,17240,6754,10486,11838,5154,248,ITI,ITI4,12,Lazio,Lazio,5879082,4840736,82.34,0.29
167,2021-01-31,LAZ,4461,1855,2606,477,3983,1,ITI,ITI4,12,Lazio,Lazio,5879082,4845197,82.41,0.08
168,2021-05-11,LAZ,48287,22173,26114,31152,16541,594,ITI,ITI4,12,Lazio,Lazio,5879082,4893484,83.24,0.82
169,2021-04-24,LAZ,33428,15079,18349,20163,12777,488,ITI,ITI4,12,Lazio,Lazio,5879082,4926912,83.8,0.57
170,2021-05-30,LAZ,41206,17634,23572,33180,7353,673,ITI,ITI4,12,Lazio,Lazio,5879082,4968118,84.5,0.7
171,2021-05-13,LAZ,50123,22521,27602,31661,17786,676,ITI,ITI4,12,Lazio,Lazio,5879082,5018241,85.36,0.85
172,2021-06-29,LAZ,59254,28167,31087,27648,31051,555,ITI,ITI4,12,Lazio,Lazio,5879082,5077495,86.37,1.01
173,2021-01-14,LAZ,5489,2146,3343,5315,0,174,ITI,ITI4,12,Lazio,Lazio,5879082,5082984,86.46,0.09
174,2021-04-07,LAZ,25865,12056,13809,18227,7314,324,ITI,ITI4,12,Lazio,Lazio,5879082,5108849,86.9,0.44
175,2020-12-28,LAZ,959,412,547,954,0,5,ITI,ITI4,12,Lazio,Lazio,5879082,5109808,86.92,0.02
176,2021-01-16,LAZ,5645,2281,3364,5499,0,146,ITI,ITI4,12,Lazio,Lazio,5879082,5115453,87.01,0.1
177,2021-04-26,LAZ,29241,13464,15777,19599,9204,438,ITI,ITI4,12,Lazio,Lazio,5879082,5144694,87.51,0.5
178,2021-02-02,LAZ,5911,2213,3698,636,5272,3,ITI,ITI4,12,Lazio,Lazio,5879082,5150605,87.61,0.1
179,2021-05-23,LAZ,47089,22845,24244,39034,7382,673,ITI,ITI4,12,Lazio,Lazio,5879082,5197694,88.41,0.8
180,2021-05-09,LAZ,37541,17259,20282,25822,11273,446,ITI,ITI4,12,Lazio,Lazio,5879082,5235235,89.05,0.64
181,2021-05-16,LAZ,50934,24525,26409,36894,13488,552,ITI,ITI4,12,Lazio,Lazio,5879082,5286169,89.91,0.87
182,2021-06-28,LAZ,58710,28047,30663,27445,30853,412,ITI,ITI4,12,Lazio,Lazio,5879082,5344879,90.91,1.0
183,2021-02-12,LAZ,6848,2849,3999,6353,416,79,ITI,ITI4,12,Lazio,Lazio,5879082,5351727,91.03,0.12
184,2020-12-31,LAZ,5293,2121,3172,5233,0,60,ITI,ITI4,12,Lazio,Lazio,5879082,5357020,91.12,0.09
185,2021-04-10,LAZ,23931,10409,13522,16496,7190,245,ITI,ITI4,12,Lazio,Lazio,5879082,5380951,91.53,0.41
186,2021-02-05,LAZ,7309,2979,4330,1208,6099,2,ITI,ITI4,12,Lazio,Lazio,5879082,5388260,91.65,0.12
187,2021-04-03,LAZ,24787,11186,13601,17876,6700,211,ITI,ITI4,12,Lazio,Lazio,5879082,5413047,92.07,0.42
188,2021-02-19,LAZ,10044,5079,4965,9073,832,139,ITI,ITI4,12,Lazio,Lazio,5879082,5423091,92.24,0.17
189,2021-06-17,LAZ,66539,31937,34602,31647,34206,686,ITI,ITI4,12,Lazio,Lazio,5879082,5489630,93.38,1.13
190,2021-04-21,LAZ,33039,15015,18024,20297,12375,367,ITI,ITI4,12,Lazio,Lazio,5879082,5522669,93.94,0.56
191,2021-06-03,LAZ,56338,28497,27841,37970,17689,679,ITI,ITI4,12,Lazio,Lazio,5879082,5579007,94.9,0.96
192,2021-06-10,LAZ,71573,33779,37794,36956,33826,791,ITI,ITI4,12,Lazio,Lazio,5879082,5650580,96.11,1.22
193,2021-04-14,LAZ,29313,13287,16026,18880,10123,310,ITI,ITI4,12,Lazio,Lazio,5879082,5679893,96.61,0.5
194,2021-06-21,EMR,37512,18966,18546,16404,20861,247,ITH,ITH5,8,Emilia-Romagna,Emilia-Romagna,4459477,37512,0.84,0.84
195,2021-07-08,EMR,12127,6063,6064,1334,10730,63,ITH,ITH5,8,Emilia-Romagna,Emilia-Romagna,4459477,49639,1.11,0.27
196,2021-03-30,EMR,23345,10338,13007,18005,5041,299,ITH,ITH5,8,Emilia-Romagna,Emilia-Romagna,4459477,72984,1.64,0.52
197,2021-01-04,EMR,7315,2527,4788,7312,0,3,ITH,ITH5,8,Emilia-Romagna,Emilia-Romagna,4459477,80299,1.8,0.16
198,2021-05-12,EMR,38902,18286,20616,28372,9675,855,ITH,ITH5,8,Emilia-Romagna,Emilia-Romagna,4459477,119201,2.67,0.87
199,2021-02-01,EMR,10320,3610,6710,360,9958,2,ITH,ITH5,8,Emilia-Romagna,Emilia-Romagna,4459477,129521,2.9,0.23
200,2021-01-18,EMR,3128,879,2249,2446,679,3,ITH,ITH5,8,Emilia-Romagna,Emilia-Romagna,4459477,132649,2.97,0.07
201,2021-03-16,EMR,12246,5027,7219,4871,7309,66,ITH,ITH5,8,Emilia-Romagna,Emilia-Romagna,4459477,144895,3.25,0.27
202,2021-01-25,EMR,6462,2146,4316,206,6255,1,ITH,ITH5,8,Emilia-Romagna,Emilia-Romagna,4459477,151357,3.39,0.14
203,2021-07-01,EMR,34394,16806,17588,15330,18755,309,ITH,ITH5,8,Emilia-Romagna,Emilia-Romagna,4459477,185751,4.17,0.77
204,2021-03-23,EMR,18797,8144,10653,11951,6687,159,ITH,ITH5,8,Emilia-Romagna,Emilia-Romagna,4459477,204548,4.59,0.42
205,2021-04-11,EMR,15278,6935,8343,11979,3048,251,ITH,ITH5,8,Emilia-Romagna,Emilia-Romagna,4459477,219826,4.93,0.34
206,2021-02-11,EMR,4255,1415,2840,3397,842,16,ITH,ITH5,8,Emilia-Romagna,Emilia-Romagna,4459477,224081,5.02,0.1
207,2021-02-18,EMR,7039,2892,4147,6440,583,16,ITH,ITH5,8,Emilia-Romagna,Emilia-Romagna,4459477,231120,5.18,0.16
208,2021-06-07,EMR,40420,20745,19675,33809,6246,365,ITH,ITH5,8,Emilia-Romagna,Emilia-Romagna,4459477,271540,6.09,0.91
209,2021-04-16,EMR,29229,13763,15466,20019,8838,372,ITH,ITH5,8,Emilia-Romagna,Emilia-Romagna,4459477,300769,6.74,0.66
210,2021-01-06,EMR,8287,2955,5332,8286,0,1,ITH,ITH5,8,Emilia-Romagna,Emilia-Romagna,4459477,309056,6.93,0.19
211,2021-04-30,EMR,36605,16788,19817,21186,14794,625,ITH,ITH5,8,Emilia-Romagna,Emilia-Romagna,4459477,345661,7.75,0.82
212,2021-03-28,EMR,13500,6026,7474,9505,3870,125,ITH,ITH5,8,Emilia-Romagna,Emilia-Romagna,4459477,359161,8.05,0.3
213,2021-02-25,EMR,9249,3499,5750,8273,954,22,ITH,ITH5,8,Emilia-Romagna,Emilia-Romagna,4459477,368410,8.26,0.21
214,2021-06-19,EMR,36598,18319,18279,17021,19369,208,ITH,ITH5,8,Emilia-Romagna,Emilia-Romagna,4459477,405008,9.08,0.82
215,2021-03-11,EMR,17453,7306,10147,11431,5851,171,ITH,ITH5,8,Emilia-Romagna,Emilia-Romagna,4459477,422461,9.47,0.39
216,2021-01-23,EMR,2448,871,1577,443,2005,0,ITH,ITH5,8,Emilia-Romagna,Emilia-Romagna,4459477,424909,9.53,0.05
217,2021-05-07,EMR,35272,16962,18310,22724,11856,692,ITH,ITH5,8,Emilia-Romagna,Emilia-Romagna,4459477,460181,10.32,0.79
218,2021-07-03,EMR,31991,15864,16127,11774,19926,291,ITH,ITH5,8,Emilia-Romagna,Emilia-Romagna,4459477,492172,11.04,0.72
219,2021-01-30,EMR,10079,3520,6559,140,9938,1,ITH,ITH5,8,Emilia-Romagna,Emilia-Romagna,4459477,502251,11.26,0.23
220,2021-04-23,EMR,29562,13811,15751,14287,14882,393,ITH,ITH5,8,Emilia-Romagna,Emilia-Romagna,4459477,531813,11.93,0.66
221,2021-01-13,EMR,9077,2942,6135,9072,0,5,ITH,ITH5,8,Emilia-Romagna,Emilia-Romagna,4459477,540890,12.13,0.2
222,2021-05-26,EMR,33224,14730,18494,9923,22924,377,ITH,ITH5,8,Emilia-Romagna,Emilia-Romagna,4459477,574114,12.87,0.75
223,2021-06-12,EMR,41249,21812,19437,35777,4910,562,ITH,ITH5,8,Emilia-Romagna,Emilia-Romagna,4459477,615363,13.8,0.92
224,2021-03-04,EMR,16452,5350,11102,13344,3017,91,ITH,ITH5,8,Emilia-Romagna,Emilia-Romagna,4459477,631815,14.17,0.37
225,2021-05-24,EMR,29946,13715,16231,17949,11478,519,ITH,ITH5,8,Emilia-Romagna,Emilia-Romagna,4459477,661761,14.84,0.67
226,2021-02-13,EMR,3627,1084,2543,3014,598,15,ITH,ITH5,8,Emilia-Romagna,Emilia-Romagna,4459477,665388,14.92,0.08
227,2021-05-19,EMR,33720,14961,18759,18024,15175,521,ITH,ITH5,8,Emilia-Romagna,Emilia-Romagna,4459477,699108,15.68,0.76
228,2021-06-02,EMR,24090,12060,12030,18916,4968,206,ITH,ITH5,8,Emilia-Romagna,Emilia-Romagna,4459477,723198,16.22,0.54
229,2021-03-13,EMR,16136,6361,9775,10586,5313,237,ITH,ITH5,8,Emilia-Romagna,Emilia-Romagna,4459477,739334,16.58,0.36
230,2021-07-05,EMR,32977,16073,16904,11400,21263,314,ITH,ITH5,8,Emilia-Romagna,Emilia-Romagna,4459477,772311,17.32,0.74
231,2021-03-27,EMR,21661,9059,12602,14508,6908,245,ITH,ITH5,8,Emilia-Romagna,Emilia-Romagna,4459477,793972,17.8,0.49
232,2021-04-13,EMR,23713,11127,12586,19023,4342,348,ITH,ITH5,8,Emilia-Romagna,Emilia-Romagna,4459477,817685,18.34,0.53
233,2021-03-09,EMR,14754,6019,8735,10706,3953,95,ITH,ITH5,8,Emilia-Romagna,Emilia-Romagna,4459477,832439,18.67,0.33
234,2021-05-05,EMR,30092,13985,16107,18268,11250,574,ITH,ITH5,8,Emilia-Romagna,Emilia-Romagna,4459477,862531,19.34,0.67
235,2021-05-23,EMR,25480,11859,13621,13575,11592,313,ITH,ITH5,8,Emilia-Romagna,Emilia-Romagna,4459477,888011,19.91,0.57
236,2021-04-18,EMR,17504,8396,9108,12359,4918,227,ITH,ITH5,8,Emilia-Romagna,Emilia-Romagna,4459477,905515,20.31,0.39
237,2021-06-14,EMR,41214,21297,19917,27706,13059,449,ITH,ITH5,8,Emilia-Romagna,Emilia-Romagna,4459477,946729,21.23,0.92
238,2021-01-10,EMR,7171,2684,4487,7170,0,1,ITH,ITH5,8,Emilia-Romagna,Emilia-Romagna,4459477,953900,21.39,0.16
239,2021-06-16,EMR,45668,23336,22332,25374,19905,389,ITH,ITH5,8,Emilia-Romagna,Emilia-Romagna,4459477,999568,22.41,1.02
240,2021-03-08,EMR,12190,5092,7098,9465,2646,79,ITH,ITH5,8,Emilia-Romagna,Emilia-Romagna,4459477,1011758,22.69,0.27
241,2021-05-31,EMR,29734,13753,15981,17718,11467,549,ITH,ITH5,8,Emilia-Romagna,Emilia-Romagna,4459477,1041492,23.35,0.67
242,2021-02-20,EMR,5319,2094,3225,5049,263,7,ITH,ITH5,8,Emilia-Romagna,Emilia-Romagna,4459477,1046811,23.47,0.12
243,2021-01-15,EMR,7750,2404,5346,7742,0,8,ITH,ITH5,8,Emilia-Romagna,Emilia-Romagna,4459477,1054561,23.65,0.17
244,2021-06-09,EMR,42944,21824,21120,36080,6360,504,ITH,ITH5,8,Emilia-Romagna,Emilia-Romagna,4459477,1097505,24.61,0.96
245,2021-03-01,EMR,10096,3582,6514,7813,2258,25,ITH,ITH5,8,Emilia-Romagna,Emilia-Romagna,4459477,1107601,24.84,0.23
246,2021-05-04,EMR,29274,13704,15570,15119,13659,496,ITH,ITH5,8,Emilia-Romagna,Emilia-Romagna,4459477,1136875,25.49,0.66
247,2021-02-06,EMR,7594,2404,5190,2105,5485,4,ITH,ITH5,8,Emilia-Romagna,Emilia-Romagna,4459477,1144469,25.66,0.17
248,2021-06-26,EMR,37374,18937,18437,21503,15481,390,ITH,ITH5,8,Emilia-Romagna,Emilia-Romagna,4459477,1181843,26.5,0.84
249,2021-04-04,EMR,9879,4717,5162,7525,2267,87,ITH,ITH5,8,Emilia-Romagna,Emilia-Romagna,4459477,1191722,26.72,0.22
250,2021-01-11,EMR,9347,3273,6074,9338,0,9,ITH,ITH5,8,Emilia-Romagna,Emilia-Romagna,4459477,1201069,26.93,0.21
251,2021-05-09,EMR,25609,12252,13357,18228,6967,414,ITH,ITH5,8,Emilia-Romagna,Emilia-Romagna,4459477,1226678,27.51,0.57
252,2021-01-29,EMR,10414,3496,6918,289,10124,1,ITH,ITH5,8,Emilia-Romagna,Emilia-Romagna,4459477,1237092,27.74,0.23
253,2021-02-15,EMR,2904,851,2053,2712,125,67,ITH,ITH5,8,Emilia-Romagna,Emilia-Romagna,4459477,1239996,27.81,0.07
254,2021-01-27,EMR,8361,2947,5414,462,7899,0,ITH,ITH5,8,Emilia-Romagna,Emilia-Romagna,4459477,1248357,27.99,0.19
255,2021-01-03,EMR,2763,943,1820,2763,0,0,ITH,ITH5,8,Emilia-Romagna,Emilia-Romagna,4459477,1251120,28.06,0.06
256,2021-05-02,EMR,25578,11651,13927,13185,11990,403,ITH,ITH5,8,Emilia-Romagna,Emilia-Romagna,4459477,1276698,28.63,0.57
257,2021-01-22,EMR,1829,477,1352,1086,741,2,ITH,ITH5,8,Emilia-Romagna,Emilia-Romagna,4459477,1278527,28.67,0.04
258,2021-02-08,EMR,5231,1534,3697,2315,2913,3,ITH,ITH5,8,Emilia-Romagna,Emilia-Romagna,4459477,1283758,28.79,0.12
259,2021-05-16,EMR,25845,12168,13677,18354,7112,379,ITH,ITH5,8,Emilia-Romagna,Emilia-Romagna,4459477,1309603,29.37,0.58
260,2021-02-22,EMR,7482,3091,4391,7197,272,13,ITH,ITH5,8,Emilia-Romagna,Emilia-Romagna,4459477,1317085,29.53,0.17
261,2021-04-20,EMR,22621,10404,12217,13869,8353,399,ITH,ITH5,8,Emilia-Romagna,Emilia-Romagna,4459477,1339706,30.04,0.51
262,2021-06-23,EMR,37723,18875,18848,18627,18817,279,ITH,ITH5,8,Emilia-Romagna,Emilia-Romagna,4459477,1377429,30.89,0.85
263,2021-01-08,EMR,10866,3580,7286,10863,0,3,ITH,ITH5,8,Emilia-Romagna,Emilia-Romagna,4459477,1388295,31.13,0.24
264,2021-03-06,EMR,20905,5938,14967,18047,2735,123,ITH,ITH5,8,Emilia-Romagna,Emilia-Romagna,4459477,1409200,31.6,0.47
265,2021-05-20,EMR,40269,18310,21959,18403,21370,496,ITH,ITH5,8,Emilia-Romagna,Emilia-Romagna,4459477,1449469,32.5,0.9
266,2021-06-25,EMR,42437,21491,20946,19792,22232,413,ITH,ITH5,8,Emilia-Romagna,Emilia-Romagna,4459477,1491906,33.45,0.95
267,2021-03-17,EMR,13718,5692,8026,5814,7846,58,ITH,ITH5,8,Emilia-Romagna,Emilia-Romagna,4459477,1505624,33.76,0.31
268,2021-05-13,EMR,35785,16494,19291,27248,7797,740,ITH,ITH5,8,Emilia-Romagna,Emilia-Romagna,4459477,1541409,34.56,0.8
269,2021-02-27,EMR,10961,3998,6963,9192,1738,31,ITH,ITH5,8,Emilia-Romagna,Emilia-Romagna,4459477,1552370,34.81,0.25
270,2021-04-25,EMR,22349,10239,12110,14386,7511,452,ITH,ITH5,8,Emilia-Romagna,Emilia-Romagna,4459477,1574719,35.31,0.5
271,2021-04-27,EMR,32101,14863,17238,19194,12461,446,ITH,ITH5,8,Emilia-Romagna,Emilia-Romagna,4459477,1606820,36.03,0.72
272,2021-06-04,EMR,45584,22957,22627,37102,8132,350,ITH,ITH5,8,Emilia-Romagna,Emilia-Romagna,4459477,1652404,37.05,1.02
273,2021-01-20,EMR,1326,270,1056,1324,1,1,ITH,ITH5,8,Emilia-Romagna,Emilia-Romagna,4459477,1653730,37.08,0.03
274,2021-04-15,EMR,29345,13980,15365,19236,9674,435,ITH,ITH5,8,Emilia-Romagna,Emilia-Romagna,4459477,1683075,37.74,0.66
275,2021-06-18,EMR,42407,21211,21196,16371,25781,255,ITH,ITH5,8,Emilia-Romagna,Emilia-Romagna,4459477,1725482,38.69,0.95
276,2021-03-10,EMR,18799,7741,11058,12975,5645,179,ITH,ITH5,8,Emilia-Romagna,Emilia-Romagna,4459477,1744281,39.11,0.42
277,2021-05-18,EMR,29101,13247,15854,18089,10525,487,ITH,ITH5,8,Emilia-Romagna,Emilia-Romagna,4459477,1773382,39.77,0.65
278,2021-02-07,EMR,4785,1536,3249,1722,3061,2,ITH,ITH5,8,Emilia-Romagna,Emilia-Romagna,4459477,1778167,39.87,0.11
279,2021-02-24,EMR,9351,3566,5785,8450,884,17,ITH,ITH5,8,Emilia-Romagna,Emilia-Romagna,4459477,1787518,40.08,0.21
280,2021-01-05,EMR,9361,3170,6191,9357,0,4,ITH,ITH5,8,Emilia-Romagna,Emilia-Romagna,4459477,1796879,40.29,0.21
281,2021-04-29,EMR,44951,21134,23817,26591,17548,812,ITH,ITH5,8,Emilia-Romagna,Emilia-Romagna,4459477,1841830,41.3,1.01
282,2021-01-19,EMR,2046,505,1541,2028,17,1,ITH,ITH5,8,Emilia-Romagna,Emilia-Romagna,4459477,1843876,41.35,0.05
283,2021-05-28,EMR,41183,18934,22249,17259,23333,591,ITH,ITH5,8,Emilia-Romagna,Emilia-Romagna,4459477,1885059,42.27,0.92
284,2021-04-22,EMR,29052,13452,15600,14598,14077,377,ITH,ITH5,8,Emilia-Romagna,Emilia-Romagna,4459477,1914111,42.92,0.65
285,2021-01-12,EMR,9476,3124,6352,9466,0,10,ITH,ITH5,8,Emilia-Romagna,Emilia-Romagna,4459477,1923587,43.13,0.21
286,2021-06-27,EMR,29492,14829,14663,16520,12679,293,ITH,ITH5,8,Emilia-Romagna,Emilia-Romagna,4459477,1953079,43.8,0.66
287,2021-04-05,EMR,14848,6802,8046,11779,2892,177,ITH,ITH5,8,Emilia-Romagna,Emilia-Romagna,4459477,1967927,44.13,0.33
288,2021-05-06,EMR,35927,16602,19325,22155,13056,716,ITH,ITH5,8,Emilia-Romagna,Emilia-Romagna,4459477,2003854,44.93,0.81
289,2021-01-26,EMR,8334,3000,5334,213,8120,1,ITH,ITH5,8,Emilia-Romagna,Emilia-Romagna,4459477,2012188,45.12,0.19
290,2021-07-02,EMR,34575,16994,17581,12647,21602,326,ITH,ITH5,8,Emilia-Romagna,Emilia-Romagna,4459477,2046763,45.9,0.78
291,2021-03-24,EMR,21219,9401,11818,13618,7382,219,ITH,ITH5,8,Emilia-Romagna,Emilia-Romagna,4459477,2067982,46.37,0.48
292,2021-01-24,EMR,2443,885,1558,298,2145,0,ITH,ITH5,8,Emilia-Romagna,Emilia-Romagna,4459477,2070425,46.43,0.05
293,2021-01-17,EMR,2890,887,2003,2643,246,1,ITH,ITH5,8,Emilia-Romagna,Emilia-Romagna,4459477,2073315,46.49,0.06
294,2021-04-02,EMR,23394,10552,12842,18557,4481,356,ITH,ITH5,8,Emilia-Romagna,Emilia-Romagna,4459477,2096709,47.02,0.52
295,2021-05-29,EMR,37838,16496,21342,16638,20676,524,ITH,ITH5,8,Emilia-Romagna,Emilia-Romagna,4459477,2134547,47.87,0.85
296,2021-03-31,EMR,25265,11043,14222,19490,5454,321,ITH,ITH5,8,Emilia-Romagna,Emilia-Romagna,4459477,2159812,48.43,0.57
297,2021-07-04,EMR,24115,11984,12131,10413,13491,211,ITH,ITH5,8,Emilia-Romagna,Emilia-Romagna,4459477,2183927,48.97,0.54
298,2021-03-26,EMR,23704,10110,13594,16997,6437,270,ITH,ITH5,8,Emilia-Romagna,Emilia-Romagna,4459477,2207631,49.5,0.53
299,2021-05-01,EMR,28402,12774,15628,15266,12776,360,ITH,ITH5,8,Emilia-Romagna,Emilia-Romagna,4459477,2236033,50.14,0.64
300,2021-07-07,EMR,35666,18025,17641,13796,21623,247,ITH,ITH5,8,Emilia-Romagna,Emilia-Romagna,4459477,2271699,50.94,0.8
301,2021-03-29,EMR,21424,9613,11811,16535,4650,239,ITH,ITH5,8,Emilia-Romagna,Emilia-Romagna,4459477,2293123,51.42,0.48
302,2021-02-21,EMR,4450,1708,2742,4000,440,10,ITH,ITH5,8,Emilia-Romagna,Emilia-Romagna,4459477,2297573,51.52,0.1
303,2021-03-15,EMR,13444,6244,7200,6849,6499,96,ITH,ITH5,8,Emilia-Romagna,Emilia-Romagna,4459477,2311017,51.82,0.3
304,2021-02-09,EMR,4154,1249,2905,2306,1847,1,ITH,ITH5,8,Emilia-Romagna,Emilia-Romagna,4459477,2315171,51.92,0.09
305,2021-05-15,EMR,33249,14982,18267,22193,10408,648,ITH,ITH5,8,Emilia-Romagna,Emilia-Romagna,4459477,2348420,52.66,0.75
306,2021-02-04,EMR,9920,3201,6719,1229,8690,1,ITH,ITH5,8,Emilia-Romagna,Emilia-Romagna,4459477,2358340,52.88,0.22
307,2021-05-22,EMR,33049,14136,18913,16453,16136,460,ITH,ITH5,8,Emilia-Romagna,Emilia-Romagna,4459477,2391389,53.62,0.74
308,2021-04-09,EMR,25723,11666,14057,19526,5697,500,ITH,ITH5,8,Emilia-Romagna,Emilia-Romagna,4459477,2417112,54.2,0.58
309,2021-02-02,EMR,9474,3048,6426,515,8959,0,ITH,ITH5,8,Emilia-Romagna,Emilia-Romagna,4459477,2426586,54.41,0.21
310,2021-02-12,EMR,5313,1673,3640,3886,1403,24,ITH,ITH5,8,Emilia-Romagna,Emilia-Romagna,4459477,2431899,54.53,0.12
311,2021-04-10,EMR,20921,9300,11621,16445,4143,333,ITH,ITH5,8,Emilia-Romagna,Emilia-Romagna,4459477,2452820,55.0,0.47
312,2021-04-17,EMR,27298,13073,14225,17558,9345,395,ITH,ITH5,8,Emilia-Romagna,Emilia-Romagna,4459477,2480118,55.61,0.61
313,2021-01-07,EMR,10274,3406,6868,10270,0,4,ITH,ITH5,8,Emilia-Romagna,Emilia-Romagna,4459477,2490392,55.84,0.23
314,2021-04-03,EMR,19940,8767,11173,15955,3740,245,ITH,ITH5,8,Emilia-Romagna,Emilia-Romagna,4459477,2510332,56.29,0.45
315,2021-05-30,EMR,27075,12792,14283,12975,13693,407,ITH,ITH5,8,Emilia-Romagna,Emilia-Romagna,4459477,2537407,56.9,0.61
316,2021-02-19,EMR,7327,3010,4317,6800,514,13,ITH,ITH5,8,Emilia-Romagna,Emilia-Romagna,4459477,2544734,57.06,0.16
317,2020-12-31,EMR,2215,780,1435,2214,0,1,ITH,ITH5,8,Emilia-Romagna,Emilia-Romagna,4459477,2546949,57.11,0.05
318,2021-06-06,EMR,36551,18979,17572,31950,4406,195,ITH,ITH5,8,Emilia-Romagna,Emilia-Romagna,4459477,2583500,57.93,0.82
319,2021-02-26,EMR,9634,3673,5961,8566,1048,20,ITH,ITH5,8,Emilia-Romagna,Emilia-Romagna,4459477,2593134,58.15,0.22
320,2021-04-24,EMR,28634,13242,15392,14035,14230,369,ITH,ITH5,8,Emilia-Romagna,Emilia-Romagna,4459477,2621768,58.79,0.64
321,2021-05-11,EMR,35780,16793,18987,27764,7254,762,ITH,ITH5,8,Emilia-Romagna,Emilia-Romagna,4459477,2657548,59.59,0.8
322,2021-01-31,EMR,7698,2763,4935,241,7457,0,ITH,ITH5,8,Emilia-Romagna,Emilia-Romagna,4459477,2665246,59.77,0.17
323,2021-06-29,EMR,37517,18493,19024,18519,18677,321,ITH,ITH5,8,Emilia-Romagna,Emilia-Romagna,4459477,2702763,60.61,0.84
324,2021-03-21,EMR,11956,5296,6660,7261,4605,90,ITH,ITH5,8,Emilia-Romagna,Emilia-Romagna,4459477,2714719,60.88,0.27
325,2021-06-10,EMR,44899,23060,21839,39002,5348,549,ITH,ITH5,8,Emilia-Romagna,Emilia-Romagna,4459477,2759618,61.88,1.01
326,2021-03-02,EMR,12659,4272,8387,10527,2077,55,ITH,ITH5,8,Emilia-Romagna,Emilia-Romagna,4459477,2772277,62.17,0.28
327,2021-03-19,EMR,15925,6972,8953,7799,7969,157,ITH,ITH5,8,Emilia-Romagna,Emilia-Romagna,4459477,2788202,62.52,0.36
328,2021-04-07,EMR,26116,11890,14226,19790,6011,315,ITH,ITH5,8,Emilia-Romagna,Emilia-Romagna,4459477,2814318,63.11,0.59
329,2021-01-14,EMR,8129,2593,5536,8119,0,10,ITH,ITH5,8,Emilia-Romagna,Emilia-Romagna,4459477,2822447,63.29,0.18
330,2021-04-28,EMR,33715,15588,18127,20243,12887,585,ITH,ITH5,8,Emilia-Romagna,Emilia-Romagna,4459477,2856162,64.05,0.76
331,2021-06-24,EMR,40149,20078,20071,20251,19539,359,ITH,ITH5,8,Emilia-Romagna,Emilia-Romagna,4459477,2896311,64.95,0.9
332,2021-06-17,EMR,46267,23390,22877,21779,24136,352,ITH,ITH5,8,Emilia-Romagna,Emilia-Romagna,4459477,2942578,65.98,1.04
333,2021-02-05,EMR,9290,2956,6334,1601,7683,6,ITH,ITH5,8,Emilia-Romagna,Emilia-Romagna,4459477,2951868,66.19,0.21
334,2021-06-20,EMR,30703,15581,15122,15932,14645,126,ITH,ITH5,8,Emilia-Romagna,Emilia-Romagna,4459477,2982571,66.88,0.69
335,2021-06-30,EMR,34182,17253,16929,18227,15631,324,ITH,ITH5,8,Emilia-Romagna,Emilia-Romagna,4459477,3016753,67.65,0.77
336,2021-06-11,EMR,45746,23758,21988,38670,6497,579,ITH,ITH5,8,Emilia-Romagna,Emilia-Romagna,4459477,3062499,68.67,1.03
337,2021-06-28,EMR,39953,19601,20352,20005,19506,442,ITH,ITH5,8,Emilia-Romagna,Emilia-Romagna,4459477,3102452,69.57,0.9
338,2021-03-20,EMR,16085,6829,9256,8955,6964,166,ITH,ITH5,8,Emilia-Romagna,Emilia-Romagna,4459477,3118537,69.93,0.36
339,2021-04-06,EMR,24745,11172,13573,19718,4742,285,ITH,ITH5,8,Emilia-Romagna,Emilia-Romagna,4459477,3143282,70.49,0.55
340,2020-12-27,EMR,972,373,599,972,0,0,ITH,ITH5,8,Emilia-Romagna,Emilia-Romagna,4459477,3144254,70.51,0.02
341,2021-01-02,EMR,2375,916,1459,2375,0,0,ITH,ITH5,8,Emilia-Romagna,Emilia-Romagna,4459477,3146629,70.56,0.05
342,2021-06-05,EMR,44164,22325,21839,36869,6866,429,ITH,ITH5,8,Emilia-Romagna,Emilia-Romagna,4459477,3190793,71.55,0.99
343,2021-06-22,EMR,35972,17899,18073,16312,19403,257,ITH,ITH5,8,Emilia-Romagna,Emilia-Romagna,4459477,3226765,72.36,0.81
344,2021-07-06,EMR,35812,17997,17815,12949,22585,278,ITH,ITH5,8,Emilia-Romagna,Emilia-Romagna,4459477,3262577,73.16,0.8
345,2021-05-17,EMR,32395,15389,17006,22364,9491,540,ITH,ITH5,8,Emilia-Romagna,Emilia-Romagna,4459477,3294972,73.89,0.73
346,2021-04-14,EMR,27043,12844,14199,20511,6104,428,ITH,ITH5,8,Emilia-Romagna,Emilia-Romagna,4459477,3322015,74.49,0.61
347,2021-01-21,EMR,2165,729,1436,819,1346,0,ITH,ITH5,8,Emilia-Romagna,Emilia-Romagna,4459477,3324180,74.54,0.05
348,2021-06-03,EMR,37863,18420,19443,30053,7513,297,ITH,ITH5,8,Emilia-Romagna,Emilia-Romagna,4459477,3362043,75.39,0.85
349,2021-02-23,EMR,8216,3219,4997,7819,386,11,ITH,ITH5,8,Emilia-Romagna,Emilia-Romagna,4459477,3370259,75.58,0.18
350,2021-03-12,EMR,18306,7701,10605,11305,6717,284,ITH,ITH5,8,Emilia-Romagna,Emilia-Romagna,4459477,3388565,75.99,0.41
351,2021-06-13,EMR,28688,14960,13728,24109,4270,309,ITH,ITH5,8,Emilia-Romagna,Emilia-Romagna,4459477,3417253,76.63,0.64
352,2021-03-05,EMR,17864,5842,12022,14290,3454,120,ITH,ITH5,8,Emilia-Romagna,Emilia-Romagna,4459477,3435117,77.03,0.4
353,2021-03-22,EMR,17647,7814,9833,10617,6862,168,ITH,ITH5,8,Emilia-Romagna,Emilia-Romagna,4459477,3452764,77.43,0.4
354,2021-03-03,EMR,15857,5253,10604,13320,2485,52,ITH,ITH5,8,Emilia-Romagna,Emilia-Romagna,4459477,3468621,77.78,0.36
355,2021-05-25,EMR,25078,11194,13884,11291,13363,424,ITH,ITH5,8,Emilia-Romagna,Emilia-Romagna,4459477,3493699,78.34,0.56
356,2021-02-14,EMR,1403,378,1025,1275,120,8,ITH,ITH5,8,Emilia-Romagna,Emilia-Romagna,4459477,3495102,78.37,0.03
357,2021-05-27,EMR,42244,18742,23502,13621,28190,433,ITH,ITH5,8,Emilia-Romagna,Emilia-Romagna,4459477,3537346,79.32,0.95
358,2021-02-16,EMR,5772,2446,3326,5227,531,14,ITH,ITH5,8,Emilia-Romagna,Emilia-Romagna,4459477,3543118,79.45,0.13
359,2021-05-10,EMR,33842,16125,17717,26010,7245,587,ITH,ITH5,8,Emilia-Romagna,Emilia-Romagna,4459477,3576960,80.21,0.76
360,2021-04-21,EMR,23959,10963,12996,13846,9744,369,ITH,ITH5,8,Emilia-Romagna,Emilia-Romagna,4459477,3600919,80.75,0.54
361,2021-05-08,EMR,32345,15095,17250,20373,11422,550,ITH,ITH5,8,Emilia-Romagna,Emilia-Romagna,4459477,3633264,81.47,0.73
362,2021-01-28,EMR,10255,3339,6916,348,9907,0,ITH,ITH5,8,Emilia-Romagna,Emilia-Romagna,4459477,3643519,81.7,0.23
363,2021-03-25,EMR,21481,9417,12064,14233,6989,259,ITH,ITH5,8,Emilia-Romagna,Emilia-Romagna,4459477,3665000,82.18,0.48
364,2021-05-21,EMR,39261,17530,21731,21626,17023,612,ITH,ITH5,8,Emilia-Romagna,Emilia-Romagna,4459477,3704261,83.06,0.88
365,2021-02-10,EMR,4023,1385,2638,2761,1256,6,ITH,ITH5,8,Emilia-Romagna,Emilia-Romagna,4459477,3708284,83.16,0.09
366,2021-04-08,EMR,31213,14333,16880,25213,5303,697,ITH,ITH5,8,Emilia-Romagna,Emilia-Romagna,4459477,3739497,83.86,0.7
367,2021-03-18,EMR,13675,5806,7869,5584,8000,91,ITH,ITH5,8,Emilia-Romagna,Emilia-Romagna,4459477,3753172,84.16,0.31
368,2021-05-14,EMR,37253,17168,20085,26746,9608,899,ITH,ITH5,8,Emilia-Romagna,Emilia-Romagna,4459477,3790425,85.0,0.84
369,2021-02-03,EMR,9338,2989,6349,964,8373,1,ITH,ITH5,8,Emilia-Romagna,Emilia-Romagna,4459477,3799763,85.21,0.21
370,2021-04-01,EMR,23948,10771,13177,19064,4546,338,ITH,ITH5,8,Emilia-Romagna,Emilia-Romagna,4459477,3823711,85.74,0.54
371,2021-02-17,EMR,6538,2764,3774,5754,772,12,ITH,ITH5,8,Emilia-Romagna,Emilia-Romagna,4459477,3830249,85.89,0.15
372,2021-06-01,EMR,27133,13085,14048,17050,9893,190,ITH,ITH5,8,Emilia-Romagna,Emilia-Romagna,4459477,3857382,86.5,0.61
373,2021-04-12,EMR,19245,9007,10238,14445,4447,353,ITH,ITH5,8,Emilia-Romagna,Emilia-Romagna,4459477,3876627,86.93,0.43
374,2021-06-08,EMR,44853,22959,21894,37004,7461,388,ITH,ITH5,8,Emilia-Romagna,Emilia-Romagna,4459477,3921480,87.94,1.01
375,2021-04-19,EMR,20900,9796,11104,14317,6273,310,ITH,ITH5,8,Emilia-Romagna,Emilia-Romagna,4459477,3942380,88.4,0.47
376,2021-01-09,EMR,9988,3452,6536,9984,0,4,ITH,ITH5,8,Emilia-Romagna,Emilia-Romagna,4459477,3952368,88.63,0.22
377,2021-06-15,EMR,43578,22454,21124,28001,15026,551,ITH,ITH5,8,Emilia-Romagna,Emilia-Romagna,4459477,3995946,89.61,0.98
378,2021-03-07,EMR,7839,2958,4881,6287,1520,32,ITH,ITH5,8,Emilia-Romagna,Emilia-Romagna,4459477,4003785,89.78,0.18
379,2021-05-03,EMR,28700,13559,15141,17359,10878,463,ITH,ITH5,8,Emilia-Romagna,Emilia-Romagna,4459477,4032485,90.43,0.64
380,2021-02-28,EMR,6819,2527,4292,4955,1845,19,ITH,ITH5,8,Emilia-Romagna,Emilia-Romagna,4459477,4039304,90.58,0.15
381,2021-04-26,EMR,27902,12936,14966,18003,9321,578,ITH,ITH5,8,Emilia-Romagna,Emilia-Romagna,4459477,4067206,91.2,0.63
382,2021-01-16,EMR,5628,1718,3910,5627,0,1,ITH,ITH5,8,Emilia-Romagna,Emilia-Romagna,4459477,4072834,91.33,0.13
383,2021-03-14,EMR,8802,3839,4963,4941,3798,63,ITH,ITH5,8,Emilia-Romagna,Emilia-Romagna,4459477,4081636,91.53,0.2
384,2021-04-18,CAL,5847,2795,3052,4913,913,21,ITF,ITF6,18,Calabria,Calabria,1947131,5847,0.3,0.3
385,2021-04-04,CAL,1571,785,786,1140,421,10,ITF,ITF6,18,Calabria,Calabria,1947131,7418,0.38,0.08
386,2021-06-26,CAL,15558,7186,8372,7552,7939,67,ITF,ITF6,18,Calabria,Calabria,1947131,22976,1.18,0.8
387,2021-06-07,CAL,17996,8417,9579,14710,3209,77,ITF,ITF6,18,Calabria,Calabria,1947131,40972,2.1,0.92
388,2021-02-06,CAL,2912,1341,1571,444,2467,1,ITF,ITF6,18,Calabria,Calabria,1947131,43884,2.25,0.15
389,2021-01-23,CAL,401,186,215,359,42,0,ITF,ITF6,18,Calabria,Calabria,1947131,44285,2.27,0.02
390,2021-03-28,CAL,2691,1231,1460,1565,1122,4,ITF,ITF6,18,Calabria,Calabria,1947131,46976,2.41,0.14
391,2021-06-14,CAL,14333,6494,7839,9620,4637,76,ITF,ITF6,18,Calabria,Calabria,1947131,61309,3.15,0.74
392,2021-03-04,CAL,5483,3191,2292,4666,797,20,ITF,ITF6,18,Calabria,Calabria,1947131,66792,3.43,0.28
393,2021-06-12,CAL,13221,6290,6931,10752,2406,63,ITF,ITF6,18,Calabria,Calabria,1947131,80013,4.11,0.68
394,2021-02-25,CAL,2892,1557,1335,2256,596,40,ITF,ITF6,18,Calabria,Calabria,1947131,82905,4.26,0.15
395,2021-01-06,CAL,933,504,429,933,0,0,ITF,ITF6,18,Calabria,Calabria,1947131,83838,4.31,0.05
396,2021-04-16,CAL,10209,4975,5234,8572,1584,53,ITF,ITF6,18,Calabria,Calabria,1947131,94047,4.83,0.52
397,2021-02-18,CAL,1851,850,1001,1608,228,15,ITF,ITF6,18,Calabria,Calabria,1947131,95898,4.93,0.1
398,2021-06-21,CAL,15347,7058,8289,7977,7335,35,ITF,ITF6,18,Calabria,Calabria,1947131,111245,5.71,0.79
399,2021-01-04,CAL,1068,529,539,1065,0,3,ITF,ITF6,18,Calabria,Calabria,1947131,112313,5.77,0.05
400,2021-01-11,CAL,2171,1050,1121,2169,0,2,ITF,ITF6,18,Calabria,Calabria,1947131,114484,5.88,0.11
401,2021-01-25,CAL,1077,516,561,148,929,0,ITF,ITF6,18,Calabria,Calabria,1947131,115561,5.93,0.06
402,2021-05-05,CAL,13536,6473,7063,8409,5056,71,ITF,ITF6,18,Calabria,Calabria,1947131,129097,6.63,0.7
403,2021-03-02,CAL,4368,2492,1876,3604,756,8,ITF,ITF6,18,Calabria,Calabria,1947131,133465,6.85,0.22
404,2021-03-16,CAL,3858,1892,1966,2186,1661,11,ITF,ITF6,18,Calabria,Calabria,1947131,137323,7.05,0.2
405,2021-07-01,CAL,12323,5809,6514,5399,6841,83,ITF,ITF6,18,Calabria,Calabria,1947131,149646,7.69,0.63
406,2021-02-01,CAL,2521,1200,1321,241,2277,3,ITF,ITF6,18,Calabria,Calabria,1947131,152167,7.81,0.13
407,2021-07-08,CAL,5043,2300,2743,1055,3970,18,ITF,ITF6,18,Calabria,Calabria,1947131,157210,8.07,0.26
408,2021-05-12,CAL,16405,8000,8405,10822,5491,92,ITF,ITF6,18,Calabria,Calabria,1947131,173615,8.92,0.84
409,2021-05-26,CAL,18679,9286,9393,10310,8277,92,ITF,ITF6,18,Calabria,Calabria,1947131,192294,9.88,0.96
410,2021-03-09,CAL,6411,3313,3098,5367,981,63,ITF,ITF6,18,Calabria,Calabria,1947131,198705,10.21,0.33
411,2021-02-20,CAL,1437,764,673,1104,319,14,ITF,ITF6,18,Calabria,Calabria,1947131,200142,10.28,0.07
412,2021-05-31,CAL,15275,7329,7946,7312,7882,81,ITF,ITF6,18,Calabria,Calabria,1947131,215417,11.06,0.78
413,2021-04-30,CAL,14985,7348,7637,10551,4366,68,ITF,ITF6,18,Calabria,Calabria,1947131,230402,11.83,0.77
414,2021-01-18,CAL,1295,586,709,1051,240,4,ITF,ITF6,18,Calabria,Calabria,1947131,231697,11.9,0.07
415,2021-05-24,CAL,17712,8843,8869,9933,7696,83,ITF,ITF6,18,Calabria,Calabria,1947131,249409,12.81,0.91
416,2021-05-07,CAL,16116,7594,8522,9657,6385,74,ITF,ITF6,18,Calabria,Calabria,1947131,265525,13.64,0.83
417,2021-02-13,CAL,1398,604,794,1030,365,3,ITF,ITF6,18,Calabria,Calabria,1947131,266923,13.71,0.07
418,2021-06-11,CAL,17814,8756,9058,15115,2584,115,ITF,ITF6,18,Calabria,Calabria,1947131,284737,14.62,0.91
419,2021-01-08,CAL,2178,1038,1140,2171,0,7,ITF,ITF6,18,Calabria,Calabria,1947131,286915,14.74,0.11
420,2021-03-18,CAL,4424,2068,2356,2333,2068,23,ITF,ITF6,18,Calabria,Calabria,1947131,291339,14.96,0.23
421,2021-01-30,CAL,2213,1161,1052,346,1864,3,ITF,ITF6,18,Calabria,Calabria,1947131,293552,15.08,0.11
422,2021-02-17,CAL,1868,826,1042,1644,211,13,ITF,ITF6,18,Calabria,Calabria,1947131,295420,15.17,0.1
423,2021-05-28,CAL,20983,10196,10787,11414,9459,110,ITF,ITF6,18,Calabria,Calabria,1947131,316403,16.25,1.08
424,2021-04-15,CAL,7732,3793,3939,5970,1724,38,ITF,ITF6,18,Calabria,Calabria,1947131,324135,16.65,0.4
425,2021-04-01,CAL,8671,3946,4725,4161,4478,32,ITF,ITF6,18,Calabria,Calabria,1947131,332806,17.09,0.45
426,2021-03-06,CAL,8453,4354,4099,7639,795,19,ITF,ITF6,18,Calabria,Calabria,1947131,341259,17.53,0.43
427,2021-04-23,CAL,13118,6441,6677,9428,3594,96,ITF,ITF6,18,Calabria,Calabria,1947131,354377,18.2,0.67
428,2021-01-13,CAL,2053,1036,1017,2041,0,12,ITF,ITF6,18,Calabria,Calabria,1947131,356430,18.31,0.11
429,2021-06-23,CAL,17117,7811,9306,8092,8944,81,ITF,ITF6,18,Calabria,Calabria,1947131,373547,19.18,0.88
430,2021-02-11,CAL,2340,1044,1296,1062,1256,22,ITF,ITF6,18,Calabria,Calabria,1947131,375887,19.3,0.12
431,2021-05-23,CAL,11387,5552,5835,6995,4349,43,ITF,ITF6,18,Calabria,Calabria,1947131,387274,19.89,0.58
432,2021-03-01,CAL,2728,1548,1180,2269,455,4,ITF,ITF6,18,Calabria,Calabria,1947131,390002,20.03,0.14
433,2021-06-09,CAL,18209,8594,9615,15889,2238,82,ITF,ITF6,18,Calabria,Calabria,1947131,408211,20.96,0.94
434,2021-03-30,CAL,6389,2758,3631,3624,2749,16,ITF,ITF6,18,Calabria,Calabria,1947131,414600,21.29,0.33
435,2021-05-19,CAL,18332,9077,9255,11285,6974,73,ITF,ITF6,18,Calabria,Calabria,1947131,432932,22.23,0.94
436,2021-03-23,CAL,5245,2460,2785,3415,1809,21,ITF,ITF6,18,Calabria,Calabria,1947131,438177,22.5,0.27
437,2021-03-11,CAL,7236,3430,3806,5924,1267,45,ITF,ITF6,18,Calabria,Calabria,1947131,445413,22.88,0.37
438,2021-06-19,CAL,15843,7414,8429,8494,7284,65,ITF,ITF6,18,Calabria,Calabria,1947131,461256,23.69,0.81
439,2021-05-14,CAL,19916,9566,10350,12945,6864,107,ITF,ITF6,18,Calabria,Calabria,1947131,481172,24.71,1.02
440,2021-04-27,CAL,9954,4894,5060,7963,1945,46,ITF,ITF6,18,Calabria,Calabria,1947131,491126,25.22,0.51
441,2021-02-03,CAL,2821,1453,1368,565,2251,5,ITF,ITF6,18,Calabria,Calabria,1947131,493947,25.37,0.14
442,2021-07-03,CAL,15137,7127,8010,5259,9803,75,ITF,ITF6,18,Calabria,Calabria,1947131,509084,26.15,0.78
443,2021-04-11,CAL,4189,1904,2285,2230,1943,16,ITF,ITF6,18,Calabria,Calabria,1947131,513273,26.36,0.22
444,2021-04-13,CAL,6903,3385,3518,5569,1313,21,ITF,ITF6,18,Calabria,Calabria,1947131,520176,26.71,0.35
445,2021-01-20,CAL,1403,627,776,1399,1,3,ITF,ITF6,18,Calabria,Calabria,1947131,521579,26.79,0.07
446,2021-01-03,CAL,6,3,3,6,0,0,ITF,ITF6,18,Calabria,Calabria,1947131,521585,26.79,0.0
447,2021-03-27,CAL,8761,3982,4779,4651,4067,43,ITF,ITF6,18,Calabria,Calabria,1947131,530346,27.24,0.45
448,2021-02-27,CAL,4003,2060,1943,3614,382,7,ITF,ITF6,18,Calabria,Calabria,1947131,534349,27.44,0.21
449,2021-01-27,CAL,1473,744,729,395,1077,1,ITF,ITF6,18,Calabria,Calabria,1947131,535822,27.52,0.08
450,2021-05-09,CAL,9621,4485,5136,6044,3537,40,ITF,ITF6,18,Calabria,Calabria,1947131,545443,28.01,0.49
451,2021-01-29,CAL,2067,996,1071,227,1839,1,ITF,ITF6,18,Calabria,Calabria,1947131,547510,28.12,0.11
452,2021-05-04,CAL,16430,7573,8857,11644,4701,85,ITF,ITF6,18,Calabria,Calabria,1947131,563940,28.96,0.84
453,2021-01-22,CAL,659,275,384,657,2,0,ITF,ITF6,18,Calabria,Calabria,1947131,564599,29.0,0.03
454,2021-05-02,CAL,12517,5843,6674,10612,1848,57,ITF,ITF6,18,Calabria,Calabria,1947131,577116,29.64,0.64
455,2021-03-29,CAL,5741,2468,3273,3957,1760,24,ITF,ITF6,18,Calabria,Calabria,1947131,582857,29.93,0.29
456,2021-01-31,CAL,1115,556,559,153,962,0,ITF,ITF6,18,Calabria,Calabria,1947131,583972,29.99,0.06
457,2021-07-07,CAL,13959,6571,7388,3891,9999,69,ITF,ITF6,18,Calabria,Calabria,1947131,597931,30.71,0.72
458,2021-05-11,CAL,15054,7284,7770,10213,4774,67,ITF,ITF6,18,Calabria,Calabria,1947131,612985,31.48,0.77
459,2021-03-13,CAL,6949,3019,3930,5934,987,28,ITF,ITF6,18,Calabria,Calabria,1947131,619934,31.84,0.36
460,2021-01-15,CAL,2802,1259,1543,2796,0,6,ITF,ITF6,18,Calabria,Calabria,1947131,622736,31.98,0.14
461,2021-04-25,CAL,15884,8059,7825,14792,1032,60,ITF,ITF6,18,Calabria,Calabria,1947131,638620,32.8,0.82
462,2021-06-30,CAL,16367,7494,8873,7007,9265,95,ITF,ITF6,18,Calabria,Calabria,1947131,654987,33.64,0.84
463,2021-06-28,CAL,13259,6100,7159,5366,7829,64,ITF,ITF6,18,Calabria,Calabria,1947131,668246,34.32,0.68
464,2021-03-20,CAL,6711,3073,3638,4183,2512,16,ITF,ITF6,18,Calabria,Calabria,1947131,674957,34.66,0.34
465,2021-01-10,CAL,937,530,407,937,0,0,ITF,ITF6,18,Calabria,Calabria,1947131,675894,34.71,0.05
466,2021-04-20,CAL,7854,3962,3892,6052,1730,72,ITF,ITF6,18,Calabria,Calabria,1947131,683748,35.12,0.4
467,2021-02-12,CAL,1710,668,1042,941,763,6,ITF,ITF6,18,Calabria,Calabria,1947131,685458,35.2,0.09
468,2021-06-27,CAL,8413,3938,4475,4980,3397,36,ITF,ITF6,18,Calabria,Calabria,1947131,693871,35.64,0.43
469,2021-04-03,CAL,9372,4056,5316,4503,4811,58,ITF,ITF6,18,Calabria,Calabria,1947131,703243,36.12,0.48
470,2021-04-08,CAL,9254,4372,4882,5741,3468,45,ITF,ITF6,18,Calabria,Calabria,1947131,712497,36.59,0.48
471,2021-02-10,CAL,2513,1081,1432,868,1630,15,ITF,ITF6,18,Calabria,Calabria,1947131,715010,36.72,0.13
472,2021-06-04,CAL,17509,8145,9364,12951,4491,67,ITF,ITF6,18,Calabria,Calabria,1947131,732519,37.62,0.9
473,2021-05-21,CAL,21332,10861,10471,13869,7356,107,ITF,ITF6,18,Calabria,Calabria,1947131,753851,38.72,1.1
474,2021-01-05,CAL,1520,711,809,1518,0,2,ITF,ITF6,18,Calabria,Calabria,1947131,755371,38.79,0.08
475,2021-07-05,CAL,13382,6259,7123,4288,9038,56,ITF,ITF6,18,Calabria,Calabria,1947131,768753,39.48,0.69
476,2021-03-08,CAL,5432,2914,2518,4338,1068,26,ITF,ITF6,18,Calabria,Calabria,1947131,774185,39.76,0.28
477,2021-03-25,CAL,7442,3498,3944,4552,2860,30,ITF,ITF6,18,Calabria,Calabria,1947131,781627,40.14,0.38
478,2021-06-16,CAL,18303,8450,9853,12118,6100,85,ITF,ITF6,18,Calabria,Calabria,1947131,799930,41.08,0.94
479,2021-06-18,CAL,18847,8781,10066,11247,7493,107,ITF,ITF6,18,Calabria,Calabria,1947131,818777,42.05,0.97
480,2021-03-10,CAL,6734,3422,3312,5370,1335,29,ITF,ITF6,18,Calabria,Calabria,1947131,825511,42.4,0.35
481,2021-06-01,CAL,12853,5960,6893,7879,4916,58,ITF,ITF6,18,Calabria,Calabria,1947131,838364,43.06,0.66
482,2021-03-15,CAL,3583,1711,1872,2127,1447,9,ITF,ITF6,18,Calabria,Calabria,1947131,841947,43.24,0.18
483,2021-07-02,CAL,16245,7528,8717,6238,9926,81,ITF,ITF6,18,Calabria,Calabria,1947131,858192,44.07,0.83
484,2021-05-20,CAL,16932,8456,8476,11259,5606,67,ITF,ITF6,18,Calabria,Calabria,1947131,875124,44.94,0.87
485,2021-02-07,CAL,861,430,431,146,713,2,ITF,ITF6,18,Calabria,Calabria,1947131,875985,44.99,0.04
486,2021-05-18,CAL,15282,7639,7643,11798,3416,68,ITF,ITF6,18,Calabria,Calabria,1947131,891267,45.77,0.78
487,2021-03-22,CAL,4951,2321,2630,3165,1762,24,ITF,ITF6,18,Calabria,Calabria,1947131,896218,46.03,0.25
488,2021-02-09,CAL,2158,912,1246,946,1203,9,ITF,ITF6,18,Calabria,Calabria,1947131,898376,46.14,0.11
489,2021-05-29,CAL,19269,8949,10320,9342,9851,76,ITF,ITF6,18,Calabria,Calabria,1947131,917645,47.13,0.99
490,2021-04-14,CAL,8071,3896,4175,6582,1445,44,ITF,ITF6,18,Calabria,Calabria,1947131,925716,47.54,0.41
491,2021-02-16,CAL,1740,736,1004,1456,279,5,ITF,ITF6,18,Calabria,Calabria,1947131,927456,47.63,0.09
492,2021-05-27,CAL,17618,8693,8925,9755,7781,82,ITF,ITF6,18,Calabria,Calabria,1947131,945074,48.54,0.9
493,2021-02-14,CAL,471,215,256,440,30,1,ITF,ITF6,18,Calabria,Calabria,1947131,945545,48.56,0.02
494,2021-05-25,CAL,16368,8000,8368,10206,6078,84,ITF,ITF6,18,Calabria,Calabria,1947131,961913,49.4,0.84
495,2021-01-26,CAL,1847,880,967,276,1570,1,ITF,ITF6,18,Calabria,Calabria,1947131,963760,49.5,0.09
496,2021-04-22,CAL,9747,4865,4882,6815,2889,43,ITF,ITF6,18,Calabria,Calabria,1947131,973507,50.0,0.5
497,2021-05-06,CAL,13259,6277,6982,8924,4269,66,ITF,ITF6,18,Calabria,Calabria,1947131,986766,50.68,0.68
498,2021-01-28,CAL,2264,1126,1138,82,2182,0,ITF,ITF6,18,Calabria,Calabria,1947131,989030,50.79,0.12
499,2021-05-08,CAL,18453,8388,10065,10545,7845,63,ITF,ITF6,18,Calabria,Calabria,1947131,1007483,51.74,0.95
500,2021-05-22,CAL,22177,10554,11623,14231,7856,90,ITF,ITF6,18,Calabria,Calabria,1947131,1029660,52.88,1.14
501,2021-04-21,CAL,11545,5799,5746,8599,2895,51,ITF,ITF6,18,Calabria,Calabria,1947131,1041205,53.47,0.59
502,2021-04-02,CAL,8528,3904,4624,4579,3917,32,ITF,ITF6,18,Calabria,Calabria,1947131,1049733,53.91,0.44
503,2021-01-24,CAL,46,19,27,39,7,0,ITF,ITF6,18,Calabria,Calabria,1947131,1049779,53.91,0.0
504,2020-12-28,CAL,6,2,4,6,0,0,ITF,ITF6,18,Calabria,Calabria,1947131,1049785,53.91,0.0
505,2021-06-03,CAL,14224,6649,7575,9581,4588,55,ITF,ITF6,18,Calabria,Calabria,1947131,1064009,54.64,0.73
506,2021-04-07,CAL,7095,3214,3881,4040,3010,45,ITF,ITF6,18,Calabria,Calabria,1947131,1071104,55.01,0.36
507,2021-02-23,CAL,1593,754,839,1473,115,5,ITF,ITF6,18,Calabria,Calabria,1947131,1072697,55.09,0.08
508,2021-03-31,CAL,9086,4136,4950,5014,4038,34,ITF,ITF6,18,Calabria,Calabria,1947131,1081783,55.56,0.47
509,2021-04-09,CAL,7947,3728,4219,4980,2887,80,ITF,ITF6,18,Calabria,Calabria,1947131,1089730,55.97,0.41
510,2021-06-05,CAL,20640,9672,10968,17589,2973,78,ITF,ITF6,18,Calabria,Calabria,1947131,1110370,57.03,1.06
511,2021-01-12,CAL,2076,1027,1049,2067,0,9,ITF,ITF6,18,Calabria,Calabria,1947131,1112446,57.13,0.11
512,2021-02-24,CAL,1914,975,939,1430,478,6,ITF,ITF6,18,Calabria,Calabria,1947131,1114360,57.23,0.1
513,2021-03-03,CAL,5056,2761,2295,3963,1080,13,ITF,ITF6,18,Calabria,Calabria,1947131,1119416,57.49,0.26
514,2021-05-13,CAL,15936,7662,8274,11162,4708,66,ITF,ITF6,18,Calabria,Calabria,1947131,1135352,58.31,0.82
515,2021-02-19,CAL,1509,682,827,1239,261,9,ITF,ITF6,18,Calabria,Calabria,1947131,1136861,58.39,0.08
516,2021-05-30,CAL,10954,5265,5689,6768,4151,35,ITF,ITF6,18,Calabria,Calabria,1947131,1147815,58.95,0.56
517,2021-05-17,CAL,14894,7443,7451,10129,4715,50,ITF,ITF6,18,Calabria,Calabria,1947131,1162709,59.71,0.76
518,2021-02-21,CAL,623,295,328,545,77,1,ITF,ITF6,18,Calabria,Calabria,1947131,1163332,59.75,0.03
519,2021-04-28,CAL,12526,6059,6467,9592,2863,71,ITF,ITF6,18,Calabria,Calabria,1947131,1175858,60.39,0.64
520,2021-02-04,CAL,3595,1709,1886,647,2942,6,ITF,ITF6,18,Calabria,Calabria,1947131,1179453,60.57,0.18
521,2021-05-15,CAL,27244,13032,14212,20262,6853,129,ITF,ITF6,18,Calabria,Calabria,1947131,1206697,61.97,1.4
522,2021-02-02,CAL,2352,1152,1200,177,2175,0,ITF,ITF6,18,Calabria,Calabria,1947131,1209049,62.09,0.12
523,2021-01-16,CAL,2402,1126,1276,2399,0,3,ITF,ITF6,18,Calabria,Calabria,1947131,1211451,62.22,0.12
524,2021-06-29,CAL,13016,6012,7004,5330,7636,50,ITF,ITF6,18,Calabria,Calabria,1947131,1224467,62.89,0.67
525,2021-05-03,CAL,14768,6769,7999,10463,4219,86,ITF,ITF6,18,Calabria,Calabria,1947131,1239235,63.64,0.76
526,2021-03-21,CAL,4453,1922,2531,2726,1717,10,ITF,ITF6,18,Calabria,Calabria,1947131,1243688,63.87,0.23
527,2021-03-07,CAL,3395,1731,1664,3290,92,13,ITF,ITF6,18,Calabria,Calabria,1947131,1247083,64.05,0.17
528,2021-06-15,CAL,9812,4539,5273,6431,3327,54,ITF,ITF6,18,Calabria,Calabria,1947131,1256895,64.55,0.5
529,2021-03-14,CAL,2714,1055,1659,2280,428,6,ITF,ITF6,18,Calabria,Calabria,1947131,1259609,64.69,0.14
530,2021-06-22,CAL,14530,6856,7674,7351,7087,92,ITF,ITF6,18,Calabria,Calabria,1947131,1274139,65.44,0.75
531,2021-05-10,CAL,13120,6087,7033,7668,5398,54,ITF,ITF6,18,Calabria,Calabria,1947131,1287259,66.11,0.67
532,2021-04-26,CAL,10185,5060,5125,7722,2419,44,ITF,ITF6,18,Calabria,Calabria,1947131,1297444,66.63,0.52
533,2021-04-05,CAL,3643,1728,1915,2672,959,12,ITF,ITF6,18,Calabria,Calabria,1947131,1301087,66.82,0.19
534,2021-06-08,CAL,16661,7896,8765,14507,2026,128,ITF,ITF6,18,Calabria,Calabria,1947131,1317748,67.68,0.86
535,2021-03-17,CAL,4105,1826,2279,2179,1919,7,ITF,ITF6,18,Calabria,Calabria,1947131,1321853,67.89,0.21
536,2021-06-25,CAL,18784,8722,10062,8067,10640,77,ITF,ITF6,18,Calabria,Calabria,1947131,1340637,68.85,0.96
537,2021-02-22,CAL,2054,1043,1011,1487,558,9,ITF,ITF6,18,Calabria,Calabria,1947131,1342691,68.96,0.11
538,2021-06-02,CAL,12099,5802,6297,8787,3266,46,ITF,ITF6,18,Calabria,Calabria,1947131,1354790,69.58,0.62
539,2021-05-16,CAL,13782,6725,7057,9919,3811,52,ITF,ITF6,18,Calabria,Calabria,1947131,1368572,70.29,0.71
540,2021-06-24,CAL,15248,6938,8310,6885,8289,74,ITF,ITF6,18,Calabria,Calabria,1947131,1383820,71.07,0.78
541,2021-03-19,CAL,4186,1954,2232,1887,2292,7,ITF,ITF6,18,Calabria,Calabria,1947131,1388006,71.28,0.21
542,2021-06-10,CAL,15827,7274,8553,12963,2771,93,ITF,ITF6,18,Calabria,Calabria,1947131,1403833,72.1,0.81
543,2021-04-19,CAL,7874,3798,4076,6153,1676,45,ITF,ITF6,18,Calabria,Calabria,1947131,1411707,72.5,0.4
544,2021-01-09,CAL,1972,1061,911,1964,0,8,ITF,ITF6,18,Calabria,Calabria,1947131,1413679,72.6,0.1
545,2021-02-28,CAL,2337,1060,1277,2180,154,3,ITF,ITF6,18,Calabria,Calabria,1947131,1416016,72.72,0.12
546,2021-01-17,CAL,897,431,466,797,95,5,ITF,ITF6,18,Calabria,Calabria,1947131,1416913,72.77,0.05
547,2021-03-24,CAL,7818,3577,4241,4514,3282,22,ITF,ITF6,18,Calabria,Calabria,1947131,1424731,73.17,0.4
548,2021-04-10,CAL,11642,5267,6375,6744,4855,43,ITF,ITF6,18,Calabria,Calabria,1947131,1436373,73.77,0.6
549,2021-02-05,CAL,3817,1719,2098,474,3328,15,ITF,ITF6,18,Calabria,Calabria,1947131,1440190,73.96,0.2
550,2021-04-29,CAL,12456,6051,6405,8656,3749,51,ITF,ITF6,18,Calabria,Calabria,1947131,1452646,74.6,0.64
551,2021-04-12,CAL,7046,3426,3620,5379,1645,22,ITF,ITF6,18,Calabria,Calabria,1947131,1459692,74.97,0.36
552,2021-01-19,CAL,1118,493,625,1104,12,2,ITF,ITF6,18,Calabria,Calabria,1947131,1460810,75.02,0.06
553,2021-07-04,CAL,5933,2811,3122,1979,3919,35,ITF,ITF6,18,Calabria,Calabria,1947131,1466743,75.33,0.3
554,2021-06-17,CAL,15761,7202,8559,9587,6124,50,ITF,ITF6,18,Calabria,Calabria,1947131,1482504,76.14,0.81
555,2021-03-26,CAL,8084,3835,4249,4935,3121,28,ITF,ITF6,18,Calabria,Calabria,1947131,1490588,76.55,0.42
556,2021-07-06,CAL,11881,5478,6403,3619,8204,58,ITF,ITF6,18,Calabria,Calabria,1947131,1502469,77.16,0.61
557,2021-01-02,CAL,166,94,72,166,0,0,ITF,ITF6,18,Calabria,Calabria,1947131,1502635,77.17,0.01
558,2021-02-15,CAL,1149,545,604,994,151,4,ITF,ITF6,18,Calabria,Calabria,1947131,1503784,77.23,0.06
559,2020-12-27,CAL,312,170,142,312,0,0,ITF,ITF6,18,Calabria,Calabria,1947131,1504096,77.25,0.02
560,2021-04-06,CAL,8075,3663,4412,4418,3633,24,ITF,ITF6,18,Calabria,Calabria,1947131,1512171,77.66,0.41
561,2021-02-08,CAL,1857,738,1119,660,1194,3,ITF,ITF6,18,Calabria,Calabria,1947131,1514028,77.76,0.1
562,2021-04-24,CAL,19246,9579,9667,15727,3436,83,ITF,ITF6,18,Calabria,Calabria,1947131,1533274,78.75,0.99
563,2021-02-26,CAL,3083,1645,1438,2615,453,15,ITF,ITF6,18,Calabria,Calabria,1947131,1536357,78.9,0.16
564,2021-06-20,CAL,6646,3149,3497,3807,2811,28,ITF,ITF6,18,Calabria,Calabria,1947131,1543003,79.24,0.34
565,2021-06-06,CAL,13705,6585,7120,11944,1698,63,ITF,ITF6,18,Calabria,Calabria,1947131,1556708,79.95,0.7
566,2021-01-07,CAL,2202,1077,1125,2198,0,4,ITF,ITF6,18,Calabria,Calabria,1947131,1558910,80.06,0.11
567,2021-06-13,CAL,6800,3336,3464,5711,1037,52,ITF,ITF6,18,Calabria,Calabria,1947131,1565710,80.41,0.35
568,2021-04-17,CAL,10824,5075,5749,9003,1776,45,ITF,ITF6,18,Calabria,Calabria,1947131,1576534,80.97,0.56
569,2021-05-01,CAL,16662,7943,8719,12375,4201,86,ITF,ITF6,18,Calabria,Calabria,1947131,1593196,81.82,0.86
570,2021-03-05,CAL,6237,3619,2618,5647,575,15,ITF,ITF6,18,Calabria,Calabria,1947131,1599433,82.14,0.32
571,2021-03-12,CAL,5161,2475,2686,4080,1063,18,ITF,ITF6,18,Calabria,Calabria,1947131,1604594,82.41,0.27
572,2021-01-14,CAL,2642,1253,1389,2636,0,6,ITF,ITF6,18,Calabria,Calabria,1947131,1607236,82.54,0.14
573,2021-01-21,CAL,966,450,516,932,31,3,ITF,ITF6,18,Calabria,Calabria,1947131,1608202,82.59,0.05
574,2021-04-08,BAS,766,351,415,741,10,15,ITF,ITF5,17,Basilicata,Basilicata,559084,766,0.14,0.14
575,2021-04-22,BAS,5037,2347,2690,3380,1603,54,ITF,ITF5,17,Basilicata,Basilicata,559084,5803,1.04,0.9
576,2021-06-30,BAS,3453,1669,1784,2316,1111,26,ITF,ITF5,17,Basilicata,Basilicata,559084,9256,1.66,0.62
577,2021-02-17,BAS,1135,493,642,1057,76,2,ITF,ITF5,17,Basilicata,Basilicata,559084,10391,1.86,0.2
578,2021-05-28,BAS,3615,1810,1805,919,2663,33,ITF,ITF5,17,Basilicata,Basilicata,559084,14006,2.51,0.65
579,2021-03-25,BAS,1886,604,1282,1522,344,20,ITF,ITF5,17,Basilicata,Basilicata,559084,15892,2.84,0.34
580,2021-01-27,BAS,412,175,237,113,299,0,ITF,ITF5,17,Basilicata,Basilicata,559084,16304,2.92,0.07
581,2021-02-10,BAS,549,238,311,495,52,2,ITF,ITF5,17,Basilicata,Basilicata,559084,16853,3.01,0.1
582,2021-05-21,BAS,4574,2320,2254,1479,3083,12,ITF,ITF5,17,Basilicata,Basilicata,559084,21427,3.83,0.82
583,2021-04-01,BAS,2696,1107,1589,1947,721,28,ITF,ITF5,17,Basilicata,Basilicata,559084,24123,4.31,0.48
584,2021-02-03,BAS,669,301,368,32,637,0,ITF,ITF5,17,Basilicata,Basilicata,559084,24792,4.43,0.12
585,2021-01-10,BAS,77,24,53,77,0,0,ITF,ITF5,17,Basilicata,Basilicata,559084,24869,4.45,0.01
586,2021-04-20,BAS,4035,1921,2114,2178,1833,24,ITF,ITF5,17,Basilicata,Basilicata,559084,28904,5.17,0.72
587,2021-01-08,BAS,554,219,335,554,0,0,ITF,ITF5,17,Basilicata,Basilicata,559084,29458,5.27,0.1
588,2021-03-15,BAS,2361,986,1375,508,1837,16,ITF,ITF5,17,Basilicata,Basilicata,559084,31819,5.69,0.42
589,2021-01-17,BAS,328,133,195,327,1,0,ITF,ITF5,17,Basilicata,Basilicata,559084,32147,5.75,0.06
590,2021-05-04,BAS,4137,1991,2146,3566,523,48,ITF,ITF5,17,Basilicata,Basilicata,559084,36284,6.49,0.74
591,2021-03-08,BAS,1461,714,747,818,614,29,ITF,ITF5,17,Basilicata,Basilicata,559084,37745,6.75,0.26
592,2021-06-16,BAS,4700,2122,2578,2121,2559,20,ITF,ITF5,17,Basilicata,Basilicata,559084,42445,7.59,0.84
593,2021-06-09,BAS,4429,2073,2356,3973,424,32,ITF,ITF5,17,Basilicata,Basilicata,559084,46874,8.38,0.79
594,2021-01-15,BAS,816,351,465,816,0,0,ITF,ITF5,17,Basilicata,Basilicata,559084,47690,8.53,0.15
595,2020-12-27,BAS,106,41,65,106,0,0,ITF,ITF5,17,Basilicata,Basilicata,559084,47796,8.55,0.02
596,2021-03-20,BAS,1294,573,721,274,1013,7,ITF,ITF5,17,Basilicata,Basilicata,559084,49090,8.78,0.23
597,2021-06-28,BAS,3640,1745,1895,2113,1509,18,ITF,ITF5,17,Basilicata,Basilicata,559084,52730,9.43,0.65
598,2021-03-06,BAS,1361,538,823,750,599,12,ITF,ITF5,17,Basilicata,Basilicata,559084,54091,9.67,0.24
599,2021-05-30,BAS,2776,1420,1356,919,1852,5,ITF,ITF5,17,Basilicata,Basilicata,559084,56867,10.17,0.5
600,2021-04-03,BAS,1808,749,1059,1460,336,12,ITF,ITF5,17,Basilicata,Basilicata,559084,58675,10.49,0.32
601,2021-02-05,BAS,987,444,543,63,923,1,ITF,ITF5,17,Basilicata,Basilicata,559084,59662,10.67,0.18
602,2021-05-16,BAS,4972,2468,2504,2811,2113,48,ITF,ITF5,17,Basilicata,Basilicata,559084,64634,11.56,0.89
603,2021-01-22,BAS,67,24,43,67,0,0,ITF,ITF5,17,Basilicata,Basilicata,559084,64701,11.57,0.01
604,2021-05-02,BAS,4180,2001,2179,3491,629,60,ITF,ITF5,17,Basilicata,Basilicata,559084,68881,12.32,0.75
605,2021-04-15,BAS,3386,1659,1727,2589,754,43,ITF,ITF5,17,Basilicata,Basilicata,559084,72267,12.93,0.61
606,2021-07-07,BAS,5212,2476,2736,2023,3176,13,ITF,ITF5,17,Basilicata,Basilicata,559084,77479,13.86,0.93
607,2021-06-04,BAS,4833,2290,2543,3750,1046,37,ITF,ITF5,17,Basilicata,Basilicata,559084,82312,14.72,0.86
608,2021-02-24,BAS,1807,743,1064,1723,73,11,ITF,ITF5,17,Basilicata,Basilicata,559084,84119,15.05,0.32
609,2021-02-22,BAS,1791,773,1018,1730,53,8,ITF,ITF5,17,Basilicata,Basilicata,559084,85910,15.37,0.32
610,2021-06-11,BAS,4238,1982,2256,3168,1029,41,ITF,ITF5,17,Basilicata,Basilicata,559084,90148,16.12,0.76
611,2021-05-11,BAS,2654,1353,1301,1597,1033,24,ITF,ITF5,17,Basilicata,Basilicata,559084,92802,16.6,0.47
612,2021-04-05,BAS,724,233,491,412,302,10,ITF,ITF5,17,Basilicata,Basilicata,559084,93526,16.73,0.13
613,2021-06-01,BAS,6136,2926,3210,3033,3076,27,ITF,ITF5,17,Basilicata,Basilicata,559084,99662,17.83,1.1
614,2021-06-08,BAS,4584,2192,2392,4188,358,38,ITF,ITF5,17,Basilicata,Basilicata,559084,104246,18.65,0.82
615,2021-04-27,BAS,4727,2242,2485,4351,325,51,ITF,ITF5,17,Basilicata,Basilicata,559084,108973,19.49,0.85
616,2021-06-27,BAS,3007,1477,1530,2377,616,14,ITF,ITF5,17,Basilicata,Basilicata,559084,111980,20.03,0.54
617,2021-04-13,BAS,2119,1053,1066,1285,817,17,ITF,ITF5,17,Basilicata,Basilicata,559084,114099,20.41,0.38
618,2021-03-01,BAS,550,286,264,383,167,0,ITF,ITF5,17,Basilicata,Basilicata,559084,114649,20.51,0.1
619,2021-06-18,BAS,4463,2065,2398,2179,2258,26,ITF,ITF5,17,Basilicata,Basilicata,559084,119112,21.3,0.8
620,2021-01-24,BAS,842,305,537,57,784,1,ITF,ITF5,17,Basilicata,Basilicata,559084,119954,21.46,0.15
621,2021-05-13,BAS,5985,2967,3018,3299,2596,90,ITF,ITF5,17,Basilicata,Basilicata,559084,125939,22.53,1.07
622,2021-05-09,BAS,4683,2339,2344,2940,1694,49,ITF,ITF5,17,Basilicata,Basilicata,559084,130622,23.36,0.84
623,2021-02-15,BAS,622,232,390,566,42,14,ITF,ITF5,17,Basilicata,Basilicata,559084,131244,23.47,0.11
624,2021-01-29,BAS,617,231,386,63,554,0,ITF,ITF5,17,Basilicata,Basilicata,559084,131861,23.59,0.11
625,2021-03-05,BAS,1856,857,999,1096,747,13,ITF,ITF5,17,Basilicata,Basilicata,559084,133717,23.92,0.33
626,2021-06-13,BAS,3019,1440,1579,2678,313,28,ITF,ITF5,17,Basilicata,Basilicata,559084,136736,24.46,0.54
627,2021-05-27,BAS,3602,1855,1747,1059,2529,14,ITF,ITF5,17,Basilicata,Basilicata,559084,140338,25.1,0.64
628,2021-05-23,BAS,4517,2302,2215,1526,2984,7,ITF,ITF5,17,Basilicata,Basilicata,559084,144855,25.91,0.81
629,2021-03-27,BAS,2251,862,1389,1808,429,14,ITF,ITF5,17,Basilicata,Basilicata,559084,147106,26.31,0.4
630,2021-07-05,BAS,3270,1614,1656,2215,1022,33,ITF,ITF5,17,Basilicata,Basilicata,559084,150376,26.9,0.58
631,2021-01-03,BAS,901,344,557,901,0,0,ITF,ITF5,17,Basilicata,Basilicata,559084,151277,27.06,0.16
632,2021-06-23,BAS,3320,1564,1756,2412,876,32,ITF,ITF5,17,Basilicata,Basilicata,559084,154597,27.65,0.59
633,2021-03-13,BAS,1798,890,908,734,1045,19,ITF,ITF5,17,Basilicata,Basilicata,559084,156395,27.97,0.32
634,2021-02-07,BAS,375,159,216,49,326,0,ITF,ITF5,17,Basilicata,Basilicata,559084,156770,28.04,0.07
635,2021-05-18,BAS,5897,2857,3040,3385,2492,20,ITF,ITF5,17,Basilicata,Basilicata,559084,162667,29.1,1.05
636,2021-05-01,BAS,4705,2138,2567,3886,752,67,ITF,ITF5,17,Basilicata,Basilicata,559084,167372,29.94,0.84
637,2021-03-22,BAS,1190,537,653,634,548,8,ITF,ITF5,17,Basilicata,Basilicata,559084,168562,30.15,0.21
638,2021-03-03,BAS,1748,818,930,1167,559,22,ITF,ITF5,17,Basilicata,Basilicata,559084,170310,30.46,0.31
639,2021-05-25,BAS,4195,2112,2083,864,3321,10,ITF,ITF5,17,Basilicata,Basilicata,559084,174505,31.21,0.75
640,2021-02-14,BAS,151,48,103,105,0,46,ITF,ITF5,17,Basilicata,Basilicata,559084,174656,31.24,0.03
641,2021-01-31,BAS,77,24,53,0,77,0,ITF,ITF5,17,Basilicata,Basilicata,559084,174733,31.25,0.01
642,2021-01-12,BAS,217,88,129,217,0,0,ITF,ITF5,17,Basilicata,Basilicata,559084,174950,31.29,0.04
643,2021-04-29,BAS,4832,2385,2447,4339,421,72,ITF,ITF5,17,Basilicata,Basilicata,559084,179782,32.16,0.86
644,2021-03-17,BAS,1455,610,845,24,1427,4,ITF,ITF5,17,Basilicata,Basilicata,559084,181237,32.42,0.26
645,2021-01-19,BAS,199,84,115,199,0,0,ITF,ITF5,17,Basilicata,Basilicata,559084,181436,32.45,0.04
646,2021-06-25,BAS,3318,1573,1745,2454,831,33,ITF,ITF5,17,Basilicata,Basilicata,559084,184754,33.05,0.59
647,2021-07-04,BAS,3109,1562,1547,2163,921,25,ITF,ITF5,17,Basilicata,Basilicata,559084,187863,33.6,0.56
648,2021-03-24,BAS,1898,724,1174,1478,398,22,ITF,ITF5,17,Basilicata,Basilicata,559084,189761,33.94,0.34
649,2021-07-02,BAS,3636,1791,1845,2434,1174,28,ITF,ITF5,17,Basilicata,Basilicata,559084,193397,34.59,0.65
650,2021-02-11,BAS,952,401,551,867,83,2,ITF,ITF5,17,Basilicata,Basilicata,559084,194349,34.76,0.17
651,2021-05-22,BAS,5489,2723,2766,1927,3551,11,ITF,ITF5,17,Basilicata,Basilicata,559084,199838,35.74,0.98
652,2021-03-26,BAS,1955,703,1252,1669,260,26,ITF,ITF5,17,Basilicata,Basilicata,559084,201793,36.09,0.35
653,2021-05-08,BAS,4835,2399,2436,3386,1407,42,ITF,ITF5,17,Basilicata,Basilicata,559084,206628,36.96,0.86
654,2021-03-10,BAS,1681,843,838,833,839,9,ITF,ITF5,17,Basilicata,Basilicata,559084,208309,37.26,0.3
655,2021-01-26,BAS,801,354,447,101,700,0,ITF,ITF5,17,Basilicata,Basilicata,559084,209110,37.4,0.14
656,2021-05-06,BAS,5052,2435,2617,3432,1569,51,ITF,ITF5,17,Basilicata,Basilicata,559084,214162,38.31,0.9
657,2021-05-15,BAS,6529,3344,3185,3875,2571,83,ITF,ITF5,17,Basilicata,Basilicata,559084,220691,39.47,1.17
658,2021-04-24,BAS,4542,2197,2345,3474,1013,55,ITF,ITF5,17,Basilicata,Basilicata,559084,225233,40.29,0.81
659,2021-03-19,BAS,2296,995,1301,259,2030,7,ITF,ITF5,17,Basilicata,Basilicata,559084,227529,40.7,0.41
660,2021-02-16,BAS,907,377,530,790,98,19,ITF,ITF5,17,Basilicata,Basilicata,559084,228436,40.86,0.16
661,2021-01-28,BAS,907,402,505,119,788,0,ITF,ITF5,17,Basilicata,Basilicata,559084,229343,41.02,0.16
662,2021-01-14,BAS,969,413,556,969,0,0,ITF,ITF5,17,Basilicata,Basilicata,559084,230312,41.19,0.17
663,2021-04-12,BAS,2172,1053,1119,1654,489,29,ITF,ITF5,17,Basilicata,Basilicata,559084,232484,41.58,0.39
664,2021-04-19,BAS,4166,1913,2253,2398,1638,130,ITF,ITF5,17,Basilicata,Basilicata,559084,236650,42.33,0.75
665,2021-06-15,BAS,3519,1491,2028,2224,1275,20,ITF,ITF5,17,Basilicata,Basilicata,559084,240169,42.96,0.63
666,2021-02-26,BAS,2151,904,1247,2064,81,6,ITF,ITF5,17,Basilicata,Basilicata,559084,242320,43.34,0.38
667,2021-05-20,BAS,5878,2977,2901,2883,2967,28,ITF,ITF5,17,Basilicata,Basilicata,559084,248198,44.39,1.05
668,2021-06-06,BAS,4513,2074,2439,3695,780,38,ITF,ITF5,17,Basilicata,Basilicata,559084,252711,45.2,0.81
669,2021-04-14,BAS,2042,1000,1042,1352,674,16,ITF,ITF5,17,Basilicata,Basilicata,559084,254753,45.57,0.37
670,2021-01-21,BAS,30,10,20,30,0,0,ITF,ITF5,17,Basilicata,Basilicata,559084,254783,45.57,0.01
671,2021-01-04,BAS,608,271,337,608,0,0,ITF,ITF5,17,Basilicata,Basilicata,559084,255391,45.68,0.11
672,2021-07-06,BAS,4069,1943,2126,2033,2002,34,ITF,ITF5,17,Basilicata,Basilicata,559084,259460,46.41,0.73
673,2021-04-02,BAS,2318,1046,1272,1692,605,21,ITF,ITF5,17,Basilicata,Basilicata,559084,261778,46.82,0.41
674,2021-02-04,BAS,1099,443,656,63,1036,0,ITF,ITF5,17,Basilicata,Basilicata,559084,262877,47.02,0.2
675,2021-02-02,BAS,367,143,224,174,192,1,ITF,ITF5,17,Basilicata,Basilicata,559084,263244,47.08,0.07
676,2021-04-09,BAS,1151,350,801,1064,63,24,ITF,ITF5,17,Basilicata,Basilicata,559084,264395,47.29,0.21
677,2021-02-27,BAS,1993,861,1132,1812,164,17,ITF,ITF5,17,Basilicata,Basilicata,559084,266388,47.65,0.36
678,2021-06-07,BAS,4241,1921,2320,3889,316,36,ITF,ITF5,17,Basilicata,Basilicata,559084,270629,48.41,0.76
679,2021-04-11,BAS,851,330,521,756,66,29,ITF,ITF5,17,Basilicata,Basilicata,559084,271480,48.56,0.15
680,2021-04-04,BAS,610,225,385,191,413,6,ITF,ITF5,17,Basilicata,Basilicata,559084,272090,48.67,0.11
681,2021-05-10,BAS,4804,2382,2422,2718,2042,44,ITF,ITF5,17,Basilicata,Basilicata,559084,276894,49.53,0.86
682,2021-04-07,BAS,1211,551,660,1155,36,20,ITF,ITF5,17,Basilicata,Basilicata,559084,278105,49.74,0.22
683,2021-04-25,BAS,2988,1457,1531,2904,52,32,ITF,ITF5,17,Basilicata,Basilicata,559084,281093,50.28,0.53
684,2021-05-12,BAS,4724,2327,2397,2794,1882,48,ITF,ITF5,17,Basilicata,Basilicata,559084,285817,51.12,0.84
685,2021-02-13,BAS,800,314,486,701,61,38,ITF,ITF5,17,Basilicata,Basilicata,559084,286617,51.27,0.14
686,2021-05-24,BAS,4833,2343,2490,1090,3730,13,ITF,ITF5,17,Basilicata,Basilicata,559084,291450,52.13,0.86
687,2021-06-02,BAS,5963,2804,3159,4379,1543,41,ITF,ITF5,17,Basilicata,Basilicata,559084,297413,53.2,1.07
688,2021-04-18,BAS,3718,1844,1874,2330,1366,22,ITF,ITF5,17,Basilicata,Basilicata,559084,301131,53.86,0.67
689,2021-02-20,BAS,1163,532,631,1044,119,0,ITF,ITF5,17,Basilicata,Basilicata,559084,302294,54.07,0.21
690,2021-05-31,BAS,4229,2009,2220,1713,2508,8,ITF,ITF5,17,Basilicata,Basilicata,559084,306523,54.83,0.76
691,2021-02-18,BAS,1070,401,669,852,215,3,ITF,ITF5,17,Basilicata,Basilicata,559084,307593,55.02,0.19
692,2021-02-28,BAS,810,346,464,771,35,4,ITF,ITF5,17,Basilicata,Basilicata,559084,308403,55.16,0.14
693,2021-01-02,BAS,950,381,569,949,0,1,ITF,ITF5,17,Basilicata,Basilicata,559084,309353,55.33,0.17
694,2021-01-16,BAS,722,304,418,722,0,0,ITF,ITF5,17,Basilicata,Basilicata,559084,310075,55.46,0.13
695,2021-04-26,BAS,4466,2165,2301,4199,221,46,ITF,ITF5,17,Basilicata,Basilicata,559084,314541,56.26,0.8
696,2021-02-21,BAS,284,113,171,284,0,0,ITF,ITF5,17,Basilicata,Basilicata,559084,314825,56.31,0.05
697,2021-01-23,BAS,722,306,416,33,689,0,ITF,ITF5,17,Basilicata,Basilicata,559084,315547,56.44,0.13
698,2021-05-03,BAS,4511,2043,2468,3622,827,62,ITF,ITF5,17,Basilicata,Basilicata,559084,320058,57.25,0.81
699,2021-02-09,BAS,491,213,278,316,175,0,ITF,ITF5,17,Basilicata,Basilicata,559084,320549,57.33,0.09
700,2021-06-21,BAS,4252,2042,2210,2142,2091,19,ITF,ITF5,17,Basilicata,Basilicata,559084,324801,58.1,0.76
701,2021-06-19,BAS,4465,2178,2287,2370,2073,22,ITF,ITF5,17,Basilicata,Basilicata,559084,329266,58.89,0.8
702,2021-03-28,BAS,2143,743,1400,2109,17,17,ITF,ITF5,17,Basilicata,Basilicata,559084,331409,59.28,0.38
703,2021-03-11,BAS,1794,928,866,817,959,18,ITF,ITF5,17,Basilicata,Basilicata,559084,333203,59.6,0.32
704,2021-03-30,BAS,2745,1159,1586,2384,346,15,ITF,ITF5,17,Basilicata,Basilicata,559084,335948,60.09,0.49
705,2021-07-08,BAS,2854,1310,1544,974,1867,13,ITF,ITF5,17,Basilicata,Basilicata,559084,338802,60.6,0.51
706,2021-01-06,BAS,294,129,165,294,0,0,ITF,ITF5,17,Basilicata,Basilicata,559084,339096,60.65,0.05
707,2021-04-16,BAS,3321,1634,1687,2400,898,23,ITF,ITF5,17,Basilicata,Basilicata,559084,342417,61.25,0.59
708,2021-03-07,BAS,889,309,580,841,38,10,ITF,ITF5,17,Basilicata,Basilicata,559084,343306,61.41,0.16
709,2021-01-09,BAS,557,160,397,557,0,0,ITF,ITF5,17,Basilicata,Basilicata,559084,343863,61.5,0.1
710,2021-07-03,BAS,3639,1832,1807,2453,1146,40,ITF,ITF5,17,Basilicata,Basilicata,559084,347502,62.16,0.65
711,2021-05-07,BAS,4649,2284,2365,3271,1354,24,ITF,ITF5,17,Basilicata,Basilicata,559084,352151,62.99,0.83
712,2021-05-14,BAS,5907,2799,3108,3273,2531,103,ITF,ITF5,17,Basilicata,Basilicata,559084,358058,64.04,1.06
713,2021-03-18,BAS,1351,565,786,17,1326,8,ITF,ITF5,17,Basilicata,Basilicata,559084,359409,64.29,0.24
714,2021-06-26,BAS,3327,1611,1716,2742,557,28,ITF,ITF5,17,Basilicata,Basilicata,559084,362736,64.88,0.6
715,2021-06-29,BAS,3881,1892,1989,2814,1041,26,ITF,ITF5,17,Basilicata,Basilicata,559084,366617,65.57,0.69
716,2021-03-21,BAS,1062,489,573,364,696,2,ITF,ITF5,17,Basilicata,Basilicata,559084,367679,65.76,0.19
717,2021-05-29,BAS,3060,1534,1526,826,2225,9,ITF,ITF5,17,Basilicata,Basilicata,559084,370739,66.31,0.55
718,2021-04-17,BAS,3461,1655,1806,2171,1262,28,ITF,ITF5,17,Basilicata,Basilicata,559084,374200,66.93,0.62
719,2021-03-29,BAS,2435,880,1555,2097,287,51,ITF,ITF5,17,Basilicata,Basilicata,559084,376635,67.37,0.44
720,2021-01-05,BAS,946,409,537,946,0,0,ITF,ITF5,17,Basilicata,Basilicata,559084,377581,67.54,0.17
721,2021-06-20,BAS,4011,1884,2127,1941,2036,34,ITF,ITF5,17,Basilicata,Basilicata,559084,381592,68.25,0.72
722,2021-04-06,BAS,1273,464,809,1074,184,15,ITF,ITF5,17,Basilicata,Basilicata,559084,382865,68.48,0.23
723,2021-06-14,BAS,4914,2177,2737,2092,2798,24,ITF,ITF5,17,Basilicata,Basilicata,559084,387779,69.36,0.88
724,2021-03-23,BAS,1591,610,981,1406,168,17,ITF,ITF5,17,Basilicata,Basilicata,559084,389370,69.64,0.28
725,2021-07-01,BAS,3652,1807,1845,2515,1104,33,ITF,ITF5,17,Basilicata,Basilicata,559084,393022,70.3,0.65
726,2021-02-01,BAS,242,91,151,46,196,0,ITF,ITF5,17,Basilicata,Basilicata,559084,393264,70.34,0.04
727,2021-05-26,BAS,4489,2259,2230,1677,2783,29,ITF,ITF5,17,Basilicata,Basilicata,559084,397753,71.14,0.8
728,2021-01-13,BAS,916,387,529,916,0,0,ITF,ITF5,17,Basilicata,Basilicata,559084,398669,71.31,0.16
729,2021-04-23,BAS,4536,2185,2351,3478,1000,58,ITF,ITF5,17,Basilicata,Basilicata,559084,403205,72.12,0.81
730,2021-01-30,BAS,706,229,477,129,577,0,ITF,ITF5,17,Basilicata,Basilicata,559084,403911,72.25,0.13
731,2021-03-04,BAS,1884,893,991,1063,799,22,ITF,ITF5,17,Basilicata,Basilicata,559084,405795,72.58,0.34
732,2021-06-12,BAS,3694,1695,1999,2956,699,39,ITF,ITF5,17,Basilicata,Basilicata,559084,409489,73.24,0.66
733,2021-03-14,BAS,1010,477,533,529,469,12,ITF,ITF5,17,Basilicata,Basilicata,559084,410499,73.42,0.18
734,2021-03-31,BAS,3094,1258,1836,2282,782,30,ITF,ITF5,17,Basilicata,Basilicata,559084,413593,73.98,0.55
735,2021-06-22,BAS,4371,2071,2300,2237,2102,32,ITF,ITF5,17,Basilicata,Basilicata,559084,417964,74.76,0.78
736,2021-06-05,BAS,4800,2209,2591,3823,943,34,ITF,ITF5,17,Basilicata,Basilicata,559084,422764,75.62,0.86
737,2021-02-23,BAS,1901,771,1130,1746,138,17,ITF,ITF5,17,Basilicata,Basilicata,559084,424665,75.96,0.34
738,2021-06-03,BAS,4920,2257,2663,3701,1181,38,ITF,ITF5,17,Basilicata,Basilicata,559084,429585,76.84,0.88
739,2021-03-12,BAS,1908,981,927,780,1102,26,ITF,ITF5,17,Basilicata,Basilicata,559084,431493,77.18,0.34
740,2021-05-17,BAS,5540,2732,2808,3359,2132,49,ITF,ITF5,17,Basilicata,Basilicata,559084,437033,78.17,0.99
741,2021-02-08,BAS,558,193,365,151,407,0,ITF,ITF5,17,Basilicata,Basilicata,559084,437591,78.27,0.1
742,2021-05-19,BAS,2871,1498,1373,1182,1676,13,ITF,ITF5,17,Basilicata,Basilicata,559084,440462,78.78,0.51
743,2021-02-25,BAS,1789,738,1051,1732,46,11,ITF,ITF5,17,Basilicata,Basilicata,559084,442251,79.1,0.32
744,2021-02-06,BAS,907,370,537,146,761,0,ITF,ITF5,17,Basilicata,Basilicata,559084,443158,79.27,0.16
745,2021-04-30,BAS,5284,2373,2911,4064,1163,57,ITF,ITF5,17,Basilicata,Basilicata,559084,448442,80.21,0.95
746,2021-01-20,BAS,84,22,62,84,0,0,ITF,ITF5,17,Basilicata,Basilicata,559084,448526,80.23,0.02
747,2021-01-07,BAS,641,319,322,641,0,0,ITF,ITF5,17,Basilicata,Basilicata,559084,449167,80.34,0.11
748,2021-02-19,BAS,1623,738,885,1556,62,5,ITF,ITF5,17,Basilicata,Basilicata,559084,450790,80.63,0.29
749,2021-02-12,BAS,776,332,444,744,31,1,ITF,ITF5,17,Basilicata,Basilicata,559084,451566,80.77,0.14
750,2021-04-10,BAS,1033,378,655,924,83,26,ITF,ITF5,17,Basilicata,Basilicata,559084,452599,80.95,0.18
751,2021-06-24,BAS,4141,1959,2182,2201,1903,37,ITF,ITF5,17,Basilicata,Basilicata,559084,456740,81.69,0.74
752,2021-04-28,BAS,4706,2159,2547,4206,441,59,ITF,ITF5,17,Basilicata,Basilicata,559084,461446,82.54,0.84
753,2021-03-02,BAS,798,385,413,657,136,5,ITF,ITF5,17,Basilicata,Basilicata,559084,462244,82.68,0.14
754,2021-06-10,BAS,4346,2102,2244,3870,441,35,ITF,ITF5,17,Basilicata,Basilicata,559084,466590,83.46,0.78
755,2021-06-17,BAS,4432,2038,2394,2089,2319,24,ITF,ITF5,17,Basilicata,Basilicata,559084,471022,84.25,0.79
756,2021-04-21,BAS,3920,1834,2086,2241,1650,29,ITF,ITF5,17,Basilicata,Basilicata,559084,474942,84.95,0.7
757,2021-01-18,BAS,463,157,306,364,99,0,ITF,ITF5,17,Basilicata,Basilicata,559084,475405,85.03,0.08
758,2021-03-16,BAS,1908,802,1106,226,1679,3,ITF,ITF5,17,Basilicata,Basilicata,559084,477313,85.37,0.34
759,2021-05-05,BAS,4334,2048,2286,3378,890,66,ITF,ITF5,17,Basilicata,Basilicata,559084,481647,86.15,0.78
760,2021-03-09,BAS,1403,716,687,778,607,18,ITF,ITF5,17,Basilicata,Basilicata,559084,483050,86.4,0.25
761,2021-01-25,BAS,1026,430,596,73,952,1,ITF,ITF5,17,Basilicata,Basilicata,559084,484076,86.58,0.18
762,2021-01-11,BAS,183,66,117,183,0,0,ITF,ITF5,17,Basilicata,Basilicata,559084,484259,86.62,0.03
763,2021-07-01,TOS,32002,15481,16521,10717,21019,266,ITI,ITI1,9,Toscana,Toscana,3729641,32002,0.86,0.86
764,2021-03-26,TOS,20679,9393,11286,14716,5765,198,ITI,ITI1,9,Toscana,Toscana,3729641,52681,1.41,0.55
765,2021-03-09,TOS,11130,4568,6562,5504,5552,74,ITI,ITI1,9,Toscana,Toscana,3729641,63811,1.71,0.3
766,2021-04-09,TOS,24596,10580,14016,20744,3409,443,ITI,ITI1,9,Toscana,Toscana,3729641,88407,2.37,0.66
767,2021-06-17,TOS,32492,16633,15859,26649,5512,331,ITI,ITI1,9,Toscana,Toscana,3729641,120899,3.24,0.87
768,2021-02-04,TOS,4253,1594,2659,934,3292,27,ITI,ITI1,9,Toscana,Toscana,3729641,125152,3.36,0.11
769,2021-01-28,TOS,6282,1882,4400,347,5928,7,ITI,ITI1,9,Toscana,Toscana,3729641,131434,3.52,0.17
770,2021-03-19,TOS,10142,4460,5682,7131,2868,143,ITI,ITI1,9,Toscana,Toscana,3729641,141576,3.8,0.27
771,2021-06-05,TOS,28425,13594,14831,20551,7610,264,ITI,ITI1,9,Toscana,Toscana,3729641,170001,4.56,0.76
772,2021-01-11,TOS,5095,1691,3404,4995,0,100,ITI,ITI1,9,Toscana,Toscana,3729641,175096,4.69,0.14
773,2021-04-21,TOS,29621,12678,16943,16864,12127,630,ITI,ITI1,9,Toscana,Toscana,3729641,204717,5.49,0.79
774,2021-02-23,TOS,7723,3325,4398,7219,161,343,ITI,ITI1,9,Toscana,Toscana,3729641,212440,5.7,0.21
775,2021-06-03,TOS,31998,15412,16586,27128,4548,322,ITI,ITI1,9,Toscana,Toscana,3729641,244438,6.55,0.86
776,2021-04-07,TOS,35825,15462,20363,28168,7249,408,ITI,ITI1,9,Toscana,Toscana,3729641,280263,7.51,0.96
777,2021-06-12,TOS,29382,15147,14235,24650,4387,345,ITI,ITI1,9,Toscana,Toscana,3729641,309645,8.3,0.79
778,2021-04-16,TOS,28942,12879,16063,21423,6897,622,ITI,ITI1,9,Toscana,Toscana,3729641,338587,9.08,0.78
779,2021-01-16,TOS,3271,1046,2225,3213,0,58,ITI,ITI1,9,Toscana,Toscana,3729641,341858,9.17,0.09
780,2021-04-26,TOS,10142,4932,5210,7458,2552,132,ITI,ITI1,9,Toscana,Toscana,3729641,352000,9.44,0.27
781,2021-01-02,TOS,3497,1096,2401,3453,0,44,ITI,ITI1,9,Toscana,Toscana,3729641,355497,9.53,0.09
782,2021-03-07,TOS,5646,2357,3289,1997,3543,106,ITI,ITI1,9,Toscana,Toscana,3729641,361143,9.68,0.15
783,2021-06-22,TOS,31003,15591,15412,22439,8190,374,ITI,ITI1,9,Toscana,Toscana,3729641,392146,10.51,0.83
784,2021-05-17,TOS,29694,14812,14882,20621,8872,201,ITI,ITI1,9,Toscana,Toscana,3729641,421840,11.31,0.8
785,2021-03-21,TOS,3293,1627,1666,1818,1433,42,ITI,ITI1,9,Toscana,Toscana,3729641,425133,11.4,0.09
786,2021-01-23,TOS,3966,1360,2606,634,3326,6,ITI,ITI1,9,Toscana,Toscana,3729641,429099,11.51,0.11
787,2021-06-29,TOS,36966,17992,18974,7975,28848,143,ITI,ITI1,9,Toscana,Toscana,3729641,466065,12.5,0.99
788,2021-05-03,TOS,11927,5507,6420,10369,1317,241,ITI,ITI1,9,Toscana,Toscana,3729641,477992,12.82,0.32
789,2021-05-22,TOS,26016,12658,13358,21457,4285,274,ITI,ITI1,9,Toscana,Toscana,3729641,504008,13.51,0.7
790,2021-05-05,TOS,30112,13439,16673,14880,14511,721,ITI,ITI1,9,Toscana,Toscana,3729641,534120,14.32,0.81
791,2021-02-28,TOS,1649,667,982,851,727,71,ITI,ITI1,9,Toscana,Toscana,3729641,535769,14.37,0.04
792,2021-02-11,TOS,5384,2022,3362,5064,242,78,ITI,ITI1,9,Toscana,Toscana,3729641,541153,14.51,0.14
793,2021-02-09,TOS,4488,1468,3020,3763,611,114,ITI,ITI1,9,Toscana,Toscana,3729641,545641,14.63,0.12
794,2021-04-02,TOS,31989,13569,18420,23714,8027,248,ITI,ITI1,9,Toscana,Toscana,3729641,577630,15.49,0.86
795,2021-06-24,TOS,29419,14600,14819,19298,9734,387,ITI,ITI1,9,Toscana,Toscana,3729641,607049,16.28,0.79
796,2021-05-15,TOS,29339,13851,15488,22864,5887,588,ITI,ITI1,9,Toscana,Toscana,3729641,636388,17.06,0.79
797,2021-04-28,TOS,19121,8179,10942,3466,15307,348,ITI,ITI1,9,Toscana,Toscana,3729641,655509,17.58,0.51
798,2021-02-18,TOS,8822,3285,5537,7744,896,182,ITI,ITI1,9,Toscana,Toscana,3729641,664331,17.81,0.24
799,2021-05-29,TOS,31554,15255,16299,23166,8161,227,ITI,ITI1,9,Toscana,Toscana,3729641,695885,18.66,0.85
800,2021-03-23,TOS,9428,4402,5026,6963,2275,190,ITI,ITI1,9,Toscana,Toscana,3729641,705313,18.91,0.25
801,2020-12-30,TOS,327,104,223,326,0,1,ITI,ITI1,9,Toscana,Toscana,3729641,705640,18.92,0.01
802,2021-01-21,TOS,1589,686,903,858,722,9,ITI,ITI1,9,Toscana,Toscana,3729641,707229,18.96,0.04
803,2021-06-02,TOS,27570,13606,13964,21835,5507,228,ITI,ITI1,9,Toscana,Toscana,3729641,734799,19.7,0.74
804,2021-04-06,TOS,22225,9823,12402,18095,3717,413,ITI,ITI1,9,Toscana,Toscana,3729641,757024,20.3,0.6
805,2021-02-08,TOS,4097,1360,2737,3527,459,111,ITI,ITI1,9,Toscana,Toscana,3729641,761121,20.41,0.11
806,2021-05-19,TOS,27945,13567,14378,18621,9044,280,ITI,ITI1,9,Toscana,Toscana,3729641,789066,21.16,0.75
807,2021-04-13,TOS,8486,3505,4981,5749,2457,280,ITI,ITI1,9,Toscana,Toscana,3729641,797552,21.38,0.23
808,2021-02-16,TOS,9280,3340,5940,8329,721,230,ITI,ITI1,9,Toscana,Toscana,3729641,806832,21.63,0.25
809,2021-05-02,TOS,11167,4931,6236,8968,1964,235,ITI,ITI1,9,Toscana,Toscana,3729641,817999,21.93,0.3
810,2021-02-25,TOS,10633,4306,6327,9471,998,164,ITI,ITI1,9,Toscana,Toscana,3729641,828632,22.22,0.29
811,2021-06-28,TOS,37636,18100,19536,8438,29032,166,ITI,ITI1,9,Toscana,Toscana,3729641,866268,23.23,1.01
812,2021-01-20,TOS,1332,638,694,1021,248,63,ITI,ITI1,9,Toscana,Toscana,3729641,867600,23.26,0.04
813,2021-04-30,TOS,40191,17786,22405,19648,19893,650,ITI,ITI1,9,Toscana,Toscana,3729641,907791,24.34,1.08
814,2021-03-02,TOS,10599,3799,6800,7046,3444,109,ITI,ITI1,9,Toscana,Toscana,3729641,918390,24.62,0.28
815,2021-01-04,TOS,5066,1895,3171,5001,0,65,ITI,ITI1,9,Toscana,Toscana,3729641,923456,24.76,0.14
816,2021-04-14,TOS,20183,8345,11838,14539,5109,535,ITI,ITI1,9,Toscana,Toscana,3729641,943639,25.3,0.54
817,2021-06-14,TOS,31782,16321,15461,27397,4104,281,ITI,ITI1,9,Toscana,Toscana,3729641,975421,26.15,0.85
818,2021-03-04,TOS,17847,6950,10897,14616,3082,149,ITI,ITI1,9,Toscana,Toscana,3729641,993268,26.63,0.48
819,2021-03-28,TOS,6212,2808,3404,5880,254,78,ITI,ITI1,9,Toscana,Toscana,3729641,999480,26.8,0.17
820,2021-01-30,TOS,4622,1622,3000,179,4425,18,ITI,ITI1,9,Toscana,Toscana,3729641,1004102,26.92,0.12
821,2021-07-06,TOS,25663,12969,12694,11003,14444,216,ITI,ITI1,9,Toscana,Toscana,3729641,1029765,27.61,0.69
822,2021-05-10,TOS,26191,12386,13805,15328,10619,244,ITI,ITI1,9,Toscana,Toscana,3729641,1055956,28.31,0.7
823,2021-03-14,TOS,7174,2569,4605,3150,3935,89,ITI,ITI1,9,Toscana,Toscana,3729641,1063130,28.5,0.19
824,2021-06-10,TOS,26360,13522,12838,25485,534,341,ITI,ITI1,9,Toscana,Toscana,3729641,1089490,29.21,0.71
825,2021-05-24,TOS,33724,16703,17021,23854,9568,302,ITI,ITI1,9,Toscana,Toscana,3729641,1123214,30.12,0.9
826,2021-01-25,TOS,5127,1895,3232,242,4880,5,ITI,ITI1,9,Toscana,Toscana,3729641,1128341,30.25,0.14
827,2021-04-18,TOS,8359,4091,4268,7060,1029,270,ITI,ITI1,9,Toscana,Toscana,3729641,1136700,30.48,0.22
828,2021-01-09,TOS,4485,1596,2889,4419,0,66,ITI,ITI1,9,Toscana,Toscana,3729641,1141185,30.6,0.12
829,2021-03-18,TOS,9980,3984,5996,5870,3972,138,ITI,ITI1,9,Toscana,Toscana,3729641,1151165,30.87,0.27
830,2021-06-26,TOS,34525,16748,17777,9999,24301,225,ITI,ITI1,9,Toscana,Toscana,3729641,1185690,31.79,0.93
831,2021-06-09,TOS,34749,17518,17231,33908,425,416,ITI,ITI1,9,Toscana,Toscana,3729641,1220439,32.72,0.93
832,2021-05-12,TOS,34198,15574,18624,13581,20031,586,ITI,ITI1,9,Toscana,Toscana,3729641,1254637,33.64,0.92
833,2021-01-18,TOS,1119,636,483,971,98,50,ITI,ITI1,9,Toscana,Toscana,3729641,1255756,33.67,0.03
834,2021-02-01,TOS,5509,1958,3551,511,4988,10,ITI,ITI1,9,Toscana,Toscana,3729641,1261265,33.82,0.15
835,2021-04-25,TOS,11058,5248,5810,8758,2140,160,ITI,ITI1,9,Toscana,Toscana,3729641,1272323,34.11,0.3
836,2021-01-13,TOS,4062,1398,2664,3998,0,64,ITI,ITI1,9,Toscana,Toscana,3729641,1276385,34.22,0.11
837,2021-04-23,TOS,25645,11414,14231,8836,16307,502,ITI,ITI1,9,Toscana,Toscana,3729641,1302030,34.91,0.69
838,2021-03-20,TOS,6586,2977,3609,5363,1136,87,ITI,ITI1,9,Toscana,Toscana,3729641,1308616,35.09,0.18
839,2021-01-22,TOS,2866,1064,1802,525,2338,3,ITI,ITI1,9,Toscana,Toscana,3729641,1311482,35.16,0.08
840,2021-07-07,TOS,25007,12275,12732,9230,15605,172,ITI,ITI1,9,Toscana,Toscana,3729641,1336489,35.83,0.67
841,2021-03-27,TOS,8862,4153,4709,8513,215,134,ITI,ITI1,9,Toscana,Toscana,3729641,1345351,36.07,0.24
842,2021-06-21,TOS,31152,15454,15698,18134,12764,254,ITI,ITI1,9,Toscana,Toscana,3729641,1376503,36.91,0.84
843,2021-01-06,TOS,4519,1460,3059,4467,0,52,ITI,ITI1,9,Toscana,Toscana,3729641,1381022,37.03,0.12
844,2021-03-11,TOS,15897,6348,9549,12393,3329,175,ITI,ITI1,9,Toscana,Toscana,3729641,1396919,37.45,0.43
845,2021-06-19,TOS,26461,13885,12576,21384,4749,328,ITI,ITI1,9,Toscana,Toscana,3729641,1423380,38.16,0.71
846,2021-02-20,TOS,4640,1789,2851,3995,513,132,ITI,ITI1,9,Toscana,Toscana,3729641,1428020,38.29,0.12
847,2021-05-31,TOS,30281,14605,15676,19217,10823,241,ITI,ITI1,9,Toscana,Toscana,3729641,1458301,39.1,0.81
848,2021-05-14,TOS,33315,15405,17910,20018,12663,634,ITI,ITI1,9,Toscana,Toscana,3729641,1491616,39.99,0.89
849,2021-01-01,TOS,2370,788,1582,2325,0,45,ITI,ITI1,9,Toscana,Toscana,3729641,1493986,40.06,0.06
850,2021-04-11,TOS,3645,1680,1965,3337,155,153,ITI,ITI1,9,Toscana,Toscana,3729641,1497631,40.15,0.1
851,2021-07-03,TOS,29365,14789,14576,11853,17140,372,ITI,ITI1,9,Toscana,Toscana,3729641,1526996,40.94,0.79
852,2021-03-06,TOS,7110,2852,4258,2832,4196,82,ITI,ITI1,9,Toscana,Toscana,3729641,1534106,41.13,0.19
853,2021-02-03,TOS,4222,1452,2770,237,3981,4,ITI,ITI1,9,Toscana,Toscana,3729641,1538328,41.25,0.11
854,2021-01-15,TOS,3878,1347,2531,3818,0,60,ITI,ITI1,9,Toscana,Toscana,3729641,1542206,41.35,0.1
855,2021-06-18,TOS,30744,16210,14534,24980,5368,396,ITI,ITI1,9,Toscana,Toscana,3729641,1572950,42.17,0.82
856,2021-05-26,TOS,35591,17102,18489,20123,15200,268,ITI,ITI1,9,Toscana,Toscana,3729641,1608541,43.13,0.95
857,2021-03-30,TOS,17019,7643,9376,13267,3564,188,ITI,ITI1,9,Toscana,Toscana,3729641,1625560,43.58,0.46
858,2021-07-08,TOS,8351,4097,4254,3965,4304,82,ITI,ITI1,9,Toscana,Toscana,3729641,1633911,43.81,0.22
859,2021-04-04,TOS,13922,6609,7313,13508,253,161,ITI,ITI1,9,Toscana,Toscana,3729641,1647833,44.18,0.37
860,2021-03-16,TOS,4899,1882,3017,2565,2251,83,ITI,ITI1,9,Toscana,Toscana,3729641,1652732,44.31,0.13
861,2021-02-27,TOS,1984,756,1228,1007,902,75,ITI,ITI1,9,Toscana,Toscana,3729641,1654716,44.37,0.05
862,2021-06-07,TOS,34847,17071,17776,30913,3603,331,ITI,ITI1,9,Toscana,Toscana,3729641,1689563,45.3,0.93
863,2021-05-21,TOS,28885,13455,15430,17201,11411,273,ITI,ITI1,9,Toscana,Toscana,3729641,1718448,46.08,0.77
864,2021-03-01,TOS,4474,1734,2740,767,3641,66,ITI,ITI1,9,Toscana,Toscana,3729641,1722922,46.2,0.12
865,2021-05-23,TOS,28410,13661,14749,25558,2560,292,ITI,ITI1,9,Toscana,Toscana,3729641,1751332,46.96,0.76
866,2021-02-05,TOS,5749,2245,3504,1890,3825,34,ITI,ITI1,9,Toscana,Toscana,3729641,1757081,47.11,0.15
867,2021-05-16,TOS,26674,12886,13788,23887,2467,320,ITI,ITI1,9,Toscana,Toscana,3729641,1783755,47.83,0.72
868,2021-05-11,TOS,27950,12983,14967,12115,15467,368,ITI,ITI1,9,Toscana,Toscana,3729641,1811705,48.58,0.75
869,2021-03-13,TOS,9288,3310,5978,5172,3964,152,ITI,ITI1,9,Toscana,Toscana,3729641,1820993,48.82,0.25
870,2021-01-29,TOS,6144,1700,4444,292,5840,12,ITI,ITI1,9,Toscana,Toscana,3729641,1827137,48.99,0.16
871,2021-05-09,TOS,22533,9768,12765,9418,12861,254,ITI,ITI1,9,Toscana,Toscana,3729641,1849670,49.59,0.6
872,2021-05-20,TOS,29734,13887,15847,18607,10815,312,ITI,ITI1,9,Toscana,Toscana,3729641,1879404,50.39,0.8
873,2021-01-31,TOS,3050,1129,1921,103,2944,3,ITI,ITI1,9,Toscana,Toscana,3729641,1882454,50.47,0.08
874,2021-04-05,TOS,15285,6826,8459,14376,737,172,ITI,ITI1,9,Toscana,Toscana,3729641,1897739,50.88,0.41
875,2021-02-07,TOS,2806,952,1854,866,1920,20,ITI,ITI1,9,Toscana,Toscana,3729641,1900545,50.96,0.08
876,2021-05-18,TOS,28835,14269,14566,19742,8821,272,ITI,ITI1,9,Toscana,Toscana,3729641,1929380,51.73,0.77
877,2021-04-27,TOS,10354,4916,5438,3667,6487,200,ITI,ITI1,9,Toscana,Toscana,3729641,1939734,52.01,0.28
878,2021-01-17,TOS,2535,870,1665,1986,514,35,ITI,ITI1,9,Toscana,Toscana,3729641,1942269,52.08,0.07
879,2021-03-25,TOS,23896,10377,13519,15296,8352,248,ITI,ITI1,9,Toscana,Toscana,3729641,1966165,52.72,0.64
880,2021-04-12,TOS,2612,1183,1429,1791,654,167,ITI,ITI1,9,Toscana,Toscana,3729641,1968777,52.79,0.07
881,2021-05-13,TOS,35036,15450,19586,13200,21196,640,ITI,ITI1,9,Toscana,Toscana,3729641,2003813,53.73,0.94
882,2021-04-29,TOS,39303,17703,21600,18566,20080,657,ITI,ITI1,9,Toscana,Toscana,3729641,2043116,54.78,1.05
883,2021-03-24,TOS,20014,8302,11712,10417,9456,141,ITI,ITI1,9,Toscana,Toscana,3729641,2063130,55.32,0.54
884,2021-06-30,TOS,38194,18477,19717,8449,29532,213,ITI,ITI1,9,Toscana,Toscana,3729641,2101324,56.34,1.02
885,2021-02-14,TOS,9000,2569,6431,8740,110,150,ITI,ITI1,9,Toscana,Toscana,3729641,2110324,56.58,0.24
886,2021-05-25,TOS,34166,16486,17680,19263,14619,284,ITI,ITI1,9,Toscana,Toscana,3729641,2144490,57.5,0.92
887,2021-03-29,TOS,9670,4828,4842,9216,324,130,ITI,ITI1,9,Toscana,Toscana,3729641,2154160,57.76,0.26
888,2021-05-27,TOS,28321,13173,15148,13265,14834,222,ITI,ITI1,9,Toscana,Toscana,3729641,2182481,58.52,0.76
889,2021-03-31,TOS,32708,13252,19456,20219,12163,326,ITI,ITI1,9,Toscana,Toscana,3729641,2215189,59.39,0.88
890,2021-03-22,TOS,5251,2763,2488,4678,444,129,ITI,ITI1,9,Toscana,Toscana,3729641,2220440,59.53,0.14
891,2020-12-27,TOS,620,267,353,615,0,5,ITI,ITI1,9,Toscana,Toscana,3729641,2221060,59.55,0.02
892,2021-01-03,TOS,3336,1052,2284,3290,0,46,ITI,ITI1,9,Toscana,Toscana,3729641,2224396,59.64,0.09
893,2021-02-15,TOS,8770,3376,5394,7775,826,169,ITI,ITI1,9,Toscana,Toscana,3729641,2233166,59.88,0.24
894,2021-02-22,TOS,9818,4253,5565,9169,277,372,ITI,ITI1,9,Toscana,Toscana,3729641,2242984,60.14,0.26
895,2021-02-10,TOS,4263,1281,2982,3584,523,156,ITI,ITI1,9,Toscana,Toscana,3729641,2247247,60.25,0.11
896,2021-05-04,TOS,18313,8215,10098,12428,5451,434,ITI,ITI1,9,Toscana,Toscana,3729641,2265560,60.74,0.49
897,2021-02-12,TOS,7618,2694,4924,7296,213,109,ITI,ITI1,9,Toscana,Toscana,3729641,2273178,60.95,0.2
898,2021-01-26,TOS,5393,1792,3601,216,5173,4,ITI,ITI1,9,Toscana,Toscana,3729641,2278571,61.09,0.14
899,2021-05-06,TOS,31329,13620,17709,13481,17168,680,ITI,ITI1,9,Toscana,Toscana,3729641,2309900,61.93,0.84
900,2021-04-19,TOS,9097,4510,4587,7755,1032,310,ITI,ITI1,9,Toscana,Toscana,3729641,2318997,62.18,0.24
901,2021-04-17,TOS,20533,9206,11327,17920,2134,479,ITI,ITI1,9,Toscana,Toscana,3729641,2339530,62.73,0.55
902,2021-01-24,TOS,3349,1073,2276,198,3148,3,ITI,ITI1,9,Toscana,Toscana,3729641,2342879,62.82,0.09
903,2021-05-08,TOS,29151,13113,16038,13288,15472,391,ITI,ITI1,9,Toscana,Toscana,3729641,2372030,63.6,0.78
904,2021-03-12,TOS,16976,6614,10362,13267,3528,181,ITI,ITI1,9,Toscana,Toscana,3729641,2389006,64.05,0.46
905,2021-01-14,TOS,3255,1179,2076,3220,0,35,ITI,ITI1,9,Toscana,Toscana,3729641,2392261,64.14,0.09
906,2021-06-20,TOS,25175,12485,12690,15420,9517,238,ITI,ITI1,9,Toscana,Toscana,3729641,2417436,64.82,0.67
907,2021-04-24,TOS,13434,6168,7266,5623,7443,368,ITI,ITI1,9,Toscana,Toscana,3729641,2430870,65.18,0.36
908,2021-06-27,TOS,33290,16071,17219,5923,27239,128,ITI,ITI1,9,Toscana,Toscana,3729641,2464160,66.07,0.89
909,2021-05-01,TOS,23317,10065,13252,13724,9183,410,ITI,ITI1,9,Toscana,Toscana,3729641,2487477,66.69,0.63
910,2021-03-05,TOS,16877,6688,10189,11947,4754,176,ITI,ITI1,9,Toscana,Toscana,3729641,2504354,67.15,0.45
911,2021-06-13,TOS,24611,12347,12264,22598,1665,348,ITI,ITI1,9,Toscana,Toscana,3729641,2528965,67.81,0.66
912,2021-07-05,TOS,30430,15029,15401,10339,19863,228,ITI,ITI1,9,Toscana,Toscana,3729641,2559395,68.62,0.82
913,2021-03-08,TOS,6707,2945,3762,1844,4820,43,ITI,ITI1,9,Toscana,Toscana,3729641,2566102,68.8,0.18
914,2021-06-16,TOS,31738,16248,15490,26254,5168,316,ITI,ITI1,9,Toscana,Toscana,3729641,2597840,69.65,0.85
915,2021-05-30,TOS,28673,13944,14729,21486,6945,242,ITI,ITI1,9,Toscana,Toscana,3729641,2626513,70.42,0.77
916,2021-07-04,TOS,30946,15010,15936,9360,21299,287,ITI,ITI1,9,Toscana,Toscana,3729641,2657459,71.25,0.83
917,2021-05-07,TOS,32122,14691,17431,11572,20142,408,ITI,ITI1,9,Toscana,Toscana,3729641,2689581,72.11,0.86
918,2021-02-13,TOS,7786,2361,5425,7416,227,143,ITI,ITI1,9,Toscana,Toscana,3729641,2697367,72.32,0.21
919,2021-01-07,TOS,6018,1751,4267,5932,0,86,ITI,ITI1,9,Toscana,Toscana,3729641,2703385,72.48,0.16
920,2021-02-21,TOS,5105,2089,3016,4730,170,205,ITI,ITI1,9,Toscana,Toscana,3729641,2708490,72.62,0.14
921,2021-06-01,TOS,26911,13366,13545,22852,3814,245,ITI,ITI1,9,Toscana,Toscana,3729641,2735401,73.34,0.72
922,2021-07-02,TOS,28181,14131,14050,10800,17102,279,ITI,ITI1,9,Toscana,Toscana,3729641,2763582,74.1,0.76
923,2021-06-15,TOS,31186,16055,15131,26289,4564,333,ITI,ITI1,9,Toscana,Toscana,3729641,2794768,74.93,0.84
924,2021-03-10,TOS,18373,7408,10965,14252,4018,103,ITI,ITI1,9,Toscana,Toscana,3729641,2813141,75.43,0.49
925,2021-02-02,TOS,3743,1475,2268,189,3547,7,ITI,ITI1,9,Toscana,Toscana,3729641,2816884,75.53,0.1
926,2020-12-31,TOS,802,201,601,798,0,4,ITI,ITI1,9,Toscana,Toscana,3729641,2817686,75.55,0.02
927,2021-04-10,TOS,11722,5349,6373,10746,743,233,ITI,ITI1,9,Toscana,Toscana,3729641,2829408,75.86,0.31
928,2021-02-19,TOS,8292,2952,5340,7602,513,177,ITI,ITI1,9,Toscana,Toscana,3729641,2837700,76.09,0.22
929,2021-01-08,TOS,5947,1643,4304,5854,0,93,ITI,ITI1,9,Toscana,Toscana,3729641,2843647,76.24,0.16
930,2021-04-01,TOS,27056,11230,15826,16162,10662,232,ITI,ITI1,9,Toscana,Toscana,3729641,2870703,76.97,0.73
931,2021-03-15,TOS,8698,3645,5053,4084,4443,171,ITI,ITI1,9,Toscana,Toscana,3729641,2879401,77.2,0.23
932,2021-06-23,TOS,31507,15271,16236,19786,11370,351,ITI,ITI1,9,Toscana,Toscana,3729641,2910908,78.05,0.84
933,2021-01-10,TOS,3002,1105,1897,2948,0,54,ITI,ITI1,9,Toscana,Toscana,3729641,2913910,78.13,0.08
934,2021-04-20,TOS,18160,8110,10050,12228,5575,357,ITI,ITI1,9,Toscana,Toscana,3729641,2932070,78.62,0.49
935,2021-04-03,TOS,15013,6646,8367,13674,1126,213,ITI,ITI1,9,Toscana,Toscana,3729641,2947083,79.02,0.4
936,2021-01-27,TOS,4835,1573,3262,201,4629,5,ITI,ITI1,9,Toscana,Toscana,3729641,2951918,79.15,0.13
937,2021-03-17,TOS,11421,4587,6834,6799,4529,93,ITI,ITI1,9,Toscana,Toscana,3729641,2963339,79.45,0.31
938,2021-06-25,TOS,33564,16769,16795,12112,21177,275,ITI,ITI1,9,Toscana,Toscana,3729641,2996903,80.35,0.9
939,2021-06-08,TOS,32522,16661,15861,31724,442,356,ITI,ITI1,9,Toscana,Toscana,3729641,3029425,81.23,0.87
940,2021-02-26,TOS,10080,3834,6246,8659,1206,215,ITI,ITI1,9,Toscana,Toscana,3729641,3039505,81.5,0.27
941,2021-06-06,TOS,28297,13649,14648,22577,5361,359,ITI,ITI1,9,Toscana,Toscana,3729641,3067802,82.25,0.76
942,2021-02-06,TOS,4527,1550,2977,1262,3233,32,ITI,ITI1,9,Toscana,Toscana,3729641,3072329,82.38,0.12
943,2021-06-11,TOS,29702,15451,14251,24727,4622,353,ITI,ITI1,9,Toscana,Toscana,3729641,3102031,83.17,0.8
944,2021-04-15,TOS,24404,10195,14209,15305,8573,526,ITI,ITI1,9,Toscana,Toscana,3729641,3126435,83.83,0.65
945,2021-02-17,TOS,8176,3170,5006,7305,752,119,ITI,ITI1,9,Toscana,Toscana,3729641,3134611,84.05,0.22
946,2021-05-28,TOS,30079,13914,16165,17407,12445,227,ITI,ITI1,9,Toscana,Toscana,3729641,3164690,84.85,0.81
947,2021-04-22,TOS,35693,15292,20401,17385,17485,823,ITI,ITI1,9,Toscana,Toscana,3729641,3200383,85.81,0.96
948,2021-02-24,TOS,10371,4467,5904,10040,197,134,ITI,ITI1,9,Toscana,Toscana,3729641,3210754,86.09,0.28
949,2021-06-04,TOS,28251,13378,14873,20234,7755,262,ITI,ITI1,9,Toscana,Toscana,3729641,3239005,86.84,0.76
950,2021-04-08,TOS,29684,12558,17126,22938,6386,360,ITI,ITI1,9,Toscana,Toscana,3729641,3268689,87.64,0.8
951,2021-03-03,TOS,18228,6538,11690,14498,3606,124,ITI,ITI1,9,Toscana,Toscana,3729641,3286917,88.13,0.49
952,2021-01-05,TOS,5249,1755,3494,5193,0,56,ITI,ITI1,9,Toscana,Toscana,3729641,3292166,88.27,0.14
953,2021-01-19,TOS,1106,533,573,1064,0,42,ITI,ITI1,9,Toscana,Toscana,3729641,3293272,88.3,0.03
954,2021-01-12,TOS,3581,1398,2183,3508,0,73,ITI,ITI1,9,Toscana,Toscana,3729641,3296853,88.4,0.1
955,2021-01-27,VDA,151,71,80,79,72,0,ITC,ITC2,2,Valle d'Aosta / Vallée d'Aoste,Valle d'Aosta,125666,151,0.12,0.12
956,2021-04-20,VDA,933,430,503,707,194,32,ITC,ITC2,2,Valle d'Aosta / Vallée d'Aoste,Valle d'Aosta,125666,1084,0.86,0.74
957,2021-01-10,VDA,220,71,149,208,0,12,ITC,ITC2,2,Valle d'Aosta / Vallée d'Aoste,Valle d'Aosta,125666,1304,1.04,0.18
958,2020-12-27,VDA,20,9,11,20,0,0,ITC,ITC2,2,Valle d'Aosta / Vallée d'Aoste,Valle d'Aosta,125666,1324,1.05,0.02
959,2021-03-08,VDA,485,233,252,237,245,3,ITC,ITC2,2,Valle d'Aosta / Vallée d'Aoste,Valle d'Aosta,125666,1809,1.44,0.39
960,2021-05-04,VDA,1135,510,625,434,673,28,ITC,ITC2,2,Valle d'Aosta / Vallée d'Aoste,Valle d'Aosta,125666,2944,2.34,0.9
961,2021-06-16,VDA,683,365,318,642,41,0,ITC,ITC2,2,Valle d'Aosta / Vallée d'Aoste,Valle d'Aosta,125666,3627,2.89,0.54
962,2021-03-15,VDA,362,123,239,150,203,9,ITC,ITC2,2,Valle d'Aosta / Vallée d'Aoste,Valle d'Aosta,125666,3989,3.17,0.29
963,2021-05-11,VDA,647,325,322,469,151,27,ITC,ITC2,2,Valle d'Aosta / Vallée d'Aoste,Valle d'Aosta,125666,4636,3.69,0.51
964,2021-04-27,VDA,978,423,555,650,292,36,ITC,ITC2,2,Valle d'Aosta / Vallée d'Aoste,Valle d'Aosta,125666,5614,4.47,0.78
965,2021-01-17,VDA,131,56,75,131,0,0,ITC,ITC2,2,Valle d'Aosta / Vallée d'Aoste,Valle d'Aosta,125666,5745,4.57,0.1
966,2021-06-23,VDA,1043,551,492,427,616,0,ITC,ITC2,2,Valle d'Aosta / Vallée d'Aoste,Valle d'Aosta,125666,6788,5.4,0.83
967,2021-05-30,VDA,865,429,436,682,171,12,ITC,ITC2,2,Valle d'Aosta / Vallée d'Aoste,Valle d'Aosta,125666,7653,6.09,0.69
968,2021-05-28,VDA,975,414,561,544,412,19,ITC,ITC2,2,Valle d'Aosta / Vallée d'Aoste,Valle d'Aosta,125666,8628,6.87,0.78
969,2021-02-17,VDA,327,144,183,223,100,4,ITC,ITC2,2,Valle d'Aosta / Vallée d'Aoste,Valle d'Aosta,125666,8955,7.13,0.26
970,2021-02-03,VDA,351,114,237,14,337,0,ITC,ITC2,2,Valle d'Aosta / Vallée d'Aoste,Valle d'Aosta,125666,9306,7.41,0.28
971,2021-04-01,VDA,777,394,383,746,12,19,ITC,ITC2,2,Valle d'Aosta / Vallée d'Aoste,Valle d'Aosta,125666,10083,8.02,0.62
972,2021-04-03,VDA,676,341,335,649,15,12,ITC,ITC2,2,Valle d'Aosta / Vallée d'Aoste,Valle d'Aosta,125666,10759,8.56,0.54
973,2021-03-20,VDA,208,86,122,167,36,5,ITC,ITC2,2,Valle d'Aosta / Vallée d'Aoste,Valle d'Aosta,125666,10967,8.73,0.17
974,2021-06-28,VDA,986,496,490,329,657,0,ITC,ITC2,2,Valle d'Aosta / Vallée d'Aoste,Valle d'Aosta,125666,11953,9.51,0.78
975,2021-06-11,VDA,1047,483,564,764,283,0,ITC,ITC2,2,Valle d'Aosta / Vallée d'Aoste,Valle d'Aosta,125666,13000,10.34,0.83
976,2021-05-23,VDA,999,465,534,652,341,6,ITC,ITC2,2,Valle d'Aosta / Vallée d'Aoste,Valle d'Aosta,125666,13999,11.14,0.79
977,2021-01-29,VDA,318,138,180,2,316,0,ITC,ITC2,2,Valle d'Aosta / Vallée d'Aoste,Valle d'Aosta,125666,14317,11.39,0.25
978,2021-04-22,VDA,1068,450,618,652,383,33,ITC,ITC2,2,Valle d'Aosta / Vallée d'Aoste,Valle d'Aosta,125666,15385,12.24,0.85
979,2021-05-02,VDA,765,345,420,581,160,24,ITC,ITC2,2,Valle d'Aosta / Vallée d'Aoste,Valle d'Aosta,125666,16150,12.85,0.61
980,2021-01-22,VDA,56,21,35,20,36,0,ITC,ITC2,2,Valle d'Aosta / Vallée d'Aoste,Valle d'Aosta,125666,16206,12.9,0.04
981,2021-01-08,VDA,299,130,169,299,0,0,ITC,ITC2,2,Valle d'Aosta / Vallée d'Aoste,Valle d'Aosta,125666,16505,13.13,0.24
982,2021-03-06,VDA,22,4,18,18,0,4,ITC,ITC2,2,Valle d'Aosta / Vallée d'Aoste,Valle d'Aosta,125666,16527,13.15,0.02
983,2021-02-05,VDA,294,102,192,101,193,0,ITC,ITC2,2,Valle d'Aosta / Vallée d'Aoste,Valle d'Aosta,125666,16821,13.39,0.23
984,2021-02-22,VDA,316,94,222,210,103,3,ITC,ITC2,2,Valle d'Aosta / Vallée d'Aoste,Valle d'Aosta,125666,17137,13.64,0.25
985,2021-05-16,VDA,688,341,347,338,341,9,ITC,ITC2,2,Valle d'Aosta / Vallée d'Aoste,Valle d'Aosta,125666,17825,14.18,0.55
986,2021-04-15,VDA,810,377,433,638,139,33,ITC,ITC2,2,Valle d'Aosta / Vallée d'Aoste,Valle d'Aosta,125666,18635,14.83,0.64
987,2021-07-07,VDA,792,439,353,430,362,0,ITC,ITC2,2,Valle d'Aosta / Vallée d'Aoste,Valle d'Aosta,125666,19427,15.46,0.63
988,2021-06-09,VDA,1027,535,492,991,36,0,ITC,ITC2,2,Valle d'Aosta / Vallée d'Aoste,Valle d'Aosta,125666,20454,16.28,0.82
989,2021-03-01,VDA,181,66,115,139,34,8,ITC,ITC2,2,Valle d'Aosta / Vallée d'Aoste,Valle d'Aosta,125666,20635,16.42,0.14
990,2021-02-15,VDA,264,136,128,225,35,4,ITC,ITC2,2,Valle d'Aosta / Vallée d'Aoste,Valle d'Aosta,125666,20899,16.63,0.21
991,2021-06-30,VDA,1117,542,575,425,692,0,ITC,ITC2,2,Valle d'Aosta / Vallée d'Aoste,Valle d'Aosta,125666,22016,17.52,0.89
992,2021-01-31,VDA,291,91,200,58,233,0,ITC,ITC2,2,Valle d'Aosta / Vallée d'Aoste,Valle d'Aosta,125666,22307,17.75,0.23
993,2021-02-10,VDA,248,77,171,141,107,0,ITC,ITC2,2,Valle d'Aosta / Vallée d'Aoste,Valle d'Aosta,125666,22555,17.95,0.2
994,2021-03-25,VDA,389,154,235,364,10,15,ITC,ITC2,2,Valle d'Aosta / Vallée d'Aoste,Valle d'Aosta,125666,22944,18.26,0.31
995,2021-05-21,VDA,917,433,484,515,386,16,ITC,ITC2,2,Valle d'Aosta / Vallée d'Aoste,Valle d'Aosta,125666,23861,18.99,0.73
996,2021-04-17,VDA,638,407,231,593,2,43,ITC,ITC2,2,Valle d'Aosta / Vallée d'Aoste,Valle d'Aosta,125666,24499,19.5,0.51
997,2021-01-07,VDA,276,111,165,276,0,0,ITC,ITC2,2,Valle d'Aosta / Vallée d'Aoste,Valle d'Aosta,125666,24775,19.71,0.22
998,2021-02-19,VDA,292,102,190,266,24,2,ITC,ITC2,2,Valle d'Aosta / Vallée d'Aoste,Valle d'Aosta,125666,25067,19.95,0.23
999,2021-02-24,VDA,183,82,101,162,19,2,ITC,ITC2,2,Valle d'Aosta / Vallée d'Aoste,Valle d'Aosta,125666,25250,20.09,0.15
1000,2021-04-08,VDA,584,282,302,420,143,21,ITC,ITC2,2,Valle d'Aosta / Vallée d'Aoste,Valle d'Aosta,125666,25834,20.56,0.46
1001,2021-06-13,VDA,851,399,452,373,478,0,ITC,ITC2,2,Valle d'Aosta / Vallée d'Aoste,Valle d'Aosta,125666,26685,21.23,0.68
1002,2021-06-08,VDA,712,356,356,679,33,0,ITC,ITC2,2,Valle d'Aosta / Vallée d'Aoste,Valle d'Aosta,125666,27397,21.8,0.57
1003,2021-05-09,VDA,574,287,287,425,130,19,ITC,ITC2,2,Valle d'Aosta / Vallée d'Aoste,Valle d'Aosta,125666,27971,22.26,0.46
1004,2021-03-17,VDA,433,185,248,259,160,14,ITC,ITC2,2,Valle d'Aosta / Vallée d'Aoste,Valle d'Aosta,125666,28404,22.6,0.34
1005,2021-03-03,VDA,255,118,137,182,68,5,ITC,ITC2,2,Valle d'Aosta / Vallée d'Aoste,Valle d'Aosta,125666,28659,22.81,0.2
1006,2021-03-13,VDA,147,88,59,141,0,6,ITC,ITC2,2,Valle d'Aosta / Vallée d'Aoste,Valle d'Aosta,125666,28806,22.92,0.12
1007,2021-01-15,VDA,218,82,136,218,0,0,ITC,ITC2,2,Valle d'Aosta / Vallée d'Aoste,Valle d'Aosta,125666,29024,23.1,0.17
1008,2021-03-31,VDA,555,302,253,511,26,18,ITC,ITC2,2,Valle d'Aosta / Vallée d'Aoste,Valle d'Aosta,125666,29579,23.54,0.44
1009,2021-06-04,VDA,908,383,525,474,434,0,ITC,ITC2,2,Valle d'Aosta / Vallée d'Aoste,Valle d'Aosta,125666,30487,24.26,0.72
1010,2021-01-19,VDA,256,77,179,256,0,0,ITC,ITC2,2,Valle d'Aosta / Vallée d'Aoste,Valle d'Aosta,125666,30743,24.46,0.2
1011,2021-04-12,VDA,486,186,300,306,163,17,ITC,ITC2,2,Valle d'Aosta / Vallée d'Aoste,Valle d'Aosta,125666,31229,24.85,0.39
1012,2021-04-29,VDA,1291,634,657,736,534,21,ITC,ITC2,2,Valle d'Aosta / Vallée d'Aoste,Valle d'Aosta,125666,32520,25.88,1.03
1013,2021-04-13,VDA,373,171,202,311,44,18,ITC,ITC2,2,Valle d'Aosta / Vallée d'Aoste,Valle d'Aosta,125666,32893,26.17,0.3
1014,2021-07-05,VDA,834,355,479,326,508,0,ITC,ITC2,2,Valle d'Aosta / Vallée d'Aoste,Valle d'Aosta,125666,33727,26.84,0.66
1015,2021-03-27,VDA,333,164,169,289,31,13,ITC,ITC2,2,Valle d'Aosta / Vallée d'Aoste,Valle d'Aosta,125666,34060,27.1,0.26
1016,2021-06-18,VDA,998,443,555,599,399,0,ITC,ITC2,2,Valle d'Aosta / Vallée d'Aoste,Valle d'Aosta,125666,35058,27.9,0.79
1017,2021-03-29,VDA,493,233,260,448,40,5,ITC,ITC2,2,Valle d'Aosta / Vallée d'Aoste,Valle d'Aosta,125666,35551,28.29,0.39
1018,2021-05-25,VDA,1115,530,585,529,574,12,ITC,ITC2,2,Valle d'Aosta / Vallée d'Aoste,Valle d'Aosta,125666,36666,29.18,0.89
1019,2021-02-14,VDA,48,16,32,1,47,0,ITC,ITC2,2,Valle d'Aosta / Vallée d'Aoste,Valle d'Aosta,125666,36714,29.22,0.04
1020,2021-05-08,VDA,904,540,364,497,378,29,ITC,ITC2,2,Valle d'Aosta / Vallée d'Aoste,Valle d'Aosta,125666,37618,29.93,0.72
1021,2021-04-05,VDA,464,223,241,439,6,19,ITC,ITC2,2,Valle d'Aosta / Vallée d'Aoste,Valle d'Aosta,125666,38082,30.3,0.37
1022,2021-06-27,VDA,1250,607,643,322,928,0,ITC,ITC2,2,Valle d'Aosta / Vallée d'Aoste,Valle d'Aosta,125666,39332,31.3,0.99
1023,2021-01-05,VDA,150,54,96,150,0,0,ITC,ITC2,2,Valle d'Aosta / Vallée d'Aoste,Valle d'Aosta,125666,39482,31.42,0.12
1024,2021-01-14,VDA,237,69,168,237,0,0,ITC,ITC2,2,Valle d'Aosta / Vallée d'Aoste,Valle d'Aosta,125666,39719,31.61,0.19
1025,2021-04-24,VDA,722,400,322,533,167,22,ITC,ITC2,2,Valle d'Aosta / Vallée d'Aoste,Valle d'Aosta,125666,40441,32.18,0.57
1026,2021-04-19,VDA,751,325,426,519,209,23,ITC,ITC2,2,Valle d'Aosta / Vallée d'Aoste,Valle d'Aosta,125666,41192,32.78,0.6
1027,2021-01-16,VDA,237,80,157,237,0,0,ITC,ITC2,2,Valle d'Aosta / Vallée d'Aoste,Valle d'Aosta,125666,41429,32.97,0.19
1028,2021-06-22,VDA,1189,666,523,541,648,0,ITC,ITC2,2,Valle d'Aosta / Vallée d'Aoste,Valle d'Aosta,125666,42618,33.91,0.95
1029,2021-03-14,VDA,392,200,192,373,0,19,ITC,ITC2,2,Valle d'Aosta / Vallée d'Aoste,Valle d'Aosta,125666,43010,34.23,0.31
1030,2021-04-26,VDA,715,327,388,512,170,33,ITC,ITC2,2,Valle d'Aosta / Vallée d'Aoste,Valle d'Aosta,125666,43725,34.79,0.57
1031,2021-07-01,VDA,962,473,489,341,621,0,ITC,ITC2,2,Valle d'Aosta / Vallée d'Aoste,Valle d'Aosta,125666,44687,35.56,0.77
1032,2021-01-09,VDA,443,199,244,442,0,1,ITC,ITC2,2,Valle d'Aosta / Vallée d'Aoste,Valle d'Aosta,125666,45130,35.91,0.35
1033,2021-02-26,VDA,207,58,149,108,85,14,ITC,ITC2,2,Valle d'Aosta / Vallée d'Aoste,Valle d'Aosta,125666,45337,36.08,0.16
1034,2021-04-10,VDA,404,190,214,387,5,12,ITC,ITC2,2,Valle d'Aosta / Vallée d'Aoste,Valle d'Aosta,125666,45741,36.4,0.32
1035,2020-12-31,VDA,18,4,14,18,0,0,ITC,ITC2,2,Valle d'Aosta / Vallée d'Aoste,Valle d'Aosta,125666,45759,36.41,0.01
1036,2021-06-06,VDA,1160,582,578,787,373,0,ITC,ITC2,2,Valle d'Aosta / Vallée d'Aoste,Valle d'Aosta,125666,46919,37.34,0.92
1037,2021-06-15,VDA,876,479,397,621,255,0,ITC,ITC2,2,Valle d'Aosta / Vallée d'Aoste,Valle d'Aosta,125666,47795,38.03,0.7
1038,2021-03-05,VDA,275,124,151,52,222,1,ITC,ITC2,2,Valle d'Aosta / Vallée d'Aoste,Valle d'Aosta,125666,48070,38.25,0.22
1039,2021-01-26,VDA,139,48,91,0,139,0,ITC,ITC2,2,Valle d'Aosta / Vallée d'Aoste,Valle d'Aosta,125666,48209,38.36,0.11
1040,2021-02-12,VDA,263,96,167,216,46,1,ITC,ITC2,2,Valle d'Aosta / Vallée d'Aoste,Valle d'Aosta,125666,48472,38.57,0.21
1041,2021-01-12,VDA,302,72,230,302,0,0,ITC,ITC2,2,Valle d'Aosta / Vallée d'Aoste,Valle d'Aosta,125666,48774,38.81,0.24
1042,2021-05-24,VDA,1136,516,620,673,447,16,ITC,ITC2,2,Valle d'Aosta / Vallée d'Aoste,Valle d'Aosta,125666,49910,39.72,0.9
1043,2021-05-10,VDA,782,381,401,532,235,15,ITC,ITC2,2,Valle d'Aosta / Vallée d'Aoste,Valle d'Aosta,125666,50692,40.34,0.62
1044,2021-04-21,VDA,868,410,458,588,248,32,ITC,ITC2,2,Valle d'Aosta / Vallée d'Aoste,Valle d'Aosta,125666,51560,41.03,0.69
1045,2021-03-21,VDA,355,165,190,346,0,9,ITC,ITC2,2,Valle d'Aosta / Vallée d'Aoste,Valle d'Aosta,125666,51915,41.31,0.28
1046,2021-06-29,VDA,780,390,390,238,542,0,ITC,ITC2,2,Valle d'Aosta / Vallée d'Aoste,Valle d'Aosta,125666,52695,41.93,0.62
1047,2021-03-22,VDA,560,205,355,324,227,9,ITC,ITC2,2,Valle d'Aosta / Vallée d'Aoste,Valle d'Aosta,125666,53255,42.38,0.45
1048,2021-06-20,VDA,1131,545,586,487,644,0,ITC,ITC2,2,Valle d'Aosta / Vallée d'Aoste,Valle d'Aosta,125666,54386,43.28,0.9
1049,2021-03-12,VDA,531,175,356,291,226,14,ITC,ITC2,2,Valle d'Aosta / Vallée d'Aoste,Valle d'Aosta,125666,54917,43.7,0.42
1050,2021-03-10,VDA,438,183,255,220,213,5,ITC,ITC2,2,Valle d'Aosta / Vallée d'Aoste,Valle d'Aosta,125666,55355,44.05,0.35
1051,2021-02-21,VDA,18,3,15,0,18,0,ITC,ITC2,2,Valle d'Aosta / Vallée d'Aoste,Valle d'Aosta,125666,55373,44.06,0.01
1052,2021-06-01,VDA,871,469,402,518,353,0,ITC,ITC2,2,Valle d'Aosta / Vallée d'Aoste,Valle d'Aosta,125666,56244,44.76,0.69
1053,2021-02-23,VDA,216,123,93,215,0,1,ITC,ITC2,2,Valle d'Aosta / Vallée d'Aoste,Valle d'Aosta,125666,56460,44.93,0.17
1054,2021-06-03,VDA,1306,667,639,896,410,0,ITC,ITC2,2,Valle d'Aosta / Vallée d'Aoste,Valle d'Aosta,125666,57766,45.97,1.04
1055,2021-05-17,VDA,809,417,392,370,434,5,ITC,ITC2,2,Valle d'Aosta / Vallée d'Aoste,Valle d'Aosta,125666,58575,46.61,0.64
1056,2021-02-28,VDA,260,86,174,73,183,4,ITC,ITC2,2,Valle d'Aosta / Vallée d'Aoste,Valle d'Aosta,125666,58835,46.82,0.21
1057,2021-05-05,VDA,1038,566,472,434,582,22,ITC,ITC2,2,Valle d'Aosta / Vallée d'Aoste,Valle d'Aosta,125666,59873,47.64,0.83
1058,2021-05-03,VDA,839,400,439,458,351,30,ITC,ITC2,2,Valle d'Aosta / Vallée d'Aoste,Valle d'Aosta,125666,60712,48.31,0.67
1059,2021-03-07,VDA,64,30,34,11,53,0,ITC,ITC2,2,Valle d'Aosta / Vallée d'Aoste,Valle d'Aosta,125666,60776,48.36,0.05
1060,2021-01-30,VDA,439,202,237,12,425,2,ITC,ITC2,2,Valle d'Aosta / Vallée d'Aoste,Valle d'Aosta,125666,61215,48.71,0.35
1061,2021-01-25,VDA,147,65,82,0,147,0,ITC,ITC2,2,Valle d'Aosta / Vallée d'Aoste,Valle d'Aosta,125666,61362,48.83,0.12
1062,2021-05-14,VDA,960,442,518,249,669,42,ITC,ITC2,2,Valle d'Aosta / Vallée d'Aoste,Valle d'Aosta,125666,62322,49.59,0.76
1063,2021-02-01,VDA,404,127,277,84,317,3,ITC,ITC2,2,Valle d'Aosta / Vallée d'Aoste,Valle d'Aosta,125666,62726,49.91,0.32
1064,2021-07-08,VDA,621,352,269,13,608,0,ITC,ITC2,2,Valle d'Aosta / Vallée d'Aoste,Valle d'Aosta,125666,63347,50.41,0.49
1065,2021-03-30,VDA,402,223,179,365,20,17,ITC,ITC2,2,Valle d'Aosta / Vallée d'Aoste,Valle d'Aosta,125666,63749,50.73,0.32
1066,2021-05-12,VDA,1140,549,591,439,670,31,ITC,ITC2,2,Valle d'Aosta / Vallée d'Aoste,Valle d'Aosta,125666,64889,51.64,0.91
1067,2021-01-28,VDA,291,123,168,56,235,0,ITC,ITC2,2,Valle d'Aosta / Vallée d'Aoste,Valle d'Aosta,125666,65180,51.87,0.23
1068,2021-06-10,VDA,1002,558,444,960,42,0,ITC,ITC2,2,Valle d'Aosta / Vallée d'Aoste,Valle d'Aosta,125666,66182,52.67,0.8
1069,2021-03-02,VDA,339,166,173,291,3,45,ITC,ITC2,2,Valle d'Aosta / Vallée d'Aoste,Valle d'Aosta,125666,66521,52.93,0.27
1070,2021-01-11,VDA,325,112,213,325,0,0,ITC,ITC2,2,Valle d'Aosta / Vallée d'Aoste,Valle d'Aosta,125666,66846,53.19,0.26
1071,2021-06-24,VDA,1221,629,592,388,833,0,ITC,ITC2,2,Valle d'Aosta / Vallée d'Aoste,Valle d'Aosta,125666,68067,54.17,0.97
1072,2021-07-03,VDA,935,484,451,399,536,0,ITC,ITC2,2,Valle d'Aosta / Vallée d'Aoste,Valle d'Aosta,125666,69002,54.91,0.74
1073,2021-02-08,VDA,223,83,140,25,198,0,ITC,ITC2,2,Valle d'Aosta / Vallée d'Aoste,Valle d'Aosta,125666,69225,55.09,0.18
1074,2021-03-23,VDA,379,150,229,228,134,17,ITC,ITC2,2,Valle d'Aosta / Vallée d'Aoste,Valle d'Aosta,125666,69604,55.39,0.3
1075,2021-05-19,VDA,993,498,495,411,575,7,ITC,ITC2,2,Valle d'Aosta / Vallée d'Aoste,Valle d'Aosta,125666,70597,56.18,0.79
1076,2021-03-16,VDA,182,37,145,109,64,9,ITC,ITC2,2,Valle d'Aosta / Vallée d'Aoste,Valle d'Aosta,125666,70779,56.32,0.14
1077,2021-06-05,VDA,925,476,449,737,188,0,ITC,ITC2,2,Valle d'Aosta / Vallée d'Aoste,Valle d'Aosta,125666,71704,57.06,0.74
1078,2021-02-11,VDA,231,107,124,221,9,1,ITC,ITC2,2,Valle d'Aosta / Vallée d'Aoste,Valle d'Aosta,125666,71935,57.24,0.18
1079,2021-04-09,VDA,237,111,126,200,33,4,ITC,ITC2,2,Valle d'Aosta / Vallée d'Aoste,Valle d'Aosta,125666,72172,57.43,0.19
1080,2021-05-22,VDA,940,494,446,531,400,9,ITC,ITC2,2,Valle d'Aosta / Vallée d'Aoste,Valle d'Aosta,125666,73112,58.18,0.75
1081,2021-04-16,VDA,599,261,338,565,2,32,ITC,ITC2,2,Valle d'Aosta / Vallée d'Aoste,Valle d'Aosta,125666,73711,58.66,0.48
1082,2021-04-02,VDA,873,344,529,595,225,53,ITC,ITC2,2,Valle d'Aosta / Vallée d'Aoste,Valle d'Aosta,125666,74584,59.35,0.69
1083,2021-05-29,VDA,798,434,364,553,237,8,ITC,ITC2,2,Valle d'Aosta / Vallée d'Aoste,Valle d'Aosta,125666,75382,59.99,0.64
1084,2021-05-15,VDA,1065,614,451,367,685,13,ITC,ITC2,2,Valle d'Aosta / Vallée d'Aoste,Valle d'Aosta,125666,76447,60.83,0.85
1085,2021-02-04,VDA,294,86,208,8,286,0,ITC,ITC2,2,Valle d'Aosta / Vallée d'Aoste,Valle d'Aosta,125666,76741,61.07,0.23
1086,2021-04-28,VDA,1218,632,586,681,503,34,ITC,ITC2,2,Valle d'Aosta / Vallée d'Aoste,Valle d'Aosta,125666,77959,62.04,0.97
1087,2021-02-06,VDA,289,104,185,91,197,1,ITC,ITC2,2,Valle d'Aosta / Vallée d'Aoste,Valle d'Aosta,125666,78248,62.27,0.23
1088,2021-04-30,VDA,831,355,476,467,346,18,ITC,ITC2,2,Valle d'Aosta / Vallée d'Aoste,Valle d'Aosta,125666,79079,62.93,0.66
1089,2021-01-20,VDA,23,8,15,23,0,0,ITC,ITC2,2,Valle d'Aosta / Vallée d'Aoste,Valle d'Aosta,125666,79102,62.95,0.02
1090,2021-01-18,VDA,213,74,139,213,0,0,ITC,ITC2,2,Valle d'Aosta / Vallée d'Aoste,Valle d'Aosta,125666,79315,63.12,0.17
1091,2021-02-25,VDA,201,101,100,190,7,4,ITC,ITC2,2,Valle d'Aosta / Vallée d'Aoste,Valle d'Aosta,125666,79516,63.28,0.16
1092,2021-01-06,VDA,65,33,32,65,0,0,ITC,ITC2,2,Valle d'Aosta / Vallée d'Aoste,Valle d'Aosta,125666,79581,63.33,0.05
1093,2021-02-18,VDA,349,153,196,255,88,6,ITC,ITC2,2,Valle d'Aosta / Vallée d'Aoste,Valle d'Aosta,125666,79930,63.61,0.28
1094,2021-06-12,VDA,1232,599,633,1066,166,0,ITC,ITC2,2,Valle d'Aosta / Vallée d'Aoste,Valle d'Aosta,125666,81162,64.59,0.98
1095,2021-03-19,VDA,322,85,237,277,35,10,ITC,ITC2,2,Valle d'Aosta / Vallée d'Aoste,Valle d'Aosta,125666,81484,64.84,0.26
1096,2021-05-07,VDA,564,245,319,519,31,14,ITC,ITC2,2,Valle d'Aosta / Vallée d'Aoste,Valle d'Aosta,125666,82048,65.29,0.45
1097,2021-04-23,VDA,921,443,478,509,383,29,ITC,ITC2,2,Valle d'Aosta / Vallée d'Aoste,Valle d'Aosta,125666,82969,66.02,0.73
1098,2021-07-04,VDA,1191,530,661,351,840,0,ITC,ITC2,2,Valle d'Aosta / Vallée d'Aoste,Valle d'Aosta,125666,84160,66.97,0.95
1099,2021-05-18,VDA,970,484,486,349,617,4,ITC,ITC2,2,Valle d'Aosta / Vallée d'Aoste,Valle d'Aosta,125666,85130,67.74,0.77
1100,2021-02-07,VDA,292,120,172,190,102,0,ITC,ITC2,2,Valle d'Aosta / Vallée d'Aoste,Valle d'Aosta,125666,85422,67.98,0.23
1101,2021-04-11,VDA,479,208,271,462,0,17,ITC,ITC2,2,Valle d'Aosta / Vallée d'Aoste,Valle d'Aosta,125666,85901,68.36,0.38
1102,2021-04-04,VDA,572,253,319,550,1,21,ITC,ITC2,2,Valle d'Aosta / Vallée d'Aoste,Valle d'Aosta,125666,86473,68.81,0.46
1103,2021-02-13,VDA,216,196,20,213,1,2,ITC,ITC2,2,Valle d'Aosta / Vallée d'Aoste,Valle d'Aosta,125666,86689,68.98,0.17
1104,2021-01-13,VDA,337,110,227,337,0,0,ITC,ITC2,2,Valle d'Aosta / Vallée d'Aoste,Valle d'Aosta,125666,87026,69.25,0.27
1105,2021-04-06,VDA,741,381,360,595,112,34,ITC,ITC2,2,Valle d'Aosta / Vallée d'Aoste,Valle d'Aosta,125666,87767,69.84,0.59
1106,2021-03-18,VDA,136,43,93,96,37,3,ITC,ITC2,2,Valle d'Aosta / Vallée d'Aoste,Valle d'Aosta,125666,87903,69.95,0.11
1107,2021-06-26,VDA,1061,509,552,357,704,0,ITC,ITC2,2,Valle d'Aosta / Vallée d'Aoste,Valle d'Aosta,125666,88964,70.79,0.84
1108,2021-03-04,VDA,291,139,152,40,249,2,ITC,ITC2,2,Valle d'Aosta / Vallée d'Aoste,Valle d'Aosta,125666,89255,71.03,0.23
1109,2021-05-26,VDA,1209,587,622,565,633,11,ITC,ITC2,2,Valle d'Aosta / Vallée d'Aoste,Valle d'Aosta,125666,90464,71.99,0.96
1110,2021-05-01,VDA,940,563,377,439,484,17,ITC,ITC2,2,Valle d'Aosta / Vallée d'Aoste,Valle d'Aosta,125666,91404,72.74,0.75
1111,2021-04-14,VDA,941,430,511,689,224,28,ITC,ITC2,2,Valle d'Aosta / Vallée d'Aoste,Valle d'Aosta,125666,92345,73.48,0.75
1112,2021-07-06,VDA,878,477,401,160,718,0,ITC,ITC2,2,Valle d'Aosta / Vallée d'Aoste,Valle d'Aosta,125666,93223,74.18,0.7
1113,2021-01-02,VDA,6,5,1,6,0,0,ITC,ITC2,2,Valle d'Aosta / Vallée d'Aoste,Valle d'Aosta,125666,93229,74.19,0.0
1114,2021-03-26,VDA,498,204,294,472,7,19,ITC,ITC2,2,Valle d'Aosta / Vallée d'Aoste,Valle d'Aosta,125666,93727,74.58,0.4
1115,2021-06-17,VDA,775,422,353,626,149,0,ITC,ITC2,2,Valle d'Aosta / Vallée d'Aoste,Valle d'Aosta,125666,94502,75.2,0.62
1116,2021-01-21,VDA,33,12,21,33,0,0,ITC,ITC2,2,Valle d'Aosta / Vallée d'Aoste,Valle d'Aosta,125666,94535,75.23,0.03
1117,2021-01-04,VDA,142,59,83,142,0,0,ITC,ITC2,2,Valle d'Aosta / Vallée d'Aoste,Valle d'Aosta,125666,94677,75.34,0.11
1118,2021-03-28,VDA,522,212,310,492,1,29,ITC,ITC2,2,Valle d'Aosta / Vallée d'Aoste,Valle d'Aosta,125666,95199,75.76,0.42
1119,2021-03-11,VDA,197,76,121,66,131,0,ITC,ITC2,2,Valle d'Aosta / Vallée d'Aoste,Valle d'Aosta,125666,95396,75.91,0.16
1120,2021-06-02,VDA,1215,688,527,814,401,0,ITC,ITC2,2,Valle d'Aosta / Vallée d'Aoste,Valle d'Aosta,125666,96611,76.88,0.97
1121,2021-06-19,VDA,1288,667,621,669,619,0,ITC,ITC2,2,Valle d'Aosta / Vallée d'Aoste,Valle d'Aosta,125666,97899,77.9,1.02
1122,2021-03-09,VDA,206,96,110,166,32,8,ITC,ITC2,2,Valle d'Aosta / Vallée d'Aoste,Valle d'Aosta,125666,98105,78.07,0.16
1123,2021-02-20,VDA,251,210,41,238,10,3,ITC,ITC2,2,Valle d'Aosta / Vallée d'Aoste,Valle d'Aosta,125666,98356,78.27,0.2
1124,2021-05-27,VDA,1089,497,592,574,503,12,ITC,ITC2,2,Valle d'Aosta / Vallée d'Aoste,Valle d'Aosta,125666,99445,79.13,0.87
1125,2021-05-13,VDA,1139,556,583,515,599,25,ITC,ITC2,2,Valle d'Aosta / Vallée d'Aoste,Valle d'Aosta,125666,100584,80.04,0.91
1126,2021-02-02,VDA,273,70,203,2,271,0,ITC,ITC2,2,Valle d'Aosta / Vallée d'Aoste,Valle d'Aosta,125666,100857,80.26,0.22
1127,2021-06-25,VDA,977,445,532,324,653,0,ITC,ITC2,2,Valle d'Aosta / Vallée d'Aoste,Valle d'Aosta,125666,101834,81.04,0.78
1128,2021-05-20,VDA,807,363,444,358,440,9,ITC,ITC2,2,Valle d'Aosta / Vallée d'Aoste,Valle d'Aosta,125666,102641,81.68,0.64
1129,2021-07-02,VDA,865,383,482,305,560,0,ITC,ITC2,2,Valle d'Aosta / Vallée d'Aoste,Valle d'Aosta,125666,103506,82.37,0.69
1130,2021-03-24,VDA,515,230,285,255,257,3,ITC,ITC2,2,Valle d'Aosta / Vallée d'Aoste,Valle d'Aosta,125666,104021,82.78,0.41
1131,2021-05-06,VDA,1064,510,554,646,384,34,ITC,ITC2,2,Valle d'Aosta / Vallée d'Aoste,Valle d'Aosta,125666,105085,83.62,0.85
1132,2021-02-16,VDA,326,53,273,309,6,11,ITC,ITC2,2,Valle d'Aosta / Vallée d'Aoste,Valle d'Aosta,125666,105411,83.88,0.26
1133,2021-04-07,VDA,910,474,436,654,229,27,ITC,ITC2,2,Valle d'Aosta / Vallée d'Aoste,Valle d'Aosta,125666,106321,84.61,0.72
1134,2021-02-09,VDA,251,84,167,67,183,1,ITC,ITC2,2,Valle d'Aosta / Vallée d'Aoste,Valle d'Aosta,125666,106572,84.81,0.2
1135,2021-04-18,VDA,522,254,268,492,4,26,ITC,ITC2,2,Valle d'Aosta / Vallée d'Aoste,Valle d'Aosta,125666,107094,85.22,0.42
1136,2021-06-14,VDA,306,163,143,12,294,0,ITC,ITC2,2,Valle d'Aosta / Vallée d'Aoste,Valle d'Aosta,125666,107400,85.46,0.24
1137,2021-05-31,VDA,880,396,484,490,379,11,ITC,ITC2,2,Valle d'Aosta / Vallée d'Aoste,Valle d'Aosta,125666,108280,86.16,0.7
1138,2021-04-25,VDA,849,408,441,673,139,37,ITC,ITC2,2,Valle d'Aosta / Vallée d'Aoste,Valle d'Aosta,125666,109129,86.84,0.68
1139,2021-06-21,VDA,1122,600,522,617,505,0,ITC,ITC2,2,Valle d'Aosta / Vallée d'Aoste,Valle d'Aosta,125666,110251,87.73,0.89
1140,2021-06-07,VDA,710,347,363,649,61,0,ITC,ITC2,2,Valle d'Aosta / Vallée d'Aoste,Valle d'Aosta,125666,110961,88.3,0.56
1141,2021-02-27,VDA,231,85,146,119,107,5,ITC,ITC2,2,Valle d'Aosta / Vallée d'Aoste,Valle d'Aosta,125666,111192,88.48,0.18
1142,2021-02-06,PAT,575,299,276,434,141,0,ITH,ITH2,4,Provincia Autonoma Trento,P.A. Trento,541380,575,0.11,0.11
1143,2021-02-23,PAT,1112,395,717,898,213,1,ITH,ITH2,4,Provincia Autonoma Trento,P.A. Trento,541380,1687,0.31,0.21
1144,2021-05-17,PAT,4294,2122,2172,3932,351,11,ITH,ITH2,4,Provincia Autonoma Trento,P.A. Trento,541380,5981,1.1,0.79
1145,2021-04-14,PAT,3119,1465,1654,2375,737,7,ITH,ITH2,4,Provincia Autonoma Trento,P.A. Trento,541380,9100,1.68,0.58
1146,2021-03-28,PAT,753,294,459,749,2,2,ITH,ITH2,4,Provincia Autonoma Trento,P.A. Trento,541380,9853,1.82,0.14
1147,2021-05-31,PAT,4722,2174,2548,1675,3045,2,ITH,ITH2,4,Provincia Autonoma Trento,P.A. Trento,541380,14575,2.69,0.87
1148,2021-01-23,PAT,577,334,243,388,189,0,ITH,ITH2,4,Provincia Autonoma Trento,P.A. Trento,541380,15152,2.8,0.11
1149,2021-05-03,PAT,4260,2197,2063,4096,154,10,ITH,ITH2,4,Provincia Autonoma Trento,P.A. Trento,541380,19412,3.59,0.79
1150,2021-07-01,PAT,6918,3599,3319,3459,3320,139,ITH,ITH2,4,Provincia Autonoma Trento,P.A. Trento,541380,26330,4.86,1.28
1151,2021-05-05,PAT,4989,2580,2409,4674,297,18,ITH,ITH2,4,Provincia Autonoma Trento,P.A. Trento,541380,31319,5.79,0.92
1152,2021-01-16,PAT,319,148,171,319,0,0,ITH,ITH2,4,Provincia Autonoma Trento,P.A. Trento,541380,31638,5.84,0.06
1153,2021-03-09,PAT,1585,591,994,936,646,3,ITH,ITH2,4,Provincia Autonoma Trento,P.A. Trento,541380,33223,6.14,0.29
1154,2021-06-17,PAT,6599,3461,3138,2120,4477,2,ITH,ITH2,4,Provincia Autonoma Trento,P.A. Trento,541380,39822,7.36,1.22
1155,2021-03-14,PAT,108,65,43,21,87,0,ITH,ITH2,4,Provincia Autonoma Trento,P.A. Trento,541380,39930,7.38,0.02
1156,2021-03-26,PAT,3231,1257,1974,2613,610,8,ITH,ITH2,4,Provincia Autonoma Trento,P.A. Trento,541380,43161,7.97,0.6
1157,2021-06-19,PAT,3098,1696,1402,256,2842,0,ITH,ITH2,4,Provincia Autonoma Trento,P.A. Trento,541380,46259,8.54,0.57
1158,2021-04-09,PAT,2740,1162,1578,1535,1200,5,ITH,ITH2,4,Provincia Autonoma Trento,P.A. Trento,541380,48999,9.05,0.51
1159,2021-02-11,PAT,1135,365,770,796,339,0,ITH,ITH2,4,Provincia Autonoma Trento,P.A. Trento,541380,50134,9.26,0.21
1160,2021-02-25,PAT,1641,643,998,1199,441,1,ITH,ITH2,4,Provincia Autonoma Trento,P.A. Trento,541380,51775,9.56,0.3
1161,2020-12-30,PAT,7,3,4,7,0,0,ITH,ITH2,4,Provincia Autonoma Trento,P.A. Trento,541380,51782,9.56,0.0
1162,2021-06-05,PAT,4081,1915,2166,750,3331,0,ITH,ITH2,4,Provincia Autonoma Trento,P.A. Trento,541380,55863,10.32,0.75
1163,2021-05-22,PAT,3258,1598,1660,922,2333,3,ITH,ITH2,4,Provincia Autonoma Trento,P.A. Trento,541380,59121,10.92,0.6
1164,2021-04-21,PAT,2910,1359,1551,2855,50,5,ITH,ITH2,4,Provincia Autonoma Trento,P.A. Trento,541380,62031,11.46,0.54
1165,2021-01-28,PAT,530,147,383,48,482,0,ITH,ITH2,4,Provincia Autonoma Trento,P.A. Trento,541380,62561,11.56,0.1
1166,2021-01-11,PAT,732,223,509,732,0,0,ITH,ITH2,4,Provincia Autonoma Trento,P.A. Trento,541380,63293,11.69,0.14
1167,2021-02-16,PAT,666,246,420,658,5,3,ITH,ITH2,4,Provincia Autonoma Trento,P.A. Trento,541380,63959,11.81,0.12
1168,2021-04-23,PAT,3638,1770,1868,3572,54,12,ITH,ITH2,4,Provincia Autonoma Trento,P.A. Trento,541380,67597,12.49,0.67
1169,2021-01-30,PAT,386,132,254,152,234,0,ITH,ITH2,4,Provincia Autonoma Trento,P.A. Trento,541380,67983,12.56,0.07
1170,2021-06-29,PAT,6218,3132,3086,2716,3502,0,ITH,ITH2,4,Provincia Autonoma Trento,P.A. Trento,541380,74201,13.71,1.15
1171,2021-06-12,PAT,5359,2688,2671,472,4887,0,ITH,ITH2,4,Provincia Autonoma Trento,P.A. Trento,541380,79560,14.7,0.99
1172,2021-03-21,PAT,129,69,60,129,0,0,ITH,ITH2,4,Provincia Autonoma Trento,P.A. Trento,541380,79689,14.72,0.02
1173,2021-05-24,PAT,4385,2014,2371,1361,3023,1,ITH,ITH2,4,Provincia Autonoma Trento,P.A. Trento,541380,84074,15.53,0.81
1174,2021-03-02,PAT,1307,440,867,929,376,2,ITH,ITH2,4,Provincia Autonoma Trento,P.A. Trento,541380,85381,15.77,0.24
1175,2021-06-10,PAT,6127,2978,3149,1915,4211,1,ITH,ITH2,4,Provincia Autonoma Trento,P.A. Trento,541380,91508,16.9,1.13
1176,2021-01-04,PAT,872,229,643,870,0,2,ITH,ITH2,4,Provincia Autonoma Trento,P.A. Trento,541380,92380,17.06,0.16
1177,2021-07-06,PAT,4966,2609,2357,2925,1893,148,ITH,ITH2,4,Provincia Autonoma Trento,P.A. Trento,541380,97346,17.98,0.92
1178,2021-01-18,PAT,644,154,490,589,55,0,ITH,ITH2,4,Provincia Autonoma Trento,P.A. Trento,541380,97990,18.1,0.12
1179,2021-02-20,PAT,407,245,162,123,284,0,ITH,ITH2,4,Provincia Autonoma Trento,P.A. Trento,541380,98397,18.18,0.08
1180,2021-01-08,PAT,1451,314,1137,1451,0,0,ITH,ITH2,4,Provincia Autonoma Trento,P.A. Trento,541380,99848,18.44,0.27
1181,2021-06-14,PAT,5740,2968,2772,2115,3624,1,ITH,ITH2,4,Provincia Autonoma Trento,P.A. Trento,541380,105588,19.5,1.06
1182,2021-04-18,PAT,1855,845,1010,1844,9,2,ITH,ITH2,4,Provincia Autonoma Trento,P.A. Trento,541380,107443,19.85,0.34
1183,2021-04-28,PAT,4251,1977,2274,4103,138,10,ITH,ITH2,4,Provincia Autonoma Trento,P.A. Trento,541380,111694,20.63,0.79
1184,2021-04-01,PAT,2905,1231,1674,1806,1094,5,ITH,ITH2,4,Provincia Autonoma Trento,P.A. Trento,541380,114599,21.17,0.54
1185,2021-03-23,PAT,2448,944,1504,1668,740,40,ITH,ITH2,4,Provincia Autonoma Trento,P.A. Trento,541380,117047,21.62,0.45
1186,2021-03-07,PAT,22,6,16,22,0,0,ITH,ITH2,4,Provincia Autonoma Trento,P.A. Trento,541380,117069,21.62,0.0
1187,2021-01-09,PAT,190,40,150,190,0,0,ITH,ITH2,4,Provincia Autonoma Trento,P.A. Trento,541380,117259,21.66,0.04
1188,2021-06-24,PAT,5921,3103,2818,3736,2185,0,ITH,ITH2,4,Provincia Autonoma Trento,P.A. Trento,541380,123180,22.75,1.09
1189,2021-05-12,PAT,3305,1494,1811,2107,1188,10,ITH,ITH2,4,Provincia Autonoma Trento,P.A. Trento,541380,126485,23.36,0.61
1190,2021-03-16,PAT,1391,506,885,598,783,10,ITH,ITH2,4,Provincia Autonoma Trento,P.A. Trento,541380,127876,23.62,0.26
1191,2021-05-14,PAT,5320,2543,2777,3918,1386,16,ITH,ITH2,4,Provincia Autonoma Trento,P.A. Trento,541380,133196,24.6,0.98
1192,2021-02-08,PAT,1153,319,834,342,811,0,ITH,ITH2,4,Provincia Autonoma Trento,P.A. Trento,541380,134349,24.82,0.21
1193,2021-07-08,PAT,1203,611,592,592,532,79,ITH,ITH2,4,Provincia Autonoma Trento,P.A. Trento,541380,135552,25.04,0.22
1194,2021-02-04,PAT,976,304,672,422,554,0,ITH,ITH2,4,Provincia Autonoma Trento,P.A. Trento,541380,136528,25.22,0.18
1195,2021-04-13,PAT,2556,1059,1497,2046,507,3,ITH,ITH2,4,Provincia Autonoma Trento,P.A. Trento,541380,139084,25.69,0.47
1196,2021-01-20,PAT,292,73,219,280,12,0,ITH,ITH2,4,Provincia Autonoma Trento,P.A. Trento,541380,139376,25.74,0.05
1197,2021-04-30,PAT,4930,2404,2526,4768,152,10,ITH,ITH2,4,Provincia Autonoma Trento,P.A. Trento,541380,144306,26.66,0.91
1198,2021-05-19,PAT,5103,2459,2644,3828,1256,19,ITH,ITH2,4,Provincia Autonoma Trento,P.A. Trento,541380,149409,27.6,0.94
1199,2021-05-29,PAT,2236,1167,1069,838,1397,1,ITH,ITH2,4,Provincia Autonoma Trento,P.A. Trento,541380,151645,28.01,0.41
1200,2021-04-02,PAT,2845,1157,1688,2156,675,14,ITH,ITH2,4,Provincia Autonoma Trento,P.A. Trento,541380,154490,28.54,0.53
1201,2021-04-16,PAT,2866,1360,1506,2714,145,7,ITH,ITH2,4,Provincia Autonoma Trento,P.A. Trento,541380,157356,29.07,0.53
1202,2021-02-18,PAT,1211,429,782,1147,63,1,ITH,ITH2,4,Provincia Autonoma Trento,P.A. Trento,541380,158567,29.29,0.22
1203,2021-05-10,PAT,3212,1646,1566,2701,505,6,ITH,ITH2,4,Provincia Autonoma Trento,P.A. Trento,541380,161779,29.88,0.59
1204,2021-03-18,PAT,2320,957,1363,1237,1080,3,ITH,ITH2,4,Provincia Autonoma Trento,P.A. Trento,541380,164099,30.31,0.43
1205,2021-06-09,PAT,6237,3077,3160,2164,4073,0,ITH,ITH2,4,Provincia Autonoma Trento,P.A. Trento,541380,170336,31.46,1.15
1206,2021-06-26,PAT,1389,725,664,675,712,2,ITH,ITH2,4,Provincia Autonoma Trento,P.A. Trento,541380,171725,31.72,0.26
1207,2021-03-04,PAT,2362,794,1568,1580,779,3,ITH,ITH2,4,Provincia Autonoma Trento,P.A. Trento,541380,174087,32.16,0.44
1208,2021-05-02,PAT,3514,1955,1559,3470,37,7,ITH,ITH2,4,Provincia Autonoma Trento,P.A. Trento,541380,177601,32.81,0.65
1209,2021-03-13,PAT,835,384,451,781,48,6,ITH,ITH2,4,Provincia Autonoma Trento,P.A. Trento,541380,178436,32.96,0.15
1210,2021-07-05,PAT,5227,2738,2489,3653,1374,200,ITH,ITH2,4,Provincia Autonoma Trento,P.A. Trento,541380,183663,33.92,0.97
1211,2021-06-21,PAT,6131,3309,2822,3733,2398,0,ITH,ITH2,4,Provincia Autonoma Trento,P.A. Trento,541380,189794,35.06,1.13
1212,2021-05-28,PAT,3721,1736,1985,1492,2228,1,ITH,ITH2,4,Provincia Autonoma Trento,P.A. Trento,541380,193515,35.74,0.69
1213,2021-01-25,PAT,818,215,603,24,794,0,ITH,ITH2,4,Provincia Autonoma Trento,P.A. Trento,541380,194333,35.9,0.15
1214,2021-03-25,PAT,2875,1105,1770,1822,1049,4,ITH,ITH2,4,Provincia Autonoma Trento,P.A. Trento,541380,197208,36.43,0.53
1215,2021-07-03,PAT,1255,669,586,80,1170,5,ITH,ITH2,4,Provincia Autonoma Trento,P.A. Trento,541380,198463,36.66,0.23
1216,2021-03-30,PAT,2388,973,1415,1742,637,9,ITH,ITH2,4,Provincia Autonoma Trento,P.A. Trento,541380,200851,37.1,0.44
1217,2021-06-06,PAT,2229,1061,1168,445,1784,0,ITH,ITH2,4,Provincia Autonoma Trento,P.A. Trento,541380,203080,37.51,0.41
1218,2021-02-17,PAT,1113,425,688,1022,91,0,ITH,ITH2,4,Provincia Autonoma Trento,P.A. Trento,541380,204193,37.72,0.21
1219,2021-05-30,PAT,1770,872,898,930,840,0,ITH,ITH2,4,Provincia Autonoma Trento,P.A. Trento,541380,205963,38.04,0.33
1220,2021-04-03,PAT,1142,471,671,970,170,2,ITH,ITH2,4,Provincia Autonoma Trento,P.A. Trento,541380,207105,38.26,0.21
1221,2021-05-21,PAT,5055,2422,2633,3332,1711,12,ITH,ITH2,4,Provincia Autonoma Trento,P.A. Trento,541380,212160,39.19,0.93
1222,2021-02-01,PAT,1224,338,886,92,1132,0,ITH,ITH2,4,Provincia Autonoma Trento,P.A. Trento,541380,213384,39.41,0.23
1223,2021-06-02,PAT,2838,1359,1479,944,1894,0,ITH,ITH2,4,Provincia Autonoma Trento,P.A. Trento,541380,216222,39.94,0.52
1224,2021-03-11,PAT,2300,853,1447,1469,826,5,ITH,ITH2,4,Provincia Autonoma Trento,P.A. Trento,541380,218522,40.36,0.42
1225,2021-07-07,PAT,4086,2193,1893,2663,1257,166,ITH,ITH2,4,Provincia Autonoma Trento,P.A. Trento,541380,222608,41.12,0.75
1226,2021-01-03,PAT,493,160,333,493,0,0,ITH,ITH2,4,Provincia Autonoma Trento,P.A. Trento,541380,223101,41.21,0.09
1227,2021-02-22,PAT,746,259,487,661,84,1,ITH,ITH2,4,Provincia Autonoma Trento,P.A. Trento,541380,223847,41.35,0.14
1228,2021-03-06,PAT,786,277,509,632,151,3,ITH,ITH2,4,Provincia Autonoma Trento,P.A. Trento,541380,224633,41.49,0.15
1229,2021-04-11,PAT,2340,1135,1205,2243,91,6,ITH,ITH2,4,Provincia Autonoma Trento,P.A. Trento,541380,226973,41.92,0.43
1230,2021-02-27,PAT,1031,458,573,606,422,3,ITH,ITH2,4,Provincia Autonoma Trento,P.A. Trento,541380,228004,42.12,0.19
1231,2021-01-01,PAT,214,50,164,214,0,0,ITH,ITH2,4,Provincia Autonoma Trento,P.A. Trento,541380,228218,42.15,0.04
1232,2021-06-07,PAT,5789,2880,2909,2805,2983,1,ITH,ITH2,4,Provincia Autonoma Trento,P.A. Trento,541380,234007,43.22,1.07
1233,2021-04-25,PAT,1971,940,1031,1959,7,5,ITH,ITH2,4,Provincia Autonoma Trento,P.A. Trento,541380,235978,43.59,0.36
1234,2021-01-27,PAT,810,280,530,92,716,2,ITH,ITH2,4,Provincia Autonoma Trento,P.A. Trento,541380,236788,43.74,0.15
1235,2021-02-13,PAT,537,333,204,172,365,0,ITH,ITH2,4,Provincia Autonoma Trento,P.A. Trento,541380,237325,43.84,0.1
1236,2021-05-07,PAT,5998,3086,2912,5137,841,20,ITH,ITH2,4,Provincia Autonoma Trento,P.A. Trento,541380,243323,44.94,1.11
1237,2021-04-20,PAT,2879,1377,1502,2832,36,11,ITH,ITH2,4,Provincia Autonoma Trento,P.A. Trento,541380,246202,45.48,0.53
1238,2021-05-09,PAT,2324,1210,1114,1976,344,4,ITH,ITH2,4,Provincia Autonoma Trento,P.A. Trento,541380,248526,45.91,0.43
1239,2021-02-15,PAT,534,188,346,420,114,0,ITH,ITH2,4,Provincia Autonoma Trento,P.A. Trento,541380,249060,46.0,0.1
1240,2021-05-26,PAT,3918,1843,2075,1225,2692,1,ITH,ITH2,4,Provincia Autonoma Trento,P.A. Trento,541380,252978,46.73,0.72
1241,2021-02-03,PAT,847,315,532,414,433,0,ITH,ITH2,4,Provincia Autonoma Trento,P.A. Trento,541380,253825,46.88,0.16
1242,2021-05-23,PAT,1956,994,962,448,1508,0,ITH,ITH2,4,Provincia Autonoma Trento,P.A. Trento,541380,255781,47.25,0.36
1243,2021-04-10,PAT,2823,1321,1502,2025,795,3,ITH,ITH2,4,Provincia Autonoma Trento,P.A. Trento,541380,258604,47.77,0.52
1244,2021-02-10,PAT,853,291,562,511,342,0,ITH,ITH2,4,Provincia Autonoma Trento,P.A. Trento,541380,259457,47.93,0.16
1245,2021-04-08,PAT,3140,1316,1824,2009,1119,12,ITH,ITH2,4,Provincia Autonoma Trento,P.A. Trento,541380,262597,48.51,0.58
1246,2020-12-31,PAT,1626,449,1177,1626,0,0,ITH,ITH2,4,Provincia Autonoma Trento,P.A. Trento,541380,264223,48.81,0.3
1247,2021-06-22,PAT,6187,3379,2808,3649,2537,1,ITH,ITH2,4,Provincia Autonoma Trento,P.A. Trento,541380,270410,49.95,1.14
1248,2021-03-05,PAT,2248,704,1544,1655,566,27,ITH,ITH2,4,Provincia Autonoma Trento,P.A. Trento,541380,272658,50.36,0.42
1249,2021-01-07,PAT,1272,310,962,1269,0,3,ITH,ITH2,4,Provincia Autonoma Trento,P.A. Trento,541380,273930,50.6,0.23
1250,2021-04-17,PAT,2232,1139,1093,2168,57,7,ITH,ITH2,4,Provincia Autonoma Trento,P.A. Trento,541380,276162,51.01,0.41
1251,2021-04-19,PAT,2625,1235,1390,2590,22,13,ITH,ITH2,4,Provincia Autonoma Trento,P.A. Trento,541380,278787,51.5,0.48
1252,2021-06-15,PAT,6240,3283,2957,1723,4517,0,ITH,ITH2,4,Provincia Autonoma Trento,P.A. Trento,541380,285027,52.65,1.15
1253,2021-04-29,PAT,4642,2241,2401,4415,208,19,ITH,ITH2,4,Provincia Autonoma Trento,P.A. Trento,541380,289669,53.51,0.86
1254,2021-01-22,PAT,1673,435,1238,330,1342,1,ITH,ITH2,4,Provincia Autonoma Trento,P.A. Trento,541380,291342,53.81,0.31
1255,2021-02-05,PAT,805,272,533,283,522,0,ITH,ITH2,4,Provincia Autonoma Trento,P.A. Trento,541380,292147,53.96,0.15
1256,2021-05-16,PAT,1331,736,595,1090,239,2,ITH,ITH2,4,Provincia Autonoma Trento,P.A. Trento,541380,293478,54.21,0.25
1257,2021-01-05,PAT,711,233,478,711,0,0,ITH,ITH2,4,Provincia Autonoma Trento,P.A. Trento,541380,294189,54.34,0.13
1258,2021-04-15,PAT,3202,1443,1759,3030,154,18,ITH,ITH2,4,Provincia Autonoma Trento,P.A. Trento,541380,297391,54.93,0.59
1259,2021-05-18,PAT,4253,2010,2243,3394,846,13,ITH,ITH2,4,Provincia Autonoma Trento,P.A. Trento,541380,301644,55.72,0.79
1260,2021-03-12,PAT,2518,940,1578,1706,806,6,ITH,ITH2,4,Provincia Autonoma Trento,P.A. Trento,541380,304162,56.18,0.47
1261,2021-06-20,PAT,1869,1034,835,32,1837,0,ITH,ITH2,4,Provincia Autonoma Trento,P.A. Trento,541380,306031,56.53,0.35
1262,2021-01-02,PAT,502,143,359,502,0,0,ITH,ITH2,4,Provincia Autonoma Trento,P.A. Trento,541380,306533,56.62,0.09
1263,2021-03-29,PAT,2494,967,1527,1752,735,7,ITH,ITH2,4,Provincia Autonoma Trento,P.A. Trento,541380,309027,57.08,0.46
1264,2021-04-12,PAT,3084,1407,1677,2585,496,3,ITH,ITH2,4,Provincia Autonoma Trento,P.A. Trento,541380,312111,57.65,0.57
1265,2021-04-24,PAT,3548,1701,1847,3527,14,7,ITH,ITH2,4,Provincia Autonoma Trento,P.A. Trento,541380,315659,58.31,0.66
1266,2021-02-26,PAT,1218,435,783,922,295,1,ITH,ITH2,4,Provincia Autonoma Trento,P.A. Trento,541380,316877,58.53,0.22
1267,2021-01-14,PAT,701,203,498,699,0,2,ITH,ITH2,4,Provincia Autonoma Trento,P.A. Trento,541380,317578,58.66,0.13
1268,2021-02-28,PAT,242,121,121,242,0,0,ITH,ITH2,4,Provincia Autonoma Trento,P.A. Trento,541380,317820,58.71,0.04
1269,2021-06-08,PAT,5919,2863,3056,1869,4049,1,ITH,ITH2,4,Provincia Autonoma Trento,P.A. Trento,541380,323739,59.8,1.09
1270,2021-04-26,PAT,2659,1254,1405,2557,95,7,ITH,ITH2,4,Provincia Autonoma Trento,P.A. Trento,541380,326398,60.29,0.49
1271,2021-02-19,PAT,929,359,570,868,59,2,ITH,ITH2,4,Provincia Autonoma Trento,P.A. Trento,541380,327327,60.46,0.17
1272,2021-06-25,PAT,7480,4008,3472,4109,3371,0,ITH,ITH2,4,Provincia Autonoma Trento,P.A. Trento,541380,334807,61.84,1.38
1273,2021-07-02,PAT,7136,3880,3256,3427,3537,172,ITH,ITH2,4,Provincia Autonoma Trento,P.A. Trento,541380,341943,63.16,1.32
1274,2021-01-15,PAT,597,132,465,597,0,0,ITH,ITH2,4,Provincia Autonoma Trento,P.A. Trento,541380,342540,63.27,0.11
1275,2021-01-10,PAT,85,20,65,85,0,0,ITH,ITH2,4,Provincia Autonoma Trento,P.A. Trento,541380,342625,63.29,0.02
1276,2021-01-29,PAT,1358,334,1024,55,1303,0,ITH,ITH2,4,Provincia Autonoma Trento,P.A. Trento,541380,343983,63.54,0.25
1277,2021-04-22,PAT,3152,1470,1682,3099,45,8,ITH,ITH2,4,Provincia Autonoma Trento,P.A. Trento,541380,347135,64.12,0.58
1278,2021-04-07,PAT,2622,1017,1605,1664,942,16,ITH,ITH2,4,Provincia Autonoma Trento,P.A. Trento,541380,349757,64.6,0.48
1279,2021-06-27,PAT,1303,698,605,362,940,1,ITH,ITH2,4,Provincia Autonoma Trento,P.A. Trento,541380,351060,64.85,0.24
1280,2021-01-12,PAT,507,158,349,506,0,1,ITH,ITH2,4,Provincia Autonoma Trento,P.A. Trento,541380,351567,64.94,0.09
1281,2021-03-19,PAT,2423,915,1508,1563,852,8,ITH,ITH2,4,Provincia Autonoma Trento,P.A. Trento,541380,353990,65.39,0.45
1282,2021-04-05,PAT,35,17,18,33,2,0,ITH,ITH2,4,Provincia Autonoma Trento,P.A. Trento,541380,354025,65.39,0.01
1283,2021-05-20,PAT,5014,2358,2656,3365,1635,14,ITH,ITH2,4,Provincia Autonoma Trento,P.A. Trento,541380,359039,66.32,0.93
1284,2021-03-24,PAT,2377,940,1437,1553,820,4,ITH,ITH2,4,Provincia Autonoma Trento,P.A. Trento,541380,361416,66.76,0.44
1285,2021-02-09,PAT,918,287,631,443,475,0,ITH,ITH2,4,Provincia Autonoma Trento,P.A. Trento,541380,362334,66.93,0.17
1286,2021-03-17,PAT,2071,792,1279,1190,871,10,ITH,ITH2,4,Provincia Autonoma Trento,P.A. Trento,541380,364405,67.31,0.38
1287,2021-02-02,PAT,910,240,670,191,719,0,ITH,ITH2,4,Provincia Autonoma Trento,P.A. Trento,541380,365315,67.48,0.17
1288,2021-05-13,PAT,3407,1580,1827,2297,1102,8,ITH,ITH2,4,Provincia Autonoma Trento,P.A. Trento,541380,368722,68.11,0.63
1289,2021-03-31,PAT,2585,983,1602,1723,858,4,ITH,ITH2,4,Provincia Autonoma Trento,P.A. Trento,541380,371307,68.59,0.48
1290,2021-01-26,PAT,543,154,389,27,516,0,ITH,ITH2,4,Provincia Autonoma Trento,P.A. Trento,541380,371850,68.69,0.1
1291,2021-05-06,PAT,5532,2740,2792,4738,781,13,ITH,ITH2,4,Provincia Autonoma Trento,P.A. Trento,541380,377382,69.71,1.02
1292,2021-06-18,PAT,6935,3691,3244,1817,5118,0,ITH,ITH2,4,Provincia Autonoma Trento,P.A. Trento,541380,384317,70.99,1.28
1293,2021-03-27,PAT,1620,710,910,1358,257,5,ITH,ITH2,4,Provincia Autonoma Trento,P.A. Trento,541380,385937,71.29,0.3
1294,2021-06-04,PAT,5826,2605,3221,1832,3993,1,ITH,ITH2,4,Provincia Autonoma Trento,P.A. Trento,541380,391763,72.36,1.08
1295,2021-02-24,PAT,1325,525,800,922,399,4,ITH,ITH2,4,Provincia Autonoma Trento,P.A. Trento,541380,393088,72.61,0.24
1296,2021-06-03,PAT,4766,2235,2531,1301,3465,0,ITH,ITH2,4,Provincia Autonoma Trento,P.A. Trento,541380,397854,73.49,0.88
1297,2021-06-28,PAT,6743,3480,3263,2946,3797,0,ITH,ITH2,4,Provincia Autonoma Trento,P.A. Trento,541380,404597,74.73,1.25
1298,2021-04-06,PAT,2261,950,1311,1494,765,2,ITH,ITH2,4,Provincia Autonoma Trento,P.A. Trento,541380,406858,75.15,0.42
1299,2021-01-13,PAT,421,123,298,421,0,0,ITH,ITH2,4,Provincia Autonoma Trento,P.A. Trento,541380,407279,75.23,0.08
1300,2021-01-21,PAT,353,95,258,229,124,0,ITH,ITH2,4,Provincia Autonoma Trento,P.A. Trento,541380,407632,75.29,0.07
1301,2021-05-01,PAT,4851,2470,2381,4806,36,9,ITH,ITH2,4,Provincia Autonoma Trento,P.A. Trento,541380,412483,76.19,0.9
1302,2021-02-21,PAT,155,92,63,43,112,0,ITH,ITH2,4,Provincia Autonoma Trento,P.A. Trento,541380,412638,76.22,0.03
1303,2021-05-15,PAT,1568,815,753,675,889,4,ITH,ITH2,4,Provincia Autonoma Trento,P.A. Trento,541380,414206,76.51,0.29
1304,2021-06-01,PAT,4013,1875,2138,1156,2856,1,ITH,ITH2,4,Provincia Autonoma Trento,P.A. Trento,541380,418219,77.25,0.74
1305,2021-01-19,PAT,407,77,330,407,0,0,ITH,ITH2,4,Provincia Autonoma Trento,P.A. Trento,541380,418626,77.33,0.08
1306,2021-03-10,PAT,2405,929,1476,1476,922,7,ITH,ITH2,4,Provincia Autonoma Trento,P.A. Trento,541380,421031,77.77,0.44
1307,2021-02-12,PAT,1013,341,672,590,423,0,ITH,ITH2,4,Provincia Autonoma Trento,P.A. Trento,541380,422044,77.96,0.19
1308,2021-03-01,PAT,1237,454,783,941,295,1,ITH,ITH2,4,Provincia Autonoma Trento,P.A. Trento,541380,423281,78.19,0.23
1309,2021-03-20,PAT,874,403,471,671,203,0,ITH,ITH2,4,Provincia Autonoma Trento,P.A. Trento,541380,424155,78.35,0.16
1310,2021-03-03,PAT,1659,622,1037,1134,518,7,ITH,ITH2,4,Provincia Autonoma Trento,P.A. Trento,541380,425814,78.65,0.31
1311,2021-06-11,PAT,7196,3426,3770,1573,5621,2,ITH,ITH2,4,Provincia Autonoma Trento,P.A. Trento,541380,433010,79.98,1.33
1312,2021-06-13,PAT,3686,2033,1653,295,3391,0,ITH,ITH2,4,Provincia Autonoma Trento,P.A. Trento,541380,436696,80.66,0.68
1313,2020-12-27,PAT,103,40,63,103,0,0,ITH,ITH2,4,Provincia Autonoma Trento,P.A. Trento,541380,436799,80.68,0.02
1314,2021-05-25,PAT,4770,2269,2501,1868,2902,0,ITH,ITH2,4,Provincia Autonoma Trento,P.A. Trento,541380,441569,81.56,0.88
1315,2021-05-08,PAT,3162,1726,1436,2735,422,5,ITH,ITH2,4,Provincia Autonoma Trento,P.A. Trento,541380,444731,82.15,0.58
1316,2021-02-14,PAT,246,186,60,11,235,0,ITH,ITH2,4,Provincia Autonoma Trento,P.A. Trento,541380,444977,82.19,0.05
1317,2021-05-27,PAT,4294,1991,2303,1250,3042,2,ITH,ITH2,4,Provincia Autonoma Trento,P.A. Trento,541380,449271,82.99,0.79
1318,2021-01-06,PAT,42,13,29,42,0,0,ITH,ITH2,4,Provincia Autonoma Trento,P.A. Trento,541380,449313,82.99,0.01
1319,2021-06-16,PAT,6212,3347,2865,2046,4165,1,ITH,ITH2,4,Provincia Autonoma Trento,P.A. Trento,541380,455525,84.14,1.15
1320,2021-03-15,PAT,1411,545,866,943,464,4,ITH,ITH2,4,Provincia Autonoma Trento,P.A. Trento,541380,456936,84.4,0.26
1321,2021-01-17,PAT,251,195,56,251,0,0,ITH,ITH2,4,Provincia Autonoma Trento,P.A. Trento,541380,457187,84.45,0.05
1322,2021-06-23,PAT,6513,3450,3063,4643,1870,0,ITH,ITH2,4,Provincia Autonoma Trento,P.A. Trento,541380,463700,85.65,1.2
1323,2021-05-11,PAT,3701,1751,1950,2843,850,8,ITH,ITH2,4,Provincia Autonoma Trento,P.A. Trento,541380,467401,86.34,0.68
1324,2021-04-27,PAT,3914,1881,2033,3832,69,13,ITH,ITH2,4,Provincia Autonoma Trento,P.A. Trento,541380,471315,87.06,0.72
1325,2021-05-04,PAT,4511,2448,2063,4403,94,14,ITH,ITH2,4,Provincia Autonoma Trento,P.A. Trento,541380,475826,87.89,0.83
1326,2021-03-08,PAT,1411,434,977,1055,354,2,ITH,ITH2,4,Provincia Autonoma Trento,P.A. Trento,541380,477237,88.15,0.26
1327,2021-03-22,PAT,2306,973,1333,1428,875,3,ITH,ITH2,4,Provincia Autonoma Trento,P.A. Trento,541380,479543,88.58,0.43
1328,2021-01-24,PAT,548,276,272,224,324,0,ITH,ITH2,4,Provincia Autonoma Trento,P.A. Trento,541380,480091,88.68,0.1
1329,2021-06-30,PAT,6660,3425,3235,2631,3999,30,ITH,ITH2,4,Provincia Autonoma Trento,P.A. Trento,541380,486751,89.91,1.23
1330,2021-01-31,PAT,76,16,60,1,75,0,ITH,ITH2,4,Provincia Autonoma Trento,P.A. Trento,541380,486827,89.92,0.01
1331,2021-07-04,PAT,211,119,92,63,148,0,ITH,ITH2,4,Provincia Autonoma Trento,P.A. Trento,541380,487038,89.96,0.04
1332,2021-06-27,MOL,2363,1119,1244,1128,1225,10,ITF,ITF2,14,Molise,Molise,305617,2363,0.77,0.77
1333,2021-01-07,MOL,598,209,389,598,0,0,ITF,ITF2,14,Molise,Molise,305617,2961,0.97,0.2
1334,2021-02-12,MOL,332,150,182,207,124,1,ITF,ITF2,14,Molise,Molise,305617,3293,1.08,0.11
1335,2021-05-01,MOL,2647,1268,1379,405,2223,19,ITF,ITF2,14,Molise,Molise,305617,5940,1.94,0.87
1336,2021-03-05,MOL,1219,649,570,1003,204,12,ITF,ITF2,14,Molise,Molise,305617,7159,2.34,0.4
1337,2021-06-13,MOL,2785,1485,1300,2427,325,33,ITF,ITF2,14,Molise,Molise,305617,9944,3.25,0.91
1338,2021-04-17,MOL,3054,1501,1553,1543,1486,25,ITF,ITF2,14,Molise,Molise,305617,12998,4.25,1.0
1339,2021-06-20,MOL,421,174,247,47,370,4,ITF,ITF2,14,Molise,Molise,305617,13419,4.39,0.14
1340,2021-04-24,MOL,2551,1202,1349,695,1841,15,ITF,ITF2,14,Molise,Molise,305617,15970,5.23,0.83
1341,2021-02-26,MOL,563,260,303,489,73,1,ITF,ITF2,14,Molise,Molise,305617,16533,5.41,0.18
1342,2021-06-06,MOL,2060,1059,1001,1720,323,17,ITF,ITF2,14,Molise,Molise,305617,18593,6.08,0.67
1343,2021-04-05,MOL,391,189,202,292,99,0,ITF,ITF2,14,Molise,Molise,305617,18984,6.21,0.13
1344,2021-03-29,MOL,2033,835,1198,1518,486,29,ITF,ITF2,14,Molise,Molise,305617,21017,6.88,0.67
1345,2021-01-31,MOL,268,70,198,6,262,0,ITF,ITF2,14,Molise,Molise,305617,21285,6.96,0.09
1346,2021-02-07,MOL,66,32,34,19,47,0,ITF,ITF2,14,Molise,Molise,305617,21351,6.99,0.02
1347,2021-05-18,MOL,1645,877,768,984,655,6,ITF,ITF2,14,Molise,Molise,305617,22996,7.52,0.54
1348,2021-03-22,MOL,1149,441,708,889,244,16,ITF,ITF2,14,Molise,Molise,305617,24145,7.9,0.38
1349,2021-05-20,MOL,2661,1371,1290,2397,186,78,ITF,ITF2,14,Molise,Molise,305617,26806,8.77,0.87
1350,2021-01-26,MOL,450,184,266,8,442,0,ITF,ITF2,14,Molise,Molise,305617,27256,8.92,0.15
1351,2021-05-06,MOL,2679,1214,1465,2042,598,39,ITF,ITF2,14,Molise,Molise,305617,29935,9.79,0.88
1352,2021-01-12,MOL,336,114,222,336,0,0,ITF,ITF2,14,Molise,Molise,305617,30271,9.9,0.11
1353,2021-02-24,MOL,666,278,388,325,333,8,ITF,ITF2,14,Molise,Molise,305617,30937,10.12,0.22
1354,2021-03-24,MOL,1631,658,973,1212,402,17,ITF,ITF2,14,Molise,Molise,305617,32568,10.66,0.53
1355,2021-07-02,MOL,2626,1274,1352,120,2498,8,ITF,ITF2,14,Molise,Molise,305617,35194,11.52,0.86
1356,2021-07-04,MOL,2111,1057,1054,573,1515,23,ITF,ITF2,14,Molise,Molise,305617,37305,12.21,0.69
1357,2021-01-17,MOL,78,38,40,48,30,0,ITF,ITF2,14,Molise,Molise,305617,37383,12.23,0.03
1358,2021-02-19,MOL,169,93,76,167,2,0,ITF,ITF2,14,Molise,Molise,305617,37552,12.29,0.06
1359,2021-03-10,MOL,1737,720,1017,1667,50,20,ITF,ITF2,14,Molise,Molise,305617,39289,12.86,0.57
1360,2021-06-01,MOL,2598,1322,1276,2454,108,36,ITF,ITF2,14,Molise,Molise,305617,41887,13.71,0.85
1361,2021-03-15,MOL,832,338,494,570,245,17,ITF,ITF2,14,Molise,Molise,305617,42719,13.98,0.27
1362,2021-06-24,MOL,3307,1542,1765,432,2839,36,ITF,ITF2,14,Molise,Molise,305617,46026,15.06,1.08
1363,2021-03-02,MOL,667,383,284,504,158,5,ITF,ITF2,14,Molise,Molise,305617,46693,15.28,0.22
1364,2021-06-10,MOL,2571,1182,1389,1233,1301,37,ITF,ITF2,14,Molise,Molise,305617,49264,16.12,0.84
1365,2021-03-19,MOL,1184,482,702,740,427,17,ITF,ITF2,14,Molise,Molise,305617,50448,16.51,0.39
1366,2021-01-21,MOL,6,2,4,6,0,0,ITF,ITF2,14,Molise,Molise,305617,50454,16.51,0.0
1367,2021-03-31,MOL,2193,919,1274,1307,819,67,ITF,ITF2,14,Molise,Molise,305617,52647,17.23,0.72
1368,2021-05-25,MOL,1963,887,1076,1297,630,36,ITF,ITF2,14,Molise,Molise,305617,54610,17.87,0.64
1369,2021-01-04,MOL,314,131,183,314,0,0,ITF,ITF2,14,Molise,Molise,305617,54924,17.97,0.1
1370,2021-04-14,MOL,1806,767,1039,1135,661,10,ITF,ITF2,14,Molise,Molise,305617,56730,18.56,0.59
1371,2021-02-16,MOL,156,70,86,149,6,1,ITF,ITF2,14,Molise,Molise,305617,56886,18.61,0.05
1372,2021-05-27,MOL,2834,1348,1486,1960,836,38,ITF,ITF2,14,Molise,Molise,305617,59720,19.54,0.93
1373,2021-03-17,MOL,908,385,523,518,332,58,ITF,ITF2,14,Molise,Molise,305617,60628,19.84,0.3
1374,2021-06-25,MOL,3430,1688,1742,1464,1914,52,ITF,ITF2,14,Molise,Molise,305617,64058,20.96,1.12
1375,2021-06-08,MOL,2886,1593,1293,2187,696,3,ITF,ITF2,14,Molise,Molise,305617,66944,21.9,0.94
1376,2021-01-09,MOL,450,152,298,450,0,0,ITF,ITF2,14,Molise,Molise,305617,67394,22.05,0.15
1377,2021-04-19,MOL,1827,842,985,987,778,62,ITF,ITF2,14,Molise,Molise,305617,69221,22.65,0.6
1378,2021-03-03,MOL,672,316,356,586,82,4,ITF,ITF2,14,Molise,Molise,305617,69893,22.87,0.22
1379,2021-01-05,MOL,449,180,269,449,0,0,ITF,ITF2,14,Molise,Molise,305617,70342,23.02,0.15
1380,2021-04-10,MOL,2640,1261,1379,2453,152,35,ITF,ITF2,14,Molise,Molise,305617,72982,23.88,0.86
1381,2021-02-05,MOL,593,269,324,55,538,0,ITF,ITF2,14,Molise,Molise,305617,73575,24.07,0.19
1382,2021-01-19,MOL,173,63,110,162,11,0,ITF,ITF2,14,Molise,Molise,305617,73748,24.13,0.06
1383,2021-04-29,MOL,2239,1146,1093,877,1348,14,ITF,ITF2,14,Molise,Molise,305617,75987,24.86,0.73
1384,2021-04-12,MOL,1299,557,742,1037,251,11,ITF,ITF2,14,Molise,Molise,305617,77286,25.29,0.43
1385,2021-05-13,MOL,3039,1410,1629,2528,457,54,ITF,ITF2,14,Molise,Molise,305617,80325,26.28,0.99
1386,2021-04-28,MOL,1693,923,770,469,1217,7,ITF,ITF2,14,Molise,Molise,305617,82018,26.84,0.55
1387,2021-02-21,MOL,574,227,347,572,2,0,ITF,ITF2,14,Molise,Molise,305617,82592,27.02,0.19
1388,2021-04-02,MOL,1456,710,746,663,778,15,ITF,ITF2,14,Molise,Molise,305617,84048,27.5,0.48
1389,2021-05-08,MOL,2975,1455,1520,1697,1244,34,ITF,ITF2,14,Molise,Molise,305617,87023,28.47,0.97
1390,2021-04-21,MOL,1869,791,1078,968,895,6,ITF,ITF2,14,Molise,Molise,305617,88892,29.09,0.61
1391,2021-02-11,MOL,294,133,161,257,37,0,ITF,ITF2,14,Molise,Molise,305617,89186,29.18,0.1
1392,2021-05-22,MOL,1316,712,604,1225,84,7,ITF,ITF2,14,Molise,Molise,305617,90502,29.61,0.43
1393,2021-02-23,MOL,582,223,359,361,219,2,ITF,ITF2,14,Molise,Molise,305617,91084,29.8,0.19
1394,2021-06-03,MOL,3291,1566,1725,2704,554,33,ITF,ITF2,14,Molise,Molise,305617,94375,30.88,1.08
1395,2021-04-07,MOL,1688,847,841,1368,275,45,ITF,ITF2,14,Molise,Molise,305617,96063,31.43,0.55
1396,2021-06-05,MOL,2965,1504,1461,2784,154,27,ITF,ITF2,14,Molise,Molise,305617,99028,32.4,0.97
1397,2021-03-04,MOL,850,417,433,514,324,12,ITF,ITF2,14,Molise,Molise,305617,99878,32.68,0.28
1398,2021-06-12,MOL,3406,1750,1656,3241,114,51,ITF,ITF2,14,Molise,Molise,305617,103284,33.8,1.11
1399,2021-06-14,MOL,1627,810,817,535,1075,17,ITF,ITF2,14,Molise,Molise,305617,104911,34.33,0.53
1400,2021-01-20,MOL,18,8,10,18,0,0,ITF,ITF2,14,Molise,Molise,305617,104929,34.33,0.01
1401,2021-05-29,MOL,2351,1223,1128,1918,390,43,ITF,ITF2,14,Molise,Molise,305617,107280,35.1,0.77
1402,2021-02-09,MOL,359,170,189,197,162,0,ITF,ITF2,14,Molise,Molise,305617,107639,35.22,0.12
1403,2021-02-28,MOL,832,334,498,788,42,2,ITF,ITF2,14,Molise,Molise,305617,108471,35.49,0.27
1404,2021-02-27,MOL,1366,568,798,1342,19,5,ITF,ITF2,14,Molise,Molise,305617,109837,35.94,0.45
1405,2021-06-07,MOL,1953,859,1094,1113,819,21,ITF,ITF2,14,Molise,Molise,305617,111790,36.58,0.64
1406,2021-02-13,MOL,132,80,52,132,0,0,ITF,ITF2,14,Molise,Molise,305617,111922,36.62,0.04
1407,2021-05-24,MOL,1964,853,1111,1271,666,27,ITF,ITF2,14,Molise,Molise,305617,113886,37.26,0.64
1408,2021-05-07,MOL,2643,1228,1415,2021,597,25,ITF,ITF2,14,Molise,Molise,305617,116529,38.13,0.86
1409,2021-04-18,MOL,1083,483,600,144,934,5,ITF,ITF2,14,Molise,Molise,305617,117612,38.48,0.35
1410,2021-04-04,MOL,253,141,112,233,15,5,ITF,ITF2,14,Molise,Molise,305617,117865,38.57,0.08
1411,2021-03-18,MOL,1156,476,680,633,464,59,ITF,ITF2,14,Molise,Molise,305617,119021,38.94,0.38
1412,2021-06-26,MOL,3119,1529,1590,523,2581,15,ITF,ITF2,14,Molise,Molise,305617,122140,39.97,1.02
1413,2021-01-28,MOL,613,217,396,17,596,0,ITF,ITF2,14,Molise,Molise,305617,122753,40.17,0.2
1414,2021-03-12,MOL,1459,637,822,1404,36,19,ITF,ITF2,14,Molise,Molise,305617,124212,40.64,0.48
1415,2021-01-14,MOL,646,239,407,646,0,0,ITF,ITF2,14,Molise,Molise,305617,124858,40.85,0.21
1416,2021-02-04,MOL,758,295,463,77,681,0,ITF,ITF2,14,Molise,Molise,305617,125616,41.1,0.25
1417,2021-05-15,MOL,2980,1398,1582,2545,384,51,ITF,ITF2,14,Molise,Molise,305617,128596,42.08,0.98
1418,2021-02-02,MOL,539,176,363,215,323,1,ITF,ITF2,14,Molise,Molise,305617,129135,42.25,0.18
1419,2021-01-16,MOL,422,166,256,422,0,0,ITF,ITF2,14,Molise,Molise,305617,129557,42.39,0.14
1420,2021-04-26,MOL,1157,521,636,809,331,17,ITF,ITF2,14,Molise,Molise,305617,130714,42.77,0.38
1421,2021-04-09,MOL,2324,1251,1073,2105,191,28,ITF,ITF2,14,Molise,Molise,305617,133038,43.53,0.76
1422,2021-01-18,MOL,114,48,66,114,0,0,ITF,ITF2,14,Molise,Molise,305617,133152,43.57,0.04
1423,2021-04-11,MOL,1196,591,605,1168,14,14,ITF,ITF2,14,Molise,Molise,305617,134348,43.96,0.39
1424,2021-07-03,MOL,2736,1376,1360,565,2151,20,ITF,ITF2,14,Molise,Molise,305617,137084,44.85,0.9
1425,2021-03-11,MOL,1465,637,828,1446,6,13,ITF,ITF2,14,Molise,Molise,305617,138549,45.33,0.48
1426,2021-01-06,MOL,689,260,429,689,0,0,ITF,ITF2,14,Molise,Molise,305617,139238,45.56,0.23
1427,2021-04-16,MOL,2430,1033,1397,1177,1232,21,ITF,ITF2,14,Molise,Molise,305617,141668,46.35,0.8
1428,2021-06-21,MOL,2901,1350,1551,1623,1232,46,ITF,ITF2,14,Molise,Molise,305617,144569,47.3,0.95
1429,2021-04-25,MOL,792,395,397,555,233,4,ITF,ITF2,14,Molise,Molise,305617,145361,47.56,0.26
1430,2021-01-13,MOL,474,160,314,474,0,0,ITF,ITF2,14,Molise,Molise,305617,145835,47.72,0.16
1431,2021-06-19,MOL,2327,1156,1171,1275,1010,42,ITF,ITF2,14,Molise,Molise,305617,148162,48.48,0.76
1432,2021-04-23,MOL,2050,882,1168,1374,659,17,ITF,ITF2,14,Molise,Molise,305617,150212,49.15,0.67
1433,2021-06-30,MOL,2925,1391,1534,873,1971,81,ITF,ITF2,14,Molise,Molise,305617,153137,50.11,0.96
1434,2021-03-13,MOL,1189,594,595,183,989,17,ITF,ITF2,14,Molise,Molise,305617,154326,50.5,0.39
1435,2021-01-15,MOL,538,242,296,538,0,0,ITF,ITF2,14,Molise,Molise,305617,154864,50.67,0.18
1436,2021-06-23,MOL,2787,1284,1503,220,2557,10,ITF,ITF2,14,Molise,Molise,305617,157651,51.58,0.91
1437,2021-03-20,MOL,2321,968,1353,992,1321,8,ITF,ITF2,14,Molise,Molise,305617,159972,52.34,0.76
1438,2021-06-28,MOL,2888,1347,1541,996,1870,22,ITF,ITF2,14,Molise,Molise,305617,162860,53.29,0.94
1439,2021-03-16,MOL,614,230,384,265,347,2,ITF,ITF2,14,Molise,Molise,305617,163474,53.49,0.2
1440,2021-02-10,MOL,151,79,72,131,20,0,ITF,ITF2,14,Molise,Molise,305617,163625,53.54,0.05
1441,2021-05-21,MOL,2100,1053,1047,1699,322,79,ITF,ITF2,14,Molise,Molise,305617,165725,54.23,0.69
1442,2021-01-27,MOL,674,251,423,8,666,0,ITF,ITF2,14,Molise,Molise,305617,166399,54.45,0.22
1443,2021-04-30,MOL,2937,1556,1381,818,2107,12,ITF,ITF2,14,Molise,Molise,305617,169336,55.41,0.96
1444,2021-02-25,MOL,541,239,302,470,68,3,ITF,ITF2,14,Molise,Molise,305617,169877,55.58,0.18
1445,2021-01-29,MOL,421,136,285,6,415,0,ITF,ITF2,14,Molise,Molise,305617,170298,55.72,0.14
1446,2021-05-09,MOL,2052,933,1119,1923,96,33,ITF,ITF2,14,Molise,Molise,305617,172350,56.39,0.67
1447,2021-07-07,MOL,2956,1368,1588,56,2896,4,ITF,ITF2,14,Molise,Molise,305617,175306,57.36,0.97
1448,2021-05-11,MOL,3207,1414,1793,2909,250,48,ITF,ITF2,14,Molise,Molise,305617,178513,58.41,1.05
1449,2021-01-22,MOL,128,36,92,128,0,0,ITF,ITF2,14,Molise,Molise,305617,178641,58.45,0.04
1450,2021-05-02,MOL,1893,932,961,577,1305,11,ITF,ITF2,14,Molise,Molise,305617,180534,59.07,0.62
1451,2021-03-06,MOL,1728,807,921,1559,159,10,ITF,ITF2,14,Molise,Molise,305617,182262,59.64,0.57
1452,2021-05-26,MOL,1549,698,851,769,754,26,ITF,ITF2,14,Molise,Molise,305617,183811,60.14,0.51
1453,2021-03-30,MOL,2003,857,1146,1472,512,19,ITF,ITF2,14,Molise,Molise,305617,185814,60.8,0.66
1454,2021-02-01,MOL,562,201,361,14,548,0,ITF,ITF2,14,Molise,Molise,305617,186376,60.98,0.18
1455,2021-07-08,MOL,1337,647,690,34,1294,9,ITF,ITF2,14,Molise,Molise,305617,187713,61.42,0.44
1456,2021-05-12,MOL,2852,1294,1558,2691,96,65,ITF,ITF2,14,Molise,Molise,305617,190565,62.35,0.93
1457,2021-04-06,MOL,1494,701,793,1131,343,20,ITF,ITF2,14,Molise,Molise,305617,192059,62.84,0.49
1458,2021-02-08,MOL,334,141,193,216,118,0,ITF,ITF2,14,Molise,Molise,305617,192393,62.95,0.11
1459,2021-05-19,MOL,2342,1205,1137,1880,425,37,ITF,ITF2,14,Molise,Molise,305617,194735,63.72,0.77
1460,2021-03-23,MOL,1642,694,948,1411,207,24,ITF,ITF2,14,Molise,Molise,305617,196377,64.26,0.54
1461,2021-03-25,MOL,1806,730,1076,1284,497,25,ITF,ITF2,14,Molise,Molise,305617,198183,64.85,0.59
1462,2021-03-08,MOL,1379,522,857,1202,140,37,ITF,ITF2,14,Molise,Molise,305617,199562,65.3,0.45
1463,2021-06-16,MOL,2002,1013,989,1133,855,14,ITF,ITF2,14,Molise,Molise,305617,201564,65.95,0.66
1464,2021-04-13,MOL,1632,718,914,1037,587,8,ITF,ITF2,14,Molise,Molise,305617,203196,66.49,0.53
1465,2021-03-27,MOL,2743,1273,1470,1295,1433,15,ITF,ITF2,14,Molise,Molise,305617,205939,67.38,0.9
1466,2021-07-05,MOL,2716,1271,1445,39,2675,2,ITF,ITF2,14,Molise,Molise,305617,208655,68.27,0.89
1467,2021-06-18,MOL,2767,1248,1519,1283,1458,26,ITF,ITF2,14,Molise,Molise,305617,211422,69.18,0.91
1468,2021-05-30,MOL,1862,928,934,1549,285,28,ITF,ITF2,14,Molise,Molise,305617,213284,69.79,0.61
1469,2021-07-01,MOL,2659,1293,1366,269,2375,15,ITF,ITF2,14,Molise,Molise,305617,215943,70.66,0.87
1470,2021-02-15,MOL,144,70,74,141,3,0,ITF,ITF2,14,Molise,Molise,305617,216087,70.71,0.05
1471,2021-02-22,MOL,265,129,136,248,15,2,ITF,ITF2,14,Molise,Molise,305617,216352,70.79,0.09
1472,2020-12-27,MOL,50,20,30,50,0,0,ITF,ITF2,14,Molise,Molise,305617,216402,70.81,0.02
1473,2021-01-11,MOL,557,194,363,557,0,0,ITF,ITF2,14,Molise,Molise,305617,216959,70.99,0.18
1474,2021-01-25,MOL,319,130,189,3,316,0,ITF,ITF2,14,Molise,Molise,305617,217278,71.09,0.1
1475,2021-05-05,MOL,2414,1042,1372,2249,141,24,ITF,ITF2,14,Molise,Molise,305617,219692,71.88,0.79
1476,2021-05-04,MOL,2705,1181,1524,2541,128,36,ITF,ITF2,14,Molise,Molise,305617,222397,72.77,0.89
1477,2021-03-07,MOL,1132,501,631,1127,2,3,ITF,ITF2,14,Molise,Molise,305617,223529,73.14,0.37
1478,2021-06-15,MOL,2215,1042,1173,748,1451,16,ITF,ITF2,14,Molise,Molise,305617,225744,73.87,0.72
1479,2021-06-17,MOL,2307,1017,1290,911,1369,27,ITF,ITF2,14,Molise,Molise,305617,228051,74.62,0.75
1480,2021-03-26,MOL,2575,1045,1530,1889,642,44,ITF,ITF2,14,Molise,Molise,305617,230626,75.46,0.84
1481,2021-01-08,MOL,429,141,288,429,0,0,ITF,ITF2,14,Molise,Molise,305617,231055,75.6,0.14
1482,2021-04-01,MOL,1469,667,802,729,726,14,ITF,ITF2,14,Molise,Molise,305617,232524,76.08,0.48
1483,2021-01-10,MOL,270,72,198,270,0,0,ITF,ITF2,14,Molise,Molise,305617,232794,76.17,0.09
1484,2021-04-20,MOL,2319,1026,1293,1211,1098,10,ITF,ITF2,14,Molise,Molise,305617,235113,76.93,0.76
1485,2021-06-09,MOL,1023,565,458,507,500,16,ITF,ITF2,14,Molise,Molise,305617,236136,77.27,0.33
1486,2021-05-23,MOL,1703,866,837,1689,6,8,ITF,ITF2,14,Molise,Molise,305617,237839,77.82,0.56
1487,2021-03-01,MOL,662,274,388,430,215,17,ITF,ITF2,14,Molise,Molise,305617,238501,78.04,0.22
1488,2021-04-03,MOL,1773,851,922,1716,35,22,ITF,ITF2,14,Molise,Molise,305617,240274,78.62,0.58
1489,2021-02-18,MOL,319,74,245,302,13,4,ITF,ITF2,14,Molise,Molise,305617,240593,78.72,0.1
1490,2021-03-09,MOL,1329,579,750,1149,152,28,ITF,ITF2,14,Molise,Molise,305617,241922,79.16,0.43
1491,2021-02-20,MOL,1018,441,577,998,20,0,ITF,ITF2,14,Molise,Molise,305617,242940,79.49,0.33
1492,2021-05-31,MOL,2356,1144,1212,1893,418,45,ITF,ITF2,14,Molise,Molise,305617,245296,80.26,0.77
1493,2021-05-14,MOL,2644,1215,1429,1890,718,36,ITF,ITF2,14,Molise,Molise,305617,247940,81.13,0.87
1494,2021-06-02,MOL,2806,1355,1451,2687,99,20,ITF,ITF2,14,Molise,Molise,305617,250746,82.05,0.92
1495,2021-02-03,MOL,731,249,482,338,393,0,ITF,ITF2,14,Molise,Molise,305617,251477,82.29,0.24
1496,2021-04-27,MOL,1594,768,826,443,1129,22,ITF,ITF2,14,Molise,Molise,305617,253071,82.81,0.52
1497,2021-05-16,MOL,1248,572,676,1046,182,20,ITF,ITF2,14,Molise,Molise,305617,254319,83.21,0.41
1498,2021-07-06,MOL,1697,806,891,17,1677,3,ITF,ITF2,14,Molise,Molise,305617,256016,83.77,0.56
1499,2021-05-10,MOL,2890,1285,1605,2489,373,28,ITF,ITF2,14,Molise,Molise,305617,258906,84.72,0.95
1500,2021-06-29,MOL,2459,1147,1312,376,2057,26,ITF,ITF2,14,Molise,Molise,305617,261365,85.52,0.8
1501,2021-05-03,MOL,2485,1165,1320,2288,163,34,ITF,ITF2,14,Molise,Molise,305617,263850,86.33,0.81
1502,2021-05-17,MOL,2228,1092,1136,1705,496,27,ITF,ITF2,14,Molise,Molise,305617,266078,87.06,0.73
1503,2021-03-21,MOL,1246,542,704,477,767,2,ITF,ITF2,14,Molise,Molise,305617,267324,87.47,0.41
1504,2021-03-14,MOL,596,240,356,17,579,0,ITF,ITF2,14,Molise,Molise,305617,267920,87.67,0.2
1505,2021-06-22,MOL,2959,1368,1591,668,2274,17,ITF,ITF2,14,Molise,Molise,305617,270879,88.63,0.97
1506,2021-03-28,MOL,1626,747,879,517,1102,7,ITF,ITF2,14,Molise,Molise,305617,272505,89.17,0.53
1507,2021-01-30,MOL,461,158,303,12,449,0,ITF,ITF2,14,Molise,Molise,305617,272966,89.32,0.15
1508,2021-02-06,MOL,430,179,251,29,401,0,ITF,ITF2,14,Molise,Molise,305617,273396,89.46,0.14
1509,2021-06-04,MOL,3037,1490,1547,2566,442,29,ITF,ITF2,14,Molise,Molise,305617,276433,90.45,0.99
1510,2021-04-08,MOL,1767,904,863,1540,202,25,ITF,ITF2,14,Molise,Molise,305617,278200,91.03,0.58
1511,2021-04-22,MOL,1846,864,982,1057,779,10,ITF,ITF2,14,Molise,Molise,305617,280046,91.63,0.6
1512,2021-02-17,MOL,72,32,40,50,15,7,ITF,ITF2,14,Molise,Molise,305617,280118,91.66,0.02
1513,2021-05-28,MOL,2649,1364,1285,2037,547,65,ITF,ITF2,14,Molise,Molise,305617,282767,92.52,0.87
1514,2021-06-11,MOL,3443,1654,1789,1971,1429,43,ITF,ITF2,14,Molise,Molise,305617,286210,93.65,1.13
1515,2021-04-15,MOL,1926,794,1132,1074,845,7,ITF,ITF2,14,Molise,Molise,305617,288136,94.28,0.63
1516,2021-03-24,MAR,7035,2984,4051,3296,3671,68,ITI,ITI3,11,Marche,Marche,1525271,7035,0.46,0.46
1517,2021-06-01,MAR,12072,6162,5910,9693,2095,284,ITI,ITI3,11,Marche,Marche,1525271,19107,1.25,0.79
1518,2021-03-10,MAR,5678,2409,3269,4480,1146,52,ITI,ITI3,11,Marche,Marche,1525271,24785,1.62,0.37
1519,2021-02-21,MAR,376,141,235,363,1,12,ITI,ITI3,11,Marche,Marche,1525271,25161,1.65,0.02
1520,2021-01-19,MAR,232,87,145,139,90,3,ITI,ITI3,11,Marche,Marche,1525271,25393,1.66,0.02
1521,2021-06-15,MAR,13190,6567,6623,9823,3050,317,ITI,ITI3,11,Marche,Marche,1525271,38583,2.53,0.86
1522,2021-01-12,MAR,1229,415,814,1216,0,13,ITI,ITI3,11,Marche,Marche,1525271,39812,2.61,0.08
1523,2021-06-22,MAR,13204,6475,6729,6476,6445,283,ITI,ITI3,11,Marche,Marche,1525271,53016,3.48,0.87
1524,2021-04-26,MAR,9170,4062,5108,6024,3022,124,ITI,ITI3,11,Marche,Marche,1525271,62186,4.08,0.6
1525,2021-05-20,MAR,12514,5874,6640,7534,4729,251,ITI,ITI3,11,Marche,Marche,1525271,74700,4.9,0.82
1526,2021-02-07,MAR,1871,735,1136,332,1527,12,ITI,ITI3,11,Marche,Marche,1525271,76571,5.02,0.12
1527,2021-01-31,MAR,1918,769,1149,98,1816,4,ITI,ITI3,11,Marche,Marche,1525271,78489,5.15,0.13
1528,2021-05-27,MAR,13734,6817,6917,9180,4301,253,ITI,ITI3,11,Marche,Marche,1525271,92223,6.05,0.9
1529,2021-03-31,MAR,7374,3086,4288,4268,3023,83,ITI,ITI3,11,Marche,Marche,1525271,99597,6.53,0.48
1530,2021-05-15,MAR,13983,6383,7600,7831,5907,245,ITI,ITI3,11,Marche,Marche,1525271,113580,7.45,0.92
1531,2021-02-19,MAR,2002,739,1263,1826,135,41,ITI,ITI3,11,Marche,Marche,1525271,115582,7.58,0.13
1532,2021-01-21,MAR,918,261,657,574,327,17,ITI,ITI3,11,Marche,Marche,1525271,116500,7.64,0.06
1533,2021-05-01,MAR,9318,3924,5394,3500,5742,76,ITI,ITI3,11,Marche,Marche,1525271,125818,8.25,0.61
1534,2021-03-05,MAR,6224,2872,3352,4693,1468,63,ITI,ITI3,11,Marche,Marche,1525271,132042,8.66,0.41
1535,2021-01-07,MAR,1809,636,1173,1793,0,16,ITI,ITI3,11,Marche,Marche,1525271,133851,8.78,0.12
1536,2021-01-26,MAR,2022,748,1274,81,1932,9,ITI,ITI3,11,Marche,Marche,1525271,135873,8.91,0.13
1537,2021-04-19,MAR,9602,4498,5104,7901,1581,120,ITI,ITI3,11,Marche,Marche,1525271,145475,9.54,0.63
1538,2021-02-14,MAR,739,301,438,727,0,12,ITI,ITI3,11,Marche,Marche,1525271,146214,9.59,0.05
1539,2021-04-05,MAR,5691,2358,3333,4346,1269,76,ITI,ITI3,11,Marche,Marche,1525271,151905,9.96,0.37
1540,2021-06-27,MAR,9949,4820,5129,4487,5291,171,ITI,ITI3,11,Marche,Marche,1525271,161854,10.61,0.65
1541,2021-03-19,MAR,3835,1599,2236,325,3498,12,ITI,ITI3,11,Marche,Marche,1525271,165689,10.86,0.25
1542,2021-03-17,MAR,3432,1497,1935,105,3325,2,ITI,ITI3,11,Marche,Marche,1525271,169121,11.09,0.23
1543,2021-02-02,MAR,1193,398,795,72,1121,0,ITI,ITI3,11,Marche,Marche,1525271,170314,11.17,0.08
1544,2021-05-13,MAR,12603,5695,6908,6827,5499,277,ITI,ITI3,11,Marche,Marche,1525271,182917,11.99,0.83
1545,2021-04-12,MAR,8565,3771,4794,7936,482,147,ITI,ITI3,11,Marche,Marche,1525271,191482,12.55,0.56
1546,2021-01-02,MAR,456,141,315,454,0,2,ITI,ITI3,11,Marche,Marche,1525271,191938,12.58,0.03
1547,2021-03-07,MAR,5180,2107,3073,4379,754,47,ITI,ITI3,11,Marche,Marche,1525271,197118,12.92,0.34
1548,2021-01-23,MAR,557,190,367,120,434,3,ITI,ITI3,11,Marche,Marche,1525271,197675,12.96,0.04
1549,2021-06-29,MAR,13371,6599,6772,4929,8215,227,ITI,ITI3,11,Marche,Marche,1525271,211046,13.84,0.88
1550,2021-05-03,MAR,10392,4682,5710,4848,5409,135,ITI,ITI3,11,Marche,Marche,1525271,221438,14.52,0.68
1551,2021-03-28,MAR,4125,1739,2386,2396,1691,38,ITI,ITI3,11,Marche,Marche,1525271,225563,14.79,0.27
1552,2021-01-30,MAR,1905,668,1237,27,1878,0,ITI,ITI3,11,Marche,Marche,1525271,227468,14.91,0.12
1553,2021-04-07,MAR,8178,3615,4563,7716,347,115,ITI,ITI3,11,Marche,Marche,1525271,235646,15.45,0.54
1554,2021-02-09,MAR,124,42,82,46,78,0,ITI,ITI3,11,Marche,Marche,1525271,235770,15.46,0.01
1555,2021-06-12,MAR,13716,7292,6424,12106,1279,331,ITI,ITI3,11,Marche,Marche,1525271,249486,16.36,0.9
1556,2021-04-16,MAR,10083,4703,5380,9362,525,196,ITI,ITI3,11,Marche,Marche,1525271,259569,17.02,0.66
1557,2021-01-04,MAR,1513,573,940,1501,0,12,ITI,ITI3,11,Marche,Marche,1525271,261082,17.12,0.1
1558,2021-03-29,MAR,5870,2570,3300,3392,2431,47,ITI,ITI3,11,Marche,Marche,1525271,266952,17.5,0.38
1559,2021-06-03,MAR,14638,7481,7157,12078,2256,304,ITI,ITI3,11,Marche,Marche,1525271,281590,18.46,0.96
1560,2021-02-18,MAR,2144,786,1358,1809,286,49,ITI,ITI3,11,Marche,Marche,1525271,283734,18.6,0.14
1561,2021-05-29,MAR,12860,6232,6628,8114,4528,218,ITI,ITI3,11,Marche,Marche,1525271,296594,19.45,0.84
1562,2021-07-04,MAR,10896,5446,5450,3204,7530,162,ITI,ITI3,11,Marche,Marche,1525271,307490,20.16,0.71
1563,2020-12-31,MAR,392,184,208,390,0,2,ITI,ITI3,11,Marche,Marche,1525271,307882,20.19,0.03
1564,2021-02-04,MAR,2385,843,1542,107,2273,5,ITI,ITI3,11,Marche,Marche,1525271,310267,20.34,0.16
1565,2021-01-18,MAR,696,237,459,536,149,11,ITI,ITI3,11,Marche,Marche,1525271,310963,20.39,0.05
1566,2021-04-28,MAR,10925,4978,5947,6025,4731,169,ITI,ITI3,11,Marche,Marche,1525271,321888,21.1,0.72
1567,2021-03-12,MAR,4646,1975,2671,3348,1244,54,ITI,ITI3,11,Marche,Marche,1525271,326534,21.41,0.3
1568,2021-01-14,MAR,2012,694,1318,1988,0,24,ITI,ITI3,11,Marche,Marche,1525271,328546,21.54,0.13
1569,2021-06-20,MAR,11157,5545,5612,5990,4985,182,ITI,ITI3,11,Marche,Marche,1525271,339703,22.27,0.73
1570,2021-04-24,MAR,12166,5363,6803,7559,4464,143,ITI,ITI3,11,Marche,Marche,1525271,351869,23.07,0.8
1571,2021-02-26,MAR,3676,1522,2154,3097,476,103,ITI,ITI3,11,Marche,Marche,1525271,355545,23.31,0.24
1572,2021-05-08,MAR,12269,5476,6793,4857,7247,165,ITI,ITI3,11,Marche,Marche,1525271,367814,24.11,0.8
1573,2021-01-09,MAR,1714,606,1108,1694,0,20,ITI,ITI3,11,Marche,Marche,1525271,369528,24.23,0.11
1574,2021-04-02,MAR,6886,2983,3903,6039,739,108,ITI,ITI3,11,Marche,Marche,1525271,376414,24.68,0.45
1575,2021-03-16,MAR,3478,1488,1990,285,3187,6,ITI,ITI3,11,Marche,Marche,1525271,379892,24.91,0.23
1576,2021-02-28,MAR,2836,1251,1585,2822,6,8,ITI,ITI3,11,Marche,Marche,1525271,382728,25.09,0.19
1577,2021-06-08,MAR,14099,7096,7003,11197,2611,291,ITI,ITI3,11,Marche,Marche,1525271,396827,26.02,0.92
1578,2021-03-02,MAR,5002,1967,3035,4371,566,65,ITI,ITI3,11,Marche,Marche,1525271,401829,26.34,0.33
1579,2021-06-10,MAR,14921,7690,7231,12566,2013,342,ITI,ITI3,11,Marche,Marche,1525271,416750,27.32,0.98
1580,2021-07-06,MAR,13996,6939,7057,3169,10604,223,ITI,ITI3,11,Marche,Marche,1525271,430746,28.24,0.92
1581,2021-01-16,MAR,2036,733,1303,1986,0,50,ITI,ITI3,11,Marche,Marche,1525271,432782,28.37,0.13
1582,2021-06-19,MAR,14687,7402,7285,7749,6673,265,ITI,ITI3,11,Marche,Marche,1525271,447469,29.34,0.96
1583,2021-05-31,MAR,11780,5942,5838,8599,2929,252,ITI,ITI3,11,Marche,Marche,1525271,459249,30.11,0.77
1584,2021-05-17,MAR,11883,5582,6301,7469,4194,220,ITI,ITI3,11,Marche,Marche,1525271,471132,30.89,0.78
1585,2021-04-14,MAR,10214,4563,5651,9661,370,183,ITI,ITI3,11,Marche,Marche,1525271,481346,31.56,0.67
1586,2020-12-30,MAR,17,5,12,17,0,0,ITI,ITI3,11,Marche,Marche,1525271,481363,31.56,0.0
1587,2021-04-09,MAR,9568,4190,5378,9155,200,213,ITI,ITI3,11,Marche,Marche,1525271,490931,32.19,0.63
1588,2021-01-06,MAR,2204,801,1403,2185,0,19,ITI,ITI3,11,Marche,Marche,1525271,493135,32.33,0.14
1589,2021-03-04,MAR,6536,2892,3644,5084,1393,59,ITI,ITI3,11,Marche,Marche,1525271,499671,32.76,0.43
1590,2021-03-13,MAR,5771,2659,3112,1765,3966,40,ITI,ITI3,11,Marche,Marche,1525271,505442,33.14,0.38
1591,2021-06-21,MAR,12603,6182,6421,5481,6877,245,ITI,ITI3,11,Marche,Marche,1525271,518045,33.96,0.83
1592,2021-05-09,MAR,8863,4020,4843,3559,5227,77,ITI,ITI3,11,Marche,Marche,1525271,526908,34.55,0.58
1593,2021-03-06,MAR,5736,2640,3096,4422,1267,47,ITI,ITI3,11,Marche,Marche,1525271,532644,34.92,0.38
1594,2021-02-16,MAR,1287,475,812,1226,30,31,ITI,ITI3,11,Marche,Marche,1525271,533931,35.01,0.08
1595,2021-02-25,MAR,3559,1463,2096,3319,181,59,ITI,ITI3,11,Marche,Marche,1525271,537490,35.24,0.23
1596,2021-06-05,MAR,13940,7008,6932,11517,2059,364,ITI,ITI3,11,Marche,Marche,1525271,551430,36.15,0.91
1597,2021-04-23,MAR,11304,5217,6087,8087,3055,162,ITI,ITI3,11,Marche,Marche,1525271,562734,36.89,0.74
1598,2021-02-23,MAR,3315,1432,1883,3244,56,15,ITI,ITI3,11,Marche,Marche,1525271,566049,37.11,0.22
1599,2021-03-26,MAR,6335,2607,3728,3469,2810,56,ITI,ITI3,11,Marche,Marche,1525271,572384,37.53,0.42
1600,2021-06-17,MAR,15193,7557,7636,8801,6097,295,ITI,ITI3,11,Marche,Marche,1525271,587577,38.52,1.0
1601,2021-03-09,MAR,5431,2293,3138,4465,881,85,ITI,ITI3,11,Marche,Marche,1525271,593008,38.88,0.36
1602,2021-04-13,MAR,9838,4260,5578,9412,233,193,ITI,ITI3,11,Marche,Marche,1525271,602846,39.52,0.65
1603,2021-07-05,MAR,13156,6501,6655,2924,10061,171,ITI,ITI3,11,Marche,Marche,1525271,616002,40.39,0.86
1604,2021-06-16,MAR,13759,6915,6844,9130,4366,263,ITI,ITI3,11,Marche,Marche,1525271,629761,41.29,0.9
1605,2021-06-02,MAR,11900,5938,5962,11028,677,195,ITI,ITI3,11,Marche,Marche,1525271,641661,42.07,0.78
1606,2021-02-22,MAR,3459,1531,1928,3350,75,34,ITI,ITI3,11,Marche,Marche,1525271,645120,42.3,0.23
1607,2021-05-10,MAR,9448,4336,5112,4769,4551,128,ITI,ITI3,11,Marche,Marche,1525271,654568,42.91,0.62
1608,2021-03-14,MAR,2499,1032,1467,1897,592,10,ITI,ITI3,11,Marche,Marche,1525271,657067,43.08,0.16
1609,2021-03-21,MAR,4504,1873,2631,1614,2875,15,ITI,ITI3,11,Marche,Marche,1525271,661571,43.37,0.3
1610,2021-02-06,MAR,2463,902,1561,513,1941,9,ITI,ITI3,11,Marche,Marche,1525271,664034,43.54,0.16
1611,2021-05-24,MAR,10819,5120,5699,7944,2698,177,ITI,ITI3,11,Marche,Marche,1525271,674853,44.24,0.71
1612,2021-05-22,MAR,11937,5719,6218,7319,4448,170,ITI,ITI3,11,Marche,Marche,1525271,686790,45.03,0.78
1613,2021-02-11,MAR,1987,657,1330,1557,389,41,ITI,ITI3,11,Marche,Marche,1525271,688777,45.16,0.13
1614,2021-05-05,MAR,11691,5320,6371,5105,6429,157,ITI,ITI3,11,Marche,Marche,1525271,700468,45.92,0.77
1615,2021-05-07,MAR,12841,5806,7035,3584,9179,78,ITI,ITI3,11,Marche,Marche,1525271,713309,46.77,0.84
1616,2021-02-13,MAR,1093,462,631,988,82,23,ITI,ITI3,11,Marche,Marche,1525271,714402,46.84,0.07
1617,2021-01-27,MAR,2120,780,1340,119,1999,2,ITI,ITI3,11,Marche,Marche,1525271,716522,46.98,0.14
1618,2021-04-20,MAR,10716,5007,5709,9154,1432,130,ITI,ITI3,11,Marche,Marche,1525271,727238,47.68,0.7
1619,2021-01-25,MAR,1596,558,1038,94,1502,0,ITI,ITI3,11,Marche,Marche,1525271,728834,47.78,0.1
1620,2021-01-15,MAR,1771,500,1271,1754,0,17,ITI,ITI3,11,Marche,Marche,1525271,730605,47.9,0.12
1621,2021-04-25,MAR,8599,3993,4606,6897,1575,127,ITI,ITI3,11,Marche,Marche,1525271,739204,48.46,0.56
1622,2021-01-13,MAR,2107,746,1361,2066,0,41,ITI,ITI3,11,Marche,Marche,1525271,741311,48.6,0.14
1623,2021-05-02,MAR,8900,3937,4963,3082,5739,79,ITI,ITI3,11,Marche,Marche,1525271,750211,49.19,0.58
1624,2021-06-28,MAR,12306,6002,6304,4611,7460,235,ITI,ITI3,11,Marche,Marche,1525271,762517,49.99,0.81
1625,2021-03-22,MAR,5657,2379,3278,2482,3132,43,ITI,ITI3,11,Marche,Marche,1525271,768174,50.36,0.37
1626,2021-01-24,MAR,881,339,542,5,876,0,ITI,ITI3,11,Marche,Marche,1525271,769055,50.42,0.06
1627,2021-06-30,MAR,13659,6668,6991,4463,8985,211,ITI,ITI3,11,Marche,Marche,1525271,782714,51.32,0.9
1628,2021-05-04,MAR,10969,4840,6129,4927,5899,143,ITI,ITI3,11,Marche,Marche,1525271,793683,52.04,0.72
1629,2021-03-20,MAR,4146,1746,2400,1035,3097,14,ITI,ITI3,11,Marche,Marche,1525271,797829,52.31,0.27
1630,2021-01-22,MAR,489,168,321,193,294,2,ITI,ITI3,11,Marche,Marche,1525271,798318,52.34,0.03
1631,2021-07-07,MAR,14528,7200,7328,3071,11216,241,ITI,ITI3,11,Marche,Marche,1525271,812846,53.29,0.95
1632,2021-04-30,MAR,14136,6190,7946,5404,8544,188,ITI,ITI3,11,Marche,Marche,1525271,826982,54.22,0.93
1633,2021-04-11,MAR,7116,3115,4001,6692,286,138,ITI,ITI3,11,Marche,Marche,1525271,834098,54.69,0.47
1634,2021-03-11,MAR,6596,2787,3809,5149,1372,75,ITI,ITI3,11,Marche,Marche,1525271,840694,55.12,0.43
1635,2021-03-25,MAR,6657,2773,3884,3190,3411,56,ITI,ITI3,11,Marche,Marche,1525271,847351,55.55,0.44
1636,2021-07-03,MAR,13839,6989,6850,4138,9390,311,ITI,ITI3,11,Marche,Marche,1525271,861190,56.46,0.91
1637,2021-03-27,MAR,7387,3078,4309,4950,2365,72,ITI,ITI3,11,Marche,Marche,1525271,868577,56.95,0.48
1638,2021-04-10,MAR,10917,4620,6297,10370,313,234,ITI,ITI3,11,Marche,Marche,1525271,879494,57.66,0.72
1639,2021-01-03,MAR,907,354,553,897,0,10,ITI,ITI3,11,Marche,Marche,1525271,880401,57.72,0.06
1640,2021-03-08,MAR,6297,2759,3538,5187,1002,108,ITI,ITI3,11,Marche,Marche,1525271,886698,58.13,0.41
1641,2021-06-14,MAR,12834,6486,6348,9257,3308,269,ITI,ITI3,11,Marche,Marche,1525271,899532,58.98,0.84
1642,2021-01-29,MAR,1992,730,1262,161,1826,5,ITI,ITI3,11,Marche,Marche,1525271,901524,59.11,0.13
1643,2021-05-18,MAR,11083,5272,5811,7478,3428,177,ITI,ITI3,11,Marche,Marche,1525271,912607,59.83,0.73
1644,2021-05-11,MAR,10622,4832,5790,5490,4943,189,ITI,ITI3,11,Marche,Marche,1525271,923229,60.53,0.7
1645,2021-03-15,MAR,4411,2032,2379,1291,3099,21,ITI,ITI3,11,Marche,Marche,1525271,927640,60.82,0.29
1646,2021-06-23,MAR,13888,6816,7072,6619,7014,255,ITI,ITI3,11,Marche,Marche,1525271,941528,61.73,0.91
1647,2021-05-21,MAR,13736,6516,7220,7226,6299,211,ITI,ITI3,11,Marche,Marche,1525271,955264,62.63,0.9
1648,2021-05-28,MAR,13957,6737,7220,8801,4857,299,ITI,ITI3,11,Marche,Marche,1525271,969221,63.54,0.92
1649,2021-04-01,MAR,7576,3182,4394,4068,3416,92,ITI,ITI3,11,Marche,Marche,1525271,976797,64.04,0.5
1650,2021-01-08,MAR,1582,592,990,1567,0,15,ITI,ITI3,11,Marche,Marche,1525271,978379,64.14,0.1
1651,2021-04-18,MAR,8824,4131,4693,7735,921,168,ITI,ITI3,11,Marche,Marche,1525271,987203,64.72,0.58
1652,2021-01-10,MAR,1745,701,1044,1731,0,14,ITI,ITI3,11,Marche,Marche,1525271,988948,64.84,0.11
1653,2021-04-03,MAR,7572,3204,4368,6737,667,168,ITI,ITI3,11,Marche,Marche,1525271,996520,65.33,0.5
1654,2021-06-25,MAR,14312,7154,7158,6423,7602,287,ITI,ITI3,11,Marche,Marche,1525271,1010832,66.27,0.94
1655,2021-04-22,MAR,10797,4931,5866,9083,1578,136,ITI,ITI3,11,Marche,Marche,1525271,1021629,66.98,0.71
1656,2021-02-24,MAR,3534,1547,1987,3424,78,32,ITI,ITI3,11,Marche,Marche,1525271,1025163,67.21,0.23
1657,2021-06-04,MAR,14336,7289,7047,11591,2438,307,ITI,ITI3,11,Marche,Marche,1525271,1039499,68.15,0.94
1658,2021-04-08,MAR,8691,3805,4886,8216,345,130,ITI,ITI3,11,Marche,Marche,1525271,1048190,68.72,0.57
1659,2021-03-03,MAR,6699,3076,3623,5718,884,97,ITI,ITI3,11,Marche,Marche,1525271,1054889,69.16,0.44
1660,2021-01-05,MAR,1576,591,985,1557,0,19,ITI,ITI3,11,Marche,Marche,1525271,1056465,69.26,0.1
1661,2021-04-15,MAR,10377,4675,5702,9578,565,234,ITI,ITI3,11,Marche,Marche,1525271,1066842,69.94,0.68
1662,2021-02-17,MAR,1827,700,1127,1641,118,68,ITI,ITI3,11,Marche,Marche,1525271,1068669,70.06,0.12
1663,2021-02-20,MAR,4162,1732,2430,4041,111,10,ITI,ITI3,11,Marche,Marche,1525271,1072831,70.34,0.27
1664,2021-01-20,MAR,405,100,305,384,19,2,ITI,ITI3,11,Marche,Marche,1525271,1073236,70.36,0.03
1665,2021-02-03,MAR,2124,741,1383,98,2005,21,ITI,ITI3,11,Marche,Marche,1525271,1075360,70.5,0.14
1666,2021-05-14,MAR,13505,6225,7280,6509,6784,212,ITI,ITI3,11,Marche,Marche,1525271,1088865,71.39,0.89
1667,2021-07-02,MAR,14549,7177,7372,4676,9642,231,ITI,ITI3,11,Marche,Marche,1525271,1103414,72.34,0.95
1668,2021-06-24,MAR,13830,6674,7156,6189,7370,271,ITI,ITI3,11,Marche,Marche,1525271,1117244,73.25,0.91
1669,2021-01-11,MAR,1176,411,765,1158,0,18,ITI,ITI3,11,Marche,Marche,1525271,1118420,73.33,0.08
1670,2021-04-21,MAR,10783,4967,5816,9436,1194,153,ITI,ITI3,11,Marche,Marche,1525271,1129203,74.03,0.71
1671,2021-01-28,MAR,2086,725,1361,163,1922,1,ITI,ITI3,11,Marche,Marche,1525271,1131289,74.17,0.14
1672,2021-04-04,MAR,3824,1792,2032,2606,1169,49,ITI,ITI3,11,Marche,Marche,1525271,1135113,74.42,0.25
1673,2021-02-05,MAR,2154,653,1501,438,1715,1,ITI,ITI3,11,Marche,Marche,1525271,1137267,74.56,0.14
1674,2021-05-16,MAR,10898,4957,5941,6551,4228,119,ITI,ITI3,11,Marche,Marche,1525271,1148165,75.28,0.71
1675,2021-05-30,MAR,9732,4690,5042,6547,2989,196,ITI,ITI3,11,Marche,Marche,1525271,1157897,75.91,0.64
1676,2021-04-27,MAR,9590,4388,5202,5510,3986,94,ITI,ITI3,11,Marche,Marche,1525271,1167487,76.54,0.63
1677,2021-01-17,MAR,1616,693,923,1550,60,6,ITI,ITI3,11,Marche,Marche,1525271,1169103,76.65,0.11
1678,2021-06-18,MAR,15348,7648,7700,8300,6750,298,ITI,ITI3,11,Marche,Marche,1525271,1184451,77.66,1.01
1679,2021-04-29,MAR,13438,6153,7285,7163,6098,177,ITI,ITI3,11,Marche,Marche,1525271,1197889,78.54,0.88
1680,2021-06-09,MAR,14278,7416,6862,12107,1870,301,ITI,ITI3,11,Marche,Marche,1525271,1212167,79.47,0.94
1681,2021-06-07,MAR,13320,6588,6732,10568,2450,302,ITI,ITI3,11,Marche,Marche,1525271,1225487,80.35,0.87
1682,2021-02-27,MAR,3401,1457,1944,3158,209,34,ITI,ITI3,11,Marche,Marche,1525271,1228888,80.57,0.22
1683,2021-03-18,MAR,3398,1478,1920,150,3236,12,ITI,ITI3,11,Marche,Marche,1525271,1232286,80.79,0.22
1684,2021-06-26,MAR,13576,6905,6671,5688,7671,217,ITI,ITI3,11,Marche,Marche,1525271,1245862,81.68,0.89
1685,2021-05-23,MAR,9208,4282,4926,7413,1671,124,ITI,ITI3,11,Marche,Marche,1525271,1255070,82.29,0.6
1686,2021-05-06,MAR,12655,5822,6833,5362,7071,222,ITI,ITI3,11,Marche,Marche,1525271,1267725,83.11,0.83
1687,2021-02-12,MAR,1582,618,964,1404,152,26,ITI,ITI3,11,Marche,Marche,1525271,1269307,83.22,0.1
1688,2021-02-10,MAR,1439,452,987,1038,359,42,ITI,ITI3,11,Marche,Marche,1525271,1270746,83.31,0.09
1689,2021-06-11,MAR,13992,7152,6840,11368,2321,303,ITI,ITI3,11,Marche,Marche,1525271,1284738,84.23,0.92
1690,2021-05-25,MAR,11659,5750,5909,8497,2942,220,ITI,ITI3,11,Marche,Marche,1525271,1296397,84.99,0.76
1691,2021-03-01,MAR,3772,1520,2252,3503,248,21,ITI,ITI3,11,Marche,Marche,1525271,1300169,85.24,0.25
1692,2021-05-12,MAR,10429,4690,5739,4738,5501,190,ITI,ITI3,11,Marche,Marche,1525271,1310598,85.93,0.68
1693,2021-07-08,MAR,6979,3502,3477,1093,5805,81,ITI,ITI3,11,Marche,Marche,1525271,1317577,86.38,0.46
1694,2021-07-01,MAR,14685,7363,7322,4659,9748,278,ITI,ITI3,11,Marche,Marche,1525271,1332262,87.35,0.96
1695,2021-02-15,MAR,967,412,555,939,13,15,ITI,ITI3,11,Marche,Marche,1525271,1333229,87.41,0.06
1696,2021-05-26,MAR,11850,5935,5915,8449,3187,214,ITI,ITI3,11,Marche,Marche,1525271,1345079,88.19,0.78
1697,2021-03-30,MAR,7475,3075,4400,4580,2823,72,ITI,ITI3,11,Marche,Marche,1525271,1352554,88.68,0.49
1698,2021-02-01,MAR,1362,479,883,95,1264,3,ITI,ITI3,11,Marche,Marche,1525271,1353916,88.77,0.09
1699,2021-04-06,MAR,8876,3694,5182,7933,810,133,ITI,ITI3,11,Marche,Marche,1525271,1362792,89.35,0.58
1700,2021-03-23,MAR,5797,2531,3266,2227,3535,35,ITI,ITI3,11,Marche,Marche,1525271,1368589,89.73,0.38
1701,2021-02-08,MAR,833,258,575,366,462,5,ITI,ITI3,11,Marche,Marche,1525271,1369422,89.78,0.05
1702,2021-05-19,MAR,11498,5285,6213,8369,2934,195,ITI,ITI3,11,Marche,Marche,1525271,1380920,90.54,0.75
1703,2021-04-17,MAR,11704,5316,6388,10400,1073,231,ITI,ITI3,11,Marche,Marche,1525271,1392624,91.3,0.77
1704,2021-06-13,MAR,10746,5563,5183,9203,1294,249,ITI,ITI3,11,Marche,Marche,1525271,1403370,92.01,0.7
1705,2020-12-27,MAR,204,99,105,202,0,2,ITI,ITI3,11,Marche,Marche,1525271,1403574,92.02,0.01
1706,2021-06-06,MAR,12447,6133,6314,10635,1577,235,ITI,ITI3,11,Marche,Marche,1525271,1416021,92.84,0.82
1707,2021-03-28,FVG,4937,2354,2583,4725,158,54,ITH,ITH4,6,Friuli-Venezia Giulia,Friuli Venezia Giulia,1215220,4937,0.41,0.41
1708,2021-01-18,FVG,1961,606,1355,1867,94,0,ITH,ITH4,6,Friuli-Venezia Giulia,Friuli Venezia Giulia,1215220,6898,0.57,0.16
1709,2021-01-04,FVG,1507,558,949,1507,0,0,ITH,ITH4,6,Friuli-Venezia Giulia,Friuli Venezia Giulia,1215220,8405,0.69,0.12
1710,2021-02-06,FVG,1154,338,816,21,1132,1,ITH,ITH4,6,Friuli-Venezia Giulia,Friuli Venezia Giulia,1215220,9559,0.79,0.09
1711,2021-02-23,FVG,2644,1278,1366,2461,180,3,ITH,ITH4,6,Friuli-Venezia Giulia,Friuli Venezia Giulia,1215220,12203,1.0,0.22
1712,2021-04-11,FVG,3433,1520,1913,2436,906,91,ITH,ITH4,6,Friuli-Venezia Giulia,Friuli Venezia Giulia,1215220,15636,1.29,0.28
1713,2021-06-07,FVG,9159,4748,4411,8149,990,20,ITH,ITH4,6,Friuli-Venezia Giulia,Friuli Venezia Giulia,1215220,24795,2.04,0.75
1714,2021-05-31,FVG,8891,4418,4473,6502,2177,212,ITH,ITH4,6,Friuli-Venezia Giulia,Friuli Venezia Giulia,1215220,33686,2.77,0.73
1715,2021-04-28,FVG,7293,3222,4071,3672,3490,131,ITH,ITH4,6,Friuli-Venezia Giulia,Friuli Venezia Giulia,1215220,40979,3.37,0.6
1716,2021-01-23,FVG,814,323,491,4,810,0,ITH,ITH4,6,Friuli-Venezia Giulia,Friuli Venezia Giulia,1215220,41793,3.44,0.07
1717,2021-05-05,FVG,9758,4262,5496,6051,3469,238,ITH,ITH4,6,Friuli-Venezia Giulia,Friuli Venezia Giulia,1215220,51551,4.24,0.8
1718,2021-06-24,FVG,10977,5599,5378,1949,9022,6,ITH,ITH4,6,Friuli-Venezia Giulia,Friuli Venezia Giulia,1215220,62528,5.15,0.9
1719,2021-03-16,FVG,3187,1299,1888,1033,2081,73,ITH,ITH4,6,Friuli-Venezia Giulia,Friuli Venezia Giulia,1215220,65715,5.41,0.26
1720,2021-05-12,FVG,10867,5034,5833,9067,1408,392,ITH,ITH4,6,Friuli-Venezia Giulia,Friuli Venezia Giulia,1215220,76582,6.3,0.89
1721,2021-05-19,FVG,12039,5934,6105,9295,2345,399,ITH,ITH4,6,Friuli-Venezia Giulia,Friuli Venezia Giulia,1215220,88621,7.29,0.99
1722,2021-02-04,FVG,2725,808,1917,35,2690,0,ITH,ITH4,6,Friuli-Venezia Giulia,Friuli Venezia Giulia,1215220,91346,7.52,0.22
1723,2021-04-30,FVG,7348,3244,4104,3528,3650,170,ITH,ITH4,6,Friuli-Venezia Giulia,Friuli Venezia Giulia,1215220,98694,8.12,0.6
1724,2021-02-18,FVG,3218,1492,1726,2791,407,20,ITH,ITH4,6,Friuli-Venezia Giulia,Friuli Venezia Giulia,1215220,101912,8.39,0.26
1725,2021-04-02,FVG,6594,2926,3668,4643,1838,113,ITH,ITH4,6,Friuli-Venezia Giulia,Friuli Venezia Giulia,1215220,108506,8.93,0.54
1726,2021-04-16,FVG,6951,3020,3931,4897,1925,129,ITH,ITH4,6,Friuli-Venezia Giulia,Friuli Venezia Giulia,1215220,115457,9.5,0.57
1727,2021-01-06,FVG,710,264,446,710,0,0,ITH,ITH4,6,Friuli-Venezia Giulia,Friuli Venezia Giulia,1215220,116167,9.56,0.06
1728,2021-01-30,FVG,2277,745,1532,270,2007,0,ITH,ITH4,6,Friuli-Venezia Giulia,Friuli Venezia Giulia,1215220,118444,9.75,0.19
1729,2021-06-26,FVG,10041,5099,4942,3898,6141,2,ITH,ITH4,6,Friuli-Venezia Giulia,Friuli Venezia Giulia,1215220,128485,10.57,0.83
1730,2021-04-21,FVG,7754,3458,4296,3989,3680,85,ITH,ITH4,6,Friuli-Venezia Giulia,Friuli Venezia Giulia,1215220,136239,11.21,0.64
1731,2021-05-24,FVG,11418,5523,5895,7550,3616,252,ITH,ITH4,6,Friuli-Venezia Giulia,Friuli Venezia Giulia,1215220,147657,12.15,0.94
1732,2021-02-13,FVG,566,179,387,559,6,1,ITH,ITH4,6,Friuli-Venezia Giulia,Friuli Venezia Giulia,1215220,148223,12.2,0.05
1733,2021-03-02,FVG,4220,1519,2701,2702,1499,19,ITH,ITH4,6,Friuli-Venezia Giulia,Friuli Venezia Giulia,1215220,152443,12.54,0.35
1734,2021-03-04,FVG,3452,1598,1854,2770,660,22,ITH,ITH4,6,Friuli-Venezia Giulia,Friuli Venezia Giulia,1215220,155895,12.83,0.28
1735,2021-06-12,FVG,8078,4633,3445,6918,1159,1,ITH,ITH4,6,Friuli-Venezia Giulia,Friuli Venezia Giulia,1215220,163973,13.49,0.66
1736,2021-03-21,FVG,2673,1000,1673,2228,409,36,ITH,ITH4,6,Friuli-Venezia Giulia,Friuli Venezia Giulia,1215220,166646,13.71,0.22
1737,2021-05-17,FVG,8805,4086,4719,6094,2485,226,ITH,ITH4,6,Friuli-Venezia Giulia,Friuli Venezia Giulia,1215220,175451,14.44,0.72
1738,2021-03-09,FVG,4010,1722,2288,1237,2748,25,ITH,ITH4,6,Friuli-Venezia Giulia,Friuli Venezia Giulia,1215220,179461,14.77,0.33
1739,2021-06-04,FVG,12037,6181,5856,10630,1385,22,ITH,ITH4,6,Friuli-Venezia Giulia,Friuli Venezia Giulia,1215220,191498,15.76,0.99
1740,2021-02-27,FVG,3531,1201,2330,3511,1,19,ITH,ITH4,6,Friuli-Venezia Giulia,Friuli Venezia Giulia,1215220,195029,16.05,0.29
1741,2021-04-25,FVG,2365,989,1376,2177,11,177,ITH,ITH4,6,Friuli-Venezia Giulia,Friuli Venezia Giulia,1215220,197394,16.24,0.19
1742,2021-01-15,FVG,2021,605,1416,2020,0,1,ITH,ITH4,6,Friuli-Venezia Giulia,Friuli Venezia Giulia,1215220,199415,16.41,0.17
1743,2021-01-25,FVG,1583,567,1016,194,1389,0,ITH,ITH4,6,Friuli-Venezia Giulia,Friuli Venezia Giulia,1215220,200998,16.54,0.13
1744,2021-07-01,FVG,12171,6334,5837,2518,9386,267,ITH,ITH4,6,Friuli-Venezia Giulia,Friuli Venezia Giulia,1215220,213169,17.54,1.0
1745,2021-03-23,FVG,3888,1681,2207,1733,2141,14,ITH,ITH4,6,Friuli-Venezia Giulia,Friuli Venezia Giulia,1215220,217057,17.86,0.32
1746,2021-01-16,FVG,1230,360,870,1230,0,0,ITH,ITH4,6,Friuli-Venezia Giulia,Friuli Venezia Giulia,1215220,218287,17.96,0.1
1747,2021-07-03,FVG,11332,6046,5286,1069,10110,153,ITH,ITH4,6,Friuli-Venezia Giulia,Friuli Venezia Giulia,1215220,229619,18.9,0.93
1748,2021-03-25,FVG,5528,2420,3108,3337,2136,55,ITH,ITH4,6,Friuli-Venezia Giulia,Friuli Venezia Giulia,1215220,235147,19.35,0.45
1749,2021-03-30,FVG,7225,3254,3971,6190,923,112,ITH,ITH4,6,Friuli-Venezia Giulia,Friuli Venezia Giulia,1215220,242372,19.94,0.59
1750,2021-03-14,FVG,1398,550,848,1124,252,22,ITH,ITH4,6,Friuli-Venezia Giulia,Friuli Venezia Giulia,1215220,243770,20.06,0.12
1751,2021-04-08,FVG,7445,3217,4228,5403,1922,120,ITH,ITH4,6,Friuli-Venezia Giulia,Friuli Venezia Giulia,1215220,251215,20.67,0.61
1752,2021-05-21,FVG,11203,5013,6190,7917,2968,318,ITH,ITH4,6,Friuli-Venezia Giulia,Friuli Venezia Giulia,1215220,262418,21.59,0.92
1753,2021-02-10,FVG,1350,496,854,1264,86,0,ITH,ITH4,6,Friuli-Venezia Giulia,Friuli Venezia Giulia,1215220,263768,21.71,0.11
1754,2021-02-01,FVG,2097,688,1409,16,2081,0,ITH,ITH4,6,Friuli-Venezia Giulia,Friuli Venezia Giulia,1215220,265865,21.88,0.17
1755,2021-06-19,FVG,8491,4427,4064,1364,7127,0,ITH,ITH4,6,Friuli-Venezia Giulia,Friuli Venezia Giulia,1215220,274356,22.58,0.7
1756,2021-03-11,FVG,3476,1517,1959,1713,1751,12,ITH,ITH4,6,Friuli-Venezia Giulia,Friuli Venezia Giulia,1215220,277832,22.86,0.29
1757,2021-02-11,FVG,1930,664,1266,1735,192,3,ITH,ITH4,6,Friuli-Venezia Giulia,Friuli Venezia Giulia,1215220,279762,23.02,0.16
1758,2021-04-09,FVG,7914,3658,4256,6506,1248,160,ITH,ITH4,6,Friuli-Venezia Giulia,Friuli Venezia Giulia,1215220,287676,23.67,0.65
1759,2020-12-30,FVG,626,244,382,626,0,0,ITH,ITH4,6,Friuli-Venezia Giulia,Friuli Venezia Giulia,1215220,288302,23.72,0.05
1760,2021-06-05,FVG,10289,5317,4972,8741,1548,0,ITH,ITH4,6,Friuli-Venezia Giulia,Friuli Venezia Giulia,1215220,298591,24.57,0.85
1761,2021-02-25,FVG,3165,1652,1513,3112,29,24,ITH,ITH4,6,Friuli-Venezia Giulia,Friuli Venezia Giulia,1215220,301756,24.83,0.26
1762,2021-01-11,FVG,1882,608,1274,1882,0,0,ITH,ITH4,6,Friuli-Venezia Giulia,Friuli Venezia Giulia,1215220,303638,24.99,0.15
1763,2021-04-23,FVG,7467,3376,4091,3463,3866,138,ITH,ITH4,6,Friuli-Venezia Giulia,Friuli Venezia Giulia,1215220,311105,25.6,0.61
1764,2021-01-27,FVG,1271,425,846,448,821,2,ITH,ITH4,6,Friuli-Venezia Giulia,Friuli Venezia Giulia,1215220,312376,25.71,0.1
1765,2021-05-07,FVG,10609,4851,5758,6934,3510,165,ITH,ITH4,6,Friuli-Venezia Giulia,Friuli Venezia Giulia,1215220,322985,26.58,0.87
1766,2021-05-09,FVG,7356,3302,4054,3370,3858,128,ITH,ITH4,6,Friuli-Venezia Giulia,Friuli Venezia Giulia,1215220,330341,27.18,0.61
1767,2021-07-05,FVG,9168,4663,4505,1274,7749,145,ITH,ITH4,6,Friuli-Venezia Giulia,Friuli Venezia Giulia,1215220,339509,27.94,0.75
1768,2021-06-21,FVG,9127,4451,4676,1899,7225,3,ITH,ITH4,6,Friuli-Venezia Giulia,Friuli Venezia Giulia,1215220,348636,28.69,0.75
1769,2021-03-13,FVG,2942,1124,1818,1658,1272,12,ITH,ITH4,6,Friuli-Venezia Giulia,Friuli Venezia Giulia,1215220,351578,28.93,0.24
1770,2021-05-02,FVG,6898,3248,3650,3805,2959,134,ITH,ITH4,6,Friuli-Venezia Giulia,Friuli Venezia Giulia,1215220,358476,29.5,0.57
1771,2021-05-16,FVG,9987,4779,5208,8362,1399,226,ITH,ITH4,6,Friuli-Venezia Giulia,Friuli Venezia Giulia,1215220,368463,30.32,0.82
1772,2021-04-01,FVG,6391,3052,3339,5307,1015,69,ITH,ITH4,6,Friuli-Venezia Giulia,Friuli Venezia Giulia,1215220,374854,30.85,0.53
1773,2021-05-28,FVG,10538,5049,5489,6179,4111,248,ITH,ITH4,6,Friuli-Venezia Giulia,Friuli Venezia Giulia,1215220,385392,31.71,0.87
1774,2021-02-19,FVG,3253,1291,1962,2814,427,12,ITH,ITH4,6,Friuli-Venezia Giulia,Friuli Venezia Giulia,1215220,388645,31.98,0.27
1775,2021-04-24,FVG,6681,2950,3731,5207,1243,231,ITH,ITH4,6,Friuli-Venezia Giulia,Friuli Venezia Giulia,1215220,395326,32.53,0.55
1776,2021-06-06,FVG,9456,4615,4841,7906,1548,2,ITH,ITH4,6,Friuli-Venezia Giulia,Friuli Venezia Giulia,1215220,404782,33.31,0.78
1777,2021-02-26,FVG,3735,2093,1642,3560,148,27,ITH,ITH4,6,Friuli-Venezia Giulia,Friuli Venezia Giulia,1215220,408517,33.62,0.31
1778,2021-02-17,FVG,2355,1000,1355,1873,480,2,ITH,ITH4,6,Friuli-Venezia Giulia,Friuli Venezia Giulia,1215220,410872,33.81,0.19
1779,2021-05-14,FVG,10754,5355,5399,7885,2593,276,ITH,ITH4,6,Friuli-Venezia Giulia,Friuli Venezia Giulia,1215220,421626,34.7,0.88
1780,2021-02-03,FVG,2647,791,1856,22,2624,1,ITH,ITH4,6,Friuli-Venezia Giulia,Friuli Venezia Giulia,1215220,424273,34.91,0.22
1781,2021-02-08,FVG,2356,694,1662,90,2265,1,ITH,ITH4,6,Friuli-Venezia Giulia,Friuli Venezia Giulia,1215220,426629,35.11,0.19
1782,2021-04-13,FVG,7375,3291,4084,5646,1603,126,ITH,ITH4,6,Friuli-Venezia Giulia,Friuli Venezia Giulia,1215220,434004,35.71,0.61
1783,2021-01-03,FVG,312,122,190,312,0,0,ITH,ITH4,6,Friuli-Venezia Giulia,Friuli Venezia Giulia,1215220,434316,35.74,0.03
1784,2021-01-20,FVG,748,320,428,13,735,0,ITH,ITH4,6,Friuli-Venezia Giulia,Friuli Venezia Giulia,1215220,435064,35.8,0.06
1785,2021-02-22,FVG,2485,1193,1292,2064,418,3,ITH,ITH4,6,Friuli-Venezia Giulia,Friuli Venezia Giulia,1215220,437549,36.01,0.2
1786,2021-06-02,FVG,9405,4950,4455,9115,280,10,ITH,ITH4,6,Friuli-Venezia Giulia,Friuli Venezia Giulia,1215220,446954,36.78,0.77
1787,2021-02-07,FVG,1564,482,1082,384,1179,1,ITH,ITH4,6,Friuli-Venezia Giulia,Friuli Venezia Giulia,1215220,448518,36.91,0.13
1788,2021-05-18,FVG,10786,5395,5391,8379,2077,330,ITH,ITH4,6,Friuli-Venezia Giulia,Friuli Venezia Giulia,1215220,459304,37.8,0.89
1789,2021-06-01,FVG,10096,5109,4987,7948,2121,27,ITH,ITH4,6,Friuli-Venezia Giulia,Friuli Venezia Giulia,1215220,469400,38.63,0.83
1790,2021-06-20,FVG,6502,3221,3281,1567,4931,4,ITH,ITH4,6,Friuli-Venezia Giulia,Friuli Venezia Giulia,1215220,475902,39.16,0.54
1791,2021-03-29,FVG,7021,3125,3896,5379,1582,60,ITH,ITH4,6,Friuli-Venezia Giulia,Friuli Venezia Giulia,1215220,482923,39.74,0.58
1792,2021-07-07,FVG,10971,5626,5345,1371,9470,130,ITH,ITH4,6,Friuli-Venezia Giulia,Friuli Venezia Giulia,1215220,493894,40.64,0.9
1793,2021-04-18,FVG,6038,2800,3238,5448,407,183,ITH,ITH4,6,Friuli-Venezia Giulia,Friuli Venezia Giulia,1215220,499932,41.14,0.5
1794,2021-01-08,FVG,2321,746,1575,2321,0,0,ITH,ITH4,6,Friuli-Venezia Giulia,Friuli Venezia Giulia,1215220,502253,41.33,0.19
1795,2021-06-14,FVG,10033,4842,5191,5224,4804,5,ITH,ITH4,6,Friuli-Venezia Giulia,Friuli Venezia Giulia,1215220,512286,42.16,0.83
1796,2021-02-20,FVG,2068,933,1135,1921,144,3,ITH,ITH4,6,Friuli-Venezia Giulia,Friuli Venezia Giulia,1215220,514354,42.33,0.17
1797,2021-01-22,FVG,89,29,60,0,89,0,ITH,ITH4,6,Friuli-Venezia Giulia,Friuli Venezia Giulia,1215220,514443,42.33,0.01
1798,2021-03-06,FVG,3500,1196,2304,3147,325,28,ITH,ITH4,6,Friuli-Venezia Giulia,Friuli Venezia Giulia,1215220,517943,42.62,0.29
1799,2021-05-26,FVG,13419,6701,6718,9663,3436,320,ITH,ITH4,6,Friuli-Venezia Giulia,Friuli Venezia Giulia,1215220,531362,43.73,1.1
1800,2021-02-15,FVG,2454,911,1543,2196,254,4,ITH,ITH4,6,Friuli-Venezia Giulia,Friuli Venezia Giulia,1215220,533816,43.93,0.2
1801,2021-04-20,FVG,7115,3063,4052,3078,3906,131,ITH,ITH4,6,Friuli-Venezia Giulia,Friuli Venezia Giulia,1215220,540931,44.51,0.59
1802,2021-01-10,FVG,2940,918,2022,2940,0,0,ITH,ITH4,6,Friuli-Venezia Giulia,Friuli Venezia Giulia,1215220,543871,44.75,0.24
1803,2021-04-05,FVG,2895,1438,1457,2830,15,50,ITH,ITH4,6,Friuli-Venezia Giulia,Friuli Venezia Giulia,1215220,546766,44.99,0.24
1804,2021-01-12,FVG,2257,713,1544,2257,0,0,ITH,ITH4,6,Friuli-Venezia Giulia,Friuli Venezia Giulia,1215220,549023,45.18,0.19
1805,2021-01-29,FVG,2412,813,1599,264,2148,0,ITH,ITH4,6,Friuli-Venezia Giulia,Friuli Venezia Giulia,1215220,551435,45.38,0.2
1806,2021-04-22,FVG,6782,3085,3697,3031,3688,63,ITH,ITH4,6,Friuli-Venezia Giulia,Friuli Venezia Giulia,1215220,558217,45.94,0.56
1807,2021-06-13,FVG,8646,4501,4145,5322,3321,3,ITH,ITH4,6,Friuli-Venezia Giulia,Friuli Venezia Giulia,1215220,566863,46.65,0.71
1808,2021-04-17,FVG,7453,3235,4218,5808,1483,162,ITH,ITH4,6,Friuli-Venezia Giulia,Friuli Venezia Giulia,1215220,574316,47.26,0.61
1809,2021-04-10,FVG,5049,2213,2836,3758,1225,66,ITH,ITH4,6,Friuli-Venezia Giulia,Friuli Venezia Giulia,1215220,579365,47.68,0.42
1810,2021-05-23,FVG,10276,4855,5421,5928,4150,198,ITH,ITH4,6,Friuli-Venezia Giulia,Friuli Venezia Giulia,1215220,589641,48.52,0.85
1811,2021-01-07,FVG,2093,718,1375,2093,0,0,ITH,ITH4,6,Friuli-Venezia Giulia,Friuli Venezia Giulia,1215220,591734,48.69,0.17
1812,2021-03-05,FVG,3772,1511,2261,2633,1074,65,ITH,ITH4,6,Friuli-Venezia Giulia,Friuli Venezia Giulia,1215220,595506,49.0,0.31
1813,2021-04-19,FVG,6711,3133,3578,3203,3416,92,ITH,ITH4,6,Friuli-Venezia Giulia,Friuli Venezia Giulia,1215220,602217,49.56,0.55
1814,2021-01-09,FVG,2513,841,1672,2511,0,2,ITH,ITH4,6,Friuli-Venezia Giulia,Friuli Venezia Giulia,1215220,604730,49.76,0.21
1815,2021-06-15,FVG,11755,5943,5812,5302,6451,2,ITH,ITH4,6,Friuli-Venezia Giulia,Friuli Venezia Giulia,1215220,616485,50.73,0.97
1816,2021-03-07,FVG,2545,932,1613,2489,1,55,ITH,ITH4,6,Friuli-Venezia Giulia,Friuli Venezia Giulia,1215220,619030,50.94,0.21
1817,2020-12-31,FVG,1048,381,667,1047,0,1,ITH,ITH4,6,Friuli-Venezia Giulia,Friuli Venezia Giulia,1215220,620078,51.03,0.09
1818,2021-06-17,FVG,11316,5714,5602,2306,9008,2,ITH,ITH4,6,Friuli-Venezia Giulia,Friuli Venezia Giulia,1215220,631394,51.96,0.93
1819,2021-06-22,FVG,11471,5914,5557,2391,9072,8,ITH,ITH4,6,Friuli-Venezia Giulia,Friuli Venezia Giulia,1215220,642865,52.9,0.94
1820,2021-06-18,FVG,10650,5206,5444,3383,7262,5,ITH,ITH4,6,Friuli-Venezia Giulia,Friuli Venezia Giulia,1215220,653515,53.78,0.88
1821,2021-03-10,FVG,3587,1698,1889,1740,1794,53,ITH,ITH4,6,Friuli-Venezia Giulia,Friuli Venezia Giulia,1215220,657102,54.07,0.3
1822,2021-02-24,FVG,2524,1088,1436,2496,18,10,ITH,ITH4,6,Friuli-Venezia Giulia,Friuli Venezia Giulia,1215220,659626,54.28,0.21
1823,2021-03-27,FVG,5376,2917,2459,3938,1411,27,ITH,ITH4,6,Friuli-Venezia Giulia,Friuli Venezia Giulia,1215220,665002,54.72,0.44
1824,2021-05-15,FVG,12657,6105,6552,7682,4699,276,ITH,ITH4,6,Friuli-Venezia Giulia,Friuli Venezia Giulia,1215220,677659,55.76,1.04
1825,2021-05-01,FVG,7196,3246,3950,5898,1045,253,ITH,ITH4,6,Friuli-Venezia Giulia,Friuli Venezia Giulia,1215220,684855,56.36,0.59
1826,2021-01-21,FVG,896,345,551,1,895,0,ITH,ITH4,6,Friuli-Venezia Giulia,Friuli Venezia Giulia,1215220,685751,56.43,0.07
1827,2021-02-21,FVG,801,281,520,421,378,2,ITH,ITH4,6,Friuli-Venezia Giulia,Friuli Venezia Giulia,1215220,686552,56.5,0.07
1828,2021-05-30,FVG,11062,4989,6073,7245,3587,230,ITH,ITH4,6,Friuli-Venezia Giulia,Friuli Venezia Giulia,1215220,697614,57.41,0.91
1829,2021-05-03,FVG,7215,3290,3925,3315,3785,115,ITH,ITH4,6,Friuli-Venezia Giulia,Friuli Venezia Giulia,1215220,704829,58.0,0.59
1830,2021-01-14,FVG,2584,789,1795,2581,0,3,ITH,ITH4,6,Friuli-Venezia Giulia,Friuli Venezia Giulia,1215220,707413,58.21,0.21
1831,2021-06-08,FVG,10307,5393,4914,9850,428,29,ITH,ITH4,6,Friuli-Venezia Giulia,Friuli Venezia Giulia,1215220,717720,59.06,0.85
1832,2021-02-28,FVG,2686,1003,1683,2265,394,27,ITH,ITH4,6,Friuli-Venezia Giulia,Friuli Venezia Giulia,1215220,720406,59.28,0.22
1833,2021-04-26,FVG,5461,2450,3011,3691,1649,121,ITH,ITH4,6,Friuli-Venezia Giulia,Friuli Venezia Giulia,1215220,725867,59.73,0.45
1834,2021-05-06,FVG,11892,5526,6366,7664,3967,261,ITH,ITH4,6,Friuli-Venezia Giulia,Friuli Venezia Giulia,1215220,737759,60.71,0.98
1835,2021-07-02,FVG,10813,5597,5216,1932,8678,203,ITH,ITH4,6,Friuli-Venezia Giulia,Friuli Venezia Giulia,1215220,748572,61.6,0.89
1836,2021-06-25,FVG,10710,5389,5321,2193,8511,6,ITH,ITH4,6,Friuli-Venezia Giulia,Friuli Venezia Giulia,1215220,759282,62.48,0.88
1837,2021-04-03,FVG,4012,1990,2022,2638,1331,43,ITH,ITH4,6,Friuli-Venezia Giulia,Friuli Venezia Giulia,1215220,763294,62.81,0.33
1838,2021-06-10,FVG,10716,5611,5105,9667,1036,13,ITH,ITH4,6,Friuli-Venezia Giulia,Friuli Venezia Giulia,1215220,774010,63.69,0.88
1839,2021-03-19,FVG,3251,1350,1901,1301,1936,14,ITH,ITH4,6,Friuli-Venezia Giulia,Friuli Venezia Giulia,1215220,777261,63.96,0.27
1840,2021-06-27,FVG,7330,3659,3671,3520,3808,2,ITH,ITH4,6,Friuli-Venezia Giulia,Friuli Venezia Giulia,1215220,784591,64.56,0.6
1841,2021-06-29,FVG,11225,5726,5499,1153,9954,118,ITH,ITH4,6,Friuli-Venezia Giulia,Friuli Venezia Giulia,1215220,795816,65.49,0.92
1842,2021-04-07,FVG,7826,3623,4203,6940,782,104,ITH,ITH4,6,Friuli-Venezia Giulia,Friuli Venezia Giulia,1215220,803642,66.13,0.64
1843,2021-03-17,FVG,3236,1267,1969,739,2491,6,ITH,ITH4,6,Friuli-Venezia Giulia,Friuli Venezia Giulia,1215220,806878,66.4,0.27
1844,2021-05-13,FVG,11149,5375,5774,8727,2059,363,ITH,ITH4,6,Friuli-Venezia Giulia,Friuli Venezia Giulia,1215220,818027,67.32,0.92
1845,2021-02-16,FVG,2516,1135,1381,2397,116,3,ITH,ITH4,6,Friuli-Venezia Giulia,Friuli Venezia Giulia,1215220,820543,67.52,0.21
1846,2021-03-24,FVG,3974,1717,2257,2464,1481,29,ITH,ITH4,6,Friuli-Venezia Giulia,Friuli Venezia Giulia,1215220,824517,67.85,0.33
1847,2021-05-20,FVG,12697,6309,6388,9809,2514,374,ITH,ITH4,6,Friuli-Venezia Giulia,Friuli Venezia Giulia,1215220,837214,68.89,1.04
1848,2021-01-26,FVG,1977,647,1330,216,1760,1,ITH,ITH4,6,Friuli-Venezia Giulia,Friuli Venezia Giulia,1215220,839191,69.06,0.16
1849,2021-02-09,FVG,1842,555,1287,1556,286,0,ITH,ITH4,6,Friuli-Venezia Giulia,Friuli Venezia Giulia,1215220,841033,69.21,0.15
1850,2021-02-02,FVG,2467,806,1661,217,2250,0,ITH,ITH4,6,Friuli-Venezia Giulia,Friuli Venezia Giulia,1215220,843500,69.41,0.2
1851,2021-03-31,FVG,8115,3560,4555,7155,846,114,ITH,ITH4,6,Friuli-Venezia Giulia,Friuli Venezia Giulia,1215220,851615,70.08,0.67
1852,2021-04-15,FVG,6506,2873,3633,5090,1270,146,ITH,ITH4,6,Friuli-Venezia Giulia,Friuli Venezia Giulia,1215220,858121,70.61,0.54
1853,2021-04-29,FVG,6758,2978,3780,3970,2592,196,ITH,ITH4,6,Friuli-Venezia Giulia,Friuli Venezia Giulia,1215220,864879,71.17,0.56
1854,2021-01-05,FVG,1678,551,1127,1677,0,1,ITH,ITH4,6,Friuli-Venezia Giulia,Friuli Venezia Giulia,1215220,866557,71.31,0.14
1855,2021-02-05,FVG,2610,784,1826,89,2521,0,ITH,ITH4,6,Friuli-Venezia Giulia,Friuli Venezia Giulia,1215220,869167,71.52,0.21
1856,2021-04-14,FVG,7227,3122,4105,5397,1712,118,ITH,ITH4,6,Friuli-Venezia Giulia,Friuli Venezia Giulia,1215220,876394,72.12,0.59
1857,2021-07-06,FVG,10186,5344,4842,815,9280,91,ITH,ITH4,6,Friuli-Venezia Giulia,Friuli Venezia Giulia,1215220,886580,72.96,0.84
1858,2021-06-09,FVG,11166,5876,5290,9758,1390,18,ITH,ITH4,6,Friuli-Venezia Giulia,Friuli Venezia Giulia,1215220,897746,73.88,0.92
1859,2021-03-01,FVG,2958,1041,1917,2887,52,19,ITH,ITH4,6,Friuli-Venezia Giulia,Friuli Venezia Giulia,1215220,900704,74.12,0.24
1860,2021-03-18,FVG,3372,1421,1951,1683,1681,8,ITH,ITH4,6,Friuli-Venezia Giulia,Friuli Venezia Giulia,1215220,904076,74.4,0.28
1861,2021-06-28,FVG,9802,4938,4864,2123,7668,11,ITH,ITH4,6,Friuli-Venezia Giulia,Friuli Venezia Giulia,1215220,913878,75.2,0.81
1862,2021-03-20,FVG,3401,1409,1992,1300,2091,10,ITH,ITH4,6,Friuli-Venezia Giulia,Friuli Venezia Giulia,1215220,917279,75.48,0.28
1863,2021-01-13,FVG,2650,834,1816,2650,0,0,ITH,ITH4,6,Friuli-Venezia Giulia,Friuli Venezia Giulia,1215220,919929,75.7,0.22
1864,2021-04-06,FVG,6669,3126,3543,5424,1150,95,ITH,ITH4,6,Friuli-Venezia Giulia,Friuli Venezia Giulia,1215220,926598,76.25,0.55
1865,2020-12-27,FVG,262,149,113,261,0,1,ITH,ITH4,6,Friuli-Venezia Giulia,Friuli Venezia Giulia,1215220,926860,76.27,0.02
1866,2021-07-04,FVG,8557,4386,4171,2731,5562,264,ITH,ITH4,6,Friuli-Venezia Giulia,Friuli Venezia Giulia,1215220,935417,76.98,0.7
1867,2021-03-26,FVG,6002,2604,3398,3828,2016,158,ITH,ITH4,6,Friuli-Venezia Giulia,Friuli Venezia Giulia,1215220,941419,77.47,0.49
1868,2021-03-12,FVG,4102,1696,2406,2698,1381,23,ITH,ITH4,6,Friuli-Venezia Giulia,Friuli Venezia Giulia,1215220,945521,77.81,0.34
1869,2021-01-02,FVG,1216,470,746,1216,0,0,ITH,ITH4,6,Friuli-Venezia Giulia,Friuli Venezia Giulia,1215220,946737,77.91,0.1
1870,2021-04-12,FVG,7268,3186,4082,5997,1132,139,ITH,ITH4,6,Friuli-Venezia Giulia,Friuli Venezia Giulia,1215220,954005,78.5,0.6
1871,2021-06-03,FVG,12355,6702,5653,10250,2074,31,ITH,ITH4,6,Friuli-Venezia Giulia,Friuli Venezia Giulia,1215220,966360,79.52,1.02
1872,2021-01-19,FVG,6,2,4,6,0,0,ITH,ITH4,6,Friuli-Venezia Giulia,Friuli Venezia Giulia,1215220,966366,79.52,0.0
1873,2021-02-12,FVG,1193,428,765,1142,47,4,ITH,ITH4,6,Friuli-Venezia Giulia,Friuli Venezia Giulia,1215220,967559,79.62,0.1
1874,2021-05-25,FVG,12900,6377,6523,9274,3312,314,ITH,ITH4,6,Friuli-Venezia Giulia,Friuli Venezia Giulia,1215220,980459,80.68,1.06
1875,2021-06-11,FVG,10607,5777,4830,9765,829,13,ITH,ITH4,6,Friuli-Venezia Giulia,Friuli Venezia Giulia,1215220,991066,81.55,0.87
1876,2021-03-03,FVG,3646,1634,2012,2357,1275,14,ITH,ITH4,6,Friuli-Venezia Giulia,Friuli Venezia Giulia,1215220,994712,81.85,0.3
1877,2021-05-27,FVG,12819,6136,6683,7403,5228,188,ITH,ITH4,6,Friuli-Venezia Giulia,Friuli Venezia Giulia,1215220,1007531,82.91,1.05
1878,2021-01-28,FVG,2240,794,1446,355,1885,0,ITH,ITH4,6,Friuli-Venezia Giulia,Friuli Venezia Giulia,1215220,1009771,83.09,0.18
1879,2021-05-08,FVG,10269,4643,5626,5307,4782,180,ITH,ITH4,6,Friuli-Venezia Giulia,Friuli Venezia Giulia,1215220,1020040,83.94,0.85
1880,2021-02-14,FVG,1,0,1,0,1,0,ITH,ITH4,6,Friuli-Venezia Giulia,Friuli Venezia Giulia,1215220,1020041,83.94,0.0
1881,2021-05-10,FVG,7940,3529,4411,6230,1542,168,ITH,ITH4,6,Friuli-Venezia Giulia,Friuli Venezia Giulia,1215220,1027981,84.59,0.65
1882,2021-06-16,FVG,12070,5861,6209,4063,8004,3,ITH,ITH4,6,Friuli-Venezia Giulia,Friuli Venezia Giulia,1215220,1040051,85.59,0.99
1883,2021-06-23,FVG,11992,5800,6192,2093,9895,4,ITH,ITH4,6,Friuli-Venezia Giulia,Friuli Venezia Giulia,1215220,1052043,86.57,0.99
1884,2021-04-27,FVG,8102,3718,4384,3529,4475,98,ITH,ITH4,6,Friuli-Venezia Giulia,Friuli Venezia Giulia,1215220,1060145,87.24,0.67
1885,2021-05-04,FVG,9541,4301,5240,5981,3360,200,ITH,ITH4,6,Friuli-Venezia Giulia,Friuli Venezia Giulia,1215220,1069686,88.02,0.79
1886,2021-01-24,FVG,305,119,186,1,304,0,ITH,ITH4,6,Friuli-Venezia Giulia,Friuli Venezia Giulia,1215220,1069991,88.05,0.03
1887,2021-06-30,FVG,13081,6660,6421,1359,11539,183,ITH,ITH4,6,Friuli-Venezia Giulia,Friuli Venezia Giulia,1215220,1083072,89.13,1.08
1888,2021-03-08,FVG,4120,1642,2478,2020,2086,14,ITH,ITH4,6,Friuli-Venezia Giulia,Friuli Venezia Giulia,1215220,1087192,89.46,0.34
1889,2021-03-22,FVG,3659,1446,2213,1673,1954,32,ITH,ITH4,6,Friuli-Venezia Giulia,Friuli Venezia Giulia,1215220,1090851,89.77,0.3
1890,2021-01-17,FVG,1715,522,1193,1713,0,2,ITH,ITH4,6,Friuli-Venezia Giulia,Friuli Venezia Giulia,1215220,1092566,89.91,0.14
1891,2021-03-15,FVG,3951,1809,2142,1612,2321,18,ITH,ITH4,6,Friuli-Venezia Giulia,Friuli Venezia Giulia,1215220,1096517,90.23,0.33
1892,2021-05-11,FVG,9033,4333,4700,7015,1802,216,ITH,ITH4,6,Friuli-Venezia Giulia,Friuli Venezia Giulia,1215220,1105550,90.98,0.74
1893,2021-01-31,FVG,2717,838,1879,385,2332,0,ITH,ITH4,6,Friuli-Venezia Giulia,Friuli Venezia Giulia,1215220,1108267,91.2,0.22
1894,2021-05-29,FVG,12018,5846,6172,6791,4987,240,ITH,ITH4,6,Friuli-Venezia Giulia,Friuli Venezia Giulia,1215220,1120285,92.19,0.99
1895,2021-05-22,FVG,11577,5199,6378,7093,4239,245,ITH,ITH4,6,Friuli-Venezia Giulia,Friuli Venezia Giulia,1215220,1131862,93.14,0.95
1896,2021-04-05,PUG,12749,6192,6557,12075,533,141,ITF,ITF4,16,Puglia,Puglia,4029053,12749,0.32,0.32
1897,2021-03-19,PUG,7964,3654,4310,3377,4550,37,ITF,ITF4,16,Puglia,Puglia,4029053,20713,0.51,0.2
1898,2021-06-27,PUG,18439,9162,9277,9910,8249,280,ITF,ITF4,16,Puglia,Puglia,4029053,39152,0.97,0.46
1899,2021-02-14,PUG,786,347,439,658,124,4,ITF,ITF4,16,Puglia,Puglia,4029053,39938,0.99,0.02
1900,2021-01-31,PUG,1816,832,984,75,1741,0,ITF,ITF4,16,Puglia,Puglia,4029053,41754,1.04,0.05
1901,2021-04-19,PUG,27692,12873,14819,24298,3044,350,ITF,ITF4,16,Puglia,Puglia,4029053,69446,1.72,0.69
1902,2021-04-24,PUG,29365,13370,15995,25080,3945,340,ITF,ITF4,16,Puglia,Puglia,4029053,98811,2.45,0.73
1903,2021-01-14,PUG,4072,1591,2481,4066,0,6,ITF,ITF4,16,Puglia,Puglia,4029053,102883,2.55,0.1
1904,2021-01-07,PUG,5717,2459,3258,5717,0,0,ITF,ITF4,16,Puglia,Puglia,4029053,108600,2.7,0.14
1905,2021-04-17,PUG,39978,18949,21029,35983,3569,426,ITF,ITF4,16,Puglia,Puglia,4029053,148578,3.69,0.99
1906,2021-03-05,PUG,17686,7168,10518,15169,2305,212,ITF,ITF4,16,Puglia,Puglia,4029053,166264,4.13,0.44
1907,2021-02-26,PUG,13766,5055,8711,12535,1035,196,ITF,ITF4,16,Puglia,Puglia,4029053,180030,4.47,0.34
1908,2020-12-31,PUG,1634,782,852,1634,0,0,ITF,ITF4,16,Puglia,Puglia,4029053,181664,4.51,0.04
1909,2021-06-15,PUG,42347,20715,21632,22129,19571,647,ITF,ITF4,16,Puglia,Puglia,4029053,224011,5.56,1.05
1910,2021-06-08,PUG,39170,19073,20097,20831,17755,584,ITF,ITF4,16,Puglia,Puglia,4029053,263181,6.53,0.97
1911,2021-01-12,PUG,4213,1770,2443,4211,0,2,ITF,ITF4,16,Puglia,Puglia,4029053,267394,6.64,0.1
1912,2021-04-07,PUG,15703,7127,8576,8823,6678,202,ITF,ITF4,16,Puglia,Puglia,4029053,283097,7.03,0.39
1913,2021-02-09,PUG,3839,1569,2270,2149,1672,18,ITF,ITF4,16,Puglia,Puglia,4029053,286936,7.12,0.1
1914,2021-05-20,PUG,33577,15236,18341,20719,12344,514,ITF,ITF4,16,Puglia,Puglia,4029053,320513,7.96,0.83
1915,2021-03-24,PUG,13570,6508,7062,6148,7307,115,ITF,ITF4,16,Puglia,Puglia,4029053,334083,8.29,0.34
1916,2021-01-26,PUG,5364,2398,2966,570,4793,1,ITF,ITF4,16,Puglia,Puglia,4029053,339447,8.42,0.13
1917,2021-07-02,PUG,45887,21788,24099,16774,28180,933,ITF,ITF4,16,Puglia,Puglia,4029053,385334,9.56,1.14
1918,2021-05-06,PUG,39564,17300,22264,19322,19683,559,ITF,ITF4,16,Puglia,Puglia,4029053,424898,10.55,0.98
1919,2021-02-07,PUG,1580,670,910,254,1326,0,ITF,ITF4,16,Puglia,Puglia,4029053,426478,10.59,0.04
1920,2021-01-21,PUG,2132,904,1228,1269,861,2,ITF,ITF4,16,Puglia,Puglia,4029053,428610,10.64,0.05
1921,2021-05-01,PUG,27612,12646,14966,16691,10650,271,ITF,ITF4,16,Puglia,Puglia,4029053,456222,11.32,0.69
1922,2021-01-02,PUG,2951,1302,1649,2951,0,0,ITF,ITF4,16,Puglia,Puglia,4029053,459173,11.4,0.07
1923,2021-04-12,PUG,29267,13788,15479,26076,2877,314,ITF,ITF4,16,Puglia,Puglia,4029053,488440,12.12,0.73
1924,2021-07-04,PUG,19069,9250,9819,7419,11375,275,ITF,ITF4,16,Puglia,Puglia,4029053,507509,12.6,0.47
1925,2021-02-21,PUG,2177,474,1703,2046,62,69,ITF,ITF4,16,Puglia,Puglia,4029053,509686,12.65,0.05
1926,2021-06-01,PUG,34833,17428,17405,21596,12853,384,ITF,ITF4,16,Puglia,Puglia,4029053,544519,13.51,0.86
1927,2021-05-15,PUG,43544,18958,24586,22816,20007,721,ITF,ITF4,16,Puglia,Puglia,4029053,588063,14.6,1.08
1928,2021-06-03,PUG,50365,24434,25931,30351,19240,774,ITF,ITF4,16,Puglia,Puglia,4029053,638428,15.85,1.25
1929,2021-03-10,PUG,14808,6613,8195,11534,3123,151,ITF,ITF4,16,Puglia,Puglia,4029053,653236,16.21,0.37
1930,2021-03-29,PUG,13538,6599,6939,6604,6742,192,ITF,ITF4,16,Puglia,Puglia,4029053,666774,16.55,0.34
1931,2021-05-25,PUG,34663,16173,18490,20571,13505,587,ITF,ITF4,16,Puglia,Puglia,4029053,701437,17.41,0.86
1932,2021-05-08,PUG,54263,22968,31295,24021,29732,510,ITF,ITF4,16,Puglia,Puglia,4029053,755700,18.76,1.35
1933,2021-05-29,PUG,30467,14357,16110,20522,9396,549,ITF,ITF4,16,Puglia,Puglia,4029053,786167,19.51,0.76
1934,2021-04-02,PUG,12843,6000,6843,8168,4524,151,ITF,ITF4,16,Puglia,Puglia,4029053,799010,19.83,0.32
1935,2021-04-16,PUG,36011,16926,19085,32297,3282,432,ITF,ITF4,16,Puglia,Puglia,4029053,835021,20.72,0.89
1936,2021-02-19,PUG,4735,2012,2723,4289,392,54,ITF,ITF4,16,Puglia,Puglia,4029053,839756,20.84,0.12
1937,2021-06-22,PUG,42044,20381,21663,18787,22646,611,ITF,ITF4,16,Puglia,Puglia,4029053,881800,21.89,1.04
1938,2021-04-26,PUG,26267,12034,14233,22638,3234,395,ITF,ITF4,16,Puglia,Puglia,4029053,908067,22.54,0.65
1939,2021-03-16,PUG,9872,4688,5184,3455,6360,57,ITF,ITF4,16,Puglia,Puglia,4029053,917939,22.78,0.25
1940,2021-06-24,PUG,52229,25262,26967,23228,28170,831,ITF,ITF4,16,Puglia,Puglia,4029053,970168,24.08,1.3
1941,2021-04-28,PUG,19801,8878,10923,14760,4770,271,ITF,ITF4,16,Puglia,Puglia,4029053,989969,24.57,0.49
1942,2021-06-13,PUG,21695,10874,10821,16186,5177,332,ITF,ITF4,16,Puglia,Puglia,4029053,1011664,25.11,0.54
1943,2021-02-28,PUG,6059,1807,4252,5799,186,74,ITF,ITF4,16,Puglia,Puglia,4029053,1017723,25.26,0.15
1944,2021-05-12,PUG,36555,16309,20246,23473,12485,597,ITF,ITF4,16,Puglia,Puglia,4029053,1054278,26.17,0.91
1945,2021-01-23,PUG,3039,1294,1745,885,2153,1,ITF,ITF4,16,Puglia,Puglia,4029053,1057317,26.24,0.08
1946,2021-05-27,PUG,40679,19219,21460,22725,17278,676,ITF,ITF4,16,Puglia,Puglia,4029053,1097996,27.25,1.01
1947,2021-03-02,PUG,16388,6091,10297,14844,1302,242,ITF,ITF4,16,Puglia,Puglia,4029053,1114384,27.66,0.41
1948,2021-06-10,PUG,46899,23056,23843,29131,16992,776,ITF,ITF4,16,Puglia,Puglia,4029053,1161283,28.82,1.16
1949,2021-04-04,PUG,5969,2964,3005,5883,5,81,ITF,ITF4,16,Puglia,Puglia,4029053,1167252,28.97,0.15
1950,2021-03-21,PUG,2694,1227,1467,579,2104,11,ITF,ITF4,16,Puglia,Puglia,4029053,1169946,29.04,0.07
1951,2021-03-31,PUG,14553,6818,7735,8845,5560,148,ITF,ITF4,16,Puglia,Puglia,4029053,1184499,29.4,0.36
1952,2021-02-02,PUG,4344,1846,2498,591,3752,1,ITF,ITF4,16,Puglia,Puglia,4029053,1188843,29.51,0.11
1953,2021-05-13,PUG,38699,17256,21443,20944,17171,584,ITF,ITF4,16,Puglia,Puglia,4029053,1227542,30.47,0.96
1954,2021-03-17,PUG,10343,4699,5644,4107,6174,62,ITF,ITF4,16,Puglia,Puglia,4029053,1237885,30.72,0.26
1955,2021-01-19,PUG,1221,452,769,1210,10,1,ITF,ITF4,16,Puglia,Puglia,4029053,1239106,30.75,0.03
1956,2021-07-08,PUG,12919,5769,7150,1658,11170,91,ITF,ITF4,16,Puglia,Puglia,4029053,1252025,31.07,0.32
1957,2021-01-04,PUG,4508,2016,2492,4506,0,2,ITF,ITF4,16,Puglia,Puglia,4029053,1256533,31.19,0.11
1958,2021-03-12,PUG,14277,6435,7842,10213,3928,136,ITF,ITF4,16,Puglia,Puglia,4029053,1270810,31.54,0.35
1959,2021-06-20,PUG,21406,10769,10637,13923,7135,348,ITF,ITF4,16,Puglia,Puglia,4029053,1292216,32.07,0.53
1960,2021-02-04,PUG,5928,2365,3563,1184,4735,9,ITF,ITF4,16,Puglia,Puglia,4029053,1298144,32.22,0.15
1961,2021-05-17,PUG,32832,15211,17621,20467,11859,506,ITF,ITF4,16,Puglia,Puglia,4029053,1330976,33.03,0.81
1962,2021-06-12,PUG,34032,16982,17050,24529,8855,648,ITF,ITF4,16,Puglia,Puglia,4029053,1365008,33.88,0.84
1963,2021-01-28,PUG,5474,2277,3197,471,5003,0,ITF,ITF4,16,Puglia,Puglia,4029053,1370482,34.01,0.14
1964,2021-04-23,PUG,29492,13709,15783,23816,5254,422,ITF,ITF4,16,Puglia,Puglia,4029053,1399974,34.75,0.73
1965,2021-01-09,PUG,4887,2250,2637,4884,0,3,ITF,ITF4,16,Puglia,Puglia,4029053,1404861,34.87,0.12
1966,2021-07-01,PUG,47181,22092,25089,11262,35273,646,ITF,ITF4,16,Puglia,Puglia,4029053,1452042,36.04,1.17
1967,2021-03-14,PUG,3329,1434,1895,2475,818,36,ITF,ITF4,16,Puglia,Puglia,4029053,1455371,36.12,0.08
1968,2021-01-16,PUG,2507,1034,1473,2505,0,2,ITF,ITF4,16,Puglia,Puglia,4029053,1457878,36.18,0.06
1969,2021-05-21,PUG,39000,18513,20487,28172,10037,791,ITF,ITF4,16,Puglia,Puglia,4029053,1496878,37.15,0.97
1970,2021-05-19,PUG,26385,12757,13628,19512,6435,438,ITF,ITF4,16,Puglia,Puglia,4029053,1523263,37.81,0.65
1971,2021-03-23,PUG,11099,5629,5470,4540,6476,83,ITF,ITF4,16,Puglia,Puglia,4029053,1534362,38.08,0.28
1972,2021-05-03,PUG,33308,14885,18423,22092,10634,582,ITF,ITF4,16,Puglia,Puglia,4029053,1567670,38.91,0.83
1973,2021-03-07,PUG,4983,2000,2983,4373,571,39,ITF,ITF4,16,Puglia,Puglia,4029053,1572653,39.03,0.12
1974,2021-05-05,PUG,39145,17156,21989,24364,14184,597,ITF,ITF4,16,Puglia,Puglia,4029053,1611798,40.0,0.97
1975,2021-06-17,PUG,42341,20700,21641,21093,20641,607,ITF,ITF4,16,Puglia,Puglia,4029053,1654139,41.06,1.05
1976,2021-03-30,PUG,12364,5920,6444,6288,5922,154,ITF,ITF4,16,Puglia,Puglia,4029053,1666503,41.36,0.31
1977,2021-06-29,PUG,46074,22078,23996,15115,30241,718,ITF,ITF4,16,Puglia,Puglia,4029053,1712577,42.51,1.14
1978,2021-01-11,PUG,3753,1588,2165,3752,0,1,ITF,ITF4,16,Puglia,Puglia,4029053,1716330,42.6,0.09
1979,2021-04-21,PUG,23107,10667,12440,19063,3734,310,ITF,ITF4,16,Puglia,Puglia,4029053,1739437,43.17,0.57
1980,2021-05-24,PUG,36089,17027,19062,24484,10990,615,ITF,ITF4,16,Puglia,Puglia,4029053,1775526,44.07,0.9
1981,2021-02-16,PUG,3383,1455,1928,2707,646,30,ITF,ITF4,16,Puglia,Puglia,4029053,1778909,44.15,0.08
1982,2021-01-30,PUG,5531,2514,3017,408,5122,1,ITF,ITF4,16,Puglia,Puglia,4029053,1784440,44.29,0.14
1983,2021-05-10,PUG,37716,16663,21053,19297,17947,472,ITF,ITF4,16,Puglia,Puglia,4029053,1822156,45.23,0.94
1984,2021-02-13,PUG,3727,1456,2271,3015,696,16,ITF,ITF4,16,Puglia,Puglia,4029053,1825883,45.32,0.09
1985,2021-06-28,PUG,47915,23244,24671,21313,25734,868,ITF,ITF4,16,Puglia,Puglia,4029053,1873798,46.51,1.19
1986,2021-02-18,PUG,4380,1846,2534,3715,606,59,ITF,ITF4,16,Puglia,Puglia,4029053,1878178,46.62,0.11
1987,2021-04-09,PUG,22055,9507,12548,17046,4624,385,ITF,ITF4,16,Puglia,Puglia,4029053,1900233,47.16,0.55
1988,2021-02-11,PUG,3697,1401,2296,2393,1278,26,ITF,ITF4,16,Puglia,Puglia,4029053,1903930,47.26,0.09
1989,2021-05-22,PUG,34609,15852,18757,23674,10388,547,ITF,ITF4,16,Puglia,Puglia,4029053,1938539,48.11,0.86
1990,2021-02-25,PUG,11968,5062,6906,10661,1173,134,ITF,ITF4,16,Puglia,Puglia,4029053,1950507,48.41,0.3
1991,2021-06-05,PUG,42285,20732,21553,28834,12610,841,ITF,ITF4,16,Puglia,Puglia,4029053,1992792,49.46,1.05
1992,2021-02-23,PUG,9363,4421,4942,8784,488,91,ITF,ITF4,16,Puglia,Puglia,4029053,2002155,49.69,0.23
1993,2021-01-18,PUG,1845,771,1074,1495,349,1,ITF,ITF4,16,Puglia,Puglia,4029053,2004000,49.74,0.05
1994,2021-02-06,PUG,4550,1931,2619,1578,2957,15,ITF,ITF4,16,Puglia,Puglia,4029053,2008550,49.85,0.11
1995,2021-01-20,PUG,1548,542,1006,1537,8,3,ITF,ITF4,16,Puglia,Puglia,4029053,2010098,49.89,0.04
1996,2021-04-30,PUG,34926,15645,19281,22388,11969,569,ITF,ITF4,16,Puglia,Puglia,4029053,2045024,50.76,0.87
1997,2021-04-13,PUG,28737,13629,15108,25026,3402,309,ITF,ITF4,16,Puglia,Puglia,4029053,2073761,51.47,0.71
1998,2021-07-05,PUG,36849,17310,19539,6833,29480,536,ITF,ITF4,16,Puglia,Puglia,4029053,2110610,52.38,0.91
1999,2021-05-02,PUG,21315,9660,11655,13866,7266,183,ITF,ITF4,16,Puglia,Puglia,4029053,2131925,52.91,0.53
2000,2021-02-01,PUG,3966,1660,2306,369,3595,2,ITF,ITF4,16,Puglia,Puglia,4029053,2135891,53.01,0.1
2001,2021-05-14,PUG,44913,20525,24388,27924,16123,866,ITF,ITF4,16,Puglia,Puglia,4029053,2180804,54.13,1.11
2002,2021-01-25,PUG,3828,1680,2148,424,3403,1,ITF,ITF4,16,Puglia,Puglia,4029053,2184632,54.22,0.1
2003,2021-04-08,PUG,17482,7584,9898,11089,6177,216,ITF,ITF4,16,Puglia,Puglia,4029053,2202114,54.66,0.43
2004,2021-06-06,PUG,30617,15411,15206,25229,5030,358,ITF,ITF4,16,Puglia,Puglia,4029053,2232731,55.42,0.76
2005,2021-04-10,PUG,30884,13098,17786,26281,4224,379,ITF,ITF4,16,Puglia,Puglia,4029053,2263615,56.18,0.77
2006,2021-04-01,PUG,13928,6539,7389,7370,6347,211,ITF,ITF4,16,Puglia,Puglia,4029053,2277543,56.53,0.35
2007,2021-02-03,PUG,5038,2006,3032,727,4308,3,ITF,ITF4,16,Puglia,Puglia,4029053,2282581,56.65,0.13
2008,2021-03-18,PUG,9519,4315,5204,3294,6160,65,ITF,ITF4,16,Puglia,Puglia,4029053,2292100,56.89,0.24
2009,2021-06-26,PUG,31657,15944,15713,15587,15473,597,ITF,ITF4,16,Puglia,Puglia,4029053,2323757,57.68,0.79
2010,2021-03-04,PUG,15345,6092,9253,13703,1420,222,ITF,ITF4,16,Puglia,Puglia,4029053,2339102,58.06,0.38
2011,2021-06-09,PUG,41654,20626,21028,29707,11178,769,ITF,ITF4,16,Puglia,Puglia,4029053,2380756,59.09,1.03
2012,2021-02-15,PUG,3258,1270,1988,2592,622,44,ITF,ITF4,16,Puglia,Puglia,4029053,2384014,59.17,0.08
2013,2021-05-26,PUG,38488,18485,20003,26155,11674,659,ITF,ITF4,16,Puglia,Puglia,4029053,2422502,60.13,0.96
2014,2021-05-09,PUG,30696,12587,18109,14697,15617,382,ITF,ITF4,16,Puglia,Puglia,4029053,2453198,60.89,0.76
2015,2021-04-22,PUG,23014,10535,12479,17703,4918,393,ITF,ITF4,16,Puglia,Puglia,4029053,2476212,61.46,0.57
2016,2021-02-12,PUG,4212,1672,2540,3098,1092,22,ITF,ITF4,16,Puglia,Puglia,4029053,2480424,61.56,0.1
2017,2021-01-29,PUG,6201,2663,3538,425,5771,5,ITF,ITF4,16,Puglia,Puglia,4029053,2486625,61.72,0.15
2018,2021-03-25,PUG,11706,5994,5712,5369,6243,94,ITF,ITF4,16,Puglia,Puglia,4029053,2498331,62.01,0.29
2019,2021-07-03,PUG,31698,15795,15903,12901,18286,511,ITF,ITF4,16,Puglia,Puglia,4029053,2530029,62.79,0.79
2020,2021-02-08,PUG,3994,1610,2384,1581,2397,16,ITF,ITF4,16,Puglia,Puglia,4029053,2534023,62.89,0.1
2021,2021-02-10,PUG,3646,1436,2210,2114,1511,21,ITF,ITF4,16,Puglia,Puglia,4029053,2537669,62.98,0.09
2022,2021-05-23,PUG,17914,8370,9544,13848,3805,261,ITF,ITF4,16,Puglia,Puglia,4029053,2555583,63.43,0.44
2023,2021-02-17,PUG,4278,1747,2531,3633,605,40,ITF,ITF4,16,Puglia,Puglia,4029053,2559861,63.54,0.11
2024,2021-05-28,PUG,43862,20770,23092,27382,15674,806,ITF,ITF4,16,Puglia,Puglia,4029053,2603723,64.62,1.09
2025,2021-05-30,PUG,20961,10038,10923,15656,5036,269,ITF,ITF4,16,Puglia,Puglia,4029053,2624684,65.14,0.52
2026,2021-01-06,PUG,3952,1674,2278,3951,0,1,ITF,ITF4,16,Puglia,Puglia,4029053,2628636,65.24,0.1
2027,2021-06-16,PUG,41711,20514,21197,26581,14342,788,ITF,ITF4,16,Puglia,Puglia,4029053,2670347,66.28,1.04
2028,2021-06-18,PUG,47291,23281,24010,28491,17803,997,ITF,ITF4,16,Puglia,Puglia,4029053,2717638,67.45,1.17
2029,2021-01-03,PUG,2006,942,1064,2005,0,1,ITF,ITF4,16,Puglia,Puglia,4029053,2719644,67.5,0.05
2030,2021-03-27,PUG,12154,5710,6444,6875,5170,109,ITF,ITF4,16,Puglia,Puglia,4029053,2731798,67.8,0.3
2031,2021-01-05,PUG,5108,2251,2857,5105,0,3,ITF,ITF4,16,Puglia,Puglia,4029053,2736906,67.93,0.13
2032,2021-04-15,PUG,32617,15223,17394,28650,3572,395,ITF,ITF4,16,Puglia,Puglia,4029053,2769523,68.74,0.81
2033,2021-07-07,PUG,36279,17299,18980,5859,29943,477,ITF,ITF4,16,Puglia,Puglia,4029053,2805802,69.64,0.9
2034,2020-12-30,PUG,1,0,1,1,0,0,ITF,ITF4,16,Puglia,Puglia,4029053,2805803,69.64,0.0
2035,2021-03-22,PUG,9944,5108,4836,4238,5646,60,ITF,ITF4,16,Puglia,Puglia,4029053,2815747,69.89,0.25
2036,2021-01-24,PUG,1670,750,920,154,1516,0,ITF,ITF4,16,Puglia,Puglia,4029053,2817417,69.93,0.04
2037,2021-06-30,PUG,46719,22692,24027,18339,27505,875,ITF,ITF4,16,Puglia,Puglia,4029053,2864136,71.09,1.16
2038,2021-03-15,PUG,12337,6146,6191,5733,6504,100,ITF,ITF4,16,Puglia,Puglia,4029053,2876473,71.39,0.31
2039,2021-01-17,PUG,1308,590,718,1238,69,1,ITF,ITF4,16,Puglia,Puglia,4029053,2877781,71.43,0.03
2040,2021-06-23,PUG,29125,14223,14902,16769,11713,643,ITF,ITF4,16,Puglia,Puglia,4029053,2906906,72.15,0.72
2041,2021-04-27,PUG,26676,12068,14608,20748,5604,324,ITF,ITF4,16,Puglia,Puglia,4029053,2933582,72.81,0.66
2042,2021-05-11,PUG,32557,14362,18195,13640,18423,494,ITF,ITF4,16,Puglia,Puglia,4029053,2966139,73.62,0.81
2043,2021-05-04,PUG,35041,14818,20223,18171,16454,416,ITF,ITF4,16,Puglia,Puglia,4029053,3001180,74.49,0.87
2044,2021-03-08,PUG,14990,6438,8552,12436,2401,153,ITF,ITF4,16,Puglia,Puglia,4029053,3016170,74.86,0.37
2045,2021-01-27,PUG,4602,1941,2661,630,3971,1,ITF,ITF4,16,Puglia,Puglia,4029053,3020772,74.97,0.11
2046,2021-05-07,PUG,50014,22324,27690,26001,23459,554,ITF,ITF4,16,Puglia,Puglia,4029053,3070786,76.22,1.24
2047,2021-01-13,PUG,4542,1729,2813,4539,0,3,ITF,ITF4,16,Puglia,Puglia,4029053,3075328,76.33,0.11
2048,2021-04-06,PUG,13838,6249,7589,6915,6754,169,ITF,ITF4,16,Puglia,Puglia,4029053,3089166,76.67,0.34
2049,2021-03-26,PUG,11999,5838,6161,7228,4645,126,ITF,ITF4,16,Puglia,Puglia,4029053,3101165,76.97,0.3
2050,2021-03-09,PUG,13620,6083,7537,11428,2010,182,ITF,ITF4,16,Puglia,Puglia,4029053,3114785,77.31,0.34
2051,2021-04-14,PUG,31962,15082,16880,28344,3307,311,ITF,ITF4,16,Puglia,Puglia,4029053,3146747,78.1,0.79
2052,2021-03-28,PUG,3541,1654,1887,1180,2327,34,ITF,ITF4,16,Puglia,Puglia,4029053,3150288,78.19,0.09
2053,2021-07-06,PUG,39518,18133,21385,5791,33321,406,ITF,ITF4,16,Puglia,Puglia,4029053,3189806,79.17,0.98
2054,2021-06-19,PUG,34439,17262,17177,21910,11819,710,ITF,ITF4,16,Puglia,Puglia,4029053,3224245,80.02,0.85
2055,2021-03-20,PUG,8413,3878,4535,3776,4594,43,ITF,ITF4,16,Puglia,Puglia,4029053,3232658,80.23,0.21
2056,2021-03-03,PUG,16780,6799,9981,14713,1917,150,ITF,ITF4,16,Puglia,Puglia,4029053,3249438,80.65,0.42
2057,2021-06-11,PUG,47613,23291,24322,32686,13946,981,ITF,ITF4,16,Puglia,Puglia,4029053,3297051,81.83,1.18
2058,2021-04-03,PUG,10558,4644,5914,6803,3559,196,ITF,ITF4,16,Puglia,Puglia,4029053,3307609,82.09,0.26
2059,2021-03-01,PUG,15104,5867,9237,13580,1372,152,ITF,ITF4,16,Puglia,Puglia,4029053,3322713,82.47,0.37
2060,2021-01-10,PUG,2348,1061,1287,2347,0,1,ITF,ITF4,16,Puglia,Puglia,4029053,3325061,82.53,0.06
2061,2021-04-20,PUG,21162,9831,11331,17431,3465,266,ITF,ITF4,16,Puglia,Puglia,4029053,3346223,83.05,0.53
2062,2020-12-27,PUG,509,252,257,509,0,0,ITF,ITF4,16,Puglia,Puglia,4029053,3346732,83.06,0.01
2063,2021-06-21,PUG,41395,20182,21213,21185,19527,683,ITF,ITF4,16,Puglia,Puglia,4029053,3388127,84.09,1.03
2064,2021-03-11,PUG,14809,6571,8238,11440,3172,197,ITF,ITF4,16,Puglia,Puglia,4029053,3402936,84.46,0.37
2065,2021-06-02,PUG,26981,13196,13785,21791,4815,375,ITF,ITF4,16,Puglia,Puglia,4029053,3429917,85.13,0.67
2066,2021-03-13,PUG,10468,4134,6334,8562,1808,98,ITF,ITF4,16,Puglia,Puglia,4029053,3440385,85.39,0.26
2067,2021-02-24,PUG,10044,4705,5339,9360,594,90,ITF,ITF4,16,Puglia,Puglia,4029053,3450429,85.64,0.25
2068,2021-06-04,PUG,52476,25394,27082,33951,17656,869,ITF,ITF4,16,Puglia,Puglia,4029053,3502905,86.94,1.3
2069,2021-05-18,PUG,28870,13432,15438,15842,12778,250,ITF,ITF4,16,Puglia,Puglia,4029053,3531775,87.66,0.72
2070,2021-04-29,PUG,26162,12104,14058,19075,6662,425,ITF,ITF4,16,Puglia,Puglia,4029053,3557937,88.31,0.65
2071,2021-02-22,PUG,9630,4535,5095,9211,332,87,ITF,ITF4,16,Puglia,Puglia,4029053,3567567,88.55,0.24
2072,2021-02-05,PUG,5636,2273,3363,1328,4303,5,ITF,ITF4,16,Puglia,Puglia,4029053,3573203,88.69,0.14
2073,2021-05-16,PUG,24539,11065,13474,12484,11830,225,ITF,ITF4,16,Puglia,Puglia,4029053,3597742,89.29,0.61
2074,2021-05-31,PUG,37767,18192,19575,23061,14145,561,ITF,ITF4,16,Puglia,Puglia,4029053,3635509,90.23,0.94
2075,2021-04-25,PUG,11310,5237,6073,10021,1158,131,ITF,ITF4,16,Puglia,Puglia,4029053,3646819,90.51,0.28
2076,2021-02-27,PUG,14223,4818,9405,12816,1226,181,ITF,ITF4,16,Puglia,Puglia,4029053,3661042,90.87,0.35
2077,2021-01-01,PUG,148,61,87,148,0,0,ITF,ITF4,16,Puglia,Puglia,4029053,3661190,90.87,0.0
2078,2021-06-07,PUG,44160,21572,22588,30146,13197,817,ITF,ITF4,16,Puglia,Puglia,4029053,3705350,91.97,1.1
2079,2021-04-11,PUG,16465,7253,9212,14630,1658,177,ITF,ITF4,16,Puglia,Puglia,4029053,3721815,92.37,0.41
2080,2021-03-06,PUG,16146,6125,10021,13887,2093,166,ITF,ITF4,16,Puglia,Puglia,4029053,3737961,92.78,0.4
2081,2021-01-08,PUG,5649,2370,3279,5643,0,6,ITF,ITF4,16,Puglia,Puglia,4029053,3743610,92.92,0.14
2082,2021-06-14,PUG,41766,20435,21331,28562,12337,867,ITF,ITF4,16,Puglia,Puglia,4029053,3785376,93.95,1.04
2083,2021-04-18,PUG,22610,10818,11792,21352,1057,201,ITF,ITF4,16,Puglia,Puglia,4029053,3807986,94.51,0.56
2084,2021-02-20,PUG,2970,1079,1891,2686,257,27,ITF,ITF4,16,Puglia,Puglia,4029053,3810956,94.59,0.07
2085,2021-01-15,PUG,4552,1866,2686,4547,0,5,ITF,ITF4,16,Puglia,Puglia,4029053,3815508,94.7,0.11
2086,2021-01-22,PUG,1409,578,831,990,418,1,ITF,ITF4,16,Puglia,Puglia,4029053,3816917,94.73,0.03
2087,2021-06-25,PUG,50232,24736,25496,23579,25711,942,ITF,ITF4,16,Puglia,Puglia,4029053,3867149,95.98,1.25
2088,2021-01-11,VEN,7240,2102,5138,7239,0,1,ITH,ITH3,5,Veneto,Veneto,4905854,7240,0.15,0.15
2089,2021-04-21,VEN,32338,13183,19155,15504,16059,775,ITH,ITH3,5,Veneto,Veneto,4905854,39578,0.81,0.66
2090,2021-05-22,VEN,34762,16670,18092,12699,21394,669,ITH,ITH3,5,Veneto,Veneto,4905854,74340,1.52,0.71
2091,2021-02-11,VEN,4012,1238,2774,3344,628,40,ITH,ITH3,5,Veneto,Veneto,4905854,78352,1.6,0.08
2092,2021-01-28,VEN,9211,2663,6548,170,9039,2,ITH,ITH3,5,Veneto,Veneto,4905854,87563,1.78,0.19
2093,2021-05-05,VEN,44336,21243,23093,36123,6570,1643,ITH,ITH3,5,Veneto,Veneto,4905854,131899,2.69,0.9
2094,2021-07-01,VEN,50387,25742,24645,20540,28819,1028,ITH,ITH3,5,Veneto,Veneto,4905854,182286,3.72,1.03
2095,2021-05-12,VEN,36794,17811,18983,30068,5107,1619,ITH,ITH3,5,Veneto,Veneto,4905854,219080,4.47,0.75
2096,2021-07-08,VEN,17135,8886,8249,1033,16022,80,ITH,ITH3,5,Veneto,Veneto,4905854,236215,4.81,0.35
2097,2021-04-23,VEN,31244,13840,17404,21384,8708,1152,ITH,ITH3,5,Veneto,Veneto,4905854,267459,5.45,0.64
2098,2021-02-16,VEN,6644,2870,3774,6438,176,30,ITH,ITH3,5,Veneto,Veneto,4905854,274103,5.59,0.14
2099,2021-05-29,VEN,33000,16674,16326,24227,7655,1118,ITH,ITH3,5,Veneto,Veneto,4905854,307103,6.26,0.67
2100,2021-02-25,VEN,7898,3339,4559,7158,605,135,ITH,ITH3,5,Veneto,Veneto,4905854,315001,6.42,0.16
2101,2021-04-09,VEN,31193,13763,17430,21913,8340,940,ITH,ITH3,5,Veneto,Veneto,4905854,346194,7.06,0.64
2102,2021-06-05,VEN,46795,24097,22698,37162,8050,1583,ITH,ITH3,5,Veneto,Veneto,4905854,392989,8.01,0.95
2103,2021-04-04,VEN,7773,3529,4244,6501,1148,124,ITH,ITH3,5,Veneto,Veneto,4905854,400762,8.17,0.16
2104,2021-05-24,VEN,33022,16406,16616,7624,24995,403,ITH,ITH3,5,Veneto,Veneto,4905854,433784,8.84,0.67
2105,2021-01-23,VEN,4051,1246,2805,31,4020,0,ITH,ITH3,5,Veneto,Veneto,4905854,437835,8.92,0.08
2106,2021-06-29,VEN,45425,22666,22759,18987,25723,715,ITH,ITH3,5,Veneto,Veneto,4905854,483260,9.85,0.93
2107,2021-03-21,VEN,11981,4753,7228,8278,3463,240,ITH,ITH3,5,Veneto,Veneto,4905854,495241,10.09,0.24
2108,2021-01-16,VEN,4611,1542,3069,4611,0,0,ITH,ITH3,5,Veneto,Veneto,4905854,499852,10.19,0.09
2109,2021-03-14,VEN,15176,5942,9234,13845,894,437,ITH,ITH3,5,Veneto,Veneto,4905854,515028,10.5,0.31
2110,2021-05-17,VEN,26491,12976,13515,15883,10014,594,ITH,ITH3,5,Veneto,Veneto,4905854,541519,11.04,0.54
2111,2021-02-06,VEN,4095,1354,2741,709,3386,0,ITH,ITH3,5,Veneto,Veneto,4905854,545614,11.12,0.08
2112,2021-02-23,VEN,7383,3254,4129,7029,271,83,ITH,ITH3,5,Veneto,Veneto,4905854,552997,11.27,0.15
2113,2021-04-28,VEN,32402,15174,17228,22188,9019,1195,ITH,ITH3,5,Veneto,Veneto,4905854,585399,11.93,0.66
2114,2021-06-17,VEN,51495,25803,25692,25342,24932,1221,ITH,ITH3,5,Veneto,Veneto,4905854,636894,12.98,1.05
2115,2021-03-09,VEN,16543,7446,9097,9823,6323,397,ITH,ITH3,5,Veneto,Veneto,4905854,653437,13.32,0.34
2116,2021-05-31,VEN,31613,16226,15387,20873,9917,823,ITH,ITH3,5,Veneto,Veneto,4905854,685050,13.96,0.64
2117,2021-03-26,VEN,29581,13143,16438,23265,5461,855,ITH,ITH3,5,Veneto,Veneto,4905854,714631,14.57,0.6
2118,2021-03-28,VEN,31296,13603,17693,26875,3612,809,ITH,ITH3,5,Veneto,Veneto,4905854,745927,15.2,0.64
2119,2021-06-19,VEN,49195,25038,24157,25589,22508,1098,ITH,ITH3,5,Veneto,Veneto,4905854,795122,16.21,1.0
2120,2021-07-06,VEN,35870,18497,17373,13096,22125,649,ITH,ITH3,5,Veneto,Veneto,4905854,830992,16.94,0.73
2121,2021-03-02,VEN,11490,4625,6865,7934,3309,247,ITH,ITH3,5,Veneto,Veneto,4905854,842482,17.17,0.23
2122,2021-06-10,VEN,52099,26899,25200,41010,9275,1814,ITH,ITH3,5,Veneto,Veneto,4905854,894581,18.23,1.06
2123,2021-04-02,VEN,24078,10615,13463,17115,6328,635,ITH,ITH3,5,Veneto,Veneto,4905854,918659,18.73,0.49
2124,2021-06-09,VEN,42600,21853,20747,33538,7418,1644,ITH,ITH3,5,Veneto,Veneto,4905854,961259,19.59,0.87
2125,2021-06-24,VEN,55879,28303,27576,17500,37684,695,ITH,ITH3,5,Veneto,Veneto,4905854,1017138,20.73,1.14
2126,2021-03-16,VEN,12527,5353,7174,6640,5620,267,ITH,ITH3,5,Veneto,Veneto,4905854,1029665,20.99,0.26
2127,2021-03-23,VEN,22211,10239,11972,16863,4712,636,ITH,ITH3,5,Veneto,Veneto,4905854,1051876,21.44,0.45
2128,2021-05-19,VEN,32960,15097,17863,16115,15912,933,ITH,ITH3,5,Veneto,Veneto,4905854,1084836,22.11,0.67
2129,2021-02-18,VEN,5828,2455,3373,5724,64,40,ITH,ITH3,5,Veneto,Veneto,4905854,1090664,22.23,0.12
2130,2021-04-16,VEN,24447,10493,13954,11875,11887,685,ITH,ITH3,5,Veneto,Veneto,4905854,1115111,22.73,0.5
2131,2021-04-18,VEN,17510,7251,10259,9495,7564,451,ITH,ITH3,5,Veneto,Veneto,4905854,1132621,23.09,0.36
2132,2021-01-08,VEN,9407,2835,6572,9393,0,14,ITH,ITH3,5,Veneto,Veneto,4905854,1142028,23.28,0.19
2133,2021-06-12,VEN,48555,24437,24118,36201,10762,1592,ITH,ITH3,5,Veneto,Veneto,4905854,1190583,24.27,0.99
2134,2021-05-02,VEN,37229,17261,19968,25609,10325,1295,ITH,ITH3,5,Veneto,Veneto,4905854,1227812,25.03,0.76
2135,2021-06-14,VEN,42562,21520,21042,26218,15284,1060,ITH,ITH3,5,Veneto,Veneto,4905854,1270374,25.9,0.87
2136,2021-03-06,VEN,10667,4356,6311,7218,3262,187,ITH,ITH3,5,Veneto,Veneto,4905854,1281041,26.11,0.22
2137,2021-01-09,VEN,7928,2539,5389,7922,0,6,ITH,ITH3,5,Veneto,Veneto,4905854,1288969,26.27,0.16
2138,2021-03-18,VEN,12612,5138,7474,7034,5228,350,ITH,ITH3,5,Veneto,Veneto,4905854,1301581,26.53,0.26
2139,2021-06-26,VEN,47976,24468,23508,13549,33919,508,ITH,ITH3,5,Veneto,Veneto,4905854,1349557,27.51,0.98
2140,2021-05-10,VEN,36468,17053,19415,25655,9851,962,ITH,ITH3,5,Veneto,Veneto,4905854,1386025,28.25,0.74
2141,2021-01-30,VEN,8747,2672,6075,693,8054,0,ITH,ITH3,5,Veneto,Veneto,4905854,1394772,28.43,0.18
2142,2021-03-07,VEN,4493,1768,2725,3863,561,69,ITH,ITH3,5,Veneto,Veneto,4905854,1399265,28.52,0.09
2143,2021-05-03,VEN,40669,19794,20875,32757,6441,1471,ITH,ITH3,5,Veneto,Veneto,4905854,1439934,29.35,0.83
2144,2021-01-18,VEN,2762,776,1986,2558,199,5,ITH,ITH3,5,Veneto,Veneto,4905854,1442696,29.41,0.06
2145,2021-02-04,VEN,7386,2025,5361,550,6835,1,ITH,ITH3,5,Veneto,Veneto,4905854,1450082,29.56,0.15
2146,2021-04-30,VEN,49989,23474,26515,32922,15662,1405,ITH,ITH3,5,Veneto,Veneto,4905854,1500071,30.58,1.02
2147,2021-01-20,VEN,1038,368,670,386,652,0,ITH,ITH3,5,Veneto,Veneto,4905854,1501109,30.6,0.02
2148,2021-04-14,VEN,15909,6897,9012,8736,6627,546,ITH,ITH3,5,Veneto,Veneto,4905854,1517018,30.92,0.32
2149,2021-01-04,VEN,6736,2034,4702,6734,0,2,ITH,ITH3,5,Veneto,Veneto,4905854,1523754,31.06,0.14
2150,2021-05-14,VEN,46703,22208,24495,24264,20865,1574,ITH,ITH3,5,Veneto,Veneto,4905854,1570457,32.01,0.95
2151,2021-02-20,VEN,6424,2014,4410,6273,71,80,ITH,ITH3,5,Veneto,Veneto,4905854,1576881,32.14,0.13
2152,2021-06-02,VEN,20309,10235,10074,15349,4345,615,ITH,ITH3,5,Veneto,Veneto,4905854,1597190,32.56,0.41
2153,2021-06-28,VEN,47546,24061,23485,18353,28468,725,ITH,ITH3,5,Veneto,Veneto,4905854,1644736,33.53,0.97
2154,2021-01-25,VEN,6468,2075,4393,159,6309,0,ITH,ITH3,5,Veneto,Veneto,4905854,1651204,33.66,0.13
2155,2021-04-20,VEN,22429,9496,12933,7861,13999,569,ITH,ITH3,5,Veneto,Veneto,4905854,1673633,34.12,0.46
2156,2021-05-09,VEN,35062,16130,18932,23758,10057,1247,ITH,ITH3,5,Veneto,Veneto,4905854,1708695,34.83,0.71
2157,2021-01-13,VEN,5985,1606,4379,5982,0,3,ITH,ITH3,5,Veneto,Veneto,4905854,1714680,34.95,0.12
2158,2021-04-25,VEN,18318,8150,10168,12874,4836,608,ITH,ITH3,5,Veneto,Veneto,4905854,1732998,35.33,0.37
2159,2021-06-21,VEN,44268,22153,22115,20398,22933,937,ITH,ITH3,5,Veneto,Veneto,4905854,1777266,36.23,0.9
2160,2021-01-06,VEN,8134,2386,5748,8131,0,3,ITH,ITH3,5,Veneto,Veneto,4905854,1785400,36.39,0.17
2161,2021-06-23,VEN,48883,24225,24658,14572,33484,827,ITH,ITH3,5,Veneto,Veneto,4905854,1834283,37.39,1.0
2162,2021-03-15,VEN,16666,7327,9339,10955,5208,503,ITH,ITH3,5,Veneto,Veneto,4905854,1850949,37.73,0.34
2163,2021-05-18,VEN,26892,12508,14384,12621,13573,698,ITH,ITH3,5,Veneto,Veneto,4905854,1877841,38.28,0.55
2164,2020-12-30,VEN,699,245,454,699,0,0,ITH,ITH3,5,Veneto,Veneto,4905854,1878540,38.29,0.01
2165,2021-06-07,VEN,44650,23293,21357,36017,7022,1611,ITH,ITH3,5,Veneto,Veneto,4905854,1923190,39.2,0.91
2166,2021-02-27,VEN,8990,2692,6298,7963,847,180,ITH,ITH3,5,Veneto,Veneto,4905854,1932180,39.39,0.18
2167,2021-03-04,VEN,12980,4884,8096,9119,3472,389,ITH,ITH3,5,Veneto,Veneto,4905854,1945160,39.65,0.26
2168,2021-05-07,VEN,48540,23260,25280,38159,8667,1714,ITH,ITH3,5,Veneto,Veneto,4905854,1993700,40.64,0.99
2169,2021-01-27,VEN,7141,2064,5077,240,6900,1,ITH,ITH3,5,Veneto,Veneto,4905854,2000841,40.78,0.15
2170,2021-02-13,VEN,3266,1473,1793,3230,20,16,ITH,ITH3,5,Veneto,Veneto,4905854,2004107,40.85,0.07
2171,2021-03-03,VEN,12098,4647,7451,8387,3499,212,ITH,ITH3,5,Veneto,Veneto,4905854,2016205,41.1,0.25
2172,2021-06-11,VEN,47241,24565,22676,34582,11152,1507,ITH,ITH3,5,Veneto,Veneto,4905854,2063446,42.06,0.96
2173,2021-06-25,VEN,51529,26080,25449,14974,35902,653,ITH,ITH3,5,Veneto,Veneto,4905854,2114975,43.11,1.05
2174,2021-04-22,VEN,31999,13919,18080,15433,15747,819,ITH,ITH3,5,Veneto,Veneto,4905854,2146974,43.76,0.65
2175,2021-02-08,VEN,5003,1559,3444,1923,3074,6,ITH,ITH3,5,Veneto,Veneto,4905854,2151977,43.87,0.1
2176,2021-04-06,VEN,28956,13327,15629,23192,5042,722,ITH,ITH3,5,Veneto,Veneto,4905854,2180933,44.46,0.59
2177,2021-02-01,VEN,8561,2502,6059,160,8401,0,ITH,ITH3,5,Veneto,Veneto,4905854,2189494,44.63,0.17
2178,2021-02-15,VEN,4389,1824,2565,4140,240,9,ITH,ITH3,5,Veneto,Veneto,4905854,2193883,44.72,0.09
2179,2021-03-30,VEN,35958,15293,20665,29712,5242,1004,ITH,ITH3,5,Veneto,Veneto,4905854,2229841,45.45,0.73
2180,2021-04-10,VEN,27455,11971,15484,18366,8467,622,ITH,ITH3,5,Veneto,Veneto,4905854,2257296,46.01,0.56
2181,2021-03-11,VEN,19827,8888,10939,13792,5571,464,ITH,ITH3,5,Veneto,Veneto,4905854,2277123,46.42,0.4
2182,2021-04-27,VEN,28135,12757,15378,20063,6914,1158,ITH,ITH3,5,Veneto,Veneto,4905854,2305258,46.99,0.57
2183,2021-01-17,VEN,1933,781,1152,1584,349,0,ITH,ITH3,5,Veneto,Veneto,4905854,2307191,47.03,0.04
2184,2021-02-03,VEN,5946,1668,4278,477,5466,3,ITH,ITH3,5,Veneto,Veneto,4905854,2313137,47.15,0.12
2185,2021-04-29,VEN,50263,23378,26885,35333,13177,1753,ITH,ITH3,5,Veneto,Veneto,4905854,2363400,48.18,1.02
2186,2021-02-05,VEN,8378,2535,5843,1409,6960,9,ITH,ITH3,5,Veneto,Veneto,4905854,2371778,48.35,0.17
2187,2021-02-22,VEN,7014,3041,3973,6580,387,47,ITH,ITH3,5,Veneto,Veneto,4905854,2378792,48.49,0.14
2188,2021-05-16,VEN,28410,14004,14406,20306,7077,1027,ITH,ITH3,5,Veneto,Veneto,4905854,2407202,49.07,0.58
2189,2021-07-07,VEN,40058,20848,19210,15521,23749,788,ITH,ITH3,5,Veneto,Veneto,4905854,2447260,49.88,0.82
2190,2021-05-11,VEN,33158,16497,16661,27119,4719,1320,ITH,ITH3,5,Veneto,Veneto,4905854,2480418,50.56,0.68
2191,2021-01-22,VEN,1080,332,748,25,1055,0,ITH,ITH3,5,Veneto,Veneto,4905854,2481498,50.58,0.02
2192,2021-05-04,VEN,42939,20334,22605,33258,8027,1654,ITH,ITH3,5,Veneto,Veneto,4905854,2524437,51.46,0.88
2193,2021-01-24,VEN,4117,1219,2898,28,4089,0,ITH,ITH3,5,Veneto,Veneto,4905854,2528554,51.54,0.08
2194,2021-04-07,VEN,36004,16182,19822,27561,7337,1106,ITH,ITH3,5,Veneto,Veneto,4905854,2564558,52.28,0.73
2195,2021-01-31,VEN,4769,1563,3206,391,4378,0,ITH,ITH3,5,Veneto,Veneto,4905854,2569327,52.37,0.1
2196,2021-03-29,VEN,31451,13696,17755,26636,3822,993,ITH,ITH3,5,Veneto,Veneto,4905854,2600778,53.01,0.64
2197,2021-05-13,VEN,44232,21830,22402,32519,9886,1827,ITH,ITH3,5,Veneto,Veneto,4905854,2645010,53.92,0.9
2198,2021-02-02,VEN,6512,1881,4631,396,6116,0,ITH,ITH3,5,Veneto,Veneto,4905854,2651522,54.05,0.13
2199,2021-03-31,VEN,38821,16393,22428,30288,7497,1036,ITH,ITH3,5,Veneto,Veneto,4905854,2690343,54.84,0.79
2200,2021-05-26,VEN,31083,15190,15893,13947,16459,677,ITH,ITH3,5,Veneto,Veneto,4905854,2721426,55.47,0.63
2201,2021-03-01,VEN,9395,3716,5679,7410,1822,163,ITH,ITH3,5,Veneto,Veneto,4905854,2730821,55.66,0.19
2202,2021-04-03,VEN,21955,9628,12327,13843,7708,404,ITH,ITH3,5,Veneto,Veneto,4905854,2752776,56.11,0.45
2203,2021-03-20,VEN,13020,5388,7632,10649,2081,290,ITH,ITH3,5,Veneto,Veneto,4905854,2765796,56.38,0.27
2204,2021-06-08,VEN,43788,22633,21155,36058,6121,1609,ITH,ITH3,5,Veneto,Veneto,4905854,2809584,57.27,0.89
2205,2021-05-25,VEN,27754,13400,14354,11239,16016,499,ITH,ITH3,5,Veneto,Veneto,4905854,2837338,57.84,0.57
2206,2021-02-14,VEN,126,56,70,113,13,0,ITH,ITH3,5,Veneto,Veneto,4905854,2837464,57.84,0.0
2207,2021-02-28,VEN,4136,1389,2747,3225,837,74,ITH,ITH3,5,Veneto,Veneto,4905854,2841600,57.92,0.08
2208,2021-06-30,VEN,45480,22947,22533,17746,26963,771,ITH,ITH3,5,Veneto,Veneto,4905854,2887080,58.85,0.93
2209,2021-03-22,VEN,18144,8177,9967,12581,5046,517,ITH,ITH3,5,Veneto,Veneto,4905854,2905224,59.22,0.37
2210,2021-03-13,VEN,17230,7303,9927,13725,3131,374,ITH,ITH3,5,Veneto,Veneto,4905854,2922454,59.57,0.35
2211,2021-01-15,VEN,5875,1820,4055,5869,0,6,ITH,ITH3,5,Veneto,Veneto,4905854,2928329,59.69,0.12
2212,2021-05-20,VEN,44762,21234,23528,19342,24314,1106,ITH,ITH3,5,Veneto,Veneto,4905854,2973091,60.6,0.91
2213,2021-02-09,VEN,5248,1891,3357,3432,1803,13,ITH,ITH3,5,Veneto,Veneto,4905854,2978339,60.71,0.11
2214,2021-05-27,VEN,46482,22843,23639,22285,23157,1040,ITH,ITH3,5,Veneto,Veneto,4905854,3024821,61.66,0.95
2215,2021-02-07,VEN,2315,862,1453,713,1601,1,ITH,ITH3,5,Veneto,Veneto,4905854,3027136,61.7,0.05
2216,2021-07-02,VEN,49342,25036,24306,16177,32364,801,ITH,ITH3,5,Veneto,Veneto,4905854,3076478,62.71,1.01
2217,2021-03-24,VEN,22109,9573,12536,14658,6802,649,ITH,ITH3,5,Veneto,Veneto,4905854,3098587,63.16,0.45
2218,2021-06-06,VEN,37419,19154,18265,31402,4728,1289,ITH,ITH3,5,Veneto,Veneto,4905854,3136006,63.92,0.76
2219,2020-12-27,VEN,880,395,485,880,0,0,ITH,ITH3,5,Veneto,Veneto,4905854,3136886,63.94,0.02
2220,2021-05-30,VEN,22540,11265,11275,15201,6687,652,ITH,ITH3,5,Veneto,Veneto,4905854,3159426,64.4,0.46
2221,2020-12-31,VEN,3220,1042,2178,3220,0,0,ITH,ITH3,5,Veneto,Veneto,4905854,3162646,64.47,0.07
2222,2021-07-04,VEN,33839,17561,16278,14951,18274,614,ITH,ITH3,5,Veneto,Veneto,4905854,3196485,65.16,0.69
2223,2021-04-12,VEN,14901,6334,8567,6387,8214,300,ITH,ITH3,5,Veneto,Veneto,4905854,3211386,65.46,0.3
2224,2021-01-02,VEN,5744,1767,3977,5743,0,1,ITH,ITH3,5,Veneto,Veneto,4905854,3217130,65.58,0.12
2225,2021-01-19,VEN,1310,473,837,1159,150,1,ITH,ITH3,5,Veneto,Veneto,4905854,3218440,65.6,0.03
2226,2021-05-01,VEN,38857,18238,20619,28686,8942,1229,ITH,ITH3,5,Veneto,Veneto,4905854,3257297,66.4,0.79
2227,2021-02-26,VEN,8295,3271,5024,6943,1259,93,ITH,ITH3,5,Veneto,Veneto,4905854,3265592,66.57,0.17
2228,2021-04-24,VEN,24752,10826,13926,14952,9079,721,ITH,ITH3,5,Veneto,Veneto,4905854,3290344,67.07,0.5
2229,2021-01-14,VEN,7063,1924,5139,7043,0,20,ITH,ITH3,5,Veneto,Veneto,4905854,3297407,67.21,0.14
2230,2021-03-12,VEN,18658,8194,10464,11329,6748,581,ITH,ITH3,5,Veneto,Veneto,4905854,3316065,67.59,0.38
2231,2021-04-17,VEN,22418,9084,13334,14346,7274,798,ITH,ITH3,5,Veneto,Veneto,4905854,3338483,68.05,0.46
2232,2021-01-07,VEN,8360,2318,6042,8359,0,1,ITH,ITH3,5,Veneto,Veneto,4905854,3346843,68.22,0.17
2233,2021-06-13,VEN,37330,19249,18081,29219,6967,1144,ITH,ITH3,5,Veneto,Veneto,4905854,3384173,68.98,0.76
2234,2021-01-21,VEN,2293,719,1574,21,2272,0,ITH,ITH3,5,Veneto,Veneto,4905854,3386466,69.03,0.05
2235,2021-03-05,VEN,13336,5020,8316,9217,3670,449,ITH,ITH3,5,Veneto,Veneto,4905854,3399802,69.3,0.27
2236,2021-01-10,VEN,5034,1672,3362,5033,0,1,ITH,ITH3,5,Veneto,Veneto,4905854,3404836,69.4,0.1
2237,2021-05-23,VEN,34484,16464,18020,10615,23400,469,ITH,ITH3,5,Veneto,Veneto,4905854,3439320,70.11,0.7
2238,2021-02-12,VEN,4314,1447,2867,3671,572,71,ITH,ITH3,5,Veneto,Veneto,4905854,3443634,70.19,0.09
2239,2021-01-29,VEN,9023,2788,6235,366,8657,0,ITH,ITH3,5,Veneto,Veneto,4905854,3452657,70.38,0.18
2240,2021-05-08,VEN,41440,18747,22693,28184,11812,1444,ITH,ITH3,5,Veneto,Veneto,4905854,3494097,71.22,0.84
2241,2021-07-03,VEN,38600,20060,18540,11004,27014,582,ITH,ITH3,5,Veneto,Veneto,4905854,3532697,72.01,0.79
2242,2021-06-16,VEN,47560,23463,24097,25127,21293,1140,ITH,ITH3,5,Veneto,Veneto,4905854,3580257,72.98,0.97
2243,2021-01-01,VEN,1528,471,1057,1527,0,1,ITH,ITH3,5,Veneto,Veneto,4905854,3581785,73.01,0.03
2244,2021-03-25,VEN,25953,11056,14897,18961,6099,893,ITH,ITH3,5,Veneto,Veneto,4905854,3607738,73.54,0.53
2245,2021-04-11,VEN,20996,8869,12127,14217,6294,485,ITH,ITH3,5,Veneto,Veneto,4905854,3628734,73.97,0.43
2246,2021-04-13,VEN,14024,6322,7702,8043,5479,502,ITH,ITH3,5,Veneto,Veneto,4905854,3642758,74.25,0.29
2247,2021-07-05,VEN,38992,20217,18775,14058,24122,812,ITH,ITH3,5,Veneto,Veneto,4905854,3681750,75.05,0.79
2248,2021-03-17,VEN,14645,5992,8653,7530,6796,319,ITH,ITH3,5,Veneto,Veneto,4905854,3696395,75.35,0.3
2249,2021-01-12,VEN,5231,1517,3714,5223,0,8,ITH,ITH3,5,Veneto,Veneto,4905854,3701626,75.45,0.11
2250,2021-04-19,VEN,21542,8922,12620,4709,16408,425,ITH,ITH3,5,Veneto,Veneto,4905854,3723168,75.89,0.44
2251,2021-04-05,VEN,19153,8370,10783,13418,5435,300,ITH,ITH3,5,Veneto,Veneto,4905854,3742321,76.28,0.39
2252,2021-01-26,VEN,6919,2090,4829,149,6770,0,ITH,ITH3,5,Veneto,Veneto,4905854,3749240,76.42,0.14
2253,2021-05-06,VEN,46956,22027,24929,36508,8473,1975,ITH,ITH3,5,Veneto,Veneto,4905854,3796196,77.38,0.96
2254,2021-06-27,VEN,40229,20551,19678,15330,24299,600,ITH,ITH3,5,Veneto,Veneto,4905854,3836425,78.2,0.82
2255,2021-03-19,VEN,13791,5668,8123,7402,6095,294,ITH,ITH3,5,Veneto,Veneto,4905854,3850216,78.48,0.28
2256,2021-01-03,VEN,5157,1562,3595,5157,0,0,ITH,ITH3,5,Veneto,Veneto,4905854,3855373,78.59,0.11
2257,2021-03-08,VEN,13630,6271,7359,9300,4069,261,ITH,ITH3,5,Veneto,Veneto,4905854,3869003,78.87,0.28
2258,2021-06-18,VEN,53453,26688,26765,23885,28475,1093,ITH,ITH3,5,Veneto,Veneto,4905854,3922456,79.95,1.09
2259,2021-03-27,VEN,32067,14011,18056,25364,5798,905,ITH,ITH3,5,Veneto,Veneto,4905854,3954523,80.61,0.65
2260,2021-06-03,VEN,54388,27963,26425,40711,11958,1719,ITH,ITH3,5,Veneto,Veneto,4905854,4008911,81.72,1.11
2261,2021-06-20,VEN,41168,20051,21117,18879,21515,774,ITH,ITH3,5,Veneto,Veneto,4905854,4050079,82.56,0.84
2262,2021-02-19,VEN,7322,3140,4182,6992,204,126,ITH,ITH3,5,Veneto,Veneto,4905854,4057401,82.71,0.15
2263,2021-02-21,VEN,4638,1211,3427,4514,5,119,ITH,ITH3,5,Veneto,Veneto,4905854,4062039,82.8,0.09
2264,2021-05-15,VEN,36203,17494,18709,24784,9990,1429,ITH,ITH3,5,Veneto,Veneto,4905854,4098242,83.54,0.74
2265,2021-06-01,VEN,26950,13551,13399,15778,10529,643,ITH,ITH3,5,Veneto,Veneto,4905854,4125192,84.09,0.55
2266,2021-03-10,VEN,19039,8727,10312,12962,5683,394,ITH,ITH3,5,Veneto,Veneto,4905854,4144231,84.48,0.39
2267,2021-05-28,VEN,46681,22858,23823,23657,21827,1197,ITH,ITH3,5,Veneto,Veneto,4905854,4190912,85.43,0.95
2268,2021-05-21,VEN,44752,22014,22738,19893,23752,1107,ITH,ITH3,5,Veneto,Veneto,4905854,4235664,86.34,0.91
2269,2021-02-17,VEN,6022,2772,3250,5900,94,28,ITH,ITH3,5,Veneto,Veneto,4905854,4241686,86.46,0.12
2270,2021-04-01,VEN,25335,11159,14176,18148,6410,777,ITH,ITH3,5,Veneto,Veneto,4905854,4267021,86.98,0.52
2271,2021-04-15,VEN,20905,8633,12272,9334,10822,749,ITH,ITH3,5,Veneto,Veneto,4905854,4287926,87.4,0.43
2272,2021-01-05,VEN,7330,2183,5147,7328,0,2,ITH,ITH3,5,Veneto,Veneto,4905854,4295256,87.55,0.15
2273,2021-02-10,VEN,4752,1588,3164,3688,1055,9,ITH,ITH3,5,Veneto,Veneto,4905854,4300008,87.65,0.1
2274,2021-04-08,VEN,32366,14366,18000,23319,7875,1172,ITH,ITH3,5,Veneto,Veneto,4905854,4332374,88.31,0.66
2275,2021-06-04,VEN,49555,25798,23757,39666,8120,1769,ITH,ITH3,5,Veneto,Veneto,4905854,4381929,89.32,1.01
2276,2021-02-24,VEN,8616,3679,4937,7995,488,133,ITH,ITH3,5,Veneto,Veneto,4905854,4390545,89.5,0.18
2277,2021-06-22,VEN,43638,21582,22056,18417,24334,887,ITH,ITH3,5,Veneto,Veneto,4905854,4434183,90.39,0.89
2278,2021-04-26,VEN,20717,9454,11263,14898,5138,681,ITH,ITH3,5,Veneto,Veneto,4905854,4454900,90.81,0.42
2279,2021-06-15,VEN,47718,24234,23484,28983,17500,1235,ITH,ITH3,5,Veneto,Veneto,4905854,4502618,91.78,0.97
2280,2021-02-28,LIG,1058,580,478,1042,9,7,ITC,ITC3,7,Liguria,Liguria,1550640,1058,0.07,0.07
2281,2021-03-14,LIG,1659,752,907,1033,604,22,ITC,ITC3,7,Liguria,Liguria,1550640,2717,0.18,0.11
2282,2021-06-22,LIG,15772,7446,8326,7638,8110,24,ITC,ITC3,7,Liguria,Liguria,1550640,18489,1.19,1.02
2283,2021-07-06,LIG,12188,6002,6186,5649,6505,34,ITC,ITC3,7,Liguria,Liguria,1550640,30677,1.98,0.79
2284,2021-05-10,LIG,12644,5639,7005,6209,6371,64,ITC,ITC3,7,Liguria,Liguria,1550640,43321,2.79,0.82
2285,2021-05-03,LIG,13278,5921,7357,6324,6815,139,ITC,ITC3,7,Liguria,Liguria,1550640,56599,3.65,0.86
2286,2021-03-21,LIG,550,220,330,69,481,0,ITC,ITC3,7,Liguria,Liguria,1550640,57149,3.69,0.04
2287,2021-01-23,LIG,809,295,514,153,656,0,ITC,ITC3,7,Liguria,Liguria,1550640,57958,3.74,0.05
2288,2021-06-29,LIG,15073,7175,7898,8658,6383,32,ITC,ITC3,7,Liguria,Liguria,1550640,73031,4.71,0.97
2289,2021-06-05,LIG,8088,4115,3973,4936,3152,0,ITC,ITC3,7,Liguria,Liguria,1550640,81119,5.23,0.52
2290,2021-04-09,LIG,12456,5560,6896,10549,1766,141,ITC,ITC3,7,Liguria,Liguria,1550640,93575,6.03,0.8
2291,2021-03-31,LIG,11925,5275,6650,9048,2770,107,ITC,ITC3,7,Liguria,Liguria,1550640,105500,6.8,0.77
2292,2021-02-16,LIG,2427,956,1471,1995,423,9,ITC,ITC3,7,Liguria,Liguria,1550640,107927,6.96,0.16
2293,2021-05-27,LIG,16882,8652,8230,12560,4145,177,ITC,ITC3,7,Liguria,Liguria,1550640,124809,8.05,1.09
2294,2021-04-14,LIG,13074,5671,7403,10748,2201,125,ITC,ITC3,7,Liguria,Liguria,1550640,137883,8.89,0.84
2295,2021-05-29,LIG,6863,3251,3612,3969,2870,24,ITC,ITC3,7,Liguria,Liguria,1550640,144746,9.33,0.44
2296,2021-02-09,LIG,1950,694,1256,264,1684,2,ITC,ITC3,7,Liguria,Liguria,1550640,146696,9.46,0.13
2297,2021-02-11,LIG,1980,768,1212,1094,877,9,ITC,ITC3,7,Liguria,Liguria,1550640,148676,9.59,0.13
2298,2021-05-22,LIG,6649,3220,3429,4870,1684,95,ITC,ITC3,7,Liguria,Liguria,1550640,155325,10.02,0.43
2299,2021-06-10,LIG,18728,9665,9063,13101,5623,4,ITC,ITC3,7,Liguria,Liguria,1550640,174053,11.22,1.21
2300,2021-03-19,LIG,5296,2234,3062,2095,3146,55,ITC,ITC3,7,Liguria,Liguria,1550640,179349,11.57,0.34
2301,2021-03-02,LIG,4074,1689,2385,3753,310,11,ITC,ITC3,7,Liguria,Liguria,1550640,183423,11.83,0.26
2302,2021-06-24,LIG,11033,5388,5645,6247,4774,12,ITC,ITC3,7,Liguria,Liguria,1550640,194456,12.54,0.71
2303,2021-04-02,LIG,11789,5219,6570,9207,2487,95,ITC,ITC3,7,Liguria,Liguria,1550640,206245,13.3,0.76
2304,2021-01-28,LIG,2847,971,1876,39,2808,0,ITC,ITC3,7,Liguria,Liguria,1550640,209092,13.48,0.18
2305,2021-01-21,LIG,1106,385,721,674,431,1,ITC,ITC3,7,Liguria,Liguria,1550640,210198,13.56,0.07
2306,2021-03-26,LIG,9331,4025,5306,6067,3155,109,ITC,ITC3,7,Liguria,Liguria,1550640,219529,14.16,0.6
2307,2021-07-04,LIG,4835,2573,2262,3838,982,15,ITC,ITC3,7,Liguria,Liguria,1550640,224364,14.47,0.31
2308,2021-01-02,LIG,691,245,446,691,0,0,ITC,ITC3,7,Liguria,Liguria,1550640,225055,14.51,0.04
2309,2021-06-15,LIG,17396,8459,8937,9324,8059,13,ITC,ITC3,7,Liguria,Liguria,1550640,242451,15.64,1.12
2310,2021-04-26,LIG,10556,4981,5575,7814,2637,105,ITC,ITC3,7,Liguria,Liguria,1550640,253007,16.32,0.68
2311,2021-01-16,LIG,1278,557,721,1273,0,5,ITC,ITC3,7,Liguria,Liguria,1550640,254285,16.4,0.08
2312,2021-02-02,LIG,2671,1005,1666,127,2542,2,ITC,ITC3,7,Liguria,Liguria,1550640,256956,16.57,0.17
2313,2021-04-28,LIG,14443,6519,7924,6344,7983,116,ITC,ITC3,7,Liguria,Liguria,1550640,271399,17.5,0.93
2314,2021-02-04,LIG,2817,986,1831,179,2638,0,ITC,ITC3,7,Liguria,Liguria,1550640,274216,17.68,0.18
2315,2021-05-15,LIG,7306,3264,4042,4274,2954,78,ITC,ITC3,7,Liguria,Liguria,1550640,281522,18.16,0.47
2316,2021-02-21,LIG,869,491,378,857,4,8,ITC,ITC3,7,Liguria,Liguria,1550640,282391,18.21,0.06
2317,2021-01-09,LIG,1335,481,854,1334,0,1,ITC,ITC3,7,Liguria,Liguria,1550640,283726,18.3,0.09
2318,2021-04-19,LIG,12830,5615,7215,8885,3831,114,ITC,ITC3,7,Liguria,Liguria,1550640,296556,19.12,0.83
2319,2021-05-17,LIG,12023,5519,6504,8651,3322,50,ITC,ITC3,7,Liguria,Liguria,1550640,308579,19.9,0.78
2320,2021-01-30,LIG,1661,567,1094,23,1637,1,ITC,ITC3,7,Liguria,Liguria,1550640,310240,20.01,0.11
2321,2021-03-28,LIG,1141,511,630,378,751,12,ITC,ITC3,7,Liguria,Liguria,1550640,311381,20.08,0.07
2322,2020-12-28,LIG,80,30,50,80,0,0,ITC,ITC3,7,Liguria,Liguria,1550640,311461,20.09,0.01
2323,2021-06-03,LIG,15519,7689,7830,9151,6361,7,ITC,ITC3,7,Liguria,Liguria,1550640,326980,21.09,1.0
2324,2021-04-07,LIG,13677,6107,7570,11299,2288,90,ITC,ITC3,7,Liguria,Liguria,1550640,340657,21.97,0.88
2325,2021-02-23,LIG,3806,1559,2247,3657,109,40,ITC,ITC3,7,Liguria,Liguria,1550640,344463,22.21,0.25
2326,2021-06-14,LIG,15079,7282,7797,8232,6845,2,ITC,ITC3,7,Liguria,Liguria,1550640,359542,23.19,0.97
2327,2021-02-25,LIG,3457,1349,2108,3307,130,20,ITC,ITC3,7,Liguria,Liguria,1550640,362999,23.41,0.22
2328,2021-04-23,LIG,14671,6637,8034,8404,6120,147,ITC,ITC3,7,Liguria,Liguria,1550640,377670,24.36,0.95
2329,2021-03-11,LIG,6397,3088,3309,4330,2010,57,ITC,ITC3,7,Liguria,Liguria,1550640,384067,24.77,0.41
2330,2021-01-13,LIG,2758,1014,1744,2757,0,1,ITC,ITC3,7,Liguria,Liguria,1550640,386825,24.95,0.18
2331,2021-01-04,LIG,2615,855,1760,2614,0,1,ITC,ITC3,7,Liguria,Liguria,1550640,389440,25.11,0.17
2332,2021-04-21,LIG,14248,6434,7814,8799,5328,121,ITC,ITC3,7,Liguria,Liguria,1550640,403688,26.03,0.92
2333,2021-05-08,LIG,7526,3333,4193,2270,5212,44,ITC,ITC3,7,Liguria,Liguria,1550640,411214,26.52,0.49
2334,2021-01-25,LIG,2726,889,1837,476,2249,1,ITC,ITC3,7,Liguria,Liguria,1550640,413940,26.69,0.18
2335,2021-05-05,LIG,13709,6133,7576,5182,8418,109,ITC,ITC3,7,Liguria,Liguria,1550640,427649,27.58,0.88
2336,2021-01-14,LIG,2981,1055,1926,2979,0,2,ITC,ITC3,7,Liguria,Liguria,1550640,430630,27.77,0.19
2337,2021-03-12,LIG,6216,2873,3343,3688,2471,57,ITC,ITC3,7,Liguria,Liguria,1550640,436846,28.17,0.4
2338,2021-07-01,LIG,13414,6465,6949,7321,6061,32,ITC,ITC3,7,Liguria,Liguria,1550640,450260,29.04,0.87
2339,2021-05-19,LIG,13571,5962,7609,10306,3120,145,ITC,ITC3,7,Liguria,Liguria,1550640,463831,29.91,0.88
2340,2021-03-07,LIG,1915,1138,777,1590,301,24,ITC,ITC3,7,Liguria,Liguria,1550640,465746,30.04,0.12
2341,2021-06-17,LIG,16609,7889,8720,9087,7506,16,ITC,ITC3,7,Liguria,Liguria,1550640,482355,31.11,1.07
2342,2021-06-02,LIG,8530,4342,4188,5362,3168,0,ITC,ITC3,7,Liguria,Liguria,1550640,490885,31.66,0.55
2343,2020-12-30,LIG,12,5,7,12,0,0,ITC,ITC3,7,Liguria,Liguria,1550640,490897,31.66,0.0
2344,2021-07-03,LIG,8768,4349,4419,5465,3291,12,ITC,ITC3,7,Liguria,Liguria,1550640,499665,32.22,0.57
2345,2021-04-11,LIG,4246,1929,2317,3942,249,55,ITC,ITC3,7,Liguria,Liguria,1550640,503911,32.5,0.27
2346,2021-05-24,LIG,11828,5564,6264,9232,2494,102,ITC,ITC3,7,Liguria,Liguria,1550640,515739,33.26,0.76
2347,2021-05-07,LIG,13590,6038,7552,5730,7792,68,ITC,ITC3,7,Liguria,Liguria,1550640,529329,34.14,0.88
2348,2021-02-13,LIG,1080,508,572,797,280,3,ITC,ITC3,7,Liguria,Liguria,1550640,530409,34.21,0.07
2349,2021-06-07,LIG,15684,7655,8029,8665,7012,7,ITC,ITC3,7,Liguria,Liguria,1550640,546093,35.22,1.01
2350,2021-06-26,LIG,7137,3311,3826,4486,2641,10,ITC,ITC3,7,Liguria,Liguria,1550640,553230,35.68,0.46
2351,2021-04-04,LIG,756,366,390,499,249,8,ITC,ITC3,7,Liguria,Liguria,1550640,553986,35.73,0.05
2352,2021-04-18,LIG,2613,1164,1449,2074,468,71,ITC,ITC3,7,Liguria,Liguria,1550640,556599,35.89,0.17
2353,2021-03-04,LIG,4738,2118,2620,3834,847,57,ITC,ITC3,7,Liguria,Liguria,1550640,561337,36.2,0.31
2354,2021-06-12,LIG,10229,4974,5255,7477,2752,0,ITC,ITC3,7,Liguria,Liguria,1550640,571566,36.86,0.66
2355,2021-04-30,LIG,14417,6439,7978,5729,8568,120,ITC,ITC3,7,Liguria,Liguria,1550640,585983,37.79,0.93
2356,2021-03-06,LIG,3304,1842,1462,2550,705,49,ITC,ITC3,7,Liguria,Liguria,1550640,589287,38.0,0.21
2357,2021-01-22,LIG,1819,604,1215,1330,486,3,ITC,ITC3,7,Liguria,Liguria,1550640,591106,38.12,0.12
2358,2021-05-02,LIG,3978,1836,2142,505,3467,6,ITC,ITC3,7,Liguria,Liguria,1550640,595084,38.38,0.26
2359,2021-05-04,LIG,13646,6084,7562,5332,8228,86,ITC,ITC3,7,Liguria,Liguria,1550640,608730,39.26,0.88
2360,2021-05-09,LIG,2822,1244,1578,1084,1709,29,ITC,ITC3,7,Liguria,Liguria,1550640,611552,39.44,0.18
2361,2021-01-29,LIG,3082,1064,2018,67,3015,0,ITC,ITC3,7,Liguria,Liguria,1550640,614634,39.64,0.2
2362,2021-06-21,LIG,14796,7020,7776,8554,6227,15,ITC,ITC3,7,Liguria,Liguria,1550640,629430,40.59,0.95
2363,2021-04-16,LIG,11989,5287,6702,9972,1828,189,ITC,ITC3,7,Liguria,Liguria,1550640,641419,41.36,0.77
2364,2021-01-06,LIG,1660,616,1044,1657,0,3,ITC,ITC3,7,Liguria,Liguria,1550640,643079,41.47,0.11
2365,2021-03-16,LIG,6083,2731,3352,2309,3733,41,ITC,ITC3,7,Liguria,Liguria,1550640,649162,41.86,0.39
2366,2021-01-11,LIG,2653,990,1663,2652,0,1,ITC,ITC3,7,Liguria,Liguria,1550640,651815,42.04,0.17
2367,2021-01-10,LIG,648,262,386,644,0,4,ITC,ITC3,7,Liguria,Liguria,1550640,652463,42.08,0.04
2368,2021-04-20,LIG,14228,6514,7714,9704,4349,175,ITC,ITC3,7,Liguria,Liguria,1550640,666691,42.99,0.92
2369,2021-05-23,LIG,2305,1119,1186,1169,1123,13,ITC,ITC3,7,Liguria,Liguria,1550640,668996,43.14,0.15
2370,2021-03-01,LIG,3539,1447,2092,3383,136,20,ITC,ITC3,7,Liguria,Liguria,1550640,672535,43.37,0.23
2371,2021-02-06,LIG,1892,768,1124,145,1747,0,ITC,ITC3,7,Liguria,Liguria,1550640,674427,43.49,0.12
2372,2021-06-11,LIG,17813,9072,8741,11748,6063,2,ITC,ITC3,7,Liguria,Liguria,1550640,692240,44.64,1.15
2373,2021-04-15,LIG,11836,5232,6604,9873,1851,112,ITC,ITC3,7,Liguria,Liguria,1550640,704076,45.41,0.76
2374,2021-01-18,LIG,2141,746,1395,1982,157,2,ITC,ITC3,7,Liguria,Liguria,1550640,706217,45.54,0.14
2375,2021-06-16,LIG,15973,7683,8290,8968,6995,10,ITC,ITC3,7,Liguria,Liguria,1550640,722190,46.57,1.03
2376,2021-03-08,LIG,5623,2458,3165,3893,1689,41,ITC,ITC3,7,Liguria,Liguria,1550640,727813,46.94,0.36
2377,2021-03-25,LIG,9766,4231,5535,6225,3392,149,ITC,ITC3,7,Liguria,Liguria,1550640,737579,47.57,0.63
2378,2021-01-01,LIG,144,55,89,144,0,0,ITC,ITC3,7,Liguria,Liguria,1550640,737723,47.58,0.01
2379,2021-03-27,LIG,3932,1549,2383,2485,1395,52,ITC,ITC3,7,Liguria,Liguria,1550640,741655,47.83,0.25
2380,2021-07-05,LIG,11772,5718,6054,5317,6420,35,ITC,ITC3,7,Liguria,Liguria,1550640,753427,48.59,0.76
2381,2021-06-28,LIG,11559,5591,5968,7240,4279,40,ITC,ITC3,7,Liguria,Liguria,1550640,764986,49.33,0.75
2382,2021-03-20,LIG,2316,995,1321,1124,1174,18,ITC,ITC3,7,Liguria,Liguria,1550640,767302,49.48,0.15
2383,2021-06-30,LIG,15017,7164,7853,8209,6767,41,ITC,ITC3,7,Liguria,Liguria,1550640,782319,50.45,0.97
2384,2021-01-15,LIG,2257,755,1502,2252,0,5,ITC,ITC3,7,Liguria,Liguria,1550640,784576,50.6,0.15
2385,2021-04-25,LIG,1935,920,1015,1506,415,14,ITC,ITC3,7,Liguria,Liguria,1550640,786511,50.72,0.12
2386,2021-03-13,LIG,3849,1637,2212,2949,855,45,ITC,ITC3,7,Liguria,Liguria,1550640,790360,50.97,0.25
2387,2021-06-23,LIG,14254,6818,7436,9066,5169,19,ITC,ITC3,7,Liguria,Liguria,1550640,804614,51.89,0.92
2388,2021-02-14,LIG,233,122,111,233,0,0,ITC,ITC3,7,Liguria,Liguria,1550640,804847,51.9,0.02
2389,2021-05-25,LIG,14112,6866,7246,10805,3179,128,ITC,ITC3,7,Liguria,Liguria,1550640,818959,52.81,0.91
2390,2021-03-22,LIG,7745,3467,4278,4735,2937,73,ITC,ITC3,7,Liguria,Liguria,1550640,826704,53.31,0.5
2391,2021-02-07,LIG,407,153,254,2,405,0,ITC,ITC3,7,Liguria,Liguria,1550640,827111,53.34,0.03
2392,2021-05-18,LIG,13462,6118,7344,10032,3293,137,ITC,ITC3,7,Liguria,Liguria,1550640,840573,54.21,0.87
2393,2021-05-20,LIG,12871,5973,6898,8720,4025,126,ITC,ITC3,7,Liguria,Liguria,1550640,853444,55.04,0.83
2394,2021-01-08,LIG,2930,999,1931,2928,0,2,ITC,ITC3,7,Liguria,Liguria,1550640,856374,55.23,0.19
2395,2021-01-27,LIG,1744,603,1141,140,1603,1,ITC,ITC3,7,Liguria,Liguria,1550640,858118,55.34,0.11
2396,2021-05-21,LIG,12842,5955,6887,9572,3125,145,ITC,ITC3,7,Liguria,Liguria,1550640,870960,56.17,0.83
2397,2021-02-27,LIG,1888,921,967,1750,129,9,ITC,ITC3,7,Liguria,Liguria,1550640,872848,56.29,0.12
2398,2021-02-10,LIG,2315,837,1478,1015,1296,4,ITC,ITC3,7,Liguria,Liguria,1550640,875163,56.44,0.15
2399,2021-06-09,LIG,19042,9555,9487,12480,6558,4,ITC,ITC3,7,Liguria,Liguria,1550640,894205,57.67,1.23
2400,2021-04-03,LIG,5406,2498,2908,4427,943,36,ITC,ITC3,7,Liguria,Liguria,1550640,899611,58.02,0.35
2401,2021-01-24,LIG,756,237,519,113,643,0,ITC,ITC3,7,Liguria,Liguria,1550640,900367,58.06,0.05
2402,2021-01-20,LIG,1552,555,997,1537,12,3,ITC,ITC3,7,Liguria,Liguria,1550640,901919,58.16,0.1
2403,2021-04-05,LIG,3978,1753,2225,2303,1649,26,ITC,ITC3,7,Liguria,Liguria,1550640,905897,58.42,0.26
2404,2021-05-11,LIG,13913,6387,7526,7179,6615,119,ITC,ITC3,7,Liguria,Liguria,1550640,919810,59.32,0.9
2405,2021-03-29,LIG,10581,4619,5962,7343,3131,107,ITC,ITC3,7,Liguria,Liguria,1550640,930391,60.0,0.68
2406,2021-01-31,LIG,624,270,354,9,615,0,ITC,ITC3,7,Liguria,Liguria,1550640,931015,60.04,0.04
2407,2021-07-07,LIG,11562,5526,6036,4911,6634,17,ITC,ITC3,7,Liguria,Liguria,1550640,942577,60.79,0.75
2408,2021-04-08,LIG,13747,6161,7586,11545,2045,157,ITC,ITC3,7,Liguria,Liguria,1550640,956324,61.67,0.89
2409,2021-06-04,LIG,14737,7235,7502,9243,5488,6,ITC,ITC3,7,Liguria,Liguria,1550640,971061,62.62,0.95
2410,2021-04-13,LIG,13078,5867,7211,10940,2024,114,ITC,ITC3,7,Liguria,Liguria,1550640,984139,63.47,0.84
2411,2021-05-13,LIG,13295,6080,7215,8881,4246,168,ITC,ITC3,7,Liguria,Liguria,1550640,997434,64.32,0.86
2412,2021-02-19,LIG,3219,1306,1913,2988,176,55,ITC,ITC3,7,Liguria,Liguria,1550640,1000653,64.53,0.21
2413,2021-05-30,LIG,3302,1613,1689,1350,1939,13,ITC,ITC3,7,Liguria,Liguria,1550640,1003955,64.74,0.21
2414,2021-06-01,LIG,16160,8116,8044,10790,5366,4,ITC,ITC3,7,Liguria,Liguria,1550640,1020115,65.79,1.04
2415,2021-06-18,LIG,15297,7454,7843,8147,7132,18,ITC,ITC3,7,Liguria,Liguria,1550640,1035412,66.77,0.99
2416,2021-03-10,LIG,5901,2862,3039,3929,1907,65,ITC,ITC3,7,Liguria,Liguria,1550640,1041313,67.15,0.38
2417,2021-02-17,LIG,2690,1182,1508,2252,426,12,ITC,ITC3,7,Liguria,Liguria,1550640,1044003,67.33,0.17
2418,2021-05-28,LIG,16277,8127,8150,11576,4536,165,ITC,ITC3,7,Liguria,Liguria,1550640,1060280,68.38,1.05
2419,2021-01-05,LIG,2878,895,1983,2878,0,0,ITC,ITC3,7,Liguria,Liguria,1550640,1063158,68.56,0.19
2420,2021-03-03,LIG,4581,1847,2734,3443,1027,111,ITC,ITC3,7,Liguria,Liguria,1550640,1067739,68.86,0.3
2421,2021-02-24,LIG,3764,1560,2204,3448,258,58,ITC,ITC3,7,Liguria,Liguria,1550640,1071503,69.1,0.24
2422,2020-12-29,LIG,125,33,92,125,0,0,ITC,ITC3,7,Liguria,Liguria,1550640,1071628,69.11,0.01
2423,2021-01-12,LIG,2469,887,1582,2468,0,1,ITC,ITC3,7,Liguria,Liguria,1550640,1074097,69.27,0.16
2424,2021-04-22,LIG,13850,6208,7642,8615,5075,160,ITC,ITC3,7,Liguria,Liguria,1550640,1087947,70.16,0.89
2425,2021-03-18,LIG,4986,2124,2862,1972,2979,35,ITC,ITC3,7,Liguria,Liguria,1550640,1092933,70.48,0.32
2426,2021-04-01,LIG,12423,5511,6912,9564,2770,89,ITC,ITC3,7,Liguria,Liguria,1550640,1105356,71.28,0.8
2427,2021-06-08,LIG,18081,9018,9063,11446,6629,6,ITC,ITC3,7,Liguria,Liguria,1550640,1123437,72.45,1.17
2428,2021-03-17,LIG,5552,2368,3184,2451,3079,22,ITC,ITC3,7,Liguria,Liguria,1550640,1128989,72.81,0.36
2429,2021-06-19,LIG,7364,3749,3615,5688,1660,16,ITC,ITC3,7,Liguria,Liguria,1550640,1136353,73.28,0.47
2430,2021-02-18,LIG,2768,1126,1642,2423,334,11,ITC,ITC3,7,Liguria,Liguria,1550640,1139121,73.46,0.18
2431,2021-05-14,LIG,13107,5838,7269,8593,4327,187,ITC,ITC3,7,Liguria,Liguria,1550640,1152228,74.31,0.85
2432,2021-05-31,LIG,14639,7328,7311,9030,5514,95,ITC,ITC3,7,Liguria,Liguria,1550640,1166867,75.25,0.94
2433,2021-03-09,LIG,5931,2754,3177,4439,1431,61,ITC,ITC3,7,Liguria,Liguria,1550640,1172798,75.63,0.38
2434,2021-02-20,LIG,1335,637,698,1330,1,4,ITC,ITC3,7,Liguria,Liguria,1550640,1174133,75.72,0.09
2435,2021-06-27,LIG,1932,888,1044,688,1234,10,ITC,ITC3,7,Liguria,Liguria,1550640,1176065,75.84,0.12
2436,2021-02-12,LIG,1935,690,1245,895,1038,2,ITC,ITC3,7,Liguria,Liguria,1550640,1178000,75.97,0.12
2437,2021-03-15,LIG,7246,3097,4149,4491,2706,49,ITC,ITC3,7,Liguria,Liguria,1550640,1185246,76.44,0.47
2438,2021-06-25,LIG,13745,6574,7171,6870,6861,14,ITC,ITC3,7,Liguria,Liguria,1550640,1198991,77.32,0.89
2439,2021-05-06,LIG,14518,6441,8077,6038,8323,157,ITC,ITC3,7,Liguria,Liguria,1550640,1213509,78.26,0.94
2440,2021-01-26,LIG,2488,807,1681,16,2472,0,ITC,ITC3,7,Liguria,Liguria,1550640,1215997,78.42,0.16
2441,2021-05-16,LIG,3705,1862,1843,2118,1560,27,ITC,ITC3,7,Liguria,Liguria,1550640,1219702,78.66,0.24
2442,2021-02-22,LIG,3343,1476,1867,3191,142,10,ITC,ITC3,7,Liguria,Liguria,1550640,1223045,78.87,0.22
2443,2021-04-27,LIG,14778,6681,8097,7107,7586,85,ITC,ITC3,7,Liguria,Liguria,1550640,1237823,79.83,0.95
2444,2021-02-03,LIG,2316,791,1525,54,2262,0,ITC,ITC3,7,Liguria,Liguria,1550640,1240139,79.98,0.15
2445,2021-04-29,LIG,15578,6978,8600,6583,8840,155,ITC,ITC3,7,Liguria,Liguria,1550640,1255717,80.98,1.0
2446,2021-04-12,LIG,12388,5476,6912,10270,2019,99,ITC,ITC3,7,Liguria,Liguria,1550640,1268105,81.78,0.8
2447,2021-01-19,LIG,1373,439,934,1279,90,4,ITC,ITC3,7,Liguria,Liguria,1550640,1269478,81.87,0.09
2448,2021-02-05,LIG,2681,987,1694,303,2376,2,ITC,ITC3,7,Liguria,Liguria,1550640,1272159,82.04,0.17
2449,2021-03-24,LIG,9179,4032,5147,5807,3287,85,ITC,ITC3,7,Liguria,Liguria,1550640,1281338,82.63,0.59
2450,2021-07-02,LIG,12899,6337,6562,6419,6449,31,ITC,ITC3,7,Liguria,Liguria,1550640,1294237,83.46,0.83
2451,2020-12-31,LIG,990,353,637,990,0,0,ITC,ITC3,7,Liguria,Liguria,1550640,1295227,83.53,0.06
2452,2021-04-10,LIG,7885,3559,4326,6887,914,84,ITC,ITC3,7,Liguria,Liguria,1550640,1303112,84.04,0.51
2453,2021-01-17,LIG,866,301,565,865,0,1,ITC,ITC3,7,Liguria,Liguria,1550640,1303978,84.09,0.06
2454,2021-03-23,LIG,9273,4221,5052,5981,3209,83,ITC,ITC3,7,Liguria,Liguria,1550640,1313251,84.69,0.6
2455,2021-02-01,LIG,2558,922,1636,90,2468,0,ITC,ITC3,7,Liguria,Liguria,1550640,1315809,84.86,0.16
2456,2021-07-08,LIG,4390,2175,2215,1831,2552,7,ITC,ITC3,7,Liguria,Liguria,1550640,1320199,85.14,0.28
2457,2021-05-12,LIG,12032,5450,6582,6572,5347,113,ITC,ITC3,7,Liguria,Liguria,1550640,1332231,85.91,0.78
2458,2021-05-26,LIG,16655,8411,8244,12125,4373,157,ITC,ITC3,7,Liguria,Liguria,1550640,1348886,86.99,1.07
2459,2021-03-30,LIG,12211,5426,6785,8734,3388,89,ITC,ITC3,7,Liguria,Liguria,1550640,1361097,87.78,0.79
2460,2021-04-06,LIG,13246,5902,7344,10879,2260,107,ITC,ITC3,7,Liguria,Liguria,1550640,1374343,88.63,0.85
2461,2021-02-08,LIG,1977,741,1236,306,1671,0,ITC,ITC3,7,Liguria,Liguria,1550640,1376320,88.76,0.13
2462,2020-12-27,LIG,135,56,79,134,0,1,ITC,ITC3,7,Liguria,Liguria,1550640,1376455,88.77,0.01
2463,2021-02-15,LIG,2262,839,1423,1855,397,10,ITC,ITC3,7,Liguria,Liguria,1550640,1378717,88.91,0.15
2464,2021-01-03,LIG,734,230,504,732,0,2,ITC,ITC3,7,Liguria,Liguria,1550640,1379451,88.96,0.05
2465,2021-01-07,LIG,3226,1095,2131,3223,0,3,ITC,ITC3,7,Liguria,Liguria,1550640,1382677,89.17,0.21
2466,2021-06-13,LIG,5616,2695,2921,5162,454,0,ITC,ITC3,7,Liguria,Liguria,1550640,1388293,89.53,0.36
2467,2021-04-17,LIG,7382,3216,4166,6546,750,86,ITC,ITC3,7,Liguria,Liguria,1550640,1395675,90.01,0.48
2468,2021-05-01,LIG,7142,3256,3886,1303,5800,39,ITC,ITC3,7,Liguria,Liguria,1550640,1402817,90.47,0.46
2469,2021-03-05,LIG,4869,2150,2719,3674,1132,63,ITC,ITC3,7,Liguria,Liguria,1550640,1407686,90.78,0.31
2470,2021-06-06,LIG,3808,2031,1777,2947,861,0,ITC,ITC3,7,Liguria,Liguria,1550640,1411494,91.03,0.25
2471,2021-04-24,LIG,8218,3795,4423,4957,3152,109,ITC,ITC3,7,Liguria,Liguria,1550640,1419712,91.56,0.53
2472,2021-02-26,LIG,3765,1523,2242,3411,329,25,ITC,ITC3,7,Liguria,Liguria,1550640,1423477,91.8,0.24
2473,2021-06-20,LIG,1333,658,675,1051,275,7,ITC,ITC3,7,Liguria,Liguria,1550640,1424810,91.89,0.09
2474,2021-05-07,UMB,10098,4699,5399,6702,3192,204,ITI,ITI2,10,Umbria,Umbria,882015,10098,1.14,1.14
2475,2021-04-23,UMB,6608,2784,3824,3291,3120,197,ITI,ITI2,10,Umbria,Umbria,882015,16706,1.89,0.75
2476,2021-02-25,UMB,1332,495,837,1272,52,8,ITI,ITI2,10,Umbria,Umbria,882015,18038,2.05,0.15
2477,2021-03-11,UMB,3582,1722,1860,2564,1006,12,ITI,ITI2,10,Umbria,Umbria,882015,21620,2.45,0.41
2478,2021-01-13,UMB,449,139,310,449,0,0,ITI,ITI2,10,Umbria,Umbria,882015,22069,2.5,0.05
2479,2021-06-19,UMB,4568,2199,2369,2538,2030,0,ITI,ITI2,10,Umbria,Umbria,882015,26637,3.02,0.52
2480,2021-01-06,UMB,846,325,521,846,0,0,ITI,ITI2,10,Umbria,Umbria,882015,27483,3.12,0.1
2481,2021-06-12,UMB,7708,3683,4025,6130,1577,1,ITI,ITI2,10,Umbria,Umbria,882015,35191,3.99,0.87
2482,2021-04-16,UMB,8096,3740,4356,6082,1838,176,ITI,ITI2,10,Umbria,Umbria,882015,43287,4.91,0.92
2483,2021-04-30,UMB,6250,2971,3279,2732,3397,121,ITI,ITI2,10,Umbria,Umbria,882015,49537,5.62,0.71
2484,2021-03-04,UMB,4484,1855,2629,3643,827,14,ITI,ITI2,10,Umbria,Umbria,882015,54021,6.12,0.51
2485,2021-01-20,UMB,602,221,381,602,0,0,ITI,ITI2,10,Umbria,Umbria,882015,54623,6.19,0.07
2486,2021-04-06,UMB,5287,2165,3122,2863,2387,37,ITI,ITI2,10,Umbria,Umbria,882015,59910,6.79,0.6
2487,2021-03-28,UMB,1095,441,654,1040,24,31,ITI,ITI2,10,Umbria,Umbria,882015,61005,6.92,0.12
2488,2021-01-30,UMB,1575,486,1089,44,1531,0,ITI,ITI2,10,Umbria,Umbria,882015,62580,7.1,0.18
2489,2021-03-23,UMB,3790,1682,2108,2124,1629,37,ITI,ITI2,10,Umbria,Umbria,882015,66370,7.52,0.43
2490,2021-07-01,UMB,9655,4781,4874,3360,6254,41,ITI,ITI2,10,Umbria,Umbria,882015,76025,8.62,1.09
2491,2021-02-08,UMB,635,203,432,88,547,0,ITI,ITI2,10,Umbria,Umbria,882015,76660,8.69,0.07
2492,2021-05-19,UMB,9412,4211,5201,5583,3743,86,ITI,ITI2,10,Umbria,Umbria,882015,86072,9.76,1.07
2493,2021-02-06,UMB,396,138,258,34,362,0,ITI,ITI2,10,Umbria,Umbria,882015,86468,9.8,0.04
2494,2021-02-13,UMB,114,27,87,111,3,0,ITI,ITI2,10,Umbria,Umbria,882015,86582,9.82,0.01
2495,2021-05-24,UMB,9055,4509,4546,8008,879,168,ITI,ITI2,10,Umbria,Umbria,882015,95637,10.84,1.03
2496,2021-04-18,UMB,1531,681,850,578,930,23,ITI,ITI2,10,Umbria,Umbria,882015,97168,11.02,0.17
2497,2021-01-11,UMB,1303,341,962,1303,0,0,ITI,ITI2,10,Umbria,Umbria,882015,98471,11.16,0.15
2498,2021-05-05,UMB,7207,3298,3909,3822,3304,81,ITI,ITI2,10,Umbria,Umbria,882015,105678,11.98,0.82
2499,2021-01-25,UMB,648,323,325,5,643,0,ITI,ITI2,10,Umbria,Umbria,882015,106326,12.05,0.07
2500,2021-04-04,UMB,57,20,37,22,35,0,ITI,ITI2,10,Umbria,Umbria,882015,106383,12.06,0.01
2501,2021-06-14,UMB,5378,2745,2633,3368,2010,0,ITI,ITI2,10,Umbria,Umbria,882015,111761,12.67,0.61
2502,2021-07-03,UMB,6425,3224,3201,2922,3448,55,ITI,ITI2,10,Umbria,Umbria,882015,118186,13.4,0.73
2503,2021-06-02,UMB,3914,1881,2033,3873,40,1,ITI,ITI2,10,Umbria,Umbria,882015,122100,13.84,0.44
2504,2021-02-20,UMB,283,101,182,259,24,0,ITI,ITI2,10,Umbria,Umbria,882015,122383,13.88,0.03
2505,2021-03-09,UMB,4088,2000,2088,2791,1288,9,ITI,ITI2,10,Umbria,Umbria,882015,126471,14.34,0.46
2506,2021-03-18,UMB,2965,1171,1794,1699,1262,4,ITI,ITI2,10,Umbria,Umbria,882015,129436,14.68,0.34
2507,2021-06-26,UMB,9303,4725,4578,5685,3618,0,ITI,ITI2,10,Umbria,Umbria,882015,138739,15.73,1.05
2508,2021-04-20,UMB,5449,2363,3086,3429,1947,73,ITI,ITI2,10,Umbria,Umbria,882015,144188,16.35,0.62
2509,2021-01-27,UMB,840,330,510,13,827,0,ITI,ITI2,10,Umbria,Umbria,882015,145028,16.44,0.1
2510,2021-01-10,UMB,1065,274,791,1065,0,0,ITI,ITI2,10,Umbria,Umbria,882015,146093,16.56,0.12
2511,2021-05-21,UMB,8970,3668,5302,4059,4828,83,ITI,ITI2,10,Umbria,Umbria,882015,155063,17.58,1.02
2512,2021-06-30,UMB,10452,5288,5164,3761,6691,0,ITI,ITI2,10,Umbria,Umbria,882015,165515,18.77,1.19
2513,2021-07-07,UMB,9313,4411,4902,87,9208,18,ITI,ITI2,10,Umbria,Umbria,882015,174828,19.82,1.06
2514,2021-07-08,UMB,4306,2080,2226,90,4190,26,ITI,ITI2,10,Umbria,Umbria,882015,179134,20.31,0.49
2515,2021-05-12,UMB,6487,3024,3463,4193,2146,148,ITI,ITI2,10,Umbria,Umbria,882015,185621,21.05,0.74
2516,2021-03-30,UMB,3976,1729,2247,2400,1540,36,ITI,ITI2,10,Umbria,Umbria,882015,189597,21.5,0.45
2517,2020-12-27,UMB,84,44,40,84,0,0,ITI,ITI2,10,Umbria,Umbria,882015,189681,21.51,0.01
2518,2021-02-22,UMB,1889,807,1082,1803,86,0,ITI,ITI2,10,Umbria,Umbria,882015,191570,21.72,0.21
2519,2021-05-26,UMB,9645,4563,5082,8204,1250,191,ITI,ITI2,10,Umbria,Umbria,882015,201215,22.81,1.09
2520,2021-05-28,UMB,9583,4435,5148,7097,2295,191,ITI,ITI2,10,Umbria,Umbria,882015,210798,23.9,1.09
2521,2021-04-15,UMB,7635,3493,4142,5678,1887,70,ITI,ITI2,10,Umbria,Umbria,882015,218433,24.77,0.87
2522,2021-02-17,UMB,1618,748,870,1266,351,1,ITI,ITI2,10,Umbria,Umbria,882015,220051,24.95,0.18
2523,2021-06-07,UMB,6942,3425,3517,6248,694,0,ITI,ITI2,10,Umbria,Umbria,882015,226993,25.74,0.79
2524,2021-03-16,UMB,3538,1454,2084,1909,1627,2,ITI,ITI2,10,Umbria,Umbria,882015,230531,26.14,0.4
2525,2021-02-27,UMB,1658,354,1304,1642,16,0,ITI,ITI2,10,Umbria,Umbria,882015,232189,26.32,0.19
2526,2021-04-03,UMB,2097,712,1385,1034,1052,11,ITI,ITI2,10,Umbria,Umbria,882015,234286,26.56,0.24
2527,2021-01-08,UMB,1187,344,843,1187,0,0,ITI,ITI2,10,Umbria,Umbria,882015,235473,26.7,0.13
2528,2021-04-25,UMB,4357,1684,2673,3866,82,409,ITI,ITI2,10,Umbria,Umbria,882015,239830,27.19,0.49
2529,2021-06-21,UMB,7494,3926,3568,5157,2337,0,ITI,ITI2,10,Umbria,Umbria,882015,247324,28.04,0.85
2530,2021-01-01,UMB,273,104,169,273,0,0,ITI,ITI2,10,Umbria,Umbria,882015,247597,28.07,0.03
2531,2021-04-11,UMB,3097,1504,1593,3031,49,17,ITI,ITI2,10,Umbria,Umbria,882015,250694,28.42,0.35
2532,2021-01-18,UMB,613,218,395,529,84,0,ITI,ITI2,10,Umbria,Umbria,882015,251307,28.49,0.07
2533,2021-05-30,UMB,5982,2999,2983,5660,202,120,ITI,ITI2,10,Umbria,Umbria,882015,257289,29.17,0.68
2534,2021-03-08,UMB,3696,1822,1874,2323,1361,12,ITI,ITI2,10,Umbria,Umbria,882015,260985,29.59,0.42
2535,2021-06-16,UMB,6316,3093,3223,3222,3093,1,ITI,ITI2,10,Umbria,Umbria,882015,267301,30.31,0.72
2536,2021-03-25,UMB,3898,1698,2200,2794,1063,41,ITI,ITI2,10,Umbria,Umbria,882015,271199,30.75,0.44
2537,2021-05-31,UMB,5802,2837,2965,4837,884,81,ITI,ITI2,10,Umbria,Umbria,882015,277001,31.41,0.66
2538,2021-05-14,UMB,5323,2507,2816,3349,1817,157,ITI,ITI2,10,Umbria,Umbria,882015,282324,32.01,0.6
2539,2021-02-01,UMB,1284,341,943,48,1236,0,ITI,ITI2,10,Umbria,Umbria,882015,283608,32.15,0.15
2540,2021-02-18,UMB,1496,582,914,1029,466,1,ITI,ITI2,10,Umbria,Umbria,882015,285104,32.32,0.17
2541,2021-05-04,UMB,5537,2544,2993,2352,3125,60,ITI,ITI2,10,Umbria,Umbria,882015,290641,32.95,0.63
2542,2021-04-01,UMB,4372,1837,2535,2327,2009,36,ITI,ITI2,10,Umbria,Umbria,882015,295013,33.45,0.5
2543,2021-03-01,UMB,1504,774,730,1384,114,6,ITI,ITI2,10,Umbria,Umbria,882015,296517,33.62,0.17
2544,2021-06-09,UMB,8061,3907,4154,7340,721,0,ITI,ITI2,10,Umbria,Umbria,882015,304578,34.53,0.91
2545,2021-06-23,UMB,11191,5715,5476,7796,3395,0,ITI,ITI2,10,Umbria,Umbria,882015,315769,35.8,1.27
2546,2021-03-15,UMB,4594,1938,2656,2825,1766,3,ITI,ITI2,10,Umbria,Umbria,882015,320363,36.32,0.52
2547,2021-02-10,UMB,714,348,366,699,15,0,ITI,ITI2,10,Umbria,Umbria,882015,321077,36.4,0.08
2548,2021-06-11,UMB,6909,3468,3441,6143,766,0,ITI,ITI2,10,Umbria,Umbria,882015,327986,37.19,0.78
2549,2021-04-08,UMB,5863,2509,3354,4006,1789,68,ITI,ITI2,10,Umbria,Umbria,882015,333849,37.85,0.66
2550,2021-06-04,UMB,8905,4401,4504,7709,1194,2,ITI,ITI2,10,Umbria,Umbria,882015,342754,38.86,1.01
2551,2021-06-13,UMB,6763,3556,3207,6533,230,0,ITI,ITI2,10,Umbria,Umbria,882015,349517,39.63,0.77
2552,2021-05-01,UMB,5370,2638,2732,2096,3230,44,ITI,ITI2,10,Umbria,Umbria,882015,354887,40.24,0.61
2553,2021-03-05,UMB,4618,1402,3216,3947,656,15,ITI,ITI2,10,Umbria,Umbria,882015,359505,40.76,0.52
2554,2021-03-03,UMB,4431,1770,2661,3718,710,3,ITI,ITI2,10,Umbria,Umbria,882015,363936,41.26,0.5
2555,2021-06-06,UMB,7608,3904,3704,6913,693,2,ITI,ITI2,10,Umbria,Umbria,882015,371544,42.12,0.86
2556,2021-04-13,UMB,7674,3396,4278,5917,1668,89,ITI,ITI2,10,Umbria,Umbria,882015,379218,42.99,0.87
2557,2021-02-15,UMB,1367,692,675,1364,1,2,ITI,ITI2,10,Umbria,Umbria,882015,380585,43.15,0.15
2558,2021-01-03,UMB,270,112,158,270,0,0,ITI,ITI2,10,Umbria,Umbria,882015,380855,43.18,0.03
2559,2021-04-22,UMB,5445,2247,3198,2701,2664,80,ITI,ITI2,10,Umbria,Umbria,882015,386300,43.8,0.62
2560,2021-05-23,UMB,5067,1854,3213,634,4416,17,ITI,ITI2,10,Umbria,Umbria,882015,391367,44.37,0.57
2561,2021-03-17,UMB,3329,1313,2016,1855,1472,2,ITI,ITI2,10,Umbria,Umbria,882015,394696,44.75,0.38
2562,2021-01-07,UMB,1300,387,913,1300,0,0,ITI,ITI2,10,Umbria,Umbria,882015,395996,44.9,0.15
2563,2021-06-25,UMB,10096,5227,4869,5390,4705,1,ITI,ITI2,10,Umbria,Umbria,882015,406092,46.04,1.14
2564,2021-01-26,UMB,815,389,426,17,798,0,ITI,ITI2,10,Umbria,Umbria,882015,406907,46.13,0.09
2565,2021-02-12,UMB,670,224,446,664,6,0,ITI,ITI2,10,Umbria,Umbria,882015,407577,46.21,0.08
2566,2021-02-26,UMB,660,253,407,650,8,2,ITI,ITI2,10,Umbria,Umbria,882015,408237,46.28,0.07
2567,2021-05-11,UMB,6231,2833,3398,3897,2193,141,ITI,ITI2,10,Umbria,Umbria,882015,414468,46.99,0.71
2568,2021-05-16,UMB,5218,2492,2726,5087,49,82,ITI,ITI2,10,Umbria,Umbria,882015,419686,47.58,0.59
2569,2021-04-27,UMB,5663,2401,3262,3053,2578,32,ITI,ITI2,10,Umbria,Umbria,882015,425349,48.22,0.64
2570,2021-02-03,UMB,724,174,550,67,657,0,ITI,ITI2,10,Umbria,Umbria,882015,426073,48.31,0.08
2571,2021-02-05,UMB,780,234,546,18,762,0,ITI,ITI2,10,Umbria,Umbria,882015,426853,48.4,0.09
2572,2021-07-04,UMB,3403,1739,1664,2410,964,29,ITI,ITI2,10,Umbria,Umbria,882015,430256,48.78,0.39
2573,2021-04-12,UMB,7085,3081,4004,5311,1717,57,ITI,ITI2,10,Umbria,Umbria,882015,437341,49.58,0.8
2574,2021-01-19,UMB,102,23,79,102,0,0,ITI,ITI2,10,Umbria,Umbria,882015,437443,49.6,0.01
2575,2021-04-29,UMB,5214,2248,2966,2805,2320,89,ITI,ITI2,10,Umbria,Umbria,882015,442657,50.19,0.59
2576,2021-03-24,UMB,4103,1792,2311,2743,1323,37,ITI,ITI2,10,Umbria,Umbria,882015,446760,50.65,0.47
2577,2021-07-02,UMB,8658,4281,4377,3042,5526,90,ITI,ITI2,10,Umbria,Umbria,882015,455418,51.63,0.98
2578,2021-04-10,UMB,7389,3477,3912,7173,84,132,ITI,ITI2,10,Umbria,Umbria,882015,462807,52.47,0.84
2579,2021-01-17,UMB,54,17,37,54,0,0,ITI,ITI2,10,Umbria,Umbria,882015,462861,52.48,0.01
2580,2020-12-31,UMB,322,127,195,322,0,0,ITI,ITI2,10,Umbria,Umbria,882015,463183,52.51,0.04
2581,2021-04-17,UMB,6674,3069,3605,5171,1340,163,ITI,ITI2,10,Umbria,Umbria,882015,469857,53.27,0.76
2582,2021-01-05,UMB,854,429,425,854,0,0,ITI,ITI2,10,Umbria,Umbria,882015,470711,53.37,0.1
2583,2021-06-20,UMB,6211,3000,3211,1583,4628,0,ITI,ITI2,10,Umbria,Umbria,882015,476922,54.07,0.7
2584,2021-04-24,UMB,4562,1961,2601,3276,1182,104,ITI,ITI2,10,Umbria,Umbria,882015,481484,54.59,0.52
2585,2021-01-12,UMB,834,247,587,834,0,0,ITI,ITI2,10,Umbria,Umbria,882015,482318,54.68,0.09
2586,2021-03-14,UMB,66,48,18,66,0,0,ITI,ITI2,10,Umbria,Umbria,882015,482384,54.69,0.01
2587,2021-06-22,UMB,8030,4077,3953,5246,2783,1,ITI,ITI2,10,Umbria,Umbria,882015,490414,55.6,0.91
2588,2021-03-12,UMB,2694,1081,1613,2191,495,8,ITI,ITI2,10,Umbria,Umbria,882015,493108,55.91,0.31
2589,2021-03-21,UMB,675,338,337,672,0,3,ITI,ITI2,10,Umbria,Umbria,882015,493783,55.98,0.08
2590,2021-06-29,UMB,9866,5024,4842,4192,5674,0,ITI,ITI2,10,Umbria,Umbria,882015,503649,57.1,1.12
2591,2021-05-17,UMB,6368,3060,3308,4141,2177,50,ITI,ITI2,10,Umbria,Umbria,882015,510017,57.82,0.72
2592,2021-01-14,UMB,722,192,530,722,0,0,ITI,ITI2,10,Umbria,Umbria,882015,510739,57.91,0.08
2593,2021-03-19,UMB,1740,565,1175,1079,656,5,ITI,ITI2,10,Umbria,Umbria,882015,512479,58.1,0.2
2594,2021-01-24,UMB,258,106,152,1,257,0,ITI,ITI2,10,Umbria,Umbria,882015,512737,58.13,0.03
2595,2021-06-08,UMB,7373,3638,3735,6830,543,0,ITI,ITI2,10,Umbria,Umbria,882015,520110,58.97,0.84
2596,2021-05-06,UMB,9451,4313,5138,6013,3314,124,ITI,ITI2,10,Umbria,Umbria,882015,529561,60.04,1.07
2597,2021-06-10,UMB,7457,3718,3739,6684,773,0,ITI,ITI2,10,Umbria,Umbria,882015,537018,60.89,0.85
2598,2021-02-24,UMB,1518,563,955,1503,15,0,ITI,ITI2,10,Umbria,Umbria,882015,538536,61.06,0.17
2599,2021-07-06,UMB,8557,4078,4479,142,8395,20,ITI,ITI2,10,Umbria,Umbria,882015,547093,62.03,0.97
2600,2021-05-10,UMB,5976,2793,3183,3760,2148,68,ITI,ITI2,10,Umbria,Umbria,882015,553069,62.71,0.68
2601,2021-05-08,UMB,8125,3738,4387,4792,3226,107,ITI,ITI2,10,Umbria,Umbria,882015,561194,63.63,0.92
2602,2021-01-28,UMB,1248,394,854,19,1229,0,ITI,ITI2,10,Umbria,Umbria,882015,562442,63.77,0.14
2603,2021-05-03,UMB,5086,2270,2816,2098,2887,101,ITI,ITI2,10,Umbria,Umbria,882015,567528,64.34,0.58
2604,2021-01-23,UMB,280,100,180,2,278,0,ITI,ITI2,10,Umbria,Umbria,882015,567808,64.38,0.03
2605,2021-01-21,UMB,608,202,406,338,269,1,ITI,ITI2,10,Umbria,Umbria,882015,568416,64.45,0.07
2606,2021-03-29,UMB,3629,1600,2029,2152,1419,58,ITI,ITI2,10,Umbria,Umbria,882015,572045,64.86,0.41
2607,2021-01-31,UMB,1058,276,782,25,1033,0,ITI,ITI2,10,Umbria,Umbria,882015,573103,64.98,0.12
2608,2021-05-25,UMB,8812,4300,4512,7582,1062,168,ITI,ITI2,10,Umbria,Umbria,882015,581915,65.98,1.0
2609,2021-05-18,UMB,7736,3350,4386,3817,3837,82,ITI,ITI2,10,Umbria,Umbria,882015,589651,66.85,0.88
2610,2021-03-22,UMB,3560,1655,1905,2304,1246,10,ITI,ITI2,10,Umbria,Umbria,882015,593211,67.26,0.4
2611,2021-04-05,UMB,4248,1728,2520,2181,2055,12,ITI,ITI2,10,Umbria,Umbria,882015,597459,67.74,0.48
2612,2021-02-07,UMB,54,17,37,1,53,0,ITI,ITI2,10,Umbria,Umbria,882015,597513,67.74,0.01
2613,2021-06-15,UMB,5975,3011,2964,3909,2066,0,ITI,ITI2,10,Umbria,Umbria,882015,603488,68.42,0.68
2614,2021-06-17,UMB,6944,3518,3426,4881,2055,8,ITI,ITI2,10,Umbria,Umbria,882015,610432,69.21,0.79
2615,2021-03-26,UMB,4588,1712,2876,4345,172,71,ITI,ITI2,10,Umbria,Umbria,882015,615020,69.73,0.52
2616,2021-01-02,UMB,304,111,193,304,0,0,ITI,ITI2,10,Umbria,Umbria,882015,615324,69.76,0.03
2617,2021-03-07,UMB,845,180,665,837,7,1,ITI,ITI2,10,Umbria,Umbria,882015,616169,69.86,0.1
2618,2021-05-29,UMB,7852,3608,4244,6167,1566,119,ITI,ITI2,10,Umbria,Umbria,882015,624021,70.75,0.89
2619,2021-06-05,UMB,8221,3775,4446,5566,2654,1,ITI,ITI2,10,Umbria,Umbria,882015,632242,71.68,0.93
2620,2021-06-27,UMB,7455,3730,3725,1768,5687,0,ITI,ITI2,10,Umbria,Umbria,882015,639697,72.53,0.85
2621,2021-03-27,UMB,4251,1513,2738,3855,340,56,ITI,ITI2,10,Umbria,Umbria,882015,643948,73.01,0.48
2622,2021-06-18,UMB,4769,2353,2416,1615,3153,1,ITI,ITI2,10,Umbria,Umbria,882015,648717,73.55,0.54
2623,2021-07-05,UMB,8344,4041,4303,161,8177,6,ITI,ITI2,10,Umbria,Umbria,882015,657061,74.5,0.95
2624,2021-04-21,UMB,5318,2316,3002,3053,2227,38,ITI,ITI2,10,Umbria,Umbria,882015,662379,75.1,0.6
2625,2021-03-02,UMB,3641,1346,2295,3634,4,3,ITI,ITI2,10,Umbria,Umbria,882015,666020,75.51,0.41
2626,2021-06-24,UMB,10123,5105,5018,6136,3987,0,ITI,ITI2,10,Umbria,Umbria,882015,676143,76.66,1.15
2627,2021-02-11,UMB,839,348,491,834,5,0,ITI,ITI2,10,Umbria,Umbria,882015,676982,76.75,0.1
2628,2021-05-22,UMB,6960,2752,4208,2594,4319,47,ITI,ITI2,10,Umbria,Umbria,882015,683942,77.54,0.79
2629,2021-04-02,UMB,4343,1778,2565,3545,755,43,ITI,ITI2,10,Umbria,Umbria,882015,688285,78.04,0.49
2630,2021-01-09,UMB,1717,495,1222,1717,0,0,ITI,ITI2,10,Umbria,Umbria,882015,690002,78.23,0.19
2631,2021-04-19,UMB,5033,2226,2807,2930,2048,55,ITI,ITI2,10,Umbria,Umbria,882015,695035,78.8,0.57
2632,2021-05-13,UMB,5914,2657,3257,3701,2083,130,ITI,ITI2,10,Umbria,Umbria,882015,700949,79.47,0.67
2633,2021-02-19,UMB,743,293,450,525,217,1,ITI,ITI2,10,Umbria,Umbria,882015,701692,79.56,0.08
2634,2021-06-01,UMB,4381,2089,2292,4226,155,0,ITI,ITI2,10,Umbria,Umbria,882015,706073,80.05,0.5
2635,2021-03-10,UMB,4031,1943,2088,2760,1256,15,ITI,ITI2,10,Umbria,Umbria,882015,710104,80.51,0.46
2636,2021-01-16,UMB,217,71,146,216,0,1,ITI,ITI2,10,Umbria,Umbria,882015,710321,80.53,0.02
2637,2021-02-02,UMB,942,272,670,32,910,0,ITI,ITI2,10,Umbria,Umbria,882015,711263,80.64,0.11
2638,2021-04-26,UMB,5390,2337,3053,3098,2251,41,ITI,ITI2,10,Umbria,Umbria,882015,716653,81.25,0.61
2639,2021-04-09,UMB,6731,3125,3606,6406,209,116,ITI,ITI2,10,Umbria,Umbria,882015,723384,82.01,0.76
2640,2021-04-28,UMB,5379,2327,3052,2938,2395,46,ITI,ITI2,10,Umbria,Umbria,882015,728763,82.62,0.61
2641,2021-02-04,UMB,733,226,507,25,708,0,ITI,ITI2,10,Umbria,Umbria,882015,729496,82.71,0.08
2642,2021-05-15,UMB,4990,1882,3108,1764,3164,62,ITI,ITI2,10,Umbria,Umbria,882015,734486,83.27,0.57
2643,2021-03-06,UMB,4304,1146,3158,4134,138,32,ITI,ITI2,10,Umbria,Umbria,882015,738790,83.76,0.49
2644,2021-01-22,UMB,276,105,171,32,244,0,ITI,ITI2,10,Umbria,Umbria,882015,739066,83.79,0.03
2645,2021-06-28,UMB,9675,4782,4893,3778,5897,0,ITI,ITI2,10,Umbria,Umbria,882015,748741,84.89,1.1
2646,2021-05-02,UMB,3780,1866,1914,1294,2454,32,ITI,ITI2,10,Umbria,Umbria,882015,752521,85.32,0.43
2647,2021-03-20,UMB,2319,845,1474,2290,25,4,ITI,ITI2,10,Umbria,Umbria,882015,754840,85.58,0.26
2648,2021-03-13,UMB,1734,523,1211,1485,249,0,ITI,ITI2,10,Umbria,Umbria,882015,756574,85.78,0.2
2649,2021-01-15,UMB,695,213,482,695,0,0,ITI,ITI2,10,Umbria,Umbria,882015,757269,85.86,0.08
2650,2021-01-29,UMB,1230,348,882,79,1151,0,ITI,ITI2,10,Umbria,Umbria,882015,758499,86.0,0.14
2651,2021-05-09,UMB,5753,2752,3001,5242,391,120,ITI,ITI2,10,Umbria,Umbria,882015,764252,86.65,0.65
2652,2021-05-20,UMB,9831,4585,5246,6100,3650,81,ITI,ITI2,10,Umbria,Umbria,882015,774083,87.76,1.11
2653,2021-03-31,UMB,3897,1728,2169,2179,1686,32,ITI,ITI2,10,Umbria,Umbria,882015,777980,88.2,0.44
2654,2021-02-16,UMB,1308,655,653,1299,9,0,ITI,ITI2,10,Umbria,Umbria,882015,779288,88.35,0.15
2655,2021-05-27,UMB,9965,4864,5101,8465,1317,183,ITI,ITI2,10,Umbria,Umbria,882015,789253,89.48,1.13
2656,2021-01-04,UMB,809,398,411,809,0,0,ITI,ITI2,10,Umbria,Umbria,882015,790062,89.57,0.09
2657,2021-04-14,UMB,8152,3680,4472,6096,1979,77,ITI,ITI2,10,Umbria,Umbria,882015,798214,90.5,0.92
2658,2021-06-03,UMB,9035,4466,4569,8747,288,0,ITI,ITI2,10,Umbria,Umbria,882015,807249,91.52,1.02
2659,2021-04-07,UMB,5572,2292,3280,3482,2005,85,ITI,ITI2,10,Umbria,Umbria,882015,812821,92.16,0.63
2660,2021-02-23,UMB,1691,657,1034,1649,42,0,ITI,ITI2,10,Umbria,Umbria,882015,814512,92.35,0.19
2661,2021-06-20,PAB,5226,2842,2384,610,4592,24,ITH,ITH1,4,Provincia Autonoma Bolzano / Bozen,P.A. Bolzano,533050,5226,0.98,0.98
2662,2021-02-07,PAB,2362,1058,1304,14,2348,0,ITH,ITH1,4,Provincia Autonoma Bolzano / Bozen,P.A. Bolzano,533050,7588,1.42,0.44
2663,2021-05-18,PAB,3342,1753,1589,2134,1186,22,ITH,ITH1,4,Provincia Autonoma Bolzano / Bozen,P.A. Bolzano,533050,10930,2.05,0.63
2664,2021-01-24,PAB,12,10,2,0,12,0,ITH,ITH1,4,Provincia Autonoma Bolzano / Bozen,P.A. Bolzano,533050,10942,2.05,0.0
2665,2021-07-04,PAB,4412,2129,2283,188,4224,0,ITH,ITH1,4,Provincia Autonoma Bolzano / Bozen,P.A. Bolzano,533050,15354,2.88,0.83
2666,2021-02-12,PAB,730,217,513,482,248,0,ITH,ITH1,4,Provincia Autonoma Bolzano / Bozen,P.A. Bolzano,533050,16084,3.02,0.14
2667,2021-04-10,PAB,5396,2666,2730,4802,588,6,ITH,ITH1,4,Provincia Autonoma Bolzano / Bozen,P.A. Bolzano,533050,21480,4.03,1.01
2668,2020-12-31,PAB,913,519,394,913,0,0,ITH,ITH1,4,Provincia Autonoma Bolzano / Bozen,P.A. Bolzano,533050,22393,4.2,0.17
2669,2021-04-19,PAB,1872,858,1014,1688,182,2,ITH,ITH1,4,Provincia Autonoma Bolzano / Bozen,P.A. Bolzano,533050,24265,4.55,0.35
2670,2021-06-15,PAB,2017,1165,852,486,1531,0,ITH,ITH1,4,Provincia Autonoma Bolzano / Bozen,P.A. Bolzano,533050,26282,4.93,0.38
2671,2021-04-17,PAB,5239,2602,2637,5182,44,13,ITH,ITH1,4,Provincia Autonoma Bolzano / Bozen,P.A. Bolzano,533050,31521,5.91,0.98
2672,2021-01-07,PAB,918,327,591,918,0,0,ITH,ITH1,4,Provincia Autonoma Bolzano / Bozen,P.A. Bolzano,533050,32439,6.09,0.17
2673,2021-06-06,PAB,4530,2176,2354,855,3675,0,ITH,ITH1,4,Provincia Autonoma Bolzano / Bozen,P.A. Bolzano,533050,36969,6.94,0.85
2674,2021-02-26,PAB,1526,551,975,1493,30,3,ITH,ITH1,4,Provincia Autonoma Bolzano / Bozen,P.A. Bolzano,533050,38495,7.22,0.29
2675,2021-06-01,PAB,3559,2318,1241,2087,1472,0,ITH,ITH1,4,Provincia Autonoma Bolzano / Bozen,P.A. Bolzano,533050,42054,7.89,0.67
2676,2021-02-19,PAB,2252,512,1740,2241,11,0,ITH,ITH1,4,Provincia Autonoma Bolzano / Bozen,P.A. Bolzano,533050,44306,8.31,0.42
2677,2021-05-20,PAB,4726,2336,2390,3229,1469,28,ITH,ITH1,4,Provincia Autonoma Bolzano / Bozen,P.A. Bolzano,533050,49032,9.2,0.89
2678,2021-03-31,PAB,1832,694,1138,821,1011,0,ITH,ITH1,4,Provincia Autonoma Bolzano / Bozen,P.A. Bolzano,533050,50864,9.54,0.34
2679,2021-01-26,PAB,810,291,519,1,809,0,ITH,ITH1,4,Provincia Autonoma Bolzano / Bozen,P.A. Bolzano,533050,51674,9.69,0.15
2680,2021-07-02,PAB,3195,1657,1538,1023,2172,0,ITH,ITH1,4,Provincia Autonoma Bolzano / Bozen,P.A. Bolzano,533050,54869,10.29,0.6
2681,2021-03-24,PAB,2064,999,1065,2049,13,2,ITH,ITH1,4,Provincia Autonoma Bolzano / Bozen,P.A. Bolzano,533050,56933,10.68,0.39
2682,2021-03-10,PAB,1268,529,739,1123,143,2,ITH,ITH1,4,Provincia Autonoma Bolzano / Bozen,P.A. Bolzano,533050,58201,10.92,0.24
2683,2021-05-06,PAB,5181,2747,2434,2591,2568,22,ITH,ITH1,4,Provincia Autonoma Bolzano / Bozen,P.A. Bolzano,533050,63382,11.89,0.97
2684,2021-04-24,PAB,5106,2450,2656,4602,485,19,ITH,ITH1,4,Provincia Autonoma Bolzano / Bozen,P.A. Bolzano,533050,68488,12.85,0.96
2685,2021-04-05,PAB,301,144,157,22,278,1,ITH,ITH1,4,Provincia Autonoma Bolzano / Bozen,P.A. Bolzano,533050,68789,12.9,0.06
2686,2021-06-27,PAB,4421,2311,2110,615,3806,0,ITH,ITH1,4,Provincia Autonoma Bolzano / Bozen,P.A. Bolzano,533050,73210,13.73,0.83
2687,2021-01-12,PAB,1709,459,1250,1709,0,0,ITH,ITH1,4,Provincia Autonoma Bolzano / Bozen,P.A. Bolzano,533050,74919,14.05,0.32
2688,2021-03-22,PAB,1144,523,621,1138,5,1,ITH,ITH1,4,Provincia Autonoma Bolzano / Bozen,P.A. Bolzano,533050,76063,14.27,0.21
2689,2021-03-05,PAB,1840,625,1215,1395,443,2,ITH,ITH1,4,Provincia Autonoma Bolzano / Bozen,P.A. Bolzano,533050,77903,14.61,0.35
2690,2021-05-01,PAB,2104,1067,1037,1940,160,4,ITH,ITH1,4,Provincia Autonoma Bolzano / Bozen,P.A. Bolzano,533050,80007,15.01,0.39
2691,2021-03-12,PAB,1664,734,930,1250,413,1,ITH,ITH1,4,Provincia Autonoma Bolzano / Bozen,P.A. Bolzano,533050,81671,15.32,0.31
2692,2021-03-29,PAB,1171,499,672,411,759,1,ITH,ITH1,4,Provincia Autonoma Bolzano / Bozen,P.A. Bolzano,533050,82842,15.54,0.22
2693,2021-05-15,PAB,7005,3691,3314,6679,294,32,ITH,ITH1,4,Provincia Autonoma Bolzano / Bozen,P.A. Bolzano,533050,89847,16.86,1.31
2694,2021-02-04,PAB,1958,593,1365,8,1950,0,ITH,ITH1,4,Provincia Autonoma Bolzano / Bozen,P.A. Bolzano,533050,91805,17.22,0.37
2695,2021-04-12,PAB,2105,946,1159,2095,7,3,ITH,ITH1,4,Provincia Autonoma Bolzano / Bozen,P.A. Bolzano,533050,93910,17.62,0.39
2696,2021-03-07,PAB,114,13,101,9,105,0,ITH,ITH1,4,Provincia Autonoma Bolzano / Bozen,P.A. Bolzano,533050,94024,17.64,0.02
2697,2021-04-21,PAB,3013,1468,1545,2156,848,9,ITH,ITH1,4,Provincia Autonoma Bolzano / Bozen,P.A. Bolzano,533050,97037,18.2,0.57
2698,2021-06-24,PAB,3916,2026,1890,1727,2189,0,ITH,ITH1,4,Provincia Autonoma Bolzano / Bozen,P.A. Bolzano,533050,100953,18.94,0.73
2699,2021-06-08,PAB,4149,2118,2031,832,3317,0,ITH,ITH1,4,Provincia Autonoma Bolzano / Bozen,P.A. Bolzano,533050,105102,19.72,0.78
2700,2021-04-28,PAB,2464,1302,1162,2444,5,15,ITH,ITH1,4,Provincia Autonoma Bolzano / Bozen,P.A. Bolzano,533050,107566,20.18,0.46
2701,2021-01-05,PAB,830,286,544,830,0,0,ITH,ITH1,4,Provincia Autonoma Bolzano / Bozen,P.A. Bolzano,533050,108396,20.34,0.16
2702,2021-01-23,PAB,197,117,80,0,197,0,ITH,ITH1,4,Provincia Autonoma Bolzano / Bozen,P.A. Bolzano,533050,108593,20.37,0.04
2703,2021-05-03,PAB,1830,847,983,416,1413,1,ITH,ITH1,4,Provincia Autonoma Bolzano / Bozen,P.A. Bolzano,533050,110423,20.72,0.34
2704,2021-02-23,PAB,769,324,445,763,6,0,ITH,ITH1,4,Provincia Autonoma Bolzano / Bozen,P.A. Bolzano,533050,111192,20.86,0.14
2705,2021-05-17,PAB,3139,1516,1623,2436,694,9,ITH,ITH1,4,Provincia Autonoma Bolzano / Bozen,P.A. Bolzano,533050,114331,21.45,0.59
2706,2021-06-03,PAB,4722,2566,2156,3775,947,0,ITH,ITH1,4,Provincia Autonoma Bolzano / Bozen,P.A. Bolzano,533050,119053,22.33,0.89
2707,2021-03-17,PAB,582,213,369,580,2,0,ITH,ITH1,4,Provincia Autonoma Bolzano / Bozen,P.A. Bolzano,533050,119635,22.44,0.11
2708,2021-05-13,PAB,2995,1355,1640,1059,1930,6,ITH,ITH1,4,Provincia Autonoma Bolzano / Bozen,P.A. Bolzano,533050,122630,23.01,0.56
2709,2021-04-29,PAB,2631,1351,1280,1925,694,12,ITH,ITH1,4,Provincia Autonoma Bolzano / Bozen,P.A. Bolzano,533050,125261,23.5,0.49
2710,2021-01-19,PAB,853,371,482,723,130,0,ITH,ITH1,4,Provincia Autonoma Bolzano / Bozen,P.A. Bolzano,533050,126114,23.66,0.16
2711,2021-06-25,PAB,4159,2293,1866,1153,3006,0,ITH,ITH1,4,Provincia Autonoma Bolzano / Bozen,P.A. Bolzano,533050,130273,24.44,0.78
2712,2021-02-09,PAB,317,126,191,1,316,0,ITH,ITH1,4,Provincia Autonoma Bolzano / Bozen,P.A. Bolzano,533050,130590,24.5,0.06
2713,2021-06-29,PAB,1873,1010,863,257,1616,0,ITH,ITH1,4,Provincia Autonoma Bolzano / Bozen,P.A. Bolzano,533050,132463,24.85,0.35
2714,2021-03-21,PAB,768,285,483,14,754,0,ITH,ITH1,4,Provincia Autonoma Bolzano / Bozen,P.A. Bolzano,533050,133231,24.99,0.14
2715,2021-06-12,PAB,5038,2733,2305,1750,3288,0,ITH,ITH1,4,Provincia Autonoma Bolzano / Bozen,P.A. Bolzano,533050,138269,25.94,0.95
2716,2021-01-14,PAB,1946,575,1371,1946,0,0,ITH,ITH1,4,Provincia Autonoma Bolzano / Bozen,P.A. Bolzano,533050,140215,26.3,0.37
2717,2021-04-07,PAB,1798,823,975,1255,540,3,ITH,ITH1,4,Provincia Autonoma Bolzano / Bozen,P.A. Bolzano,533050,142013,26.64,0.34
2718,2021-05-27,PAB,6087,3200,2887,4020,2010,57,ITH,ITH1,4,Provincia Autonoma Bolzano / Bozen,P.A. Bolzano,533050,148100,27.78,1.14
2719,2021-06-13,PAB,3682,2049,1633,490,3192,0,ITH,ITH1,4,Provincia Autonoma Bolzano / Bozen,P.A. Bolzano,533050,151782,28.47,0.69
2720,2021-05-25,PAB,3839,1992,1847,2935,886,18,ITH,ITH1,4,Provincia Autonoma Bolzano / Bozen,P.A. Bolzano,533050,155621,29.19,0.72
2721,2021-02-14,PAB,297,130,167,297,0,0,ITH,ITH1,4,Provincia Autonoma Bolzano / Bozen,P.A. Bolzano,533050,155918,29.25,0.06
2722,2021-05-08,PAB,4427,2382,2045,3749,663,15,ITH,ITH1,4,Provincia Autonoma Bolzano / Bozen,P.A. Bolzano,533050,160345,30.08,0.83
2723,2021-03-03,PAB,1181,395,786,1168,13,0,ITH,ITH1,4,Provincia Autonoma Bolzano / Bozen,P.A. Bolzano,533050,161526,30.3,0.22
2724,2021-01-21,PAB,953,442,511,139,814,0,ITH,ITH1,4,Provincia Autonoma Bolzano / Bozen,P.A. Bolzano,533050,162479,30.48,0.18
2725,2021-06-05,PAB,6069,3023,3046,4974,1095,0,ITH,ITH1,4,Provincia Autonoma Bolzano / Bozen,P.A. Bolzano,533050,168548,31.62,1.14
2726,2021-01-09,PAB,612,326,286,612,0,0,ITH,ITH1,4,Provincia Autonoma Bolzano / Bozen,P.A. Bolzano,533050,169160,31.73,0.11
2727,2021-06-17,PAB,1757,976,781,679,1078,0,ITH,ITH1,4,Provincia Autonoma Bolzano / Bozen,P.A. Bolzano,533050,170917,32.06,0.33
2728,2021-01-02,PAB,91,48,43,91,0,0,ITH,ITH1,4,Provincia Autonoma Bolzano / Bozen,P.A. Bolzano,533050,171008,32.08,0.02
2729,2021-06-26,PAB,4523,2319,2204,1451,3072,0,ITH,ITH1,4,Provincia Autonoma Bolzano / Bozen,P.A. Bolzano,533050,175531,32.93,0.85
2730,2021-03-18,PAB,1302,531,771,226,1076,0,ITH,ITH1,4,Provincia Autonoma Bolzano / Bozen,P.A. Bolzano,533050,176833,33.17,0.24
2731,2021-05-14,PAB,5134,2320,2814,3086,2037,11,ITH,ITH1,4,Provincia Autonoma Bolzano / Bozen,P.A. Bolzano,533050,181967,34.14,0.96
2732,2021-03-16,PAB,1290,532,758,124,1166,0,ITH,ITH1,4,Provincia Autonoma Bolzano / Bozen,P.A. Bolzano,533050,183257,34.38,0.24
2733,2021-05-12,PAB,3792,2058,1734,3621,153,18,ITH,ITH1,4,Provincia Autonoma Bolzano / Bozen,P.A. Bolzano,533050,187049,35.09,0.71
2734,2021-02-01,PAB,1452,440,1012,12,1440,0,ITH,ITH1,4,Provincia Autonoma Bolzano / Bozen,P.A. Bolzano,533050,188501,35.36,0.27
2735,2021-01-16,PAB,2840,1265,1575,2840,0,0,ITH,ITH1,4,Provincia Autonoma Bolzano / Bozen,P.A. Bolzano,533050,191341,35.9,0.53
2736,2021-06-10,PAB,4443,2307,2136,1348,3095,0,ITH,ITH1,4,Provincia Autonoma Bolzano / Bozen,P.A. Bolzano,533050,195784,36.73,0.83
2737,2021-04-26,PAB,1543,771,772,1532,5,6,ITH,ITH1,4,Provincia Autonoma Bolzano / Bozen,P.A. Bolzano,533050,197327,37.02,0.29
2738,2021-07-06,PAB,1573,843,730,614,959,0,ITH,ITH1,4,Provincia Autonoma Bolzano / Bozen,P.A. Bolzano,533050,198900,37.31,0.3
2739,2021-06-22,PAB,2451,1409,1042,335,2116,0,ITH,ITH1,4,Provincia Autonoma Bolzano / Bozen,P.A. Bolzano,533050,201351,37.77,0.46
2740,2021-03-14,PAB,758,336,422,25,733,0,ITH,ITH1,4,Provincia Autonoma Bolzano / Bozen,P.A. Bolzano,533050,202109,37.92,0.14
2741,2021-04-14,PAB,3593,1645,1948,3488,91,14,ITH,ITH1,4,Provincia Autonoma Bolzano / Bozen,P.A. Bolzano,533050,205702,38.59,0.67
2742,2021-01-04,PAB,508,201,307,508,0,0,ITH,ITH1,4,Provincia Autonoma Bolzano / Bozen,P.A. Bolzano,533050,206210,38.68,0.1
2743,2021-02-06,PAB,2626,1171,1455,18,2607,1,ITH,ITH1,4,Provincia Autonoma Bolzano / Bozen,P.A. Bolzano,533050,208836,39.18,0.49
2744,2021-06-21,PAB,3162,1612,1550,295,2867,0,ITH,ITH1,4,Provincia Autonoma Bolzano / Bozen,P.A. Bolzano,533050,211998,39.77,0.59
2745,2021-03-28,PAB,569,212,357,11,558,0,ITH,ITH1,4,Provincia Autonoma Bolzano / Bozen,P.A. Bolzano,533050,212567,39.88,0.11
2746,2021-04-02,PAB,2077,837,1240,718,1357,2,ITH,ITH1,4,Provincia Autonoma Bolzano / Bozen,P.A. Bolzano,533050,214644,40.27,0.39
2747,2021-05-29,PAB,7134,3768,3366,3967,3140,27,ITH,ITH1,4,Provincia Autonoma Bolzano / Bozen,P.A. Bolzano,533050,221778,41.61,1.34
2748,2021-03-26,PAB,1657,733,924,523,1134,0,ITH,ITH1,4,Provincia Autonoma Bolzano / Bozen,P.A. Bolzano,533050,223435,41.92,0.31
2749,2021-04-09,PAB,2937,1301,1636,2200,730,7,ITH,ITH1,4,Provincia Autonoma Bolzano / Bozen,P.A. Bolzano,533050,226372,42.47,0.55
2750,2021-05-22,PAB,6821,3553,3268,4620,2166,35,ITH,ITH1,4,Provincia Autonoma Bolzano / Bozen,P.A. Bolzano,533050,233193,43.75,1.28
2751,2021-02-11,PAB,1094,432,662,239,855,0,ITH,ITH1,4,Provincia Autonoma Bolzano / Bozen,P.A. Bolzano,533050,234287,43.95,0.21
2752,2021-05-10,PAB,3018,1300,1718,1412,1605,1,ITH,ITH1,4,Provincia Autonoma Bolzano / Bozen,P.A. Bolzano,533050,237305,44.52,0.57
2753,2021-02-16,PAB,530,205,325,530,0,0,ITH,ITH1,4,Provincia Autonoma Bolzano / Bozen,P.A. Bolzano,533050,237835,44.62,0.1
2754,2021-01-28,PAB,871,308,563,9,862,0,ITH,ITH1,4,Provincia Autonoma Bolzano / Bozen,P.A. Bolzano,533050,238706,44.78,0.16
2755,2021-04-25,PAB,3073,1497,1576,2398,672,3,ITH,ITH1,4,Provincia Autonoma Bolzano / Bozen,P.A. Bolzano,533050,241779,45.36,0.58
2756,2021-01-13,PAB,1691,557,1134,1691,0,0,ITH,ITH1,4,Provincia Autonoma Bolzano / Bozen,P.A. Bolzano,533050,243470,45.67,0.32
2757,2021-01-30,PAB,498,245,253,4,494,0,ITH,ITH1,4,Provincia Autonoma Bolzano / Bozen,P.A. Bolzano,533050,243968,45.77,0.09
2758,2021-04-23,PAB,4543,2151,2392,3243,1291,9,ITH,ITH1,4,Provincia Autonoma Bolzano / Bozen,P.A. Bolzano,533050,248511,46.62,0.85
2759,2021-01-18,PAB,1772,687,1085,1767,5,0,ITH,ITH1,4,Provincia Autonoma Bolzano / Bozen,P.A. Bolzano,533050,250283,46.95,0.33
2760,2021-05-07,PAB,4193,2061,2132,3649,528,16,ITH,ITH1,4,Provincia Autonoma Bolzano / Bozen,P.A. Bolzano,533050,254476,47.74,0.79
2761,2021-07-03,PAB,5629,2790,2839,1072,4557,0,ITH,ITH1,4,Provincia Autonoma Bolzano / Bozen,P.A. Bolzano,533050,260105,48.8,1.06
2762,2021-05-05,PAB,4154,1945,2209,2025,2116,13,ITH,ITH1,4,Provincia Autonoma Bolzano / Bozen,P.A. Bolzano,533050,264259,49.57,0.78
2763,2021-01-25,PAB,487,183,304,3,484,0,ITH,ITH1,4,Provincia Autonoma Bolzano / Bozen,P.A. Bolzano,533050,264746,49.67,0.09
2764,2021-03-23,PAB,1555,760,795,1554,1,0,ITH,ITH1,4,Provincia Autonoma Bolzano / Bozen,P.A. Bolzano,533050,266301,49.96,0.29
2765,2021-04-01,PAB,2787,1407,1380,2638,144,5,ITH,ITH1,4,Provincia Autonoma Bolzano / Bozen,P.A. Bolzano,533050,269088,50.48,0.52
2766,2021-07-05,PAB,2930,1404,1526,949,1981,0,ITH,ITH1,4,Provincia Autonoma Bolzano / Bozen,P.A. Bolzano,533050,272018,51.03,0.55
2767,2021-05-30,PAB,4763,2516,2247,749,4011,3,ITH,ITH1,4,Provincia Autonoma Bolzano / Bozen,P.A. Bolzano,533050,276781,51.92,0.89
2768,2021-04-03,PAB,831,364,467,20,810,1,ITH,ITH1,4,Provincia Autonoma Bolzano / Bozen,P.A. Bolzano,533050,277612,52.08,0.16
2769,2021-03-25,PAB,2150,1063,1087,1706,443,1,ITH,ITH1,4,Provincia Autonoma Bolzano / Bozen,P.A. Bolzano,533050,279762,52.48,0.4
2770,2021-01-27,PAB,85,29,56,2,83,0,ITH,ITH1,4,Provincia Autonoma Bolzano / Bozen,P.A. Bolzano,533050,279847,52.5,0.02
2771,2021-04-30,PAB,3342,1594,1748,1559,1776,7,ITH,ITH1,4,Provincia Autonoma Bolzano / Bozen,P.A. Bolzano,533050,283189,53.13,0.63
2772,2021-01-20,PAB,618,253,365,410,208,0,ITH,ITH1,4,Provincia Autonoma Bolzano / Bozen,P.A. Bolzano,533050,283807,53.24,0.12
2773,2021-01-06,PAB,59,18,41,59,0,0,ITH,ITH1,4,Provincia Autonoma Bolzano / Bozen,P.A. Bolzano,533050,283866,53.25,0.01
2774,2021-03-30,PAB,1299,532,767,219,1080,0,ITH,ITH1,4,Provincia Autonoma Bolzano / Bozen,P.A. Bolzano,533050,285165,53.5,0.24
2775,2021-04-16,PAB,2951,1419,1532,2437,511,3,ITH,ITH1,4,Provincia Autonoma Bolzano / Bozen,P.A. Bolzano,533050,288116,54.05,0.55
2776,2021-07-08,PAB,2513,1287,1226,45,2468,0,ITH,ITH1,4,Provincia Autonoma Bolzano / Bozen,P.A. Bolzano,533050,290629,54.52,0.47
2777,2021-06-19,PAB,5658,3012,2646,624,5034,0,ITH,ITH1,4,Provincia Autonoma Bolzano / Bozen,P.A. Bolzano,533050,296287,55.58,1.06
2778,2021-03-11,PAB,1685,825,860,1136,538,11,ITH,ITH1,4,Provincia Autonoma Bolzano / Bozen,P.A. Bolzano,533050,297972,55.9,0.32
2779,2021-06-04,PAB,6467,3238,3229,4937,1530,0,ITH,ITH1,4,Provincia Autonoma Bolzano / Bozen,P.A. Bolzano,533050,304439,57.11,1.21
2780,2021-02-24,PAB,1367,406,961,1354,12,1,ITH,ITH1,4,Provincia Autonoma Bolzano / Bozen,P.A. Bolzano,533050,305806,57.37,0.26
2781,2021-03-27,PAB,3051,1554,1497,1543,1508,0,ITH,ITH1,4,Provincia Autonoma Bolzano / Bozen,P.A. Bolzano,533050,308857,57.94,0.57
2782,2021-03-13,PAB,2885,1459,1426,2782,101,2,ITH,ITH1,4,Provincia Autonoma Bolzano / Bozen,P.A. Bolzano,533050,311742,58.48,0.54
2783,2021-03-09,PAB,1194,543,651,1192,2,0,ITH,ITH1,4,Provincia Autonoma Bolzano / Bozen,P.A. Bolzano,533050,312936,58.71,0.22
2784,2021-05-23,PAB,4338,2303,2035,4311,8,19,ITH,ITH1,4,Provincia Autonoma Bolzano / Bozen,P.A. Bolzano,533050,317274,59.52,0.81
2785,2021-02-03,PAB,1503,478,1025,5,1498,0,ITH,ITH1,4,Provincia Autonoma Bolzano / Bozen,P.A. Bolzano,533050,318777,59.8,0.28
2786,2021-02-10,PAB,1636,605,1031,26,1610,0,ITH,ITH1,4,Provincia Autonoma Bolzano / Bozen,P.A. Bolzano,533050,320413,60.11,0.31
2787,2021-05-21,PAB,6924,3806,3118,5044,1845,35,ITH,ITH1,4,Provincia Autonoma Bolzano / Bozen,P.A. Bolzano,533050,327337,61.41,1.3
2788,2021-05-16,PAB,2025,932,1093,1329,692,4,ITH,ITH1,4,Provincia Autonoma Bolzano / Bozen,P.A. Bolzano,533050,329362,61.79,0.38
2789,2021-02-18,PAB,1839,457,1382,1832,7,0,ITH,ITH1,4,Provincia Autonoma Bolzano / Bozen,P.A. Bolzano,533050,331201,62.13,0.34
2790,2020-12-30,PAB,388,182,206,388,0,0,ITH,ITH1,4,Provincia Autonoma Bolzano / Bozen,P.A. Bolzano,533050,331589,62.21,0.07
2791,2021-01-11,PAB,1574,513,1061,1574,0,0,ITH,ITH1,4,Provincia Autonoma Bolzano / Bozen,P.A. Bolzano,533050,333163,62.5,0.3
2792,2021-04-06,PAB,2250,1118,1132,2147,103,0,ITH,ITH1,4,Provincia Autonoma Bolzano / Bozen,P.A. Bolzano,533050,335413,62.92,0.42
2793,2021-04-08,PAB,2767,1347,1420,2562,204,1,ITH,ITH1,4,Provincia Autonoma Bolzano / Bozen,P.A. Bolzano,533050,338180,63.44,0.52
2794,2020-12-27,PAB,144,65,79,144,0,0,ITH,ITH1,4,Provincia Autonoma Bolzano / Bozen,P.A. Bolzano,533050,338324,63.47,0.03
2795,2021-06-30,PAB,3060,1564,1496,456,2604,0,ITH,ITH1,4,Provincia Autonoma Bolzano / Bozen,P.A. Bolzano,533050,341384,64.04,0.57
2796,2021-06-11,PAB,5755,2952,2803,2285,3470,0,ITH,ITH1,4,Provincia Autonoma Bolzano / Bozen,P.A. Bolzano,533050,347139,65.12,1.08
2797,2021-03-20,PAB,1758,849,909,1132,625,1,ITH,ITH1,4,Provincia Autonoma Bolzano / Bozen,P.A. Bolzano,533050,348897,65.45,0.33
2798,2021-06-09,PAB,3789,1884,1905,1314,2475,0,ITH,ITH1,4,Provincia Autonoma Bolzano / Bozen,P.A. Bolzano,533050,352686,66.16,0.71
2799,2021-03-01,PAB,922,221,701,918,1,3,ITH,ITH1,4,Provincia Autonoma Bolzano / Bozen,P.A. Bolzano,533050,353608,66.34,0.17
2800,2021-03-15,PAB,1192,451,741,710,482,0,ITH,ITH1,4,Provincia Autonoma Bolzano / Bozen,P.A. Bolzano,533050,354800,66.56,0.22
2801,2021-04-27,PAB,2226,1013,1213,1146,1077,3,ITH,ITH1,4,Provincia Autonoma Bolzano / Bozen,P.A. Bolzano,533050,357026,66.98,0.42
2802,2021-01-17,PAB,2328,1044,1284,2317,11,0,ITH,ITH1,4,Provincia Autonoma Bolzano / Bozen,P.A. Bolzano,533050,359354,67.41,0.44
2803,2021-06-23,PAB,1148,591,557,384,764,0,ITH,ITH1,4,Provincia Autonoma Bolzano / Bozen,P.A. Bolzano,533050,360502,67.63,0.22
2804,2021-04-20,PAB,1562,784,778,1558,2,2,ITH,ITH1,4,Provincia Autonoma Bolzano / Bozen,P.A. Bolzano,533050,362064,67.92,0.29
2805,2021-01-10,PAB,2,2,0,2,0,0,ITH,ITH1,4,Provincia Autonoma Bolzano / Bozen,P.A. Bolzano,533050,362066,67.92,0.0
2806,2021-06-16,PAB,3812,2018,1794,9,3803,0,ITH,ITH1,4,Provincia Autonoma Bolzano / Bozen,P.A. Bolzano,533050,365878,68.64,0.72
2807,2021-03-08,PAB,1210,534,676,1183,27,0,ITH,ITH1,4,Provincia Autonoma Bolzano / Bozen,P.A. Bolzano,533050,367088,68.87,0.23
2808,2021-05-04,PAB,3449,1843,1606,2400,1037,12,ITH,ITH1,4,Provincia Autonoma Bolzano / Bozen,P.A. Bolzano,533050,370537,69.51,0.65
2809,2021-02-25,PAB,1498,549,949,1496,1,1,ITH,ITH1,4,Provincia Autonoma Bolzano / Bozen,P.A. Bolzano,533050,372035,69.79,0.28
2810,2021-06-02,PAB,1444,809,635,987,457,0,ITH,ITH1,4,Provincia Autonoma Bolzano / Bozen,P.A. Bolzano,533050,373479,70.06,0.27
2811,2021-02-08,PAB,2,1,1,1,1,0,ITH,ITH1,4,Provincia Autonoma Bolzano / Bozen,P.A. Bolzano,533050,373481,70.06,0.0
2812,2021-05-19,PAB,3637,1850,1787,1843,1786,8,ITH,ITH1,4,Provincia Autonoma Bolzano / Bozen,P.A. Bolzano,533050,377118,70.75,0.68
2813,2021-01-03,PAB,41,16,25,41,0,0,ITH,ITH1,4,Provincia Autonoma Bolzano / Bozen,P.A. Bolzano,533050,377159,70.75,0.01
2814,2021-04-13,PAB,2394,1132,1262,2385,7,2,ITH,ITH1,4,Provincia Autonoma Bolzano / Bozen,P.A. Bolzano,533050,379553,71.2,0.45
2815,2021-03-02,PAB,695,200,495,692,2,1,ITH,ITH1,4,Provincia Autonoma Bolzano / Bozen,P.A. Bolzano,533050,380248,71.33,0.13
2816,2021-03-19,PAB,1906,773,1133,794,1107,5,ITH,ITH1,4,Provincia Autonoma Bolzano / Bozen,P.A. Bolzano,533050,382154,71.69,0.36
2817,2021-07-01,PAB,4622,2296,2326,1459,3163,0,ITH,ITH1,4,Provincia Autonoma Bolzano / Bozen,P.A. Bolzano,533050,386776,72.56,0.87
2818,2021-06-28,PAB,4607,2304,2303,240,4367,0,ITH,ITH1,4,Provincia Autonoma Bolzano / Bozen,P.A. Bolzano,533050,391383,73.42,0.86
2819,2021-02-05,PAB,3195,1181,2014,8,3187,0,ITH,ITH1,4,Provincia Autonoma Bolzano / Bozen,P.A. Bolzano,533050,394578,74.02,0.6
2820,2021-04-15,PAB,4399,2307,2092,4116,263,20,ITH,ITH1,4,Provincia Autonoma Bolzano / Bozen,P.A. Bolzano,533050,398977,74.85,0.83
2821,2021-05-02,PAB,2457,1288,1169,1531,921,5,ITH,ITH1,4,Provincia Autonoma Bolzano / Bozen,P.A. Bolzano,533050,401434,75.31,0.46
2822,2021-01-22,PAB,248,143,105,124,124,0,ITH,ITH1,4,Provincia Autonoma Bolzano / Bozen,P.A. Bolzano,533050,401682,75.36,0.05
2823,2021-02-22,PAB,526,143,383,514,12,0,ITH,ITH1,4,Provincia Autonoma Bolzano / Bozen,P.A. Bolzano,533050,402208,75.45,0.1
2824,2021-07-07,PAB,1607,818,789,296,1311,0,ITH,ITH1,4,Provincia Autonoma Bolzano / Bozen,P.A. Bolzano,533050,403815,75.76,0.3
2825,2021-03-04,PAB,1715,1005,710,1481,229,5,ITH,ITH1,4,Provincia Autonoma Bolzano / Bozen,P.A. Bolzano,533050,405530,76.08,0.32
2826,2021-05-26,PAB,4939,2492,2447,2946,1974,19,ITH,ITH1,4,Provincia Autonoma Bolzano / Bozen,P.A. Bolzano,533050,410469,77.0,0.93
2827,2021-06-14,PAB,2961,1606,1355,604,2357,0,ITH,ITH1,4,Provincia Autonoma Bolzano / Bozen,P.A. Bolzano,533050,413430,77.56,0.56
2828,2021-02-15,PAB,72,42,30,26,46,0,ITH,ITH1,4,Provincia Autonoma Bolzano / Bozen,P.A. Bolzano,533050,413502,77.57,0.01
2829,2021-05-11,PAB,2844,1335,1509,1308,1523,13,ITH,ITH1,4,Provincia Autonoma Bolzano / Bozen,P.A. Bolzano,533050,416346,78.11,0.53
2830,2021-01-29,PAB,1497,510,987,24,1473,0,ITH,ITH1,4,Provincia Autonoma Bolzano / Bozen,P.A. Bolzano,533050,417843,78.39,0.28
2831,2021-04-22,PAB,2924,1501,1423,1975,942,7,ITH,ITH1,4,Provincia Autonoma Bolzano / Bozen,P.A. Bolzano,533050,420767,78.94,0.55
2832,2021-05-09,PAB,4241,2410,1831,3084,1152,5,ITH,ITH1,4,Provincia Autonoma Bolzano / Bozen,P.A. Bolzano,533050,425008,79.73,0.8
2833,2021-03-06,PAB,3973,2081,1892,3758,211,4,ITH,ITH1,4,Provincia Autonoma Bolzano / Bozen,P.A. Bolzano,533050,428981,80.48,0.75
2834,2021-05-28,PAB,5683,2896,2787,3777,1890,16,ITH,ITH1,4,Provincia Autonoma Bolzano / Bozen,P.A. Bolzano,533050,434664,81.54,1.07
2835,2021-02-17,PAB,156,51,105,139,17,0,ITH,ITH1,4,Provincia Autonoma Bolzano / Bozen,P.A. Bolzano,533050,434820,81.57,0.03
2836,2021-02-02,PAB,1745,506,1239,8,1737,0,ITH,ITH1,4,Provincia Autonoma Bolzano / Bozen,P.A. Bolzano,533050,436565,81.9,0.33
2837,2021-05-31,PAB,2987,1464,1523,2105,867,15,ITH,ITH1,4,Provincia Autonoma Bolzano / Bozen,P.A. Bolzano,533050,439552,82.46,0.56
2838,2021-01-01,PAB,6,5,1,6,0,0,ITH,ITH1,4,Provincia Autonoma Bolzano / Bozen,P.A. Bolzano,533050,439558,82.46,0.0
2839,2021-06-07,PAB,2901,1506,1395,2582,319,0,ITH,ITH1,4,Provincia Autonoma Bolzano / Bozen,P.A. Bolzano,533050,442459,83.01,0.54
2840,2021-02-27,PAB,2458,759,1699,2445,10,3,ITH,ITH1,4,Provincia Autonoma Bolzano / Bozen,P.A. Bolzano,533050,444917,83.47,0.46
2841,2021-02-13,PAB,318,79,239,312,6,0,ITH,ITH1,4,Provincia Autonoma Bolzano / Bozen,P.A. Bolzano,533050,445235,83.53,0.06
2842,2021-04-11,PAB,2724,1294,1430,2543,177,4,ITH,ITH1,4,Provincia Autonoma Bolzano / Bozen,P.A. Bolzano,533050,447959,84.04,0.51
2843,2021-05-24,PAB,1444,762,682,1093,333,18,ITH,ITH1,4,Provincia Autonoma Bolzano / Bozen,P.A. Bolzano,533050,449403,84.31,0.27
2844,2021-02-20,PAB,1802,540,1262,1784,18,0,ITH,ITH1,4,Provincia Autonoma Bolzano / Bozen,P.A. Bolzano,533050,451205,84.65,0.34
2845,2021-04-18,PAB,3110,1607,1503,2099,1010,1,ITH,ITH1,4,Provincia Autonoma Bolzano / Bozen,P.A. Bolzano,533050,454315,85.23,0.58
2846,2021-01-15,PAB,3282,1228,2054,3282,0,0,ITH,ITH1,4,Provincia Autonoma Bolzano / Bozen,P.A. Bolzano,533050,457597,85.85,0.62
2847,2021-06-18,PAB,4157,2162,1995,1258,2899,0,ITH,ITH1,4,Provincia Autonoma Bolzano / Bozen,P.A. Bolzano,533050,461754,86.62,0.78
2848,2021-01-08,PAB,1521,479,1042,1521,0,0,ITH,ITH1,4,Provincia Autonoma Bolzano / Bozen,P.A. Bolzano,533050,463275,86.91,0.29
2849,2021-03-03,ABR,4633,1891,2742,3704,906,23,ITF,ITF1,13,Abruzzo,Abruzzo,1304970,4633,0.36,0.36
2850,2021-04-08,ABR,7394,3337,4057,4933,2330,131,ITF,ITF1,13,Abruzzo,Abruzzo,1304970,12027,0.92,0.57
2851,2021-04-22,ABR,6731,3250,3481,4827,1730,174,ITF,ITF1,13,Abruzzo,Abruzzo,1304970,18758,1.44,0.52
2852,2021-03-22,ABR,4343,1907,2436,2311,1971,61,ITF,ITF1,13,Abruzzo,Abruzzo,1304970,23101,1.77,0.33
2853,2021-06-30,ABR,11083,5393,5690,4445,6473,165,ITF,ITF1,13,Abruzzo,Abruzzo,1304970,34184,2.62,0.85
2854,2021-02-10,ABR,947,312,635,493,444,10,ITF,ITF1,13,Abruzzo,Abruzzo,1304970,35131,2.69,0.07
2855,2021-01-10,ABR,1139,409,730,1135,0,4,ITF,ITF1,13,Abruzzo,Abruzzo,1304970,36270,2.78,0.09
2856,2021-04-29,ABR,12672,5850,6822,9275,3095,302,ITF,ITF1,13,Abruzzo,Abruzzo,1304970,48942,3.75,0.97
2857,2021-06-25,ABR,10978,5433,5545,4829,6008,141,ITF,ITF1,13,Abruzzo,Abruzzo,1304970,59920,4.59,0.84
2858,2021-01-15,ABR,379,149,230,365,0,14,ITF,ITF1,13,Abruzzo,Abruzzo,1304970,60299,4.62,0.03
2859,2021-04-27,ABR,9084,4368,4716,6506,2467,111,ITF,ITF1,13,Abruzzo,Abruzzo,1304970,69383,5.32,0.7
2860,2021-07-02,ABR,11850,5954,5896,4836,6832,182,ITF,ITF1,13,Abruzzo,Abruzzo,1304970,81233,6.22,0.91
2861,2021-05-04,ABR,10861,5100,5761,7055,3616,190,ITF,ITF1,13,Abruzzo,Abruzzo,1304970,92094,7.06,0.83
2862,2021-03-08,ABR,5148,1693,3455,4088,970,90,ITF,ITF1,13,Abruzzo,Abruzzo,1304970,97242,7.45,0.39
2863,2021-01-24,ABR,50,22,28,6,44,0,ITF,ITF1,13,Abruzzo,Abruzzo,1304970,97292,7.46,0.0
2864,2021-03-01,ABR,3479,1385,2094,2705,751,23,ITF,ITF1,13,Abruzzo,Abruzzo,1304970,100771,7.72,0.27
2865,2021-06-18,ABR,10166,4988,5178,6543,3481,142,ITF,ITF1,13,Abruzzo,Abruzzo,1304970,110937,8.5,0.78
2866,2020-12-27,ABR,37,19,18,37,0,0,ITF,ITF1,13,Abruzzo,Abruzzo,1304970,110974,8.5,0.0
2867,2021-03-20,ABR,4793,2199,2594,2560,2171,62,ITF,ITF1,13,Abruzzo,Abruzzo,1304970,115767,8.87,0.37
2868,2021-06-13,ABR,9850,4926,4924,7849,1836,165,ITF,ITF1,13,Abruzzo,Abruzzo,1304970,125617,9.63,0.75
2869,2021-01-29,ABR,1387,449,938,73,1313,1,ITF,ITF1,13,Abruzzo,Abruzzo,1304970,127004,9.73,0.11
2870,2021-05-30,ABR,8657,4109,4548,5325,3253,79,ITF,ITF1,13,Abruzzo,Abruzzo,1304970,135661,10.4,0.66
2871,2021-04-03,ABR,5160,2257,2903,3484,1597,79,ITF,ITF1,13,Abruzzo,Abruzzo,1304970,140821,10.79,0.4
2872,2021-01-22,ABR,118,57,61,118,0,0,ITF,ITF1,13,Abruzzo,Abruzzo,1304970,140939,10.8,0.01
2873,2021-01-03,ABR,471,185,286,469,0,2,ITF,ITF1,13,Abruzzo,Abruzzo,1304970,141410,10.84,0.04
2874,2021-03-27,ABR,6120,2620,3500,3563,2486,71,ITF,ITF1,13,Abruzzo,Abruzzo,1304970,147530,11.31,0.47
2875,2021-02-22,ABR,2642,1173,1469,2587,30,25,ITF,ITF1,13,Abruzzo,Abruzzo,1304970,150172,11.51,0.2
2876,2021-02-05,ABR,1534,521,1013,772,746,16,ITF,ITF1,13,Abruzzo,Abruzzo,1304970,151706,11.63,0.12
2877,2021-05-16,ABR,9579,4137,5442,5648,3814,117,ITF,ITF1,13,Abruzzo,Abruzzo,1304970,161285,12.36,0.73
2878,2021-06-04,ABR,15627,7389,8238,10754,4689,184,ITF,ITF1,13,Abruzzo,Abruzzo,1304970,176912,13.56,1.2
2879,2021-05-18,ABR,12110,5660,6450,7562,4380,168,ITF,ITF1,13,Abruzzo,Abruzzo,1304970,189022,14.48,0.93
2880,2021-02-24,ABR,3305,1441,1864,3112,176,17,ITF,ITF1,13,Abruzzo,Abruzzo,1304970,192327,14.74,0.25
2881,2021-02-17,ABR,2071,948,1123,1780,282,9,ITF,ITF1,13,Abruzzo,Abruzzo,1304970,194398,14.9,0.16
2882,2021-06-11,ABR,11767,5849,5918,8824,2763,180,ITF,ITF1,13,Abruzzo,Abruzzo,1304970,206165,15.8,0.9
2883,2021-05-11,ABR,10760,5117,5643,5736,4851,173,ITF,ITF1,13,Abruzzo,Abruzzo,1304970,216925,16.62,0.82
2884,2021-02-03,ABR,2062,717,1345,411,1643,8,ITF,ITF1,13,Abruzzo,Abruzzo,1304970,218987,16.78,0.16
2885,2021-02-28,ABR,1702,508,1194,1666,2,34,ITF,ITF1,13,Abruzzo,Abruzzo,1304970,220689,16.91,0.13
2886,2021-01-02,ABR,552,220,332,551,0,1,ITF,ITF1,13,Abruzzo,Abruzzo,1304970,221241,16.95,0.04
2887,2021-06-08,ABR,12826,6598,6228,10393,2197,236,ITF,ITF1,13,Abruzzo,Abruzzo,1304970,234067,17.94,0.98
2888,2021-04-26,ABR,8562,4065,4497,7142,1214,206,ITF,ITF1,13,Abruzzo,Abruzzo,1304970,242629,18.59,0.66
2889,2021-06-01,ABR,11006,4883,6123,6512,4374,120,ITF,ITF1,13,Abruzzo,Abruzzo,1304970,253635,19.44,0.84
2890,2021-03-15,ABR,3683,1447,2236,1845,1807,31,ITF,ITF1,13,Abruzzo,Abruzzo,1304970,257318,19.72,0.28
2891,2021-01-17,ABR,188,59,129,180,7,1,ITF,ITF1,13,Abruzzo,Abruzzo,1304970,257506,19.73,0.01
2892,2021-06-23,ABR,11017,5290,5727,5581,5291,145,ITF,ITF1,13,Abruzzo,Abruzzo,1304970,268523,20.58,0.84
2893,2021-03-17,ABR,4539,1873,2666,2776,1740,23,ITF,ITF1,13,Abruzzo,Abruzzo,1304970,273062,20.92,0.35
2894,2021-02-02,ABR,1763,668,1095,218,1541,4,ITF,ITF1,13,Abruzzo,Abruzzo,1304970,274825,21.06,0.14
2895,2021-05-13,ABR,11146,5042,6104,6959,3959,228,ITF,ITF1,13,Abruzzo,Abruzzo,1304970,285971,21.91,0.85
2896,2021-03-31,ABR,6714,2939,3775,4555,2069,90,ITF,ITF1,13,Abruzzo,Abruzzo,1304970,292685,22.43,0.51
2897,2021-05-15,ABR,11428,5178,6250,5951,5301,176,ITF,ITF1,13,Abruzzo,Abruzzo,1304970,304113,23.3,0.88
2898,2021-05-27,ABR,13311,6094,7217,8316,4821,174,ITF,ITF1,13,Abruzzo,Abruzzo,1304970,317424,24.32,1.02
2899,2021-03-19,ABR,5793,2584,3209,2732,3020,41,ITF,ITF1,13,Abruzzo,Abruzzo,1304970,323217,24.77,0.44
2900,2021-03-05,ABR,5348,1958,3390,4592,697,59,ITF,ITF1,13,Abruzzo,Abruzzo,1304970,328565,25.18,0.41
2901,2021-02-12,ABR,1228,567,661,1026,189,13,ITF,ITF1,13,Abruzzo,Abruzzo,1304970,329793,25.27,0.09
2902,2021-05-23,ABR,9881,4696,5185,7068,2692,121,ITF,ITF1,13,Abruzzo,Abruzzo,1304970,339674,26.03,0.76
2903,2021-06-06,ABR,11149,5309,5840,8780,2241,128,ITF,ITF1,13,Abruzzo,Abruzzo,1304970,350823,26.88,0.85
2904,2021-04-10,ABR,8774,4057,4717,6127,2508,139,ITF,ITF1,13,Abruzzo,Abruzzo,1304970,359597,27.56,0.67
2905,2021-04-17,ABR,7358,3401,3957,4216,3053,89,ITF,ITF1,13,Abruzzo,Abruzzo,1304970,366955,28.12,0.56
2906,2021-01-05,ABR,1615,604,1011,1610,0,5,ITF,ITF1,13,Abruzzo,Abruzzo,1304970,368570,28.24,0.12
2907,2021-04-15,ABR,7819,3679,4140,5834,1840,145,ITF,ITF1,13,Abruzzo,Abruzzo,1304970,376389,28.84,0.6
2908,2021-07-07,ABR,11996,5881,6115,4026,7731,239,ITF,ITF1,13,Abruzzo,Abruzzo,1304970,388385,29.76,0.92
2909,2021-06-22,ABR,10407,4877,5530,5385,4844,178,ITF,ITF1,13,Abruzzo,Abruzzo,1304970,398792,30.56,0.8
2910,2021-01-19,ABR,111,55,56,90,20,1,ITF,ITF1,13,Abruzzo,Abruzzo,1304970,398903,30.57,0.01
2911,2021-02-07,ABR,779,308,471,200,578,1,ITF,ITF1,13,Abruzzo,Abruzzo,1304970,399682,30.63,0.06
2912,2021-01-21,ABR,157,47,110,157,0,0,ITF,ITF1,13,Abruzzo,Abruzzo,1304970,399839,30.64,0.01
2913,2021-04-05,ABR,2692,1147,1545,1731,879,82,ITF,ITF1,13,Abruzzo,Abruzzo,1304970,402531,30.85,0.21
2914,2021-01-12,ABR,1805,667,1138,1791,0,14,ITF,ITF1,13,Abruzzo,Abruzzo,1304970,404336,30.98,0.14
2915,2021-05-25,ABR,11417,5324,6093,8083,3137,197,ITF,ITF1,13,Abruzzo,Abruzzo,1304970,415753,31.86,0.87
2916,2021-01-31,ABR,1521,494,1027,288,1232,1,ITF,ITF1,13,Abruzzo,Abruzzo,1304970,417274,31.98,0.12
2917,2021-03-24,ABR,6383,2784,3599,3997,2251,135,ITF,ITF1,13,Abruzzo,Abruzzo,1304970,423657,32.46,0.49
2918,2021-02-09,ABR,909,312,597,499,409,1,ITF,ITF1,13,Abruzzo,Abruzzo,1304970,424566,32.53,0.07
2919,2021-07-04,ABR,8374,4215,4159,3333,4917,124,ITF,ITF1,13,Abruzzo,Abruzzo,1304970,432940,33.18,0.64
2920,2021-02-11,ABR,816,262,554,771,43,2,ITF,ITF1,13,Abruzzo,Abruzzo,1304970,433756,33.24,0.06
2921,2021-05-24,ABR,12223,5837,6386,8724,3340,159,ITF,ITF1,13,Abruzzo,Abruzzo,1304970,445979,34.18,0.94
2922,2021-02-18,ABR,2288,933,1355,2140,130,18,ITF,ITF1,13,Abruzzo,Abruzzo,1304970,448267,34.35,0.18
2923,2021-05-29,ABR,10317,4429,5888,4456,5772,89,ITF,ITF1,13,Abruzzo,Abruzzo,1304970,458584,35.14,0.79
2924,2021-03-10,ABR,5045,1682,3363,4025,956,64,ITF,ITF1,13,Abruzzo,Abruzzo,1304970,463629,35.53,0.39
2925,2021-01-26,ABR,1542,567,975,29,1513,0,ITF,ITF1,13,Abruzzo,Abruzzo,1304970,465171,35.65,0.12
2926,2021-05-06,ABR,12973,6072,6901,7794,5026,153,ITF,ITF1,13,Abruzzo,Abruzzo,1304970,478144,36.64,0.99
2927,2021-06-27,ABR,8370,4302,4068,5012,3217,141,ITF,ITF1,13,Abruzzo,Abruzzo,1304970,486514,37.28,0.64
2928,2021-04-07,ABR,7222,3333,3889,4314,2784,124,ITF,ITF1,13,Abruzzo,Abruzzo,1304970,493736,37.84,0.55
2929,2021-05-08,ABR,10292,4871,5421,6338,3833,121,ITF,ITF1,13,Abruzzo,Abruzzo,1304970,504028,38.62,0.79
2930,2021-04-24,ABR,8725,3974,4751,6941,1531,253,ITF,ITF1,13,Abruzzo,Abruzzo,1304970,512753,39.29,0.67
2931,2021-01-14,ABR,530,189,341,528,0,2,ITF,ITF1,13,Abruzzo,Abruzzo,1304970,513283,39.33,0.04
2932,2021-02-16,ABR,1917,842,1075,1892,12,13,ITF,ITF1,13,Abruzzo,Abruzzo,1304970,515200,39.48,0.15
2933,2021-03-02,ABR,3965,1675,2290,3261,684,20,ITF,ITF1,13,Abruzzo,Abruzzo,1304970,519165,39.78,0.3
2934,2021-06-10,ABR,12704,6319,6385,10303,2162,239,ITF,ITF1,13,Abruzzo,Abruzzo,1304970,531869,40.76,0.97
2935,2021-01-28,ABR,1433,495,938,12,1421,0,ITF,ITF1,13,Abruzzo,Abruzzo,1304970,533302,40.87,0.11
2936,2021-04-19,ABR,6231,2861,3370,3787,2375,69,ITF,ITF1,13,Abruzzo,Abruzzo,1304970,539533,41.34,0.48
2937,2021-02-21,ABR,1218,550,668,1193,1,24,ITF,ITF1,13,Abruzzo,Abruzzo,1304970,540751,41.44,0.09
2938,2021-06-15,ABR,11317,5561,5756,8684,2428,205,ITF,ITF1,13,Abruzzo,Abruzzo,1304970,552068,42.31,0.87
2939,2021-04-12,ABR,6240,2958,3282,4987,1174,79,ITF,ITF1,13,Abruzzo,Abruzzo,1304970,558308,42.78,0.48
2940,2021-05-01,ABR,10734,5042,5692,5628,4974,132,ITF,ITF1,13,Abruzzo,Abruzzo,1304970,569042,43.61,0.82
2941,2021-05-20,ABR,12801,5927,6874,7413,5262,126,ITF,ITF1,13,Abruzzo,Abruzzo,1304970,581843,44.59,0.98
2942,2021-06-19,ABR,10484,5164,5320,6484,3829,171,ITF,ITF1,13,Abruzzo,Abruzzo,1304970,592327,45.39,0.8
2943,2021-03-28,ABR,2415,1015,1400,1993,372,50,ITF,ITF1,13,Abruzzo,Abruzzo,1304970,594742,45.58,0.19
2944,2021-07-06,ABR,9915,4942,4973,4100,5651,164,ITF,ITF1,13,Abruzzo,Abruzzo,1304970,604657,46.33,0.76
2945,2021-04-14,ABR,6593,2949,3644,4341,2120,132,ITF,ITF1,13,Abruzzo,Abruzzo,1304970,611250,46.84,0.51
2946,2021-01-04,ABR,1403,576,827,1397,0,6,ITF,ITF1,13,Abruzzo,Abruzzo,1304970,612653,46.95,0.11
2947,2021-01-23,ABR,264,115,149,51,207,6,ITF,ITF1,13,Abruzzo,Abruzzo,1304970,612917,46.97,0.02
2948,2021-05-03,ABR,11147,5256,5891,7135,3833,179,ITF,ITF1,13,Abruzzo,Abruzzo,1304970,624064,47.82,0.85
2949,2021-04-09,ABR,8992,4261,4731,6250,2602,140,ITF,ITF1,13,Abruzzo,Abruzzo,1304970,633056,48.51,0.69
2950,2021-04-02,ABR,6694,3102,3592,5117,1487,90,ITF,ITF1,13,Abruzzo,Abruzzo,1304970,639750,49.02,0.51
2951,2021-02-04,ABR,1682,616,1066,598,1072,12,ITF,ITF1,13,Abruzzo,Abruzzo,1304970,641432,49.15,0.13
2952,2021-04-04,ABR,1632,768,864,1460,129,43,ITF,ITF1,13,Abruzzo,Abruzzo,1304970,643064,49.28,0.13
2953,2021-06-16,ABR,10878,5444,5434,7990,2674,214,ITF,ITF1,13,Abruzzo,Abruzzo,1304970,653942,50.11,0.83
2954,2021-02-27,ABR,2813,1339,1474,2513,267,33,ITF,ITF1,13,Abruzzo,Abruzzo,1304970,656755,50.33,0.22
2955,2021-06-07,ABR,11082,5286,5796,9065,1832,185,ITF,ITF1,13,Abruzzo,Abruzzo,1304970,667837,51.18,0.85
2956,2021-04-11,ABR,5380,2628,2752,4842,487,51,ITF,ITF1,13,Abruzzo,Abruzzo,1304970,673217,51.59,0.41
2957,2021-06-09,ABR,11563,6088,5475,9700,1682,181,ITF,ITF1,13,Abruzzo,Abruzzo,1304970,684780,52.47,0.89
2958,2021-03-06,ABR,4177,1358,2819,3568,570,39,ITF,ITF1,13,Abruzzo,Abruzzo,1304970,688957,52.79,0.32
2959,2021-05-10,ABR,10109,4782,5327,5374,4649,86,ITF,ITF1,13,Abruzzo,Abruzzo,1304970,699066,53.57,0.77
2960,2021-04-23,ABR,7391,3392,3999,4920,2306,165,ITF,ITF1,13,Abruzzo,Abruzzo,1304970,706457,54.14,0.57
2961,2021-01-30,ABR,1511,568,943,68,1442,1,ITF,ITF1,13,Abruzzo,Abruzzo,1304970,707968,54.25,0.12
2962,2021-06-29,ABR,11395,5620,5775,5223,5986,186,ITF,ITF1,13,Abruzzo,Abruzzo,1304970,719363,55.12,0.87
2963,2021-01-11,ABR,1553,557,996,1549,0,4,ITF,ITF1,13,Abruzzo,Abruzzo,1304970,720916,55.24,0.12
2964,2021-04-21,ABR,6389,3102,3287,4637,1675,77,ITF,ITF1,13,Abruzzo,Abruzzo,1304970,727305,55.73,0.49
2965,2021-06-28,ABR,10034,4825,5209,5294,4572,168,ITF,ITF1,13,Abruzzo,Abruzzo,1304970,737339,56.5,0.77
2966,2021-04-06,ABR,7678,3579,4099,5235,2318,125,ITF,ITF1,13,Abruzzo,Abruzzo,1304970,745017,57.09,0.59
2967,2021-05-22,ABR,13152,6390,6762,8130,4910,112,ITF,ITF1,13,Abruzzo,Abruzzo,1304970,758169,58.1,1.01
2968,2021-03-26,ABR,5354,2311,3043,3177,2075,102,ITF,ITF1,13,Abruzzo,Abruzzo,1304970,763523,58.51,0.41
2969,2021-05-31,ABR,11332,5111,6221,6760,4443,129,ITF,ITF1,13,Abruzzo,Abruzzo,1304970,774855,59.38,0.87
2970,2021-04-20,ABR,5636,2713,2923,4109,1455,72,ITF,ITF1,13,Abruzzo,Abruzzo,1304970,780491,59.81,0.43
2971,2021-04-25,ABR,9066,4621,4445,8056,810,200,ITF,ITF1,13,Abruzzo,Abruzzo,1304970,789557,60.5,0.69
2972,2021-01-08,ABR,1525,507,1018,1516,0,9,ITF,ITF1,13,Abruzzo,Abruzzo,1304970,791082,60.62,0.12
2973,2021-04-18,ABR,5814,2728,3086,4726,943,145,ITF,ITF1,13,Abruzzo,Abruzzo,1304970,796896,61.07,0.45
2974,2021-02-20,ABR,4773,1841,2932,4657,76,40,ITF,ITF1,13,Abruzzo,Abruzzo,1304970,801669,61.43,0.37
2975,2021-01-16,ABR,934,430,504,926,0,8,ITF,ITF1,13,Abruzzo,Abruzzo,1304970,802603,61.5,0.07
2976,2021-03-07,ABR,2523,630,1893,2484,0,39,ITF,ITF1,13,Abruzzo,Abruzzo,1304970,805126,61.7,0.19
2977,2021-01-09,ABR,1484,566,918,1472,0,12,ITF,ITF1,13,Abruzzo,Abruzzo,1304970,806610,61.81,0.11
2978,2021-07-08,ABR,5760,2835,2925,1249,4451,60,ITF,ITF1,13,Abruzzo,Abruzzo,1304970,812370,62.25,0.44
2979,2021-04-16,ABR,7535,3486,4049,5497,1916,122,ITF,ITF1,13,Abruzzo,Abruzzo,1304970,819905,62.83,0.58
2980,2021-03-11,ABR,5494,2220,3274,4273,1138,83,ITF,ITF1,13,Abruzzo,Abruzzo,1304970,825399,63.25,0.42
2981,2021-06-02,ABR,9765,4744,5021,6836,2811,118,ITF,ITF1,13,Abruzzo,Abruzzo,1304970,835164,64.0,0.75
2982,2021-03-13,ABR,4125,1420,2705,3015,1043,67,ITF,ITF1,13,Abruzzo,Abruzzo,1304970,839289,64.31,0.32
2983,2021-06-21,ABR,11030,5381,5649,4931,5972,127,ITF,ITF1,13,Abruzzo,Abruzzo,1304970,850319,65.16,0.85
2984,2021-03-30,ABR,5126,2261,2865,3146,1822,158,ITF,ITF1,13,Abruzzo,Abruzzo,1304970,855445,65.55,0.39
2985,2021-01-06,ABR,1832,664,1168,1822,0,10,ITF,ITF1,13,Abruzzo,Abruzzo,1304970,857277,65.69,0.14
2986,2021-05-07,ABR,12200,5711,6489,7667,4413,120,ITF,ITF1,13,Abruzzo,Abruzzo,1304970,869477,66.63,0.93
2987,2021-03-25,ABR,5793,2662,3131,3065,2617,111,ITF,ITF1,13,Abruzzo,Abruzzo,1304970,875270,67.07,0.44
2988,2021-01-27,ABR,1365,515,850,39,1326,0,ITF,ITF1,13,Abruzzo,Abruzzo,1304970,876635,67.18,0.1
2989,2021-07-03,ABR,10258,5166,5092,3531,6579,148,ITF,ITF1,13,Abruzzo,Abruzzo,1304970,886893,67.96,0.79
2990,2021-05-21,ABR,13015,6327,6688,7862,4979,174,ITF,ITF1,13,Abruzzo,Abruzzo,1304970,899908,68.96,1.0
2991,2021-03-18,ABR,3896,1651,2245,2039,1831,26,ITF,ITF1,13,Abruzzo,Abruzzo,1304970,903804,69.26,0.3
2992,2021-06-26,ABR,10033,5011,5022,5679,4196,158,ITF,ITF1,13,Abruzzo,Abruzzo,1304970,913837,70.03,0.77
2993,2021-05-14,ABR,10594,5069,5525,5285,5147,162,ITF,ITF1,13,Abruzzo,Abruzzo,1304970,924431,70.84,0.81
2994,2021-04-01,ABR,5591,2505,3086,3430,2087,74,ITF,ITF1,13,Abruzzo,Abruzzo,1304970,930022,71.27,0.43
2995,2021-03-21,ABR,2134,914,1220,840,1290,4,ITF,ITF1,13,Abruzzo,Abruzzo,1304970,932156,71.43,0.16
2996,2021-06-12,ABR,11398,5902,5496,9891,1331,176,ITF,ITF1,13,Abruzzo,Abruzzo,1304970,943554,72.3,0.87
2997,2021-01-13,ABR,1258,441,817,1250,0,8,ITF,ITF1,13,Abruzzo,Abruzzo,1304970,944812,72.4,0.1
2998,2021-03-29,ABR,5708,2599,3109,3020,2639,49,ITF,ITF1,13,Abruzzo,Abruzzo,1304970,950520,72.84,0.44
2999,2021-06-03,ABR,13183,6280,6903,9237,3776,170,ITF,ITF1,13,Abruzzo,Abruzzo,1304970,963703,73.85,1.01
3000,2021-03-12,ABR,6014,1987,4027,4355,1582,77,ITF,ITF1,13,Abruzzo,Abruzzo,1304970,969717,74.31,0.46
3001,2021-05-09,ABR,9156,4090,5066,4175,4870,111,ITF,ITF1,13,Abruzzo,Abruzzo,1304970,978873,75.01,0.7
3002,2021-02-15,ABR,1794,832,962,1735,42,17,ITF,ITF1,13,Abruzzo,Abruzzo,1304970,980667,75.15,0.14
3003,2021-05-26,ABR,13542,6039,7503,8390,4991,161,ITF,ITF1,13,Abruzzo,Abruzzo,1304970,994209,76.19,1.04
3004,2021-06-14,ABR,10966,5424,5542,7428,3368,170,ITF,ITF1,13,Abruzzo,Abruzzo,1304970,1005175,77.03,0.84
3005,2021-02-13,ABR,854,385,469,434,416,4,ITF,ITF1,13,Abruzzo,Abruzzo,1304970,1006029,77.09,0.07
3006,2021-03-04,ABR,5935,2360,3575,4973,922,40,ITF,ITF1,13,Abruzzo,Abruzzo,1304970,1011964,77.55,0.45
3007,2021-05-28,ABR,14013,6307,7706,7491,6354,168,ITF,ITF1,13,Abruzzo,Abruzzo,1304970,1025977,78.62,1.07
3008,2021-06-20,ABR,8443,4239,4204,5415,2928,100,ITF,ITF1,13,Abruzzo,Abruzzo,1304970,1034420,79.27,0.65
3009,2021-03-14,ABR,1873,731,1142,1191,666,16,ITF,ITF1,13,Abruzzo,Abruzzo,1304970,1036293,79.41,0.14
3010,2021-02-25,ABR,3052,1340,1712,2506,528,18,ITF,ITF1,13,Abruzzo,Abruzzo,1304970,1039345,79.65,0.23
3011,2021-06-05,ABR,14618,6864,7754,10373,4047,198,ITF,ITF1,13,Abruzzo,Abruzzo,1304970,1053963,80.77,1.12
3012,2021-05-17,ABR,11034,5037,5997,6024,4854,156,ITF,ITF1,13,Abruzzo,Abruzzo,1304970,1064997,81.61,0.85
3013,2021-02-23,ABR,2781,1274,1507,2755,11,15,ITF,ITF1,13,Abruzzo,Abruzzo,1304970,1067778,81.82,0.21
3014,2021-02-06,ABR,1610,743,867,595,1008,7,ITF,ITF1,13,Abruzzo,Abruzzo,1304970,1069388,81.95,0.12
3015,2021-02-08,ABR,1194,395,799,486,708,0,ITF,ITF1,13,Abruzzo,Abruzzo,1304970,1070582,82.04,0.09
3016,2021-05-19,ABR,10729,5124,5605,7568,3038,123,ITF,ITF1,13,Abruzzo,Abruzzo,1304970,1081311,82.86,0.82
3017,2021-04-30,ABR,12502,5868,6634,6516,5722,264,ITF,ITF1,13,Abruzzo,Abruzzo,1304970,1093813,83.82,0.96
3018,2021-04-13,ABR,5893,2754,3139,4561,1237,95,ITF,ITF1,13,Abruzzo,Abruzzo,1304970,1099706,84.27,0.45
3019,2021-01-20,ABR,447,156,291,425,2,20,ITF,ITF1,13,Abruzzo,Abruzzo,1304970,1100153,84.3,0.03
3020,2021-07-05,ABR,10876,5324,5552,3994,6697,185,ITF,ITF1,13,Abruzzo,Abruzzo,1304970,1111029,85.14,0.83
3021,2021-05-02,ABR,10459,5111,5348,5089,5228,142,ITF,ITF1,13,Abruzzo,Abruzzo,1304970,1121488,85.94,0.8
3022,2021-02-19,ABR,3300,1551,1749,3162,100,38,ITF,ITF1,13,Abruzzo,Abruzzo,1304970,1124788,86.19,0.25
3023,2021-01-07,ABR,1605,553,1052,1598,0,7,ITF,ITF1,13,Abruzzo,Abruzzo,1304970,1126393,86.32,0.12
3024,2021-02-26,ABR,3924,1680,2244,2929,969,26,ITF,ITF1,13,Abruzzo,Abruzzo,1304970,1130317,86.62,0.3
3025,2021-01-18,ABR,125,51,74,46,79,0,ITF,ITF1,13,Abruzzo,Abruzzo,1304970,1130442,86.63,0.01
3026,2021-06-24,ABR,10830,5389,5441,5685,4978,167,ITF,ITF1,13,Abruzzo,Abruzzo,1304970,1141272,87.46,0.83
3027,2021-04-28,ABR,9513,4588,4925,7317,2023,173,ITF,ITF1,13,Abruzzo,Abruzzo,1304970,1150785,88.18,0.73
3028,2021-05-12,ABR,9629,4600,5029,5875,3580,174,ITF,ITF1,13,Abruzzo,Abruzzo,1304970,1160414,88.92,0.74
3029,2021-03-16,ABR,3484,1452,2032,1802,1654,28,ITF,ITF1,13,Abruzzo,Abruzzo,1304970,1163898,89.19,0.27
3030,2021-05-05,ABR,11635,5571,6064,6273,5204,158,ITF,ITF1,13,Abruzzo,Abruzzo,1304970,1175533,90.08,0.89
3031,2021-03-09,ABR,5177,1805,3372,4156,938,83,ITF,ITF1,13,Abruzzo,Abruzzo,1304970,1180710,90.48,0.4
3032,2021-07-01,ABR,12753,6279,6474,5769,6761,223,ITF,ITF1,13,Abruzzo,Abruzzo,1304970,1193463,91.46,0.98
3033,2021-06-17,ABR,10913,5456,5457,7299,3456,158,ITF,ITF1,13,Abruzzo,Abruzzo,1304970,1204376,92.29,0.84
3034,2021-02-01,ABR,1631,573,1058,270,1360,1,ITF,ITF1,13,Abruzzo,Abruzzo,1304970,1206007,92.42,0.12
3035,2021-03-23,ABR,4831,2187,2644,2213,2566,52,ITF,ITF1,13,Abruzzo,Abruzzo,1304970,1210838,92.79,0.37
3036,2021-01-25,ABR,1604,632,972,15,1587,2,ITF,ITF1,13,Abruzzo,Abruzzo,1304970,1212442,92.91,0.12
3037,2021-05-24,CAM,31358,15151,16207,15864,15149,345,ITF,ITF3,15,Campania,Campania,5801692,31358,0.54,0.54
3038,2021-02-13,CAM,5508,2550,2958,5109,217,182,ITF,ITF3,15,Campania,Campania,5801692,36866,0.64,0.09
3039,2021-04-23,CAM,32323,15521,16802,22484,9149,690,ITF,ITF3,15,Campania,Campania,5801692,69189,1.19,0.56
3040,2021-01-30,CAM,10724,5081,5643,36,10686,2,ITF,ITF3,15,Campania,Campania,5801692,79913,1.38,0.18
3041,2021-07-03,CAM,67264,32485,34779,8202,58686,376,ITF,ITF3,15,Campania,Campania,5801692,147177,2.54,1.16
3042,2021-01-16,CAM,3371,1677,1694,3262,0,109,ITF,ITF3,15,Campania,Campania,5801692,150548,2.59,0.06
3043,2021-06-07,CAM,57572,27717,29855,52863,4033,676,ITF,ITF3,15,Campania,Campania,5801692,208120,3.59,0.99
3044,2021-02-25,CAM,12426,4479,7947,10969,1188,269,ITF,ITF3,15,Campania,Campania,5801692,220546,3.8,0.21
3045,2021-04-09,CAM,30044,14153,15891,23313,6134,597,ITF,ITF3,15,Campania,Campania,5801692,250590,4.32,0.52
3046,2021-06-05,CAM,77595,37563,40032,70867,6023,705,ITF,ITF3,15,Campania,Campania,5801692,328185,5.66,1.34
3047,2021-06-14,CAM,37079,17904,19175,18768,18004,307,ITF,ITF3,15,Campania,Campania,5801692,365264,6.3,0.64
3048,2021-02-11,CAM,6280,2704,3576,5929,66,285,ITF,ITF3,15,Campania,Campania,5801692,371544,6.4,0.11
3049,2021-04-16,CAM,34323,16559,17764,23018,10665,640,ITF,ITF3,15,Campania,Campania,5801692,405867,7.0,0.59
3050,2021-03-02,CAM,12761,4558,8203,8214,4345,202,ITF,ITF3,15,Campania,Campania,5801692,418628,7.22,0.22
3051,2021-01-11,CAM,4070,1871,2199,3961,0,109,ITF,ITF3,15,Campania,Campania,5801692,422698,7.29,0.07
3052,2021-06-24,CAM,66027,31802,34225,13467,52231,329,ITF,ITF3,15,Campania,Campania,5801692,488725,8.42,1.14
3053,2021-03-16,CAM,8086,3519,4567,3700,4314,72,ITF,ITF3,15,Campania,Campania,5801692,496811,8.56,0.14
3054,2021-01-25,CAM,5746,2927,2819,163,5583,0,ITF,ITF3,15,Campania,Campania,5801692,502557,8.66,0.1
3055,2021-07-01,CAM,61463,29823,31640,19842,40972,649,ITF,ITF3,15,Campania,Campania,5801692,564020,9.72,1.06
3056,2021-03-23,CAM,15742,7445,8297,12924,2513,305,ITF,ITF3,15,Campania,Campania,5801692,579762,9.99,0.27
3057,2021-05-19,CAM,51156,22605,28551,33827,16608,721,ITF,ITF3,15,Campania,Campania,5801692,630918,10.87,0.88
3058,2021-03-28,CAM,15556,7504,8052,13601,1625,330,ITF,ITF3,15,Campania,Campania,5801692,646474,11.14,0.27
3059,2021-01-04,CAM,5826,2963,2863,5727,0,99,ITF,ITF3,15,Campania,Campania,5801692,652300,11.24,0.1
3060,2021-06-19,CAM,62346,29693,32653,24240,37731,375,ITF,ITF3,15,Campania,Campania,5801692,714646,12.32,1.07
3061,2021-03-09,CAM,14128,6870,7258,9961,3785,382,ITF,ITF3,15,Campania,Campania,5801692,728774,12.56,0.24
3062,2021-04-11,CAM,17523,8606,8917,15068,2082,373,ITF,ITF3,15,Campania,Campania,5801692,746297,12.86,0.3
3063,2021-04-28,CAM,36434,17641,18793,25916,9756,762,ITF,ITF3,15,Campania,Campania,5801692,782731,13.49,0.63
3064,2021-01-18,CAM,958,399,559,682,244,32,ITF,ITF3,15,Campania,Campania,5801692,783689,13.51,0.02
3065,2021-06-26,CAM,62903,30680,32223,14648,47847,408,ITF,ITF3,15,Campania,Campania,5801692,846592,14.59,1.08
3066,2021-04-04,CAM,7967,4018,3949,6702,1047,218,ITF,ITF3,15,Campania,Campania,5801692,854559,14.73,0.14
3067,2021-06-12,CAM,63979,31537,32442,55944,7214,821,ITF,ITF3,15,Campania,Campania,5801692,918538,15.83,1.1
3068,2021-03-04,CAM,14708,5396,9312,8555,5894,259,ITF,ITF3,15,Campania,Campania,5801692,933246,16.09,0.25
3069,2021-05-07,CAM,59769,29207,30562,42785,15946,1038,ITF,ITF3,15,Campania,Campania,5801692,993015,17.12,1.03
3070,2021-01-27,CAM,7738,3820,3918,157,7576,5,ITF,ITF3,15,Campania,Campania,5801692,1000753,17.25,0.13
3071,2021-01-23,CAM,3839,2029,1810,267,3566,6,ITF,ITF3,15,Campania,Campania,5801692,1004592,17.32,0.07
3072,2021-03-21,CAM,10070,4674,5396,7506,2390,174,ITF,ITF3,15,Campania,Campania,5801692,1014662,17.49,0.17
3073,2021-02-10,CAM,6905,3413,3492,6484,177,244,ITF,ITF3,15,Campania,Campania,5801692,1021567,17.61,0.12
3074,2021-04-08,CAM,28391,13749,14642,21992,5843,556,ITF,ITF3,15,Campania,Campania,5801692,1049958,18.1,0.49
3075,2021-06-04,CAM,74483,35803,38680,64779,9060,644,ITF,ITF3,15,Campania,Campania,5801692,1124441,19.38,1.28
3076,2021-05-21,CAM,63708,29604,34104,42178,20525,1005,ITF,ITF3,15,Campania,Campania,5801692,1188149,20.48,1.1
3077,2021-02-27,CAM,13948,4473,9475,12008,1642,298,ITF,ITF3,15,Campania,Campania,5801692,1202097,20.72,0.24
3078,2021-06-16,CAM,31579,14973,16606,20531,10754,294,ITF,ITF3,15,Campania,Campania,5801692,1233676,21.26,0.54
3079,2021-01-06,CAM,7651,3749,3902,7507,0,144,ITF,ITF3,15,Campania,Campania,5801692,1241327,21.4,0.13
3080,2021-02-18,CAM,9080,3813,5267,8151,707,222,ITF,ITF3,15,Campania,Campania,5801692,1250407,21.55,0.16
3081,2021-04-25,CAM,30731,15168,15563,24597,5396,738,ITF,ITF3,15,Campania,Campania,5801692,1281138,22.08,0.53
3082,2021-01-13,CAM,8020,3666,4354,7781,0,239,ITF,ITF3,15,Campania,Campania,5801692,1289158,22.22,0.14
3083,2021-05-26,CAM,52669,25833,26836,21106,31098,465,ITF,ITF3,15,Campania,Campania,5801692,1341827,23.13,0.91
3084,2021-04-06,CAM,24510,11561,12949,19506,4523,481,ITF,ITF3,15,Campania,Campania,5801692,1366337,23.55,0.42
3085,2020-12-27,CAM,720,422,298,716,0,4,ITF,ITF3,15,Campania,Campania,5801692,1367057,23.56,0.01
3086,2021-04-20,CAM,32036,15500,16536,20158,11312,566,ITF,ITF3,15,Campania,Campania,5801692,1399093,24.12,0.55
3087,2021-05-05,CAM,51173,24857,26316,43287,6386,1500,ITF,ITF3,15,Campania,Campania,5801692,1450266,25.0,0.88
3088,2021-05-12,CAM,40887,19950,20937,30591,9156,1140,ITF,ITF3,15,Campania,Campania,5801692,1491153,25.7,0.7
3089,2021-07-08,CAM,25316,11929,13387,2139,23074,103,ITF,ITF3,15,Campania,Campania,5801692,1516469,26.14,0.44
3090,2021-05-31,CAM,40724,20662,20062,29850,10309,565,ITF,ITF3,15,Campania,Campania,5801692,1557193,26.84,0.7
3091,2021-06-02,CAM,42818,20137,22681,37708,4674,436,ITF,ITF3,15,Campania,Campania,5801692,1600011,27.58,0.74
3092,2021-05-17,CAM,49361,21701,27660,23653,25257,451,ITF,ITF3,15,Campania,Campania,5801692,1649372,28.43,0.85
3093,2021-02-06,CAM,5341,2666,2675,2006,3239,96,ITF,ITF3,15,Campania,Campania,5801692,1654713,28.52,0.09
3094,2021-04-30,CAM,42322,20191,22131,25036,16498,788,ITF,ITF3,15,Campania,Campania,5801692,1697035,29.25,0.73
3095,2021-02-04,CAM,7943,3429,4514,1249,6635,59,ITF,ITF3,15,Campania,Campania,5801692,1704978,29.39,0.14
3096,2021-01-01,CAM,919,506,413,900,0,19,ITF,ITF3,15,Campania,Campania,5801692,1705897,29.4,0.02
3097,2021-03-25,CAM,20321,9653,10668,16390,3503,428,ITF,ITF3,15,Campania,Campania,5801692,1726218,29.75,0.35
3098,2021-03-18,CAM,12175,5380,6795,5795,6189,191,ITF,ITF3,15,Campania,Campania,5801692,1738393,29.96,0.21
3099,2021-05-02,CAM,43496,21541,21955,31286,11359,851,ITF,ITF3,15,Campania,Campania,5801692,1781889,30.71,0.75
3100,2021-01-22,CAM,1525,776,749,659,852,14,ITF,ITF3,15,Campania,Campania,5801692,1783414,30.74,0.03
3101,2021-03-06,CAM,16370,6814,9556,10411,5669,290,ITF,ITF3,15,Campania,Campania,5801692,1799784,31.02,0.28
3102,2021-03-08,CAM,14685,6846,7839,9504,4775,406,ITF,ITF3,15,Campania,Campania,5801692,1814469,31.27,0.25
3103,2021-05-04,CAM,48480,23346,25134,38349,8901,1230,ITF,ITF3,15,Campania,Campania,5801692,1862949,32.11,0.84
3104,2021-01-24,CAM,4122,2119,2003,360,3745,17,ITF,ITF3,15,Campania,Campania,5801692,1867071,32.18,0.07
3105,2021-05-13,CAM,55451,24828,30623,37876,16005,1570,ITF,ITF3,15,Campania,Campania,5801692,1922522,33.14,0.96
3106,2021-01-31,CAM,8070,3712,4358,22,8047,1,ITF,ITF3,15,Campania,Campania,5801692,1930592,33.28,0.14
3107,2021-04-18,CAM,27220,13285,13935,17823,8900,497,ITF,ITF3,15,Campania,Campania,5801692,1957812,33.75,0.47
3108,2021-01-08,CAM,10454,4967,5487,10195,0,259,ITF,ITF3,15,Campania,Campania,5801692,1968266,33.93,0.18
3109,2021-04-27,CAM,32158,15625,16533,23497,7921,740,ITF,ITF3,15,Campania,Campania,5801692,2000424,34.48,0.55
3110,2021-06-23,CAM,46733,22076,24657,10750,35777,206,ITF,ITF3,15,Campania,Campania,5801692,2047157,35.29,0.81
3111,2021-01-15,CAM,4980,2381,2599,4824,0,156,ITF,ITF3,15,Campania,Campania,5801692,2052137,35.37,0.09
3112,2021-06-21,CAM,46774,22583,24191,11341,35150,283,ITF,ITF3,15,Campania,Campania,5801692,2098911,36.18,0.81
3113,2021-03-13,CAM,14518,7038,7480,8989,5282,247,ITF,ITF3,15,Campania,Campania,5801692,2113429,36.43,0.25
3114,2021-03-22,CAM,13181,6344,6837,10864,2041,276,ITF,ITF3,15,Campania,Campania,5801692,2126610,36.65,0.23
3115,2021-06-28,CAM,46484,22717,23767,20582,25384,518,ITF,ITF3,15,Campania,Campania,5801692,2173094,37.46,0.8
3116,2021-03-20,CAM,13986,6526,7460,10011,3739,236,ITF,ITF3,15,Campania,Campania,5801692,2187080,37.7,0.24
3117,2021-02-15,CAM,5471,2516,2955,5160,174,137,ITF,ITF3,15,Campania,Campania,5801692,2192551,37.79,0.09
3118,2021-06-09,CAM,53044,26047,26997,41698,10902,444,ITF,ITF3,15,Campania,Campania,5801692,2245595,38.71,0.91
3119,2021-03-01,CAM,12130,4248,7882,7784,4112,234,ITF,ITF3,15,Campania,Campania,5801692,2257725,38.91,0.21
3120,2021-05-09,CAM,43201,20285,22916,30970,11095,1136,ITF,ITF3,15,Campania,Campania,5801692,2300926,39.66,0.74
3121,2021-01-10,CAM,8165,3736,4429,7963,0,202,ITF,ITF3,15,Campania,Campania,5801692,2309091,39.8,0.14
3122,2021-04-03,CAM,21115,10315,10800,18280,2381,454,ITF,ITF3,15,Campania,Campania,5801692,2330206,40.16,0.36
3123,2021-05-23,CAM,58744,28638,30106,37221,20895,628,ITF,ITF3,15,Campania,Campania,5801692,2388950,41.18,1.01
3124,2021-04-01,CAM,24680,12010,12670,20080,4133,467,ITF,ITF3,15,Campania,Campania,5801692,2413630,41.6,0.43
3125,2021-05-28,CAM,73015,35285,37730,26278,46123,614,ITF,ITF3,15,Campania,Campania,5801692,2486645,42.86,1.26
3126,2021-05-14,CAM,61038,27583,33455,34851,24706,1481,ITF,ITF3,15,Campania,Campania,5801692,2547683,43.91,1.05
3127,2021-02-24,CAM,11783,4149,7634,10848,688,247,ITF,ITF3,15,Campania,Campania,5801692,2559466,44.12,0.2
3128,2021-01-20,CAM,1257,650,607,1226,0,31,ITF,ITF3,15,Campania,Campania,5801692,2560723,44.14,0.02
3129,2021-04-13,CAM,26606,12685,13921,20575,5533,498,ITF,ITF3,15,Campania,Campania,5801692,2587329,44.6,0.46
3130,2021-01-03,CAM,3836,2009,1827,3787,0,49,ITF,ITF3,15,Campania,Campania,5801692,2591165,44.66,0.07
3131,2021-07-05,CAM,63253,30494,32759,12751,49835,667,ITF,ITF3,15,Campania,Campania,5801692,2654418,45.75,1.09
3132,2021-07-07,CAM,52034,24606,27428,7251,44405,378,ITF,ITF3,15,Campania,Campania,5801692,2706452,46.65,0.9
3133,2021-03-29,CAM,19404,9577,9827,17470,1547,387,ITF,ITF3,15,Campania,Campania,5801692,2725856,46.98,0.33
3134,2021-02-07,CAM,2929,1382,1547,2068,771,90,ITF,ITF3,15,Campania,Campania,5801692,2728785,47.03,0.05
3135,2021-06-30,CAM,47563,22719,24844,18365,28585,613,ITF,ITF3,15,Campania,Campania,5801692,2776348,47.85,0.82
3136,2021-01-17,CAM,1155,551,604,682,453,20,ITF,ITF3,15,Campania,Campania,5801692,2777503,47.87,0.02
3137,2021-03-15,CAM,13345,6490,6855,8353,4746,246,ITF,ITF3,15,Campania,Campania,5801692,2790848,48.1,0.23
3138,2021-07-02,CAM,55851,26986,28865,14440,40927,484,ITF,ITF3,15,Campania,Campania,5801692,2846699,49.07,0.96
3139,2021-05-27,CAM,72911,35350,37561,25820,46533,558,ITF,ITF3,15,Campania,Campania,5801692,2919610,50.32,1.26
3140,2021-02-16,CAM,5439,2411,3028,4493,771,175,ITF,ITF3,15,Campania,Campania,5801692,2925049,50.42,0.09
3141,2021-05-22,CAM,67952,32508,35444,45625,21483,844,ITF,ITF3,15,Campania,Campania,5801692,2993001,51.59,1.17
3142,2021-03-24,CAM,17923,8370,9553,14626,2958,339,ITF,ITF3,15,Campania,Campania,5801692,3010924,51.9,0.31
3143,2021-05-20,CAM,60808,28121,32687,42224,17625,959,ITF,ITF3,15,Campania,Campania,5801692,3071732,52.95,1.05
3144,2021-02-09,CAM,4643,2202,2441,4234,252,157,ITF,ITF3,15,Campania,Campania,5801692,3076375,53.03,0.08
3145,2021-05-29,CAM,67813,32257,35556,43108,23866,839,ITF,ITF3,15,Campania,Campania,5801692,3144188,54.19,1.17
3146,2021-04-05,CAM,11638,5542,6096,8939,2424,275,ITF,ITF3,15,Campania,Campania,5801692,3155826,54.39,0.2
3147,2021-03-17,CAM,11590,5100,6490,4860,6581,149,ITF,ITF3,15,Campania,Campania,5801692,3167416,54.59,0.2
3148,2021-06-11,CAM,70781,34383,36398,63906,6033,842,ITF,ITF3,15,Campania,Campania,5801692,3238197,55.81,1.22
3149,2021-03-03,CAM,13924,5496,8428,7099,6630,195,ITF,ITF3,15,Campania,Campania,5801692,3252121,56.05,0.24
3150,2021-06-25,CAM,65481,31788,33693,13792,51310,379,ITF,ITF3,15,Campania,Campania,5801692,3317602,57.18,1.13
3151,2021-02-12,CAM,6530,2861,3669,6092,188,250,ITF,ITF3,15,Campania,Campania,5801692,3324132,57.3,0.11
3152,2021-01-29,CAM,10053,4812,5241,43,10006,4,ITF,ITF3,15,Campania,Campania,5801692,3334185,57.47,0.17
3153,2021-06-27,CAM,43539,21447,22092,14102,29063,374,ITF,ITF3,15,Campania,Campania,5801692,3377724,58.22,0.75
3154,2021-03-19,CAM,11143,4973,6170,7096,3873,174,ITF,ITF3,15,Campania,Campania,5801692,3388867,58.41,0.19
3155,2021-06-10,CAM,75888,36669,39219,67981,7033,874,ITF,ITF3,15,Campania,Campania,5801692,3464755,59.72,1.31
3156,2021-05-11,CAM,39861,19237,20624,29550,9400,911,ITF,ITF3,15,Campania,Campania,5801692,3504616,60.41,0.69
3157,2021-02-02,CAM,5724,2805,2919,413,5280,31,ITF,ITF3,15,Campania,Campania,5801692,3510340,60.51,0.1
3158,2021-03-31,CAM,23183,11369,11814,19355,3440,388,ITF,ITF3,15,Campania,Campania,5801692,3533523,60.91,0.4
3159,2021-04-07,CAM,24970,11985,12985,19712,4725,533,ITF,ITF3,15,Campania,Campania,5801692,3558493,61.34,0.43
3160,2021-04-02,CAM,21861,10522,11339,19096,2322,443,ITF,ITF3,15,Campania,Campania,5801692,3580354,61.71,0.38
3161,2021-01-05,CAM,7237,3637,3600,7076,0,161,ITF,ITF3,15,Campania,Campania,5801692,3587591,61.84,0.12
3162,2021-02-17,CAM,7389,3211,4178,6205,1060,124,ITF,ITF3,15,Campania,Campania,5801692,3594980,61.96,0.13
3163,2021-04-15,CAM,34343,16663,17680,23813,9902,628,ITF,ITF3,15,Campania,Campania,5801692,3629323,62.56,0.59
3164,2021-06-20,CAM,47594,22739,24855,14334,32975,285,ITF,ITF3,15,Campania,Campania,5801692,3676917,63.38,0.82
3165,2021-03-27,CAM,21513,10242,11271,17256,3865,392,ITF,ITF3,15,Campania,Campania,5801692,3698430,63.75,0.37
3166,2021-06-01,CAM,42009,20850,21159,31300,10490,219,ITF,ITF3,15,Campania,Campania,5801692,3740439,64.47,0.72
3167,2021-06-18,CAM,65877,31394,34483,35099,30290,488,ITF,ITF3,15,Campania,Campania,5801692,3806316,65.61,1.14
3168,2021-03-10,CAM,15611,7720,7891,8463,6835,313,ITF,ITF3,15,Campania,Campania,5801692,3821927,65.88,0.27
3169,2021-05-15,CAM,62655,29040,33615,42154,18712,1789,ITF,ITF3,15,Campania,Campania,5801692,3884582,66.96,1.08
3170,2021-03-12,CAM,14573,7409,7164,8198,6083,292,ITF,ITF3,15,Campania,Campania,5801692,3899155,67.21,0.25
3171,2021-06-03,CAM,72627,35223,37404,61156,10672,799,ITF,ITF3,15,Campania,Campania,5801692,3971782,68.46,1.25
3172,2021-02-23,CAM,11002,3388,7614,10206,526,270,ITF,ITF3,15,Campania,Campania,5801692,3982784,68.65,0.19
3173,2021-02-21,CAM,5836,2241,3595,5496,225,115,ITF,ITF3,15,Campania,Campania,5801692,3988620,68.75,0.1
3174,2021-06-22,CAM,52432,25003,27429,13197,38988,247,ITF,ITF3,15,Campania,Campania,5801692,4041052,69.65,0.9
3175,2021-03-14,CAM,8617,3827,4790,4380,4140,97,ITF,ITF3,15,Campania,Campania,5801692,4049669,69.8,0.15
3176,2021-05-10,CAM,35465,16389,19076,24991,9926,548,ITF,ITF3,15,Campania,Campania,5801692,4085134,70.41,0.61
3177,2021-06-08,CAM,53031,25849,27182,45457,6994,580,ITF,ITF3,15,Campania,Campania,5801692,4138165,71.33,0.91
3178,2021-04-26,CAM,34031,16648,17383,27571,5622,838,ITF,ITF3,15,Campania,Campania,5801692,4172196,71.91,0.59
3179,2021-03-07,CAM,11973,5404,6569,7816,3843,314,ITF,ITF3,15,Campania,Campania,5801692,4184169,72.12,0.21
3180,2021-05-03,CAM,40777,19898,20879,27957,11857,963,ITF,ITF3,15,Campania,Campania,5801692,4224946,72.82,0.7
3181,2021-06-29,CAM,49293,23973,25320,19840,28993,460,ITF,ITF3,15,Campania,Campania,5801692,4274239,73.67,0.85
3182,2021-06-15,CAM,18646,9069,9577,11013,7403,230,ITF,ITF3,15,Campania,Campania,5801692,4292885,73.99,0.32
3183,2021-05-25,CAM,46501,22382,24119,22546,23407,548,ITF,ITF3,15,Campania,Campania,5801692,4339386,74.8,0.8
3184,2021-04-22,CAM,33962,16540,17422,20932,12405,625,ITF,ITF3,15,Campania,Campania,5801692,4373348,75.38,0.59
3185,2021-01-12,CAM,5215,2564,2651,5076,0,139,ITF,ITF3,15,Campania,Campania,5801692,4378563,75.47,0.09
3186,2021-05-06,CAM,57282,27909,29373,41311,14451,1520,ITF,ITF3,15,Campania,Campania,5801692,4435845,76.46,0.99
3187,2021-02-22,CAM,10682,3294,7388,10194,263,225,ITF,ITF3,15,Campania,Campania,5801692,4446527,76.64,0.18
3188,2021-03-11,CAM,17998,9056,8942,10331,7279,388,ITF,ITF3,15,Campania,Campania,5801692,4464525,76.95,0.31
3189,2021-05-16,CAM,51145,23225,27920,32867,17572,706,ITF,ITF3,15,Campania,Campania,5801692,4515670,77.83,0.88
3190,2021-02-20,CAM,8573,3080,5493,8109,303,161,ITF,ITF3,15,Campania,Campania,5801692,4524243,77.98,0.15
3191,2021-02-03,CAM,8903,4003,4900,842,8025,36,ITF,ITF3,15,Campania,Campania,5801692,4533146,78.13,0.15
3192,2021-05-08,CAM,56429,27142,29287,39153,15828,1448,ITF,ITF3,15,Campania,Campania,5801692,4589575,79.11,0.97
3193,2021-01-28,CAM,8833,4122,4711,126,8699,8,ITF,ITF3,15,Campania,Campania,5801692,4598408,79.26,0.15
3194,2021-04-21,CAM,30231,14728,15503,17481,12227,523,ITF,ITF3,15,Campania,Campania,5801692,4628639,79.78,0.52
3195,2021-02-28,CAM,10412,3207,7205,8315,1900,197,ITF,ITF3,15,Campania,Campania,5801692,4639051,79.96,0.18
3196,2021-02-14,CAM,3928,1923,2005,3844,34,50,ITF,ITF3,15,Campania,Campania,5801692,4642979,80.03,0.07
3197,2021-01-26,CAM,7341,3726,3615,331,6989,21,ITF,ITF3,15,Campania,Campania,5801692,4650320,80.15,0.13
3198,2021-04-19,CAM,30769,14830,15939,18692,11572,505,ITF,ITF3,15,Campania,Campania,5801692,4681089,80.68,0.53
3199,2021-01-09,CAM,10567,5024,5543,10306,0,261,ITF,ITF3,15,Campania,Campania,5801692,4691656,80.87,0.18
3200,2021-05-18,CAM,52186,23231,28955,31877,19656,653,ITF,ITF3,15,Campania,Campania,5801692,4743842,81.77,0.9
3201,2021-02-05,CAM,7261,3463,3798,2019,5128,114,ITF,ITF3,15,Campania,Campania,5801692,4751103,81.89,0.13
3202,2021-04-29,CAM,41328,20036,21292,24096,16481,751,ITF,ITF3,15,Campania,Campania,5801692,4792431,82.6,0.71
3203,2021-01-19,CAM,1095,474,621,1042,3,50,ITF,ITF3,15,Campania,Campania,5801692,4793526,82.62,0.02
3204,2021-01-21,CAM,2092,1115,977,670,1416,6,ITF,ITF3,15,Campania,Campania,5801692,4795618,82.66,0.04
3205,2021-04-14,CAM,27650,13338,14312,18670,8570,410,ITF,ITF3,15,Campania,Campania,5801692,4823268,83.14,0.48
3206,2021-05-01,CAM,46342,22661,23681,29334,16105,903,ITF,ITF3,15,Campania,Campania,5801692,4869610,83.93,0.8
3207,2021-07-06,CAM,56592,27017,29575,16331,39814,447,ITF,ITF3,15,Campania,Campania,5801692,4926202,84.91,0.98
3208,2021-04-12,CAM,23306,10920,12386,19772,3035,499,ITF,ITF3,15,Campania,Campania,5801692,4949508,85.31,0.4
3209,2021-01-02,CAM,3672,1962,1710,3614,0,58,ITF,ITF3,15,Campania,Campania,5801692,4953180,85.37,0.06
3210,2021-06-17,CAM,60123,28834,31289,32867,26757,499,ITF,ITF3,15,Campania,Campania,5801692,5013303,86.41,1.04
3211,2021-07-04,CAM,48811,23761,25050,6326,42303,182,ITF,ITF3,15,Campania,Campania,5801692,5062114,87.25,0.84
3212,2021-03-26,CAM,19860,9320,10540,15648,3815,397,ITF,ITF3,15,Campania,Campania,5801692,5081974,87.59,0.34
3213,2021-02-08,CAM,5113,2449,2664,4164,803,146,ITF,ITF3,15,Campania,Campania,5801692,5087087,87.68,0.09
3214,2021-02-01,CAM,3984,1813,2171,102,3874,8,ITF,ITF3,15,Campania,Campania,5801692,5091071,87.75,0.07
3215,2021-03-30,CAM,22050,10575,11475,18597,2957,496,ITF,ITF3,15,Campania,Campania,5801692,5113121,88.13,0.38
3216,2021-04-17,CAM,36184,17511,18673,23985,11512,687,ITF,ITF3,15,Campania,Campania,5801692,5149305,88.76,0.62
3217,2021-06-13,CAM,43422,21236,22186,38101,4728,593,ITF,ITF3,15,Campania,Campania,5801692,5192727,89.5,0.75
3218,2021-05-30,CAM,52153,25441,26712,37960,13313,880,ITF,ITF3,15,Campania,Campania,5801692,5244880,90.4,0.9
3219,2021-02-19,CAM,9571,3559,6012,8714,650,207,ITF,ITF3,15,Campania,Campania,5801692,5254451,90.57,0.16
3220,2020-12-31,CAM,1489,810,679,1470,0,19,ITF,ITF3,15,Campania,Campania,5801692,5255940,90.59,0.03
3221,2021-06-06,CAM,63221,31442,31779,61926,648,647,ITF,ITF3,15,Campania,Campania,5801692,5319161,91.68,1.09
3222,2021-02-26,CAM,13335,4227,9108,11731,1336,268,ITF,ITF3,15,Campania,Campania,5801692,5332496,91.91,0.23
3223,2021-04-24,CAM,36363,17527,18836,24360,11248,755,ITF,ITF3,15,Campania,Campania,5801692,5368859,92.54,0.63
3224,2021-04-10,CAM,28354,13493,14861,22826,4914,614,ITF,ITF3,15,Campania,Campania,5801692,5397213,93.03,0.49
3225,2021-01-07,CAM,8910,4167,4743,8737,0,173,ITF,ITF3,15,Campania,Campania,5801692,5406123,93.18,0.15
3226,2021-03-05,CAM,16812,6665,10147,9864,6663,285,ITF,ITF3,15,Campania,Campania,5801692,5422935,93.47,0.29
3227,2021-01-14,CAM,7074,2978,4096,6810,0,264,ITF,ITF3,15,Campania,Campania,5801692,5430009,93.59,0.12
3228,2021-07-06,PIE,38174,19342,18832,9163,29011,0,ITC,ITC1,1,Piemonte,Piemonte,4356406,38174,0.88,0.88
3229,2021-03-28,PIE,16062,6901,9161,8118,7622,322,ITC,ITC1,1,Piemonte,Piemonte,4356406,54236,1.24,0.37
3230,2021-04-11,PIE,20841,9327,11514,18231,2154,456,ITC,ITC1,1,Piemonte,Piemonte,4356406,75077,1.72,0.48
3231,2021-01-04,PIE,5564,1679,3885,5563,0,1,ITC,ITC1,1,Piemonte,Piemonte,4356406,80641,1.85,0.13
3232,2021-04-28,PIE,26048,11740,14308,15467,10035,546,ITC,ITC1,1,Piemonte,Piemonte,4356406,106689,2.45,0.6
3233,2021-01-18,PIE,6167,2048,4119,5914,249,4,ITC,ITC1,1,Piemonte,Piemonte,4356406,112856,2.59,0.14
3234,2021-06-07,PIE,34883,17858,17025,30091,4788,4,ITC,ITC1,1,Piemonte,Piemonte,4356406,147739,3.39,0.8
3235,2020-12-28,PIE,1,1,0,1,0,0,ITC,ITC1,1,Piemonte,Piemonte,4356406,147740,3.39,0.0
3236,2021-03-23,PIE,13120,5491,7629,6567,6245,308,ITC,ITC1,1,Piemonte,Piemonte,4356406,160860,3.69,0.3
3237,2021-01-16,PIE,7771,2630,5141,7764,0,7,ITC,ITC1,1,Piemonte,Piemonte,4356406,168631,3.87,0.18
3238,2021-01-23,PIE,4257,1325,2932,877,3378,2,ITC,ITC1,1,Piemonte,Piemonte,4356406,172888,3.97,0.1
3239,2021-03-21,PIE,10728,4741,5987,4028,6533,167,ITC,ITC1,1,Piemonte,Piemonte,4356406,183616,4.21,0.25
3240,2021-05-19,PIE,33157,15307,17850,21453,11125,579,ITC,ITC1,1,Piemonte,Piemonte,4356406,216773,4.98,0.76
3241,2021-03-14,PIE,8205,3336,4869,5173,2897,135,ITC,ITC1,1,Piemonte,Piemonte,4356406,224978,5.16,0.19
3242,2021-05-10,PIE,28962,13964,14998,15414,13119,429,ITC,ITC1,1,Piemonte,Piemonte,4356406,253940,5.83,0.66
3243,2021-01-30,PIE,5981,2136,3845,217,5763,1,ITC,ITC1,1,Piemonte,Piemonte,4356406,259921,5.97,0.14
3244,2021-06-24,PIE,39143,19635,19508,18872,20271,0,ITC,ITC1,1,Piemonte,Piemonte,4356406,299064,6.86,0.9
3245,2021-03-16,PIE,10523,4269,6254,4372,6060,91,ITC,ITC1,1,Piemonte,Piemonte,4356406,309587,7.11,0.24
3246,2021-05-12,PIE,31906,15199,16707,18382,12906,618,ITC,ITC1,1,Piemonte,Piemonte,4356406,341493,7.84,0.73
3247,2021-06-19,PIE,39951,20261,19690,23307,16644,0,ITC,ITC1,1,Piemonte,Piemonte,4356406,381444,8.76,0.92
3248,2021-02-04,PIE,10206,3341,6865,586,9618,2,ITC,ITC1,1,Piemonte,Piemonte,4356406,391650,8.99,0.23
3249,2021-04-30,PIE,31849,14329,17520,17844,13337,668,ITC,ITC1,1,Piemonte,Piemonte,4356406,423499,9.72,0.73
3250,2021-02-11,PIE,6764,2107,4657,2987,3758,19,ITC,ITC1,1,Piemonte,Piemonte,4356406,430263,9.88,0.16
3251,2021-04-09,PIE,25859,11392,14467,20791,4507,561,ITC,ITC1,1,Piemonte,Piemonte,4356406,456122,10.47,0.59
3252,2020-12-30,PIE,730,322,408,730,0,0,ITC,ITC1,1,Piemonte,Piemonte,4356406,456852,10.49,0.02
3253,2021-06-05,PIE,36932,18920,18012,32474,4458,0,ITC,ITC1,1,Piemonte,Piemonte,4356406,493784,11.33,0.85
3254,2021-02-25,PIE,12219,5252,6967,11494,547,178,ITC,ITC1,1,Piemonte,Piemonte,4356406,506003,11.62,0.28
3255,2021-04-23,PIE,27452,12604,14848,19985,6762,705,ITC,ITC1,1,Piemonte,Piemonte,4356406,533455,12.25,0.63
3256,2021-05-24,PIE,28988,13423,15565,16647,11963,378,ITC,ITC1,1,Piemonte,Piemonte,4356406,562443,12.91,0.67
3257,2021-03-02,PIE,11202,4506,6696,10202,816,184,ITC,ITC1,1,Piemonte,Piemonte,4356406,573645,13.17,0.26
3258,2021-06-12,PIE,42539,22428,20111,39911,2628,0,ITC,ITC1,1,Piemonte,Piemonte,4356406,616184,14.14,0.98
3259,2021-05-17,PIE,30929,14611,16318,17493,13155,281,ITC,ITC1,1,Piemonte,Piemonte,4356406,647113,14.85,0.71
3260,2021-02-06,PIE,7995,2666,5329,398,7595,2,ITC,ITC1,1,Piemonte,Piemonte,4356406,655108,15.04,0.18
3261,2021-02-23,PIE,9234,3713,5521,8482,581,171,ITC,ITC1,1,Piemonte,Piemonte,4356406,664342,15.25,0.21
3262,2021-05-31,PIE,29107,14058,15049,20137,8579,391,ITC,ITC1,1,Piemonte,Piemonte,4356406,693449,15.92,0.67
3263,2021-06-17,PIE,41010,20593,20417,24709,16301,0,ITC,ITC1,1,Piemonte,Piemonte,4356406,734459,16.86,0.94
3264,2021-03-09,PIE,14064,5515,8549,11496,2343,225,ITC,ITC1,1,Piemonte,Piemonte,4356406,748523,17.18,0.32
3265,2021-05-02,PIE,25098,11276,13822,13968,10745,385,ITC,ITC1,1,Piemonte,Piemonte,4356406,773621,17.76,0.58
3266,2021-02-27,PIE,12691,4851,7840,12119,345,227,ITC,ITC1,1,Piemonte,Piemonte,4356406,786312,18.05,0.29
3267,2021-04-25,PIE,20234,9306,10928,17270,2501,463,ITC,ITC1,1,Piemonte,Piemonte,4356406,806546,18.51,0.46
3268,2021-05-05,PIE,32199,15099,17100,18547,13020,632,ITC,ITC1,1,Piemonte,Piemonte,4356406,838745,19.25,0.74
3269,2021-07-01,PIE,41806,20925,20881,20714,21091,1,ITC,ITC1,1,Piemonte,Piemonte,4356406,880551,20.21,0.96
3270,2021-07-03,PIE,39911,20042,19869,15915,23996,0,ITC,ITC1,1,Piemonte,Piemonte,4356406,920462,21.13,0.92
3271,2021-02-08,PIE,6919,2357,4562,662,6253,4,ITC,ITC1,1,Piemonte,Piemonte,4356406,927381,21.29,0.16
3272,2021-05-21,PIE,36088,16753,19335,19947,15638,503,ITC,ITC1,1,Piemonte,Piemonte,4356406,963469,22.12,0.83
3273,2021-06-02,PIE,26532,12999,13533,22064,4468,0,ITC,ITC1,1,Piemonte,Piemonte,4356406,990001,22.73,0.61
3274,2021-02-22,PIE,8483,3472,5011,7793,590,100,ITC,ITC1,1,Piemonte,Piemonte,4356406,998484,22.92,0.19
3275,2021-03-11,PIE,13822,5119,8703,10481,3098,243,ITC,ITC1,1,Piemonte,Piemonte,4356406,1012306,23.24,0.32
3276,2021-03-25,PIE,17071,7209,9862,7997,8639,435,ITC,ITC1,1,Piemonte,Piemonte,4356406,1029377,23.63,0.39
3277,2021-04-02,PIE,20143,8304,11839,11321,8427,395,ITC,ITC1,1,Piemonte,Piemonte,4356406,1049520,24.09,0.46
3278,2021-05-29,PIE,32805,15229,17576,20272,12169,364,ITC,ITC1,1,Piemonte,Piemonte,4356406,1082325,24.84,0.75
3279,2021-02-18,PIE,4791,2094,2697,4276,430,85,ITC,ITC1,1,Piemonte,Piemonte,4356406,1087116,24.95,0.11
3280,2021-04-16,PIE,28419,13220,15199,22655,4997,767,ITC,ITC1,1,Piemonte,Piemonte,4356406,1115535,25.61,0.65
3281,2021-06-26,PIE,41120,20918,20202,22618,18502,0,ITC,ITC1,1,Piemonte,Piemonte,4356406,1156655,26.55,0.94
3282,2021-04-04,PIE,9261,4062,5199,6398,2714,149,ITC,ITC1,1,Piemonte,Piemonte,4356406,1165916,26.76,0.21
3283,2021-04-21,PIE,25757,11841,13916,19792,5340,625,ITC,ITC1,1,Piemonte,Piemonte,4356406,1191673,27.35,0.59
3284,2021-01-11,PIE,8745,2981,5764,8739,0,6,ITC,ITC1,1,Piemonte,Piemonte,4356406,1200418,27.56,0.2
3285,2021-06-28,PIE,38358,19046,19312,15664,22692,2,ITC,ITC1,1,Piemonte,Piemonte,4356406,1238776,28.44,0.88
3286,2021-04-06,PIE,20250,8815,11435,14601,5197,452,ITC,ITC1,1,Piemonte,Piemonte,4356406,1259026,28.9,0.46
3287,2020-12-27,PIE,913,369,544,913,0,0,ITC,ITC1,1,Piemonte,Piemonte,4356406,1259939,28.92,0.02
3288,2021-04-20,PIE,25489,11667,13822,18516,6345,628,ITC,ITC1,1,Piemonte,Piemonte,4356406,1285428,29.51,0.59
3289,2021-05-07,PIE,33075,15644,17431,18559,14125,391,ITC,ITC1,1,Piemonte,Piemonte,4356406,1318503,30.27,0.76
3290,2021-01-27,PIE,4197,1453,2744,997,3198,2,ITC,ITC1,1,Piemonte,Piemonte,4356406,1322700,30.36,0.1
3291,2021-02-13,PIE,4153,1334,2819,2915,1222,16,ITC,ITC1,1,Piemonte,Piemonte,4356406,1326853,30.46,0.1
3292,2021-01-01,PIE,1038,395,643,1037,0,1,ITC,ITC1,1,Piemonte,Piemonte,4356406,1327891,30.48,0.02
3293,2021-07-05,PIE,35536,17778,17758,12352,23183,1,ITC,ITC1,1,Piemonte,Piemonte,4356406,1363427,31.3,0.82
3294,2021-02-20,PIE,3834,1254,2580,3560,174,100,ITC,ITC1,1,Piemonte,Piemonte,4356406,1367261,31.39,0.09
3295,2021-03-30,PIE,16917,7056,9861,8660,7873,384,ITC,ITC1,1,Piemonte,Piemonte,4356406,1384178,31.77,0.39
3296,2021-04-01,PIE,19348,8083,11265,10919,8120,309,ITC,ITC1,1,Piemonte,Piemonte,4356406,1403526,32.22,0.44
3297,2021-05-28,PIE,35039,16600,18439,18663,15978,398,ITC,ITC1,1,Piemonte,Piemonte,4356406,1438565,33.02,0.8
3298,2021-01-25,PIE,6215,1938,4277,981,5232,2,ITC,ITC1,1,Piemonte,Piemonte,4356406,1444780,33.16,0.14
3299,2021-05-30,PIE,27705,13187,14518,18007,9324,374,ITC,ITC1,1,Piemonte,Piemonte,4356406,1472485,33.8,0.64
3300,2021-02-19,PIE,5535,2175,3360,4915,501,119,ITC,ITC1,1,Piemonte,Piemonte,4356406,1478020,33.93,0.13
3301,2021-06-04,PIE,37526,19623,17903,34571,2953,2,ITC,ITC1,1,Piemonte,Piemonte,4356406,1515546,34.79,0.86
3302,2021-02-24,PIE,11410,4630,6780,10764,505,141,ITC,ITC1,1,Piemonte,Piemonte,4356406,1526956,35.05,0.26
3303,2021-02-01,PIE,8645,3055,5590,578,8066,1,ITC,ITC1,1,Piemonte,Piemonte,4356406,1535601,35.25,0.2
3304,2021-05-14,PIE,33417,16277,17140,17335,15424,658,ITC,ITC1,1,Piemonte,Piemonte,4356406,1569018,36.02,0.77
3305,2021-04-13,PIE,25951,11619,14332,21899,3459,593,ITC,ITC1,1,Piemonte,Piemonte,4356406,1594969,36.61,0.6
3306,2021-01-20,PIE,6618,2089,4529,5893,718,7,ITC,ITC1,1,Piemonte,Piemonte,4356406,1601587,36.76,0.15
3307,2021-02-03,PIE,10203,3305,6898,609,9592,2,ITC,ITC1,1,Piemonte,Piemonte,4356406,1611790,37.0,0.23
3308,2021-05-18,PIE,32137,14841,17296,19039,12663,435,ITC,ITC1,1,Piemonte,Piemonte,4356406,1643927,37.74,0.74
3309,2021-01-03,PIE,3063,967,2096,3061,0,2,ITC,ITC1,1,Piemonte,Piemonte,4356406,1646990,37.81,0.07
3310,2021-01-15,PIE,9114,3012,6102,9108,0,6,ITC,ITC1,1,Piemonte,Piemonte,4356406,1656104,38.02,0.21
3311,2021-06-21,PIE,38294,19103,19191,17607,20687,0,ITC,ITC1,1,Piemonte,Piemonte,4356406,1694398,38.89,0.88
3312,2021-03-13,PIE,13047,4723,8324,11334,1445,268,ITC,ITC1,1,Piemonte,Piemonte,4356406,1707445,39.19,0.3
3313,2021-04-18,PIE,22973,10822,12151,19654,2756,563,ITC,ITC1,1,Piemonte,Piemonte,4356406,1730418,39.72,0.53
3314,2021-01-08,PIE,5533,1762,3771,5531,0,2,ITC,ITC1,1,Piemonte,Piemonte,4356406,1735951,39.85,0.13
3315,2021-06-14,PIE,37918,19536,18382,30826,7090,2,ITC,ITC1,1,Piemonte,Piemonte,4356406,1773869,40.72,0.87
3316,2021-03-06,PIE,13994,5211,8783,11033,2789,172,ITC,ITC1,1,Piemonte,Piemonte,4356406,1787863,41.04,0.32
3317,2021-01-22,PIE,3867,1249,2618,2524,1341,2,ITC,ITC1,1,Piemonte,Piemonte,4356406,1791730,41.13,0.09
3318,2021-05-09,PIE,27150,12934,14216,13149,13621,380,ITC,ITC1,1,Piemonte,Piemonte,4356406,1818880,41.75,0.62
3319,2021-05-26,PIE,32752,15105,17647,15323,17080,349,ITC,ITC1,1,Piemonte,Piemonte,4356406,1851632,42.5,0.75
3320,2021-02-15,PIE,4432,1597,2835,3203,1205,24,ITC,ITC1,1,Piemonte,Piemonte,4356406,1856064,42.61,0.1
3321,2021-03-04,PIE,14535,5770,8765,11368,2948,219,ITC,ITC1,1,Piemonte,Piemonte,4356406,1870599,42.94,0.33
3322,2021-06-25,PIE,45349,22583,22766,20833,24514,2,ITC,ITC1,1,Piemonte,Piemonte,4356406,1915948,43.98,1.04
3323,2021-04-03,PIE,19435,8160,11275,10583,8547,305,ITC,ITC1,1,Piemonte,Piemonte,4356406,1935383,44.43,0.45
3324,2021-01-10,PIE,5214,2275,2939,5212,0,2,ITC,ITC1,1,Piemonte,Piemonte,4356406,1940597,44.55,0.12
3325,2021-04-22,PIE,27697,12754,14943,20194,6709,794,ITC,ITC1,1,Piemonte,Piemonte,4356406,1968294,45.18,0.64
3326,2021-01-12,PIE,10090,3415,6675,10083,0,7,ITC,ITC1,1,Piemonte,Piemonte,4356406,1978384,45.41,0.23
3327,2021-01-29,PIE,5945,1887,4058,455,5490,0,ITC,ITC1,1,Piemonte,Piemonte,4356406,1984329,45.55,0.14
3328,2021-04-17,PIE,30484,14161,16323,26460,3316,708,ITC,ITC1,1,Piemonte,Piemonte,4356406,2014813,46.25,0.7
3329,2021-06-13,PIE,37877,19996,17881,33746,4131,0,ITC,ITC1,1,Piemonte,Piemonte,4356406,2052690,47.12,0.87
3330,2021-02-10,PIE,7536,2371,5165,1301,6220,15,ITC,ITC1,1,Piemonte,Piemonte,4356406,2060226,47.29,0.17
3331,2021-04-08,PIE,25154,10935,14219,19870,4730,554,ITC,ITC1,1,Piemonte,Piemonte,4356406,2085380,47.87,0.58
3332,2021-04-10,PIE,30198,13431,16767,25275,4278,645,ITC,ITC1,1,Piemonte,Piemonte,4356406,2115578,48.56,0.69
3333,2021-04-15,PIE,29655,13585,16070,23496,5486,673,ITC,ITC1,1,Piemonte,Piemonte,4356406,2145233,49.24,0.68
3334,2021-01-05,PIE,5381,1603,3778,5376,0,5,ITC,ITC1,1,Piemonte,Piemonte,4356406,2150614,49.37,0.12
3335,2021-06-22,PIE,40492,19985,20507,18292,22200,0,ITC,ITC1,1,Piemonte,Piemonte,4356406,2191106,50.3,0.93
3336,2021-01-07,PIE,5387,1739,3648,5385,0,2,ITC,ITC1,1,Piemonte,Piemonte,4356406,2196493,50.42,0.12
3337,2021-03-05,PIE,15377,6061,9316,11290,3819,268,ITC,ITC1,1,Piemonte,Piemonte,4356406,2211870,50.77,0.35
3338,2021-06-15,PIE,38874,20023,18851,27109,11761,4,ITC,ITC1,1,Piemonte,Piemonte,4356406,2250744,51.67,0.89
3339,2021-03-07,PIE,11977,4658,7319,10858,878,241,ITC,ITC1,1,Piemonte,Piemonte,4356406,2262721,51.94,0.27
3340,2020-12-31,PIE,3909,1334,2575,3909,0,0,ITC,ITC1,1,Piemonte,Piemonte,4356406,2266630,52.03,0.09
3341,2021-04-29,PIE,48477,21980,26497,34684,12618,1175,ITC,ITC1,1,Piemonte,Piemonte,4356406,2315107,53.14,1.11
3342,2021-05-16,PIE,28145,12780,15365,14711,13065,369,ITC,ITC1,1,Piemonte,Piemonte,4356406,2343252,53.79,0.65
3343,2021-02-05,PIE,9604,3139,6465,657,8945,2,ITC,ITC1,1,Piemonte,Piemonte,4356406,2352856,54.01,0.22
3344,2021-07-07,PIE,37653,18743,18910,10098,27540,15,ITC,ITC1,1,Piemonte,Piemonte,4356406,2390509,54.87,0.86
3345,2021-03-29,PIE,15186,6405,8781,8315,6612,259,ITC,ITC1,1,Piemonte,Piemonte,4356406,2405695,55.22,0.35
3346,2021-04-12,PIE,22951,10368,12583,19523,2990,438,ITC,ITC1,1,Piemonte,Piemonte,4356406,2428646,55.75,0.53
3347,2021-01-02,PIE,3545,1134,2411,3544,0,1,ITC,ITC1,1,Piemonte,Piemonte,4356406,2432191,55.83,0.08
3348,2021-05-01,PIE,28540,12999,15541,16303,11799,438,ITC,ITC1,1,Piemonte,Piemonte,4356406,2460731,56.49,0.66
3349,2021-01-21,PIE,6881,2314,4567,3379,3496,6,ITC,ITC1,1,Piemonte,Piemonte,4356406,2467612,56.64,0.16
3350,2021-05-15,PIE,33779,15747,18032,19409,13718,652,ITC,ITC1,1,Piemonte,Piemonte,4356406,2501391,57.42,0.78
3351,2021-06-06,PIE,35042,18313,16729,32588,2454,0,ITC,ITC1,1,Piemonte,Piemonte,4356406,2536433,58.22,0.8
3352,2021-02-17,PIE,4795,2158,2637,3746,990,59,ITC,ITC1,1,Piemonte,Piemonte,4356406,2541228,58.33,0.11
3353,2021-06-08,PIE,37644,19493,18151,34803,2841,0,ITC,ITC1,1,Piemonte,Piemonte,4356406,2578872,59.2,0.86
3354,2021-04-26,PIE,19800,8748,11052,14893,4402,505,ITC,ITC1,1,Piemonte,Piemonte,4356406,2598672,59.65,0.45
3355,2021-05-03,PIE,26659,12168,14491,12058,14161,440,ITC,ITC1,1,Piemonte,Piemonte,4356406,2625331,60.26,0.61
3356,2021-02-26,PIE,12293,4933,7360,11353,737,203,ITC,ITC1,1,Piemonte,Piemonte,4356406,2637624,60.55,0.28
3357,2021-04-24,PIE,27512,12438,15074,21279,5659,574,ITC,ITC1,1,Piemonte,Piemonte,4356406,2665136,61.18,0.63
3358,2021-01-14,PIE,9767,3152,6615,9759,0,8,ITC,ITC1,1,Piemonte,Piemonte,4356406,2674903,61.4,0.22
3359,2021-07-02,PIE,43546,21904,21642,18091,25454,1,ITC,ITC1,1,Piemonte,Piemonte,4356406,2718449,62.4,1.0
3360,2021-02-28,PIE,10816,4060,6756,10403,240,173,ITC,ITC1,1,Piemonte,Piemonte,4356406,2729265,62.65,0.25
3361,2021-03-17,PIE,12518,5055,7463,5044,7294,180,ITC,ITC1,1,Piemonte,Piemonte,4356406,2741783,62.94,0.29
3362,2021-06-10,PIE,40296,21052,19244,37734,2557,5,ITC,ITC1,1,Piemonte,Piemonte,4356406,2782079,63.86,0.92
3363,2021-06-27,PIE,37423,18561,18862,15689,21734,0,ITC,ITC1,1,Piemonte,Piemonte,4356406,2819502,64.72,0.86
3364,2021-03-19,PIE,11032,4521,6511,4219,6606,207,ITC,ITC1,1,Piemonte,Piemonte,4356406,2830534,64.97,0.25
3365,2021-04-05,PIE,14748,6234,8514,11941,2556,251,ITC,ITC1,1,Piemonte,Piemonte,4356406,2845282,65.31,0.34
3366,2021-06-29,PIE,40437,20210,20227,19803,20633,1,ITC,ITC1,1,Piemonte,Piemonte,4356406,2885719,66.24,0.93
3367,2021-05-13,PIE,35685,17527,18158,19867,15118,700,ITC,ITC1,1,Piemonte,Piemonte,4356406,2921404,67.06,0.82
3368,2021-02-02,PIE,10242,3509,6733,815,9426,1,ITC,ITC1,1,Piemonte,Piemonte,4356406,2931646,67.3,0.24
3369,2021-03-31,PIE,19110,8104,11006,10078,8694,338,ITC,ITC1,1,Piemonte,Piemonte,4356406,2950756,67.73,0.44
3370,2021-05-27,PIE,37397,17394,20003,18826,18138,433,ITC,ITC1,1,Piemonte,Piemonte,4356406,2988153,68.59,0.86
3371,2021-02-16,PIE,3967,1756,2211,3161,758,48,ITC,ITC1,1,Piemonte,Piemonte,4356406,2992120,68.68,0.09
3372,2021-03-24,PIE,15540,6373,9167,6083,9127,330,ITC,ITC1,1,Piemonte,Piemonte,4356406,3007660,69.04,0.36
3373,2021-05-20,PIE,38624,17938,20686,13326,24944,354,ITC,ITC1,1,Piemonte,Piemonte,4356406,3046284,69.93,0.89
3374,2021-02-09,PIE,7392,2316,5076,720,6670,2,ITC,ITC1,1,Piemonte,Piemonte,4356406,3053676,70.1,0.17
3375,2021-04-07,PIE,23611,9999,13612,17635,5461,515,ITC,ITC1,1,Piemonte,Piemonte,4356406,3077287,70.64,0.54
3376,2021-06-18,PIE,40444,20191,20253,26301,14143,0,ITC,ITC1,1,Piemonte,Piemonte,4356406,3117731,71.57,0.93
3377,2021-03-10,PIE,13682,5214,8468,11138,2294,250,ITC,ITC1,1,Piemonte,Piemonte,4356406,3131413,71.88,0.31
3378,2021-03-27,PIE,18398,7828,10570,9137,8827,434,ITC,ITC1,1,Piemonte,Piemonte,4356406,3149811,72.3,0.42
3379,2021-01-19,PIE,6466,2105,4361,6445,12,9,ITC,ITC1,1,Piemonte,Piemonte,4356406,3156277,72.45,0.15
3380,2021-06-09,PIE,38577,20335,18242,35855,2716,6,ITC,ITC1,1,Piemonte,Piemonte,4356406,3194854,73.34,0.89
3381,2021-03-18,PIE,11759,4805,6954,3838,7730,191,ITC,ITC1,1,Piemonte,Piemonte,4356406,3206613,73.61,0.27
3382,2021-06-01,PIE,29274,14675,14599,24868,4406,0,ITC,ITC1,1,Piemonte,Piemonte,4356406,3235887,74.28,0.67
3383,2021-02-21,PIE,5090,2083,3007,4937,102,51,ITC,ITC1,1,Piemonte,Piemonte,4356406,3240977,74.4,0.12
3384,2021-06-20,PIE,33996,17031,16965,19279,14717,0,ITC,ITC1,1,Piemonte,Piemonte,4356406,3274973,75.18,0.78
3385,2021-03-12,PIE,14015,5241,8774,10802,2937,276,ITC,ITC1,1,Piemonte,Piemonte,4356406,3288988,75.5,0.32
3386,2021-07-04,PIE,33640,16955,16685,11766,21874,0,ITC,ITC1,1,Piemonte,Piemonte,4356406,3322628,76.27,0.77
3387,2021-03-26,PIE,17811,7028,10783,8380,8907,524,ITC,ITC1,1,Piemonte,Piemonte,4356406,3340439,76.68,0.41
3388,2021-04-14,PIE,27716,12566,15150,22495,4525,696,ITC,ITC1,1,Piemonte,Piemonte,4356406,3368155,77.31,0.64
3389,2021-06-03,PIE,34610,17878,16732,30210,4399,1,ITC,ITC1,1,Piemonte,Piemonte,4356406,3402765,78.11,0.79
3390,2021-03-03,PIE,12120,4644,7476,11113,819,188,ITC,ITC1,1,Piemonte,Piemonte,4356406,3414885,78.39,0.28
3391,2021-03-20,PIE,11924,4901,7023,5783,5898,243,ITC,ITC1,1,Piemonte,Piemonte,4356406,3426809,78.66,0.27
3392,2021-05-06,PIE,33483,15796,17687,19330,13555,598,ITC,ITC1,1,Piemonte,Piemonte,4356406,3460292,79.43,0.77
3393,2021-05-23,PIE,28730,13146,15584,15470,12952,308,ITC,ITC1,1,Piemonte,Piemonte,4356406,3489022,80.09,0.66
3394,2021-02-12,PIE,6892,2216,4676,3908,2961,23,ITC,ITC1,1,Piemonte,Piemonte,4356406,3495914,80.25,0.16
3395,2021-03-01,PIE,12043,4846,7197,11066,809,168,ITC,ITC1,1,Piemonte,Piemonte,4356406,3507957,80.52,0.28
3396,2021-05-25,PIE,31152,14456,16696,15624,15143,385,ITC,ITC1,1,Piemonte,Piemonte,4356406,3539109,81.24,0.72
3397,2021-06-11,PIE,43524,23037,20487,40682,2836,6,ITC,ITC1,1,Piemonte,Piemonte,4356406,3582633,82.24,1.0
3398,2021-04-19,PIE,22562,10775,11787,17635,4364,563,ITC,ITC1,1,Piemonte,Piemonte,4356406,3605195,82.76,0.52
3399,2021-01-09,PIE,6185,2185,4000,6184,0,1,ITC,ITC1,1,Piemonte,Piemonte,4356406,3611380,82.9,0.14
3400,2021-01-26,PIE,6333,1880,4453,734,5598,1,ITC,ITC1,1,Piemonte,Piemonte,4356406,3617713,83.04,0.15
3401,2021-05-08,PIE,34295,16274,18021,18140,15642,513,ITC,ITC1,1,Piemonte,Piemonte,4356406,3652008,83.83,0.79
3402,2021-01-28,PIE,5591,1809,3782,384,5207,0,ITC,ITC1,1,Piemonte,Piemonte,4356406,3657599,83.96,0.13
3403,2021-02-14,PIE,1476,498,978,869,600,7,ITC,ITC1,1,Piemonte,Piemonte,4356406,3659075,83.99,0.03
3404,2021-01-13,PIE,10085,3226,6859,10076,0,9,ITC,ITC1,1,Piemonte,Piemonte,4356406,3669160,84.22,0.23
3405,2021-06-16,PIE,40340,20220,20120,24093,16247,0,ITC,ITC1,1,Piemonte,Piemonte,4356406,3709500,85.15,0.93
3406,2021-01-06,PIE,3117,1111,2006,3116,0,1,ITC,ITC1,1,Piemonte,Piemonte,4356406,3712617,85.22,0.07
3407,2021-06-23,PIE,39662,19693,19969,16842,22820,0,ITC,ITC1,1,Piemonte,Piemonte,4356406,3752279,86.13,0.91
3408,2021-03-08,PIE,14020,5359,8661,11078,2714,228,ITC,ITC1,1,Piemonte,Piemonte,4356406,3766299,86.45,0.32
3409,2021-05-04,PIE,28587,13146,15441,15891,12177,519,ITC,ITC1,1,Piemonte,Piemonte,4356406,3794886,87.11,0.66
3410,2021-01-24,PIE,3153,959,2194,432,2719,2,ITC,ITC1,1,Piemonte,Piemonte,4356406,3798039,87.18,0.07
3411,2021-06-30,PIE,41109,20090,21019,19191,21915,3,ITC,ITC1,1,Piemonte,Piemonte,4356406,3839148,88.13,0.94
3412,2021-03-22,PIE,11523,4890,6633,3710,7606,207,ITC,ITC1,1,Piemonte,Piemonte,4356406,3850671,88.39,0.26
3413,2021-04-27,PIE,22611,10214,12397,16824,5147,640,ITC,ITC1,1,Piemonte,Piemonte,4356406,3873282,88.91,0.52
3414,2021-01-17,PIE,3520,1169,2351,2870,648,2,ITC,ITC1,1,Piemonte,Piemonte,4356406,3876802,88.99,0.08
3415,2021-03-15,PIE,10682,4184,6498,4911,5620,151,ITC,ITC1,1,Piemonte,Piemonte,4356406,3887484,89.24,0.25
3416,2021-05-11,PIE,32080,15460,16620,18229,13213,638,ITC,ITC1,1,Piemonte,Piemonte,4356406,3919564,89.97,0.74
3417,2021-01-31,PIE,4113,1753,2360,112,4001,0,ITC,ITC1,1,Piemonte,Piemonte,4356406,3923677,90.07,0.09
3418,2021-02-07,PIE,3089,974,2115,444,2644,1,ITC,ITC1,1,Piemonte,Piemonte,4356406,3926766,90.14,0.07
3419,2021-05-22,PIE,33495,15115,18380,16875,16226,394,ITC,ITC1,1,Piemonte,Piemonte,4356406,3960261,90.91,0.77
3420,2021-02-25,SIC,9868,5155,4713,8619,1164,85,ITG,ITG1,19,Sicilia,Sicilia,4999891,9868,0.2,0.2
3421,2021-06-05,SIC,59931,28508,31423,48738,10578,615,ITG,ITG1,19,Sicilia,Sicilia,4999891,69799,1.4,1.2
3422,2021-03-14,SIC,8773,3927,4846,4886,3836,51,ITG,ITG1,19,Sicilia,Sicilia,4999891,78572,1.57,0.18
3423,2021-02-11,SIC,5236,2059,3177,4656,463,117,ITG,ITG1,19,Sicilia,Sicilia,4999891,83808,1.68,0.1
3424,2021-06-19,SIC,44249,21040,23209,18750,25183,316,ITG,ITG1,19,Sicilia,Sicilia,4999891,128057,2.56,0.88
3425,2021-04-23,SIC,28565,13695,14870,22367,5835,363,ITG,ITG1,19,Sicilia,Sicilia,4999891,156622,3.13,0.57
3426,2021-06-26,SIC,37230,17762,19468,16356,20576,298,ITG,ITG1,19,Sicilia,Sicilia,4999891,193852,3.88,0.74
3427,2021-04-30,SIC,34984,16332,18652,23522,11016,446,ITG,ITG1,19,Sicilia,Sicilia,4999891,228836,4.58,0.7
3428,2021-01-30,SIC,7694,3535,4159,166,7526,2,ITG,ITG1,19,Sicilia,Sicilia,4999891,236530,4.73,0.15
3429,2021-03-28,SIC,10980,5147,5833,6909,4011,60,ITG,ITG1,19,Sicilia,Sicilia,4999891,247510,4.95,0.22
3430,2021-04-04,SIC,6805,3322,3483,5451,1292,62,ITG,ITG1,19,Sicilia,Sicilia,4999891,254315,5.09,0.14
3431,2021-02-13,SIC,2977,1123,1854,2686,255,36,ITG,ITG1,19,Sicilia,Sicilia,4999891,257292,5.15,0.06
3432,2021-05-24,SIC,35669,17307,18362,15477,19960,232,ITG,ITG1,19,Sicilia,Sicilia,4999891,292961,5.86,0.71
3433,2021-05-17,SIC,31848,15365,16483,18950,12616,282,ITG,ITG1,19,Sicilia,Sicilia,4999891,324809,6.5,0.64
3434,2021-03-21,SIC,15217,7340,7877,11181,3969,67,ITG,ITG1,19,Sicilia,Sicilia,4999891,340026,6.8,0.3
3435,2021-02-06,SIC,4699,2099,2600,1444,3234,21,ITG,ITG1,19,Sicilia,Sicilia,4999891,344725,6.89,0.09
3436,2021-06-24,SIC,42274,19625,22649,17584,24337,353,ITG,ITG1,19,Sicilia,Sicilia,4999891,386999,7.74,0.85
3437,2021-06-07,SIC,49563,23362,26201,41114,7920,529,ITG,ITG1,19,Sicilia,Sicilia,4999891,436562,8.73,0.99
3438,2021-01-25,SIC,7422,3674,3748,284,7131,7,ITG,ITG1,19,Sicilia,Sicilia,4999891,443984,8.88,0.15
3439,2021-05-05,SIC,26294,12187,14107,16243,9627,424,ITG,ITG1,19,Sicilia,Sicilia,4999891,470278,9.41,0.53
3440,2021-05-19,SIC,42736,20708,22028,28075,14302,359,ITG,ITG1,19,Sicilia,Sicilia,4999891,513014,10.26,0.85
3441,2021-03-02,SIC,14666,6305,8361,11780,2774,112,ITG,ITG1,19,Sicilia,Sicilia,4999891,527680,10.55,0.29
3442,2021-01-04,SIC,8392,4195,4197,8347,0,45,ITG,ITG1,19,Sicilia,Sicilia,4999891,536072,10.72,0.17
3443,2021-01-18,SIC,1594,652,942,1430,153,11,ITG,ITG1,19,Sicilia,Sicilia,4999891,537666,10.75,0.03
3444,2021-04-28,SIC,29258,13714,15544,19732,9144,382,ITG,ITG1,19,Sicilia,Sicilia,4999891,566924,11.34,0.59
3445,2021-04-11,SIC,15367,7590,7777,8234,7030,103,ITG,ITG1,19,Sicilia,Sicilia,4999891,582291,11.65,0.31
3446,2020-12-30,SIC,184,109,75,183,0,1,ITG,ITG1,19,Sicilia,Sicilia,4999891,582475,11.65,0.0
3447,2021-01-16,SIC,2716,1211,1505,2695,0,21,ITG,ITG1,19,Sicilia,Sicilia,4999891,585191,11.7,0.05
3448,2021-07-01,SIC,30904,14035,16869,10723,19926,255,ITG,ITG1,19,Sicilia,Sicilia,4999891,616095,12.32,0.62
3449,2021-04-09,SIC,20270,9876,10394,10948,9076,246,ITG,ITG1,19,Sicilia,Sicilia,4999891,636365,12.73,0.41
3450,2021-03-23,SIC,20850,10008,10842,15185,5514,151,ITG,ITG1,19,Sicilia,Sicilia,4999891,657215,13.14,0.42
3451,2020-12-28,SIC,214,128,86,213,0,1,ITG,ITG1,19,Sicilia,Sicilia,4999891,657429,13.15,0.0
3452,2021-05-31,SIC,37916,17052,20864,21280,16339,297,ITG,ITG1,19,Sicilia,Sicilia,4999891,695345,13.91,0.76
3453,2021-04-16,SIC,28842,14482,14360,20266,8271,305,ITG,ITG1,19,Sicilia,Sicilia,4999891,724187,14.48,0.58
3454,2021-01-23,SIC,4435,2282,2153,195,4230,10,ITG,ITG1,19,Sicilia,Sicilia,4999891,728622,14.57,0.09
3455,2021-01-06,SIC,6240,3284,2956,6180,0,60,ITG,ITG1,19,Sicilia,Sicilia,4999891,734862,14.7,0.12
3456,2021-04-02,SIC,13874,6542,7332,9037,4733,104,ITG,ITG1,19,Sicilia,Sicilia,4999891,748736,14.98,0.28
3457,2021-02-10,SIC,4354,1775,2579,3889,381,84,ITG,ITG1,19,Sicilia,Sicilia,4999891,753090,15.06,0.09
3458,2021-05-21,SIC,48546,23016,25530,26551,21575,420,ITG,ITG1,19,Sicilia,Sicilia,4999891,801636,16.03,0.97
3459,2021-03-04,SIC,15074,6570,8504,10832,4117,125,ITG,ITG1,19,Sicilia,Sicilia,4999891,816710,16.33,0.3
3460,2021-06-12,SIC,45759,22384,23375,39347,5888,524,ITG,ITG1,19,Sicilia,Sicilia,4999891,862469,17.25,0.92
3461,2021-05-07,SIC,36558,17259,19299,24626,11614,318,ITG,ITG1,19,Sicilia,Sicilia,4999891,899027,17.98,0.73
3462,2021-03-11,SIC,15338,6620,8718,12830,2370,138,ITG,ITG1,19,Sicilia,Sicilia,4999891,914365,18.29,0.31
3463,2021-01-27,SIC,7286,3711,3575,176,7109,1,ITG,ITG1,19,Sicilia,Sicilia,4999891,921651,18.43,0.15
3464,2021-01-13,SIC,5175,2437,2738,5141,0,34,ITG,ITG1,19,Sicilia,Sicilia,4999891,926826,18.54,0.1
3465,2021-06-04,SIC,57691,26664,31027,45376,11817,498,ITG,ITG1,19,Sicilia,Sicilia,4999891,984517,19.69,1.15
3466,2021-04-06,SIC,17748,8479,9269,13268,4283,197,ITG,ITG1,19,Sicilia,Sicilia,4999891,1002265,20.05,0.35
3467,2021-02-04,SIC,6748,3074,3674,1423,5296,29,ITG,ITG1,19,Sicilia,Sicilia,4999891,1009013,20.18,0.13
3468,2021-01-01,SIC,819,438,381,815,0,4,ITG,ITG1,19,Sicilia,Sicilia,4999891,1009832,20.2,0.02
3469,2021-04-20,SIC,19009,9004,10005,13473,5245,291,ITG,ITG1,19,Sicilia,Sicilia,4999891,1028841,20.58,0.38
3470,2021-03-16,SIC,9559,4278,5281,3556,5936,67,ITG,ITG1,19,Sicilia,Sicilia,4999891,1038400,20.77,0.19
3471,2021-07-08,SIC,19845,8872,10973,2743,17018,84,ITG,ITG1,19,Sicilia,Sicilia,4999891,1058245,21.17,0.4
3472,2021-02-27,SIC,12235,5501,6734,10936,1204,95,ITG,ITG1,19,Sicilia,Sicilia,4999891,1070480,21.41,0.24
3473,2021-02-08,SIC,3884,1680,2204,2080,1755,49,ITG,ITG1,19,Sicilia,Sicilia,4999891,1074364,21.49,0.08
3474,2021-02-23,SIC,8685,4590,4095,8140,466,79,ITG,ITG1,19,Sicilia,Sicilia,4999891,1083049,21.66,0.17
3475,2021-03-09,SIC,13081,5702,7379,10757,2200,124,ITG,ITG1,19,Sicilia,Sicilia,4999891,1096130,21.92,0.26
3476,2021-01-11,SIC,5827,2571,3256,5769,0,58,ITG,ITG1,19,Sicilia,Sicilia,4999891,1101957,22.04,0.12
3477,2021-06-16,SIC,40245,18710,21535,21212,18681,352,ITG,ITG1,19,Sicilia,Sicilia,4999891,1142202,22.84,0.8
3478,2021-03-25,SIC,20356,9460,10896,14724,5465,167,ITG,ITG1,19,Sicilia,Sicilia,4999891,1162558,23.25,0.41
3479,2021-07-03,SIC,33931,16244,17687,9077,24616,238,ITG,ITG1,19,Sicilia,Sicilia,4999891,1196489,23.93,0.68
3480,2021-02-18,SIC,5277,3100,2177,4783,430,64,ITG,ITG1,19,Sicilia,Sicilia,4999891,1201766,24.04,0.11
3481,2021-05-12,SIC,36768,17315,19453,21330,14909,529,ITG,ITG1,19,Sicilia,Sicilia,4999891,1238534,24.77,0.74
3482,2021-04-08,SIC,16704,8251,8453,8083,8470,151,ITG,ITG1,19,Sicilia,Sicilia,4999891,1255238,25.11,0.33
3483,2021-04-01,SIC,14288,6617,7671,9496,4664,128,ITG,ITG1,19,Sicilia,Sicilia,4999891,1269526,25.39,0.29
3484,2021-06-23,SIC,44440,20672,23768,17884,26225,331,ITG,ITG1,19,Sicilia,Sicilia,4999891,1313966,26.28,0.89
3485,2021-02-22,SIC,7892,4095,3797,7321,493,78,ITG,ITG1,19,Sicilia,Sicilia,4999891,1321858,26.44,0.16
3486,2020-12-27,SIC,92,55,37,91,0,1,ITG,ITG1,19,Sicilia,Sicilia,4999891,1321950,26.44,0.0
3487,2021-06-02,SIC,35270,16297,18973,27105,7772,393,ITG,ITG1,19,Sicilia,Sicilia,4999891,1357220,27.14,0.71
3488,2021-03-01,SIC,12694,6015,6679,10914,1656,124,ITG,ITG1,19,Sicilia,Sicilia,4999891,1369914,27.4,0.25
3489,2021-06-09,SIC,49691,23651,26040,41944,7131,616,ITG,ITG1,19,Sicilia,Sicilia,4999891,1419605,28.39,0.99
3490,2021-01-19,SIC,1498,662,836,1262,222,14,ITG,ITG1,19,Sicilia,Sicilia,4999891,1421103,28.42,0.03
3491,2021-06-11,SIC,49808,23774,26034,41561,7591,656,ITG,ITG1,19,Sicilia,Sicilia,4999891,1470911,29.42,1.0
3492,2021-04-29,SIC,31792,14832,16960,21798,9558,436,ITG,ITG1,19,Sicilia,Sicilia,4999891,1502703,30.05,0.64
3493,2021-03-03,SIC,14419,6431,7988,11232,3065,122,ITG,ITG1,19,Sicilia,Sicilia,4999891,1517122,30.34,0.29
3494,2021-02-15,SIC,3730,1733,1997,3092,564,74,ITG,ITG1,19,Sicilia,Sicilia,4999891,1520852,30.42,0.07
3495,2021-05-26,SIC,44466,20854,23612,23760,20360,346,ITG,ITG1,19,Sicilia,Sicilia,4999891,1565318,31.31,0.89
3496,2021-01-03,SIC,4783,2497,2286,4753,0,30,ITG,ITG1,19,Sicilia,Sicilia,4999891,1570101,31.4,0.1
3497,2021-04-13,SIC,20235,9862,10373,11241,8835,159,ITG,ITG1,19,Sicilia,Sicilia,4999891,1590336,31.81,0.4
3498,2021-01-22,SIC,1280,637,643,260,1018,2,ITG,ITG1,19,Sicilia,Sicilia,4999891,1591616,31.83,0.03
3499,2021-01-08,SIC,8116,3783,4333,8027,0,89,ITG,ITG1,19,Sicilia,Sicilia,4999891,1599732,32.0,0.16
3500,2021-04-18,SIC,19825,9913,9912,15286,4362,177,ITG,ITG1,19,Sicilia,Sicilia,4999891,1619557,32.39,0.4
3501,2021-03-30,SIC,14556,6758,7798,9700,4763,93,ITG,ITG1,19,Sicilia,Sicilia,4999891,1634113,32.68,0.29
3502,2021-03-13,SIC,12210,5387,6823,7627,4492,91,ITG,ITG1,19,Sicilia,Sicilia,4999891,1646323,32.93,0.24
3503,2021-04-17,SIC,26000,13151,12849,18673,7065,262,ITG,ITG1,19,Sicilia,Sicilia,4999891,1672323,33.45,0.52
3504,2021-03-17,SIC,14983,7397,7586,9074,5787,122,ITG,ITG1,19,Sicilia,Sicilia,4999891,1687306,33.75,0.3
3505,2021-06-25,SIC,39809,18682,21127,17427,22049,333,ITG,ITG1,19,Sicilia,Sicilia,4999891,1727115,34.54,0.8
3506,2021-06-06,SIC,49524,23918,25606,41153,7821,550,ITG,ITG1,19,Sicilia,Sicilia,4999891,1776639,35.53,0.99
3507,2021-02-26,SIC,11883,5811,6072,10091,1680,112,ITG,ITG1,19,Sicilia,Sicilia,4999891,1788522,35.77,0.24
3508,2021-05-06,SIC,29420,13992,15428,18121,10830,469,ITG,ITG1,19,Sicilia,Sicilia,4999891,1817942,36.36,0.59
3509,2021-01-20,SIC,958,509,449,688,267,3,ITG,ITG1,19,Sicilia,Sicilia,4999891,1818900,36.38,0.02
3510,2021-03-18,SIC,15288,7667,7621,9739,5499,50,ITG,ITG1,19,Sicilia,Sicilia,4999891,1834188,36.68,0.31
3511,2021-02-07,SIC,2322,982,1340,665,1648,9,ITG,ITG1,19,Sicilia,Sicilia,4999891,1836510,36.73,0.05
3512,2021-02-20,SIC,7138,3692,3446,6800,241,97,ITG,ITG1,19,Sicilia,Sicilia,4999891,1843648,36.87,0.14
3513,2021-02-03,SIC,5921,2779,3142,713,5200,8,ITG,ITG1,19,Sicilia,Sicilia,4999891,1849569,36.99,0.12
3514,2021-04-27,SIC,26413,12666,13747,15172,10921,320,ITG,ITG1,19,Sicilia,Sicilia,4999891,1875982,37.52,0.53
3515,2021-05-14,SIC,52046,24397,27649,35629,15666,751,ITG,ITG1,19,Sicilia,Sicilia,4999891,1928028,38.56,1.04
3516,2021-01-15,SIC,5252,2294,2958,5185,0,67,ITG,ITG1,19,Sicilia,Sicilia,4999891,1933280,38.67,0.11
3517,2021-04-25,SIC,21392,10202,11190,16152,5015,225,ITG,ITG1,19,Sicilia,Sicilia,4999891,1954672,39.09,0.43
3518,2021-02-01,SIC,5904,2625,3279,305,5587,12,ITG,ITG1,19,Sicilia,Sicilia,4999891,1960576,39.21,0.12
3519,2021-03-22,SIC,16587,7838,8749,11135,5363,89,ITG,ITG1,19,Sicilia,Sicilia,4999891,1977163,39.54,0.33
3520,2021-06-30,SIC,32456,14977,17479,11392,20747,317,ITG,ITG1,19,Sicilia,Sicilia,4999891,2009619,40.19,0.65
3521,2020-12-29,SIC,243,152,91,243,0,0,ITG,ITG1,19,Sicilia,Sicilia,4999891,2009862,40.2,0.0
3522,2021-06-13,SIC,34530,17155,17375,30595,3504,431,ITG,ITG1,19,Sicilia,Sicilia,4999891,2044392,40.89,0.69
3523,2021-04-10,SIC,20422,9969,10453,11303,8963,156,ITG,ITG1,19,Sicilia,Sicilia,4999891,2064814,41.3,0.41
3524,2021-01-10,SIC,3534,1578,1956,3513,0,21,ITG,ITG1,19,Sicilia,Sicilia,4999891,2068348,41.37,0.07
3525,2021-01-05,SIC,10336,5079,5257,10261,0,75,ITG,ITG1,19,Sicilia,Sicilia,4999891,2078684,41.57,0.21
3526,2021-04-15,SIC,21538,10475,11063,11998,9339,201,ITG,ITG1,19,Sicilia,Sicilia,4999891,2100222,42.01,0.43
3527,2021-06-20,SIC,33387,15801,17586,15114,18014,259,ITG,ITG1,19,Sicilia,Sicilia,4999891,2133609,42.67,0.67
3528,2021-04-22,SIC,26737,12631,14106,19879,6458,400,ITG,ITG1,19,Sicilia,Sicilia,4999891,2160346,43.21,0.53
3529,2021-03-10,SIC,13861,6059,7802,11548,2183,130,ITG,ITG1,19,Sicilia,Sicilia,4999891,2174207,43.49,0.28
3530,2021-01-12,SIC,4326,2120,2206,4283,0,43,ITG,ITG1,19,Sicilia,Sicilia,4999891,2178533,43.57,0.09
3531,2021-06-18,SIC,43516,20120,23396,18838,24312,366,ITG,ITG1,19,Sicilia,Sicilia,4999891,2222049,44.44,0.87
3532,2021-06-27,SIC,25295,12195,13100,12104,12965,226,ITG,ITG1,19,Sicilia,Sicilia,4999891,2247344,44.95,0.51
3533,2021-05-15,SIC,56463,26381,30082,40335,15236,892,ITG,ITG1,19,Sicilia,Sicilia,4999891,2303807,46.08,1.13
3534,2021-03-19,SIC,16215,7985,8230,10646,5481,88,ITG,ITG1,19,Sicilia,Sicilia,4999891,2320022,46.4,0.32
3535,2021-03-12,SIC,12774,5493,7281,10632,1995,147,ITG,ITG1,19,Sicilia,Sicilia,4999891,2332796,46.66,0.26
3536,2021-06-29,SIC,31240,14635,16605,15678,15165,397,ITG,ITG1,19,Sicilia,Sicilia,4999891,2364036,47.28,0.62
3537,2021-01-24,SIC,4317,2257,2060,132,4183,2,ITG,ITG1,19,Sicilia,Sicilia,4999891,2368353,47.37,0.09
3538,2021-05-04,SIC,26827,12468,14359,17150,9291,386,ITG,ITG1,19,Sicilia,Sicilia,4999891,2395180,47.9,0.54
3539,2021-03-31,SIC,14519,6706,7813,9447,4932,140,ITG,ITG1,19,Sicilia,Sicilia,4999891,2409699,48.2,0.29
3540,2021-01-07,SIC,8925,4129,4796,8845,0,80,ITG,ITG1,19,Sicilia,Sicilia,4999891,2418624,48.37,0.18
3541,2021-02-24,SIC,9306,4760,4546,8644,560,102,ITG,ITG1,19,Sicilia,Sicilia,4999891,2427930,48.56,0.19
3542,2021-01-21,SIC,1435,706,729,490,934,11,ITG,ITG1,19,Sicilia,Sicilia,4999891,2429365,48.59,0.03
3543,2021-05-01,SIC,24439,11311,13128,19001,5164,274,ITG,ITG1,19,Sicilia,Sicilia,4999891,2453804,49.08,0.49
3544,2021-07-06,SIC,37409,17332,20077,10386,26710,313,ITG,ITG1,19,Sicilia,Sicilia,4999891,2491213,49.83,0.75
3545,2021-05-10,SIC,28605,13739,14866,16148,12186,271,ITG,ITG1,19,Sicilia,Sicilia,4999891,2519818,50.4,0.57
3546,2021-03-26,SIC,17891,8296,9595,12329,5430,132,ITG,ITG1,19,Sicilia,Sicilia,4999891,2537709,50.76,0.36
3547,2021-01-28,SIC,9027,4271,4756,391,8635,1,ITG,ITG1,19,Sicilia,Sicilia,4999891,2546736,50.94,0.18
3548,2021-07-04,SIC,26574,12833,13741,7628,18777,169,ITG,ITG1,19,Sicilia,Sicilia,4999891,2573310,51.47,0.53
3549,2021-05-08,SIC,35628,17027,18601,24984,10297,347,ITG,ITG1,19,Sicilia,Sicilia,4999891,2608938,52.18,0.71
3550,2021-01-26,SIC,9531,4717,4814,247,9283,1,ITG,ITG1,19,Sicilia,Sicilia,4999891,2618469,52.37,0.19
3551,2021-05-18,SIC,36061,17359,18702,23185,12482,394,ITG,ITG1,19,Sicilia,Sicilia,4999891,2654530,53.09,0.72
3552,2021-07-07,SIC,35444,16179,19265,6058,29164,222,ITG,ITG1,19,Sicilia,Sicilia,4999891,2689974,53.8,0.71
3553,2021-05-25,SIC,33344,15289,18055,13845,19246,253,ITG,ITG1,19,Sicilia,Sicilia,4999891,2723318,54.47,0.67
3554,2021-03-29,SIC,15020,7065,7955,10389,4497,134,ITG,ITG1,19,Sicilia,Sicilia,4999891,2738338,54.77,0.3
3555,2021-06-01,SIC,38799,17642,21157,24623,13828,348,ITG,ITG1,19,Sicilia,Sicilia,4999891,2777137,55.54,0.78
3556,2021-04-05,SIC,8013,3954,4059,6510,1440,63,ITG,ITG1,19,Sicilia,Sicilia,4999891,2785150,55.7,0.16
3557,2021-01-17,SIC,1305,592,713,1236,60,9,ITG,ITG1,19,Sicilia,Sicilia,4999891,2786455,55.73,0.03
3558,2021-07-02,SIC,30502,14170,16332,9931,20294,277,ITG,ITG1,19,Sicilia,Sicilia,4999891,2816957,56.34,0.61
3559,2021-03-05,SIC,15667,6770,8897,11294,4235,138,ITG,ITG1,19,Sicilia,Sicilia,4999891,2832624,56.65,0.31
3560,2021-02-16,SIC,4200,2207,1993,3664,465,71,ITG,ITG1,19,Sicilia,Sicilia,4999891,2836824,56.74,0.08
3561,2021-06-17,SIC,41767,19446,22321,20280,21128,359,ITG,ITG1,19,Sicilia,Sicilia,4999891,2878591,57.57,0.84
3562,2020-12-31,SIC,887,473,414,879,0,8,ITG,ITG1,19,Sicilia,Sicilia,4999891,2879478,57.59,0.02
3563,2021-03-07,SIC,9259,3454,5805,8117,1083,59,ITG,ITG1,19,Sicilia,Sicilia,4999891,2888737,57.78,0.19
3564,2021-06-15,SIC,45992,21695,24297,28225,17342,425,ITG,ITG1,19,Sicilia,Sicilia,4999891,2934729,58.7,0.92
3565,2021-03-24,SIC,20881,9805,11076,15030,5663,188,ITG,ITG1,19,Sicilia,Sicilia,4999891,2955610,59.11,0.42
3566,2021-04-12,SIC,19000,9209,9791,11485,7274,241,ITG,ITG1,19,Sicilia,Sicilia,4999891,2974610,59.49,0.38
3567,2021-02-14,SIC,1055,402,653,907,140,8,ITG,ITG1,19,Sicilia,Sicilia,4999891,2975665,59.51,0.02
3568,2021-01-02,SIC,4850,2526,2324,4820,0,30,ITG,ITG1,19,Sicilia,Sicilia,4999891,2980515,59.61,0.1
3569,2021-02-21,SIC,5168,2501,2667,5047,106,15,ITG,ITG1,19,Sicilia,Sicilia,4999891,2985683,59.71,0.1
3570,2021-03-15,SIC,10615,4687,5928,5646,4893,76,ITG,ITG1,19,Sicilia,Sicilia,4999891,2996298,59.93,0.21
3571,2021-03-06,SIC,12638,5058,7580,9761,2782,95,ITG,ITG1,19,Sicilia,Sicilia,4999891,3008936,60.18,0.25
3572,2021-06-14,SIC,43356,20600,22756,28168,14772,416,ITG,ITG1,19,Sicilia,Sicilia,4999891,3052292,61.05,0.87
3573,2021-05-28,SIC,51225,22956,28269,24328,26489,408,ITG,ITG1,19,Sicilia,Sicilia,4999891,3103517,62.07,1.02
3574,2021-05-29,SIC,47167,21461,25706,23529,23191,447,ITG,ITG1,19,Sicilia,Sicilia,4999891,3150684,63.02,0.94
3575,2021-02-09,SIC,4346,1798,2548,3246,1035,65,ITG,ITG1,19,Sicilia,Sicilia,4999891,3155030,63.1,0.09
3576,2021-05-20,SIC,43950,21068,22882,27627,15912,411,ITG,ITG1,19,Sicilia,Sicilia,4999891,3198980,63.98,0.88
3577,2021-06-22,SIC,39956,18363,21593,18290,21295,371,ITG,ITG1,19,Sicilia,Sicilia,4999891,3238936,64.78,0.8
3578,2021-05-22,SIC,47958,22781,25177,28250,19308,400,ITG,ITG1,19,Sicilia,Sicilia,4999891,3286894,65.74,0.96
3579,2021-02-28,SIC,7164,3062,4102,6483,630,51,ITG,ITG1,19,Sicilia,Sicilia,4999891,3294058,65.88,0.14
3580,2021-06-08,SIC,47525,22331,25194,40474,6535,516,ITG,ITG1,19,Sicilia,Sicilia,4999891,3341583,66.83,0.95
3581,2021-01-09,SIC,7186,3388,3798,7126,0,60,ITG,ITG1,19,Sicilia,Sicilia,4999891,3348769,66.98,0.14
3582,2021-05-03,SIC,23309,10794,12515,13276,9787,246,ITG,ITG1,19,Sicilia,Sicilia,4999891,3372078,67.44,0.47
3583,2021-04-19,SIC,18268,8656,9612,12466,5581,221,ITG,ITG1,19,Sicilia,Sicilia,4999891,3390346,67.81,0.37
3584,2021-02-19,SIC,4907,2647,2260,4262,564,81,ITG,ITG1,19,Sicilia,Sicilia,4999891,3395253,67.91,0.1
3585,2021-03-08,SIC,13392,5865,7527,10665,2613,114,ITG,ITG1,19,Sicilia,Sicilia,4999891,3408645,68.17,0.27
3586,2021-05-30,SIC,35766,16169,19597,17424,18046,296,ITG,ITG1,19,Sicilia,Sicilia,4999891,3444411,68.89,0.72
3587,2021-05-13,SIC,47293,22164,25129,30139,16537,617,ITG,ITG1,19,Sicilia,Sicilia,4999891,3491704,69.84,0.95
3588,2021-01-31,SIC,4032,1927,2105,110,3920,2,ITG,ITG1,19,Sicilia,Sicilia,4999891,3495736,69.92,0.08
3589,2021-05-11,SIC,32435,15422,17013,19480,12483,472,ITG,ITG1,19,Sicilia,Sicilia,4999891,3528171,70.56,0.65
3590,2021-02-17,SIC,5215,3203,2012,4501,668,46,ITG,ITG1,19,Sicilia,Sicilia,4999891,3533386,70.67,0.1
3591,2021-04-24,SIC,31135,14696,16439,23120,7630,385,ITG,ITG1,19,Sicilia,Sicilia,4999891,3564521,71.29,0.62
3592,2021-04-26,SIC,21684,10262,11422,13303,8079,302,ITG,ITG1,19,Sicilia,Sicilia,4999891,3586205,71.73,0.43
3593,2021-02-02,SIC,5271,2472,2799,617,4644,10,ITG,ITG1,19,Sicilia,Sicilia,4999891,3591476,71.83,0.11
3594,2021-01-14,SIC,5251,2483,2768,5189,0,62,ITG,ITG1,19,Sicilia,Sicilia,4999891,3596727,71.94,0.11
3595,2021-05-16,SIC,33625,16394,17231,21823,11511,291,ITG,ITG1,19,Sicilia,Sicilia,4999891,3630352,72.61,0.67
3596,2021-05-02,SIC,24604,11428,13176,17707,6601,296,ITG,ITG1,19,Sicilia,Sicilia,4999891,3654956,73.1,0.49
3597,2021-03-20,SIC,18574,8967,9607,13353,5138,83,ITG,ITG1,19,Sicilia,Sicilia,4999891,3673530,73.47,0.37
3598,2021-06-28,SIC,31849,14801,17048,14880,16678,291,ITG,ITG1,19,Sicilia,Sicilia,4999891,3705379,74.11,0.64
3599,2021-07-05,SIC,37448,17590,19858,8950,28267,231,ITG,ITG1,19,Sicilia,Sicilia,4999891,3742827,74.86,0.75
3600,2021-06-21,SIC,40227,18626,21601,18425,21480,322,ITG,ITG1,19,Sicilia,Sicilia,4999891,3783054,75.66,0.8
3601,2021-05-09,SIC,28405,13307,15098,19779,8284,342,ITG,ITG1,19,Sicilia,Sicilia,4999891,3811459,76.23,0.57
3602,2021-02-05,SIC,6741,2980,3761,2089,4614,38,ITG,ITG1,19,Sicilia,Sicilia,4999891,3818200,76.37,0.13
3603,2021-04-03,SIC,16412,7815,8597,13424,2834,154,ITG,ITG1,19,Sicilia,Sicilia,4999891,3834612,76.69,0.33
3604,2021-03-27,SIC,15624,7357,8267,10654,4852,118,ITG,ITG1,19,Sicilia,Sicilia,4999891,3850236,77.01,0.31
3605,2021-01-29,SIC,9176,4253,4923,413,8751,12,ITG,ITG1,19,Sicilia,Sicilia,4999891,3859412,77.19,0.18
3606,2021-02-12,SIC,4586,1811,2775,4242,266,78,ITG,ITG1,19,Sicilia,Sicilia,4999891,3863998,77.28,0.09
3607,2021-05-23,SIC,34090,16596,17494,19847,14014,229,ITG,ITG1,19,Sicilia,Sicilia,4999891,3898088,77.96,0.68
3608,2021-06-10,SIC,52791,24792,27999,45056,7087,648,ITG,ITG1,19,Sicilia,Sicilia,4999891,3950879,79.02,1.06
3609,2021-05-27,SIC,47427,21783,25644,24431,22582,414,ITG,ITG1,19,Sicilia,Sicilia,4999891,3998306,79.97,0.95
3610,2021-04-14,SIC,20574,9937,10637,11631,8759,184,ITG,ITG1,19,Sicilia,Sicilia,4999891,4018880,80.38,0.41
3611,2021-04-21,SIC,22381,10743,11638,15996,6119,266,ITG,ITG1,19,Sicilia,Sicilia,4999891,4041261,80.83,0.45
3612,2021-04-07,SIC,15490,7622,7868,8190,7126,174,ITG,ITG1,19,Sicilia,Sicilia,4999891,4056751,81.14,0.31
3613,2021-06-03,SIC,45816,21002,24814,33761,11542,513,ITG,ITG1,19,Sicilia,Sicilia,4999891,4102567,82.05,0.92
3614,2021-04-23,SAR,12640,5635,7005,7041,5462,137,ITG,ITG2,20,Sardegna,Sardegna,1639591,12640,0.77,0.77
3615,2021-05-10,SAR,9731,4337,5394,7027,2538,166,ITG,ITG2,20,Sardegna,Sardegna,1639591,22371,1.36,0.59
3616,2021-01-30,SAR,3863,1392,2471,362,3501,0,ITG,ITG2,20,Sardegna,Sardegna,1639591,26234,1.6,0.24
3617,2021-01-16,SAR,1488,525,963,1488,0,0,ITG,ITG2,20,Sardegna,Sardegna,1639591,27722,1.69,0.09
3618,2021-02-11,SAR,1311,488,823,1200,111,0,ITG,ITG2,20,Sardegna,Sardegna,1639591,29033,1.77,0.08
3619,2021-05-24,SAR,14469,7256,7213,8354,5983,132,ITG,ITG2,20,Sardegna,Sardegna,1639591,43502,2.65,0.88
3620,2021-02-13,SAR,1440,560,880,1434,2,4,ITG,ITG2,20,Sardegna,Sardegna,1639591,44942,2.74,0.09
3621,2021-05-29,SAR,17994,8648,9346,13234,4593,167,ITG,ITG2,20,Sardegna,Sardegna,1639591,62936,3.84,1.1
3622,2021-02-18,SAR,1726,669,1057,1625,64,37,ITG,ITG2,20,Sardegna,Sardegna,1639591,64662,3.94,0.11
3623,2021-04-09,SAR,12263,5456,6807,7794,4350,119,ITG,ITG2,20,Sardegna,Sardegna,1639591,76925,4.69,0.75
3624,2021-04-11,SAR,5392,2441,2951,4245,1121,26,ITG,ITG2,20,Sardegna,Sardegna,1639591,82317,5.02,0.33
3625,2021-06-07,SAR,12560,6142,6418,9435,3004,121,ITG,ITG2,20,Sardegna,Sardegna,1639591,94877,5.79,0.77
3626,2021-02-04,SAR,2253,810,1443,895,1355,3,ITG,ITG2,20,Sardegna,Sardegna,1639591,97130,5.92,0.14
3627,2021-04-02,SAR,8840,3493,5347,5454,3237,149,ITG,ITG2,20,Sardegna,Sardegna,1639591,105970,6.46,0.54
3628,2021-07-01,SAR,20084,9899,10185,7257,12734,93,ITG,ITG2,20,Sardegna,Sardegna,1639591,126054,7.69,1.22
3629,2021-03-23,SAR,6389,2863,3526,5172,1065,152,ITG,ITG2,20,Sardegna,Sardegna,1639591,132443,8.08,0.39
3630,2021-05-12,SAR,11129,5257,5872,7785,3138,206,ITG,ITG2,20,Sardegna,Sardegna,1639591,143572,8.76,0.68
3631,2021-03-09,SAR,5513,2726,2787,4728,728,57,ITG,ITG2,20,Sardegna,Sardegna,1639591,149085,9.09,0.34
3632,2021-05-05,SAR,10152,4642,5510,7946,2012,194,ITG,ITG2,20,Sardegna,Sardegna,1639591,159237,9.71,0.62
3633,2021-03-02,SAR,3033,1629,1404,1815,1152,66,ITG,ITG2,20,Sardegna,Sardegna,1639591,162270,9.9,0.18
3634,2021-05-19,SAR,17011,8662,8349,12620,4235,156,ITG,ITG2,20,Sardegna,Sardegna,1639591,179281,10.93,1.04
3635,2021-06-05,SAR,17874,8433,9441,11285,6455,134,ITG,ITG2,20,Sardegna,Sardegna,1639591,197155,12.02,1.09
3636,2021-02-25,SAR,2797,1200,1597,2162,604,31,ITG,ITG2,20,Sardegna,Sardegna,1639591,199952,12.2,0.17
3637,2021-03-14,SAR,604,376,228,595,0,9,ITG,ITG2,20,Sardegna,Sardegna,1639591,200556,12.23,0.04
3638,2021-06-19,SAR,15333,7510,7823,9114,6120,99,ITG,ITG2,20,Sardegna,Sardegna,1639591,215889,13.17,0.94
3639,2021-07-06,SAR,15933,7722,8211,4664,11173,96,ITG,ITG2,20,Sardegna,Sardegna,1639591,231822,14.14,0.97
3640,2021-03-28,SAR,4518,1784,2734,4377,78,63,ITG,ITG2,20,Sardegna,Sardegna,1639591,236340,14.41,0.28
3641,2021-01-04,SAR,586,215,371,586,0,0,ITG,ITG2,20,Sardegna,Sardegna,1639591,236926,14.45,0.04
3642,2021-07-08,SAR,1135,566,569,227,899,9,ITG,ITG2,20,Sardegna,Sardegna,1639591,238061,14.52,0.07
3643,2021-06-12,SAR,14753,7192,7561,9938,4700,115,ITG,ITG2,20,Sardegna,Sardegna,1639591,252814,15.42,0.9
3644,2021-03-04,SAR,4342,2279,2063,3040,1248,54,ITG,ITG2,20,Sardegna,Sardegna,1639591,257156,15.68,0.26
3645,2021-03-21,SAR,4017,1804,2213,2571,1427,19,ITG,ITG2,20,Sardegna,Sardegna,1639591,261173,15.93,0.25
3646,2021-06-26,SAR,19123,9000,10123,5444,13605,74,ITG,ITG2,20,Sardegna,Sardegna,1639591,280296,17.1,1.17
3647,2021-05-07,SAR,14307,6553,7754,9583,4496,228,ITG,ITG2,20,Sardegna,Sardegna,1639591,294603,17.97,0.87
3648,2021-01-27,SAR,1370,481,889,78,1292,0,ITG,ITG2,20,Sardegna,Sardegna,1639591,295973,18.05,0.08
3649,2021-07-03,SAR,15842,7563,8279,3247,12564,31,ITG,ITG2,20,Sardegna,Sardegna,1639591,311815,19.02,0.97
3650,2021-03-25,SAR,9097,3965,5132,7679,1302,116,ITG,ITG2,20,Sardegna,Sardegna,1639591,320912,19.57,0.55
3651,2021-05-21,SAR,22638,11203,11435,16260,6098,280,ITG,ITG2,20,Sardegna,Sardegna,1639591,343550,20.95,1.38
3652,2021-05-31,SAR,11372,5411,5961,8163,3110,99,ITG,ITG2,20,Sardegna,Sardegna,1639591,354922,21.65,0.69
3653,2021-04-18,SAR,5118,2220,2898,2223,2867,28,ITG,ITG2,20,Sardegna,Sardegna,1639591,360040,21.96,0.31
3654,2021-01-08,SAR,3241,1178,2063,3239,0,2,ITG,ITG2,20,Sardegna,Sardegna,1639591,363281,22.16,0.2
3655,2021-06-02,SAR,9788,4692,5096,8062,1640,86,ITG,ITG2,20,Sardegna,Sardegna,1639591,373069,22.75,0.6
3656,2021-04-20,SAR,10967,4975,5992,7674,3202,91,ITG,ITG2,20,Sardegna,Sardegna,1639591,384036,23.42,0.67
3657,2021-04-04,SAR,1,0,1,0,1,0,ITG,ITG2,20,Sardegna,Sardegna,1639591,384037,23.42,0.0
3658,2021-06-16,SAR,17632,8276,9356,12169,5303,160,ITG,ITG2,20,Sardegna,Sardegna,1639591,401669,24.5,1.08
3659,2020-12-28,SAR,65,25,40,65,0,0,ITG,ITG2,20,Sardegna,Sardegna,1639591,401734,24.5,0.0
3660,2021-06-14,SAR,13743,6638,7105,9995,3609,139,ITG,ITG2,20,Sardegna,Sardegna,1639591,415477,25.34,0.84
3661,2021-03-06,SAR,2626,1074,1552,773,1780,73,ITG,ITG2,20,Sardegna,Sardegna,1639591,418103,25.5,0.16
3662,2021-06-28,SAR,14982,7037,7945,3052,11866,64,ITG,ITG2,20,Sardegna,Sardegna,1639591,433085,26.41,0.91
3663,2021-04-06,SAR,7453,3123,4330,4967,2428,58,ITG,ITG2,20,Sardegna,Sardegna,1639591,440538,26.87,0.45
3664,2020-12-27,SAR,65,34,31,65,0,0,ITG,ITG2,20,Sardegna,Sardegna,1639591,440603,26.87,0.0
3665,2021-04-28,SAR,8996,4267,4729,5158,3691,147,ITG,ITG2,20,Sardegna,Sardegna,1639591,449599,27.42,0.55
3666,2021-01-18,SAR,866,312,554,743,123,0,ITG,ITG2,20,Sardegna,Sardegna,1639591,450465,27.47,0.05
3667,2021-06-24,SAR,19164,9202,9962,8113,10950,101,ITG,ITG2,20,Sardegna,Sardegna,1639591,469629,28.64,1.17
3668,2021-03-16,SAR,4303,1904,2399,3342,921,40,ITG,ITG2,20,Sardegna,Sardegna,1639591,473932,28.91,0.26
3669,2021-04-21,SAR,12038,5542,6496,6433,5507,98,ITG,ITG2,20,Sardegna,Sardegna,1639591,485970,29.64,0.73
3670,2021-01-11,SAR,1172,500,672,1171,0,1,ITG,ITG2,20,Sardegna,Sardegna,1639591,487142,29.71,0.07
3671,2021-06-17,SAR,18452,8526,9926,9919,8413,120,ITG,ITG2,20,Sardegna,Sardegna,1639591,505594,30.84,1.13
3672,2021-04-30,SAR,11119,5294,5825,6745,4203,171,ITG,ITG2,20,Sardegna,Sardegna,1639591,516713,31.51,0.68
3673,2021-05-17,SAR,12784,6245,6539,9124,3516,144,ITG,ITG2,20,Sardegna,Sardegna,1639591,529497,32.29,0.78
3674,2021-02-06,SAR,1969,697,1272,564,1402,3,ITG,ITG2,20,Sardegna,Sardegna,1639591,531466,32.41,0.12
3675,2021-02-23,SAR,1500,992,508,1233,252,15,ITG,ITG2,20,Sardegna,Sardegna,1639591,532966,32.51,0.09
3676,2021-05-02,SAR,5879,2669,3210,5214,575,90,ITG,ITG2,20,Sardegna,Sardegna,1639591,538845,32.86,0.36
3677,2021-02-08,SAR,1466,531,935,852,613,1,ITG,ITG2,20,Sardegna,Sardegna,1639591,540311,32.95,0.09
3678,2021-04-16,SAR,14430,6483,7947,8931,5337,162,ITG,ITG2,20,Sardegna,Sardegna,1639591,554741,33.83,0.88
3679,2021-01-23,SAR,50,18,32,0,50,0,ITG,ITG2,20,Sardegna,Sardegna,1639591,554791,33.84,0.0
3680,2021-02-22,SAR,1625,941,684,1371,228,26,ITG,ITG2,20,Sardegna,Sardegna,1639591,556416,33.94,0.1
3681,2021-03-11,SAR,6377,3052,3325,5112,1197,68,ITG,ITG2,20,Sardegna,Sardegna,1639591,562793,34.33,0.39
3682,2021-01-13,SAR,571,178,393,571,0,0,ITG,ITG2,20,Sardegna,Sardegna,1639591,563364,34.36,0.03
3683,2021-02-20,SAR,2002,831,1171,1645,334,23,ITG,ITG2,20,Sardegna,Sardegna,1639591,565366,34.48,0.12
3684,2021-04-29,SAR,11115,5102,6013,6613,4351,151,ITG,ITG2,20,Sardegna,Sardegna,1639591,576481,35.16,0.68
3685,2021-06-25,SAR,16675,7877,8798,3942,12677,56,ITG,ITG2,20,Sardegna,Sardegna,1639591,593156,36.18,1.02
3686,2021-01-10,SAR,2167,746,1421,2167,0,0,ITG,ITG2,20,Sardegna,Sardegna,1639591,595323,36.31,0.13
3687,2021-01-01,SAR,32,17,15,32,0,0,ITG,ITG2,20,Sardegna,Sardegna,1639591,595355,36.31,0.0
3688,2021-02-27,SAR,1867,622,1245,1271,555,41,ITG,ITG2,20,Sardegna,Sardegna,1639591,597222,36.43,0.11
3689,2021-04-13,SAR,7534,3562,3972,5653,1824,57,ITG,ITG2,20,Sardegna,Sardegna,1639591,604756,36.88,0.46
3690,2021-06-09,SAR,15462,7366,8096,11576,3738,148,ITG,ITG2,20,Sardegna,Sardegna,1639591,620218,37.83,0.94
3691,2021-04-25,SAR,4490,2265,2225,3667,777,46,ITG,ITG2,20,Sardegna,Sardegna,1639591,624708,38.1,0.27
3692,2021-01-15,SAR,1275,499,776,1273,0,2,ITG,ITG2,20,Sardegna,Sardegna,1639591,625983,38.18,0.08
3693,2021-02-01,SAR,1523,605,918,224,1299,0,ITG,ITG2,20,Sardegna,Sardegna,1639591,627506,38.27,0.09
3694,2021-05-09,SAR,6124,2872,3252,5111,926,87,ITG,ITG2,20,Sardegna,Sardegna,1639591,633630,38.65,0.37
3695,2021-05-26,SAR,15531,8188,7343,9702,5645,184,ITG,ITG2,20,Sardegna,Sardegna,1639591,649161,39.59,0.95
3696,2021-02-15,SAR,954,347,607,917,31,6,ITG,ITG2,20,Sardegna,Sardegna,1639591,650115,39.65,0.06
3697,2021-03-20,SAR,5174,2066,3108,2890,2258,26,ITG,ITG2,20,Sardegna,Sardegna,1639591,655289,39.97,0.32
3698,2021-06-13,SAR,9498,4674,4824,6158,3260,80,ITG,ITG2,20,Sardegna,Sardegna,1639591,664787,40.55,0.58
3699,2021-01-29,SAR,2955,1070,1885,45,2908,2,ITG,ITG2,20,Sardegna,Sardegna,1639591,667742,40.73,0.18
3700,2021-03-18,SAR,7249,3068,4181,5571,1605,73,ITG,ITG2,20,Sardegna,Sardegna,1639591,674991,41.17,0.44
3701,2021-05-14,SAR,14539,6860,7679,10759,3618,162,ITG,ITG2,20,Sardegna,Sardegna,1639591,689530,42.06,0.89
3702,2021-02-03,SAR,1118,418,700,424,693,1,ITG,ITG2,20,Sardegna,Sardegna,1639591,690648,42.12,0.07
3703,2021-04-01,SAR,10123,4054,6069,6982,3006,135,ITG,ITG2,20,Sardegna,Sardegna,1639591,700771,42.74,0.62
3704,2021-06-04,SAR,14480,6930,7550,9769,4554,157,ITG,ITG2,20,Sardegna,Sardegna,1639591,715251,43.62,0.88
3705,2021-06-21,SAR,14014,6730,7284,5122,8820,72,ITG,ITG2,20,Sardegna,Sardegna,1639591,729265,44.48,0.85
3706,2021-03-13,SAR,2740,1070,1670,2422,279,39,ITG,ITG2,20,Sardegna,Sardegna,1639591,732005,44.65,0.17
3707,2021-03-30,SAR,8708,3566,5142,6335,2235,138,ITG,ITG2,20,Sardegna,Sardegna,1639591,740713,45.18,0.53
3708,2021-01-06,SAR,1609,546,1063,1609,0,0,ITG,ITG2,20,Sardegna,Sardegna,1639591,742322,45.27,0.1
3709,2021-06-23,SAR,20533,9661,10872,6192,14250,91,ITG,ITG2,20,Sardegna,Sardegna,1639591,762855,46.53,1.25
3710,2021-05-18,SAR,14747,7373,7374,9443,5200,104,ITG,ITG2,20,Sardegna,Sardegna,1639591,777602,47.43,0.9
3711,2021-02-24,SAR,2406,1290,1116,2182,189,35,ITG,ITG2,20,Sardegna,Sardegna,1639591,780008,47.57,0.15
3712,2021-03-08,SAR,4670,2419,2251,3412,1219,39,ITG,ITG2,20,Sardegna,Sardegna,1639591,784678,47.86,0.28
3713,2021-05-04,SAR,9535,4384,5151,7538,1852,145,ITG,ITG2,20,Sardegna,Sardegna,1639591,794213,48.44,0.58
3714,2021-01-24,SAR,90,34,56,5,85,0,ITG,ITG2,20,Sardegna,Sardegna,1639591,794303,48.45,0.01
3715,2021-06-18,SAR,16484,7506,8978,8603,7766,115,ITG,ITG2,20,Sardegna,Sardegna,1639591,810787,49.45,1.01
3716,2021-03-10,SAR,6019,2940,3079,5128,829,62,ITG,ITG2,20,Sardegna,Sardegna,1639591,816806,49.82,0.37
3717,2021-05-06,SAR,12938,6007,6931,9558,3143,237,ITG,ITG2,20,Sardegna,Sardegna,1639591,829744,50.61,0.79
3718,2021-03-01,SAR,2042,962,1080,1358,658,26,ITG,ITG2,20,Sardegna,Sardegna,1639591,831786,50.73,0.12
3719,2021-05-13,SAR,12363,5858,6505,8718,3446,199,ITG,ITG2,20,Sardegna,Sardegna,1639591,844149,51.49,0.75
3720,2021-02-02,SAR,1498,669,829,257,1241,0,ITG,ITG2,20,Sardegna,Sardegna,1639591,845647,51.58,0.09
3721,2021-05-15,SAR,13783,6419,7364,10189,3433,161,ITG,ITG2,20,Sardegna,Sardegna,1639591,859430,52.42,0.84
3722,2021-01-26,SAR,1336,453,883,27,1309,0,ITG,ITG2,20,Sardegna,Sardegna,1639591,860766,52.5,0.08
3723,2021-05-08,SAR,13058,5954,7104,10647,2281,130,ITG,ITG2,20,Sardegna,Sardegna,1639591,873824,53.3,0.8
3724,2021-05-28,SAR,17951,8697,9254,13488,4275,188,ITG,ITG2,20,Sardegna,Sardegna,1639591,891775,54.39,1.09
3725,2021-02-17,SAR,1380,570,810,1250,74,56,ITG,ITG2,20,Sardegna,Sardegna,1639591,893155,54.47,0.08
3726,2021-05-25,SAR,15139,7703,7436,8488,6476,175,ITG,ITG2,20,Sardegna,Sardegna,1639591,908294,55.4,0.92
3727,2021-06-11,SAR,14776,7021,7755,9093,5532,151,ITG,ITG2,20,Sardegna,Sardegna,1639591,923070,56.3,0.9
3728,2021-03-03,SAR,4108,2274,1834,2736,1296,76,ITG,ITG2,20,Sardegna,Sardegna,1639591,927178,56.55,0.25
3729,2021-06-30,SAR,17801,8526,9275,4818,12902,81,ITG,ITG2,20,Sardegna,Sardegna,1639591,944979,57.64,1.09
3730,2021-03-22,SAR,3666,1490,2176,3094,498,74,ITG,ITG2,20,Sardegna,Sardegna,1639591,948645,57.86,0.22
3731,2021-04-08,SAR,13415,5927,7488,8196,5110,109,ITG,ITG2,20,Sardegna,Sardegna,1639591,962060,58.68,0.82
3732,2020-12-29,SAR,55,31,24,55,0,0,ITG,ITG2,20,Sardegna,Sardegna,1639591,962115,58.68,0.0
3733,2021-01-28,SAR,2969,1044,1925,67,2902,0,ITG,ITG2,20,Sardegna,Sardegna,1639591,965084,58.86,0.18
3734,2021-05-27,SAR,17819,9258,8561,12077,5534,208,ITG,ITG2,20,Sardegna,Sardegna,1639591,982903,59.95,1.09
3735,2021-02-16,SAR,699,289,410,663,27,9,ITG,ITG2,20,Sardegna,Sardegna,1639591,983602,59.99,0.04
3736,2021-03-05,SAR,5188,2593,2595,2803,2350,35,ITG,ITG2,20,Sardegna,Sardegna,1639591,988790,60.31,0.32
3737,2021-07-02,SAR,18930,8889,10041,4408,14426,96,ITG,ITG2,20,Sardegna,Sardegna,1639591,1007720,61.46,1.15
3738,2021-04-27,SAR,7610,3547,4063,5471,2041,98,ITG,ITG2,20,Sardegna,Sardegna,1639591,1015330,61.93,0.46
3739,2021-01-17,SAR,859,277,582,858,1,0,ITG,ITG2,20,Sardegna,Sardegna,1639591,1016189,61.98,0.05
3740,2021-03-15,SAR,2793,1316,1477,2380,373,40,ITG,ITG2,20,Sardegna,Sardegna,1639591,1018982,62.15,0.17
3741,2021-07-04,SAR,8199,3986,4213,2068,6116,15,ITG,ITG2,20,Sardegna,Sardegna,1639591,1027181,62.65,0.5
3742,2021-03-26,SAR,8422,3486,4936,6776,1526,120,ITG,ITG2,20,Sardegna,Sardegna,1639591,1035603,63.16,0.51
3743,2021-05-22,SAR,24826,11945,12881,19391,5130,305,ITG,ITG2,20,Sardegna,Sardegna,1639591,1060429,64.68,1.51
3744,2021-01-19,SAR,739,265,474,686,52,1,ITG,ITG2,20,Sardegna,Sardegna,1639591,1061168,64.72,0.05
3745,2021-03-17,SAR,6456,2808,3648,4822,1597,37,ITG,ITG2,20,Sardegna,Sardegna,1639591,1067624,65.12,0.39
3746,2021-06-27,SAR,9010,4306,4704,2956,6026,28,ITG,ITG2,20,Sardegna,Sardegna,1639591,1076634,65.66,0.55
3747,2021-03-24,SAR,7384,3101,4283,5896,1356,132,ITG,ITG2,20,Sardegna,Sardegna,1639591,1084018,66.12,0.45
3748,2021-02-10,SAR,1954,765,1189,1430,518,6,ITG,ITG2,20,Sardegna,Sardegna,1639591,1085972,66.23,0.12
3749,2021-06-06,SAR,10035,5002,5033,6316,3651,68,ITG,ITG2,20,Sardegna,Sardegna,1639591,1096007,66.85,0.61
3750,2021-04-14,SAR,8212,3881,4331,6915,1237,60,ITG,ITG2,20,Sardegna,Sardegna,1639591,1104219,67.35,0.5
3751,2021-05-01,SAR,9875,4747,5128,5329,4455,91,ITG,ITG2,20,Sardegna,Sardegna,1639591,1114094,67.95,0.6
3752,2021-01-21,SAR,126,60,66,94,32,0,ITG,ITG2,20,Sardegna,Sardegna,1639591,1114220,67.96,0.01
3753,2021-02-07,SAR,1117,395,722,227,889,1,ITG,ITG2,20,Sardegna,Sardegna,1639591,1115337,68.03,0.07
3754,2021-05-03,SAR,8166,3807,4359,6469,1596,101,ITG,ITG2,20,Sardegna,Sardegna,1639591,1123503,68.52,0.5
3755,2021-05-20,SAR,16304,7851,8453,11239,4890,175,ITG,ITG2,20,Sardegna,Sardegna,1639591,1139807,69.52,0.99
3756,2021-02-09,SAR,2284,835,1449,1283,996,5,ITG,ITG2,20,Sardegna,Sardegna,1639591,1142091,69.66,0.14
3757,2021-02-26,SAR,2711,1068,1643,2357,306,48,ITG,ITG2,20,Sardegna,Sardegna,1639591,1144802,69.82,0.17
3758,2021-04-12,SAR,6977,3172,3805,5200,1713,64,ITG,ITG2,20,Sardegna,Sardegna,1639591,1151779,70.25,0.43
3759,2021-01-02,SAR,59,21,38,59,0,0,ITG,ITG2,20,Sardegna,Sardegna,1639591,1151838,70.25,0.0
3760,2021-06-08,SAR,14828,7069,7759,11171,3504,153,ITG,ITG2,20,Sardegna,Sardegna,1639591,1166666,71.16,0.9
3761,2021-02-28,SAR,367,169,198,139,226,2,ITG,ITG2,20,Sardegna,Sardegna,1639591,1167033,71.18,0.02
3762,2021-04-26,SAR,6847,3274,3573,5856,903,88,ITG,ITG2,20,Sardegna,Sardegna,1639591,1173880,71.6,0.42
3763,2021-06-01,SAR,14346,6665,7681,9659,4591,96,ITG,ITG2,20,Sardegna,Sardegna,1639591,1188226,72.47,0.87
3764,2021-02-21,SAR,1588,709,879,1557,30,1,ITG,ITG2,20,Sardegna,Sardegna,1639591,1189814,72.57,0.1
3765,2021-04-19,SAR,10154,4606,5548,8599,1423,132,ITG,ITG2,20,Sardegna,Sardegna,1639591,1199968,73.19,0.62
3766,2021-01-09,SAR,4001,1412,2589,4001,0,0,ITG,ITG2,20,Sardegna,Sardegna,1639591,1203969,73.43,0.24
3767,2021-06-15,SAR,14680,6799,7881,9816,4731,133,ITG,ITG2,20,Sardegna,Sardegna,1639591,1218649,74.33,0.9
3768,2021-03-07,SAR,1631,725,906,1088,539,4,ITG,ITG2,20,Sardegna,Sardegna,1639591,1220280,74.43,0.1
3769,2021-04-22,SAR,10438,4630,5808,5498,4856,84,ITG,ITG2,20,Sardegna,Sardegna,1639591,1230718,75.06,0.64
3770,2021-01-12,SAR,863,406,457,863,0,0,ITG,ITG2,20,Sardegna,Sardegna,1639591,1231581,75.12,0.05
3771,2021-05-11,SAR,8806,4087,4719,6303,2377,126,ITG,ITG2,20,Sardegna,Sardegna,1639591,1240387,75.65,0.54
3772,2021-01-31,SAR,2117,749,1368,45,2072,0,ITG,ITG2,20,Sardegna,Sardegna,1639591,1242504,75.78,0.13
3773,2021-02-14,SAR,537,263,274,535,2,0,ITG,ITG2,20,Sardegna,Sardegna,1639591,1243041,75.81,0.03
3774,2021-01-20,SAR,210,77,133,208,2,0,ITG,ITG2,20,Sardegna,Sardegna,1639591,1243251,75.83,0.01
3775,2021-03-19,SAR,7259,3044,4215,4993,2213,53,ITG,ITG2,20,Sardegna,Sardegna,1639591,1250510,76.27,0.44
3776,2021-04-07,SAR,13519,6041,7478,7809,5642,68,ITG,ITG2,20,Sardegna,Sardegna,1639591,1264029,77.09,0.82
3777,2021-04-24,SAR,10312,4821,5491,7852,2333,127,ITG,ITG2,20,Sardegna,Sardegna,1639591,1274341,77.72,0.63
3778,2021-01-14,SAR,1104,425,679,1104,0,0,ITG,ITG2,20,Sardegna,Sardegna,1639591,1275445,77.79,0.07
3779,2021-04-05,SAR,2031,782,1249,1999,1,31,ITG,ITG2,20,Sardegna,Sardegna,1639591,1277476,77.91,0.12
3780,2021-06-29,SAR,17877,8598,9279,3755,14074,48,ITG,ITG2,20,Sardegna,Sardegna,1639591,1295353,79.0,1.09
3781,2021-03-29,SAR,4507,1755,2752,3944,486,77,ITG,ITG2,20,Sardegna,Sardegna,1639591,1299860,79.28,0.27
3782,2021-04-15,SAR,11750,5490,6260,6763,4876,111,ITG,ITG2,20,Sardegna,Sardegna,1639591,1311610,80.0,0.72
3783,2021-01-05,SAR,1321,443,878,1321,0,0,ITG,ITG2,20,Sardegna,Sardegna,1639591,1312931,80.08,0.08
3784,2021-01-22,SAR,83,47,36,55,28,0,ITG,ITG2,20,Sardegna,Sardegna,1639591,1313014,80.08,0.01
3785,2021-04-17,SAR,9984,4464,5520,5397,4509,78,ITG,ITG2,20,Sardegna,Sardegna,1639591,1322998,80.69,0.61
3786,2021-01-03,SAR,90,36,54,90,0,0,ITG,ITG2,20,Sardegna,Sardegna,1639591,1323088,80.7,0.01
3787,2021-07-07,SAR,15902,7728,8174,4089,11762,51,ITG,ITG2,20,Sardegna,Sardegna,1639591,1338990,81.67,0.97
3788,2021-06-22,SAR,19333,8986,10347,7170,12061,102,ITG,ITG2,20,Sardegna,Sardegna,1639591,1358323,82.85,1.18
3789,2021-03-31,SAR,10202,4128,6074,7655,2425,122,ITG,ITG2,20,Sardegna,Sardegna,1639591,1368525,83.47,0.62
3790,2021-06-03,SAR,16396,7646,8750,10569,5687,140,ITG,ITG2,20,Sardegna,Sardegna,1639591,1384921,84.47,1.0
3791,2021-06-20,SAR,6288,2804,3484,3636,2620,32,ITG,ITG2,20,Sardegna,Sardegna,1639591,1391209,84.85,0.38
3792,2021-03-12,SAR,5962,2611,3351,4514,1304,144,ITG,ITG2,20,Sardegna,Sardegna,1639591,1397171,85.21,0.36
3793,2021-01-25,SAR,591,214,377,22,569,0,ITG,ITG2,20,Sardegna,Sardegna,1639591,1397762,85.25,0.04
3794,2021-05-16,SAR,8221,3831,4390,5987,2160,74,ITG,ITG2,20,Sardegna,Sardegna,1639591,1405983,85.75,0.5
3795,2021-07-05,SAR,15569,7569,8000,3329,12191,49,ITG,ITG2,20,Sardegna,Sardegna,1639591,1421552,86.7,0.95
3796,2021-02-05,SAR,1894,747,1147,430,1462,2,ITG,ITG2,20,Sardegna,Sardegna,1639591,1423446,86.82,0.12
3797,2021-04-03,SAR,4657,1803,2854,2629,1964,64,ITG,ITG2,20,Sardegna,Sardegna,1639591,1428103,87.1,0.28
3798,2021-05-30,SAR,9727,4836,4891,7300,2357,70,ITG,ITG2,20,Sardegna,Sardegna,1639591,1437830,87.69,0.59
3799,2021-02-19,SAR,1473,463,1010,1374,56,43,ITG,ITG2,20,Sardegna,Sardegna,1639591,1439303,87.78,0.09
3800,2021-03-27,SAR,5729,2192,3537,5220,422,87,ITG,ITG2,20,Sardegna,Sardegna,1639591,1445032,88.13,0.35
3801,2021-05-23,SAR,9964,4806,5158,7623,2245,96,ITG,ITG2,20,Sardegna,Sardegna,1639591,1454996,88.74,0.61
3802,2021-02-12,SAR,2216,920,1296,2152,59,5,ITG,ITG2,20,Sardegna,Sardegna,1639591,1457212,88.88,0.14
3803,2021-04-10,SAR,10460,4737,5723,8446,1914,100,ITG,ITG2,20,Sardegna,Sardegna,1639591,1467672,89.51,0.64
3804,2021-01-07,SAR,3094,1069,2025,3090,0,4,ITG,ITG2,20,Sardegna,Sardegna,1639591,1470766,89.7,0.19
3805,2021-06-10,SAR,17807,8477,9330,11648,6035,124,ITG,ITG2,20,Sardegna,Sardegna,1639591,1488573,90.79,1.09
3806,2020-12-31,SAR,27,15,12,27,0,0,ITG,ITG2,20,Sardegna,Sardegna,1639591,1488600,90.79,0.0
3807,2021-04-23,LOM,73515,33317,40198,55561,16567,1387,ITC,ITC4,3,Lombardia,Lombardia,10060574,73515,0.73,0.73
3808,2021-05-10,LOM,85263,40880,44383,62032,21577,1654,ITC,ITC4,3,Lombardia,Lombardia,10060574,158778,1.58,0.85
3809,2021-01-30,LOM,12314,4566,7748,145,12160,9,ITC,ITC4,3,Lombardia,Lombardia,10060574,171092,1.7,0.12
3810,2021-01-16,LOM,15436,5736,9700,15425,0,11,ITC,ITC4,3,Lombardia,Lombardia,10060574,186528,1.85,0.15
3811,2021-01-09,LOM,12426,4577,7849,12418,0,8,ITC,ITC4,3,Lombardia,Lombardia,10060574,198954,1.98,0.12
3812,2021-02-04,LOM,27821,8109,19712,2007,25808,6,ITC,ITC4,3,Lombardia,Lombardia,10060574,226775,2.25,0.28
3813,2021-04-09,LOM,52384,22366,30018,35553,15993,838,ITC,ITC4,3,Lombardia,Lombardia,10060574,279159,2.77,0.52
3814,2021-04-04,LOM,7611,3230,4381,3682,3895,34,ITC,ITC4,3,Lombardia,Lombardia,10060574,286770,2.85,0.08
3815,2021-04-02,LOM,41264,16881,24383,26191,14514,559,ITC,ITC4,3,Lombardia,Lombardia,10060574,328034,3.26,0.41
3816,2021-05-24,LOM,89510,43482,46028,48580,39996,934,ITC,ITC4,3,Lombardia,Lombardia,10060574,417544,4.15,0.89
3817,2021-02-11,LOM,17082,5011,12071,9629,7374,79,ITC,ITC4,3,Lombardia,Lombardia,10060574,434626,4.32,0.17
3818,2021-05-31,LOM,95644,47396,48248,78342,16197,1105,ITC,ITC4,3,Lombardia,Lombardia,10060574,530270,5.27,0.95
3819,2021-03-26,LOM,41304,15695,25609,27490,13142,672,ITC,ITC4,3,Lombardia,Lombardia,10060574,571574,5.68,0.41
3820,2021-05-22,LOM,70591,33833,36758,31721,38156,714,ITC,ITC4,3,Lombardia,Lombardia,10060574,642165,6.38,0.7
3821,2021-02-16,LOM,9506,3073,6433,8957,448,101,ITC,ITC4,3,Lombardia,Lombardia,10060574,651671,6.48,0.09
3822,2021-06-10,LOM,102566,52215,50351,86356,14408,1802,ITC,ITC4,3,Lombardia,Lombardia,10060574,754237,7.5,1.02
3823,2021-03-02,LOM,22813,9703,13110,19505,3039,269,ITC,ITC4,3,Lombardia,Lombardia,10060574,777050,7.72,0.23
3824,2020-12-28,LOM,107,47,60,107,0,0,ITC,ITC4,3,Lombardia,Lombardia,10060574,777157,7.72,0.0
3825,2021-04-21,LOM,71824,32561,39263,55791,14658,1375,ITC,ITC4,3,Lombardia,Lombardia,10060574,848981,8.44,0.71
3826,2021-01-11,LOM,16264,5379,10885,16254,0,10,ITC,ITC4,3,Lombardia,Lombardia,10060574,865245,8.6,0.16
3827,2021-01-28,LOM,12227,3703,8524,794,11426,7,ITC,ITC4,3,Lombardia,Lombardia,10060574,877472,8.72,0.12
3828,2021-04-28,LOM,95726,43665,52061,66845,26904,1977,ITC,ITC4,3,Lombardia,Lombardia,10060574,973198,9.67,0.95
3829,2021-06-24,LOM,109489,56618,52871,78384,28720,2385,ITC,ITC4,3,Lombardia,Lombardia,10060574,1082687,10.76,1.09
3830,2021-03-16,LOM,25497,10113,15384,16297,9078,122,ITC,ITC4,3,Lombardia,Lombardia,10060574,1108184,11.02,0.25
3831,2021-05-12,LOM,87479,41745,45734,57400,27559,2520,ITC,ITC4,3,Lombardia,Lombardia,10060574,1195663,11.88,0.87
3832,2021-03-28,LOM,20483,7818,12665,13934,6165,384,ITC,ITC4,3,Lombardia,Lombardia,10060574,1216146,12.09,0.2
3833,2021-04-14,LOM,47173,21025,26148,33523,12971,679,ITC,ITC4,3,Lombardia,Lombardia,10060574,1263319,12.56,0.47
3834,2021-01-04,LOM,6105,2106,3999,6099,0,6,ITC,ITC4,3,Lombardia,Lombardia,10060574,1269424,12.62,0.06
3835,2021-06-19,LOM,104251,51965,52286,56380,46449,1422,ITC,ITC4,3,Lombardia,Lombardia,10060574,1373675,13.65,1.04
3836,2021-07-06,LOM,99136,49346,49790,22405,75358,1373,ITC,ITC4,3,Lombardia,Lombardia,10060574,1472811,14.64,0.99
3837,2021-06-05,LOM,102409,52946,49463,91096,9801,1512,ITC,ITC4,3,Lombardia,Lombardia,10060574,1575220,15.66,1.02
3838,2021-03-14,LOM,14874,5348,9526,11218,3283,373,ITC,ITC4,3,Lombardia,Lombardia,10060574,1590094,15.81,0.15
3839,2021-02-23,LOM,11829,4803,7026,11289,332,208,ITC,ITC4,3,Lombardia,Lombardia,10060574,1601923,15.92,0.12
3840,2021-06-12,LOM,89307,48060,41247,84382,3081,1844,ITC,ITC4,3,Lombardia,Lombardia,10060574,1691230,16.81,0.89
3841,2021-06-29,LOM,107060,53104,53956,57367,47690,2003,ITC,ITC4,3,Lombardia,Lombardia,10060574,1798290,17.87,1.06
3842,2021-03-21,LOM,23513,8494,15019,17730,5194,589,ITC,ITC4,3,Lombardia,Lombardia,10060574,1821803,18.11,0.23
3843,2021-02-13,LOM,6419,2441,3978,4882,1477,60,ITC,ITC4,3,Lombardia,Lombardia,10060574,1828222,18.17,0.06
3844,2021-03-07,LOM,12087,5361,6726,9337,2560,190,ITC,ITC4,3,Lombardia,Lombardia,10060574,1840309,18.29,0.12
3845,2021-01-27,LOM,8042,2677,5365,807,7233,2,ITC,ITC4,3,Lombardia,Lombardia,10060574,1848351,18.37,0.08
3846,2021-07-03,LOM,102313,51617,50696,44532,55673,2108,ITC,ITC4,3,Lombardia,Lombardia,10060574,1950664,19.39,1.02
3847,2021-03-25,LOM,42822,16015,26807,29234,12684,904,ITC,ITC4,3,Lombardia,Lombardia,10060574,1993486,19.81,0.43
3848,2021-05-21,LOM,93830,45234,48596,28372,64694,764,ITC,ITC4,3,Lombardia,Lombardia,10060574,2087316,20.75,0.93
3849,2021-04-11,LOM,32220,13944,18276,24314,7395,511,ITC,ITC4,3,Lombardia,Lombardia,10060574,2119536,21.07,0.32
3850,2021-01-01,LOM,24,7,17,24,0,0,ITC,ITC4,3,Lombardia,Lombardia,10060574,2119560,21.07,0.0
3851,2021-06-07,LOM,98942,50420,48522,84008,13314,1620,ITC,ITC4,3,Lombardia,Lombardia,10060574,2218502,22.05,0.98
3852,2021-02-27,LOM,13946,5871,8075,13151,641,154,ITC,ITC4,3,Lombardia,Lombardia,10060574,2232448,22.19,0.14
3853,2020-12-30,LOM,114,42,72,114,0,0,ITC,ITC4,3,Lombardia,Lombardia,10060574,2232562,22.19,0.0
3854,2021-05-29,LOM,88298,42407,45891,41396,46060,842,ITC,ITC4,3,Lombardia,Lombardia,10060574,2320860,23.07,0.88
3855,2021-02-18,LOM,14050,4924,9126,12816,1037,197,ITC,ITC4,3,Lombardia,Lombardia,10060574,2334910,23.21,0.14
3856,2021-04-25,LOM,51500,23614,27886,45536,4744,1220,ITC,ITC4,3,Lombardia,Lombardia,10060574,2386410,23.72,0.51
3857,2021-06-28,LOM,107853,54959,52894,74273,30989,2591,ITC,ITC4,3,Lombardia,Lombardia,10060574,2494263,24.79,1.07
3858,2021-04-06,LOM,43064,17585,25479,24437,17936,691,ITC,ITC4,3,Lombardia,Lombardia,10060574,2537327,25.22,0.43
3859,2021-06-17,LOM,108506,52690,55816,51279,56045,1182,ITC,ITC4,3,Lombardia,Lombardia,10060574,2645833,26.3,1.08
3860,2021-03-09,LOM,33220,12863,20357,25242,7396,582,ITC,ITC4,3,Lombardia,Lombardia,10060574,2679053,26.63,0.33
3861,2021-05-05,LOM,87935,41923,46012,70357,15314,2264,ITC,ITC4,3,Lombardia,Lombardia,10060574,2766988,27.5,0.87
3862,2021-07-01,LOM,104761,52709,52052,53321,49051,2389,ITC,ITC4,3,Lombardia,Lombardia,10060574,2871749,28.54,1.04
3863,2021-07-08,LOM,50306,25401,24905,3877,46140,289,ITC,ITC4,3,Lombardia,Lombardia,10060574,2922055,29.04,0.5
3864,2021-04-16,LOM,53673,23923,29750,38424,14357,892,ITC,ITC4,3,Lombardia,Lombardia,10060574,2975728,29.58,0.53
3865,2021-05-03,LOM,83703,39754,43949,69456,12125,2122,ITC,ITC4,3,Lombardia,Lombardia,10060574,3059431,30.41,0.83
3866,2021-01-23,LOM,1116,357,759,914,199,3,ITC,ITC4,3,Lombardia,Lombardia,10060574,3060547,30.42,0.01
3867,2021-06-21,LOM,113203,58005,55198,78383,32644,2176,ITC,ITC4,3,Lombardia,Lombardia,10060574,3173750,31.55,1.13
3868,2021-05-17,LOM,94633,45350,49283,29521,64409,703,ITC,ITC4,3,Lombardia,Lombardia,10060574,3268383,32.49,0.94
3869,2021-05-19,LOM,82881,39587,43294,33041,49065,775,ITC,ITC4,3,Lombardia,Lombardia,10060574,3351264,33.31,0.82
3870,2021-02-08,LOM,10083,2919,7164,2121,7953,9,ITC,ITC4,3,Lombardia,Lombardia,10060574,3361347,33.41,0.1
3871,2021-02-25,LOM,15293,6349,8944,13520,1572,201,ITC,ITC4,3,Lombardia,Lombardia,10060574,3376640,33.56,0.15
3872,2021-01-13,LOM,26432,8072,18360,26405,0,27,ITC,ITC4,3,Lombardia,Lombardia,10060574,3403072,33.83,0.26
3873,2021-03-04,LOM,29322,12110,17212,20038,9064,220,ITC,ITC4,3,Lombardia,Lombardia,10060574,3432394,34.12,0.29
3874,2021-06-16,LOM,99203,50412,48791,49998,48051,1154,ITC,ITC4,3,Lombardia,Lombardia,10060574,3531597,35.1,0.99
3875,2021-03-06,LOM,21339,9099,12240,16523,4513,303,ITC,ITC4,3,Lombardia,Lombardia,10060574,3552936,35.32,0.21
3876,2021-06-09,LOM,103591,52201,51390,87408,14463,1720,ITC,ITC4,3,Lombardia,Lombardia,10060574,3656527,36.35,1.03
3877,2021-03-08,LOM,29748,11187,18561,22150,7079,519,ITC,ITC4,3,Lombardia,Lombardia,10060574,3686275,36.64,0.3
3878,2021-05-04,LOM,86818,41076,45742,70283,14393,2142,ITC,ITC4,3,Lombardia,Lombardia,10060574,3773093,37.5,0.86
3879,2021-01-24,LOM,1199,457,742,536,663,0,ITC,ITC4,3,Lombardia,Lombardia,10060574,3774292,37.52,0.01
3880,2021-02-20,LOM,9339,3868,5471,8844,298,197,ITC,ITC4,3,Lombardia,Lombardia,10060574,3783631,37.61,0.09
3881,2021-04-18,LOM,36404,16229,20175,30522,5240,642,ITC,ITC4,3,Lombardia,Lombardia,10060574,3820035,37.97,0.36
3882,2021-01-08,LOM,12714,3923,8791,12703,0,11,ITC,ITC4,3,Lombardia,Lombardia,10060574,3832749,38.1,0.13
3883,2021-06-14,LOM,94740,48137,46603,49088,44513,1139,ITC,ITC4,3,Lombardia,Lombardia,10060574,3927489,39.04,0.94
3884,2021-05-26,LOM,93646,44640,49006,42721,50034,891,ITC,ITC4,3,Lombardia,Lombardia,10060574,4021135,39.97,0.93
3885,2021-02-15,LOM,8950,3137,5813,8353,418,179,ITC,ITC4,3,Lombardia,Lombardia,10060574,4030085,40.06,0.09
3886,2021-03-20,LOM,32591,12163,20428,22240,9850,501,ITC,ITC4,3,Lombardia,Lombardia,10060574,4062676,40.38,0.32
3887,2020-12-27,LOM,718,414,304,718,0,0,ITC,ITC4,3,Lombardia,Lombardia,10060574,4063394,40.39,0.01
3888,2021-05-09,LOM,69708,32884,36824,54466,13269,1973,ITC,ITC4,3,Lombardia,Lombardia,10060574,4133102,41.08,0.69
3889,2021-05-07,LOM,92287,43696,48591,68363,22385,1539,ITC,ITC4,3,Lombardia,Lombardia,10060574,4225389,42.0,0.92
3890,2021-03-18,LOM,27390,10954,16436,15928,11237,225,ITC,ITC4,3,Lombardia,Lombardia,10060574,4252779,42.27,0.27
3891,2021-05-14,LOM,85930,41381,44549,53236,30311,2383,ITC,ITC4,3,Lombardia,Lombardia,10060574,4338709,43.13,0.85
3892,2021-06-26,LOM,105864,55423,50441,77784,25681,2399,ITC,ITC4,3,Lombardia,Lombardia,10060574,4444573,44.18,1.05
3893,2021-02-10,LOM,14401,4506,9895,7547,6823,31,ITC,ITC4,3,Lombardia,Lombardia,10060574,4458974,44.32,0.14
3894,2021-02-06,LOM,15262,5538,9724,1011,14247,4,ITC,ITC4,3,Lombardia,Lombardia,10060574,4474236,44.47,0.15
3895,2021-05-02,LOM,83504,38337,45167,59260,22464,1780,ITC,ITC4,3,Lombardia,Lombardia,10060574,4557740,45.3,0.83
3896,2021-04-13,LOM,47649,21269,26380,32928,14078,643,ITC,ITC4,3,Lombardia,Lombardia,10060574,4605389,45.78,0.47
3897,2021-04-30,LOM,117252,54794,62458,87197,27491,2564,ITC,ITC4,3,Lombardia,Lombardia,10060574,4722641,46.94,1.17
3898,2021-01-20,LOM,5667,1377,4290,5547,114,6,ITC,ITC4,3,Lombardia,Lombardia,10060574,4728308,47.0,0.06
3899,2021-01-22,LOM,3143,869,2274,3069,69,5,ITC,ITC4,3,Lombardia,Lombardia,10060574,4731451,47.03,0.03
3900,2021-07-07,LOM,111619,55959,55660,17956,92498,1165,ITC,ITC4,3,Lombardia,Lombardia,10060574,4843070,48.14,1.11
3901,2021-01-15,LOM,25221,7435,17786,25169,0,52,ITC,ITC4,3,Lombardia,Lombardia,10060574,4868291,48.39,0.25
3902,2021-04-29,LOM,115514,53588,61926,83088,29845,2581,ITC,ITC4,3,Lombardia,Lombardia,10060574,4983805,49.54,1.15
3903,2021-06-25,LOM,108010,56056,51954,78184,27517,2309,ITC,ITC4,3,Lombardia,Lombardia,10060574,5091815,50.61,1.07
3904,2021-04-20,LOM,67677,30835,36842,55903,10339,1435,ITC,ITC4,3,Lombardia,Lombardia,10060574,5159492,51.28,0.67
3905,2021-01-10,LOM,10519,3960,6559,10510,0,9,ITC,ITC4,3,Lombardia,Lombardia,10060574,5170011,51.39,0.1
3906,2021-01-17,LOM,8350,3347,5003,8143,201,6,ITC,ITC4,3,Lombardia,Lombardia,10060574,5178361,51.47,0.08
3907,2021-06-23,LOM,110762,57314,53448,76803,31812,2147,ITC,ITC4,3,Lombardia,Lombardia,10060574,5289123,52.57,1.1
3908,2021-03-15,LOM,31553,11329,20224,22422,8517,614,ITC,ITC4,3,Lombardia,Lombardia,10060574,5320676,52.89,0.31
3909,2021-04-27,LOM,86013,39981,46032,67641,16565,1807,ITC,ITC4,3,Lombardia,Lombardia,10060574,5406689,53.74,0.85
3910,2021-03-17,LOM,26258,10496,15762,15099,10999,160,ITC,ITC4,3,Lombardia,Lombardia,10060574,5432947,54.0,0.26
3911,2021-07-04,LOM,86640,43334,43306,40178,44507,1955,ITC,ITC4,3,Lombardia,Lombardia,10060574,5519587,54.86,0.86
3912,2021-07-02,LOM,103716,51970,51746,48847,52662,2207,ITC,ITC4,3,Lombardia,Lombardia,10060574,5623303,55.89,1.03
3913,2021-03-24,LOM,43239,15608,27631,30466,11882,891,ITC,ITC4,3,Lombardia,Lombardia,10060574,5666542,56.32,0.43
3914,2021-02-09,LOM,12217,3334,8883,4023,8180,14,ITC,ITC4,3,Lombardia,Lombardia,10060574,5678759,56.45,0.12
3915,2021-06-30,LOM,106736,52890,53846,56569,48061,2106,ITC,ITC4,3,Lombardia,Lombardia,10060574,5785495,57.51,1.06
3916,2021-03-22,LOM,40336,14302,26034,28944,10557,835,ITC,ITC4,3,Lombardia,Lombardia,10060574,5825831,57.91,0.4
3917,2021-04-08,LOM,52357,21762,30595,35223,16459,675,ITC,ITC4,3,Lombardia,Lombardia,10060574,5878188,58.43,0.52
3918,2020-12-29,LOM,106,45,61,106,0,0,ITC,ITC4,3,Lombardia,Lombardia,10060574,5878294,58.43,0.0
3919,2021-04-22,LOM,73897,33386,40511,56184,16326,1387,ITC,ITC4,3,Lombardia,Lombardia,10060574,5952191,59.16,0.73
3920,2021-03-03,LOM,26971,11515,15456,19470,7282,219,ITC,ITC4,3,Lombardia,Lombardia,10060574,5979162,59.43,0.27
3921,2021-01-29,LOM,13489,4127,9362,683,12803,3,ITC,ITC4,3,Lombardia,Lombardia,10060574,5992651,59.57,0.13
3922,2021-06-13,LOM,75994,40560,35434,72282,2124,1588,ITC,ITC4,3,Lombardia,Lombardia,10060574,6068645,60.32,0.76
3923,2021-03-05,LOM,28948,11940,17008,20229,8419,300,ITC,ITC4,3,Lombardia,Lombardia,10060574,6097593,60.61,0.29
3924,2021-06-27,LOM,90906,46795,44111,69784,18827,2295,ITC,ITC4,3,Lombardia,Lombardia,10060574,6188499,61.51,0.9
3925,2021-03-19,LOM,32428,12915,19513,18905,13200,323,ITC,ITC4,3,Lombardia,Lombardia,10060574,6220927,61.83,0.32
3926,2021-06-18,LOM,107583,52844,54739,52128,54208,1247,ITC,ITC4,3,Lombardia,Lombardia,10060574,6328510,62.9,1.07
3927,2021-03-01,LOM,18794,8233,10561,16882,1705,207,ITC,ITC4,3,Lombardia,Lombardia,10060574,6347304,63.09,0.19
3928,2021-05-15,LOM,80905,38782,42123,45474,33383,2048,ITC,ITC4,3,Lombardia,Lombardia,10060574,6428209,63.9,0.8
3929,2021-05-13,LOM,87145,41766,45379,55704,28852,2589,ITC,ITC4,3,Lombardia,Lombardia,10060574,6515354,64.76,0.87
3930,2021-02-02,LOM,19880,6598,13282,496,19381,3,ITC,ITC4,3,Lombardia,Lombardia,10060574,6535234,64.96,0.2
3931,2021-03-31,LOM,42107,17077,25030,26178,15252,677,ITC,ITC4,3,Lombardia,Lombardia,10060574,6577341,65.38,0.42
3932,2021-03-10,LOM,33250,12716,20534,24800,7863,587,ITC,ITC4,3,Lombardia,Lombardia,10060574,6610591,65.71,0.33
3933,2021-05-06,LOM,89829,42193,47636,70963,16499,2367,ITC,ITC4,3,Lombardia,Lombardia,10060574,6700420,66.6,0.89
3934,2021-01-26,LOM,8342,2706,5636,349,7993,0,ITC,ITC4,3,Lombardia,Lombardia,10060574,6708762,66.68,0.08
3935,2021-02-03,LOM,25646,7917,17729,1076,24565,5,ITC,ITC4,3,Lombardia,Lombardia,10060574,6734408,66.94,0.25
3936,2021-04-01,LOM,42964,17235,25729,26049,16204,711,ITC,ITC4,3,Lombardia,Lombardia,10060574,6777372,67.37,0.43
3937,2021-04-15,LOM,49449,21860,27589,34871,13825,753,ITC,ITC4,3,Lombardia,Lombardia,10060574,6826821,67.86,0.49
3938,2021-01-05,LOM,7856,2576,5280,7850,0,6,ITC,ITC4,3,Lombardia,Lombardia,10060574,6834677,67.94,0.08
3939,2021-03-27,LOM,32441,12377,20064,23102,8708,631,ITC,ITC4,3,Lombardia,Lombardia,10060574,6867118,68.26,0.32
3940,2021-01-03,LOM,854,316,538,853,0,1,ITC,ITC4,3,Lombardia,Lombardia,10060574,6867972,68.27,0.01
3941,2021-06-22,LOM,110940,57908,53032,79095,29721,2124,ITC,ITC4,3,Lombardia,Lombardia,10060574,6978912,69.37,1.1
3942,2021-06-03,LOM,97143,49716,47427,84579,10870,1694,ITC,ITC4,3,Lombardia,Lombardia,10060574,7076055,70.33,0.97
3943,2021-06-20,LOM,88930,44327,44603,52922,34770,1238,ITC,ITC4,3,Lombardia,Lombardia,10060574,7164985,71.22,0.88
3944,2021-03-12,LOM,35269,12967,22302,24447,10204,618,ITC,ITC4,3,Lombardia,Lombardia,10060574,7200254,71.57,0.35
3945,2021-03-29,LOM,40046,15542,24504,24528,14837,681,ITC,ITC4,3,Lombardia,Lombardia,10060574,7240300,71.97,0.4
3946,2021-06-01,LOM,93942,46096,47846,75734,17090,1118,ITC,ITC4,3,Lombardia,Lombardia,10060574,7334242,72.9,0.93
3947,2021-01-02,LOM,202,74,128,202,0,0,ITC,ITC4,3,Lombardia,Lombardia,10060574,7334444,72.9,0.0
3948,2021-06-08,LOM,102839,52281,50558,87136,14033,1670,ITC,ITC4,3,Lombardia,Lombardia,10060574,7437283,73.93,1.02
3949,2021-02-28,LOM,7884,3254,4630,7602,210,72,ITC,ITC4,3,Lombardia,Lombardia,10060574,7445167,74.0,0.08
3950,2021-04-26,LOM,87948,40924,47024,67016,19165,1767,ITC,ITC4,3,Lombardia,Lombardia,10060574,7533115,74.88,0.87
3951,2021-04-12,LOM,47244,20583,26661,32264,14343,637,ITC,ITC4,3,Lombardia,Lombardia,10060574,7580359,75.35,0.47
3952,2021-02-21,LOM,5053,1864,3189,4942,17,94,ITC,ITC4,3,Lombardia,Lombardia,10060574,7585412,75.4,0.05
3953,2021-04-19,LOM,60116,27349,32767,49441,9403,1272,ITC,ITC4,3,Lombardia,Lombardia,10060574,7645528,75.99,0.6
3954,2021-06-15,LOM,95955,48833,47122,49025,45857,1073,ITC,ITC4,3,Lombardia,Lombardia,10060574,7741483,76.95,0.95
3955,2021-05-11,LOM,86873,41433,45440,58239,26221,2413,ITC,ITC4,3,Lombardia,Lombardia,10060574,7828356,77.81,0.86
3956,2021-05-28,LOM,93525,44821,48704,42024,50586,915,ITC,ITC4,3,Lombardia,Lombardia,10060574,7921881,78.74,0.93
3957,2021-02-17,LOM,11990,3756,8234,10407,1390,193,ITC,ITC4,3,Lombardia,Lombardia,10060574,7933871,78.86,0.12
3958,2021-06-11,LOM,101364,51649,49715,84883,14584,1897,ITC,ITC4,3,Lombardia,Lombardia,10060574,8035235,79.87,1.01
3959,2021-06-02,LOM,84644,43577,41067,76994,6331,1319,ITC,ITC4,3,Lombardia,Lombardia,10060574,8119879,80.71,0.84
3960,2021-03-11,LOM,36217,13477,22740,25624,9909,684,ITC,ITC4,3,Lombardia,Lombardia,10060574,8156096,81.07,0.36
3961,2021-03-30,LOM,39629,15589,24040,24235,14780,614,ITC,ITC4,3,Lombardia,Lombardia,10060574,8195725,81.46,0.39
3962,2021-01-06,LOM,7061,2493,4568,7056,0,5,ITC,ITC4,3,Lombardia,Lombardia,10060574,8202786,81.53,0.07
3963,2021-05-27,LOM,94811,45429,49382,40603,53419,789,ITC,ITC4,3,Lombardia,Lombardia,10060574,8297597,82.48,0.94
3964,2021-04-24,LOM,75808,33596,42212,53436,21132,1240,ITC,ITC4,3,Lombardia,Lombardia,10060574,8373405,83.23,0.75
3965,2021-01-14,LOM,26919,7803,19116,26864,0,55,ITC,ITC4,3,Lombardia,Lombardia,10060574,8400324,83.5,0.27
3966,2021-05-08,LOM,87727,40755,46972,63468,22042,2217,ITC,ITC4,3,Lombardia,Lombardia,10060574,8488051,84.37,0.87
3967,2021-04-07,LOM,50589,20922,29667,34072,15810,707,ITC,ITC4,3,Lombardia,Lombardia,10060574,8538640,84.87,0.5
3968,2021-04-05,LOM,27380,11695,15685,19023,8103,254,ITC,ITC4,3,Lombardia,Lombardia,10060574,8566020,85.14,0.27
3969,2021-01-31,LOM,9740,3765,5975,29,9711,0,ITC,ITC4,3,Lombardia,Lombardia,10060574,8575760,85.24,0.1
3970,2021-05-25,LOM,91151,43619,47532,43843,46483,825,ITC,ITC4,3,Lombardia,Lombardia,10060574,8666911,86.15,0.91
3971,2021-02-14,LOM,3583,1547,2036,2934,635,14,ITC,ITC4,3,Lombardia,Lombardia,10060574,8670494,86.18,0.04
3972,2021-01-12,LOM,20230,6701,13529,20201,0,29,ITC,ITC4,3,Lombardia,Lombardia,10060574,8690724,86.38,0.2
3973,2021-05-18,LOM,88201,42158,46043,31865,55570,766,ITC,ITC4,3,Lombardia,Lombardia,10060574,8778925,87.26,0.88
3974,2021-06-04,LOM,104602,54300,50302,93189,9627,1786,ITC,ITC4,3,Lombardia,Lombardia,10060574,8883527,88.3,1.04
3975,2021-02-24,LOM,14720,5957,8763,13557,954,209,ITC,ITC4,3,Lombardia,Lombardia,10060574,8898247,88.45,0.15
3976,2021-05-16,LOM,68699,32505,36194,35586,32203,910,ITC,ITC4,3,Lombardia,Lombardia,10060574,8966946,89.13,0.68
3977,2021-02-05,LOM,25706,7456,18250,2409,23278,19,ITC,ITC4,3,Lombardia,Lombardia,10060574,8992652,89.39,0.26
3978,2021-02-22,LOM,11897,4809,7088,11393,305,199,ITC,ITC4,3,Lombardia,Lombardia,10060574,9004549,89.5,0.12
3979,2021-03-13,LOM,27176,9771,17405,20530,6094,552,ITC,ITC4,3,Lombardia,Lombardia,10060574,9031725,89.77,0.27
3980,2021-05-01,LOM,95976,43673,52303,65052,29212,1712,ITC,ITC4,3,Lombardia,Lombardia,10060574,9127701,90.73,0.95
3981,2021-01-21,LOM,5465,1598,3867,4759,690,16,ITC,ITC4,3,Lombardia,Lombardia,10060574,9133166,90.78,0.05
3982,2021-02-07,LOM,7312,2825,4487,335,6974,3,ITC,ITC4,3,Lombardia,Lombardia,10060574,9140478,90.85,0.07
3983,2021-01-19,LOM,8053,2329,5724,7571,468,14,ITC,ITC4,3,Lombardia,Lombardia,10060574,9148531,90.93,0.08
3984,2021-05-20,LOM,94426,45630,48796,31228,62555,643,ITC,ITC4,3,Lombardia,Lombardia,10060574,9242957,91.87,0.94
3985,2021-01-18,LOM,9202,2972,6230,8212,975,15,ITC,ITC4,3,Lombardia,Lombardia,10060574,9252159,91.96,0.09
3986,2021-03-23,LOM,42573,15466,27107,28858,12860,855,ITC,ITC4,3,Lombardia,Lombardia,10060574,9294732,92.39,0.42
3987,2021-01-25,LOM,7022,2373,4649,472,6547,3,ITC,ITC4,3,Lombardia,Lombardia,10060574,9301754,92.46,0.07
3988,2021-02-01,LOM,16066,5322,10744,307,15757,2,ITC,ITC4,3,Lombardia,Lombardia,10060574,9317820,92.62,0.16
3989,2021-07-05,LOM,101289,49483,51806,31220,68187,1882,ITC,ITC4,3,Lombardia,Lombardia,10060574,9419109,93.62,1.01
3990,2021-04-03,LOM,36243,14861,21382,25771,10091,381,ITC,ITC4,3,Lombardia,Lombardia,10060574,9455352,93.98,0.36
3991,2021-05-30,LOM,74366,35587,38779,33790,39956,620,ITC,ITC4,3,Lombardia,Lombardia,10060574,9529718,94.72,0.74
3992,2021-05-23,LOM,60762,28927,31835,26292,33955,515,ITC,ITC4,3,Lombardia,Lombardia,10060574,9590480,95.33,0.6
3993,2021-02-12,LOM,13964,4366,9598,8869,4935,160,ITC,ITC4,3,Lombardia,Lombardia,10060574,9604444,95.47,0.14
3994,2021-04-10,LOM,52738,21837,30901,40029,11956,753,ITC,ITC4,3,Lombardia,Lombardia,10060574,9657182,95.99,0.52
3995,2021-06-06,LOM,90124,46344,43780,79526,9221,1377,ITC,ITC4,3,Lombardia,Lombardia,10060574,9747306,96.89,0.9
3996,2021-01-07,LOM,11762,3636,8126,11722,0,40,ITC,ITC4,3,Lombardia,Lombardia,10060574,9759068,97.0,0.12
3997,2021-02-19,LOM,14218,5400,8818,13320,723,175,ITC,ITC4,3,Lombardia,Lombardia,10060574,9773286,97.14,0.14
3998,2021-04-17,LOM,48501,21300,27201,36944,10839,718,ITC,ITC4,3,Lombardia,Lombardia,10060574,9821787,97.63,0.48
3999,2021-02-26,LOM,18396,7554,10842,16319,1873,204,ITC,ITC4,3,Lombardia,Lombardia,10060574,9840183,97.81,0.18
4000,2020-12-31,LOM,714,302,412,714,0,0,ITC,ITC4,3,Lombardia,Lombardia,10060574,9840897,97.82,0.01
