,data,area,Vaccinazioni giornaliere,sesso_maschile,sesso_femminile,Operatori sanitari - sociosanitari,Personale non sanitario,categoria_altro,Ospiti RSA,categoria_over80,categoria_forze_armate,categoria_personale_scolastico,prima_dose,seconda_dose,codice_NUTS1,codice_NUTS2,codice_regione_ISTAT,nome_area,Regione,popolazione,Totale vaccinazioni,Totale vaccinazioni ogni cento ab,Vaccinazioni giornaliere ogni cento ab
0,2021-02-15,BAS,621,232,389,191,93,44,46,246,1,0,580,41,ITF,ITF5,17,Basilicata,Basilicata,559084,621,0.11,0.11
1,2021-01-04,BAS,607,271,336,550,45,10,0,0,0,2,607,0,ITF,ITF5,17,Basilicata,Basilicata,559084,1228,0.22,0.11
2,2021-01-05,BAS,945,409,536,861,38,46,0,0,0,0,945,0,ITF,ITF5,17,Basilicata,Basilicata,559084,2173,0.39,0.17
3,2021-01-27,BAS,410,174,236,299,16,69,26,0,0,0,113,297,ITF,ITF5,17,Basilicata,Basilicata,559084,2583,0.46,0.07
4,2021-03-09,BAS,1391,706,685,222,47,48,33,545,258,238,787,604,ITF,ITF5,17,Basilicata,Basilicata,559084,3974,0.71,0.25
5,2021-03-13,BAS,1794,888,906,82,292,66,46,864,231,213,749,1045,ITF,ITF5,17,Basilicata,Basilicata,559084,5768,1.03,0.32
6,2021-02-09,BAS,491,213,278,200,225,12,54,0,0,0,316,175,ITF,ITF5,17,Basilicata,Basilicata,559084,6259,1.12,0.09
7,2021-03-25,BAS,963,321,642,27,0,48,0,580,0,308,794,169,ITF,ITF5,17,Basilicata,Basilicata,559084,7222,1.29,0.17
8,2021-01-09,BAS,557,160,397,386,52,51,67,0,0,1,557,0,ITF,ITF5,17,Basilicata,Basilicata,559084,7779,1.39,0.1
9,2021-03-03,BAS,1740,813,927,191,252,161,99,590,203,244,1184,556,ITF,ITF5,17,Basilicata,Basilicata,559084,9519,1.7,0.31
10,2021-01-22,BAS,67,24,43,6,0,60,0,1,0,0,67,0,ITF,ITF5,17,Basilicata,Basilicata,559084,9586,1.71,0.01
11,2021-03-06,BAS,1350,534,816,296,118,52,57,383,185,259,756,594,ITF,ITF5,17,Basilicata,Basilicata,559084,10936,1.96,0.24
12,2021-01-03,BAS,900,344,556,790,45,63,0,0,0,2,900,0,ITF,ITF5,17,Basilicata,Basilicata,559084,11836,2.12,0.16
13,2021-01-30,BAS,703,226,477,424,81,72,126,0,0,0,127,576,ITF,ITF5,17,Basilicata,Basilicata,559084,12539,2.24,0.13
14,2021-02-03,BAS,666,300,366,425,15,54,172,0,0,0,32,634,ITF,ITF5,17,Basilicata,Basilicata,559084,13205,2.36,0.12
15,2021-01-21,BAS,30,10,20,0,0,30,0,0,0,0,30,0,ITF,ITF5,17,Basilicata,Basilicata,559084,13235,2.37,0.01
16,2021-03-21,BAS,1045,480,565,32,0,51,0,803,0,159,352,693,ITF,ITF5,17,Basilicata,Basilicata,559084,14280,2.55,0.19
17,2021-03-05,BAS,1849,855,994,298,123,104,72,689,254,309,1104,745,ITF,ITF5,17,Basilicata,Basilicata,559084,16129,2.88,0.33
18,2021-02-26,BAS,2148,904,1244,88,93,12,1,1954,0,0,2069,79,ITF,ITF5,17,Basilicata,Basilicata,559084,18277,3.27,0.38
19,2021-02-01,BAS,242,91,151,156,24,14,48,0,0,0,46,196,ITF,ITF5,17,Basilicata,Basilicata,559084,18519,3.31,0.04
20,2021-01-19,BAS,199,84,115,78,48,29,44,0,0,0,199,0,ITF,ITF5,17,Basilicata,Basilicata,559084,18718,3.35,0.04
21,2021-03-02,BAS,791,381,410,110,23,55,5,184,201,213,656,135,ITF,ITF5,17,Basilicata,Basilicata,559084,19509,3.49,0.14
22,2021-01-14,BAS,969,413,556,504,110,32,323,0,0,0,969,0,ITF,ITF5,17,Basilicata,Basilicata,559084,20478,3.66,0.17
23,2021-01-18,BAS,463,157,306,364,51,3,45,0,0,0,364,99,ITF,ITF5,17,Basilicata,Basilicata,559084,20941,3.75,0.08
24,2021-03-07,BAS,882,308,574,39,12,6,4,328,22,471,844,38,ITF,ITF5,17,Basilicata,Basilicata,559084,21823,3.9,0.16
25,2021-02-11,BAS,951,401,550,200,95,74,107,471,4,0,868,83,ITF,ITF5,17,Basilicata,Basilicata,559084,22774,4.07,0.17
26,2021-03-23,BAS,621,236,385,37,0,13,0,523,5,43,616,5,ITF,ITF5,17,Basilicata,Basilicata,559084,23395,4.18,0.11
27,2021-01-02,BAS,949,380,569,855,39,52,0,0,0,3,949,0,ITF,ITF5,17,Basilicata,Basilicata,559084,24344,4.35,0.17
28,2021-01-20,BAS,84,22,62,0,0,84,0,0,0,0,84,0,ITF,ITF5,17,Basilicata,Basilicata,559084,24428,4.37,0.02
29,2021-01-15,BAS,813,350,463,578,21,40,174,0,0,0,813,0,ITF,ITF5,17,Basilicata,Basilicata,559084,25241,4.51,0.15
30,2021-02-05,BAS,983,443,540,611,36,145,191,0,0,0,64,919,ITF,ITF5,17,Basilicata,Basilicata,559084,26224,4.69,0.18
31,2021-01-13,BAS,916,387,529,699,11,57,148,0,0,1,916,0,ITF,ITF5,17,Basilicata,Basilicata,559084,27140,4.85,0.16
32,2021-03-18,BAS,1346,561,785,30,0,10,0,1306,0,0,22,1324,ITF,ITF5,17,Basilicata,Basilicata,559084,28486,5.1,0.24
33,2021-02-21,BAS,284,113,171,16,1,1,11,254,0,1,284,0,ITF,ITF5,17,Basilicata,Basilicata,559084,28770,5.15,0.05
34,2021-02-25,BAS,1787,736,1051,67,2,12,0,1705,1,0,1741,46,ITF,ITF5,17,Basilicata,Basilicata,559084,30557,5.47,0.32
35,2021-01-12,BAS,217,88,129,87,22,9,99,0,0,0,217,0,ITF,ITF5,17,Basilicata,Basilicata,559084,30774,5.5,0.04
36,2021-01-23,BAS,707,299,408,592,38,76,1,0,0,0,33,674,ITF,ITF5,17,Basilicata,Basilicata,559084,31481,5.63,0.13
37,2021-03-11,BAS,1783,919,864,163,63,99,77,905,253,223,824,959,ITF,ITF5,17,Basilicata,Basilicata,559084,33264,5.95,0.32
38,2021-01-11,BAS,183,66,117,107,15,20,41,0,0,0,183,0,ITF,ITF5,17,Basilicata,Basilicata,559084,33447,5.98,0.03
39,2021-01-28,BAS,903,401,502,717,24,80,81,1,0,0,119,784,ITF,ITF5,17,Basilicata,Basilicata,559084,34350,6.14,0.16
40,2021-01-29,BAS,612,228,384,397,38,107,70,0,0,0,63,549,ITF,ITF5,17,Basilicata,Basilicata,559084,34962,6.25,0.11
41,2021-02-24,BAS,1803,743,1060,85,9,20,2,1686,1,0,1734,69,ITF,ITF5,17,Basilicata,Basilicata,559084,36765,6.58,0.32
42,2021-01-26,BAS,793,350,443,622,70,66,35,0,0,0,101,692,ITF,ITF5,17,Basilicata,Basilicata,559084,37558,6.72,0.14
43,2021-03-10,BAS,1650,814,836,101,46,64,33,877,256,273,811,839,ITF,ITF5,17,Basilicata,Basilicata,559084,39208,7.01,0.3
44,2021-03-08,BAS,1450,707,743,221,126,126,38,410,256,273,840,610,ITF,ITF5,17,Basilicata,Basilicata,559084,40658,7.27,0.26
45,2021-03-04,BAS,1872,889,983,217,107,136,66,842,263,241,1079,793,ITF,ITF5,17,Basilicata,Basilicata,559084,42530,7.61,0.33
46,2021-02-19,BAS,1622,737,885,219,356,19,66,962,0,0,1560,62,ITF,ITF5,17,Basilicata,Basilicata,559084,44152,7.9,0.29
47,2021-02-20,BAS,1160,530,630,77,170,31,80,802,0,0,1043,117,ITF,ITF5,17,Basilicata,Basilicata,559084,45312,8.1,0.21
48,2021-02-16,BAS,905,377,528,250,90,5,67,492,1,0,807,98,ITF,ITF5,17,Basilicata,Basilicata,559084,46217,8.27,0.16
49,2021-02-07,BAS,373,159,214,259,25,49,40,0,0,0,49,324,ITF,ITF5,17,Basilicata,Basilicata,559084,46590,8.33,0.07
50,2021-03-20,BAS,1286,566,720,45,68,47,0,943,5,178,275,1011,ITF,ITF5,17,Basilicata,Basilicata,559084,47876,8.56,0.23
51,2021-02-10,BAS,547,237,310,176,95,58,127,90,0,1,495,52,ITF,ITF5,17,Basilicata,Basilicata,559084,48423,8.66,0.1
52,2021-01-31,BAS,77,24,53,75,2,0,0,0,0,0,0,77,ITF,ITF5,17,Basilicata,Basilicata,559084,48500,8.67,0.01
53,2021-02-14,BAS,151,48,103,55,12,1,65,18,0,0,151,0,ITF,ITF5,17,Basilicata,Basilicata,559084,48651,8.7,0.03
54,2021-01-08,BAS,554,219,335,383,30,82,59,0,0,0,554,0,ITF,ITF5,17,Basilicata,Basilicata,559084,49205,8.8,0.1
55,2021-02-27,BAS,1986,856,1130,103,123,61,21,1678,0,0,1822,164,ITF,ITF5,17,Basilicata,Basilicata,559084,51191,9.16,0.36
56,2021-03-01,BAS,540,279,261,121,50,79,4,169,67,50,376,164,ITF,ITF5,17,Basilicata,Basilicata,559084,51731,9.25,0.1
57,2021-02-17,BAS,1135,493,642,123,42,27,57,884,1,1,1059,76,ITF,ITF5,17,Basilicata,Basilicata,559084,52866,9.46,0.2
58,2021-02-04,BAS,1092,440,652,636,106,69,281,0,0,0,63,1029,ITF,ITF5,17,Basilicata,Basilicata,559084,53958,9.65,0.2
59,2021-01-06,BAS,294,129,165,229,9,20,36,0,0,0,294,0,ITF,ITF5,17,Basilicata,Basilicata,559084,54252,9.7,0.05
60,2021-03-15,BAS,2347,981,1366,78,26,20,0,1934,23,266,520,1827,ITF,ITF5,17,Basilicata,Basilicata,559084,56599,10.12,0.42
61,2021-02-12,BAS,775,332,443,288,138,63,90,190,6,0,744,31,ITF,ITF5,17,Basilicata,Basilicata,559084,57374,10.26,0.14
62,2021-03-14,BAS,1008,477,531,41,110,13,8,516,71,249,539,469,ITF,ITF5,17,Basilicata,Basilicata,559084,58382,10.44,0.18
63,2021-02-02,BAS,365,141,224,212,15,36,102,0,0,0,175,190,ITF,ITF5,17,Basilicata,Basilicata,559084,58747,10.51,0.07
64,2021-02-06,BAS,902,367,535,546,115,72,168,0,0,1,146,756,ITF,ITF5,17,Basilicata,Basilicata,559084,59649,10.67,0.16
65,2021-02-13,BAS,799,313,486,279,125,79,115,199,2,0,738,61,ITF,ITF5,17,Basilicata,Basilicata,559084,60448,10.81,0.14
66,2021-03-24,BAS,887,375,512,54,0,15,0,697,2,119,646,241,ITF,ITF5,17,Basilicata,Basilicata,559084,61335,10.97,0.16
67,2021-01-24,BAS,834,299,535,706,46,81,1,0,0,0,58,776,ITF,ITF5,17,Basilicata,Basilicata,559084,62169,11.12,0.15
68,2021-03-22,BAS,1172,529,643,46,49,38,0,638,16,385,626,546,ITF,ITF5,17,Basilicata,Basilicata,559084,63341,11.33,0.21
69,2021-03-17,BAS,1448,606,842,22,11,18,0,1390,5,2,27,1421,ITF,ITF5,17,Basilicata,Basilicata,559084,64789,11.59,0.26
70,2021-02-18,BAS,1070,401,669,270,55,19,150,576,0,0,855,215,ITF,ITF5,17,Basilicata,Basilicata,559084,65859,11.78,0.19
71,2021-03-16,BAS,1899,799,1100,103,27,31,0,1671,5,62,228,1671,ITF,ITF5,17,Basilicata,Basilicata,559084,67758,12.12,0.34
72,2021-03-12,BAS,1896,975,921,266,61,48,37,985,241,258,798,1098,ITF,ITF5,17,Basilicata,Basilicata,559084,69654,12.46,0.34
73,2021-01-16,BAS,721,304,417,466,17,75,161,0,0,2,721,0,ITF,ITF5,17,Basilicata,Basilicata,559084,70375,12.59,0.13
74,2021-01-25,BAS,1020,427,593,828,80,111,1,0,0,0,74,946,ITF,ITF5,17,Basilicata,Basilicata,559084,71395,12.77,0.18
75,2021-01-07,BAS,640,319,321,556,8,47,29,0,0,0,640,0,ITF,ITF5,17,Basilicata,Basilicata,559084,72035,12.88,0.11
76,2021-02-23,BAS,1901,771,1130,159,24,25,35,1658,0,0,1763,138,ITF,ITF5,17,Basilicata,Basilicata,559084,73936,13.22,0.34
77,2021-02-28,BAS,802,342,460,32,0,30,0,740,0,0,774,28,ITF,ITF5,17,Basilicata,Basilicata,559084,74738,13.37,0.14
78,2021-02-08,BAS,557,193,364,436,49,23,49,0,0,0,151,406,ITF,ITF5,17,Basilicata,Basilicata,559084,75295,13.47,0.1
79,2021-02-22,BAS,1790,773,1017,125,18,68,2,1577,0,0,1737,53,ITF,ITF5,17,Basilicata,Basilicata,559084,77085,13.79,0.32
80,2021-01-17,BAS,328,133,195,233,11,30,54,0,0,0,327,1,ITF,ITF5,17,Basilicata,Basilicata,559084,77413,13.85,0.06
81,2021-03-19,BAS,2284,988,1296,58,75,37,0,1950,22,142,261,2023,ITF,ITF5,17,Basilicata,Basilicata,559084,79697,14.25,0.41
82,2021-01-10,BAS,77,24,53,9,2,66,0,0,0,0,77,0,ITF,ITF5,17,Basilicata,Basilicata,559084,79774,14.27,0.01
83,2020-12-27,BAS,106,41,65,104,0,2,0,0,0,0,106,0,ITF,ITF5,17,Basilicata,Basilicata,559084,79880,14.29,0.02
84,2021-02-22,LAZ,11415,4975,6440,1779,123,186,473,5242,1390,2222,10914,501,ITI,ITI4,12,Lazio,Lazio,5879082,11415,0.19,0.19
85,2021-03-22,LAZ,21307,8866,12441,1524,75,5971,243,9116,517,3861,14934,6373,ITI,ITI4,12,Lazio,Lazio,5879082,32722,0.56,0.36
86,2021-02-24,LAZ,11982,5179,6803,1797,428,508,337,5185,1327,2400,10993,989,ITI,ITI4,12,Lazio,Lazio,5879082,44704,0.76,0.2
87,2021-03-20,LAZ,18113,6775,11338,1827,139,3761,360,8775,204,3047,12277,5836,ITI,ITI4,12,Lazio,Lazio,5879082,62817,1.07,0.31
88,2021-03-16,LAZ,13445,5703,7742,1496,69,2145,280,9443,7,5,7044,6401,ITI,ITI4,12,Lazio,Lazio,5879082,76262,1.3,0.23
89,2020-12-30,LAZ,1630,629,1001,1603,0,0,27,0,0,0,1630,0,ITI,ITI4,12,Lazio,Lazio,5879082,77892,1.32,0.03
90,2021-01-11,LAZ,5525,2103,3422,4553,307,96,569,0,0,0,5525,0,ITI,ITI4,12,Lazio,Lazio,5879082,83417,1.42,0.09
91,2021-03-07,LAZ,14031,5408,8623,1200,24,1205,148,7225,696,3533,10442,3589,ITI,ITI4,12,Lazio,Lazio,5879082,97448,1.66,0.24
92,2021-01-13,LAZ,5559,2063,3496,4145,270,132,1009,3,0,0,5559,0,ITI,ITI4,12,Lazio,Lazio,5879082,103007,1.75,0.09
93,2021-01-04,LAZ,7478,2907,4571,7075,5,81,316,0,0,1,7478,0,ITI,ITI4,12,Lazio,Lazio,5879082,110485,1.88,0.13
94,2021-02-01,LAZ,5669,2173,3496,4784,189,130,559,7,0,0,353,5316,ITI,ITI4,12,Lazio,Lazio,5879082,116154,1.98,0.1
95,2021-01-07,LAZ,7734,2900,4834,6890,174,104,566,0,0,0,7734,0,ITI,ITI4,12,Lazio,Lazio,5879082,123888,2.11,0.13
96,2021-02-07,LAZ,4668,1865,2803,3251,138,247,218,813,0,1,382,4286,ITI,ITI4,12,Lazio,Lazio,5879082,128556,2.19,0.08
97,2021-01-17,LAZ,4562,1843,2719,3238,145,191,177,811,0,0,4350,212,ITI,ITI4,12,Lazio,Lazio,5879082,133118,2.26,0.08
98,2020-12-29,LAZ,440,155,285,440,0,0,0,0,0,0,440,0,ITI,ITI4,12,Lazio,Lazio,5879082,133558,2.27,0.01
99,2021-02-12,LAZ,6494,2645,3849,1995,136,287,302,3774,0,0,6417,77,ITI,ITI4,12,Lazio,Lazio,5879082,140052,2.38,0.11
100,2021-01-25,LAZ,7761,3041,4720,7006,205,65,363,122,0,0,421,7340,ITI,ITI4,12,Lazio,Lazio,5879082,147813,2.51,0.13
101,2021-02-26,LAZ,12884,5604,7280,1909,533,800,352,5166,1385,2739,11666,1218,ITI,ITI4,12,Lazio,Lazio,5879082,160697,2.73,0.22
102,2021-02-17,LAZ,8808,4371,4437,2282,225,207,499,4249,1345,1,8280,528,ITI,ITI4,12,Lazio,Lazio,5879082,169505,2.88,0.15
103,2021-01-24,LAZ,5467,2109,3358,4945,131,131,134,126,0,0,385,5082,ITI,ITI4,12,Lazio,Lazio,5879082,174972,2.98,0.09
104,2021-01-28,LAZ,7954,2998,4956,6810,374,122,514,134,0,0,459,7495,ITI,ITI4,12,Lazio,Lazio,5879082,182926,3.11,0.14
105,2021-01-30,LAZ,6649,2730,3919,5298,265,309,651,126,0,0,448,6201,ITI,ITI4,12,Lazio,Lazio,5879082,189575,3.22,0.11
106,2021-01-29,LAZ,7594,2866,4728,6373,258,169,704,90,0,0,477,7117,ITI,ITI4,12,Lazio,Lazio,5879082,197169,3.35,0.13
107,2021-02-11,LAZ,6658,2788,3870,2197,174,160,500,3627,0,0,6460,198,ITI,ITI4,12,Lazio,Lazio,5879082,203827,3.47,0.11
108,2021-02-28,LAZ,10223,3996,6227,1601,260,428,77,4576,682,2599,9709,514,ITI,ITI4,12,Lazio,Lazio,5879082,214050,3.64,0.17
109,2021-01-01,LAZ,3553,1381,2172,3483,0,2,68,0,0,0,3553,0,ITI,ITI4,12,Lazio,Lazio,5879082,217603,3.7,0.06
110,2021-03-11,LAZ,23615,10508,13107,4823,124,3021,440,9245,1526,4436,17392,6223,ITI,ITI4,12,Lazio,Lazio,5879082,241218,4.1,0.4
111,2021-02-20,LAZ,8795,4082,4713,1942,111,350,298,4762,1310,22,8378,417,ITI,ITI4,12,Lazio,Lazio,5879082,250013,4.25,0.15
112,2021-03-10,LAZ,21788,9377,12411,4019,143,2489,451,8890,1179,4617,16162,5626,ITI,ITI4,12,Lazio,Lazio,5879082,271801,4.62,0.37
113,2021-02-18,LAZ,9676,4799,4877,2162,91,328,473,4956,1665,1,9178,498,ITI,ITI4,12,Lazio,Lazio,5879082,281477,4.79,0.16
114,2021-02-08,LAZ,9334,3868,5466,3788,428,446,918,3754,0,0,4487,4847,ITI,ITI4,12,Lazio,Lazio,5879082,290811,4.95,0.16
115,2021-01-09,LAZ,6292,2559,3733,5114,229,329,620,0,0,0,6292,0,ITI,ITI4,12,Lazio,Lazio,5879082,297103,5.05,0.11
116,2020-12-28,LAZ,959,412,547,957,0,2,0,0,0,0,959,0,ITI,ITI4,12,Lazio,Lazio,5879082,298062,5.07,0.02
117,2021-02-27,LAZ,11373,4246,7127,1358,399,486,515,4792,1120,2703,10420,953,ITI,ITI4,12,Lazio,Lazio,5879082,309435,5.26,0.19
118,2021-03-21,LAZ,17764,6803,10961,1238,27,4689,111,8170,100,3429,12744,5020,ITI,ITI4,12,Lazio,Lazio,5879082,327199,5.57,0.3
119,2021-03-17,LAZ,13472,5751,7721,1507,87,2239,254,9364,7,14,7284,6188,ITI,ITI4,12,Lazio,Lazio,5879082,340671,5.79,0.23
120,2021-03-06,LAZ,17948,6891,11057,3662,113,1251,327,7891,932,3772,13694,4254,ITI,ITI4,12,Lazio,Lazio,5879082,358619,6.1,0.31
121,2021-01-27,LAZ,5768,2170,3598,4797,215,170,457,129,0,0,651,5117,ITI,ITI4,12,Lazio,Lazio,5879082,364387,6.2,0.1
122,2021-02-10,LAZ,7776,3116,4660,2646,275,306,633,3916,0,0,4841,2935,ITI,ITI4,12,Lazio,Lazio,5879082,372163,6.33,0.13
123,2021-01-31,LAZ,4279,1783,2496,3572,139,200,244,124,0,0,296,3983,ITI,ITI4,12,Lazio,Lazio,5879082,376442,6.4,0.07
124,2021-02-14,LAZ,5536,2246,3290,1645,20,298,127,3446,0,0,5287,249,ITI,ITI4,12,Lazio,Lazio,5879082,381978,6.5,0.09
125,2021-02-19,LAZ,9698,4893,4805,2170,93,297,408,5060,1636,34,9201,497,ITI,ITI4,12,Lazio,Lazio,5879082,391676,6.66,0.16
126,2021-03-05,LAZ,18494,7801,10693,2725,171,1574,256,8476,1323,3969,13773,4721,ITI,ITI4,12,Lazio,Lazio,5879082,410170,6.98,0.31
127,2021-02-04,LAZ,6045,2281,3764,4460,354,267,892,72,0,0,942,5103,ITI,ITI4,12,Lazio,Lazio,5879082,416215,7.08,0.1
128,2021-01-22,LAZ,3662,1442,2220,3379,63,27,70,123,0,0,148,3514,ITI,ITI4,12,Lazio,Lazio,5879082,419877,7.14,0.06
129,2021-03-02,LAZ,16598,7182,9416,1808,357,1069,229,8103,1278,3754,12669,3929,ITI,ITI4,12,Lazio,Lazio,5879082,436475,7.42,0.28
130,2021-01-10,LAZ,4039,1700,2339,3424,156,207,252,0,0,0,4039,0,ITI,ITI4,12,Lazio,Lazio,5879082,440514,7.49,0.07
131,2021-03-08,LAZ,19842,8203,11639,2428,120,2062,379,9042,1102,4709,14580,5262,ITI,ITI4,12,Lazio,Lazio,5879082,460356,7.83,0.34
132,2021-02-13,LAZ,6274,2436,3838,2123,42,171,280,3658,0,0,6186,88,ITI,ITI4,12,Lazio,Lazio,5879082,466630,7.94,0.11
133,2021-03-18,LAZ,14126,6045,8081,1747,90,2631,330,9313,9,6,7762,6364,ITI,ITI4,12,Lazio,Lazio,5879082,480756,8.18,0.24
134,2021-02-25,LAZ,12629,5513,7116,1754,434,775,489,5143,1423,2611,11583,1046,ITI,ITI4,12,Lazio,Lazio,5879082,493385,8.39,0.21
135,2021-01-26,LAZ,7602,2907,4695,6590,212,44,631,125,0,0,372,7230,ITI,ITI4,12,Lazio,Lazio,5879082,500987,8.52,0.13
136,2021-01-02,LAZ,6704,2629,4075,6268,47,31,358,0,0,0,6704,0,ITI,ITI4,12,Lazio,Lazio,5879082,507691,8.64,0.11
137,2021-03-09,LAZ,20794,8913,11881,3365,104,2187,338,8953,1230,4617,15601,5193,ITI,ITI4,12,Lazio,Lazio,5879082,528485,8.99,0.35
138,2021-01-14,LAZ,5232,1961,3271,3887,304,146,811,84,0,0,5232,0,ITI,ITI4,12,Lazio,Lazio,5879082,533717,9.08,0.09
139,2021-01-20,LAZ,4390,1657,2733,3279,233,166,426,286,0,0,2849,1541,ITI,ITI4,12,Lazio,Lazio,5879082,538107,9.15,0.07
140,2021-01-15,LAZ,6227,2467,3760,4480,417,187,988,155,0,0,6227,0,ITI,ITI4,12,Lazio,Lazio,5879082,544334,9.26,0.11
141,2021-03-04,LAZ,18187,7743,10444,2773,211,1345,507,8131,1315,3905,13176,5011,ITI,ITI4,12,Lazio,Lazio,5879082,562521,9.57,0.31
142,2021-03-13,LAZ,21253,8343,12910,5090,109,2378,325,8892,720,3739,15367,5886,ITI,ITI4,12,Lazio,Lazio,5879082,583774,9.93,0.36
143,2021-01-03,LAZ,5250,1972,3278,5125,18,42,65,0,0,0,5250,0,ITI,ITI4,12,Lazio,Lazio,5879082,589024,10.02,0.09
144,2021-02-03,LAZ,6288,2348,3940,4620,335,220,1078,35,0,0,901,5387,ITI,ITI4,12,Lazio,Lazio,5879082,595312,10.13,0.11
145,2021-03-24,LAZ,25373,11039,14334,3685,92,8347,107,9305,239,3598,19329,6044,ITI,ITI4,12,Lazio,Lazio,5879082,620685,10.56,0.43
146,2021-03-25,LAZ,25625,10910,14715,4329,81,7948,315,9270,199,3483,19522,6103,ITI,ITI4,12,Lazio,Lazio,5879082,646310,10.99,0.44
147,2021-02-21,LAZ,6799,3101,3698,1245,53,309,51,4518,607,16,6517,282,ITI,ITI4,12,Lazio,Lazio,5879082,653109,11.11,0.12
148,2021-02-15,LAZ,7726,3379,4347,2447,362,313,378,4218,8,0,7429,297,ITI,ITI4,12,Lazio,Lazio,5879082,660835,11.24,0.13
149,2021-01-21,LAZ,5247,2109,3138,4780,78,32,232,125,0,0,196,5051,ITI,ITI4,12,Lazio,Lazio,5879082,666082,11.33,0.09
150,2021-03-23,LAZ,22781,9772,13009,2452,98,6709,181,9150,381,3810,16522,6259,ITI,ITI4,12,Lazio,Lazio,5879082,688863,11.72,0.39
151,2021-02-06,LAZ,5069,2015,3054,3270,206,424,660,509,0,0,769,4300,ITI,ITI4,12,Lazio,Lazio,5879082,693932,11.8,0.09
152,2021-01-19,LAZ,4361,1671,2690,2967,222,340,424,408,0,0,3908,453,ITI,ITI4,12,Lazio,Lazio,5879082,698293,11.88,0.07
153,2021-02-02,LAZ,5772,2133,3639,4712,367,119,571,3,0,0,501,5271,ITI,ITI4,12,Lazio,Lazio,5879082,704065,11.98,0.1
154,2020-12-27,LAZ,272,131,141,272,0,0,0,0,0,0,272,0,ITI,ITI4,12,Lazio,Lazio,5879082,704337,11.98,0.0
155,2021-03-03,LAZ,17052,7206,9846,2110,200,1177,379,8000,1249,3937,12762,4290,ITI,ITI4,12,Lazio,Lazio,5879082,721389,12.27,0.29
156,2021-03-01,LAZ,16639,7108,9531,1554,527,1209,383,7981,1406,3579,12789,3850,ITI,ITI4,12,Lazio,Lazio,5879082,738028,12.55,0.28
157,2021-02-16,LAZ,8043,3862,4181,2058,102,476,261,4195,950,1,7786,257,ITI,ITI4,12,Lazio,Lazio,5879082,746071,12.69,0.14
158,2021-01-06,LAZ,5114,1956,3158,4619,40,133,320,0,1,1,5114,0,ITI,ITI4,12,Lazio,Lazio,5879082,751185,12.78,0.09
159,2021-03-14,LAZ,17033,6585,10448,1342,89,3295,81,8335,445,3446,11879,5154,ITI,ITI4,12,Lazio,Lazio,5879082,768218,13.07,0.29
160,2021-02-23,LAZ,10901,4680,6221,1896,109,493,309,5169,1015,1910,10277,624,ITI,ITI4,12,Lazio,Lazio,5879082,779119,13.25,0.19
161,2021-01-08,LAZ,7725,2894,4831,6518,191,218,798,0,0,0,7725,0,ITI,ITI4,12,Lazio,Lazio,5879082,786844,13.38,0.13
162,2021-02-09,LAZ,8393,3484,4909,3258,244,338,548,4005,0,0,4571,3822,ITI,ITI4,12,Lazio,Lazio,5879082,795237,13.53,0.14
163,2021-02-05,LAZ,6910,2722,4188,5095,373,258,995,189,0,0,1131,5779,ITI,ITI4,12,Lazio,Lazio,5879082,802147,13.64,0.12
164,2020-12-31,LAZ,5218,2095,3123,4927,0,12,279,0,0,0,5218,0,ITI,ITI4,12,Lazio,Lazio,5879082,807365,13.73,0.09
165,2021-01-18,LAZ,5835,2268,3567,3901,387,369,725,453,0,0,4857,978,ITI,ITI4,12,Lazio,Lazio,5879082,813200,13.83,0.1
166,2021-03-15,LAZ,19194,8303,10891,2302,122,3553,408,9577,706,2526,12479,6715,ITI,ITI4,12,Lazio,Lazio,5879082,832394,14.16,0.33
167,2021-03-12,LAZ,22599,9994,12605,4642,170,3252,400,9413,774,3948,16287,6312,ITI,ITI4,12,Lazio,Lazio,5879082,854993,14.54,0.38
168,2021-01-12,LAZ,5391,1974,3417,4343,342,122,584,0,0,0,5391,0,ITI,ITI4,12,Lazio,Lazio,5879082,860384,14.63,0.09
169,2021-01-23,LAZ,6883,2682,4201,6063,247,31,417,125,0,0,255,6628,ITI,ITI4,12,Lazio,Lazio,5879082,867267,14.75,0.12
170,2021-01-16,LAZ,5349,2073,3276,3354,241,220,1064,470,0,0,5349,0,ITI,ITI4,12,Lazio,Lazio,5879082,872616,14.84,0.09
171,2021-01-05,LAZ,7370,2802,4568,6690,0,102,577,0,1,0,7370,0,ITI,ITI4,12,Lazio,Lazio,5879082,879986,14.97,0.13
172,2021-03-19,LAZ,16965,7250,9715,2111,140,3757,389,9314,248,1006,10674,6291,ITI,ITI4,12,Lazio,Lazio,5879082,896951,15.26,0.29
173,2021-03-04,ABR,5936,2358,3578,1170,14,521,93,2992,328,818,5015,921,ITF,ITF1,13,Abruzzo,Abruzzo,1304970,5936,0.45,0.45
174,2021-01-24,ABR,50,22,28,49,0,1,0,0,0,0,6,44,ITF,ITF1,13,Abruzzo,Abruzzo,1304970,5986,0.46,0.0
175,2020-12-27,ABR,37,19,18,34,0,1,2,0,0,0,37,0,ITF,ITF1,13,Abruzzo,Abruzzo,1304970,6023,0.46,0.0
176,2021-03-01,ABR,3486,1391,2095,698,29,264,174,1911,128,282,2722,764,ITF,ITF1,13,Abruzzo,Abruzzo,1304970,9509,0.73,0.27
177,2021-01-22,ABR,118,57,61,2,1,3,112,0,0,0,118,0,ITF,ITF1,13,Abruzzo,Abruzzo,1304970,9627,0.74,0.01
178,2021-03-05,ABR,5261,1937,3324,561,10,447,107,2582,202,1352,4564,697,ITF,ITF1,13,Abruzzo,Abruzzo,1304970,14888,1.14,0.4
179,2021-02-26,ABR,3920,1671,2249,1025,13,552,160,1651,257,262,2951,969,ITF,ITF1,13,Abruzzo,Abruzzo,1304970,18808,1.44,0.3
180,2021-01-12,ABR,1804,666,1138,1470,42,292,0,0,0,0,1804,0,ITF,ITF1,13,Abruzzo,Abruzzo,1304970,20612,1.58,0.14
181,2021-02-12,ABR,968,319,649,438,11,209,310,0,0,0,779,189,ITF,ITF1,13,Abruzzo,Abruzzo,1304970,21580,1.65,0.07
182,2021-01-06,ABR,1830,664,1166,1546,119,32,133,0,0,0,1830,0,ITF,ITF1,13,Abruzzo,Abruzzo,1304970,23410,1.79,0.14
183,2021-01-04,ABR,1401,575,826,1396,0,5,0,0,0,0,1401,0,ITF,ITF1,13,Abruzzo,Abruzzo,1304970,24811,1.9,0.11
184,2021-03-11,ABR,5425,2188,3237,1324,39,519,241,1539,199,1564,4286,1139,ITF,ITF1,13,Abruzzo,Abruzzo,1304970,30236,2.32,0.42
185,2021-01-31,ABR,1502,488,1014,1154,85,160,103,0,0,0,287,1215,ITF,ITF1,13,Abruzzo,Abruzzo,1304970,31738,2.43,0.12
186,2021-01-27,ABR,1364,515,849,1301,1,62,0,0,0,0,39,1325,ITF,ITF1,13,Abruzzo,Abruzzo,1304970,33102,2.54,0.1
187,2021-03-09,ABR,5169,1795,3374,987,21,507,84,1320,204,2046,4230,939,ITF,ITF1,13,Abruzzo,Abruzzo,1304970,38271,2.93,0.4
188,2021-03-08,ABR,5127,1669,3458,1190,30,477,112,1019,104,2195,4153,974,ITF,ITF1,13,Abruzzo,Abruzzo,1304970,43398,3.33,0.39
189,2021-03-03,ABR,4627,1881,2746,1222,6,577,36,1585,346,855,3721,906,ITF,ITF1,13,Abruzzo,Abruzzo,1304970,48025,3.68,0.35
190,2021-02-23,ABR,2784,1274,1510,324,22,401,215,1436,286,100,2773,11,ITF,ITF1,13,Abruzzo,Abruzzo,1304970,50809,3.89,0.21
191,2021-03-10,ABR,4948,1640,3308,735,29,426,242,1518,127,1871,3992,956,ITF,ITF1,13,Abruzzo,Abruzzo,1304970,55757,4.27,0.38
192,2021-02-05,ABR,1535,520,1015,1188,11,230,106,0,0,0,788,747,ITF,ITF1,13,Abruzzo,Abruzzo,1304970,57292,4.39,0.12
193,2021-03-06,ABR,4174,1354,2820,432,24,344,52,1748,15,1559,3604,570,ITF,ITF1,13,Abruzzo,Abruzzo,1304970,61466,4.71,0.32
194,2021-02-13,ABR,845,383,462,549,25,199,72,0,0,0,437,408,ITF,ITF1,13,Abruzzo,Abruzzo,1304970,62311,4.77,0.06
195,2021-01-14,ABR,530,189,341,364,0,166,0,0,0,0,530,0,ITF,ITF1,13,Abruzzo,Abruzzo,1304970,62841,4.82,0.04
196,2021-02-08,ABR,1201,398,803,710,122,105,264,0,0,0,491,710,ITF,ITF1,13,Abruzzo,Abruzzo,1304970,64042,4.91,0.09
197,2021-03-25,ABR,5354,2408,2946,249,10,796,39,3599,213,448,2923,2431,ITF,ITF1,13,Abruzzo,Abruzzo,1304970,69396,5.32,0.41
198,2021-01-20,ABR,447,156,291,147,1,95,204,0,0,0,445,2,ITF,ITF1,13,Abruzzo,Abruzzo,1304970,69843,5.35,0.03
199,2021-02-01,ABR,1632,573,1059,1384,34,213,1,0,0,0,271,1361,ITF,ITF1,13,Abruzzo,Abruzzo,1304970,71475,5.48,0.13
200,2021-01-03,ABR,471,185,286,464,0,7,0,0,0,0,471,0,ITF,ITF1,13,Abruzzo,Abruzzo,1304970,71946,5.51,0.04
201,2021-03-15,ABR,3517,1378,2139,656,8,562,78,1963,41,209,1701,1816,ITF,ITF1,13,Abruzzo,Abruzzo,1304970,75463,5.78,0.27
202,2021-02-03,ABR,2061,717,1344,1541,47,355,118,0,0,0,419,1642,ITF,ITF1,13,Abruzzo,Abruzzo,1304970,77524,5.94,0.16
203,2021-01-28,ABR,1433,495,938,1370,1,61,1,0,0,0,12,1421,ITF,ITF1,13,Abruzzo,Abruzzo,1304970,78957,6.05,0.11
204,2021-01-30,ABR,1509,566,943,1348,1,113,47,0,0,0,69,1440,ITF,ITF1,13,Abruzzo,Abruzzo,1304970,80466,6.17,0.12
205,2021-01-02,ABR,548,218,330,540,0,8,0,0,0,0,548,0,ITF,ITF1,13,Abruzzo,Abruzzo,1304970,81014,6.21,0.04
206,2021-02-06,ABR,1611,742,869,1168,29,342,72,0,0,0,602,1009,ITF,ITF1,13,Abruzzo,Abruzzo,1304970,82625,6.33,0.12
207,2021-01-17,ABR,187,59,128,136,13,38,0,0,0,0,180,7,ITF,ITF1,13,Abruzzo,Abruzzo,1304970,82812,6.35,0.01
208,2021-03-17,ABR,4543,1876,2667,285,26,187,144,3873,17,11,2800,1743,ITF,ITF1,13,Abruzzo,Abruzzo,1304970,87355,6.69,0.35
209,2021-02-28,ABR,1707,511,1196,23,0,34,0,79,149,1422,1705,2,ITF,ITF1,13,Abruzzo,Abruzzo,1304970,89062,6.82,0.13
210,2021-03-13,ABR,4253,1460,2793,539,17,1008,137,1468,23,1061,3177,1076,ITF,ITF1,13,Abruzzo,Abruzzo,1304970,93315,7.15,0.33
211,2021-03-12,ABR,6021,1988,4033,1005,28,847,135,1700,117,2189,4438,1583,ITF,ITF1,13,Abruzzo,Abruzzo,1304970,99336,7.61,0.46
212,2021-01-16,ABR,927,428,499,710,7,195,15,0,0,0,927,0,ITF,ITF1,13,Abruzzo,Abruzzo,1304970,100263,7.68,0.07
213,2021-01-26,ABR,1542,567,975,1513,0,29,0,0,0,0,29,1513,ITF,ITF1,13,Abruzzo,Abruzzo,1304970,101805,7.8,0.12
214,2021-01-13,ABR,1253,440,813,1103,0,150,0,0,0,0,1253,0,ITF,ITF1,13,Abruzzo,Abruzzo,1304970,103058,7.9,0.1
215,2021-03-24,ABR,5823,2538,3285,479,10,1403,143,3144,215,429,3799,2024,ITF,ITF1,13,Abruzzo,Abruzzo,1304970,108881,8.34,0.45
216,2021-03-07,ABR,2523,630,1893,28,0,210,0,461,1,1823,2523,0,ITF,ITF1,13,Abruzzo,Abruzzo,1304970,111404,8.54,0.19
217,2021-01-19,ABR,111,55,56,27,1,33,50,0,0,0,91,20,ITF,ITF1,13,Abruzzo,Abruzzo,1304970,111515,8.55,0.01
218,2021-02-15,ABR,1796,831,965,625,30,457,221,217,246,0,1754,42,ITF,ITF1,13,Abruzzo,Abruzzo,1304970,113311,8.68,0.14
219,2021-03-19,ABR,5795,2584,3211,755,28,432,118,4398,51,13,2774,3021,ITF,ITF1,13,Abruzzo,Abruzzo,1304970,119106,9.13,0.44
220,2021-01-21,ABR,157,47,110,10,4,2,141,0,0,0,157,0,ITF,ITF1,13,Abruzzo,Abruzzo,1304970,119263,9.14,0.01
221,2021-01-23,ABR,263,114,149,223,0,14,26,0,0,0,57,206,ITF,ITF1,13,Abruzzo,Abruzzo,1304970,119526,9.16,0.02
222,2021-02-09,ABR,908,311,597,612,56,109,131,0,0,0,499,409,ITF,ITF1,13,Abruzzo,Abruzzo,1304970,120434,9.23,0.07
223,2021-03-22,ABR,4276,1918,2358,340,8,771,50,2578,136,393,2306,1970,ITF,ITF1,13,Abruzzo,Abruzzo,1304970,124710,9.56,0.33
224,2021-02-04,ABR,1681,616,1065,1168,47,409,57,0,0,0,609,1072,ITF,ITF1,13,Abruzzo,Abruzzo,1304970,126391,9.69,0.13
225,2021-02-22,ABR,2644,1175,1469,477,5,352,46,1094,419,251,2614,30,ITF,ITF1,13,Abruzzo,Abruzzo,1304970,129035,9.89,0.2
226,2021-02-11,ABR,816,262,554,473,26,163,154,0,0,0,773,43,ITF,ITF1,13,Abruzzo,Abruzzo,1304970,129851,9.95,0.06
227,2021-03-16,ABR,3486,1453,2033,284,3,163,169,2849,6,12,1831,1655,ITF,ITF1,13,Abruzzo,Abruzzo,1304970,133337,10.22,0.27
228,2021-02-18,ABR,2291,934,1357,670,36,344,416,610,215,0,2161,130,ITF,ITF1,13,Abruzzo,Abruzzo,1304970,135628,10.39,0.18
229,2021-02-07,ABR,777,307,470,646,6,124,1,0,0,0,201,576,ITF,ITF1,13,Abruzzo,Abruzzo,1304970,136405,10.45,0.06
230,2021-03-14,ABR,1895,733,1162,8,0,150,0,1488,0,249,1228,667,ITF,ITF1,13,Abruzzo,Abruzzo,1304970,138300,10.6,0.15
231,2021-01-10,ABR,1139,409,730,1091,0,48,0,0,0,0,1139,0,ITF,ITF1,13,Abruzzo,Abruzzo,1304970,139439,10.69,0.09
232,2021-02-20,ABR,4782,1843,2939,310,7,563,192,1417,406,1887,4706,76,ITF,ITF1,13,Abruzzo,Abruzzo,1304970,144221,11.05,0.37
233,2021-02-24,ABR,3302,1439,1863,391,17,323,247,1967,226,131,3126,176,ITF,ITF1,13,Abruzzo,Abruzzo,1304970,147523,11.3,0.25
234,2021-01-29,ABR,1386,449,937,1290,2,94,0,0,0,0,74,1312,ITF,ITF1,13,Abruzzo,Abruzzo,1304970,148909,11.41,0.11
235,2021-01-09,ABR,1483,565,918,1430,0,53,0,0,0,0,1483,0,ITF,ITF1,13,Abruzzo,Abruzzo,1304970,150392,11.52,0.11
236,2021-02-19,ABR,3301,1552,1749,990,32,401,371,1111,388,8,3201,100,ITF,ITF1,13,Abruzzo,Abruzzo,1304970,153693,11.78,0.25
237,2021-01-08,ABR,1525,507,1018,1487,0,38,0,0,0,0,1525,0,ITF,ITF1,13,Abruzzo,Abruzzo,1304970,155218,11.89,0.12
238,2021-01-07,ABR,1603,552,1051,1566,0,37,0,0,0,0,1603,0,ITF,ITF1,13,Abruzzo,Abruzzo,1304970,156821,12.02,0.12
239,2021-02-17,ABR,2077,952,1125,512,27,215,394,718,210,1,1794,283,ITF,ITF1,13,Abruzzo,Abruzzo,1304970,158898,12.18,0.16
240,2021-03-20,ABR,4733,2159,2574,318,15,509,60,3650,84,97,2569,2164,ITF,ITF1,13,Abruzzo,Abruzzo,1304970,163631,12.54,0.36
241,2021-01-25,ABR,1604,633,971,1584,0,20,0,0,0,0,20,1584,ITF,ITF1,13,Abruzzo,Abruzzo,1304970,165235,12.66,0.12
242,2021-03-02,ABR,3963,1676,2287,934,15,424,53,1856,276,405,3279,684,ITF,ITF1,13,Abruzzo,Abruzzo,1304970,169198,12.97,0.3
243,2021-01-11,ABR,1551,557,994,1337,62,104,48,0,0,0,1551,0,ITF,ITF1,13,Abruzzo,Abruzzo,1304970,170749,13.08,0.12
244,2021-02-27,ABR,2809,1337,1472,253,23,162,123,732,642,874,2543,266,ITF,ITF1,13,Abruzzo,Abruzzo,1304970,173558,13.3,0.22
245,2021-02-02,ABR,1798,677,1121,1243,67,346,142,0,0,0,241,1557,ITF,ITF1,13,Abruzzo,Abruzzo,1304970,175356,13.44,0.14
246,2021-02-16,ABR,1978,869,1109,841,20,493,139,410,75,0,1966,12,ITF,ITF1,13,Abruzzo,Abruzzo,1304970,177334,13.59,0.15
247,2021-03-23,ABR,4765,2180,2585,180,25,499,183,3273,206,399,2278,2487,ITF,ITF1,13,Abruzzo,Abruzzo,1304970,182099,13.95,0.37
248,2021-01-05,ABR,1614,604,1010,1604,0,10,0,0,0,0,1614,0,ITF,ITF1,13,Abruzzo,Abruzzo,1304970,183713,14.08,0.12
249,2021-01-18,ABR,122,48,74,106,0,14,2,0,0,0,46,76,ITF,ITF1,13,Abruzzo,Abruzzo,1304970,183835,14.09,0.01
250,2021-01-15,ABR,379,149,230,223,6,115,35,0,0,0,379,0,ITF,ITF1,13,Abruzzo,Abruzzo,1304970,184214,14.12,0.03
251,2021-03-18,ABR,3896,1651,2245,281,2,284,3,3297,22,7,2065,1831,ITF,ITF1,13,Abruzzo,Abruzzo,1304970,188110,14.41,0.3
252,2021-03-21,ABR,2135,913,1222,9,0,47,1,1919,29,130,844,1291,ITF,ITF1,13,Abruzzo,Abruzzo,1304970,190245,14.58,0.16
253,2021-02-25,ABR,3086,1347,1739,615,29,528,18,1508,262,126,2558,528,ITF,ITF1,13,Abruzzo,Abruzzo,1304970,193331,14.81,0.24
254,2021-02-10,ABR,948,313,635,622,42,168,116,0,0,0,504,444,ITF,ITF1,13,Abruzzo,Abruzzo,1304970,194279,14.89,0.07
255,2021-02-21,ABR,1221,551,670,2,0,4,3,1210,2,0,1220,1,ITF,ITF1,13,Abruzzo,Abruzzo,1304970,195500,14.98,0.09
256,2021-03-13,PUG,10014,3943,6071,2158,226,197,128,3841,226,3238,8290,1724,ITF,ITF4,16,Puglia,Puglia,4029053,10014,0.25,0.25
257,2021-01-19,PUG,1221,452,769,527,113,4,577,0,0,0,1211,10,ITF,ITF4,16,Puglia,Puglia,4029053,11235,0.28,0.03
258,2021-03-17,PUG,10120,4640,5480,1758,427,181,62,7595,33,64,4067,6053,ITF,ITF4,16,Puglia,Puglia,4029053,21355,0.53,0.25
259,2021-03-02,PUG,16248,6021,10227,1393,370,687,112,4278,1247,8161,14943,1305,ITF,ITF4,16,Puglia,Puglia,4029053,37603,0.93,0.4
260,2021-01-04,PUG,4503,2012,2491,4371,84,36,11,0,0,1,4503,0,ITF,ITF4,16,Puglia,Puglia,4029053,42106,1.05,0.11
261,2021-01-21,PUG,2129,903,1226,1429,166,8,526,0,0,0,1270,859,ITF,ITF4,16,Puglia,Puglia,4029053,44235,1.1,0.05
262,2021-01-22,PUG,1409,579,830,876,150,7,373,2,0,1,992,417,ITF,ITF4,16,Puglia,Puglia,4029053,45644,1.13,0.03
263,2021-02-10,PUG,3603,1425,2178,2491,247,0,864,0,0,1,2122,1481,ITF,ITF4,16,Puglia,Puglia,4029053,49247,1.22,0.09
264,2021-03-08,PUG,14457,5995,8462,2094,525,613,202,6694,521,3808,12081,2376,ITF,ITF4,16,Puglia,Puglia,4029053,63704,1.58,0.36
265,2021-01-09,PUG,4867,2245,2622,4313,246,57,246,4,0,1,4867,0,ITF,ITF4,16,Puglia,Puglia,4029053,68571,1.7,0.12
266,2021-02-24,PUG,10004,4687,5317,1920,415,295,117,6336,365,556,9416,588,ITF,ITF4,16,Puglia,Puglia,4029053,78575,1.95,0.25
267,2021-01-29,PUG,6188,2659,3529,5465,341,91,288,0,0,3,436,5752,ITF,ITF4,16,Puglia,Puglia,4029053,84763,2.1,0.15
268,2021-02-12,PUG,4098,1629,2469,2937,440,11,690,5,10,5,3008,1090,ITF,ITF4,16,Puglia,Puglia,4029053,88861,2.21,0.1
269,2021-03-20,PUG,7878,3576,4302,1412,64,233,51,5276,35,807,3329,4549,ITF,ITF4,16,Puglia,Puglia,4029053,96739,2.4,0.2
270,2020-12-31,PUG,1635,782,853,1549,33,6,44,0,0,3,1635,0,ITF,ITF4,16,Puglia,Puglia,4029053,98374,2.44,0.04
271,2021-01-18,PUG,1844,770,1074,1182,210,6,446,0,0,0,1495,349,ITF,ITF4,16,Puglia,Puglia,4029053,100218,2.49,0.05
272,2021-01-28,PUG,5464,2271,3193,4759,314,62,327,0,0,2,474,4990,ITF,ITF4,16,Puglia,Puglia,4029053,105682,2.62,0.14
273,2021-02-03,PUG,5028,1999,3029,4363,469,9,184,0,0,3,729,4299,ITF,ITF4,16,Puglia,Puglia,4029053,110710,2.75,0.12
274,2021-02-26,PUG,13549,4954,8595,2117,620,224,284,5085,602,4617,12529,1020,ITF,ITF4,16,Puglia,Puglia,4029053,124259,3.08,0.34
275,2021-01-23,PUG,3036,1291,1745,2522,174,32,307,0,0,1,885,2151,ITF,ITF4,16,Puglia,Puglia,4029053,127295,3.16,0.08
276,2021-02-15,PUG,3252,1267,1985,2249,518,23,452,1,6,3,2632,620,ITF,ITF4,16,Puglia,Puglia,4029053,130547,3.24,0.08
277,2021-03-19,PUG,7758,3578,4180,1748,211,206,69,5202,64,258,3293,4465,ITF,ITF4,16,Puglia,Puglia,4029053,138305,3.43,0.19
278,2021-02-19,PUG,4728,2009,2719,3039,981,260,390,2,49,7,4338,390,ITF,ITF4,16,Puglia,Puglia,4029053,143033,3.55,0.12
279,2021-01-27,PUG,4575,1927,2648,3916,221,40,396,0,0,2,610,3965,ITF,ITF4,16,Puglia,Puglia,4029053,147608,3.66,0.11
280,2021-02-05,PUG,5622,2269,3353,4562,494,31,526,0,3,6,1325,4297,ITF,ITF4,16,Puglia,Puglia,4029053,153230,3.8,0.14
281,2021-03-22,PUG,8992,4426,4566,583,183,495,11,6565,203,952,3591,5401,ITF,ITF4,16,Puglia,Puglia,4029053,162222,4.03,0.22
282,2021-01-17,PUG,1307,589,718,824,146,1,336,0,0,0,1238,69,ITF,ITF4,16,Puglia,Puglia,4029053,163529,4.06,0.03
283,2021-02-27,PUG,13977,4735,9242,1583,543,251,178,5080,345,5997,12798,1179,ITF,ITF4,16,Puglia,Puglia,4029053,177506,4.41,0.35
284,2021-03-14,PUG,3241,1396,1845,951,62,141,73,973,42,999,2486,755,ITF,ITF4,16,Puglia,Puglia,4029053,180747,4.49,0.08
285,2021-02-16,PUG,3379,1451,1928,2133,727,83,414,4,16,2,2733,646,ITF,ITF4,16,Puglia,Puglia,4029053,184126,4.57,0.08
286,2021-01-20,PUG,1550,543,1007,783,125,40,602,0,0,0,1542,8,ITF,ITF4,16,Puglia,Puglia,4029053,185676,4.61,0.04
287,2021-01-02,PUG,2946,1298,1648,2826,64,29,23,0,0,4,2946,0,ITF,ITF4,16,Puglia,Puglia,4029053,188622,4.68,0.07
288,2021-02-21,PUG,2171,472,1699,537,24,61,49,32,12,1456,2110,61,ITF,ITF4,16,Puglia,Puglia,4029053,190793,4.74,0.05
289,2021-01-11,PUG,3749,1587,2162,3212,318,39,175,0,3,2,3749,0,ITF,ITF4,16,Puglia,Puglia,4029053,194542,4.83,0.09
290,2021-01-16,PUG,2510,1033,1477,1685,299,7,518,0,0,1,2510,0,ITF,ITF4,16,Puglia,Puglia,4029053,197052,4.89,0.06
291,2021-02-02,PUG,4331,1838,2493,3622,376,13,317,0,0,3,591,3740,ITF,ITF4,16,Puglia,Puglia,4029053,201383,5.0,0.11
292,2021-01-06,PUG,3943,1664,2279,3221,204,145,373,0,0,0,3943,0,ITF,ITF4,16,Puglia,Puglia,4029053,205326,5.1,0.1
293,2021-03-06,PUG,15605,5818,9787,2113,339,439,70,5189,479,6976,13640,1965,ITF,ITF4,16,Puglia,Puglia,4029053,220931,5.48,0.39
294,2021-01-08,PUG,5573,2337,3236,4844,356,45,325,0,0,3,5573,0,ITF,ITF4,16,Puglia,Puglia,4029053,226504,5.62,0.14
295,2021-03-01,PUG,14947,5817,9130,1960,479,444,83,6090,819,5072,13580,1367,ITF,ITF4,16,Puglia,Puglia,4029053,241451,5.99,0.37
296,2021-01-31,PUG,1805,825,980,1499,103,1,198,2,0,2,73,1732,ITF,ITF4,16,Puglia,Puglia,4029053,243256,6.04,0.04
297,2021-01-03,PUG,2006,943,1063,1816,33,11,145,0,0,1,2006,0,ITF,ITF4,16,Puglia,Puglia,4029053,245262,6.09,0.05
298,2021-02-25,PUG,11740,4974,6766,1721,524,349,419,5623,725,2379,10590,1150,ITF,ITF4,16,Puglia,Puglia,4029053,257002,6.38,0.29
299,2021-03-16,PUG,9564,4559,5005,2165,517,308,76,6400,62,36,3235,6329,ITF,ITF4,16,Puglia,Puglia,4029053,266566,6.62,0.24
300,2021-03-21,PUG,2669,1219,1450,462,15,103,13,1778,14,284,566,2103,ITF,ITF4,16,Puglia,Puglia,4029053,269235,6.68,0.07
301,2021-01-24,PUG,1668,749,919,1286,231,0,150,1,0,0,152,1516,ITF,ITF4,16,Puglia,Puglia,4029053,270903,6.72,0.04
302,2020-12-27,PUG,506,249,257,401,2,40,63,0,0,0,506,0,ITF,ITF4,16,Puglia,Puglia,4029053,271409,6.74,0.01
303,2021-01-15,PUG,4545,1860,2685,3592,337,51,558,0,3,4,4545,0,ITF,ITF4,16,Puglia,Puglia,4029053,275954,6.85,0.11
304,2021-02-28,PUG,5844,1773,4071,559,119,142,26,1484,194,3320,5658,186,ITF,ITF4,16,Puglia,Puglia,4029053,281798,6.99,0.15
305,2021-03-03,PUG,16394,6578,9816,2017,416,400,192,5868,810,6691,14573,1821,ITF,ITF4,16,Puglia,Puglia,4029053,298192,7.4,0.41
306,2021-01-13,PUG,4534,1728,2806,3968,309,25,230,0,0,2,4534,0,ITF,ITF4,16,Puglia,Puglia,4029053,302726,7.51,0.11
307,2021-02-23,PUG,9302,4401,4901,1763,308,179,156,5483,398,1015,8835,467,ITF,ITF4,16,Puglia,Puglia,4029053,312028,7.74,0.23
308,2021-03-07,PUG,4905,1937,2968,930,48,189,2,1617,323,1796,4335,570,ITF,ITF4,16,Puglia,Puglia,4029053,316933,7.87,0.12
309,2021-03-05,PUG,16931,6746,10185,2308,542,679,272,5192,1022,6916,14771,2160,ITF,ITF4,16,Puglia,Puglia,4029053,333864,8.29,0.42
310,2021-01-30,PUG,5524,2511,3013,4748,323,25,419,3,0,6,413,5111,ITF,ITF4,16,Puglia,Puglia,4029053,339388,8.42,0.14
311,2021-03-15,PUG,11657,5566,6091,2072,503,306,115,7630,353,678,5173,6484,ITF,ITF4,16,Puglia,Puglia,4029053,351045,8.71,0.29
312,2021-02-17,PUG,4263,1742,2521,2453,1170,40,598,1,0,1,3666,597,ITF,ITF4,16,Puglia,Puglia,4029053,355308,8.82,0.11
313,2021-03-23,PUG,10262,4909,5353,1849,307,638,51,5986,452,979,3865,6397,ITF,ITF4,16,Puglia,Puglia,4029053,365570,9.07,0.25
314,2021-03-11,PUG,14128,6081,8047,2886,746,443,515,5063,797,3678,11036,3092,ITF,ITF4,16,Puglia,Puglia,4029053,379698,9.42,0.35
315,2021-03-12,PUG,13726,6032,7694,3277,907,404,430,4883,886,2939,9802,3924,ITF,ITF4,16,Puglia,Puglia,4029053,393424,9.76,0.34
316,2021-01-14,PUG,4062,1585,2477,3165,368,28,499,0,0,2,4062,0,ITF,ITF4,16,Puglia,Puglia,4029053,397486,9.87,0.1
317,2021-03-24,PUG,11706,5376,6330,1782,420,627,69,7316,177,1315,5394,6312,ITF,ITF4,16,Puglia,Puglia,4029053,409192,10.16,0.29
318,2021-02-20,PUG,2959,1075,1884,2112,194,50,167,8,4,424,2703,256,ITF,ITF4,16,Puglia,Puglia,4029053,412151,10.23,0.07
319,2021-01-07,PUG,5707,2448,3259,5210,246,30,217,0,1,3,5707,0,ITF,ITF4,16,Puglia,Puglia,4029053,417858,10.37,0.14
320,2021-02-01,PUG,3957,1656,2301,3439,279,21,209,0,4,5,375,3582,ITF,ITF4,16,Puglia,Puglia,4029053,421815,10.47,0.1
321,2021-02-18,PUG,4368,1843,2525,2709,912,56,682,5,2,2,3765,603,ITF,ITF4,16,Puglia,Puglia,4029053,426183,10.58,0.11
322,2021-03-10,PUG,14202,6155,8047,2563,908,336,355,6363,601,3076,11091,3111,ITF,ITF4,16,Puglia,Puglia,4029053,440385,10.93,0.35
323,2021-01-12,PUG,4202,1765,2437,3628,339,11,218,1,0,5,4202,0,ITF,ITF4,16,Puglia,Puglia,4029053,444587,11.03,0.1
324,2021-01-01,PUG,146,60,86,145,1,0,0,0,0,0,146,0,ITF,ITF4,16,Puglia,Puglia,4029053,444733,11.04,0.0
325,2021-03-04,PUG,14985,5838,9147,1542,389,510,322,4712,1231,6279,13608,1377,ITF,ITF4,16,Puglia,Puglia,4029053,459718,11.41,0.37
326,2021-01-10,PUG,2346,1060,1286,2035,100,9,202,0,0,0,2346,0,ITF,ITF4,16,Puglia,Puglia,4029053,462064,11.47,0.06
327,2020-12-30,PUG,1,0,1,1,0,0,0,0,0,0,1,0,ITF,ITF4,16,Puglia,Puglia,4029053,462065,11.47,0.0
328,2021-02-07,PUG,1540,657,883,1029,218,4,288,0,0,1,252,1288,ITF,ITF4,16,Puglia,Puglia,4029053,463605,11.51,0.04
329,2021-01-05,PUG,5096,2244,2852,4740,153,96,98,5,0,4,5096,0,ITF,ITF4,16,Puglia,Puglia,4029053,468701,11.63,0.13
330,2021-01-26,PUG,5360,2397,2963,4846,241,40,232,1,0,0,574,4786,ITF,ITF4,16,Puglia,Puglia,4029053,474061,11.77,0.13
331,2021-03-25,PUG,9937,4832,5105,1189,293,833,52,6584,338,648,4067,5870,ITF,ITF4,16,Puglia,Puglia,4029053,483998,12.01,0.25
332,2021-01-25,PUG,3820,1677,2143,3470,155,24,168,2,0,1,422,3398,ITF,ITF4,16,Puglia,Puglia,4029053,487818,12.11,0.09
333,2021-02-11,PUG,3693,1401,2292,2568,389,11,723,0,0,2,2417,1276,ITF,ITF4,16,Puglia,Puglia,4029053,491511,12.2,0.09
334,2021-03-09,PUG,12779,5610,7169,1768,483,381,197,5409,1007,3534,10786,1993,ITF,ITF4,16,Puglia,Puglia,4029053,504290,12.52,0.32
335,2021-02-08,PUG,3987,1606,2381,2956,568,47,389,1,25,1,1597,2390,ITF,ITF4,16,Puglia,Puglia,4029053,508277,12.62,0.1
336,2021-02-22,PUG,9603,4522,5081,1425,432,302,139,6771,215,319,9273,330,ITF,ITF4,16,Puglia,Puglia,4029053,517880,12.85,0.24
337,2021-03-18,PUG,8980,4060,4920,1737,293,322,195,6304,39,90,2970,6010,ITF,ITF4,16,Puglia,Puglia,4029053,526860,13.08,0.22
338,2021-02-13,PUG,3719,1451,2268,2880,507,12,291,4,18,7,3027,692,ITF,ITF4,16,Puglia,Puglia,4029053,530579,13.17,0.09
339,2021-02-06,PUG,4509,1913,2596,3491,483,4,528,0,0,3,1591,2918,ITF,ITF4,16,Puglia,Puglia,4029053,535088,13.28,0.11
340,2021-02-04,PUG,5894,2356,3538,4424,623,189,652,0,0,6,1167,4727,ITF,ITF4,16,Puglia,Puglia,4029053,540982,13.43,0.15
341,2021-02-14,PUG,784,348,436,681,32,0,70,0,0,1,662,122,ITF,ITF4,16,Puglia,Puglia,4029053,541766,13.45,0.02
342,2021-02-09,PUG,3835,1568,2267,2533,651,17,621,8,0,5,2163,1672,ITF,ITF4,16,Puglia,Puglia,4029053,545601,13.54,0.1
343,2021-03-03,CAL,4865,2651,2214,631,110,1047,917,1367,789,4,3802,1063,ITF,ITF6,18,Calabria,Calabria,1947131,4865,0.25,0.25
344,2021-02-04,CAL,3391,1623,1768,2560,38,571,222,0,0,0,644,2747,ITF,ITF6,18,Calabria,Calabria,1947131,8256,0.42,0.17
345,2021-02-06,CAL,2909,1337,1572,2095,30,537,247,0,0,0,442,2467,ITF,ITF6,18,Calabria,Calabria,1947131,11165,0.57,0.15
346,2021-03-05,CAL,6145,3540,2605,695,33,1556,710,1854,1292,5,5570,575,ITF,ITF6,18,Calabria,Calabria,1947131,17310,0.89,0.32
347,2021-02-28,CAL,2167,983,1184,113,8,144,190,1706,6,0,2016,151,ITF,ITF6,18,Calabria,Calabria,1947131,19477,1.0,0.11
348,2021-03-18,CAL,4240,1978,2262,359,49,1316,232,2195,44,45,2271,1969,ITF,ITF6,18,Calabria,Calabria,1947131,23717,1.22,0.22
349,2021-03-19,CAL,4184,1947,2237,486,5,1326,293,1964,8,102,1898,2286,ITF,ITF6,18,Calabria,Calabria,1947131,27901,1.43,0.21
350,2021-02-21,CAL,608,286,322,36,28,136,47,331,30,0,531,77,ITF,ITF6,18,Calabria,Calabria,1947131,28509,1.46,0.03
351,2021-03-04,CAL,5382,3104,2278,646,105,1309,731,1540,1049,2,4586,796,ITF,ITF6,18,Calabria,Calabria,1947131,33891,1.74,0.28
352,2021-01-31,CAL,1108,554,554,765,1,284,58,0,0,0,155,953,ITF,ITF6,18,Calabria,Calabria,1947131,34999,1.8,0.06
353,2021-02-12,CAL,1711,669,1042,815,42,718,136,0,0,0,943,768,ITF,ITF6,18,Calabria,Calabria,1947131,36710,1.89,0.09
354,2021-02-05,CAL,3795,1709,2086,2327,298,616,554,0,0,0,488,3307,ITF,ITF6,18,Calabria,Calabria,1947131,40505,2.08,0.19
355,2021-01-17,CAL,867,418,449,527,9,283,48,0,0,0,801,66,ITF,ITF6,18,Calabria,Calabria,1947131,41372,2.12,0.04
356,2021-02-27,CAL,3679,1913,1766,421,37,551,395,1971,302,2,3301,378,ITF,ITF6,18,Calabria,Calabria,1947131,45051,2.31,0.19
357,2021-01-21,CAL,958,444,514,735,1,107,115,0,0,0,929,29,ITF,ITF6,18,Calabria,Calabria,1947131,46009,2.36,0.05
358,2021-03-14,CAL,2542,1018,1524,322,2,374,312,802,9,721,2142,400,ITF,ITF6,18,Calabria,Calabria,1947131,48551,2.49,0.13
359,2021-02-09,CAL,2147,904,1243,1422,220,274,231,0,0,0,948,1199,ITF,ITF6,18,Calabria,Calabria,1947131,50698,2.6,0.11
360,2021-01-09,CAL,1916,1036,880,1529,0,387,0,0,0,0,1916,0,ITF,ITF6,18,Calabria,Calabria,1947131,52614,2.7,0.1
361,2021-03-24,CAL,6521,3010,3511,356,23,2136,696,2360,63,887,3395,3126,ITF,ITF6,18,Calabria,Calabria,1947131,59135,3.04,0.33
362,2021-01-16,CAL,2394,1120,1274,1664,22,467,241,0,0,0,2394,0,ITF,ITF6,18,Calabria,Calabria,1947131,61529,3.16,0.12
363,2021-01-24,CAL,44,18,26,15,0,3,26,0,0,0,39,5,ITF,ITF6,18,Calabria,Calabria,1947131,61573,3.16,0.0
364,2021-03-23,CAL,5158,2411,2747,280,4,1798,47,1869,77,1083,3388,1770,ITF,ITF6,18,Calabria,Calabria,1947131,66731,3.43,0.26
365,2021-01-05,CAL,1350,618,732,1256,0,94,0,0,0,0,1350,0,ITF,ITF6,18,Calabria,Calabria,1947131,68081,3.5,0.07
366,2021-02-08,CAL,1847,733,1114,1214,158,354,121,0,0,0,661,1186,ITF,ITF6,18,Calabria,Calabria,1947131,69928,3.59,0.09
367,2021-03-08,CAL,5313,2816,2497,707,25,1788,453,1514,823,3,4255,1058,ITF,ITF6,18,Calabria,Calabria,1947131,75241,3.86,0.27
368,2020-12-27,CAL,275,150,125,274,0,1,0,0,0,0,275,0,ITF,ITF6,18,Calabria,Calabria,1947131,75516,3.88,0.01
369,2021-02-24,CAL,1843,940,903,658,7,359,115,653,47,4,1368,475,ITF,ITF6,18,Calabria,Calabria,1947131,77359,3.97,0.09
370,2021-01-29,CAL,2048,984,1064,1752,4,243,49,0,0,0,234,1814,ITF,ITF6,18,Calabria,Calabria,1947131,79407,4.08,0.11
371,2021-01-22,CAL,656,274,382,298,4,244,110,0,0,0,654,2,ITF,ITF6,18,Calabria,Calabria,1947131,80063,4.11,0.03
372,2021-03-20,CAL,6478,2982,3496,432,7,1581,398,3561,34,465,4090,2388,ITF,ITF6,18,Calabria,Calabria,1947131,86541,4.44,0.33
373,2021-01-18,CAL,1230,550,680,982,0,237,11,0,0,0,1040,190,ITF,ITF6,18,Calabria,Calabria,1947131,87771,4.51,0.06
374,2021-03-06,CAL,7945,4053,3892,701,69,1803,758,3795,813,6,7190,755,ITF,ITF6,18,Calabria,Calabria,1947131,95716,4.92,0.41
375,2021-01-28,CAL,2232,1107,1125,1920,1,311,0,0,0,0,84,2148,ITF,ITF6,18,Calabria,Calabria,1947131,97948,5.03,0.11
376,2021-02-16,CAL,1534,643,891,659,11,506,240,118,0,0,1255,279,ITF,ITF6,18,Calabria,Calabria,1947131,99482,5.11,0.08
377,2021-02-15,CAL,1137,538,599,499,26,386,159,66,0,1,989,148,ITF,ITF6,18,Calabria,Calabria,1947131,100619,5.17,0.06
378,2021-02-03,CAL,2763,1428,1335,2170,22,468,103,0,0,0,583,2180,ITF,ITF6,18,Calabria,Calabria,1947131,103382,5.31,0.14
379,2021-02-18,CAL,1800,803,997,586,55,454,299,345,0,61,1577,223,ITF,ITF6,18,Calabria,Calabria,1947131,105182,5.4,0.09
380,2021-02-13,CAL,1331,583,748,731,18,470,111,1,0,0,968,363,ITF,ITF6,18,Calabria,Calabria,1947131,106513,5.47,0.07
381,2021-01-25,CAL,1064,512,552,1021,0,43,0,0,0,0,156,908,ITF,ITF6,18,Calabria,Calabria,1947131,107577,5.52,0.05
382,2021-02-19,CAL,1461,652,809,544,21,320,195,380,1,0,1200,261,ITF,ITF6,18,Calabria,Calabria,1947131,109038,5.6,0.08
383,2021-01-04,CAL,996,492,504,969,0,27,0,0,0,0,996,0,ITF,ITF6,18,Calabria,Calabria,1947131,110034,5.65,0.05
384,2021-02-02,CAL,2289,1112,1177,1863,4,347,75,0,0,0,177,2112,ITF,ITF6,18,Calabria,Calabria,1947131,112323,5.77,0.12
385,2021-03-02,CAL,4131,2390,1741,705,58,677,427,1390,872,2,3422,709,ITF,ITF6,18,Calabria,Calabria,1947131,116454,5.98,0.21
386,2021-01-02,CAL,165,94,71,165,0,0,0,0,0,0,165,0,ITF,ITF6,18,Calabria,Calabria,1947131,116619,5.99,0.01
387,2021-01-30,CAL,2173,1147,1026,1974,0,199,0,0,0,0,358,1815,ITF,ITF6,18,Calabria,Calabria,1947131,118792,6.1,0.11
388,2021-01-12,CAL,2058,1017,1041,1706,0,323,29,0,0,0,2058,0,ITF,ITF6,18,Calabria,Calabria,1947131,120850,6.21,0.11
389,2021-03-01,CAL,2688,1533,1155,399,6,416,257,971,636,3,2238,450,ITF,ITF6,18,Calabria,Calabria,1947131,123538,6.34,0.14
390,2021-03-17,CAL,3634,1621,2013,277,49,931,165,2093,26,93,1937,1697,ITF,ITF6,18,Calabria,Calabria,1947131,127172,6.53,0.19
391,2021-01-13,CAL,2028,1022,1006,1800,0,194,34,0,0,0,2028,0,ITF,ITF6,18,Calabria,Calabria,1947131,129200,6.64,0.1
392,2021-02-07,CAL,859,428,431,566,15,197,81,0,0,0,147,712,ITF,ITF6,18,Calabria,Calabria,1947131,130059,6.68,0.04
393,2021-03-13,CAL,6654,2933,3721,425,44,1333,338,3764,65,685,5680,974,ITF,ITF6,18,Calabria,Calabria,1947131,136713,7.02,0.34
394,2021-01-19,CAL,1109,488,621,853,8,172,76,0,0,0,1098,11,ITF,ITF6,18,Calabria,Calabria,1947131,137822,7.08,0.06
395,2021-01-23,CAL,400,186,214,325,1,51,23,0,0,0,358,42,ITF,ITF6,18,Calabria,Calabria,1947131,138222,7.1,0.02
396,2021-01-10,CAL,929,524,405,830,0,99,0,0,0,0,929,0,ITF,ITF6,18,Calabria,Calabria,1947131,139151,7.15,0.05
397,2021-03-25,CAL,6914,3267,3647,291,34,2859,428,2148,57,1097,4421,2493,ITF,ITF6,18,Calabria,Calabria,1947131,146065,7.5,0.36
398,2021-03-15,CAL,3447,1652,1795,542,38,889,136,1093,163,586,2018,1429,ITF,ITF6,18,Calabria,Calabria,1947131,149512,7.68,0.18
399,2021-01-14,CAL,2557,1214,1343,1962,0,592,3,0,0,0,2557,0,ITF,ITF6,18,Calabria,Calabria,1947131,152069,7.81,0.13
400,2021-03-16,CAL,3767,1847,1920,459,5,1116,22,2077,58,30,2171,1596,ITF,ITF6,18,Calabria,Calabria,1947131,155836,8.0,0.19
401,2021-02-25,CAL,2821,1519,1302,736,49,587,234,863,348,4,2242,579,ITF,ITF6,18,Calabria,Calabria,1947131,158657,8.15,0.14
402,2021-01-06,CAL,926,500,426,822,0,104,0,0,0,0,926,0,ITF,ITF6,18,Calabria,Calabria,1947131,159583,8.2,0.05
403,2021-02-17,CAL,1681,672,1009,673,21,322,285,299,0,81,1471,210,ITF,ITF6,18,Calabria,Calabria,1947131,161264,8.28,0.09
404,2021-02-10,CAL,2463,1074,1389,1469,66,571,357,0,0,0,839,1624,ITF,ITF6,18,Calabria,Calabria,1947131,163727,8.41,0.13
405,2021-03-21,CAL,3395,1404,1991,105,0,555,198,1791,23,723,1695,1700,ITF,ITF6,18,Calabria,Calabria,1947131,167122,8.58,0.17
406,2021-02-11,CAL,2341,1043,1298,1464,71,565,241,0,0,0,1081,1260,ITF,ITF6,18,Calabria,Calabria,1947131,169463,8.7,0.12
407,2021-01-03,CAL,6,3,3,4,0,2,0,0,0,0,6,0,ITF,ITF6,18,Calabria,Calabria,1947131,169469,8.7,0.0
408,2021-02-14,CAL,371,145,226,146,13,129,83,0,0,0,341,30,ITF,ITF6,18,Calabria,Calabria,1947131,169840,8.72,0.02
409,2021-01-08,CAL,2109,1014,1095,1898,0,211,0,0,0,0,2109,0,ITF,ITF6,18,Calabria,Calabria,1947131,171949,8.83,0.11
410,2021-03-12,CAL,5092,2438,2654,468,26,1300,217,1963,333,785,4049,1043,ITF,ITF6,18,Calabria,Calabria,1947131,177041,9.09,0.26
411,2021-03-09,CAL,5820,3031,2789,803,23,1916,419,1768,873,18,4843,977,ITF,ITF6,18,Calabria,Calabria,1947131,182861,9.39,0.3
412,2021-01-26,CAL,1805,861,944,1571,18,146,70,0,0,0,285,1520,ITF,ITF6,18,Calabria,Calabria,1947131,184666,9.48,0.09
413,2021-01-20,CAL,1395,622,773,864,6,346,179,0,0,0,1394,1,ITF,ITF6,18,Calabria,Calabria,1947131,186061,9.56,0.07
414,2021-03-11,CAL,6875,3276,3599,934,25,2038,570,2379,329,600,5619,1256,ITF,ITF6,18,Calabria,Calabria,1947131,192936,9.91,0.35
415,2021-02-22,CAL,1996,1013,983,727,48,495,166,552,3,5,1441,555,ITF,ITF6,18,Calabria,Calabria,1947131,194932,10.01,0.1
416,2021-03-22,CAL,4707,2202,2505,194,10,1197,147,1994,40,1125,3041,1666,ITF,ITF6,18,Calabria,Calabria,1947131,199639,10.25,0.24
417,2021-02-20,CAL,1358,735,623,438,23,388,55,433,19,2,1043,315,ITF,ITF6,18,Calabria,Calabria,1947131,200997,10.32,0.07
418,2021-02-01,CAL,2497,1192,1305,2044,4,406,43,0,0,0,248,2249,ITF,ITF6,18,Calabria,Calabria,1947131,203494,10.45,0.13
419,2021-01-15,CAL,2793,1258,1535,1690,35,656,412,0,0,0,2793,0,ITF,ITF6,18,Calabria,Calabria,1947131,206287,10.59,0.14
420,2021-01-07,CAL,2180,1061,1119,1883,0,297,0,0,0,0,2180,0,ITF,ITF6,18,Calabria,Calabria,1947131,208467,10.71,0.11
421,2021-02-23,CAL,1549,728,821,437,33,348,206,522,2,1,1434,115,ITF,ITF6,18,Calabria,Calabria,1947131,210016,10.79,0.08
422,2021-01-27,CAL,1457,734,723,1226,2,206,23,0,0,0,396,1061,ITF,ITF6,18,Calabria,Calabria,1947131,211473,10.86,0.07
423,2021-02-26,CAL,3079,1631,1448,539,57,631,407,1147,294,4,2611,468,ITF,ITF6,18,Calabria,Calabria,1947131,214552,11.02,0.16
424,2021-03-07,CAL,3131,1561,1570,105,0,655,348,1674,347,2,3042,89,ITF,ITF6,18,Calabria,Calabria,1947131,217683,11.18,0.16
425,2020-12-28,CAL,6,2,4,6,0,0,0,0,0,0,6,0,ITF,ITF6,18,Calabria,Calabria,1947131,217689,11.18,0.0
426,2021-03-10,CAL,6441,3278,3163,742,42,2309,586,2021,677,64,5250,1191,ITF,ITF6,18,Calabria,Calabria,1947131,224130,11.51,0.33
427,2021-01-11,CAL,2154,1040,1114,1759,0,392,3,0,0,0,2154,0,ITF,ITF6,18,Calabria,Calabria,1947131,226284,11.62,0.11
428,2021-02-09,PIE,7350,2309,5041,4154,1323,43,1830,0,0,0,722,6628,ITC,ITC1,1,Piemonte,Piemonte,4356406,7350,0.17,0.17
429,2021-01-27,PIE,4196,1453,2743,2983,541,115,557,0,0,0,999,3197,ITC,ITC1,1,Piemonte,Piemonte,4356406,11546,0.27,0.1
430,2021-02-16,PIE,3962,1752,2210,1819,778,816,548,0,0,1,3204,758,ITC,ITC1,1,Piemonte,Piemonte,4356406,15508,0.36,0.09
431,2021-02-14,PIE,1475,498,977,796,331,49,285,0,0,14,875,600,ITC,ITC1,1,Piemonte,Piemonte,4356406,16983,0.39,0.03
432,2021-01-09,PIE,6183,2185,3998,4488,1094,33,568,0,0,0,6183,0,ITC,ITC1,1,Piemonte,Piemonte,4356406,23166,0.53,0.14
433,2021-02-24,PIE,11384,4618,6766,1843,586,728,407,5661,0,2159,10873,511,ITC,ITC1,1,Piemonte,Piemonte,4356406,34550,0.79,0.26
434,2021-02-27,PIE,12660,4840,7820,882,464,517,232,7529,0,3036,12312,348,ITC,ITC1,1,Piemonte,Piemonte,4356406,47210,1.08,0.29
435,2021-03-20,PIE,11577,4770,6807,878,449,753,163,7403,0,1931,5683,5894,ITC,ITC1,1,Piemonte,Piemonte,4356406,58787,1.35,0.27
436,2021-03-09,PIE,13524,5263,8261,1679,850,718,354,7615,0,2308,11184,2340,ITC,ITC1,1,Piemonte,Piemonte,4356406,72311,1.66,0.31
437,2021-02-18,PIE,4781,2089,2692,2251,868,1036,624,0,0,2,4351,430,ITC,ITC1,1,Piemonte,Piemonte,4356406,77092,1.77,0.11
438,2020-12-30,PIE,730,322,408,685,45,0,0,0,0,0,730,0,ITC,ITC1,1,Piemonte,Piemonte,4356406,77822,1.79,0.02
439,2021-03-19,PIE,10576,4331,6245,1085,453,444,416,7908,0,270,4149,6427,ITC,ITC1,1,Piemonte,Piemonte,4356406,88398,2.03,0.24
440,2021-01-20,PIE,6538,2067,4471,3573,1140,13,1812,0,0,0,5813,725,ITC,ITC1,1,Piemonte,Piemonte,4356406,94936,2.18,0.15
441,2021-03-11,PIE,13538,4971,8567,2308,809,635,381,7314,0,2091,10446,3092,ITC,ITC1,1,Piemonte,Piemonte,4356406,108474,2.49,0.31
442,2021-01-06,PIE,3114,1110,2004,2368,319,114,313,0,0,0,3114,0,ITC,ITC1,1,Piemonte,Piemonte,4356406,111588,2.56,0.07
443,2021-02-15,PIE,4427,1594,2833,2319,841,303,962,1,0,1,3222,1205,ITC,ITC1,1,Piemonte,Piemonte,4356406,116015,2.66,0.1
444,2021-01-07,PIE,5385,1739,3646,4158,837,49,341,0,0,0,5385,0,ITC,ITC1,1,Piemonte,Piemonte,4356406,121400,2.79,0.12
445,2021-01-13,PIE,10078,3222,6856,6484,2039,226,1329,0,0,0,10078,0,ITC,ITC1,1,Piemonte,Piemonte,4356406,131478,3.02,0.23
446,2021-02-17,PIE,4730,2124,2606,2188,954,1089,497,1,0,1,3741,989,ITC,ITC1,1,Piemonte,Piemonte,4356406,136208,3.13,0.11
447,2021-01-29,PIE,5940,1886,4054,4198,1018,51,673,0,0,0,455,5485,ITC,ITC1,1,Piemonte,Piemonte,4356406,142148,3.26,0.14
448,2021-03-08,PIE,13793,5248,8545,2040,892,538,412,7394,0,2517,11082,2711,ITC,ITC1,1,Piemonte,Piemonte,4356406,155941,3.58,0.32
449,2021-02-22,PIE,8461,3462,4999,1702,800,639,511,3889,0,920,7872,589,ITC,ITC1,1,Piemonte,Piemonte,4356406,164402,3.77,0.19
450,2021-01-08,PIE,5529,1761,3768,4078,971,58,422,0,0,0,5529,0,ITC,ITC1,1,Piemonte,Piemonte,4356406,169931,3.9,0.13
451,2020-12-31,PIE,3907,1332,2575,3413,354,6,134,0,0,0,3907,0,ITC,ITC1,1,Piemonte,Piemonte,4356406,173838,3.99,0.09
452,2021-02-07,PIE,3087,974,2113,1648,643,19,777,0,0,0,445,2642,ITC,ITC1,1,Piemonte,Piemonte,4356406,176925,4.06,0.07
453,2021-03-07,PIE,11953,4650,7303,1321,726,419,111,7327,0,2049,11073,880,ITC,ITC1,1,Piemonte,Piemonte,4356406,188878,4.34,0.27
454,2021-01-14,PIE,9761,3150,6611,6175,2006,96,1484,0,0,0,9761,0,ITC,ITC1,1,Piemonte,Piemonte,4356406,198639,4.56,0.22
455,2021-01-23,PIE,4254,1325,2929,3206,453,75,520,0,0,0,878,3376,ITC,ITC1,1,Piemonte,Piemonte,4356406,202893,4.66,0.1
456,2021-03-25,PIE,15696,6601,9095,950,481,1024,417,11445,178,1201,7135,8561,ITC,ITC1,1,Piemonte,Piemonte,4356406,218589,5.02,0.36
457,2021-02-11,PIE,6761,2106,4655,3421,1136,191,2010,0,0,3,3004,3757,ITC,ITC1,1,Piemonte,Piemonte,4356406,225350,5.17,0.16
458,2021-01-05,PIE,5377,1602,3775,4364,683,45,285,0,0,0,5377,0,ITC,ITC1,1,Piemonte,Piemonte,4356406,230727,5.3,0.12
459,2020-12-28,PIE,1,1,0,1,0,0,0,0,0,0,1,0,ITC,ITC1,1,Piemonte,Piemonte,4356406,230728,5.3,0.0
460,2021-01-30,PIE,5978,2135,3843,4367,1049,67,495,0,0,0,218,5760,ITC,ITC1,1,Piemonte,Piemonte,4356406,236706,5.43,0.14
461,2021-02-06,PIE,7982,2664,5318,5100,1528,104,1250,0,0,0,400,7582,ITC,ITC1,1,Piemonte,Piemonte,4356406,244688,5.62,0.18
462,2021-02-01,PIE,8641,3053,5588,6170,1324,79,1068,0,0,0,578,8063,ITC,ITC1,1,Piemonte,Piemonte,4356406,253329,5.82,0.2
463,2021-02-19,PIE,5526,2171,3355,1987,788,977,666,30,0,1078,5024,502,ITC,ITC1,1,Piemonte,Piemonte,4356406,258855,5.94,0.13
464,2021-02-05,PIE,9450,3077,6373,5766,1959,82,1643,0,0,0,657,8793,ITC,ITC1,1,Piemonte,Piemonte,4356406,268305,6.16,0.22
465,2021-01-17,PIE,3517,1168,2349,2082,588,7,840,0,0,0,2870,647,ITC,ITC1,1,Piemonte,Piemonte,4356406,271822,6.24,0.08
466,2021-01-26,PIE,6328,1878,4450,4725,831,44,728,0,0,0,735,5593,ITC,ITC1,1,Piemonte,Piemonte,4356406,278150,6.38,0.15
467,2021-02-28,PIE,10803,4054,6749,642,344,167,53,6812,0,2785,10563,240,ITC,ITC1,1,Piemonte,Piemonte,4356406,288953,6.63,0.25
468,2021-02-08,PIE,6914,2355,4559,3784,1480,78,1572,0,0,0,666,6248,ITC,ITC1,1,Piemonte,Piemonte,4356406,295867,6.79,0.16
469,2021-01-15,PIE,8962,2951,6011,5495,1860,64,1543,0,0,0,8962,0,ITC,ITC1,1,Piemonte,Piemonte,4356406,304829,7.0,0.21
470,2021-02-25,PIE,12199,5244,6955,1439,592,1484,405,6320,1,1958,11651,548,ITC,ITC1,1,Piemonte,Piemonte,4356406,317028,7.28,0.28
471,2021-01-28,PIE,5588,1809,3779,4118,829,50,590,1,0,0,384,5204,ITC,ITC1,1,Piemonte,Piemonte,4356406,322616,7.41,0.13
472,2021-01-11,PIE,8740,2980,5760,6053,1484,77,1126,0,0,0,8740,0,ITC,ITC1,1,Piemonte,Piemonte,4356406,331356,7.61,0.2
473,2021-02-02,PIE,10232,3504,6728,6867,1979,69,1317,0,0,0,814,9418,ITC,ITC1,1,Piemonte,Piemonte,4356406,341588,7.84,0.23
474,2021-01-19,PIE,6421,2099,4322,3574,1238,61,1548,0,0,0,6412,9,ITC,ITC1,1,Piemonte,Piemonte,4356406,348009,7.99,0.15
475,2021-02-13,PIE,4150,1334,2816,2309,654,68,1113,1,0,5,2928,1222,ITC,ITC1,1,Piemonte,Piemonte,4356406,352159,8.08,0.1
476,2021-01-18,PIE,6162,2047,4115,3236,1322,82,1522,0,0,0,5914,248,ITC,ITC1,1,Piemonte,Piemonte,4356406,358321,8.23,0.14
477,2021-02-20,PIE,3828,1251,2577,1100,394,669,219,30,0,1416,3654,174,ITC,ITC1,1,Piemonte,Piemonte,4356406,362149,8.31,0.09
478,2021-02-10,PIE,7445,2346,5099,3850,1461,37,2097,0,0,0,1316,6129,ITC,ITC1,1,Piemonte,Piemonte,4356406,369594,8.48,0.17
479,2021-03-14,PIE,8181,3322,4859,794,233,384,2,5795,0,973,5286,2895,ITC,ITC1,1,Piemonte,Piemonte,4356406,377775,8.67,0.19
480,2021-03-17,PIE,12256,4971,7285,2075,717,342,235,8878,0,9,4970,7286,ITC,ITC1,1,Piemonte,Piemonte,4356406,390031,8.95,0.28
481,2021-03-13,PIE,12773,4619,8154,1168,503,510,157,8300,0,2135,11333,1440,ITC,ITC1,1,Piemonte,Piemonte,4356406,402804,9.25,0.29
482,2021-03-02,PIE,11132,4476,6656,901,316,816,214,6384,0,2501,10315,817,ITC,ITC1,1,Piemonte,Piemonte,4356406,413936,9.5,0.26
483,2021-03-16,PIE,10273,4153,6120,2227,798,296,320,6619,0,13,4219,6054,ITC,ITC1,1,Piemonte,Piemonte,4356406,424209,9.74,0.24
484,2021-03-06,PIE,13966,5203,8763,2261,771,357,456,7428,0,2693,11183,2783,ITC,ITC1,1,Piemonte,Piemonte,4356406,438175,10.06,0.32
485,2021-01-04,PIE,5562,1678,3884,4590,716,21,235,0,0,0,5562,0,ITC,ITC1,1,Piemonte,Piemonte,4356406,443737,10.19,0.13
486,2021-01-03,PIE,3061,966,2095,2714,268,27,52,0,0,0,3061,0,ITC,ITC1,1,Piemonte,Piemonte,4356406,446798,10.26,0.07
487,2021-01-16,PIE,7754,2630,5124,4795,1515,80,1364,0,0,0,7754,0,ITC,ITC1,1,Piemonte,Piemonte,4356406,454552,10.43,0.18
488,2021-02-04,PIE,10196,3337,6859,6234,2129,70,1763,0,0,0,588,9608,ITC,ITC1,1,Piemonte,Piemonte,4356406,464748,10.67,0.23
489,2021-01-31,PIE,4105,1748,2357,3076,636,18,375,0,0,0,112,3993,ITC,ITC1,1,Piemonte,Piemonte,4356406,468853,10.76,0.09
490,2021-03-05,PIE,15249,5952,9297,2538,1098,925,654,7663,0,2371,11432,3817,ITC,ITC1,1,Piemonte,Piemonte,4356406,484102,11.11,0.35
491,2021-03-18,PIE,11468,4706,6762,1459,677,329,342,8643,0,18,3760,7708,ITC,ITC1,1,Piemonte,Piemonte,4356406,495570,11.38,0.26
492,2021-01-21,PIE,6876,2314,4562,4705,825,30,1316,0,0,0,3381,3495,ITC,ITC1,1,Piemonte,Piemonte,4356406,502446,11.53,0.16
493,2020-12-27,PIE,912,368,544,760,65,11,76,0,0,0,912,0,ITC,ITC1,1,Piemonte,Piemonte,4356406,503358,11.55,0.02
494,2021-01-22,PIE,3864,1248,2616,2280,609,41,934,0,0,0,2523,1341,ITC,ITC1,1,Piemonte,Piemonte,4356406,507222,11.64,0.09
495,2021-01-12,PIE,10040,3401,6639,6859,1917,92,1172,0,0,0,10040,0,ITC,ITC1,1,Piemonte,Piemonte,4356406,517262,11.87,0.23
496,2021-01-10,PIE,5207,2273,2934,3904,765,19,519,0,0,0,5207,0,ITC,ITC1,1,Piemonte,Piemonte,4356406,522469,11.99,0.12
497,2021-03-21,PIE,10342,4527,5815,575,383,1237,9,6823,0,1315,3820,6522,ITC,ITC1,1,Piemonte,Piemonte,4356406,532811,12.23,0.24
498,2021-02-23,PIE,9226,3708,5518,2294,821,570,389,4100,0,1052,8645,581,ITC,ITC1,1,Piemonte,Piemonte,4356406,542037,12.44,0.21
499,2021-02-26,PIE,12234,4909,7325,811,376,1070,487,6593,1,2896,11497,737,ITC,ITC1,1,Piemonte,Piemonte,4356406,554271,12.72,0.28
500,2021-01-25,PIE,6209,1938,4271,4782,839,26,562,0,0,0,982,5227,ITC,ITC1,1,Piemonte,Piemonte,4356406,560480,12.87,0.14
501,2021-03-15,PIE,10595,4138,6457,1715,923,579,229,5689,0,1460,4981,5614,ITC,ITC1,1,Piemonte,Piemonte,4356406,571075,13.11,0.24
502,2021-03-22,PIE,10664,4406,6258,871,457,542,181,7400,0,1213,3442,7222,ITC,ITC1,1,Piemonte,Piemonte,4356406,581739,13.35,0.24
503,2021-03-04,PIE,14425,5716,8709,2169,870,1093,581,7523,0,2189,11517,2908,ITC,ITC1,1,Piemonte,Piemonte,4356406,596164,13.68,0.33
504,2021-03-24,PIE,14495,5968,8527,1018,495,884,362,10991,37,708,5420,9075,ITC,ITC1,1,Piemonte,Piemonte,4356406,610659,14.02,0.33
505,2021-03-23,PIE,12355,5092,7263,673,325,943,188,8971,0,1255,6122,6233,ITC,ITC1,1,Piemonte,Piemonte,4356406,623014,14.3,0.28
506,2021-01-24,PIE,3150,957,2193,2632,344,28,146,0,0,0,434,2716,ITC,ITC1,1,Piemonte,Piemonte,4356406,626164,14.37,0.07
507,2021-01-02,PIE,3540,1134,2406,3073,336,78,53,0,0,0,3540,0,ITC,ITC1,1,Piemonte,Piemonte,4356406,629704,14.45,0.08
508,2021-03-03,PIE,12059,4621,7438,1102,434,594,257,7020,0,2652,11236,823,ITC,ITC1,1,Piemonte,Piemonte,4356406,641763,14.73,0.28
509,2021-01-01,PIE,1038,395,643,922,116,0,0,0,0,0,1038,0,ITC,ITC1,1,Piemonte,Piemonte,4356406,642801,14.76,0.02
510,2021-03-12,PIE,13722,5074,8648,2131,854,477,454,7551,0,2255,10813,2909,ITC,ITC1,1,Piemonte,Piemonte,4356406,656523,15.07,0.31
511,2021-03-10,PIE,13373,5060,8313,1662,732,642,279,7918,0,2140,11079,2294,ITC,ITC1,1,Piemonte,Piemonte,4356406,669896,15.38,0.31
512,2021-03-01,PIE,11703,4685,7018,1142,538,743,281,6596,0,2403,10891,812,ITC,ITC1,1,Piemonte,Piemonte,4356406,681599,15.65,0.27
513,2021-02-21,PIE,5086,2080,3006,686,189,75,47,3352,0,737,4983,103,ITC,ITC1,1,Piemonte,Piemonte,4356406,686685,15.76,0.12
514,2021-02-03,PIE,10185,3301,6884,6641,2041,268,1235,0,0,0,611,9574,ITC,ITC1,1,Piemonte,Piemonte,4356406,696870,16.0,0.23
515,2021-02-12,PIE,6881,2212,4669,3525,1509,138,1707,0,0,2,3924,2957,ITC,ITC1,1,Piemonte,Piemonte,4356406,703751,16.15,0.16
516,2021-01-14,PAB,1810,541,1269,477,427,335,285,286,0,0,1810,0,ITH,ITH1,4,Provincia Autonoma Bolzano / Bozen,P.A. Bolzano,533050,1810,0.34,0.34
517,2021-03-19,PAB,1896,768,1128,159,52,560,15,1096,0,14,793,1103,ITH,ITH1,4,Provincia Autonoma Bolzano / Bozen,P.A. Bolzano,533050,3706,0.7,0.36
518,2021-03-15,PAB,839,293,546,285,94,385,13,56,2,4,365,474,ITH,ITH1,4,Provincia Autonoma Bolzano / Bozen,P.A. Bolzano,533050,4545,0.85,0.16
519,2021-02-02,PAB,1731,500,1231,617,370,130,605,9,0,0,8,1723,ITH,ITH1,4,Provincia Autonoma Bolzano / Bozen,P.A. Bolzano,533050,6276,1.18,0.32
520,2021-02-08,PAB,1,1,0,0,0,1,0,0,0,0,1,0,ITH,ITH1,4,Provincia Autonoma Bolzano / Bozen,P.A. Bolzano,533050,6277,1.18,0.0
521,2021-03-01,PAB,909,217,692,11,2,157,5,0,0,734,909,0,ITH,ITH1,4,Provincia Autonoma Bolzano / Bozen,P.A. Bolzano,533050,7186,1.35,0.17
522,2021-02-16,PAB,529,205,324,10,1,6,0,512,0,0,529,0,ITH,ITH1,4,Provincia Autonoma Bolzano / Bozen,P.A. Bolzano,533050,7715,1.45,0.1
523,2021-01-23,PAB,195,115,80,183,0,12,0,0,0,0,0,195,ITH,ITH1,4,Provincia Autonoma Bolzano / Bozen,P.A. Bolzano,533050,7910,1.48,0.04
524,2021-02-27,PAB,2454,758,1696,202,86,42,8,881,3,1232,2447,7,ITH,ITH1,4,Provincia Autonoma Bolzano / Bozen,P.A. Bolzano,533050,10364,1.94,0.46
525,2021-01-25,PAB,462,177,285,380,68,12,0,1,0,1,3,459,ITH,ITH1,4,Provincia Autonoma Bolzano / Bozen,P.A. Bolzano,533050,10826,2.03,0.09
526,2021-01-17,PAB,2270,1025,1245,54,28,208,19,1961,0,0,2259,11,ITH,ITH1,4,Provincia Autonoma Bolzano / Bozen,P.A. Bolzano,533050,13096,2.46,0.43
527,2021-02-04,PAB,1878,569,1309,624,497,124,419,214,0,0,8,1870,ITH,ITH1,4,Provincia Autonoma Bolzano / Bozen,P.A. Bolzano,533050,14974,2.81,0.35
528,2021-03-05,PAB,1756,590,1166,337,92,291,28,760,9,239,1314,442,ITH,ITH1,4,Provincia Autonoma Bolzano / Bozen,P.A. Bolzano,533050,16730,3.14,0.33
529,2021-01-15,PAB,3069,1141,1928,592,303,574,339,1261,0,0,3069,0,ITH,ITH1,4,Provincia Autonoma Bolzano / Bozen,P.A. Bolzano,533050,19799,3.71,0.58
530,2021-01-09,PAB,600,317,283,75,28,411,74,12,0,0,600,0,ITH,ITH1,4,Provincia Autonoma Bolzano / Bozen,P.A. Bolzano,533050,20399,3.83,0.11
531,2021-01-11,PAB,1501,476,1025,537,268,372,174,150,0,0,1501,0,ITH,ITH1,4,Provincia Autonoma Bolzano / Bozen,P.A. Bolzano,533050,21900,4.11,0.28
532,2020-12-30,PAB,384,181,203,340,40,4,0,0,0,0,384,0,ITH,ITH1,4,Provincia Autonoma Bolzano / Bozen,P.A. Bolzano,533050,22284,4.18,0.07
533,2021-01-06,PAB,59,18,41,59,0,0,0,0,0,0,59,0,ITH,ITH1,4,Provincia Autonoma Bolzano / Bozen,P.A. Bolzano,533050,22343,4.19,0.01
534,2021-02-07,PAB,2165,975,1190,99,25,373,1,1667,0,0,12,2153,ITH,ITH1,4,Provincia Autonoma Bolzano / Bozen,P.A. Bolzano,533050,24508,4.6,0.41
535,2021-01-21,PAB,915,426,489,720,88,12,68,27,0,0,138,777,ITH,ITH1,4,Provincia Autonoma Bolzano / Bozen,P.A. Bolzano,533050,25423,4.77,0.17
536,2021-01-28,PAB,867,307,560,584,185,29,69,0,0,0,10,857,ITH,ITH1,4,Provincia Autonoma Bolzano / Bozen,P.A. Bolzano,533050,26290,4.93,0.16
537,2021-03-17,PAB,570,212,358,7,6,34,42,481,0,0,569,1,ITH,ITH1,4,Provincia Autonoma Bolzano / Bozen,P.A. Bolzano,533050,26860,5.04,0.11
538,2021-03-04,PAB,1681,994,687,292,72,527,37,40,452,261,1469,212,ITH,ITH1,4,Provincia Autonoma Bolzano / Bozen,P.A. Bolzano,533050,28541,5.35,0.32
539,2021-02-13,PAB,318,79,239,126,57,127,7,1,0,0,312,6,ITH,ITH1,4,Provincia Autonoma Bolzano / Bozen,P.A. Bolzano,533050,28859,5.41,0.06
540,2021-01-13,PAB,1317,409,908,368,284,304,255,106,0,0,1317,0,ITH,ITH1,4,Provincia Autonoma Bolzano / Bozen,P.A. Bolzano,533050,30176,5.66,0.25
541,2021-01-02,PAB,91,48,43,69,1,21,0,0,0,0,91,0,ITH,ITH1,4,Provincia Autonoma Bolzano / Bozen,P.A. Bolzano,533050,30267,5.68,0.02
542,2021-01-12,PAB,1527,398,1129,299,204,476,475,73,0,0,1527,0,ITH,ITH1,4,Provincia Autonoma Bolzano / Bozen,P.A. Bolzano,533050,31794,5.96,0.29
543,2021-01-04,PAB,469,191,278,397,41,31,0,0,0,0,469,0,ITH,ITH1,4,Provincia Autonoma Bolzano / Bozen,P.A. Bolzano,533050,32263,6.05,0.09
544,2021-02-20,PAB,1502,471,1031,196,53,30,24,469,1,729,1484,18,ITH,ITH1,4,Provincia Autonoma Bolzano / Bozen,P.A. Bolzano,533050,33765,6.33,0.28
545,2021-03-11,PAB,1644,806,838,89,79,473,68,365,237,333,1129,515,ITH,ITH1,4,Provincia Autonoma Bolzano / Bozen,P.A. Bolzano,533050,35409,6.64,0.31
546,2021-03-25,PAB,2081,1026,1055,207,68,1386,20,298,56,46,1676,405,ITH,ITH1,4,Provincia Autonoma Bolzano / Bozen,P.A. Bolzano,533050,37490,7.03,0.39
547,2021-01-05,PAB,821,283,538,728,58,35,0,0,0,0,821,0,ITH,ITH1,4,Provincia Autonoma Bolzano / Bozen,P.A. Bolzano,533050,38311,7.19,0.15
548,2021-03-23,PAB,1542,751,791,0,0,1238,0,213,57,34,1542,0,ITH,ITH1,4,Provincia Autonoma Bolzano / Bozen,P.A. Bolzano,533050,39853,7.48,0.29
549,2021-03-24,PAB,1956,926,1030,12,11,1596,5,246,57,29,1945,11,ITH,ITH1,4,Provincia Autonoma Bolzano / Bozen,P.A. Bolzano,533050,41809,7.84,0.37
550,2021-02-22,PAB,521,142,379,339,66,102,0,4,0,10,510,11,ITH,ITH1,4,Provincia Autonoma Bolzano / Bozen,P.A. Bolzano,533050,42330,7.94,0.1
551,2021-03-20,PAB,1749,843,906,113,47,618,9,956,5,1,1126,623,ITH,ITH1,4,Provincia Autonoma Bolzano / Bozen,P.A. Bolzano,533050,44079,8.27,0.33
552,2021-01-18,PAB,1655,638,1017,368,102,197,7,981,0,0,1651,4,ITH,ITH1,4,Provincia Autonoma Bolzano / Bozen,P.A. Bolzano,533050,45734,8.58,0.31
553,2021-02-03,PAB,1445,457,988,615,335,106,321,68,0,0,5,1440,ITH,ITH1,4,Provincia Autonoma Bolzano / Bozen,P.A. Bolzano,533050,47179,8.85,0.27
554,2021-01-07,PAB,892,317,575,613,103,124,0,52,0,0,892,0,ITH,ITH1,4,Provincia Autonoma Bolzano / Bozen,P.A. Bolzano,533050,48071,9.02,0.17
555,2021-02-01,PAB,1385,404,981,709,312,67,296,0,0,1,11,1374,ITH,ITH1,4,Provincia Autonoma Bolzano / Bozen,P.A. Bolzano,533050,49456,9.28,0.26
556,2021-03-02,PAB,681,193,488,1,0,0,0,0,7,673,681,0,ITH,ITH1,4,Provincia Autonoma Bolzano / Bozen,P.A. Bolzano,533050,50137,9.41,0.13
557,2021-03-08,PAB,1187,517,670,23,10,275,164,712,0,3,1162,25,ITH,ITH1,4,Provincia Autonoma Bolzano / Bozen,P.A. Bolzano,533050,51324,9.63,0.22
558,2021-02-12,PAB,721,214,507,316,69,223,104,7,2,0,475,246,ITH,ITH1,4,Provincia Autonoma Bolzano / Bozen,P.A. Bolzano,533050,52045,9.76,0.14
559,2021-03-09,PAB,1185,540,645,29,6,95,21,915,72,47,1183,2,ITH,ITH1,4,Provincia Autonoma Bolzano / Bozen,P.A. Bolzano,533050,53230,9.99,0.22
560,2021-01-27,PAB,84,28,56,54,26,4,0,0,0,0,1,83,ITH,ITH1,4,Provincia Autonoma Bolzano / Bozen,P.A. Bolzano,533050,53314,10.0,0.02
561,2021-02-24,PAB,1361,403,958,10,3,0,0,0,8,1340,1349,12,ITH,ITH1,4,Provincia Autonoma Bolzano / Bozen,P.A. Bolzano,533050,54675,10.26,0.26
562,2021-02-05,PAB,2826,1057,1769,647,313,393,396,1077,0,0,6,2820,ITH,ITH1,4,Provincia Autonoma Bolzano / Bozen,P.A. Bolzano,533050,57501,10.79,0.53
563,2021-02-06,PAB,2300,1025,1275,447,43,332,6,1471,0,1,18,2282,ITH,ITH1,4,Provincia Autonoma Bolzano / Bozen,P.A. Bolzano,533050,59801,11.22,0.43
564,2021-02-26,PAB,1386,492,894,62,32,111,2,846,0,333,1356,30,ITH,ITH1,4,Provincia Autonoma Bolzano / Bozen,P.A. Bolzano,533050,61187,11.48,0.26
565,2021-03-06,PAB,3946,2069,1877,478,160,711,7,1953,256,381,3734,212,ITH,ITH1,4,Provincia Autonoma Bolzano / Bozen,P.A. Bolzano,533050,65133,12.22,0.74
566,2021-01-22,PAB,242,138,104,130,8,15,85,3,0,1,124,118,ITH,ITH1,4,Provincia Autonoma Bolzano / Bozen,P.A. Bolzano,533050,65375,12.26,0.05
567,2021-01-30,PAB,496,244,252,216,44,135,101,0,0,0,4,492,ITH,ITH1,4,Provincia Autonoma Bolzano / Bozen,P.A. Bolzano,533050,65871,12.36,0.09
568,2021-01-20,PAB,609,248,361,287,50,22,0,250,0,0,401,208,ITH,ITH1,4,Provincia Autonoma Bolzano / Bozen,P.A. Bolzano,533050,66480,12.47,0.11
569,2021-01-10,PAB,2,2,0,1,0,1,0,0,0,0,2,0,ITH,ITH1,4,Provincia Autonoma Bolzano / Bozen,P.A. Bolzano,533050,66482,12.47,0.0
570,2021-02-25,PAB,1495,548,947,22,5,335,0,728,0,405,1494,1,ITH,ITH1,4,Provincia Autonoma Bolzano / Bozen,P.A. Bolzano,533050,67977,12.75,0.28
571,2021-03-03,PAB,1162,391,771,12,5,8,6,345,51,735,1149,13,ITH,ITH1,4,Provincia Autonoma Bolzano / Bozen,P.A. Bolzano,533050,69139,12.97,0.22
572,2021-01-26,PAB,809,291,518,681,119,9,0,0,0,0,1,808,ITH,ITH1,4,Provincia Autonoma Bolzano / Bozen,P.A. Bolzano,533050,69948,13.12,0.15
573,2021-01-03,PAB,41,16,25,33,5,2,0,1,0,0,41,0,ITH,ITH1,4,Provincia Autonoma Bolzano / Bozen,P.A. Bolzano,533050,69989,13.13,0.01
574,2021-03-16,PAB,632,249,383,24,29,34,48,497,0,0,115,517,ITH,ITH1,4,Provincia Autonoma Bolzano / Bozen,P.A. Bolzano,533050,70621,13.25,0.12
575,2021-01-24,PAB,12,10,2,1,0,11,0,0,0,0,0,12,ITH,ITH1,4,Provincia Autonoma Bolzano / Bozen,P.A. Bolzano,533050,70633,13.25,0.0
576,2021-03-14,PAB,754,336,418,130,11,26,33,553,1,0,25,729,ITH,ITH1,4,Provincia Autonoma Bolzano / Bozen,P.A. Bolzano,533050,71387,13.39,0.14
577,2021-02-17,PAB,4,1,3,1,0,2,0,1,0,0,2,2,ITH,ITH1,4,Provincia Autonoma Bolzano / Bozen,P.A. Bolzano,533050,71391,13.39,0.0
578,2021-02-18,PAB,1641,401,1240,23,44,269,20,4,0,1281,1638,3,ITH,ITH1,4,Provincia Autonoma Bolzano / Bozen,P.A. Bolzano,533050,73032,13.7,0.31
579,2021-02-23,PAB,763,320,443,0,0,58,0,621,0,84,758,5,ITH,ITH1,4,Provincia Autonoma Bolzano / Bozen,P.A. Bolzano,533050,73795,13.84,0.14
580,2021-01-29,PAB,1488,508,980,874,282,31,295,2,0,4,23,1465,ITH,ITH1,4,Provincia Autonoma Bolzano / Bozen,P.A. Bolzano,533050,75283,14.12,0.28
581,2021-03-18,PAB,1289,524,765,49,15,154,48,1023,0,0,215,1074,ITH,ITH1,4,Provincia Autonoma Bolzano / Bozen,P.A. Bolzano,533050,76572,14.36,0.24
582,2021-02-11,PAB,1031,408,623,205,47,334,102,343,0,0,222,809,ITH,ITH1,4,Provincia Autonoma Bolzano / Bozen,P.A. Bolzano,533050,77603,14.56,0.19
583,2021-02-10,PAB,1630,602,1028,489,164,394,1,582,0,0,26,1604,ITH,ITH1,4,Provincia Autonoma Bolzano / Bozen,P.A. Bolzano,533050,79233,14.86,0.31
584,2021-03-12,PAB,868,400,468,65,72,286,41,298,57,49,718,150,ITH,ITH1,4,Provincia Autonoma Bolzano / Bozen,P.A. Bolzano,533050,80101,15.03,0.16
585,2021-01-08,PAB,1488,469,1019,777,167,282,166,96,0,0,1488,0,ITH,ITH1,4,Provincia Autonoma Bolzano / Bozen,P.A. Bolzano,533050,81589,15.31,0.28
586,2020-12-31,PAB,847,485,362,424,58,365,0,0,0,0,847,0,ITH,ITH1,4,Provincia Autonoma Bolzano / Bozen,P.A. Bolzano,533050,82436,15.46,0.16
587,2021-02-19,PAB,1962,449,1513,121,139,111,79,7,0,1505,1951,11,ITH,ITH1,4,Provincia Autonoma Bolzano / Bozen,P.A. Bolzano,533050,84398,15.83,0.37
588,2021-01-01,PAB,1,1,0,1,0,0,0,0,0,0,1,0,ITH,ITH1,4,Provincia Autonoma Bolzano / Bozen,P.A. Bolzano,533050,84399,15.83,0.0
589,2021-02-15,PAB,72,42,30,17,2,8,40,5,0,0,26,46,ITH,ITH1,4,Provincia Autonoma Bolzano / Bozen,P.A. Bolzano,533050,84471,15.85,0.01
590,2021-01-16,PAB,2749,1229,1520,450,57,303,77,1861,0,1,2749,0,ITH,ITH1,4,Provincia Autonoma Bolzano / Bozen,P.A. Bolzano,533050,87220,16.36,0.52
591,2021-03-22,PAB,1123,511,612,1,0,921,0,191,10,0,1123,0,ITH,ITH1,4,Provincia Autonoma Bolzano / Bozen,P.A. Bolzano,533050,88343,16.57,0.21
592,2021-02-09,PAB,317,126,191,64,16,6,2,227,0,2,1,316,ITH,ITH1,4,Provincia Autonoma Bolzano / Bozen,P.A. Bolzano,533050,88660,16.63,0.06
593,2021-03-10,PAB,1172,446,726,653,7,181,0,134,80,117,1029,143,ITH,ITH1,4,Provincia Autonoma Bolzano / Bozen,P.A. Bolzano,533050,89832,16.85,0.22
594,2020-12-27,PAB,143,65,78,136,2,4,0,1,0,0,143,0,ITH,ITH1,4,Provincia Autonoma Bolzano / Bozen,P.A. Bolzano,533050,89975,16.88,0.03
595,2021-03-13,PAB,2859,1448,1411,165,52,1261,1,1272,89,19,2758,101,ITH,ITH1,4,Provincia Autonoma Bolzano / Bozen,P.A. Bolzano,533050,92834,17.42,0.54
596,2021-01-19,PAB,811,349,462,170,19,47,0,575,0,0,681,130,ITH,ITH1,4,Provincia Autonoma Bolzano / Bozen,P.A. Bolzano,533050,93645,17.57,0.15
597,2021-03-07,PAB,114,13,101,59,28,23,0,3,0,1,9,105,ITH,ITH1,4,Provincia Autonoma Bolzano / Bozen,P.A. Bolzano,533050,93759,17.59,0.02
598,2021-03-21,PAB,763,280,483,165,17,16,1,561,0,3,14,749,ITH,ITH1,4,Provincia Autonoma Bolzano / Bozen,P.A. Bolzano,533050,94522,17.73,0.14
599,2021-03-18,VDA,134,43,91,4,0,3,25,101,1,0,98,36,ITC,ITC2,2,Valle d'Aosta / Vallée d'Aoste,Valle d'Aosta,125666,134,0.11,0.11
600,2021-01-15,VDA,218,82,136,116,32,36,28,6,0,0,218,0,ITC,ITC2,2,Valle d'Aosta / Vallée d'Aoste,Valle d'Aosta,125666,352,0.28,0.17
601,2021-03-11,VDA,192,72,120,2,0,14,7,166,1,2,64,128,ITC,ITC2,2,Valle d'Aosta / Vallée d'Aoste,Valle d'Aosta,125666,544,0.43,0.15
602,2021-03-10,VDA,436,182,254,9,0,67,17,337,6,0,225,211,ITC,ITC2,2,Valle d'Aosta / Vallée d'Aoste,Valle d'Aosta,125666,980,0.78,0.35
603,2021-02-27,VDA,230,84,146,69,2,28,1,126,4,0,124,106,ITC,ITC2,2,Valle d'Aosta / Vallée d'Aoste,Valle d'Aosta,125666,1210,0.96,0.18
604,2021-01-18,VDA,213,74,139,29,7,104,27,46,0,0,213,0,ITC,ITC2,2,Valle d'Aosta / Vallée d'Aoste,Valle d'Aosta,125666,1423,1.13,0.17
605,2021-03-07,VDA,64,30,34,16,3,16,0,26,2,1,11,53,ITC,ITC2,2,Valle d'Aosta / Vallée d'Aoste,Valle d'Aosta,125666,1487,1.18,0.05
606,2021-03-05,VDA,275,124,151,51,8,60,13,138,0,5,53,222,ITC,ITC2,2,Valle d'Aosta / Vallée d'Aoste,Valle d'Aosta,125666,1762,1.4,0.22
607,2021-01-16,VDA,236,80,156,127,32,4,22,51,0,0,236,0,ITC,ITC2,2,Valle d'Aosta / Vallée d'Aoste,Valle d'Aosta,125666,1998,1.59,0.19
608,2021-01-14,VDA,237,69,168,151,62,22,0,2,0,0,237,0,ITC,ITC2,2,Valle d'Aosta / Vallée d'Aoste,Valle d'Aosta,125666,2235,1.78,0.19
609,2021-01-30,VDA,436,202,234,232,181,11,12,0,0,0,13,423,ITC,ITC2,2,Valle d'Aosta / Vallée d'Aoste,Valle d'Aosta,125666,2671,2.13,0.35
610,2021-03-04,VDA,291,139,152,55,13,45,2,160,14,2,42,249,ITC,ITC2,2,Valle d'Aosta / Vallée d'Aoste,Valle d'Aosta,125666,2962,2.36,0.23
611,2021-02-05,VDA,294,102,192,159,45,37,0,53,0,0,101,193,ITC,ITC2,2,Valle d'Aosta / Vallée d'Aoste,Valle d'Aosta,125666,3256,2.59,0.23
612,2021-01-28,VDA,290,123,167,202,34,46,6,2,0,0,56,234,ITC,ITC2,2,Valle d'Aosta / Vallée d'Aoste,Valle d'Aosta,125666,3546,2.82,0.23
613,2020-12-27,VDA,20,9,11,20,0,0,0,0,0,0,20,0,ITC,ITC2,2,Valle d'Aosta / Vallée d'Aoste,Valle d'Aosta,125666,3566,2.84,0.02
614,2021-02-08,VDA,223,83,140,28,17,86,3,64,0,25,25,198,ITC,ITC2,2,Valle d'Aosta / Vallée d'Aoste,Valle d'Aosta,125666,3789,3.02,0.18
615,2021-03-24,VDA,512,230,282,8,3,135,0,363,2,1,257,255,ITC,ITC2,2,Valle d'Aosta / Vallée d'Aoste,Valle d'Aosta,125666,4301,3.42,0.41
616,2021-03-01,VDA,181,66,115,19,5,10,29,116,2,0,147,34,ITC,ITC2,2,Valle d'Aosta / Vallée d'Aoste,Valle d'Aosta,125666,4482,3.57,0.14
617,2021-01-08,VDA,299,130,169,240,35,8,16,0,0,0,299,0,ITC,ITC2,2,Valle d'Aosta / Vallée d'Aoste,Valle d'Aosta,125666,4781,3.8,0.24
618,2021-02-20,VDA,250,210,40,6,2,49,8,2,174,9,241,9,ITC,ITC2,2,Valle d'Aosta / Vallée d'Aoste,Valle d'Aosta,125666,5031,4.0,0.2
619,2021-01-11,VDA,325,112,213,238,50,7,30,0,0,0,325,0,ITC,ITC2,2,Valle d'Aosta / Vallée d'Aoste,Valle d'Aosta,125666,5356,4.26,0.26
620,2021-03-02,VDA,339,166,173,17,1,103,39,109,65,5,336,3,ITC,ITC2,2,Valle d'Aosta / Vallée d'Aoste,Valle d'Aosta,125666,5695,4.53,0.27
621,2021-02-09,VDA,251,84,167,78,9,21,14,75,1,53,68,183,ITC,ITC2,2,Valle d'Aosta / Vallée d'Aoste,Valle d'Aosta,125666,5946,4.73,0.2
622,2021-02-17,VDA,327,144,183,25,1,18,30,237,16,0,227,100,ITC,ITC2,2,Valle d'Aosta / Vallée d'Aoste,Valle d'Aosta,125666,6273,4.99,0.26
623,2021-02-26,VDA,206,57,149,67,4,30,4,96,4,1,122,84,ITC,ITC2,2,Valle d'Aosta / Vallée d'Aoste,Valle d'Aosta,125666,6479,5.16,0.16
624,2021-02-28,VDA,260,86,174,78,31,27,24,93,3,4,77,183,ITC,ITC2,2,Valle d'Aosta / Vallée d'Aoste,Valle d'Aosta,125666,6739,5.36,0.21
625,2021-02-04,VDA,294,86,208,168,74,17,34,1,0,0,8,286,ITC,ITC2,2,Valle d'Aosta / Vallée d'Aoste,Valle d'Aosta,125666,7033,5.6,0.23
626,2021-03-12,VDA,529,175,354,14,7,96,7,148,2,255,303,226,ITC,ITC2,2,Valle d'Aosta / Vallée d'Aoste,Valle d'Aosta,125666,7562,6.02,0.42
627,2021-03-09,VDA,204,96,108,2,0,79,23,36,39,25,172,32,ITC,ITC2,2,Valle d'Aosta / Vallée d'Aoste,Valle d'Aosta,125666,7766,6.18,0.16
628,2021-01-27,VDA,151,71,80,55,8,17,18,53,0,0,79,72,ITC,ITC2,2,Valle d'Aosta / Vallée d'Aoste,Valle d'Aosta,125666,7917,6.3,0.12
629,2021-02-13,VDA,215,195,20,0,0,54,0,0,161,0,215,0,ITC,ITC2,2,Valle d'Aosta / Vallée d'Aoste,Valle d'Aosta,125666,8132,6.47,0.17
630,2021-01-19,VDA,256,77,179,160,10,14,15,57,0,0,256,0,ITC,ITC2,2,Valle d'Aosta / Vallée d'Aoste,Valle d'Aosta,125666,8388,6.67,0.2
631,2021-01-05,VDA,150,54,96,127,11,1,11,0,0,0,150,0,ITC,ITC2,2,Valle d'Aosta / Vallée d'Aoste,Valle d'Aosta,125666,8538,6.79,0.12
632,2021-01-10,VDA,220,71,149,172,25,4,19,0,0,0,220,0,ITC,ITC2,2,Valle d'Aosta / Vallée d'Aoste,Valle d'Aosta,125666,8758,6.97,0.18
633,2021-03-03,VDA,255,118,137,9,1,105,1,134,1,4,186,69,ITC,ITC2,2,Valle d'Aosta / Vallée d'Aoste,Valle d'Aosta,125666,9013,7.17,0.2
634,2021-03-14,VDA,390,200,190,6,3,295,0,0,34,52,390,0,ITC,ITC2,2,Valle d'Aosta / Vallée d'Aoste,Valle d'Aosta,125666,9403,7.48,0.31
635,2021-01-06,VDA,65,33,32,29,8,10,18,0,0,0,65,0,ITC,ITC2,2,Valle d'Aosta / Vallée d'Aoste,Valle d'Aosta,125666,9468,7.53,0.05
636,2021-03-06,VDA,22,4,18,13,0,0,5,4,0,0,22,0,ITC,ITC2,2,Valle d'Aosta / Vallée d'Aoste,Valle d'Aosta,125666,9490,7.55,0.02
637,2021-03-17,VDA,430,185,245,35,2,90,15,240,41,7,270,160,ITC,ITC2,2,Valle d'Aosta / Vallée d'Aoste,Valle d'Aosta,125666,9920,7.89,0.34
638,2021-01-09,VDA,443,199,244,225,183,13,22,0,0,0,443,0,ITC,ITC2,2,Valle d'Aosta / Vallée d'Aoste,Valle d'Aosta,125666,10363,8.25,0.35
639,2021-03-20,VDA,205,85,120,5,2,164,15,14,4,1,170,35,ITC,ITC2,2,Valle d'Aosta / Vallée d'Aoste,Valle d'Aosta,125666,10568,8.41,0.16
640,2021-01-12,VDA,302,72,230,242,34,15,11,0,0,0,302,0,ITC,ITC2,2,Valle d'Aosta / Vallée d'Aoste,Valle d'Aosta,125666,10870,8.65,0.24
641,2021-03-16,VDA,175,35,140,2,0,42,13,118,0,0,114,61,ITC,ITC2,2,Valle d'Aosta / Vallée d'Aoste,Valle d'Aosta,125666,11045,8.79,0.14
642,2020-12-31,VDA,18,4,14,16,2,0,0,0,0,0,18,0,ITC,ITC2,2,Valle d'Aosta / Vallée d'Aoste,Valle d'Aosta,125666,11063,8.8,0.01
643,2021-03-25,VDA,375,151,224,10,0,120,1,243,0,1,366,9,ITC,ITC2,2,Valle d'Aosta / Vallée d'Aoste,Valle d'Aosta,125666,11438,9.1,0.3
644,2021-02-07,VDA,292,120,172,110,55,17,0,105,2,3,190,102,ITC,ITC2,2,Valle d'Aosta / Vallée d'Aoste,Valle d'Aosta,125666,11730,9.33,0.23
645,2021-02-21,VDA,18,3,15,0,0,0,18,0,0,0,0,18,ITC,ITC2,2,Valle d'Aosta / Vallée d'Aoste,Valle d'Aosta,125666,11748,9.35,0.01
646,2021-03-15,VDA,361,122,239,20,4,41,10,215,6,65,159,202,ITC,ITC2,2,Valle d'Aosta / Vallée d'Aoste,Valle d'Aosta,125666,12109,9.64,0.29
647,2021-02-24,VDA,183,82,101,30,7,8,13,65,53,7,164,19,ITC,ITC2,2,Valle d'Aosta / Vallée d'Aoste,Valle d'Aosta,125666,12292,9.78,0.15
648,2021-01-29,VDA,316,138,178,259,32,9,16,0,0,0,2,314,ITC,ITC2,2,Valle d'Aosta / Vallée d'Aoste,Valle d'Aosta,125666,12608,10.03,0.25
649,2021-03-08,VDA,481,231,250,28,1,80,13,343,15,1,237,244,ITC,ITC2,2,Valle d'Aosta / Vallée d'Aoste,Valle d'Aosta,125666,13089,10.42,0.38
650,2021-02-11,VDA,231,107,124,53,17,21,0,127,13,0,222,9,ITC,ITC2,2,Valle d'Aosta / Vallée d'Aoste,Valle d'Aosta,125666,13320,10.6,0.18
651,2021-02-15,VDA,264,136,128,24,2,27,24,170,15,2,229,35,ITC,ITC2,2,Valle d'Aosta / Vallée d'Aoste,Valle d'Aosta,125666,13584,10.81,0.21
652,2021-02-01,VDA,403,127,276,268,56,9,70,0,0,0,87,316,ITC,ITC2,2,Valle d'Aosta / Vallée d'Aoste,Valle d'Aosta,125666,13987,11.13,0.32
653,2021-01-07,VDA,275,111,164,224,38,8,5,0,0,0,275,0,ITC,ITC2,2,Valle d'Aosta / Vallée d'Aoste,Valle d'Aosta,125666,14262,11.35,0.22
654,2021-03-22,VDA,556,204,352,36,4,137,18,334,10,17,330,226,ITC,ITC2,2,Valle d'Aosta / Vallée d'Aoste,Valle d'Aosta,125666,14818,11.79,0.44
655,2021-02-18,VDA,349,153,196,61,4,37,45,180,14,8,261,88,ITC,ITC2,2,Valle d'Aosta / Vallée d'Aoste,Valle d'Aosta,125666,15167,12.07,0.28
656,2021-02-19,VDA,292,102,190,17,0,30,35,145,0,65,268,24,ITC,ITC2,2,Valle d'Aosta / Vallée d'Aoste,Valle d'Aosta,125666,15459,12.3,0.23
657,2021-02-25,VDA,201,101,100,6,3,154,11,0,25,2,194,7,ITC,ITC2,2,Valle d'Aosta / Vallée d'Aoste,Valle d'Aosta,125666,15660,12.46,0.16
658,2021-01-17,VDA,131,56,75,49,2,1,20,59,0,0,131,0,ITC,ITC2,2,Valle d'Aosta / Vallée d'Aoste,Valle d'Aosta,125666,15791,12.57,0.1
659,2021-02-10,VDA,248,77,171,51,8,17,26,127,1,18,141,107,ITC,ITC2,2,Valle d'Aosta / Vallée d'Aoste,Valle d'Aosta,125666,16039,12.76,0.2
660,2021-03-23,VDA,375,149,226,13,2,70,7,276,0,7,242,133,ITC,ITC2,2,Valle d'Aosta / Vallée d'Aoste,Valle d'Aosta,125666,16414,13.06,0.3
661,2021-01-04,VDA,142,59,83,126,14,2,0,0,0,0,142,0,ITC,ITC2,2,Valle d'Aosta / Vallée d'Aoste,Valle d'Aosta,125666,16556,13.17,0.11
662,2021-03-19,VDA,319,84,235,8,1,70,21,9,1,209,284,35,ITC,ITC2,2,Valle d'Aosta / Vallée d'Aoste,Valle d'Aosta,125666,16875,13.43,0.25
663,2021-01-22,VDA,56,21,35,36,0,0,20,0,0,0,20,36,ITC,ITC2,2,Valle d'Aosta / Vallée d'Aoste,Valle d'Aosta,125666,16931,13.47,0.04
664,2021-02-06,VDA,289,104,185,170,31,13,0,74,1,0,92,197,ITC,ITC2,2,Valle d'Aosta / Vallée d'Aoste,Valle d'Aosta,125666,17220,13.7,0.23
665,2021-01-02,VDA,6,5,1,0,0,0,6,0,0,0,6,0,ITC,ITC2,2,Valle d'Aosta / Vallée d'Aoste,Valle d'Aosta,125666,17226,13.71,0.0
666,2021-02-02,VDA,271,70,201,225,34,9,3,0,0,0,2,269,ITC,ITC2,2,Valle d'Aosta / Vallée d'Aoste,Valle d'Aosta,125666,17497,13.92,0.22
667,2021-03-13,VDA,142,84,58,2,1,113,0,0,23,3,142,0,ITC,ITC2,2,Valle d'Aosta / Vallée d'Aoste,Valle d'Aosta,125666,17639,14.04,0.11
668,2021-01-13,VDA,337,110,227,166,138,5,28,0,0,0,337,0,ITC,ITC2,2,Valle d'Aosta / Vallée d'Aoste,Valle d'Aosta,125666,17976,14.3,0.27
669,2021-02-22,VDA,316,94,222,62,7,34,37,103,6,67,213,103,ITC,ITC2,2,Valle d'Aosta / Vallée d'Aoste,Valle d'Aosta,125666,18292,14.56,0.25
670,2021-02-14,VDA,48,16,32,6,0,0,42,0,0,0,1,47,ITC,ITC2,2,Valle d'Aosta / Vallée d'Aoste,Valle d'Aosta,125666,18340,14.59,0.04
671,2021-01-26,VDA,139,48,91,115,11,1,12,0,0,0,0,139,ITC,ITC2,2,Valle d'Aosta / Vallée d'Aoste,Valle d'Aosta,125666,18479,14.7,0.11
672,2021-02-12,VDA,263,96,167,51,9,41,26,131,0,5,217,46,ITC,ITC2,2,Valle d'Aosta / Vallée d'Aoste,Valle d'Aosta,125666,18742,14.91,0.21
673,2021-02-03,VDA,351,114,237,157,135,6,52,1,0,0,14,337,ITC,ITC2,2,Valle d'Aosta / Vallée d'Aoste,Valle d'Aosta,125666,19093,15.19,0.28
674,2021-01-25,VDA,147,65,82,125,13,3,6,0,0,0,0,147,ITC,ITC2,2,Valle d'Aosta / Vallée d'Aoste,Valle d'Aosta,125666,19240,15.31,0.12
675,2021-02-16,VDA,325,53,272,10,0,58,12,5,4,236,320,5,ITC,ITC2,2,Valle d'Aosta / Vallée d'Aoste,Valle d'Aosta,125666,19565,15.57,0.26
676,2021-01-21,VDA,33,12,21,0,0,0,33,0,0,0,33,0,ITC,ITC2,2,Valle d'Aosta / Vallée d'Aoste,Valle d'Aosta,125666,19598,15.6,0.03
677,2021-02-23,VDA,216,123,93,0,1,164,0,0,35,16,216,0,ITC,ITC2,2,Valle d'Aosta / Vallée d'Aoste,Valle d'Aosta,125666,19814,15.77,0.17
678,2021-01-31,VDA,290,90,200,231,31,10,18,0,0,0,58,232,ITC,ITC2,2,Valle d'Aosta / Vallée d'Aoste,Valle d'Aosta,125666,20104,16.0,0.23
679,2021-03-21,VDA,353,164,189,2,4,312,0,1,6,28,353,0,ITC,ITC2,2,Valle d'Aosta / Vallée d'Aoste,Valle d'Aosta,125666,20457,16.28,0.28
680,2021-01-20,VDA,23,8,15,0,0,0,6,17,0,0,23,0,ITC,ITC2,2,Valle d'Aosta / Vallée d'Aoste,Valle d'Aosta,125666,20480,16.3,0.02
681,2021-02-07,VEN,2314,861,1453,1931,11,319,50,2,0,1,714,1600,ITH,ITH3,5,Veneto,Veneto,4905854,2314,0.05,0.05
682,2020-12-30,VEN,699,245,454,598,12,50,39,0,0,0,699,0,ITH,ITH3,5,Veneto,Veneto,4905854,3013,0.06,0.01
683,2021-01-04,VEN,6726,2029,4697,5238,181,388,913,1,0,5,6726,0,ITH,ITH3,5,Veneto,Veneto,4905854,9739,0.2,0.14
684,2021-02-28,VEN,4127,1382,2745,1702,30,1394,15,983,0,3,3290,837,ITH,ITH3,5,Veneto,Veneto,4905854,13866,0.28,0.08
685,2021-01-26,VEN,6902,2081,4821,5338,220,375,963,0,1,5,155,6747,ITH,ITH3,5,Veneto,Veneto,4905854,20768,0.42,0.14
686,2021-02-04,VEN,7314,2013,5301,3459,446,1013,2380,12,0,4,555,6759,ITH,ITH3,5,Veneto,Veneto,4905854,28082,0.57,0.15
687,2021-03-10,VEN,18822,8551,10271,1453,64,2455,555,9051,1100,4144,13148,5674,ITH,ITH3,5,Veneto,Veneto,4905854,46904,0.96,0.38
688,2021-03-01,VEN,9358,3699,5659,2023,145,998,923,2611,156,2502,7536,1822,ITH,ITH3,5,Veneto,Veneto,4905854,56262,1.15,0.19
689,2021-01-28,VEN,9204,2662,6542,6459,358,931,1448,5,0,3,175,9029,ITH,ITH3,5,Veneto,Veneto,4905854,65466,1.33,0.19
690,2021-01-21,VEN,2290,719,1571,1985,48,114,141,0,0,2,21,2269,ITH,ITH3,5,Veneto,Veneto,4905854,67756,1.38,0.05
691,2021-01-03,VEN,5159,1563,3596,4597,59,253,249,0,0,1,5159,0,ITH,ITH3,5,Veneto,Veneto,4905854,72915,1.49,0.11
692,2021-02-03,VEN,5934,1660,4274,2851,426,908,1744,1,0,4,482,5452,ITH,ITH3,5,Veneto,Veneto,4905854,78849,1.61,0.12
693,2021-01-18,VEN,2770,782,1988,1222,233,308,999,8,0,0,2571,199,ITH,ITH3,5,Veneto,Veneto,4905854,81619,1.66,0.06
694,2020-12-31,VEN,3219,1043,2176,2700,77,188,252,0,0,2,3219,0,ITH,ITH3,5,Veneto,Veneto,4905854,84838,1.73,0.07
695,2021-02-01,VEN,8517,2488,6029,4206,489,1464,2106,245,0,7,165,8352,ITH,ITH3,5,Veneto,Veneto,4905854,93355,1.9,0.17
696,2021-01-19,VEN,1309,472,837,726,83,170,324,6,0,0,1160,149,ITH,ITH3,5,Veneto,Veneto,4905854,94664,1.93,0.03
697,2021-02-09,VEN,5153,1871,3282,3096,313,557,1167,19,0,1,3423,1730,ITH,ITH3,5,Veneto,Veneto,4905854,99817,2.03,0.11
698,2021-01-31,VEN,4740,1550,3190,3676,147,532,377,4,2,2,393,4347,ITH,ITH3,5,Veneto,Veneto,4905854,104557,2.13,0.1
699,2021-01-09,VEN,7929,2538,5391,5174,335,830,1574,3,11,2,7929,0,ITH,ITH3,5,Veneto,Veneto,4905854,112486,2.29,0.16
700,2021-03-17,VEN,14472,5906,8566,1872,166,2538,257,8916,26,697,7788,6684,ITH,ITH3,5,Veneto,Veneto,4905854,126958,2.59,0.29
701,2021-03-14,VEN,15119,5902,9217,2243,208,4586,100,4136,242,3604,14223,896,ITH,ITH3,5,Veneto,Veneto,4905854,142077,2.9,0.31
702,2021-02-11,VEN,4011,1239,2772,2614,152,444,789,9,1,2,3381,630,ITH,ITH3,5,Veneto,Veneto,4905854,146088,2.98,0.08
703,2021-02-16,VEN,6630,2868,3762,718,109,278,478,5044,2,1,6453,177,ITH,ITH3,5,Veneto,Veneto,4905854,152718,3.11,0.14
704,2021-01-22,VEN,1079,332,747,946,35,41,57,0,0,0,25,1054,ITH,ITH3,5,Veneto,Veneto,4905854,153797,3.13,0.02
705,2021-02-17,VEN,6004,2764,3240,411,19,262,361,4946,5,0,5910,94,ITH,ITH3,5,Veneto,Veneto,4905854,159801,3.26,0.12
706,2021-03-06,VEN,10503,4254,6249,2956,48,2667,1487,1973,46,1326,7307,3196,ITH,ITH3,5,Veneto,Veneto,4905854,170304,3.47,0.21
707,2021-01-16,VEN,4606,1541,3065,3193,273,484,656,0,0,0,4606,0,ITH,ITH3,5,Veneto,Veneto,4905854,174910,3.57,0.09
708,2021-03-20,VEN,12571,5135,7436,654,27,4492,215,4818,86,2279,10471,2100,ITH,ITH3,5,Veneto,Veneto,4905854,187481,3.82,0.26
709,2021-01-10,VEN,5020,1662,3358,3839,165,550,462,2,2,0,5020,0,ITH,ITH3,5,Veneto,Veneto,4905854,192501,3.92,0.1
710,2021-03-04,VEN,12710,4711,7999,3106,380,1287,1354,3405,352,2826,9307,3403,ITH,ITH3,5,Veneto,Veneto,4905854,205211,4.18,0.26
711,2021-01-01,VEN,1525,470,1055,1494,0,30,1,0,0,0,1525,0,ITH,ITH3,5,Veneto,Veneto,4905854,206736,4.21,0.03
712,2021-01-30,VEN,8746,2671,6075,6209,291,995,1233,4,12,2,696,8050,ITH,ITH3,5,Veneto,Veneto,4905854,215482,4.39,0.18
713,2021-02-21,VEN,4624,1203,3421,495,0,9,18,417,2,3683,4619,5,ITH,ITH3,5,Veneto,Veneto,4905854,220106,4.49,0.09
714,2021-02-13,VEN,3267,1474,1793,1559,74,596,1034,2,1,1,3247,20,ITH,ITH3,5,Veneto,Veneto,4905854,223373,4.55,0.07
715,2021-01-24,VEN,4117,1219,2898,3752,17,122,222,1,0,3,28,4089,ITH,ITH3,5,Veneto,Veneto,4905854,227490,4.64,0.08
716,2021-01-14,VEN,7060,1925,5135,3235,524,809,2473,17,0,2,7060,0,ITH,ITH3,5,Veneto,Veneto,4905854,234550,4.78,0.14
717,2021-01-12,VEN,5231,1516,3715,2251,359,697,1753,168,0,3,5231,0,ITH,ITH3,5,Veneto,Veneto,4905854,239781,4.89,0.11
718,2021-03-07,VEN,4446,1739,2707,1692,1,926,17,983,0,827,3891,555,ITH,ITH3,5,Veneto,Veneto,4905854,244227,4.98,0.09
719,2021-01-23,VEN,4063,1255,2808,3404,115,90,450,1,0,3,34,4029,ITH,ITH3,5,Veneto,Veneto,4905854,248290,5.06,0.08
720,2021-03-02,VEN,11318,4547,6771,2767,436,1406,1165,3286,410,1848,8043,3275,ITH,ITH3,5,Veneto,Veneto,4905854,259608,5.29,0.23
721,2021-03-15,VEN,16365,7083,9282,1349,36,2855,370,9296,505,1954,11172,5193,ITH,ITH3,5,Veneto,Veneto,4905854,275973,5.63,0.33
722,2021-03-09,VEN,16283,7316,8967,1232,139,1828,683,8541,917,2943,10095,6188,ITH,ITH3,5,Veneto,Veneto,4905854,292256,5.96,0.33
723,2021-01-02,VEN,5741,1765,3976,4797,147,249,544,2,0,2,5741,0,ITH,ITH3,5,Veneto,Veneto,4905854,297997,6.07,0.12
724,2021-01-05,VEN,7327,2183,5144,5410,304,485,1122,0,1,5,7327,0,ITH,ITH3,5,Veneto,Veneto,4905854,305324,6.22,0.15
725,2021-01-20,VEN,1038,368,670,695,58,72,213,0,0,0,386,652,ITH,ITH3,5,Veneto,Veneto,4905854,306362,6.24,0.02
726,2021-01-27,VEN,7140,2064,5076,5206,210,836,879,0,0,9,246,6894,ITH,ITH3,5,Veneto,Veneto,4905854,313502,6.39,0.15
727,2021-03-19,VEN,13386,5505,7881,1648,109,2561,436,7870,42,720,7566,5820,ITH,ITH3,5,Veneto,Veneto,4905854,326888,6.66,0.27
728,2021-01-17,VEN,1932,780,1152,1587,40,180,120,3,0,2,1583,349,ITH,ITH3,5,Veneto,Veneto,4905854,328820,6.7,0.04
729,2021-02-08,VEN,4969,1539,3430,2788,268,725,1174,12,0,2,1930,3039,ITH,ITH3,5,Veneto,Veneto,4905854,333789,6.8,0.1
730,2021-03-22,VEN,17895,7985,9910,1156,123,6402,509,6738,631,2336,12890,5005,ITH,ITH3,5,Veneto,Veneto,4905854,351684,7.17,0.36
731,2021-03-23,VEN,21722,9919,11803,1092,202,9532,633,6699,776,2788,17130,4592,ITH,ITH3,5,Veneto,Veneto,4905854,373406,7.61,0.44
732,2021-02-06,VEN,4090,1351,2739,3024,171,525,367,3,0,0,709,3381,ITH,ITH3,5,Veneto,Veneto,4905854,377496,7.69,0.08
733,2021-03-24,VEN,21500,9156,12344,1151,234,5423,799,10469,614,2810,14731,6769,ITH,ITH3,5,Veneto,Veneto,4905854,398996,8.13,0.44
734,2021-02-05,VEN,8364,2533,5831,4272,679,1233,2164,7,5,4,1425,6939,ITH,ITH3,5,Veneto,Veneto,4905854,407360,8.3,0.17
735,2021-01-13,VEN,5978,1601,4377,2792,428,872,1881,3,0,2,5978,0,ITH,ITH3,5,Veneto,Veneto,4905854,413338,8.43,0.12
736,2021-03-21,VEN,11905,4684,7221,1480,50,3141,30,4566,113,2525,8445,3460,ITH,ITH3,5,Veneto,Veneto,4905854,425243,8.67,0.24
737,2021-02-02,VEN,6402,1842,4560,2970,533,751,1994,152,0,2,391,6011,ITH,ITH3,5,Veneto,Veneto,4905854,431645,8.8,0.13
738,2021-02-22,VEN,6958,3016,3942,743,44,187,342,5401,1,240,6572,386,ITH,ITH3,5,Veneto,Veneto,4905854,438603,8.94,0.14
739,2021-02-25,VEN,7853,3321,4532,1498,248,320,467,4937,109,274,7255,598,ITH,ITH3,5,Veneto,Veneto,4905854,446456,9.1,0.16
740,2021-03-11,VEN,19402,8608,10794,1552,116,2960,822,9336,969,3647,13911,5491,ITH,ITH3,5,Veneto,Veneto,4905854,465858,9.5,0.4
741,2021-01-07,VEN,8359,2319,6040,5467,460,627,1805,0,0,0,8359,0,ITH,ITH3,5,Veneto,Veneto,4905854,474217,9.67,0.17
742,2021-03-18,VEN,12483,5071,7412,1404,225,1918,482,7593,20,841,7306,5177,ITH,ITH3,5,Veneto,Veneto,4905854,486700,9.92,0.25
743,2021-02-12,VEN,4312,1447,2865,2761,137,743,659,6,2,4,3740,572,ITH,ITH3,5,Veneto,Veneto,4905854,491012,10.01,0.09
744,2020-12-27,VEN,880,395,485,875,0,4,0,0,0,1,880,0,ITH,ITH3,5,Veneto,Veneto,4905854,491892,10.03,0.02
745,2021-01-08,VEN,9398,2832,6566,5978,567,1035,1807,3,1,7,9398,0,ITH,ITH3,5,Veneto,Veneto,4905854,501290,10.22,0.19
746,2021-02-14,VEN,125,56,69,95,1,29,0,0,0,0,112,13,ITH,ITH3,5,Veneto,Veneto,4905854,501415,10.22,0.0
747,2021-03-16,VEN,12371,5294,7077,1272,105,2558,454,7857,19,106,6839,5532,ITH,ITH3,5,Veneto,Veneto,4905854,513786,10.47,0.25
748,2021-01-25,VEN,6466,2074,4392,5060,152,347,904,1,0,2,170,6296,ITH,ITH3,5,Veneto,Veneto,4905854,520252,10.6,0.13
749,2021-03-05,VEN,13154,4902,8252,3430,266,1730,1401,3089,285,2953,9570,3584,ITH,ITH3,5,Veneto,Veneto,4905854,533406,10.87,0.27
750,2021-02-27,VEN,8979,2691,6288,2174,38,618,63,1956,12,4118,8128,851,ITH,ITH3,5,Veneto,Veneto,4905854,542385,11.06,0.18
751,2021-03-08,VEN,13423,6104,7319,701,56,1149,384,7149,1040,2944,9384,4039,ITH,ITH3,5,Veneto,Veneto,4905854,555808,11.33,0.27
752,2021-01-11,VEN,7237,2100,5137,3499,501,1029,1956,247,0,5,7237,0,ITH,ITH3,5,Veneto,Veneto,4905854,563045,11.48,0.15
753,2021-01-15,VEN,5863,1819,4044,2984,453,846,1565,9,3,3,5863,0,ITH,ITH3,5,Veneto,Veneto,4905854,568908,11.6,0.12
754,2021-02-10,VEN,4750,1587,3163,3117,199,666,767,0,0,1,3698,1052,ITH,ITH3,5,Veneto,Veneto,4905854,573658,11.69,0.1
755,2021-02-15,VEN,4386,1820,2566,483,65,145,383,3294,14,2,4146,240,ITH,ITH3,5,Veneto,Veneto,4905854,578044,11.78,0.09
756,2021-03-13,VEN,16971,7135,9836,2327,31,5317,103,4816,346,4031,13889,3082,ITH,ITH3,5,Veneto,Veneto,4905854,595015,12.13,0.35
757,2021-02-18,VEN,5700,2440,3260,934,64,289,607,3799,1,6,5637,63,ITH,ITH3,5,Veneto,Veneto,4905854,600715,12.24,0.12
758,2021-02-20,VEN,6325,1988,4337,1803,2,202,100,970,6,3242,6321,4,ITH,ITH3,5,Veneto,Veneto,4905854,607040,12.37,0.13
759,2021-03-25,VEN,23766,9963,13803,1236,331,8673,773,10145,403,2205,17771,5995,ITH,ITH3,5,Veneto,Veneto,4905854,630806,12.86,0.48
760,2021-02-19,VEN,7292,3121,4171,1535,175,541,665,4366,3,7,7090,202,ITH,ITH3,5,Veneto,Veneto,4905854,638098,13.01,0.15
761,2021-01-06,VEN,8131,2383,5748,6308,170,833,807,1,2,10,8131,0,ITH,ITH3,5,Veneto,Veneto,4905854,646229,13.17,0.17
762,2021-03-12,VEN,18445,8046,10399,1937,211,3148,749,8050,862,3488,11728,6717,ITH,ITH3,5,Veneto,Veneto,4905854,664674,13.55,0.38
763,2021-01-29,VEN,8996,2780,6216,6039,478,1038,1434,3,1,3,366,8630,ITH,ITH3,5,Veneto,Veneto,4905854,673670,13.73,0.18
764,2021-03-03,VEN,11947,4526,7421,3313,296,1207,1190,3372,310,2259,8454,3493,ITH,ITH3,5,Veneto,Veneto,4905854,685617,13.98,0.24
765,2021-02-24,VEN,8541,3655,4886,1527,224,419,506,5590,263,12,8059,482,ITH,ITH3,5,Veneto,Veneto,4905854,694158,14.15,0.17
766,2021-02-26,VEN,8222,3243,4979,1687,202,900,739,4381,31,282,6972,1250,ITH,ITH3,5,Veneto,Veneto,4905854,702380,14.32,0.17
767,2021-02-23,VEN,7306,3214,4092,1012,62,427,214,5342,69,180,7048,258,ITH,ITH3,5,Veneto,Veneto,4905854,709686,14.47,0.15
768,2021-01-23,PAT,570,330,240,480,2,0,88,0,0,0,384,186,ITH,ITH2,4,Provincia Autonoma Trento,P.A. Trento,541380,570,0.11,0.11
769,2021-02-26,PAT,1206,431,775,249,12,11,19,809,1,105,892,314,ITH,ITH2,4,Provincia Autonoma Trento,P.A. Trento,541380,1776,0.33,0.22
770,2021-03-17,PAT,2043,786,1257,390,15,339,55,1238,1,5,1160,883,ITH,ITH2,4,Provincia Autonoma Trento,P.A. Trento,541380,3819,0.71,0.38
771,2021-03-10,PAT,2352,909,1443,347,36,45,25,1376,222,301,1410,942,ITH,ITH2,4,Provincia Autonoma Trento,P.A. Trento,541380,6171,1.14,0.43
772,2021-03-18,PAT,2233,922,1311,55,0,575,2,1595,2,4,1162,1071,ITH,ITH2,4,Provincia Autonoma Trento,P.A. Trento,541380,8404,1.55,0.41
773,2021-02-13,PAT,536,333,203,373,4,1,0,158,0,0,171,365,ITH,ITH2,4,Provincia Autonoma Trento,P.A. Trento,541380,8940,1.65,0.1
774,2021-01-08,PAT,1442,312,1130,764,128,24,526,0,0,0,1442,0,ITH,ITH2,4,Provincia Autonoma Trento,P.A. Trento,541380,10382,1.92,0.27
775,2021-03-01,PAT,1235,453,782,74,1,17,10,1035,3,95,937,298,ITH,ITH2,4,Provincia Autonoma Trento,P.A. Trento,541380,11617,2.15,0.23
776,2021-02-09,PAT,914,287,627,447,8,5,73,381,0,0,441,473,ITH,ITH2,4,Provincia Autonoma Trento,P.A. Trento,541380,12531,2.31,0.17
777,2021-03-02,PAT,1288,434,854,133,16,28,53,914,0,144,898,390,ITH,ITH2,4,Provincia Autonoma Trento,P.A. Trento,541380,13819,2.55,0.24
778,2021-03-13,PAT,831,382,449,201,15,5,30,39,282,259,781,50,ITH,ITH2,4,Provincia Autonoma Trento,P.A. Trento,541380,14650,2.71,0.15
779,2021-01-09,PAT,184,40,144,139,13,1,31,0,0,0,184,0,ITH,ITH2,4,Provincia Autonoma Trento,P.A. Trento,541380,14834,2.74,0.03
780,2021-02-24,PAT,1311,521,790,237,4,7,28,968,1,66,918,393,ITH,ITH2,4,Provincia Autonoma Trento,P.A. Trento,541380,16145,2.98,0.24
781,2021-01-22,PAT,1636,425,1211,876,120,9,628,0,0,3,317,1319,ITH,ITH2,4,Provincia Autonoma Trento,P.A. Trento,541380,17781,3.28,0.3
782,2021-02-16,PAT,663,244,419,73,2,12,3,563,0,10,658,5,ITH,ITH2,4,Provincia Autonoma Trento,P.A. Trento,541380,18444,3.41,0.12
783,2021-03-08,PAT,1385,431,954,65,15,30,0,992,7,276,1025,360,ITH,ITH2,4,Provincia Autonoma Trento,P.A. Trento,541380,19829,3.66,0.26
784,2021-02-19,PAT,902,347,555,170,37,16,70,580,1,28,845,57,ITH,ITH2,4,Provincia Autonoma Trento,P.A. Trento,541380,20731,3.83,0.17
785,2021-01-28,PAT,530,147,383,390,29,4,107,0,0,0,48,482,ITH,ITH2,4,Provincia Autonoma Trento,P.A. Trento,541380,21261,3.93,0.1
786,2021-01-19,PAT,403,77,326,363,3,1,36,0,0,0,403,0,ITH,ITH2,4,Provincia Autonoma Trento,P.A. Trento,541380,21664,4.0,0.07
787,2021-02-12,PAT,1009,340,669,335,54,14,55,551,0,0,588,421,ITH,ITH2,4,Provincia Autonoma Trento,P.A. Trento,541380,22673,4.19,0.19
788,2021-02-04,PAT,971,303,668,541,10,7,89,324,0,0,420,551,ITH,ITH2,4,Provincia Autonoma Trento,P.A. Trento,541380,23644,4.37,0.18
789,2021-01-10,PAT,84,19,65,53,18,1,12,0,0,0,84,0,ITH,ITH2,4,Provincia Autonoma Trento,P.A. Trento,541380,23728,4.38,0.02
790,2021-02-10,PAT,849,289,560,310,7,2,51,479,0,0,509,340,ITH,ITH2,4,Provincia Autonoma Trento,P.A. Trento,541380,24577,4.54,0.16
791,2021-03-11,PAT,2234,829,1405,101,49,112,41,1500,59,372,1376,858,ITH,ITH2,4,Provincia Autonoma Trento,P.A. Trento,541380,26811,4.95,0.41
792,2021-03-06,PAT,736,256,480,325,10,7,0,194,5,195,584,152,ITH,ITH2,4,Provincia Autonoma Trento,P.A. Trento,541380,27547,5.09,0.14
793,2020-12-31,PAT,1598,440,1158,819,105,4,670,0,0,0,1598,0,ITH,ITH2,4,Provincia Autonoma Trento,P.A. Trento,541380,29145,5.38,0.3
794,2021-01-18,PAT,640,154,486,527,35,5,73,0,0,0,586,54,ITH,ITH2,4,Provincia Autonoma Trento,P.A. Trento,541380,29785,5.5,0.12
795,2021-01-06,PAT,42,13,29,42,0,0,0,0,0,0,42,0,ITH,ITH2,4,Provincia Autonoma Trento,P.A. Trento,541380,29827,5.51,0.01
796,2021-01-05,PAT,707,231,476,494,46,6,161,0,0,0,707,0,ITH,ITH2,4,Provincia Autonoma Trento,P.A. Trento,541380,30534,5.64,0.13
797,2021-02-03,PAT,846,314,532,355,13,12,73,393,0,0,414,432,ITH,ITH2,4,Provincia Autonoma Trento,P.A. Trento,541380,31380,5.8,0.16
798,2021-03-16,PAT,1361,497,864,221,7,74,36,1020,0,3,587,774,ITH,ITH2,4,Provincia Autonoma Trento,P.A. Trento,541380,32741,6.05,0.25
799,2021-01-04,PAT,853,223,630,481,41,8,322,1,0,0,853,0,ITH,ITH2,4,Provincia Autonoma Trento,P.A. Trento,541380,33594,6.21,0.16
800,2021-02-25,PAT,1584,620,964,120,9,7,32,1322,1,93,1159,425,ITH,ITH2,4,Provincia Autonoma Trento,P.A. Trento,541380,35178,6.5,0.29
801,2021-01-14,PAT,696,201,495,477,6,5,208,0,0,0,696,0,ITH,ITH2,4,Provincia Autonoma Trento,P.A. Trento,541380,35874,6.63,0.13
802,2021-01-30,PAT,383,130,253,345,7,0,31,0,0,0,151,232,ITH,ITH2,4,Provincia Autonoma Trento,P.A. Trento,541380,36257,6.7,0.07
803,2021-03-05,PAT,2179,686,1493,125,66,62,101,905,157,763,1581,598,ITH,ITH2,4,Provincia Autonoma Trento,P.A. Trento,541380,38436,7.1,0.4
804,2021-03-15,PAT,1372,529,843,62,118,376,7,592,54,163,908,464,ITH,ITH2,4,Provincia Autonoma Trento,P.A. Trento,541380,39808,7.35,0.25
805,2020-12-27,PAT,103,40,63,76,4,2,21,0,0,0,103,0,ITH,ITH2,4,Provincia Autonoma Trento,P.A. Trento,541380,39911,7.37,0.02
806,2021-01-15,PAT,592,130,462,460,18,3,111,0,0,0,592,0,ITH,ITH2,4,Provincia Autonoma Trento,P.A. Trento,541380,40503,7.48,0.11
807,2021-02-05,PAT,802,271,531,467,19,3,66,247,0,0,283,519,ITH,ITH2,4,Provincia Autonoma Trento,P.A. Trento,541380,41305,7.63,0.15
808,2021-03-22,PAT,2238,951,1287,69,132,974,4,949,18,92,1369,869,ITH,ITH2,4,Provincia Autonoma Trento,P.A. Trento,541380,43543,8.04,0.41
809,2021-02-02,PAT,907,240,667,507,33,14,189,164,0,0,190,717,ITH,ITH2,4,Provincia Autonoma Trento,P.A. Trento,541380,44450,8.21,0.17
810,2021-01-21,PAT,349,93,256,318,13,2,16,0,0,0,227,122,ITH,ITH2,4,Provincia Autonoma Trento,P.A. Trento,541380,44799,8.27,0.06
811,2021-03-04,PAT,2328,783,1545,160,23,59,23,1699,19,345,1480,848,ITH,ITH2,4,Provincia Autonoma Trento,P.A. Trento,541380,47127,8.7,0.43
812,2021-03-24,PAT,2192,862,1330,201,75,303,38,1350,15,210,1411,781,ITH,ITH2,4,Provincia Autonoma Trento,P.A. Trento,541380,49319,9.11,0.4
813,2021-02-17,PAT,1108,424,684,324,9,18,35,707,3,12,1017,91,ITH,ITH2,4,Provincia Autonoma Trento,P.A. Trento,541380,50427,9.31,0.2
814,2021-01-20,PAT,288,71,217,229,10,1,48,0,0,0,276,12,ITH,ITH2,4,Provincia Autonoma Trento,P.A. Trento,541380,50715,9.37,0.05
815,2021-01-02,PAT,498,142,356,334,21,4,139,0,0,0,498,0,ITH,ITH2,4,Provincia Autonoma Trento,P.A. Trento,541380,51213,9.46,0.09
816,2021-01-11,PAT,724,220,504,516,49,9,150,0,0,0,724,0,ITH,ITH2,4,Provincia Autonoma Trento,P.A. Trento,541380,51937,9.59,0.13
817,2021-02-21,PAT,155,92,63,154,0,0,0,0,0,1,43,112,ITH,ITH2,4,Provincia Autonoma Trento,P.A. Trento,541380,52092,9.62,0.03
818,2021-02-20,PAT,406,245,161,330,10,1,30,1,3,31,122,284,ITH,ITH2,4,Provincia Autonoma Trento,P.A. Trento,541380,52498,9.7,0.07
819,2021-02-01,PAT,1219,335,884,766,70,8,375,0,0,0,92,1127,ITH,ITH2,4,Provincia Autonoma Trento,P.A. Trento,541380,53717,9.92,0.23
820,2021-02-23,PAT,1098,393,705,272,13,2,17,741,3,50,887,211,ITH,ITH2,4,Provincia Autonoma Trento,P.A. Trento,541380,54815,10.13,0.2
821,2021-01-24,PAT,545,274,271,533,12,0,0,0,0,0,223,322,ITH,ITH2,4,Provincia Autonoma Trento,P.A. Trento,541380,55360,10.23,0.1
822,2021-03-21,PAT,129,69,60,34,1,76,0,0,0,18,128,1,ITH,ITH2,4,Provincia Autonoma Trento,P.A. Trento,541380,55489,10.25,0.02
823,2021-02-22,PAT,745,259,486,118,4,7,70,501,0,45,660,85,ITH,ITH2,4,Provincia Autonoma Trento,P.A. Trento,541380,56234,10.39,0.14
824,2021-02-18,PAT,1196,422,774,300,25,5,35,773,3,55,1138,58,ITH,ITH2,4,Provincia Autonoma Trento,P.A. Trento,541380,57430,10.61,0.22
825,2021-03-23,PAT,2342,891,1451,142,97,905,70,984,5,139,1612,730,ITH,ITH2,4,Provincia Autonoma Trento,P.A. Trento,541380,59772,11.04,0.43
826,2021-01-12,PAT,501,158,343,413,25,4,59,0,0,0,501,0,ITH,ITH2,4,Provincia Autonoma Trento,P.A. Trento,541380,60273,11.13,0.09
827,2021-03-12,PAT,2398,899,1499,205,248,53,85,1070,203,534,1618,780,ITH,ITH2,4,Provincia Autonoma Trento,P.A. Trento,541380,62671,11.58,0.44
828,2021-01-07,PAT,1268,310,958,649,45,18,556,0,0,0,1268,0,ITH,ITH2,4,Provincia Autonoma Trento,P.A. Trento,541380,63939,11.81,0.23
829,2021-02-27,PAT,1022,455,567,445,12,16,0,434,4,111,599,423,ITH,ITH2,4,Provincia Autonoma Trento,P.A. Trento,541380,64961,12.0,0.19
830,2021-01-16,PAT,318,147,171,303,0,1,14,0,0,0,318,0,ITH,ITH2,4,Provincia Autonoma Trento,P.A. Trento,541380,65279,12.06,0.06
831,2021-01-01,PAT,207,49,158,110,11,0,86,0,0,0,207,0,ITH,ITH2,4,Provincia Autonoma Trento,P.A. Trento,541380,65486,12.1,0.04
832,2021-03-09,PAT,1537,578,959,95,42,24,28,1065,91,192,902,635,ITH,ITH2,4,Provincia Autonoma Trento,P.A. Trento,541380,67023,12.38,0.28
833,2021-02-11,PAT,1130,364,766,331,3,13,48,735,0,0,796,334,ITH,ITH2,4,Provincia Autonoma Trento,P.A. Trento,541380,68153,12.59,0.21
834,2021-03-19,PAT,2338,891,1447,278,63,889,37,1005,2,64,1522,816,ITH,ITH2,4,Provincia Autonoma Trento,P.A. Trento,541380,70491,13.02,0.43
835,2021-02-28,PAT,242,121,121,231,0,0,0,0,0,11,242,0,ITH,ITH2,4,Provincia Autonoma Trento,P.A. Trento,541380,70733,13.07,0.04
836,2020-12-30,PAT,6,2,4,4,1,0,1,0,0,0,6,0,ITH,ITH2,4,Provincia Autonoma Trento,P.A. Trento,541380,70739,13.07,0.0
837,2021-03-25,PAT,1945,788,1157,81,123,622,1,1099,2,17,1026,919,ITH,ITH2,4,Provincia Autonoma Trento,P.A. Trento,541380,72684,13.43,0.36
838,2021-01-26,PAT,497,138,359,397,15,1,84,0,0,0,25,472,ITH,ITH2,4,Provincia Autonoma Trento,P.A. Trento,541380,73181,13.52,0.09
839,2021-01-25,PAT,775,205,570,482,27,3,263,0,0,0,23,752,ITH,ITH2,4,Provincia Autonoma Trento,P.A. Trento,541380,73956,13.66,0.14
840,2021-02-08,PAT,1149,318,831,550,53,6,237,302,0,1,341,808,ITH,ITH2,4,Provincia Autonoma Trento,P.A. Trento,541380,75105,13.87,0.21
841,2021-01-31,PAT,74,15,59,55,13,0,6,0,0,0,0,74,ITH,ITH2,4,Provincia Autonoma Trento,P.A. Trento,541380,75179,13.89,0.01
842,2021-03-14,PAT,107,65,42,102,0,0,0,0,0,5,20,87,ITH,ITH2,4,Provincia Autonoma Trento,P.A. Trento,541380,75286,13.91,0.02
843,2021-01-27,PAT,734,257,477,395,33,1,304,1,0,0,73,661,ITH,ITH2,4,Provincia Autonoma Trento,P.A. Trento,541380,76020,14.04,0.14
844,2021-01-29,PAT,1350,331,1019,723,74,12,541,0,0,0,54,1296,ITH,ITH2,4,Provincia Autonoma Trento,P.A. Trento,541380,77370,14.29,0.25
845,2021-03-20,PAT,854,396,458,151,97,469,0,76,0,61,652,202,ITH,ITH2,4,Provincia Autonoma Trento,P.A. Trento,541380,78224,14.45,0.16
846,2021-01-17,PAT,251,195,56,251,0,0,0,0,0,0,251,0,ITH,ITH2,4,Provincia Autonoma Trento,P.A. Trento,541380,78475,14.5,0.05
847,2021-03-03,PAT,1641,618,1023,73,11,21,59,1255,19,203,1083,558,ITH,ITH2,4,Provincia Autonoma Trento,P.A. Trento,541380,80116,14.8,0.3
848,2021-01-13,PAT,420,123,297,391,6,0,23,0,0,0,420,0,ITH,ITH2,4,Provincia Autonoma Trento,P.A. Trento,541380,80536,14.88,0.08
849,2021-03-07,PAT,22,6,16,0,0,0,0,0,0,22,22,0,ITH,ITH2,4,Provincia Autonoma Trento,P.A. Trento,541380,80558,14.88,0.0
850,2021-02-06,PAT,573,297,276,178,0,8,0,387,0,0,433,140,ITH,ITH2,4,Provincia Autonoma Trento,P.A. Trento,541380,81131,14.99,0.11
851,2021-01-03,PAT,483,158,325,409,9,3,62,0,0,0,483,0,ITH,ITH2,4,Provincia Autonoma Trento,P.A. Trento,541380,81614,15.08,0.09
852,2021-02-14,PAT,246,186,60,246,0,0,0,0,0,0,11,235,ITH,ITH2,4,Provincia Autonoma Trento,P.A. Trento,541380,81860,15.12,0.05
853,2021-02-15,PAT,532,186,346,145,21,8,27,320,0,11,418,114,ITH,ITH2,4,Provincia Autonoma Trento,P.A. Trento,541380,82392,15.22,0.1
854,2021-02-28,SIC,7180,3072,4108,871,33,1279,93,3291,254,1359,6550,630,ITG,ITG1,19,Sicilia,Sicilia,4999891,7180,0.14,0.14
855,2021-02-11,SIC,5332,2103,3229,2458,307,1677,890,0,0,0,4868,464,ITG,ITG1,19,Sicilia,Sicilia,4999891,12512,0.25,0.11
856,2021-03-13,SIC,12435,5477,6958,1173,87,4170,493,4615,133,1764,7829,4606,ITG,ITG1,19,Sicilia,Sicilia,4999891,24947,0.5,0.25
857,2021-03-11,SIC,15444,6504,8940,1610,127,5065,906,3931,481,3324,12871,2573,ITG,ITG1,19,Sicilia,Sicilia,4999891,40391,0.81,0.31
858,2021-02-02,SIC,5540,2622,2918,3155,221,1735,429,0,0,0,633,4907,ITG,ITG1,19,Sicilia,Sicilia,4999891,45931,0.92,0.11
859,2021-03-15,SIC,10741,4708,6033,1239,48,2589,665,4830,216,1154,5669,5072,ITG,ITG1,19,Sicilia,Sicilia,4999891,56672,1.13,0.21
860,2021-01-28,SIC,9328,4399,4929,7464,221,1348,295,0,0,0,414,8914,ITG,ITG1,19,Sicilia,Sicilia,4999891,66000,1.32,0.19
861,2021-02-25,SIC,10158,5276,4882,1771,49,1654,507,3981,1525,671,8978,1180,ITG,ITG1,19,Sicilia,Sicilia,4999891,76158,1.52,0.2
862,2021-03-03,SIC,14701,6544,8157,2408,130,2201,507,4295,1330,3830,11616,3085,ITG,ITG1,19,Sicilia,Sicilia,4999891,90859,1.82,0.29
863,2021-02-01,SIC,6077,2684,3393,4168,214,1377,318,0,0,0,304,5773,ITG,ITG1,19,Sicilia,Sicilia,4999891,96936,1.94,0.12
864,2021-01-04,SIC,8373,4172,4201,7595,20,752,6,0,0,0,8373,0,ITG,ITG1,19,Sicilia,Sicilia,4999891,105309,2.11,0.17
865,2021-02-15,SIC,3951,1862,2089,1700,108,1237,563,10,307,26,3382,569,ITG,ITG1,19,Sicilia,Sicilia,4999891,109260,2.19,0.08
866,2021-02-19,SIC,5160,2757,2403,1487,183,1181,600,74,1396,239,4589,571,ITG,ITG1,19,Sicilia,Sicilia,4999891,114420,2.29,0.1
867,2021-02-04,SIC,6877,3159,3718,4417,172,1748,540,0,0,0,1460,5417,ITG,ITG1,19,Sicilia,Sicilia,4999891,121297,2.43,0.14
868,2021-01-16,SIC,2776,1195,1581,1329,165,984,298,0,0,0,2776,0,ITG,ITG1,19,Sicilia,Sicilia,4999891,124073,2.48,0.06
869,2021-01-23,SIC,4149,2147,2002,3912,33,188,16,0,0,0,225,3924,ITG,ITG1,19,Sicilia,Sicilia,4999891,128222,2.56,0.08
870,2021-01-11,SIC,5903,2590,3313,3923,194,1404,382,0,0,0,5903,0,ITG,ITG1,19,Sicilia,Sicilia,4999891,134125,2.68,0.12
871,2021-03-24,SIC,21024,9824,11200,955,64,12062,549,5846,86,1462,15138,5886,ITG,ITG1,19,Sicilia,Sicilia,4999891,155149,3.1,0.42
872,2021-01-15,SIC,5079,2233,2846,2824,158,1618,479,0,0,0,5079,0,ITG,ITG1,19,Sicilia,Sicilia,4999891,160228,3.2,0.1
873,2021-03-07,SIC,9270,3459,5811,968,62,903,431,3393,216,3297,8186,1084,ITG,ITG1,19,Sicilia,Sicilia,4999891,169498,3.39,0.19
874,2020-12-28,SIC,207,124,83,205,0,2,0,0,0,0,207,0,ITG,ITG1,19,Sicilia,Sicilia,4999891,169705,3.39,0.0
875,2021-01-29,SIC,9360,4321,5039,7151,174,1730,305,0,0,0,432,8928,ITG,ITG1,19,Sicilia,Sicilia,4999891,179065,3.58,0.19
876,2021-01-22,SIC,1235,625,610,1035,13,69,118,0,0,0,242,993,ITG,ITG1,19,Sicilia,Sicilia,4999891,180300,3.61,0.02
877,2021-03-18,SIC,15583,7764,7819,1284,80,8166,598,5357,61,37,9871,5712,ITG,ITG1,19,Sicilia,Sicilia,4999891,195883,3.92,0.31
878,2021-03-16,SIC,10168,4462,5706,1662,105,1628,810,5677,68,218,4016,6152,ITG,ITG1,19,Sicilia,Sicilia,4999891,206051,4.12,0.2
879,2021-01-17,SIC,1295,584,711,619,118,398,160,0,0,0,1245,50,ITG,ITG1,19,Sicilia,Sicilia,4999891,207346,4.15,0.03
880,2020-12-29,SIC,235,146,89,235,0,0,0,0,0,0,235,0,ITG,ITG1,19,Sicilia,Sicilia,4999891,207581,4.15,0.0
881,2021-03-06,SIC,12936,5172,7764,2003,127,1873,758,3887,638,3650,10030,2906,ITG,ITG1,19,Sicilia,Sicilia,4999891,220517,4.41,0.26
882,2021-03-22,SIC,16806,7915,8891,913,19,8677,356,5541,71,1229,11263,5543,ITG,ITG1,19,Sicilia,Sicilia,4999891,237323,4.75,0.34
883,2021-02-08,SIC,4086,1759,2327,2346,188,1155,397,0,0,0,2128,1958,ITG,ITG1,19,Sicilia,Sicilia,4999891,241409,4.83,0.08
884,2021-01-07,SIC,9173,4239,4934,7694,70,1199,210,0,0,0,9173,0,ITG,ITG1,19,Sicilia,Sicilia,4999891,250582,5.01,0.18
885,2021-03-08,SIC,13499,5780,7719,2011,113,1992,626,3836,920,4001,10686,2813,ITG,ITG1,19,Sicilia,Sicilia,4999891,264081,5.28,0.27
886,2021-02-18,SIC,5495,3174,2321,1635,165,1080,813,9,1697,96,5064,431,ITG,ITG1,19,Sicilia,Sicilia,4999891,269576,5.39,0.11
887,2021-01-18,SIC,1548,646,902,721,68,551,208,0,0,0,1432,116,ITG,ITG1,19,Sicilia,Sicilia,4999891,271124,5.42,0.03
888,2021-02-21,SIC,5178,2508,2670,379,30,622,174,3682,138,153,5070,108,ITG,ITG1,19,Sicilia,Sicilia,4999891,276302,5.53,0.1
889,2021-02-12,SIC,4746,1853,2893,2301,260,1542,643,0,0,0,4415,331,ITG,ITG1,19,Sicilia,Sicilia,4999891,281048,5.62,0.09
890,2021-01-27,SIC,7531,3835,3696,6329,66,984,152,0,0,0,189,7342,ITG,ITG1,19,Sicilia,Sicilia,4999891,288579,5.77,0.15
891,2021-01-01,SIC,815,437,378,740,0,75,0,0,0,0,815,0,ITG,ITG1,19,Sicilia,Sicilia,4999891,289394,5.79,0.02
892,2021-03-12,SIC,13115,5616,7499,1386,110,4408,695,3765,344,2407,10892,2223,ITG,ITG1,19,Sicilia,Sicilia,4999891,302509,6.05,0.26
893,2021-02-27,SIC,12450,5570,6880,1515,72,2351,277,3843,1021,3371,11239,1211,ITG,ITG1,19,Sicilia,Sicilia,4999891,314959,6.3,0.25
894,2021-02-17,SIC,5432,3293,2139,1530,118,1009,880,8,1885,2,4758,674,ITG,ITG1,19,Sicilia,Sicilia,4999891,320391,6.41,0.11
895,2021-01-30,SIC,7837,3569,4268,5450,253,1659,475,0,0,0,175,7662,ITG,ITG1,19,Sicilia,Sicilia,4999891,328228,6.56,0.16
896,2021-01-14,SIC,5250,2514,2736,3046,91,1854,259,0,0,0,5250,0,ITG,ITG1,19,Sicilia,Sicilia,4999891,333478,6.67,0.11
897,2021-03-21,SIC,15200,7323,7877,489,10,9092,57,4502,92,958,11226,3974,ITG,ITG1,19,Sicilia,Sicilia,4999891,348678,6.97,0.3
898,2021-01-24,SIC,4335,2262,2073,3990,31,311,3,0,0,0,148,4187,ITG,ITG1,19,Sicilia,Sicilia,4999891,353013,7.06,0.09
899,2021-02-05,SIC,7216,3232,3984,3618,267,2475,856,0,0,0,2132,5084,ITG,ITG1,19,Sicilia,Sicilia,4999891,360229,7.2,0.14
900,2021-02-26,SIC,12246,5977,6269,1836,74,1898,361,3891,1733,2453,10557,1689,ITG,ITG1,19,Sicilia,Sicilia,4999891,372475,7.45,0.24
901,2020-12-30,SIC,173,101,72,156,3,14,0,0,0,0,173,0,ITG,ITG1,19,Sicilia,Sicilia,4999891,372648,7.45,0.0
902,2021-02-16,SIC,4414,2300,2114,1465,207,1080,779,25,857,1,3947,467,ITG,ITG1,19,Sicilia,Sicilia,4999891,377062,7.54,0.09
903,2021-01-09,SIC,7325,3424,3901,5034,146,1689,456,0,0,0,7325,0,ITG,ITG1,19,Sicilia,Sicilia,4999891,384387,7.69,0.15
904,2021-02-24,SIC,9600,4869,4731,1423,80,1173,499,4028,1474,923,9004,596,ITG,ITG1,19,Sicilia,Sicilia,4999891,393987,7.88,0.19
905,2021-02-13,SIC,3107,1168,1939,1296,160,1081,570,0,0,0,2850,257,ITG,ITG1,19,Sicilia,Sicilia,4999891,397094,7.94,0.06
906,2021-03-09,SIC,13042,5480,7562,1593,132,2160,584,3943,939,3691,10669,2373,ITG,ITG1,19,Sicilia,Sicilia,4999891,410136,8.2,0.26
907,2021-01-25,SIC,7512,3697,3815,6634,14,794,70,0,0,0,322,7190,ITG,ITG1,19,Sicilia,Sicilia,4999891,417648,8.35,0.15
908,2021-03-20,SIC,18900,9075,9825,836,43,10835,413,5475,79,1219,13510,5390,ITG,ITG1,19,Sicilia,Sicilia,4999891,436548,8.73,0.38
909,2021-03-23,SIC,20942,10040,10902,873,41,11886,365,5824,306,1647,15337,5605,ITG,ITG1,19,Sicilia,Sicilia,4999891,457490,9.15,0.42
910,2021-01-31,SIC,4111,1958,2153,2600,117,1099,295,0,0,0,113,3998,ITG,ITG1,19,Sicilia,Sicilia,4999891,461601,9.23,0.08
911,2021-02-10,SIC,4433,1819,2614,1975,221,1496,741,0,0,0,4008,425,ITG,ITG1,19,Sicilia,Sicilia,4999891,466034,9.32,0.09
912,2021-01-13,SIC,5204,2462,2742,3033,169,1561,441,0,0,0,5204,0,ITG,ITG1,19,Sicilia,Sicilia,4999891,471238,9.42,0.1
913,2021-03-05,SIC,15894,6851,9043,3190,153,2334,712,3998,1423,4084,11569,4325,ITG,ITG1,19,Sicilia,Sicilia,4999891,487132,9.74,0.32
914,2021-03-04,SIC,15197,6550,8647,2811,186,2622,698,3927,1124,3829,10993,4204,ITG,ITG1,19,Sicilia,Sicilia,4999891,502329,10.05,0.3
915,2021-02-23,SIC,8947,4688,4259,1267,103,1133,502,3996,1367,579,8457,490,ITG,ITG1,19,Sicilia,Sicilia,4999891,511276,10.23,0.18
916,2021-02-07,SIC,2348,996,1352,1610,109,472,157,0,0,0,675,1673,ITG,ITG1,19,Sicilia,Sicilia,4999891,513624,10.27,0.05
917,2021-03-02,SIC,14955,6388,8567,2383,98,1831,500,4471,1338,4334,12130,2825,ITG,ITG1,19,Sicilia,Sicilia,4999891,528579,10.57,0.3
918,2021-03-14,SIC,8818,3944,4874,569,42,3037,176,4280,36,678,4961,3857,ITG,ITG1,19,Sicilia,Sicilia,4999891,537397,10.75,0.18
919,2021-03-19,SIC,16484,8112,8372,1261,101,8712,561,5351,42,456,10757,5727,ITG,ITG1,19,Sicilia,Sicilia,4999891,553881,11.08,0.33
920,2021-01-03,SIC,4693,2454,2239,4361,0,332,0,0,0,0,4693,0,ITG,ITG1,19,Sicilia,Sicilia,4999891,558574,11.17,0.09
921,2021-02-03,SIC,6102,2857,3245,3358,151,1969,624,0,0,0,756,5346,ITG,ITG1,19,Sicilia,Sicilia,4999891,564676,11.29,0.12
922,2021-03-25,SIC,20386,9474,10912,1324,76,11433,582,5509,82,1380,14871,5515,ITG,ITG1,19,Sicilia,Sicilia,4999891,585062,11.7,0.41
923,2021-01-06,SIC,6471,3402,3069,5717,24,728,2,0,0,0,6471,0,ITG,ITG1,19,Sicilia,Sicilia,4999891,591533,11.83,0.13
924,2021-03-01,SIC,12978,6129,6849,1557,75,1735,392,4302,1764,3153,11319,1659,ITG,ITG1,19,Sicilia,Sicilia,4999891,604511,12.09,0.26
925,2021-01-12,SIC,4542,2234,2308,2863,128,1356,195,0,0,0,4542,0,ITG,ITG1,19,Sicilia,Sicilia,4999891,609053,12.18,0.09
926,2021-01-05,SIC,10527,5159,5368,9074,122,1124,207,0,0,0,10527,0,ITG,ITG1,19,Sicilia,Sicilia,4999891,619580,12.39,0.21
927,2020-12-31,SIC,877,469,408,827,0,50,0,0,0,0,877,0,ITG,ITG1,19,Sicilia,Sicilia,4999891,620457,12.41,0.02
928,2021-01-26,SIC,9515,4679,4836,8379,72,810,254,0,0,0,265,9250,ITG,ITG1,19,Sicilia,Sicilia,4999891,629972,12.6,0.19
929,2021-02-06,SIC,5066,2225,2841,2535,251,1688,592,0,0,0,1488,3578,ITG,ITG1,19,Sicilia,Sicilia,4999891,635038,12.7,0.1
930,2021-01-08,SIC,8328,3864,4464,6591,87,1437,213,0,0,0,8328,0,ITG,ITG1,19,Sicilia,Sicilia,4999891,643366,12.87,0.17
931,2021-01-21,SIC,1328,647,681,1001,86,104,137,0,0,0,499,829,ITG,ITG1,19,Sicilia,Sicilia,4999891,644694,12.89,0.03
932,2021-02-20,SIC,7284,3736,3548,848,76,1258,558,3749,620,175,7033,251,ITG,ITG1,19,Sicilia,Sicilia,4999891,651978,13.04,0.15
933,2021-01-19,SIC,1271,521,750,521,59,453,238,0,0,0,1093,178,ITG,ITG1,19,Sicilia,Sicilia,4999891,653249,13.07,0.03
934,2021-03-10,SIC,13838,5879,7959,1479,134,2867,933,4061,646,3718,11448,2390,ITG,ITG1,19,Sicilia,Sicilia,4999891,667087,13.34,0.28
935,2020-12-27,SIC,89,54,35,62,0,2,25,0,0,0,89,0,ITG,ITG1,19,Sicilia,Sicilia,4999891,667176,13.34,0.0
936,2021-01-20,SIC,808,410,398,422,51,143,192,0,0,0,573,235,ITG,ITG1,19,Sicilia,Sicilia,4999891,667984,13.36,0.02
937,2021-01-02,SIC,4872,2533,2339,4311,0,561,0,0,0,0,4872,0,ITG,ITG1,19,Sicilia,Sicilia,4999891,672856,13.46,0.1
938,2021-02-14,SIC,1057,402,655,433,58,330,236,0,0,0,917,140,ITG,ITG1,19,Sicilia,Sicilia,4999891,673913,13.48,0.02
939,2021-02-09,SIC,4371,1831,2540,2241,155,1335,640,0,0,0,3365,1006,ITG,ITG1,19,Sicilia,Sicilia,4999891,678284,13.57,0.09
940,2021-03-17,SIC,15389,7550,7839,1401,100,7154,664,5721,43,306,9445,5944,ITG,ITG1,19,Sicilia,Sicilia,4999891,693673,13.87,0.31
941,2021-02-22,SIC,8036,4160,3876,1107,34,902,554,4065,1053,321,7544,492,ITG,ITG1,19,Sicilia,Sicilia,4999891,701709,14.03,0.16
942,2021-01-10,SIC,3618,1615,2003,2126,125,903,464,0,0,0,3618,0,ITG,ITG1,19,Sicilia,Sicilia,4999891,705327,14.11,0.07
943,2021-03-10,MAR,5778,2488,3290,721,22,799,101,2673,424,1038,4641,1137,ITI,ITI3,11,Marche,Marche,1525271,5778,0.38,0.38
944,2021-01-18,MAR,673,230,443,370,5,166,132,0,0,0,547,126,ITI,ITI3,11,Marche,Marche,1525271,6451,0.42,0.04
945,2021-02-19,MAR,1971,716,1255,1273,11,481,203,1,0,2,1836,135,ITI,ITI3,11,Marche,Marche,1525271,8422,0.55,0.13
946,2021-02-05,MAR,2156,653,1503,1317,20,400,419,0,0,0,440,1716,ITI,ITI3,11,Marche,Marche,1525271,10578,0.69,0.14
947,2021-02-03,MAR,2125,742,1383,1344,2,613,166,0,0,0,119,2006,ITI,ITI3,11,Marche,Marche,1525271,12703,0.83,0.14
948,2021-01-15,MAR,1771,500,1271,985,60,360,366,0,0,0,1771,0,ITI,ITI3,11,Marche,Marche,1525271,14474,0.95,0.12
949,2021-01-04,MAR,1500,563,937,1290,36,163,11,0,0,0,1500,0,ITI,ITI3,11,Marche,Marche,1525271,15974,1.05,0.1
950,2021-03-15,MAR,4489,2109,2380,300,4,469,8,3453,14,241,1422,3067,ITI,ITI3,11,Marche,Marche,1525271,20463,1.34,0.29
951,2021-02-02,MAR,1193,397,796,804,17,279,93,0,0,0,73,1120,ITI,ITI3,11,Marche,Marche,1525271,21656,1.42,0.08
952,2021-02-08,MAR,833,258,575,408,21,142,262,0,0,0,371,462,ITI,ITI3,11,Marche,Marche,1525271,22489,1.47,0.05
953,2021-01-05,MAR,1562,586,976,1436,0,126,0,0,0,0,1562,0,ITI,ITI3,11,Marche,Marche,1525271,24051,1.58,0.1
954,2021-01-27,MAR,2120,780,1340,1754,7,219,140,0,0,0,122,1998,ITI,ITI3,11,Marche,Marche,1525271,26171,1.72,0.14
955,2021-02-20,MAR,4127,1708,2419,118,24,387,261,3334,3,0,4016,111,ITI,ITI3,11,Marche,Marche,1525271,30298,1.99,0.27
956,2021-03-20,MAR,4146,1745,2401,181,8,110,111,3641,6,89,1054,3092,ITI,ITI3,11,Marche,Marche,1525271,34444,2.26,0.27
957,2021-02-18,MAR,2104,746,1358,1150,41,509,402,1,0,1,1816,288,ITI,ITI3,11,Marche,Marche,1525271,36548,2.4,0.14
958,2021-02-10,MAR,1439,452,987,881,26,317,215,0,0,0,1080,359,ITI,ITI3,11,Marche,Marche,1525271,37987,2.49,0.09
959,2021-01-31,MAR,1927,772,1155,1532,0,395,0,0,0,0,105,1822,ITI,ITI3,11,Marche,Marche,1525271,39914,2.62,0.13
960,2021-01-13,MAR,2105,746,1359,1408,11,610,76,0,0,0,2105,0,ITI,ITI3,11,Marche,Marche,1525271,42019,2.75,0.14
961,2021-02-06,MAR,2460,900,1560,1402,40,603,415,0,0,0,523,1937,ITI,ITI3,11,Marche,Marche,1525271,44479,2.92,0.16
962,2021-01-21,MAR,896,253,643,460,41,59,336,0,0,0,585,311,ITI,ITI3,11,Marche,Marche,1525271,45375,2.97,0.06
963,2021-03-21,MAR,4511,1878,2633,87,0,109,54,4046,10,205,1631,2880,ITI,ITI3,11,Marche,Marche,1525271,49886,3.27,0.3
964,2021-01-03,MAR,896,348,548,759,0,137,0,0,0,0,896,0,ITI,ITI3,11,Marche,Marche,1525271,50782,3.33,0.06
965,2021-01-24,MAR,891,342,549,772,0,119,0,0,0,0,17,874,ITI,ITI3,11,Marche,Marche,1525271,51673,3.39,0.06
966,2021-01-08,MAR,1574,588,986,1226,0,348,0,0,0,0,1574,0,ITI,ITI3,11,Marche,Marche,1525271,53247,3.49,0.1
967,2021-01-26,MAR,2016,746,1270,1736,1,193,86,0,0,0,92,1924,ITI,ITI3,11,Marche,Marche,1525271,55263,3.62,0.13
968,2020-12-31,MAR,383,178,205,370,0,13,0,0,0,0,383,0,ITI,ITI3,11,Marche,Marche,1525271,55646,3.65,0.03
969,2021-02-14,MAR,738,301,437,578,2,158,0,0,0,0,738,0,ITI,ITI3,11,Marche,Marche,1525271,56384,3.7,0.05
970,2021-03-18,MAR,3445,1514,1931,326,6,258,123,2653,76,3,216,3229,ITI,ITI3,11,Marche,Marche,1525271,59829,3.92,0.23
971,2021-02-25,MAR,3563,1447,2116,432,6,207,423,2491,3,1,3384,179,ITI,ITI3,11,Marche,Marche,1525271,63392,4.16,0.23
972,2020-12-27,MAR,200,97,103,184,4,8,4,0,0,0,200,0,ITI,ITI3,11,Marche,Marche,1525271,63592,4.17,0.01
973,2021-03-01,MAR,3727,1489,2238,387,6,171,82,2790,5,286,3480,247,ITI,ITI3,11,Marche,Marche,1525271,67319,4.41,0.24
974,2021-02-04,MAR,2342,810,1532,1406,54,607,275,0,0,0,112,2230,ITI,ITI3,11,Marche,Marche,1525271,69661,4.57,0.15
975,2021-02-09,MAR,125,42,83,78,0,21,26,0,0,0,47,78,ITI,ITI3,11,Marche,Marche,1525271,69786,4.58,0.01
976,2021-02-24,MAR,3442,1506,1936,226,11,224,166,2811,3,1,3362,80,ITI,ITI3,11,Marche,Marche,1525271,73228,4.8,0.23
977,2020-12-30,MAR,17,5,12,14,0,3,0,0,0,0,17,0,ITI,ITI3,11,Marche,Marche,1525271,73245,4.8,0.0
978,2021-01-17,MAR,1598,682,916,964,14,574,46,0,0,0,1549,49,ITI,ITI3,11,Marche,Marche,1525271,74843,4.91,0.1
979,2021-01-09,MAR,1709,605,1104,1406,0,303,0,0,0,0,1709,0,ITI,ITI3,11,Marche,Marche,1525271,76552,5.02,0.11
980,2021-02-12,MAR,1583,618,965,815,11,669,88,0,0,0,1431,152,ITI,ITI3,11,Marche,Marche,1525271,78135,5.12,0.1
981,2021-03-16,MAR,3577,1549,2028,317,3,193,54,2928,77,5,394,3183,ITI,ITI3,11,Marche,Marche,1525271,81712,5.36,0.23
982,2021-02-22,MAR,3414,1499,1915,326,10,398,77,2596,5,2,3339,75,ITI,ITI3,11,Marche,Marche,1525271,85126,5.58,0.22
983,2021-02-11,MAR,1988,658,1330,1155,15,606,212,0,0,0,1599,389,ITI,ITI3,11,Marche,Marche,1525271,87114,5.71,0.13
984,2021-02-13,MAR,1064,455,609,457,28,489,90,0,0,0,1012,52,ITI,ITI3,11,Marche,Marche,1525271,88178,5.78,0.07
985,2021-03-04,MAR,6621,2972,3649,1064,8,930,106,2800,944,769,5227,1394,ITI,ITI3,11,Marche,Marche,1525271,94799,6.22,0.43
986,2021-02-27,MAR,3374,1440,1934,186,9,163,161,2848,6,1,3165,209,ITI,ITI3,11,Marche,Marche,1525271,98173,6.44,0.22
987,2021-01-06,MAR,2181,792,1389,1738,40,256,147,0,0,0,2181,0,ITI,ITI3,11,Marche,Marche,1525271,100354,6.58,0.14
988,2021-03-14,MAR,2515,1036,1479,442,0,80,0,1535,2,456,1917,598,ITI,ITI3,11,Marche,Marche,1525271,102869,6.74,0.16
989,2021-02-23,MAR,3274,1400,1874,219,4,133,116,2794,8,0,3218,56,ITI,ITI3,11,Marche,Marche,1525271,106143,6.96,0.21
990,2021-01-25,MAR,1596,559,1037,1426,12,102,56,0,0,0,97,1499,ITI,ITI3,11,Marche,Marche,1525271,107739,7.06,0.1
991,2021-01-07,MAR,1802,633,1169,1480,0,322,0,0,0,0,1802,0,ITI,ITI3,11,Marche,Marche,1525271,109541,7.18,0.12
992,2021-03-19,MAR,3843,1598,2245,495,1,233,267,2837,4,6,343,3500,ITI,ITI3,11,Marche,Marche,1525271,113384,7.43,0.25
993,2021-02-28,MAR,2839,1250,1589,19,0,18,0,2798,2,2,2833,6,ITI,ITI3,11,Marche,Marche,1525271,116223,7.62,0.19
994,2021-03-25,MAR,6482,2703,3779,464,12,797,365,4282,43,519,3091,3391,ITI,ITI3,11,Marche,Marche,1525271,122705,8.04,0.42
995,2021-02-16,MAR,1292,475,817,737,8,455,92,0,0,0,1262,30,ITI,ITI3,11,Marche,Marche,1525271,123997,8.13,0.08
996,2021-01-23,MAR,557,190,367,440,14,40,63,0,0,0,123,434,ITI,ITI3,11,Marche,Marche,1525271,124554,8.17,0.04
997,2021-01-12,MAR,1226,413,813,912,0,264,50,0,0,0,1226,0,ITI,ITI3,11,Marche,Marche,1525271,125780,8.25,0.08
998,2021-03-05,MAR,6283,2951,3332,1128,13,864,143,2375,958,802,4816,1467,ITI,ITI3,11,Marche,Marche,1525271,132063,8.66,0.41
999,2021-01-22,MAR,487,167,320,315,19,66,87,0,0,0,194,293,ITI,ITI3,11,Marche,Marche,1525271,132550,8.69,0.03
1000,2021-03-03,MAR,6758,3091,3667,818,23,798,254,3133,949,783,5877,881,ITI,ITI3,11,Marche,Marche,1525271,139308,9.13,0.44
1001,2021-02-21,MAR,377,142,235,204,1,114,57,0,0,1,376,1,ITI,ITI3,11,Marche,Marche,1525271,139685,9.16,0.02
1002,2021-01-02,MAR,453,139,314,444,0,9,0,0,0,0,453,0,ITI,ITI3,11,Marche,Marche,1525271,140138,9.19,0.03
1003,2021-02-15,MAR,973,413,560,544,60,368,1,0,0,0,960,13,ITI,ITI3,11,Marche,Marche,1525271,141111,9.25,0.06
1004,2021-03-09,MAR,5529,2373,3156,754,8,461,36,2588,612,1070,4640,889,ITI,ITI3,11,Marche,Marche,1525271,146640,9.61,0.36
1005,2021-03-22,MAR,5660,2378,3282,407,8,448,69,4182,113,433,2531,3129,ITI,ITI3,11,Marche,Marche,1525271,152300,9.99,0.37
1006,2021-01-16,MAR,2006,723,1283,1059,43,619,285,0,0,0,2006,0,ITI,ITI3,11,Marche,Marche,1525271,154306,10.12,0.13
1007,2021-03-12,MAR,4711,2015,2696,820,10,718,0,1904,330,929,3466,1245,ITI,ITI3,11,Marche,Marche,1525271,159017,10.43,0.31
1008,2021-03-07,MAR,5183,2108,3075,607,2,355,0,3007,316,896,4430,753,ITI,ITI3,11,Marche,Marche,1525271,164200,10.77,0.34
1009,2021-03-23,MAR,5783,2524,3259,259,9,329,127,4587,144,328,2246,3537,ITI,ITI3,11,Marche,Marche,1525271,169983,11.14,0.38
1010,2021-01-28,MAR,1973,659,1314,1581,0,291,101,0,0,0,167,1806,ITI,ITI3,11,Marche,Marche,1525271,171956,11.27,0.13
1011,2021-03-08,MAR,6363,2805,3558,768,14,604,219,3101,643,1014,5361,1002,ITI,ITI3,11,Marche,Marche,1525271,178319,11.69,0.42
1012,2021-02-01,MAR,1365,480,885,1057,1,226,81,0,0,0,98,1267,ITI,ITI3,11,Marche,Marche,1525271,179684,11.78,0.09
1013,2021-01-29,MAR,1991,730,1261,1479,4,434,74,0,0,0,168,1823,ITI,ITI3,11,Marche,Marche,1525271,181675,11.91,0.13
1014,2021-01-20,MAR,398,99,299,146,15,47,190,0,0,0,386,12,ITI,ITI3,11,Marche,Marche,1525271,182073,11.94,0.03
1015,2021-01-10,MAR,1737,699,1038,1462,0,275,0,0,0,0,1737,0,ITI,ITI3,11,Marche,Marche,1525271,183810,12.05,0.11
1016,2021-03-24,MAR,6918,2945,3973,483,20,844,187,4728,64,592,3277,3641,ITI,ITI3,11,Marche,Marche,1525271,190728,12.5,0.45
1017,2021-03-17,MAR,3435,1497,1938,301,5,178,117,2822,7,5,111,3324,ITI,ITI3,11,Marche,Marche,1525271,194163,12.73,0.23
1018,2021-03-06,MAR,5731,2646,3085,973,4,833,125,2400,649,747,4463,1268,ITI,ITI3,11,Marche,Marche,1525271,199894,13.11,0.38
1019,2021-02-07,MAR,1871,735,1136,1156,5,664,46,0,0,0,344,1527,ITI,ITI3,11,Marche,Marche,1525271,201765,13.23,0.12
1020,2021-02-17,MAR,1791,664,1127,968,24,498,300,1,0,0,1672,119,ITI,ITI3,11,Marche,Marche,1525271,203556,13.35,0.12
1021,2021-02-26,MAR,3635,1502,2133,449,34,205,385,2519,4,39,3159,476,ITI,ITI3,11,Marche,Marche,1525271,207191,13.58,0.24
1022,2021-01-11,MAR,1176,411,765,1021,2,153,0,0,0,0,1176,0,ITI,ITI3,11,Marche,Marche,1525271,208367,13.66,0.08
1023,2021-01-30,MAR,1908,669,1239,1566,0,342,0,0,0,0,29,1879,ITI,ITI3,11,Marche,Marche,1525271,210275,13.79,0.13
1024,2021-01-14,MAR,2010,692,1318,1112,67,533,298,0,0,0,2010,0,ITI,ITI3,11,Marche,Marche,1525271,212285,13.92,0.13
1025,2021-03-13,MAR,5713,2554,3159,664,21,353,57,4248,133,237,1752,3961,ITI,ITI3,11,Marche,Marche,1525271,217998,14.29,0.37
1026,2021-01-19,MAR,225,81,144,120,0,20,85,0,0,0,141,84,ITI,ITI3,11,Marche,Marche,1525271,218223,14.31,0.01
1027,2021-03-11,MAR,6831,2929,3902,1094,11,910,38,3227,403,1148,5460,1371,ITI,ITI3,11,Marche,Marche,1525271,225054,14.76,0.45
1028,2021-03-02,MAR,4965,1943,3022,589,24,251,242,3318,3,538,4399,566,ITI,ITI3,11,Marche,Marche,1525271,230019,15.08,0.33
1029,2021-01-17,SAR,860,277,583,747,113,0,0,0,0,0,859,1,ITG,ITG2,20,Sardegna,Sardegna,1639591,860,0.05,0.05
1030,2021-03-19,SAR,6793,2799,3994,1315,444,1517,222,3096,189,10,4578,2215,ITG,ITG2,20,Sardegna,Sardegna,1639591,7653,0.47,0.41
1031,2021-01-16,SAR,1492,525,967,1282,165,44,0,0,0,1,1492,0,ITG,ITG2,20,Sardegna,Sardegna,1639591,9145,0.56,0.09
1032,2021-02-09,SAR,2286,837,1449,1308,408,71,497,1,0,1,1290,996,ITG,ITG2,20,Sardegna,Sardegna,1639591,11431,0.7,0.14
1033,2021-02-21,SAR,1585,710,875,66,25,8,59,1421,6,0,1555,30,ITG,ITG2,20,Sardegna,Sardegna,1639591,13016,0.79,0.1
1034,2021-03-06,SAR,2535,1046,1489,1086,531,391,405,7,79,36,852,1683,ITG,ITG2,20,Sardegna,Sardegna,1639591,15551,0.95,0.15
1035,2021-02-17,SAR,1406,576,830,689,292,85,313,0,27,0,1332,74,ITG,ITG2,20,Sardegna,Sardegna,1639591,16957,1.03,0.09
1036,2021-03-03,SAR,3742,2036,1706,1058,273,443,525,702,740,1,2604,1138,ITG,ITG2,20,Sardegna,Sardegna,1639591,20699,1.26,0.23
1037,2021-02-16,SAR,700,289,411,376,135,77,112,0,0,0,673,27,ITG,ITG2,20,Sardegna,Sardegna,1639591,21399,1.31,0.04
1038,2021-01-09,SAR,4026,1417,2609,3181,602,243,0,0,0,0,4026,0,ITG,ITG2,20,Sardegna,Sardegna,1639591,25425,1.55,0.25
1039,2021-01-29,SAR,2951,1067,1884,2580,226,142,3,0,0,0,48,2903,ITG,ITG2,20,Sardegna,Sardegna,1639591,28376,1.73,0.18
1040,2021-01-28,SAR,2968,1044,1924,2554,327,76,0,0,11,0,69,2899,ITG,ITG2,20,Sardegna,Sardegna,1639591,31344,1.91,0.18
1041,2021-01-10,SAR,2183,750,1433,1632,228,323,0,0,0,0,2183,0,ITG,ITG2,20,Sardegna,Sardegna,1639591,33527,2.04,0.13
1042,2021-03-17,SAR,6093,2620,3473,1074,452,950,528,2958,3,128,4484,1609,ITG,ITG2,20,Sardegna,Sardegna,1639591,39620,2.42,0.37
1043,2021-03-05,SAR,4959,2428,2531,1692,774,587,669,567,660,10,2671,2288,ITG,ITG2,20,Sardegna,Sardegna,1639591,44579,2.72,0.3
1044,2021-01-11,SAR,1183,505,678,656,139,387,0,1,0,0,1183,0,ITG,ITG2,20,Sardegna,Sardegna,1639591,45762,2.79,0.07
1045,2021-01-25,SAR,588,212,376,553,29,6,0,0,0,0,22,566,ITG,ITG2,20,Sardegna,Sardegna,1639591,46350,2.83,0.04
1046,2021-03-20,SAR,5003,1989,3014,695,255,355,127,2611,105,855,2727,2276,ITG,ITG2,20,Sardegna,Sardegna,1639591,51353,3.13,0.31
1047,2021-02-24,SAR,2410,1292,1118,1193,311,303,301,3,299,0,2221,189,ITG,ITG2,20,Sardegna,Sardegna,1639591,53763,3.28,0.15
1048,2021-01-31,SAR,2121,750,1371,1544,128,448,0,1,0,0,48,2073,ITG,ITG2,20,Sardegna,Sardegna,1639591,55884,3.41,0.13
1049,2021-01-26,SAR,1336,453,883,1296,27,12,0,0,0,1,27,1309,ITG,ITG2,20,Sardegna,Sardegna,1639591,57220,3.49,0.08
1050,2021-03-22,SAR,3489,1320,2169,838,151,412,109,778,66,1135,2976,513,ITG,ITG2,20,Sardegna,Sardegna,1639591,60709,3.7,0.21
1051,2021-01-22,SAR,83,47,36,45,38,0,0,0,0,0,55,28,ITG,ITG2,20,Sardegna,Sardegna,1639591,60792,3.71,0.01
1052,2021-03-12,SAR,5732,2400,3332,1037,482,778,456,2549,271,159,4423,1309,ITG,ITG2,20,Sardegna,Sardegna,1639591,66524,4.06,0.35
1053,2021-02-01,SAR,1524,605,919,896,151,400,77,0,0,0,225,1299,ITG,ITG2,20,Sardegna,Sardegna,1639591,68048,4.15,0.09
1054,2021-03-25,SAR,7515,3133,4382,806,152,1484,188,3086,248,1551,6335,1180,ITG,ITG2,20,Sardegna,Sardegna,1639591,75563,4.61,0.46
1055,2021-02-10,SAR,1959,765,1194,1169,245,56,488,0,0,1,1441,518,ITG,ITG2,20,Sardegna,Sardegna,1639591,77522,4.73,0.12
1056,2021-03-08,SAR,3965,1777,2188,732,492,668,624,852,444,153,2776,1189,ITG,ITG2,20,Sardegna,Sardegna,1639591,81487,4.97,0.24
1057,2021-02-12,SAR,2237,933,1304,986,660,89,501,1,0,0,2178,59,ITG,ITG2,20,Sardegna,Sardegna,1639591,83724,5.11,0.14
1058,2021-01-15,SAR,1563,573,990,1170,338,52,0,0,3,0,1563,0,ITG,ITG2,20,Sardegna,Sardegna,1639591,85287,5.2,0.1
1059,2021-02-28,SAR,368,169,199,245,69,7,47,0,0,0,142,226,ITG,ITG2,20,Sardegna,Sardegna,1639591,85655,5.22,0.02
1060,2021-01-14,SAR,1105,426,679,885,167,53,0,0,0,0,1105,0,ITG,ITG2,20,Sardegna,Sardegna,1639591,86760,5.29,0.07
1061,2021-01-23,SAR,60,22,38,60,0,0,0,0,0,0,0,60,ITG,ITG2,20,Sardegna,Sardegna,1639591,86820,5.3,0.0
1062,2021-01-12,SAR,865,408,457,504,88,273,0,0,0,0,865,0,ITG,ITG2,20,Sardegna,Sardegna,1639591,87685,5.35,0.05
1063,2021-03-24,SAR,6575,2692,3883,731,159,1402,382,2662,184,1055,5230,1345,ITG,ITG2,20,Sardegna,Sardegna,1639591,94260,5.75,0.4
1064,2021-02-13,SAR,1454,563,891,732,400,64,253,0,0,5,1452,2,ITG,ITG2,20,Sardegna,Sardegna,1639591,95714,5.84,0.09
1065,2021-02-06,SAR,1970,697,1273,1544,237,49,139,0,0,1,569,1401,ITG,ITG2,20,Sardegna,Sardegna,1639591,97684,5.96,0.12
1066,2021-03-23,SAR,5657,2390,3267,1059,176,818,234,2140,90,1140,4638,1019,ITG,ITG2,20,Sardegna,Sardegna,1639591,103341,6.3,0.35
1067,2020-12-27,SAR,65,34,31,65,0,0,0,0,0,0,65,0,ITG,ITG2,20,Sardegna,Sardegna,1639591,103406,6.31,0.0
1068,2021-02-02,SAR,1482,655,827,988,187,307,0,0,0,0,241,1241,ITG,ITG2,20,Sardegna,Sardegna,1639591,104888,6.4,0.09
1069,2021-01-20,SAR,210,77,133,154,56,0,0,0,0,0,208,2,ITG,ITG2,20,Sardegna,Sardegna,1639591,105098,6.41,0.01
1070,2021-01-05,SAR,1327,446,881,1283,33,11,0,0,0,0,1327,0,ITG,ITG2,20,Sardegna,Sardegna,1639591,106425,6.49,0.08
1071,2020-12-31,SAR,32,16,16,28,0,4,0,0,0,0,32,0,ITG,ITG2,20,Sardegna,Sardegna,1639591,106457,6.49,0.0
1072,2021-01-04,SAR,591,217,374,565,15,11,0,0,0,0,591,0,ITG,ITG2,20,Sardegna,Sardegna,1639591,107048,6.53,0.04
1073,2021-01-19,SAR,747,270,477,423,163,0,160,0,0,1,692,55,ITG,ITG2,20,Sardegna,Sardegna,1639591,107795,6.57,0.05
1074,2021-03-13,SAR,2725,1061,1664,274,103,291,145,1736,43,133,2444,281,ITG,ITG2,20,Sardegna,Sardegna,1639591,110520,6.74,0.17
1075,2021-03-07,SAR,1590,724,866,307,227,11,32,1011,0,2,1117,473,ITG,ITG2,20,Sardegna,Sardegna,1639591,112110,6.84,0.1
1076,2021-03-02,SAR,2760,1423,1337,1045,277,454,278,320,384,2,1709,1051,ITG,ITG2,20,Sardegna,Sardegna,1639591,114870,7.01,0.17
1077,2021-02-11,SAR,1314,490,824,588,240,116,369,1,0,0,1203,111,ITG,ITG2,20,Sardegna,Sardegna,1639591,116184,7.09,0.08
1078,2020-12-28,SAR,65,25,40,65,0,0,0,0,0,0,65,0,ITG,ITG2,20,Sardegna,Sardegna,1639591,116249,7.09,0.0
1079,2021-01-13,SAR,573,178,395,494,76,3,0,0,0,0,573,0,ITG,ITG2,20,Sardegna,Sardegna,1639591,116822,7.13,0.03
1080,2021-03-21,SAR,3919,1757,2162,64,5,402,0,2771,102,575,2479,1440,ITG,ITG2,20,Sardegna,Sardegna,1639591,120741,7.36,0.24
1081,2021-02-23,SAR,1519,1010,509,602,191,330,89,6,301,0,1285,234,ITG,ITG2,20,Sardegna,Sardegna,1639591,122260,7.46,0.09
1082,2021-01-07,SAR,3111,1077,2034,2720,311,69,0,0,11,0,3111,0,ITG,ITG2,20,Sardegna,Sardegna,1639591,125371,7.65,0.19
1083,2021-03-09,SAR,5140,2368,2772,1055,367,525,285,2266,332,310,4410,730,ITG,ITG2,20,Sardegna,Sardegna,1639591,130511,7.96,0.31
1084,2021-01-27,SAR,1408,494,914,1303,75,30,0,0,0,0,79,1329,ITG,ITG2,20,Sardegna,Sardegna,1639591,131919,8.05,0.09
1085,2021-02-20,SAR,2041,855,1186,484,128,31,195,1202,0,1,1707,334,ITG,ITG2,20,Sardegna,Sardegna,1639591,133960,8.17,0.12
1086,2021-02-15,SAR,958,349,609,440,226,13,279,0,0,0,927,31,ITG,ITG2,20,Sardegna,Sardegna,1639591,134918,8.23,0.06
1087,2021-03-16,SAR,4057,1806,2251,644,173,696,311,2225,0,8,3126,931,ITG,ITG2,20,Sardegna,Sardegna,1639591,138975,8.48,0.25
1088,2021-02-26,SAR,2797,1107,1690,1224,509,561,221,203,74,5,2491,306,ITG,ITG2,20,Sardegna,Sardegna,1639591,141772,8.65,0.17
1089,2021-03-11,SAR,5897,2668,3229,1010,418,650,416,2811,490,102,4678,1219,ITG,ITG2,20,Sardegna,Sardegna,1639591,147669,9.01,0.36
1090,2021-03-15,SAR,2680,1214,1466,458,171,477,85,322,149,1018,2307,373,ITG,ITG2,20,Sardegna,Sardegna,1639591,150349,9.17,0.16
1091,2021-01-02,SAR,60,21,39,60,0,0,0,0,0,0,60,0,ITG,ITG2,20,Sardegna,Sardegna,1639591,150409,9.17,0.0
1092,2021-02-18,SAR,1877,732,1145,1073,301,61,298,1,33,110,1813,64,ITG,ITG2,20,Sardegna,Sardegna,1639591,152286,9.29,0.11
1093,2021-01-08,SAR,3257,1184,2073,2929,230,98,0,0,0,0,3257,0,ITG,ITG2,20,Sardegna,Sardegna,1639591,155543,9.49,0.2
1094,2021-02-14,SAR,539,263,276,286,187,6,57,3,0,0,537,2,ITG,ITG2,20,Sardegna,Sardegna,1639591,156082,9.52,0.03
1095,2021-02-19,SAR,1495,470,1025,677,336,101,379,1,1,0,1439,56,ITG,ITG2,20,Sardegna,Sardegna,1639591,157577,9.61,0.09
1096,2021-02-25,SAR,2899,1255,1644,1474,348,390,466,161,51,9,2293,606,ITG,ITG2,20,Sardegna,Sardegna,1639591,160476,9.79,0.18
1097,2021-01-06,SAR,1615,549,1066,1510,67,38,0,0,0,0,1615,0,ITG,ITG2,20,Sardegna,Sardegna,1639591,162091,9.89,0.1
1098,2021-01-21,SAR,126,60,66,60,44,22,0,0,0,0,94,32,ITG,ITG2,20,Sardegna,Sardegna,1639591,162217,9.89,0.01
1099,2021-01-30,SAR,3862,1392,2470,2987,500,374,0,1,0,0,362,3500,ITG,ITG2,20,Sardegna,Sardegna,1639591,166079,10.13,0.24
1100,2021-02-27,SAR,1920,647,1273,1059,291,88,306,176,0,0,1365,555,ITG,ITG2,20,Sardegna,Sardegna,1639591,167999,10.25,0.12
1101,2021-02-03,SAR,1118,418,700,919,169,11,19,0,0,0,426,692,ITG,ITG2,20,Sardegna,Sardegna,1639591,169117,10.31,0.07
1102,2021-01-03,SAR,90,36,54,89,1,0,0,0,0,0,90,0,ITG,ITG2,20,Sardegna,Sardegna,1639591,169207,10.32,0.01
1103,2021-02-08,SAR,1470,533,937,998,315,30,126,1,0,0,856,614,ITG,ITG2,20,Sardegna,Sardegna,1639591,170677,10.41,0.09
1104,2021-02-22,SAR,1623,944,679,599,239,163,180,2,440,0,1395,228,ITG,ITG2,20,Sardegna,Sardegna,1639591,172300,10.51,0.1
1105,2021-03-04,SAR,3887,1894,1993,955,306,555,463,1094,475,39,2739,1148,ITG,ITG2,20,Sardegna,Sardegna,1639591,176187,10.75,0.24
1106,2021-01-01,SAR,30,16,14,30,0,0,0,0,0,0,30,0,ITG,ITG2,20,Sardegna,Sardegna,1639591,176217,10.75,0.0
1107,2021-02-04,SAR,2271,816,1455,1737,307,56,170,1,0,0,916,1355,ITG,ITG2,20,Sardegna,Sardegna,1639591,178488,10.89,0.14
1108,2020-12-29,SAR,57,32,25,56,1,0,0,0,0,0,57,0,ITG,ITG2,20,Sardegna,Sardegna,1639591,178545,10.89,0.0
1109,2021-03-14,SAR,606,376,230,34,1,235,0,251,73,12,606,0,ITG,ITG2,20,Sardegna,Sardegna,1639591,179151,10.93,0.04
1110,2021-03-01,SAR,2160,1054,1106,1135,233,212,141,104,334,1,1501,659,ITG,ITG2,20,Sardegna,Sardegna,1639591,181311,11.06,0.13
1111,2021-03-10,SAR,6001,2913,3088,719,384,516,414,2976,657,335,5146,855,ITG,ITG2,20,Sardegna,Sardegna,1639591,187312,11.42,0.37
1112,2021-02-07,SAR,1116,394,722,975,136,5,0,0,0,0,228,888,ITG,ITG2,20,Sardegna,Sardegna,1639591,188428,11.49,0.07
1113,2021-01-18,SAR,904,326,578,714,173,17,0,0,0,0,780,124,ITG,ITG2,20,Sardegna,Sardegna,1639591,189332,11.55,0.06
1114,2021-03-18,SAR,6925,2921,4004,1074,240,1288,354,3899,7,63,5322,1603,ITG,ITG2,20,Sardegna,Sardegna,1639591,196257,11.97,0.42
1115,2021-02-05,SAR,1897,749,1148,1214,420,95,164,1,3,0,433,1464,ITG,ITG2,20,Sardegna,Sardegna,1639591,198154,12.09,0.12
1116,2021-01-24,SAR,90,34,56,89,0,1,0,0,0,0,5,85,ITG,ITG2,20,Sardegna,Sardegna,1639591,198244,12.09,0.01
1117,2021-03-20,UMB,2272,821,1451,315,178,507,0,0,72,1200,2247,25,ITI,ITI2,10,Umbria,Umbria,882015,2272,0.26,0.26
1118,2021-02-24,UMB,1520,565,955,1082,45,1,91,292,9,0,1505,15,ITI,ITI2,10,Umbria,Umbria,882015,3792,0.43,0.17
1119,2021-01-06,UMB,843,323,520,840,0,3,0,0,0,0,843,0,ITI,ITI2,10,Umbria,Umbria,882015,4635,0.53,0.1
1120,2021-03-14,UMB,66,48,18,0,6,55,1,0,0,4,66,0,ITI,ITI2,10,Umbria,Umbria,882015,4701,0.53,0.01
1121,2021-03-10,UMB,3970,1900,2070,120,745,113,144,2564,209,75,2683,1287,ITI,ITI2,10,Umbria,Umbria,882015,8671,0.98,0.45
1122,2021-01-23,UMB,277,100,177,276,1,0,0,0,0,0,2,275,ITI,ITI2,10,Umbria,Umbria,882015,8948,1.01,0.03
1123,2021-02-04,UMB,732,226,506,692,19,1,20,0,0,0,25,707,ITI,ITI2,10,Umbria,Umbria,882015,9680,1.1,0.08
1124,2021-03-02,UMB,3638,1345,2293,318,223,53,55,1302,241,1446,3634,4,ITI,ITI2,10,Umbria,Umbria,882015,13318,1.51,0.41
1125,2021-01-15,UMB,692,212,480,588,44,0,60,0,0,0,692,0,ITI,ITI2,10,Umbria,Umbria,882015,14010,1.59,0.08
1126,2021-02-08,UMB,637,203,434,368,111,1,153,0,4,0,88,549,ITI,ITI2,10,Umbria,Umbria,882015,14647,1.66,0.07
1127,2021-03-01,UMB,1503,774,729,110,10,15,0,1249,118,1,1389,114,ITI,ITI2,10,Umbria,Umbria,882015,16150,1.83,0.17
1128,2021-01-05,UMB,850,428,422,845,0,5,0,0,0,0,850,0,ITI,ITI2,10,Umbria,Umbria,882015,17000,1.93,0.1
1129,2021-01-17,UMB,54,17,37,47,7,0,0,0,0,0,54,0,ITI,ITI2,10,Umbria,Umbria,882015,17054,1.93,0.01
1130,2021-03-19,UMB,1732,559,1173,453,141,129,68,191,26,724,1076,656,ITI,ITI2,10,Umbria,Umbria,882015,18786,2.13,0.2
1131,2021-03-06,UMB,4251,1109,3142,422,178,69,26,1114,120,2322,4108,143,ITI,ITI2,10,Umbria,Umbria,882015,23037,2.61,0.48
1132,2021-03-16,UMB,3504,1433,2071,1633,68,21,65,1707,0,10,1877,1627,ITI,ITI2,10,Umbria,Umbria,882015,26541,3.01,0.4
1133,2021-01-29,UMB,1221,343,878,934,16,0,271,0,0,0,79,1142,ITI,ITI2,10,Umbria,Umbria,882015,27762,3.15,0.14
1134,2021-03-12,UMB,2633,1031,1602,111,410,186,41,463,229,1193,2135,498,ITI,ITI2,10,Umbria,Umbria,882015,30395,3.45,0.3
1135,2021-03-22,UMB,3558,1653,1905,163,120,204,0,2825,99,147,2312,1246,ITI,ITI2,10,Umbria,Umbria,882015,33953,3.85,0.4
1136,2021-01-28,UMB,1240,392,848,891,4,0,345,0,0,0,19,1221,ITI,ITI2,10,Umbria,Umbria,882015,35193,3.99,0.14
1137,2021-01-10,UMB,1056,275,781,740,3,6,307,0,0,0,1056,0,ITI,ITI2,10,Umbria,Umbria,882015,36249,4.11,0.12
1138,2021-03-17,UMB,3328,1313,2015,1429,52,12,129,1682,8,16,1856,1472,ITI,ITI2,10,Umbria,Umbria,882015,39577,4.49,0.38
1139,2021-01-27,UMB,838,329,509,837,1,0,0,0,0,0,13,825,ITI,ITI2,10,Umbria,Umbria,882015,40415,4.58,0.1
1140,2021-01-09,UMB,1719,492,1227,888,7,3,821,0,0,0,1719,0,ITI,ITI2,10,Umbria,Umbria,882015,42134,4.78,0.19
1141,2021-01-14,UMB,749,200,549,696,35,0,17,0,0,1,749,0,ITI,ITI2,10,Umbria,Umbria,882015,42883,4.86,0.08
1142,2021-03-05,UMB,4587,1379,3208,604,295,94,7,686,347,2554,3931,656,ITI,ITI2,10,Umbria,Umbria,882015,47470,5.38,0.52
1143,2021-03-07,UMB,844,180,664,16,66,17,25,44,0,676,837,7,ITI,ITI2,10,Umbria,Umbria,882015,48314,5.48,0.1
1144,2021-02-10,UMB,715,349,366,606,106,0,3,0,0,0,700,15,ITI,ITI2,10,Umbria,Umbria,882015,49029,5.56,0.08
1145,2021-03-13,UMB,1731,524,1207,120,122,60,49,152,77,1151,1486,245,ITI,ITI2,10,Umbria,Umbria,882015,50760,5.76,0.2
1146,2021-01-13,UMB,450,139,311,379,28,1,42,0,0,0,450,0,ITI,ITI2,10,Umbria,Umbria,882015,51210,5.81,0.05
1147,2021-02-22,UMB,1859,778,1081,733,88,32,1,1005,0,0,1773,86,ITI,ITI2,10,Umbria,Umbria,882015,53069,6.02,0.21
1148,2021-02-01,UMB,1260,333,927,876,32,0,352,0,0,0,47,1213,ITI,ITI2,10,Umbria,Umbria,882015,54329,6.16,0.14
1149,2021-01-25,UMB,647,322,325,645,2,0,0,0,0,0,5,642,ITI,ITI2,10,Umbria,Umbria,882015,54976,6.23,0.07
1150,2021-01-02,UMB,301,110,191,301,0,0,0,0,0,0,301,0,ITI,ITI2,10,Umbria,Umbria,882015,55277,6.27,0.03
1151,2021-01-11,UMB,1271,336,935,878,11,9,373,0,0,0,1271,0,ITI,ITI2,10,Umbria,Umbria,882015,56548,6.41,0.14
1152,2021-03-09,UMB,4028,1950,2078,142,549,132,105,2912,165,23,2735,1293,ITI,ITI2,10,Umbria,Umbria,882015,60576,6.87,0.46
1153,2021-01-26,UMB,814,390,424,813,1,0,0,0,0,0,18,796,ITI,ITI2,10,Umbria,Umbria,882015,61390,6.96,0.09
1154,2021-01-22,UMB,276,105,171,273,1,0,2,0,0,0,32,244,ITI,ITI2,10,Umbria,Umbria,882015,61666,6.99,0.03
1155,2021-01-31,UMB,1056,276,780,765,10,0,281,0,0,0,25,1031,ITI,ITI2,10,Umbria,Umbria,882015,62722,7.11,0.12
1156,2021-01-03,UMB,267,111,156,267,0,0,0,0,0,0,267,0,ITI,ITI2,10,Umbria,Umbria,882015,62989,7.14,0.03
1157,2021-02-07,UMB,54,17,37,46,8,0,0,0,0,0,1,53,ITI,ITI2,10,Umbria,Umbria,882015,63043,7.15,0.01
1158,2021-01-18,UMB,588,215,373,315,114,35,124,0,0,0,504,84,ITI,ITI2,10,Umbria,Umbria,882015,63631,7.21,0.07
1159,2021-02-15,UMB,1368,692,676,10,4,4,0,1350,0,0,1367,1,ITI,ITI2,10,Umbria,Umbria,882015,64999,7.37,0.16
1160,2021-01-19,UMB,103,23,80,21,2,0,80,0,0,0,103,0,ITI,ITI2,10,Umbria,Umbria,882015,65102,7.38,0.01
1161,2021-02-26,UMB,660,253,407,385,73,1,40,154,4,3,652,8,ITI,ITI2,10,Umbria,Umbria,882015,65762,7.46,0.07
1162,2021-02-20,UMB,282,100,182,83,7,1,39,152,0,0,258,24,ITI,ITI2,10,Umbria,Umbria,882015,66044,7.49,0.03
1163,2021-02-12,UMB,671,224,447,459,208,0,1,1,0,2,665,6,ITI,ITI2,10,Umbria,Umbria,882015,66715,7.56,0.08
1164,2021-03-08,UMB,3665,1797,1868,140,272,83,45,2853,230,42,2303,1362,ITI,ITI2,10,Umbria,Umbria,882015,70380,7.98,0.42
1165,2021-03-04,UMB,4475,1849,2626,849,164,74,4,1552,366,1466,3647,828,ITI,ITI2,10,Umbria,Umbria,882015,74855,8.49,0.51
1166,2021-02-13,UMB,115,28,87,68,46,0,0,1,0,0,112,3,ITI,ITI2,10,Umbria,Umbria,882015,74970,8.5,0.01
1167,2021-02-25,UMB,1334,495,839,826,96,5,97,305,0,5,1282,52,ITI,ITI2,10,Umbria,Umbria,882015,76304,8.65,0.15
1168,2021-01-04,UMB,809,397,412,808,0,1,0,0,0,0,809,0,ITI,ITI2,10,Umbria,Umbria,882015,77113,8.74,0.09
1169,2021-02-06,UMB,396,138,258,333,47,0,16,0,0,0,34,362,ITI,ITI2,10,Umbria,Umbria,882015,77509,8.79,0.04
1170,2021-02-05,UMB,780,234,546,645,51,0,84,0,0,0,18,762,ITI,ITI2,10,Umbria,Umbria,882015,78289,8.88,0.09
1171,2021-01-07,UMB,1291,383,908,883,0,4,404,0,0,0,1291,0,ITI,ITI2,10,Umbria,Umbria,882015,79580,9.02,0.15
1172,2021-03-24,UMB,4019,1745,2274,215,98,170,1,3456,37,42,2695,1324,ITI,ITI2,10,Umbria,Umbria,882015,83599,9.48,0.46
1173,2021-03-23,UMB,3793,1685,2108,395,179,213,12,2845,89,60,2164,1629,ITI,ITI2,10,Umbria,Umbria,882015,87392,9.91,0.43
1174,2021-01-30,UMB,1577,483,1094,841,18,0,717,1,0,0,44,1533,ITI,ITI2,10,Umbria,Umbria,882015,88969,10.09,0.18
1175,2021-03-25,UMB,3598,1592,2006,255,51,150,63,2999,48,32,2534,1064,ITI,ITI2,10,Umbria,Umbria,882015,92567,10.49,0.41
1176,2021-01-20,UMB,613,222,391,583,14,1,14,0,0,1,613,0,ITI,ITI2,10,Umbria,Umbria,882015,93180,10.56,0.07
1177,2021-02-27,UMB,1658,354,1304,14,11,0,13,0,60,1560,1642,16,ITI,ITI2,10,Umbria,Umbria,882015,94838,10.75,0.19
1178,2021-03-03,UMB,4435,1771,2664,720,235,55,86,1517,289,1533,3723,712,ITI,ITI2,10,Umbria,Umbria,882015,99273,11.26,0.5
1179,2021-01-24,UMB,254,104,150,254,0,0,0,0,0,0,1,253,ITI,ITI2,10,Umbria,Umbria,882015,99527,11.28,0.03
1180,2021-01-21,UMB,610,202,408,428,13,0,169,0,0,0,341,269,ITI,ITI2,10,Umbria,Umbria,882015,100137,11.35,0.07
1181,2021-03-21,UMB,665,330,335,31,14,523,0,0,34,63,665,0,ITI,ITI2,10,Umbria,Umbria,882015,100802,11.43,0.08
1182,2021-02-18,UMB,1495,582,913,324,14,2,170,985,0,0,1029,466,ITI,ITI2,10,Umbria,Umbria,882015,102297,11.6,0.17
1183,2020-12-31,UMB,322,127,195,310,0,12,0,0,0,0,322,0,ITI,ITI2,10,Umbria,Umbria,882015,102619,11.63,0.04
1184,2020-12-27,UMB,85,45,40,67,2,0,16,0,0,0,85,0,ITI,ITI2,10,Umbria,Umbria,882015,102704,11.64,0.01
1185,2021-03-18,UMB,2785,1079,1706,962,115,30,205,1459,3,11,1552,1233,ITI,ITI2,10,Umbria,Umbria,882015,105489,11.96,0.32
1186,2021-02-11,UMB,842,349,493,735,98,1,5,0,0,3,837,5,ITI,ITI2,10,Umbria,Umbria,882015,106331,12.06,0.1
1187,2021-02-23,UMB,1693,658,1035,1187,95,0,17,394,0,0,1651,42,ITI,ITI2,10,Umbria,Umbria,882015,108024,12.25,0.19
1188,2021-01-08,UMB,1173,337,836,926,8,1,238,0,0,0,1173,0,ITI,ITI2,10,Umbria,Umbria,882015,109197,12.38,0.13
1189,2021-01-12,UMB,784,247,537,665,7,7,105,0,0,0,784,0,ITI,ITI2,10,Umbria,Umbria,882015,109981,12.47,0.09
1190,2021-01-01,UMB,269,102,167,268,0,1,0,0,0,0,269,0,ITI,ITI2,10,Umbria,Umbria,882015,110250,12.5,0.03
1191,2021-02-19,UMB,743,293,450,281,12,4,14,432,0,0,526,217,ITI,ITI2,10,Umbria,Umbria,882015,110993,12.58,0.08
1192,2021-01-16,UMB,221,73,148,146,32,0,43,0,0,0,221,0,ITI,ITI2,10,Umbria,Umbria,882015,111214,12.61,0.03
1193,2021-02-17,UMB,1618,748,870,363,3,11,0,1240,0,1,1267,351,ITI,ITI2,10,Umbria,Umbria,882015,112832,12.79,0.18
1194,2021-02-16,UMB,1307,655,652,33,4,8,0,1262,0,0,1298,9,ITI,ITI2,10,Umbria,Umbria,882015,114139,12.94,0.15
1195,2021-02-03,UMB,725,174,551,560,34,3,128,0,0,0,67,658,ITI,ITI2,10,Umbria,Umbria,882015,114864,13.02,0.08
1196,2021-03-11,UMB,3538,1680,1858,143,604,180,238,2014,201,158,2532,1006,ITI,ITI2,10,Umbria,Umbria,882015,118402,13.42,0.4
1197,2021-02-02,UMB,942,274,668,713,16,1,212,0,0,0,32,910,ITI,ITI2,10,Umbria,Umbria,882015,119344,13.53,0.11
1198,2021-03-15,UMB,4592,1927,2665,1426,193,154,78,2337,141,263,2822,1770,ITI,ITI2,10,Umbria,Umbria,882015,123936,14.05,0.52
1199,2021-03-15,TOS,8306,3303,5003,3216,1248,709,402,30,420,2281,3870,4436,ITI,ITI1,9,Toscana,Toscana,3729641,8306,0.22,0.22
1200,2021-02-18,TOS,8815,3284,5531,2924,1447,64,228,214,796,3142,7923,892,ITI,ITI1,9,Toscana,Toscana,3729641,17121,0.46,0.24
1201,2021-02-15,TOS,8770,3374,5396,4536,922,1106,216,56,794,1140,7945,825,ITI,ITI1,9,Toscana,Toscana,3729641,25891,0.69,0.24
1202,2021-03-19,TOS,9869,4347,5522,639,438,3998,275,4471,13,35,7117,2752,ITI,ITI1,9,Toscana,Toscana,3729641,35760,0.96,0.26
1203,2021-03-04,TOS,17464,6654,10810,2816,275,1397,274,8143,864,3695,14388,3076,ITI,ITI1,9,Toscana,Toscana,3729641,53224,1.43,0.47
1204,2021-01-17,TOS,2535,871,1664,2002,293,0,240,0,0,0,2022,513,ITI,ITI1,9,Toscana,Toscana,3729641,55759,1.5,0.07
1205,2021-03-02,TOS,10534,3769,6765,3169,428,598,125,1832,870,3512,7097,3437,ITI,ITI1,9,Toscana,Toscana,3729641,66293,1.78,0.28
1206,2021-01-24,TOS,3348,1072,2276,2601,35,2,709,1,0,0,200,3148,ITI,ITI1,9,Toscana,Toscana,3729641,69641,1.87,0.09
1207,2021-01-11,TOS,5092,1689,3403,4360,209,1,522,0,0,0,5092,0,ITI,ITI1,9,Toscana,Toscana,3729641,74733,2.0,0.14
1208,2021-03-20,TOS,6386,2815,3571,885,551,4739,134,28,15,34,5251,1135,ITI,ITI1,9,Toscana,Toscana,3729641,81119,2.17,0.17
1209,2021-02-24,TOS,10350,4459,5891,81,302,1267,301,4120,1331,2948,10153,197,ITI,ITI1,9,Toscana,Toscana,3729641,91469,2.45,0.28
1210,2021-02-17,TOS,8175,3168,5007,3465,1122,51,249,218,584,2486,7424,751,ITI,ITI1,9,Toscana,Toscana,3729641,99644,2.67,0.22
1211,2021-01-21,TOS,1589,686,903,579,220,0,790,0,0,0,867,722,ITI,ITI1,9,Toscana,Toscana,3729641,101233,2.71,0.04
1212,2021-02-19,TOS,8299,2951,5348,2968,1207,27,243,154,580,3120,7792,507,ITI,ITI1,9,Toscana,Toscana,3729641,109532,2.94,0.22
1213,2021-03-25,TOS,20779,8930,11849,183,263,5979,275,13160,215,704,13676,7103,ITI,ITI1,9,Toscana,Toscana,3729641,130311,3.49,0.56
1214,2021-03-22,TOS,4798,2369,2429,217,348,3431,352,9,126,315,4366,432,ITI,ITI1,9,Toscana,Toscana,3729641,135109,3.62,0.13
1215,2021-01-06,TOS,4519,1459,3060,3984,9,1,525,0,0,0,4519,0,ITI,ITI1,9,Toscana,Toscana,3729641,139628,3.74,0.12
1216,2021-02-07,TOS,2806,953,1853,2349,299,1,157,0,0,0,885,1921,ITI,ITI1,9,Toscana,Toscana,3729641,142434,3.82,0.08
1217,2021-01-01,TOS,2368,786,1582,1716,2,0,650,0,0,0,2368,0,ITI,ITI1,9,Toscana,Toscana,3729641,144802,3.88,0.06
1218,2021-03-09,TOS,10460,4013,6447,4804,905,1180,151,3245,164,11,4908,5552,ITI,ITI1,9,Toscana,Toscana,3729641,155262,4.16,0.28
1219,2021-02-27,TOS,1944,723,1221,1352,311,3,132,1,126,19,1042,902,ITI,ITI1,9,Toscana,Toscana,3729641,157206,4.22,0.05
1220,2021-01-25,TOS,5125,1896,3229,4159,54,2,909,1,0,0,249,4876,ITI,ITI1,9,Toscana,Toscana,3729641,162331,4.35,0.14
1221,2021-01-02,TOS,3497,1097,2400,2682,15,0,800,0,0,0,3497,0,ITI,ITI1,9,Toscana,Toscana,3729641,165828,4.45,0.09
1222,2021-01-16,TOS,3271,1046,2225,2493,538,0,240,0,0,0,3271,0,ITI,ITI1,9,Toscana,Toscana,3729641,169099,4.53,0.09
1223,2021-02-28,TOS,1649,667,982,1111,201,1,78,0,249,9,922,727,ITI,ITI1,9,Toscana,Toscana,3729641,170748,4.58,0.04
1224,2021-02-23,TOS,7720,3323,4397,1491,530,1041,204,509,1114,2831,7559,161,ITI,ITI1,9,Toscana,Toscana,3729641,178468,4.79,0.21
1225,2021-03-07,TOS,5647,2356,3291,3102,511,586,123,15,536,774,2106,3541,ITI,ITI1,9,Toscana,Toscana,3729641,184115,4.94,0.15
1226,2021-02-16,TOS,9268,3338,5930,5084,952,30,178,10,691,2323,8557,711,ITI,ITI1,9,Toscana,Toscana,3729641,193383,5.19,0.25
1227,2021-01-09,TOS,4484,1596,2888,3779,143,1,560,1,0,0,4484,0,ITI,ITI1,9,Toscana,Toscana,3729641,197867,5.31,0.12
1228,2021-03-01,TOS,4374,1664,2710,3188,592,9,137,2,421,25,739,3635,ITI,ITI1,9,Toscana,Toscana,3729641,202241,5.42,0.12
1229,2021-03-10,TOS,17638,6899,10739,2999,849,1374,238,11987,178,13,13633,4005,ITI,ITI1,9,Toscana,Toscana,3729641,219879,5.9,0.47
1230,2021-01-04,TOS,5063,1893,3170,4099,29,3,932,0,0,0,5063,0,ITI,ITI1,9,Toscana,Toscana,3729641,224942,6.03,0.14
1231,2021-03-03,TOS,18041,6434,11607,3318,496,662,135,9086,898,3446,14444,3597,ITI,ITI1,9,Toscana,Toscana,3729641,242983,6.51,0.48
1232,2021-03-11,TOS,15143,5830,9313,2436,905,1375,229,10021,165,12,11834,3309,ITI,ITI1,9,Toscana,Toscana,3729641,258126,6.92,0.41
1233,2021-02-20,TOS,4641,1790,2851,3350,1038,0,203,17,15,18,4128,513,ITI,ITI1,9,Toscana,Toscana,3729641,262767,7.05,0.12
1234,2021-01-10,TOS,3001,1104,1897,2432,134,4,431,0,0,0,3001,0,ITI,ITI1,9,Toscana,Toscana,3729641,265768,7.13,0.08
1235,2021-01-08,TOS,5944,1641,4303,5360,36,3,545,0,0,0,5944,0,ITI,ITI1,9,Toscana,Toscana,3729641,271712,7.29,0.16
1236,2021-03-05,TOS,16297,6245,10052,3921,926,1485,170,5152,771,3872,11557,4740,ITI,ITI1,9,Toscana,Toscana,3729641,288009,7.72,0.44
1237,2021-02-04,TOS,4251,1594,2657,3166,623,1,456,5,0,0,961,3290,ITI,ITI1,9,Toscana,Toscana,3729641,292260,7.84,0.11
1238,2021-01-31,TOS,3048,1129,1919,2465,133,2,448,0,0,0,105,2943,ITI,ITI1,9,Toscana,Toscana,3729641,295308,7.92,0.08
1239,2021-01-07,TOS,6018,1751,4267,5308,29,1,680,0,0,0,6018,0,ITI,ITI1,9,Toscana,Toscana,3729641,301326,8.08,0.16
1240,2021-02-06,TOS,4527,1550,2977,3725,574,1,227,0,0,0,1294,3233,ITI,ITI1,9,Toscana,Toscana,3729641,305853,8.2,0.12
1241,2021-02-26,TOS,10048,3817,6231,1557,636,1070,298,1787,1137,3563,8842,1206,ITI,ITI1,9,Toscana,Toscana,3729641,315901,8.47,0.27
1242,2021-01-22,TOS,2861,1063,1798,2022,81,0,758,0,0,0,525,2336,ITI,ITI1,9,Toscana,Toscana,3729641,318762,8.55,0.08
1243,2021-02-12,TOS,7606,2683,4923,3742,380,2892,188,2,402,0,7393,213,ITI,ITI1,9,Toscana,Toscana,3729641,326368,8.75,0.2
1244,2021-01-03,TOS,3336,1052,2284,2565,9,0,762,0,0,0,3336,0,ITI,ITI1,9,Toscana,Toscana,3729641,329704,8.84,0.09
1245,2021-01-19,TOS,1104,531,573,392,220,1,491,0,0,0,1104,0,ITI,ITI1,9,Toscana,Toscana,3729641,330808,8.87,0.03
1246,2021-03-18,TOS,9698,3866,5832,427,542,892,257,7570,7,3,5794,3904,ITI,ITI1,9,Toscana,Toscana,3729641,340506,9.13,0.26
1247,2021-02-13,TOS,7785,2360,5425,3667,574,3194,163,0,186,1,7558,227,ITI,ITI1,9,Toscana,Toscana,3729641,348291,9.34,0.21
1248,2021-02-01,TOS,5465,1942,3523,4441,403,4,617,0,0,0,521,4944,ITI,ITI1,9,Toscana,Toscana,3729641,353756,9.48,0.15
1249,2021-02-25,TOS,10581,4281,6300,1078,421,1281,259,3202,1141,3199,9587,994,ITI,ITI1,9,Toscana,Toscana,3729641,364337,9.77,0.28
1250,2021-01-20,TOS,1314,635,679,432,255,1,626,0,0,0,1077,237,ITI,ITI1,9,Toscana,Toscana,3729641,365651,9.8,0.04
1251,2021-02-21,TOS,5104,2089,3015,3666,1219,0,195,2,13,9,4935,169,ITI,ITI1,9,Toscana,Toscana,3729641,370755,9.94,0.14
1252,2021-03-13,TOS,9254,3282,5972,2833,1156,953,54,174,344,3740,5308,3946,ITI,ITI1,9,Toscana,Toscana,3729641,380009,10.19,0.25
1253,2021-03-08,TOS,6267,2560,3707,4063,746,986,177,65,222,8,1448,4819,ITI,ITI1,9,Toscana,Toscana,3729641,386276,10.36,0.17
1254,2021-02-03,TOS,4221,1452,2769,3475,239,1,505,1,0,0,241,3980,ITI,ITI1,9,Toscana,Toscana,3729641,390497,10.47,0.11
1255,2021-01-29,TOS,6136,1698,4438,5375,138,1,622,0,0,0,302,5834,ITI,ITI1,9,Toscana,Toscana,3729641,396633,10.63,0.16
1256,2021-01-28,TOS,6275,1880,4395,5421,64,2,788,0,0,0,349,5926,ITI,ITI1,9,Toscana,Toscana,3729641,402908,10.8,0.17
1257,2021-03-24,TOS,18389,7456,10933,212,322,4413,165,12321,183,773,9648,8741,ITI,ITI1,9,Toscana,Toscana,3729641,421297,11.3,0.49
1258,2021-03-12,TOS,16130,6018,10112,2604,952,999,186,6780,684,3925,12609,3521,ITI,ITI1,9,Toscana,Toscana,3729641,437427,11.73,0.43
1259,2021-03-21,TOS,3231,1574,1657,660,791,1677,77,8,6,12,1798,1433,ITI,ITI1,9,Toscana,Toscana,3729641,440658,11.82,0.09
1260,2021-03-23,TOS,8817,3992,4825,255,298,4182,309,3297,138,338,6639,2178,ITI,ITI1,9,Toscana,Toscana,3729641,449475,12.05,0.24
1261,2021-02-05,TOS,5748,2244,3504,4121,1180,4,442,1,0,0,1924,3824,ITI,ITI1,9,Toscana,Toscana,3729641,455223,12.21,0.15
1262,2021-02-11,TOS,5383,2021,3362,2809,284,1934,323,12,10,11,5141,242,ITI,ITI1,9,Toscana,Toscana,3729641,460606,12.35,0.14
1263,2020-12-30,TOS,327,104,223,34,10,0,283,0,0,0,327,0,ITI,ITI1,9,Toscana,Toscana,3729641,460933,12.36,0.01
1264,2021-03-14,TOS,7161,2561,4600,3102,797,452,121,2,211,2476,3230,3931,ITI,ITI1,9,Toscana,Toscana,3729641,468094,12.55,0.19
1265,2021-02-14,TOS,8993,2567,6426,3033,549,5064,81,0,261,5,8883,110,ITI,ITI1,9,Toscana,Toscana,3729641,477087,12.79,0.24
1266,2021-02-09,TOS,4488,1468,3020,3583,386,2,513,4,0,0,3877,611,ITI,ITI1,9,Toscana,Toscana,3729641,481575,12.91,0.12
1267,2021-03-16,TOS,4834,1852,2982,1543,424,669,120,2050,12,16,2611,2223,ITI,ITI1,9,Toscana,Toscana,3729641,486409,13.04,0.13
1268,2021-02-02,TOS,3741,1475,2266,3020,283,4,422,6,6,0,194,3547,ITI,ITI1,9,Toscana,Toscana,3729641,490150,13.14,0.1
1269,2021-03-17,TOS,11122,4467,6655,353,271,877,171,9446,2,2,6696,4426,ITI,ITI1,9,Toscana,Toscana,3729641,501272,13.44,0.3
1270,2021-01-26,TOS,5392,1791,3601,4357,81,3,951,0,0,0,219,5173,ITI,ITI1,9,Toscana,Toscana,3729641,506664,13.58,0.14
1271,2021-03-06,TOS,7096,2839,4257,3804,482,1132,145,30,357,1146,2905,4191,ITI,ITI1,9,Toscana,Toscana,3729641,513760,13.78,0.19
1272,2020-12-31,TOS,805,202,603,97,10,0,698,0,0,0,805,0,ITI,ITI1,9,Toscana,Toscana,3729641,514565,13.8,0.02
1273,2021-01-18,TOS,1119,636,483,430,313,1,375,0,0,0,1021,98,ITI,ITI1,9,Toscana,Toscana,3729641,515684,13.83,0.03
1274,2021-02-22,TOS,9817,4253,5564,3484,1390,889,315,22,1014,2703,9539,278,ITI,ITI1,9,Toscana,Toscana,3729641,525501,14.09,0.26
1275,2021-01-27,TOS,4835,1572,3263,4019,73,1,742,0,0,0,207,4628,ITI,ITI1,9,Toscana,Toscana,3729641,530336,14.22,0.13
1276,2021-02-10,TOS,4262,1280,2982,3536,239,2,484,0,1,0,3739,523,ITI,ITI1,9,Toscana,Toscana,3729641,534598,14.33,0.11
1277,2021-01-15,TOS,3878,1347,2531,2758,674,2,444,0,0,0,3878,0,ITI,ITI1,9,Toscana,Toscana,3729641,538476,14.44,0.1
1278,2021-01-14,TOS,3254,1179,2075,2459,475,0,320,0,0,0,3254,0,ITI,ITI1,9,Toscana,Toscana,3729641,541730,14.52,0.09
1279,2021-01-23,TOS,3949,1354,2595,2936,170,2,841,0,0,0,640,3309,ITI,ITI1,9,Toscana,Toscana,3729641,545679,14.63,0.11
1280,2021-01-12,TOS,3581,1398,2183,2944,282,1,354,0,0,0,3581,0,ITI,ITI1,9,Toscana,Toscana,3729641,549260,14.73,0.1
1281,2021-01-05,TOS,5244,1755,3489,4354,9,2,879,0,0,0,5244,0,ITI,ITI1,9,Toscana,Toscana,3729641,554504,14.87,0.14
1282,2021-02-08,TOS,4095,1358,2737,3373,343,2,377,0,0,0,3636,459,ITI,ITI1,9,Toscana,Toscana,3729641,558599,14.98,0.11
1283,2021-01-30,TOS,4620,1622,2998,3763,218,1,638,0,0,0,197,4423,ITI,ITI1,9,Toscana,Toscana,3729641,563219,15.1,0.12
1284,2020-12-27,TOS,620,267,353,460,10,137,13,0,0,0,620,0,ITI,ITI1,9,Toscana,Toscana,3729641,563839,15.12,0.02
1285,2021-01-13,TOS,4063,1398,2665,3308,348,2,405,0,0,0,4063,0,ITI,ITI1,9,Toscana,Toscana,3729641,567902,15.23,0.11
1286,2021-01-14,LIG,2977,1053,1924,1868,335,220,553,0,0,1,2977,0,ITC,ITC3,7,Liguria,Liguria,1550640,2977,0.19,0.19
1287,2021-01-28,LIG,2840,968,1872,2237,183,105,309,0,1,5,39,2801,ITC,ITC3,7,Liguria,Liguria,1550640,5817,0.38,0.18
1288,2021-01-05,LIG,2878,896,1982,2307,107,196,261,0,0,7,2878,0,ITC,ITC3,7,Liguria,Liguria,1550640,8695,0.56,0.19
1289,2021-01-15,LIG,2245,751,1494,1323,271,137,512,0,0,2,2245,0,ITC,ITC3,7,Liguria,Liguria,1550640,10940,0.71,0.14
1290,2021-03-22,LIG,7222,3219,4003,560,102,1563,38,3822,281,856,4445,2777,ITC,ITC3,7,Liguria,Liguria,1550640,18162,1.17,0.47
1291,2021-03-17,LIG,5503,2351,3152,774,112,287,76,4246,2,6,2446,3057,ITC,ITC3,7,Liguria,Liguria,1550640,23665,1.53,0.35
1292,2021-02-09,LIG,1893,680,1213,1080,193,143,455,0,0,22,256,1637,ITC,ITC3,7,Liguria,Liguria,1550640,25558,1.65,0.12
1293,2021-02-16,LIG,2391,948,1443,982,199,211,283,714,0,2,1998,393,ITC,ITC3,7,Liguria,Liguria,1550640,27949,1.8,0.15
1294,2021-01-09,LIG,1335,481,854,998,73,74,188,0,0,2,1335,0,ITC,ITC3,7,Liguria,Liguria,1550640,29284,1.89,0.09
1295,2021-01-11,LIG,2652,990,1662,1990,143,202,316,0,0,1,2652,0,ITC,ITC3,7,Liguria,Liguria,1550640,31936,2.06,0.17
1296,2021-01-02,LIG,691,245,446,595,54,42,0,0,0,0,691,0,ITC,ITC3,7,Liguria,Liguria,1550640,32627,2.1,0.04
1297,2021-01-12,LIG,2393,862,1531,1726,174,95,396,0,0,2,2393,0,ITC,ITC3,7,Liguria,Liguria,1550640,35020,2.26,0.15
1298,2021-02-08,LIG,1858,716,1142,1224,200,185,242,0,0,7,306,1552,ITC,ITC3,7,Liguria,Liguria,1550640,36878,2.38,0.12
1299,2021-02-25,LIG,3438,1347,2091,550,91,122,88,2584,2,1,3309,129,ITC,ITC3,7,Liguria,Liguria,1550640,40316,2.6,0.22
1300,2020-12-28,LIG,80,30,50,77,0,3,0,0,0,0,80,0,ITC,ITC3,7,Liguria,Liguria,1550640,40396,2.61,0.01
1301,2021-03-23,LIG,8641,3909,4732,632,79,2227,50,3919,457,1277,5434,3207,ITC,ITC3,7,Liguria,Liguria,1550640,49037,3.16,0.56
1302,2021-02-15,LIG,2256,837,1419,1083,185,82,241,662,1,2,1861,395,ITC,ITC3,7,Liguria,Liguria,1550640,51293,3.31,0.15
1303,2021-02-04,LIG,2813,984,1829,1865,376,92,471,0,1,8,179,2634,ITC,ITC3,7,Liguria,Liguria,1550640,54106,3.49,0.18
1304,2021-01-17,LIG,861,300,561,516,16,66,262,0,0,1,861,0,ITC,ITC3,7,Liguria,Liguria,1550640,54967,3.54,0.06
1305,2021-02-28,LIG,1060,581,479,12,1,570,3,474,0,0,1059,1,ITC,ITC3,7,Liguria,Liguria,1550640,56027,3.61,0.07
1306,2021-01-23,LIG,809,295,514,633,94,38,43,0,0,1,153,656,ITC,ITC3,7,Liguria,Liguria,1550640,56836,3.67,0.05
1307,2021-02-13,LIG,1079,508,571,543,77,58,147,254,0,0,800,279,ITC,ITC3,7,Liguria,Liguria,1550640,57915,3.73,0.07
1308,2021-01-31,LIG,624,270,354,418,67,4,135,0,0,0,9,615,ITC,ITC3,7,Liguria,Liguria,1550640,58539,3.78,0.04
1309,2021-02-10,LIG,2275,827,1448,1350,233,186,496,5,0,5,1014,1261,ITC,ITC3,7,Liguria,Liguria,1550640,60814,3.92,0.15
1310,2021-03-19,LIG,5173,2211,2962,705,151,441,93,3679,21,83,2124,3049,ITC,ITC3,7,Liguria,Liguria,1550640,65987,4.26,0.33
1311,2021-02-01,LIG,2442,904,1538,1914,158,54,315,0,0,1,76,2366,ITC,ITC3,7,Liguria,Liguria,1550640,68429,4.41,0.16
1312,2021-01-07,LIG,3166,1076,2090,2313,144,276,428,0,1,4,3166,0,ITC,ITC3,7,Liguria,Liguria,1550640,71595,4.62,0.2
1313,2021-01-08,LIG,2926,999,1927,2084,167,239,431,0,1,4,2926,0,ITC,ITC3,7,Liguria,Liguria,1550640,74521,4.81,0.19
1314,2021-03-10,LIG,5712,2760,2952,814,92,695,85,3620,405,1,3815,1897,ITC,ITC3,7,Liguria,Liguria,1550640,80233,5.17,0.37
1315,2021-03-08,LIG,5588,2443,3145,1121,171,355,80,3548,306,7,3904,1684,ITC,ITC3,7,Liguria,Liguria,1550640,85821,5.53,0.36
1316,2021-03-25,LIG,7940,3350,4590,606,152,2149,121,3328,314,1270,4882,3058,ITC,ITC3,7,Liguria,Liguria,1550640,93761,6.05,0.51
1317,2021-03-24,LIG,8604,3706,4898,496,98,2106,41,4126,401,1336,5329,3275,ITC,ITC3,7,Liguria,Liguria,1550640,102365,6.6,0.55
1318,2021-03-07,LIG,1858,1085,773,184,8,516,258,508,383,1,1557,301,ITC,ITC3,7,Liguria,Liguria,1550640,104223,6.72,0.12
1319,2021-01-24,LIG,755,236,519,632,60,3,60,0,0,0,113,642,ITC,ITC3,7,Liguria,Liguria,1550640,104978,6.77,0.05
1320,2020-12-27,LIG,135,56,79,88,0,2,45,0,0,0,135,0,ITC,ITC3,7,Liguria,Liguria,1550640,105113,6.78,0.01
1321,2021-02-24,LIG,3754,1555,2199,803,91,183,152,2524,0,1,3496,258,ITC,ITC3,7,Liguria,Liguria,1550640,108867,7.02,0.24
1322,2021-02-23,LIG,3804,1560,2244,687,79,192,116,2727,2,1,3695,109,ITC,ITC3,7,Liguria,Liguria,1550640,112671,7.27,0.25
1323,2021-02-17,LIG,2623,1165,1458,883,131,231,262,1115,0,1,2260,363,ITC,ITC3,7,Liguria,Liguria,1550640,115294,7.44,0.17
1324,2021-03-06,LIG,3241,1818,1423,373,12,775,120,1490,471,0,2537,704,ITC,ITC3,7,Liguria,Liguria,1550640,118535,7.64,0.21
1325,2021-01-25,LIG,2717,888,1829,2208,128,62,317,0,0,2,471,2246,ITC,ITC3,7,Liguria,Liguria,1550640,121252,7.82,0.18
1326,2021-01-21,LIG,1102,385,717,584,69,116,332,1,0,0,672,430,ITC,ITC3,7,Liguria,Liguria,1550640,122354,7.89,0.07
1327,2021-02-20,LIG,1334,636,698,159,28,436,122,589,0,0,1333,1,ITC,ITC3,7,Liguria,Liguria,1550640,123688,7.98,0.09
1328,2020-12-29,LIG,125,33,92,93,11,0,21,0,0,0,125,0,ITC,ITC3,7,Liguria,Liguria,1550640,123813,7.98,0.01
1329,2021-02-19,LIG,3093,1279,1814,988,123,469,97,1413,0,3,2917,176,ITC,ITC3,7,Liguria,Liguria,1550640,126906,8.18,0.2
1330,2021-03-02,LIG,4072,1688,2384,726,60,126,76,3079,1,4,3762,310,ITC,ITC3,7,Liguria,Liguria,1550640,130978,8.45,0.26
1331,2021-03-01,LIG,3497,1424,2073,528,62,57,105,2744,0,1,3375,122,ITC,ITC3,7,Liguria,Liguria,1550640,134475,8.67,0.23
1332,2021-02-12,LIG,1910,683,1227,864,119,104,392,430,0,1,896,1014,ITC,ITC3,7,Liguria,Liguria,1550640,136385,8.8,0.12
1333,2021-02-26,LIG,3759,1519,2240,780,128,96,168,2585,0,2,3431,328,ITC,ITC3,7,Liguria,Liguria,1550640,140144,9.04,0.24
1334,2021-03-20,LIG,2315,995,1320,224,44,184,0,1854,9,0,1142,1173,ITC,ITC3,7,Liguria,Liguria,1550640,142459,9.19,0.15
1335,2021-01-13,LIG,2753,1012,1741,1912,226,124,487,0,0,4,2753,0,ITC,ITC3,7,Liguria,Liguria,1550640,145212,9.36,0.18
1336,2021-01-30,LIG,1661,567,1094,1261,88,53,257,0,0,2,25,1636,ITC,ITC3,7,Liguria,Liguria,1550640,146873,9.47,0.11
1337,2021-03-12,LIG,5992,2764,3228,1193,209,712,77,3360,437,4,3552,2440,ITC,ITC3,7,Liguria,Liguria,1550640,152865,9.86,0.39
1338,2021-01-16,LIG,1278,557,721,753,62,163,299,0,0,1,1278,0,ITC,ITC3,7,Liguria,Liguria,1550640,154143,9.94,0.08
1339,2021-02-11,LIG,1953,758,1195,1234,125,133,455,0,0,6,1091,862,ITC,ITC3,7,Liguria,Liguria,1550640,156096,10.07,0.13
1340,2021-01-01,LIG,144,55,89,139,4,1,0,0,0,0,144,0,ITC,ITC3,7,Liguria,Liguria,1550640,156240,10.08,0.01
1341,2021-03-13,LIG,3523,1493,2030,329,77,634,71,1502,120,790,2670,853,ITC,ITC3,7,Liguria,Liguria,1550640,159763,10.3,0.23
1342,2021-02-18,LIG,2760,1126,1634,957,119,303,349,1030,0,2,2431,329,ITC,ITC3,7,Liguria,Liguria,1550640,162523,10.48,0.18
1343,2021-03-04,LIG,4723,2112,2611,921,106,212,277,2921,282,4,3893,830,ITC,ITC3,7,Liguria,Liguria,1550640,167246,10.79,0.3
1344,2021-02-14,LIG,233,122,111,31,0,30,112,60,0,0,233,0,ITC,ITC3,7,Liguria,Liguria,1550640,167479,10.8,0.02
1345,2021-03-09,LIG,5783,2690,3093,1027,148,497,131,3447,533,0,4361,1422,ITC,ITC3,7,Liguria,Liguria,1550640,173262,11.17,0.37
1346,2020-12-31,LIG,988,354,634,750,17,38,155,28,0,0,988,0,ITC,ITC3,7,Liguria,Liguria,1550640,174250,11.24,0.06
1347,2021-02-06,LIG,1891,767,1124,1309,161,45,375,0,0,1,145,1746,ITC,ITC3,7,Liguria,Liguria,1550640,176141,11.36,0.12
1348,2021-01-19,LIG,1356,429,927,709,130,186,328,0,0,3,1266,90,ITC,ITC3,7,Liguria,Liguria,1550640,177497,11.45,0.09
1349,2021-01-03,LIG,734,230,504,658,23,52,0,0,0,1,734,0,ITC,ITC3,7,Liguria,Liguria,1550640,178231,11.49,0.05
1350,2021-01-26,LIG,2480,801,1679,1962,152,110,251,0,0,5,14,2466,ITC,ITC3,7,Liguria,Liguria,1550640,180711,11.65,0.16
1351,2021-01-27,LIG,1743,603,1140,1336,89,90,227,0,0,1,142,1601,ITC,ITC3,7,Liguria,Liguria,1550640,182454,11.77,0.11
1352,2021-03-14,LIG,1648,747,901,64,36,347,176,567,27,431,1044,604,ITC,ITC3,7,Liguria,Liguria,1550640,184102,11.87,0.11
1353,2021-03-11,LIG,6192,2972,3220,1141,107,513,262,3671,496,2,4190,2002,ITC,ITC3,7,Liguria,Liguria,1550640,190294,12.27,0.4
1354,2021-02-07,LIG,407,153,254,191,12,17,187,0,0,0,2,405,ITC,ITC3,7,Liguria,Liguria,1550640,190701,12.3,0.03
1355,2021-01-04,LIG,2613,853,1760,2196,80,158,176,0,0,3,2613,0,ITC,ITC3,7,Liguria,Liguria,1550640,193314,12.47,0.17
1356,2021-03-15,LIG,7180,3050,4130,781,149,1247,47,3772,221,963,4478,2702,ITC,ITC3,7,Liguria,Liguria,1550640,200494,12.93,0.46
1357,2021-03-21,LIG,552,221,331,7,1,19,0,525,0,0,69,483,ITC,ITC3,7,Liguria,Liguria,1550640,201046,12.97,0.04
1358,2021-02-27,LIG,1888,921,967,139,13,527,5,1204,0,0,1759,129,ITC,ITC3,7,Liguria,Liguria,1550640,202934,13.09,0.12
1359,2021-01-29,LIG,3040,1057,1983,2298,194,117,429,0,0,2,66,2974,ITC,ITC3,7,Liguria,Liguria,1550640,205974,13.28,0.2
1360,2021-01-22,LIG,1812,602,1210,1063,143,41,565,0,0,0,1327,485,ITC,ITC3,7,Liguria,Liguria,1550640,207786,13.4,0.12
1361,2021-02-21,LIG,869,491,378,183,21,296,102,267,0,0,865,4,ITC,ITC3,7,Liguria,Liguria,1550640,208655,13.46,0.06
1362,2021-03-18,LIG,4978,2125,2853,630,68,492,94,3683,6,5,2016,2962,ITC,ITC3,7,Liguria,Liguria,1550640,213633,13.78,0.32
1363,2021-03-05,LIG,4853,2143,2710,800,66,259,81,3330,312,5,3729,1124,ITC,ITC3,7,Liguria,Liguria,1550640,218486,14.09,0.31
1364,2021-02-03,LIG,2242,771,1471,1602,197,60,382,0,0,1,54,2188,ITC,ITC3,7,Liguria,Liguria,1550640,220728,14.23,0.14
1365,2021-02-05,LIG,2628,975,1653,1728,357,75,464,0,0,4,301,2327,ITC,ITC3,7,Liguria,Liguria,1550640,223356,14.4,0.17
1366,2021-03-03,LIG,4548,1825,2723,1029,118,127,288,2978,3,5,3555,993,ITC,ITC3,7,Liguria,Liguria,1550640,227904,14.7,0.29
1367,2020-12-30,LIG,12,5,7,12,0,0,0,0,0,0,12,0,ITC,ITC3,7,Liguria,Liguria,1550640,227916,14.7,0.0
1368,2021-01-20,LIG,1546,554,992,724,121,219,480,0,0,2,1534,12,ITC,ITC3,7,Liguria,Liguria,1550640,229462,14.8,0.1
1369,2021-02-02,LIG,2598,979,1619,1947,195,33,421,0,0,2,198,2400,ITC,ITC3,7,Liguria,Liguria,1550640,232060,14.97,0.17
1370,2021-01-06,LIG,1660,616,1044,1230,40,210,113,64,0,3,1660,0,ITC,ITC3,7,Liguria,Liguria,1550640,233720,15.07,0.11
1371,2021-01-10,LIG,648,262,386,369,84,19,176,0,0,0,648,0,ITC,ITC3,7,Liguria,Liguria,1550640,234368,15.11,0.04
1372,2021-01-18,LIG,2125,740,1385,1247,182,248,438,0,0,10,1968,157,ITC,ITC3,7,Liguria,Liguria,1550640,236493,15.25,0.14
1373,2021-02-22,LIG,3329,1463,1866,712,100,113,235,2167,0,2,3191,138,ITC,ITC3,7,Liguria,Liguria,1550640,239822,15.47,0.21
1374,2021-03-16,LIG,6025,2696,3329,932,108,408,323,4246,3,5,2308,3717,ITC,ITC3,7,Liguria,Liguria,1550640,245847,15.85,0.39
1375,2021-02-27,MOL,1366,568,798,25,2,34,14,1290,0,1,1347,19,ITF,ITF2,14,Molise,Molise,305617,1366,0.45,0.45
1376,2021-03-10,MOL,1737,720,1017,188,3,92,1,757,187,509,1687,50,ITF,ITF2,14,Molise,Molise,305617,3103,1.02,0.57
1377,2021-02-09,MOL,359,170,189,161,83,5,110,0,0,0,197,162,ITF,ITF2,14,Molise,Molise,305617,3462,1.13,0.12
1378,2021-01-08,MOL,429,141,288,244,6,59,120,0,0,0,429,0,ITF,ITF2,14,Molise,Molise,305617,3891,1.27,0.14
1379,2021-03-22,MOL,1146,439,707,106,3,283,2,255,39,458,903,243,ITF,ITF2,14,Molise,Molise,305617,5037,1.65,0.37
1380,2021-02-05,MOL,593,269,324,460,22,48,63,0,0,0,55,538,ITF,ITF2,14,Molise,Molise,305617,5630,1.84,0.19
1381,2021-03-15,MOL,832,338,494,137,6,149,66,116,61,297,587,245,ITF,ITF2,14,Molise,Molise,305617,6462,2.11,0.27
1382,2021-02-19,MOL,169,93,76,95,28,42,1,0,0,3,167,2,ITF,ITF2,14,Molise,Molise,305617,6631,2.17,0.06
1383,2021-01-28,MOL,613,217,396,430,9,19,154,0,0,1,17,596,ITF,ITF2,14,Molise,Molise,305617,7244,2.37,0.2
1384,2021-02-10,MOL,150,78,72,91,6,0,53,0,0,0,130,20,ITF,ITF2,14,Molise,Molise,305617,7394,2.42,0.05
1385,2021-01-18,MOL,114,48,66,97,14,3,0,0,0,0,114,0,ITF,ITF2,14,Molise,Molise,305617,7508,2.46,0.04
1386,2021-01-31,MOL,268,70,198,85,18,0,164,0,0,1,6,262,ITF,ITF2,14,Molise,Molise,305617,7776,2.54,0.09
1387,2021-01-10,MOL,270,72,198,82,19,0,169,0,0,0,270,0,ITF,ITF2,14,Molise,Molise,305617,8046,2.63,0.09
1388,2021-02-21,MOL,573,227,346,1,0,4,0,568,0,0,571,2,ITF,ITF2,14,Molise,Molise,305617,8619,2.82,0.19
1389,2021-03-14,MOL,594,239,355,2,0,11,0,581,0,0,16,578,ITF,ITF2,14,Molise,Molise,305617,9213,3.01,0.19
1390,2021-01-07,MOL,598,209,389,414,1,38,145,0,0,0,598,0,ITF,ITF2,14,Molise,Molise,305617,9811,3.21,0.2
1391,2021-03-25,MOL,1776,718,1058,52,2,309,16,818,86,493,1279,497,ITF,ITF2,14,Molise,Molise,305617,11587,3.79,0.58
1392,2021-01-30,MOL,461,158,303,189,52,40,180,0,0,0,12,449,ITF,ITF2,14,Molise,Molise,305617,12048,3.94,0.15
1393,2021-03-04,MOL,850,417,433,252,18,6,69,469,36,0,526,324,ITF,ITF2,14,Molise,Molise,305617,12898,4.22,0.28
1394,2021-01-14,MOL,646,239,407,418,82,31,115,0,0,0,646,0,ITF,ITF2,14,Molise,Molise,305617,13544,4.43,0.21
1395,2021-01-29,MOL,421,136,285,227,23,59,109,0,0,3,6,415,ITF,ITF2,14,Molise,Molise,305617,13965,4.57,0.14
1396,2021-03-16,MOL,614,230,384,13,3,188,11,395,4,0,267,347,ITF,ITF2,14,Molise,Molise,305617,14579,4.77,0.2
1397,2021-03-17,MOL,894,381,513,34,22,211,42,572,12,1,563,331,ITF,ITF2,14,Molise,Molise,305617,15473,5.06,0.29
1398,2021-02-22,MOL,265,129,136,56,31,108,62,8,0,0,250,15,ITF,ITF2,14,Molise,Molise,305617,15738,5.15,0.09
1399,2021-02-08,MOL,334,141,193,206,38,5,85,0,0,0,216,118,ITF,ITF2,14,Molise,Molise,305617,16072,5.26,0.11
1400,2021-02-01,MOL,562,201,361,301,143,6,111,0,0,1,14,548,ITF,ITF2,14,Molise,Molise,305617,16634,5.44,0.18
1401,2021-02-20,MOL,1018,441,577,20,4,53,8,933,0,0,998,20,ITF,ITF2,14,Molise,Molise,305617,17652,5.78,0.33
1402,2021-02-23,MOL,581,223,358,136,39,4,61,340,0,1,362,219,ITF,ITF2,14,Molise,Molise,305617,18233,5.97,0.19
1403,2021-03-07,MOL,1131,501,630,2,16,0,0,1113,0,0,1129,2,ITF,ITF2,14,Molise,Molise,305617,19364,6.34,0.37
1404,2021-01-13,MOL,474,160,314,256,66,7,144,0,0,1,474,0,ITF,ITF2,14,Molise,Molise,305617,19838,6.49,0.16
1405,2021-02-16,MOL,156,70,86,148,4,4,0,0,0,0,150,6,ITF,ITF2,14,Molise,Molise,305617,19994,6.54,0.05
1406,2021-03-20,MOL,2320,968,1352,28,2,206,0,1855,7,222,999,1321,ITF,ITF2,14,Molise,Molise,305617,22314,7.3,0.76
1407,2021-03-08,MOL,1376,522,854,359,44,61,23,409,76,404,1236,140,ITF,ITF2,14,Molise,Molise,305617,23690,7.75,0.45
1408,2021-02-12,MOL,330,149,181,224,12,20,72,0,0,2,208,122,ITF,ITF2,14,Molise,Molise,305617,24020,7.86,0.11
1409,2021-03-11,MOL,1462,636,826,42,2,22,14,698,185,499,1456,6,ITF,ITF2,14,Molise,Molise,305617,25482,8.34,0.48
1410,2021-01-25,MOL,319,130,189,317,0,0,0,0,0,2,3,316,ITF,ITF2,14,Molise,Molise,305617,25801,8.44,0.1
1411,2021-01-20,MOL,18,8,10,14,4,0,0,0,0,0,18,0,ITF,ITF2,14,Molise,Molise,305617,25819,8.45,0.01
1412,2021-03-18,MOL,1156,476,680,73,10,174,45,854,0,0,692,464,ITF,ITF2,14,Molise,Molise,305617,26975,8.83,0.38
1413,2021-01-12,MOL,336,114,222,132,74,1,129,0,0,0,336,0,ITF,ITF2,14,Molise,Molise,305617,27311,8.94,0.11
1414,2021-03-05,MOL,1219,649,570,322,1,54,0,618,151,73,1015,204,ITF,ITF2,14,Molise,Molise,305617,28530,9.34,0.4
1415,2021-03-19,MOL,1180,479,701,32,0,163,9,726,2,248,753,427,ITF,ITF2,14,Molise,Molise,305617,29710,9.72,0.39
1416,2021-03-21,MOL,1245,542,703,14,1,141,0,1089,0,0,479,766,ITF,ITF2,14,Molise,Molise,305617,30955,10.13,0.41
1417,2021-02-02,MOL,539,176,363,295,64,0,180,0,0,0,216,323,ITF,ITF2,14,Molise,Molise,305617,31494,10.31,0.18
1418,2021-02-17,MOL,72,32,40,47,9,10,6,0,0,0,57,15,ITF,ITF2,14,Molise,Molise,305617,31566,10.33,0.02
1419,2021-02-07,MOL,66,32,34,49,1,0,16,0,0,0,19,47,ITF,ITF2,14,Molise,Molise,305617,31632,10.35,0.02
1420,2021-02-24,MOL,666,278,388,242,61,44,44,274,0,1,333,333,ITF,ITF2,14,Molise,Molise,305617,32298,10.57,0.22
1421,2021-01-09,MOL,450,152,298,221,27,24,178,0,0,0,450,0,ITF,ITF2,14,Molise,Molise,305617,32748,10.72,0.15
1422,2021-01-04,MOL,314,131,183,301,0,13,0,0,0,0,314,0,ITF,ITF2,14,Molise,Molise,305617,33062,10.82,0.1
1423,2021-01-05,MOL,449,180,269,441,0,8,0,0,0,0,449,0,ITF,ITF2,14,Molise,Molise,305617,33511,10.97,0.15
1424,2021-02-06,MOL,429,179,250,276,13,9,130,0,0,1,29,400,ITF,ITF2,14,Molise,Molise,305617,33940,11.11,0.14
1425,2021-03-24,MOL,1624,655,969,77,1,343,0,706,47,450,1222,402,ITF,ITF2,14,Molise,Molise,305617,35564,11.64,0.53
1426,2021-03-23,MOL,1639,692,947,76,2,451,6,571,79,454,1432,207,ITF,ITF2,14,Molise,Molise,305617,37203,12.17,0.54
1427,2021-03-12,MOL,1438,629,809,42,31,47,0,698,115,505,1402,36,ITF,ITF2,14,Molise,Molise,305617,38641,12.64,0.47
1428,2021-02-25,MOL,541,239,302,68,3,9,28,433,0,0,473,68,ITF,ITF2,14,Molise,Molise,305617,39182,12.82,0.18
1429,2021-02-03,MOL,731,249,482,391,110,49,180,0,0,1,338,393,ITF,ITF2,14,Molise,Molise,305617,39913,13.06,0.24
1430,2021-01-15,MOL,538,242,296,398,17,42,81,0,0,0,538,0,ITF,ITF2,14,Molise,Molise,305617,40451,13.24,0.18
1431,2021-03-01,MOL,641,268,373,200,28,40,108,116,2,147,427,214,ITF,ITF2,14,Molise,Molise,305617,41092,13.45,0.21
1432,2021-02-04,MOL,758,295,463,502,76,38,141,0,0,1,77,681,ITF,ITF2,14,Molise,Molise,305617,41850,13.69,0.25
1433,2021-02-11,MOL,293,133,160,225,19,0,45,0,3,1,257,36,ITF,ITF2,14,Molise,Molise,305617,42143,13.79,0.1
1434,2021-03-13,MOL,1189,594,595,29,0,23,5,981,151,0,200,989,ITF,ITF2,14,Molise,Molise,305617,43332,14.18,0.39
1435,2021-03-02,MOL,667,383,284,98,106,12,51,136,113,151,509,158,ITF,ITF2,14,Molise,Molise,305617,43999,14.4,0.22
1436,2021-03-06,MOL,1728,807,921,156,15,10,0,1395,152,0,1569,159,ITF,ITF2,14,Molise,Molise,305617,45727,14.96,0.57
1437,2021-03-03,MOL,672,316,356,63,1,4,48,384,45,127,590,82,ITF,ITF2,14,Molise,Molise,305617,46399,15.18,0.22
1438,2021-01-16,MOL,420,166,254,270,14,9,127,0,0,0,420,0,ITF,ITF2,14,Molise,Molise,305617,46819,15.32,0.14
1439,2021-01-27,MOL,674,251,423,436,11,17,209,0,0,1,8,666,ITF,ITF2,14,Molise,Molise,305617,47493,15.54,0.22
1440,2021-03-09,MOL,1329,579,750,199,1,109,0,409,218,393,1177,152,ITF,ITF2,14,Molise,Molise,305617,48822,15.97,0.43
1441,2021-02-26,MOL,563,260,303,42,7,50,3,406,0,55,490,73,ITF,ITF2,14,Molise,Molise,305617,49385,16.16,0.18
1442,2021-02-13,MOL,132,80,52,129,3,0,0,0,0,0,132,0,ITF,ITF2,14,Molise,Molise,305617,49517,16.2,0.04
1443,2021-01-06,MOL,689,260,429,456,26,36,171,0,0,0,689,0,ITF,ITF2,14,Molise,Molise,305617,50206,16.43,0.23
1444,2021-01-21,MOL,6,2,4,0,6,0,0,0,0,0,6,0,ITF,ITF2,14,Molise,Molise,305617,50212,16.43,0.0
1445,2021-01-19,MOL,173,63,110,90,57,2,22,0,0,2,162,11,ITF,ITF2,14,Molise,Molise,305617,50385,16.49,0.06
1446,2021-01-22,MOL,126,35,91,21,32,0,73,0,0,0,126,0,ITF,ITF2,14,Molise,Molise,305617,50511,16.53,0.04
1447,2021-02-28,MOL,828,331,497,38,1,4,27,758,0,0,786,42,ITF,ITF2,14,Molise,Molise,305617,51339,16.8,0.27
1448,2021-02-18,MOL,319,74,245,296,8,15,0,0,0,0,306,13,ITF,ITF2,14,Molise,Molise,305617,51658,16.9,0.1
1449,2021-01-26,MOL,450,184,266,444,0,5,0,0,0,1,8,442,ITF,ITF2,14,Molise,Molise,305617,52108,17.05,0.15
1450,2021-01-11,MOL,557,194,363,196,193,57,111,0,0,0,557,0,ITF,ITF2,14,Molise,Molise,305617,52665,17.23,0.18
1451,2020-12-27,MOL,50,20,30,29,4,0,17,0,0,0,50,0,ITF,ITF2,14,Molise,Molise,305617,52715,17.25,0.02
1452,2021-01-17,MOL,78,38,40,78,0,0,0,0,0,0,48,30,ITF,ITF2,14,Molise,Molise,305617,52793,17.27,0.03
1453,2021-02-15,MOL,144,70,74,117,8,4,15,0,0,0,141,3,ITF,ITF2,14,Molise,Molise,305617,52937,17.32,0.05
1454,2021-03-01,FVG,2956,1042,1914,93,32,68,175,1635,4,949,2903,53,ITH,ITH4,6,Friuli-Venezia Giulia,Friuli Venezia Giulia,1215220,2956,0.24,0.24
1455,2021-03-08,FVG,3987,1552,2435,690,365,176,109,2172,39,436,1899,2088,ITH,ITH4,6,Friuli-Venezia Giulia,Friuli Venezia Giulia,1215220,6943,0.57,0.33
1456,2021-02-12,FVG,1200,428,772,674,392,3,128,2,0,1,1150,50,ITH,ITH4,6,Friuli-Venezia Giulia,Friuli Venezia Giulia,1215220,8143,0.67,0.1
1457,2021-02-08,FVG,2355,693,1662,1399,521,0,435,0,0,0,92,2263,ITH,ITH4,6,Friuli-Venezia Giulia,Friuli Venezia Giulia,1215220,10498,0.86,0.19
1458,2021-01-31,FVG,2713,836,1877,1692,1,1002,18,0,0,0,385,2328,ITH,ITH4,6,Friuli-Venezia Giulia,Friuli Venezia Giulia,1215220,13211,1.09,0.22
1459,2021-03-17,FVG,3113,1236,1877,423,218,109,111,2243,3,6,625,2488,ITH,ITH4,6,Friuli-Venezia Giulia,Friuli Venezia Giulia,1215220,16324,1.34,0.26
1460,2021-02-10,FVG,1352,496,856,745,487,0,119,0,0,1,1266,86,ITH,ITH4,6,Friuli-Venezia Giulia,Friuli Venezia Giulia,1215220,17676,1.45,0.11
1461,2021-01-26,FVG,1972,647,1325,1439,0,152,381,0,0,0,214,1758,ITH,ITH4,6,Friuli-Venezia Giulia,Friuli Venezia Giulia,1215220,19648,1.62,0.16
1462,2021-03-10,FVG,3359,1494,1865,305,243,128,207,1972,309,195,1567,1792,ITH,ITH4,6,Friuli-Venezia Giulia,Friuli Venezia Giulia,1215220,23007,1.89,0.28
1463,2021-02-22,FVG,2493,1196,1297,431,312,15,115,1369,246,5,2075,418,ITH,ITH4,6,Friuli-Venezia Giulia,Friuli Venezia Giulia,1215220,25500,2.1,0.21
1464,2021-02-28,FVG,2668,988,1680,234,162,1,0,405,378,1488,2273,395,ITH,ITH4,6,Friuli-Venezia Giulia,Friuli Venezia Giulia,1215220,28168,2.32,0.22
1465,2021-02-25,FVG,3069,1603,1466,22,3,125,188,1557,433,741,3044,25,ITH,ITH4,6,Friuli-Venezia Giulia,Friuli Venezia Giulia,1215220,31237,2.57,0.25
1466,2021-01-29,FVG,2413,813,1600,1855,0,321,237,0,0,0,264,2149,ITH,ITH4,6,Friuli-Venezia Giulia,Friuli Venezia Giulia,1215220,33650,2.77,0.2
1467,2021-03-22,FVG,3415,1314,2101,131,86,102,164,2463,6,463,1486,1929,ITH,ITH4,6,Friuli-Venezia Giulia,Friuli Venezia Giulia,1215220,37065,3.05,0.28
1468,2021-01-05,FVG,1680,551,1129,1350,1,132,197,0,0,0,1680,0,ITH,ITH4,6,Friuli-Venezia Giulia,Friuli Venezia Giulia,1215220,38745,3.19,0.14
1469,2021-01-16,FVG,1231,360,871,771,1,211,248,0,0,0,1231,0,ITH,ITH4,6,Friuli-Venezia Giulia,Friuli Venezia Giulia,1215220,39976,3.29,0.1
1470,2021-02-20,FVG,2068,933,1135,11,1,18,148,1584,0,306,1924,144,ITH,ITH4,6,Friuli-Venezia Giulia,Friuli Venezia Giulia,1215220,42044,3.46,0.17
1471,2021-03-12,FVG,3903,1535,2368,175,61,110,27,2840,101,589,2523,1380,ITH,ITH4,6,Friuli-Venezia Giulia,Friuli Venezia Giulia,1215220,45947,3.78,0.32
1472,2021-01-27,FVG,1272,425,847,851,1,356,64,0,0,0,450,822,ITH,ITH4,6,Friuli-Venezia Giulia,Friuli Venezia Giulia,1215220,47219,3.89,0.1
1473,2021-01-18,FVG,1961,607,1354,1359,4,488,110,0,0,0,1867,94,ITH,ITH4,6,Friuli-Venezia Giulia,Friuli Venezia Giulia,1215220,49180,4.05,0.16
1474,2021-03-02,FVG,4218,1518,2700,1164,656,19,202,1538,5,634,2715,1503,ITH,ITH4,6,Friuli-Venezia Giulia,Friuli Venezia Giulia,1215220,53398,4.39,0.35
1475,2021-01-23,FVG,816,324,492,768,1,47,0,0,0,0,4,812,ITH,ITH4,6,Friuli-Venezia Giulia,Friuli Venezia Giulia,1215220,54214,4.46,0.07
1476,2021-02-05,FVG,2613,784,1829,1612,511,0,490,0,0,0,90,2523,ITH,ITH4,6,Friuli-Venezia Giulia,Friuli Venezia Giulia,1215220,56827,4.68,0.22
1477,2021-01-30,FVG,2271,744,1527,1475,2,352,442,0,0,0,270,2001,ITH,ITH4,6,Friuli-Venezia Giulia,Friuli Venezia Giulia,1215220,59098,4.86,0.19
1478,2021-03-15,FVG,3753,1631,2122,327,253,105,180,2420,234,234,1435,2318,ITH,ITH4,6,Friuli-Venezia Giulia,Friuli Venezia Giulia,1215220,62851,5.17,0.31
1479,2020-12-31,FVG,1053,384,669,1011,0,42,0,0,0,0,1053,0,ITH,ITH4,6,Friuli-Venezia Giulia,Friuli Venezia Giulia,1215220,63904,5.26,0.09
1480,2021-01-20,FVG,751,323,428,719,1,31,0,0,0,0,12,739,ITH,ITH4,6,Friuli-Venezia Giulia,Friuli Venezia Giulia,1215220,64655,5.32,0.06
1481,2021-02-04,FVG,2731,807,1924,1723,543,0,465,0,0,0,36,2695,ITH,ITH4,6,Friuli-Venezia Giulia,Friuli Venezia Giulia,1215220,67386,5.55,0.22
1482,2021-01-06,FVG,709,264,445,514,0,195,0,0,0,0,709,0,ITH,ITH4,6,Friuli-Venezia Giulia,Friuli Venezia Giulia,1215220,68095,5.6,0.06
1483,2021-03-03,FVG,3638,1626,2012,749,493,71,100,1329,469,427,2360,1278,ITH,ITH4,6,Friuli-Venezia Giulia,Friuli Venezia Giulia,1215220,71733,5.9,0.3
1484,2021-03-06,FVG,3487,1192,2295,182,148,111,1,1561,20,1464,3161,326,ITH,ITH4,6,Friuli-Venezia Giulia,Friuli Venezia Giulia,1215220,75220,6.19,0.29
1485,2021-02-02,FVG,2466,806,1660,1657,393,0,416,0,0,0,217,2249,ITH,ITH4,6,Friuli-Venezia Giulia,Friuli Venezia Giulia,1215220,77686,6.39,0.2
1486,2021-03-07,FVG,2536,925,1611,1,1,157,0,143,453,1781,2535,1,ITH,ITH4,6,Friuli-Venezia Giulia,Friuli Venezia Giulia,1215220,80222,6.6,0.21
1487,2021-02-24,FVG,2517,1082,1435,23,5,48,310,1834,0,297,2499,18,ITH,ITH4,6,Friuli-Venezia Giulia,Friuli Venezia Giulia,1215220,82739,6.81,0.21
1488,2021-02-11,FVG,1930,663,1267,1134,566,2,224,3,1,0,1737,193,ITH,ITH4,6,Friuli-Venezia Giulia,Friuli Venezia Giulia,1215220,84669,6.97,0.16
1489,2021-02-03,FVG,2646,790,1856,1701,558,0,386,1,0,0,23,2623,ITH,ITH4,6,Friuli-Venezia Giulia,Friuli Venezia Giulia,1215220,87315,7.19,0.22
1490,2021-01-03,FVG,312,122,190,285,0,26,1,0,0,0,312,0,ITH,ITH4,6,Friuli-Venezia Giulia,Friuli Venezia Giulia,1215220,87627,7.21,0.03
1491,2021-01-10,FVG,2941,919,2022,1745,6,945,245,0,0,0,2941,0,ITH,ITH4,6,Friuli-Venezia Giulia,Friuli Venezia Giulia,1215220,90568,7.45,0.24
1492,2021-01-13,FVG,2651,834,1817,1822,9,590,230,0,0,0,2651,0,ITH,ITH4,6,Friuli-Venezia Giulia,Friuli Venezia Giulia,1215220,93219,7.67,0.22
1493,2021-01-04,FVG,1510,559,951,1392,0,118,0,0,0,0,1510,0,ITH,ITH4,6,Friuli-Venezia Giulia,Friuli Venezia Giulia,1215220,94729,7.8,0.12
1494,2021-02-07,FVG,1561,483,1078,866,693,0,2,0,0,0,386,1175,ITH,ITH4,6,Friuli-Venezia Giulia,Friuli Venezia Giulia,1215220,96290,7.92,0.13
1495,2021-03-04,FVG,3401,1574,1827,357,212,38,88,1815,490,401,2767,634,ITH,ITH4,6,Friuli-Venezia Giulia,Friuli Venezia Giulia,1215220,99691,8.2,0.28
1496,2021-01-07,FVG,2091,718,1373,1759,1,221,110,0,0,0,2091,0,ITH,ITH4,6,Friuli-Venezia Giulia,Friuli Venezia Giulia,1215220,101782,8.38,0.17
1497,2021-01-24,FVG,305,119,186,277,0,27,1,0,0,0,1,304,ITH,ITH4,6,Friuli-Venezia Giulia,Friuli Venezia Giulia,1215220,102087,8.4,0.03
1498,2021-01-14,FVG,2588,789,1799,1608,14,536,430,0,0,0,2588,0,ITH,ITH4,6,Friuli-Venezia Giulia,Friuli Venezia Giulia,1215220,104675,8.61,0.21
1499,2021-02-27,FVG,3420,1177,2243,203,140,32,0,1523,25,1497,3419,1,ITH,ITH4,6,Friuli-Venezia Giulia,Friuli Venezia Giulia,1215220,108095,8.9,0.28
1500,2020-12-27,FVG,262,149,113,259,0,3,0,0,0,0,262,0,ITH,ITH4,6,Friuli-Venezia Giulia,Friuli Venezia Giulia,1215220,108357,8.92,0.02
1501,2021-01-22,FVG,90,30,60,89,0,1,0,0,0,0,0,90,ITH,ITH4,6,Friuli-Venezia Giulia,Friuli Venezia Giulia,1215220,108447,8.92,0.01
1502,2021-03-24,FVG,3520,1407,2113,172,175,323,109,2310,6,425,2082,1438,ITH,ITH4,6,Friuli-Venezia Giulia,Friuli Venezia Giulia,1215220,111967,9.21,0.29
1503,2021-03-23,FVG,3628,1499,2129,319,297,83,238,2442,8,241,1494,2134,ITH,ITH4,6,Friuli-Venezia Giulia,Friuli Venezia Giulia,1215220,115595,9.51,0.3
1504,2021-01-08,FVG,2322,747,1575,1680,5,241,396,0,0,0,2322,0,ITH,ITH4,6,Friuli-Venezia Giulia,Friuli Venezia Giulia,1215220,117917,9.7,0.19
1505,2021-01-02,FVG,1217,471,746,1150,0,67,0,0,0,0,1217,0,ITH,ITH4,6,Friuli-Venezia Giulia,Friuli Venezia Giulia,1215220,119134,9.8,0.1
1506,2021-01-09,FVG,2518,841,1677,1519,2,404,593,0,0,0,2518,0,ITH,ITH4,6,Friuli-Venezia Giulia,Friuli Venezia Giulia,1215220,121652,10.01,0.21
1507,2021-03-16,FVG,3076,1268,1808,325,254,99,196,2202,0,0,1038,2038,ITH,ITH4,6,Friuli-Venezia Giulia,Friuli Venezia Giulia,1215220,124728,10.26,0.25
1508,2021-02-06,FVG,1154,338,816,755,208,0,191,0,0,0,22,1132,ITH,ITH4,6,Friuli-Venezia Giulia,Friuli Venezia Giulia,1215220,125882,10.36,0.09
1509,2021-01-12,FVG,2259,712,1547,1528,19,351,361,0,0,0,2259,0,ITH,ITH4,6,Friuli-Venezia Giulia,Friuli Venezia Giulia,1215220,128141,10.54,0.19
1510,2021-01-25,FVG,1582,567,1015,1369,0,141,72,0,0,0,194,1388,ITH,ITH4,6,Friuli-Venezia Giulia,Friuli Venezia Giulia,1215220,129723,10.67,0.13
1511,2021-01-21,FVG,894,345,549,863,0,31,0,0,0,0,1,893,ITH,ITH4,6,Friuli-Venezia Giulia,Friuli Venezia Giulia,1215220,130617,10.75,0.07
1512,2021-03-21,FVG,2597,936,1661,6,3,111,0,1332,27,1118,2189,408,ITH,ITH4,6,Friuli-Venezia Giulia,Friuli Venezia Giulia,1215220,133214,10.96,0.21
1513,2021-02-09,FVG,1848,556,1292,1053,509,0,286,0,0,0,1559,289,ITH,ITH4,6,Friuli-Venezia Giulia,Friuli Venezia Giulia,1215220,135062,11.11,0.15
1514,2021-03-13,FVG,2928,1117,1811,11,4,11,86,2056,37,723,1657,1271,ITH,ITH4,6,Friuli-Venezia Giulia,Friuli Venezia Giulia,1215220,137990,11.36,0.24
1515,2021-02-15,FVG,2453,909,1544,699,386,19,315,1034,0,0,2203,250,ITH,ITH4,6,Friuli-Venezia Giulia,Friuli Venezia Giulia,1215220,140443,11.56,0.2
1516,2021-03-09,FVG,3861,1590,2271,656,420,102,196,2003,60,424,1108,2753,ITH,ITH4,6,Friuli-Venezia Giulia,Friuli Venezia Giulia,1215220,144304,11.87,0.32
1517,2021-03-19,FVG,3191,1324,1867,104,46,120,280,2508,0,133,1268,1923,ITH,ITH4,6,Friuli-Venezia Giulia,Friuli Venezia Giulia,1215220,147495,12.14,0.26
1518,2021-03-25,FVG,4960,2104,2856,51,54,1878,186,1935,29,827,2952,2008,ITH,ITH4,6,Friuli-Venezia Giulia,Friuli Venezia Giulia,1215220,152455,12.55,0.41
1519,2021-01-28,FVG,2235,792,1443,1754,0,287,194,0,0,0,354,1881,ITH,ITH4,6,Friuli-Venezia Giulia,Friuli Venezia Giulia,1215220,154690,12.73,0.18
1520,2021-03-11,FVG,3310,1391,1919,262,109,47,271,2013,104,504,1576,1734,ITH,ITH4,6,Friuli-Venezia Giulia,Friuli Venezia Giulia,1215220,158000,13.0,0.27
1521,2021-01-11,FVG,1882,609,1273,1500,3,333,46,0,0,0,1882,0,ITH,ITH4,6,Friuli-Venezia Giulia,Friuli Venezia Giulia,1215220,159882,13.16,0.15
1522,2021-01-17,FVG,1720,524,1196,674,5,555,486,0,0,0,1720,0,ITH,ITH4,6,Friuli-Venezia Giulia,Friuli Venezia Giulia,1215220,161602,13.3,0.14
1523,2021-01-15,FVG,2028,606,1422,1283,6,364,375,0,0,0,2028,0,ITH,ITH4,6,Friuli-Venezia Giulia,Friuli Venezia Giulia,1215220,163630,13.47,0.17
1524,2021-02-23,FVG,2615,1252,1363,104,44,63,206,1943,254,1,2437,178,ITH,ITH4,6,Friuli-Venezia Giulia,Friuli Venezia Giulia,1215220,166245,13.68,0.22
1525,2021-02-26,FVG,3737,2092,1645,75,26,114,452,1739,1032,299,3591,146,ITH,ITH4,6,Friuli-Venezia Giulia,Friuli Venezia Giulia,1215220,169982,13.99,0.31
1526,2021-03-18,FVG,3264,1388,1876,53,21,265,67,2857,0,1,1635,1629,ITH,ITH4,6,Friuli-Venezia Giulia,Friuli Venezia Giulia,1215220,173246,14.26,0.27
1527,2021-03-05,FVG,3654,1444,2210,1043,651,35,70,1668,43,144,2583,1071,ITH,ITH4,6,Friuli-Venezia Giulia,Friuli Venezia Giulia,1215220,176900,14.56,0.3
1528,2021-03-14,FVG,1395,548,847,0,1,17,0,247,333,797,1143,252,ITH,ITH4,6,Friuli-Venezia Giulia,Friuli Venezia Giulia,1215220,178295,14.67,0.11
1529,2021-02-01,FVG,2093,687,1406,1587,254,117,135,0,0,0,14,2079,ITH,ITH4,6,Friuli-Venezia Giulia,Friuli Venezia Giulia,1215220,180388,14.84,0.17
1530,2021-02-13,FVG,567,179,388,337,230,0,0,0,0,0,561,6,ITH,ITH4,6,Friuli-Venezia Giulia,Friuli Venezia Giulia,1215220,180955,14.89,0.05
1531,2021-03-20,FVG,3342,1350,1992,413,274,22,7,2381,179,66,1249,2093,ITH,ITH4,6,Friuli-Venezia Giulia,Friuli Venezia Giulia,1215220,184297,15.17,0.28
1532,2021-02-17,FVG,2351,997,1354,328,178,15,229,1555,46,0,1872,479,ITH,ITH4,6,Friuli-Venezia Giulia,Friuli Venezia Giulia,1215220,186648,15.36,0.19
1533,2021-02-16,FVG,2516,1135,1381,260,244,31,221,1760,0,0,2400,116,ITH,ITH4,6,Friuli-Venezia Giulia,Friuli Venezia Giulia,1215220,189164,15.57,0.21
1534,2021-02-18,FVG,3210,1488,1722,229,122,16,331,1500,34,978,2804,406,ITH,ITH4,6,Friuli-Venezia Giulia,Friuli Venezia Giulia,1215220,192374,15.83,0.26
1535,2021-02-19,FVG,3253,1290,1963,568,309,14,312,1589,35,426,2824,429,ITH,ITH4,6,Friuli-Venezia Giulia,Friuli Venezia Giulia,1215220,195627,16.1,0.27
1536,2021-01-19,FVG,7,2,5,5,0,0,2,0,0,0,7,0,ITH,ITH4,6,Friuli-Venezia Giulia,Friuli Venezia Giulia,1215220,195634,16.1,0.0
1537,2020-12-30,FVG,630,246,384,601,0,29,0,0,0,0,630,0,ITH,ITH4,6,Friuli-Venezia Giulia,Friuli Venezia Giulia,1215220,196264,16.15,0.05
1538,2021-02-21,FVG,800,281,519,213,166,11,25,383,1,1,423,377,ITH,ITH4,6,Friuli-Venezia Giulia,Friuli Venezia Giulia,1215220,197064,16.22,0.07
1539,2021-01-06,EMR,8262,2941,5321,6850,169,592,650,0,1,0,8262,0,ITH,ITH5,8,Emilia-Romagna,Emilia-Romagna,4459477,8262,0.19,0.19
1540,2021-01-31,EMR,7692,2758,4934,6172,806,453,261,0,0,0,242,7450,ITH,ITH5,8,Emilia-Romagna,Emilia-Romagna,4459477,15954,0.36,0.17
1541,2021-03-14,EMR,8465,3620,4845,699,172,770,69,5494,359,902,4689,3776,ITH,ITH5,8,Emilia-Romagna,Emilia-Romagna,4459477,24419,0.55,0.19
1542,2021-02-25,EMR,9156,3474,5682,793,132,384,140,7622,0,85,8204,952,ITH,ITH5,8,Emilia-Romagna,Emilia-Romagna,4459477,33575,0.75,0.21
1543,2021-03-17,EMR,13458,5586,7872,351,116,1251,49,11672,0,19,5727,7731,ITH,ITH5,8,Emilia-Romagna,Emilia-Romagna,4459477,47033,1.05,0.3
1544,2021-02-02,EMR,9432,3031,6401,6231,729,761,1630,80,0,1,497,8935,ITH,ITH5,8,Emilia-Romagna,Emilia-Romagna,4459477,56465,1.27,0.21
1545,2021-03-06,EMR,20355,5825,14530,2672,268,716,40,5859,517,10283,17663,2692,ITH,ITH5,8,Emilia-Romagna,Emilia-Romagna,4459477,76820,1.72,0.46
1546,2021-03-16,EMR,12021,4913,7108,409,67,654,97,10666,6,122,4790,7231,ITH,ITH5,8,Emilia-Romagna,Emilia-Romagna,4459477,88841,1.99,0.27
1547,2021-03-08,EMR,11444,4506,6938,2297,390,641,295,4272,1212,2337,8821,2623,ITH,ITH5,8,Emilia-Romagna,Emilia-Romagna,4459477,100285,2.25,0.26
1548,2021-01-15,EMR,7699,2393,5306,5297,438,646,1317,0,0,1,7699,0,ITH,ITH5,8,Emilia-Romagna,Emilia-Romagna,4459477,107984,2.42,0.17
1549,2021-01-29,EMR,10326,3477,6849,8081,388,840,1017,0,0,0,289,10037,ITH,ITH5,8,Emilia-Romagna,Emilia-Romagna,4459477,118310,2.65,0.23
1550,2021-02-26,EMR,7625,2888,4737,1008,293,331,218,5463,0,312,6587,1038,ITH,ITH5,8,Emilia-Romagna,Emilia-Romagna,4459477,125935,2.82,0.17
1551,2021-03-21,EMR,11384,4926,6458,565,291,3701,106,6079,58,584,6786,4598,ITH,ITH5,8,Emilia-Romagna,Emilia-Romagna,4459477,137319,3.08,0.26
1552,2021-01-13,EMR,9062,2938,6124,6005,435,877,1744,0,0,1,9062,0,ITH,ITH5,8,Emilia-Romagna,Emilia-Romagna,4459477,146381,3.28,0.2
1553,2021-02-06,EMR,7526,2379,5147,5358,480,466,1172,50,0,0,2120,5406,ITH,ITH5,8,Emilia-Romagna,Emilia-Romagna,4459477,153907,3.45,0.17
1554,2021-03-15,EMR,12626,5658,6968,792,179,1109,168,9075,777,526,6207,6419,ITH,ITH5,8,Emilia-Romagna,Emilia-Romagna,4459477,166533,3.73,0.28
1555,2021-01-10,EMR,7125,2663,4462,5642,652,325,499,6,0,1,7125,0,ITH,ITH5,8,Emilia-Romagna,Emilia-Romagna,4459477,173658,3.89,0.16
1556,2021-01-12,EMR,9314,3085,6229,6350,593,740,1631,0,0,0,9314,0,ITH,ITH5,8,Emilia-Romagna,Emilia-Romagna,4459477,182972,4.1,0.21
1557,2021-01-26,EMR,8324,3000,5324,6599,228,465,1032,0,0,0,216,8108,ITH,ITH5,8,Emilia-Romagna,Emilia-Romagna,4459477,191296,4.29,0.19
1558,2021-02-04,EMR,9902,3191,6711,6426,824,860,1674,118,0,0,1237,8665,ITH,ITH5,8,Emilia-Romagna,Emilia-Romagna,4459477,201198,4.51,0.22
1559,2021-01-23,EMR,2443,868,1575,1899,4,110,430,0,0,0,441,2002,ITH,ITH5,8,Emilia-Romagna,Emilia-Romagna,4459477,203641,4.57,0.05
1560,2021-03-07,EMR,6528,2433,4095,1452,320,417,22,2555,513,1249,5013,1515,ITH,ITH5,8,Emilia-Romagna,Emilia-Romagna,4459477,210169,4.71,0.15
1561,2021-03-02,EMR,11652,3828,7824,1934,332,456,224,5307,355,3044,9677,1975,ITH,ITH5,8,Emilia-Romagna,Emilia-Romagna,4459477,221821,4.97,0.26
1562,2021-03-13,EMR,15677,6088,9589,1245,157,1139,74,8216,886,3960,10391,5286,ITH,ITH5,8,Emilia-Romagna,Emilia-Romagna,4459477,237498,5.33,0.35
1563,2021-01-14,EMR,8086,2573,5513,5390,497,592,1606,0,1,0,8086,0,ITH,ITH5,8,Emilia-Romagna,Emilia-Romagna,4459477,245584,5.51,0.18
1564,2021-01-22,EMR,1827,477,1350,941,25,139,722,0,0,0,1088,739,ITH,ITH5,8,Emilia-Romagna,Emilia-Romagna,4459477,247411,5.55,0.04
1565,2021-01-02,EMR,2347,903,1444,2071,1,78,197,0,0,0,2347,0,ITH,ITH5,8,Emilia-Romagna,Emilia-Romagna,4459477,249758,5.6,0.05
1566,2021-02-12,EMR,5309,1676,3633,3391,458,451,704,305,0,0,3908,1401,ITH,ITH5,8,Emilia-Romagna,Emilia-Romagna,4459477,255067,5.72,0.12
1567,2021-03-01,EMR,9989,3544,6445,1820,265,331,433,5588,309,1243,7748,2241,ITH,ITH5,8,Emilia-Romagna,Emilia-Romagna,4459477,265056,5.94,0.22
1568,2021-02-08,EMR,5185,1519,3666,2827,378,315,1478,186,0,1,2290,2895,ITH,ITH5,8,Emilia-Romagna,Emilia-Romagna,4459477,270241,6.06,0.12
1569,2021-02-22,EMR,7462,3080,4382,386,84,134,129,6729,0,0,7199,263,ITH,ITH5,8,Emilia-Romagna,Emilia-Romagna,4459477,277703,6.23,0.17
1570,2021-02-05,EMR,9293,2959,6334,6211,628,659,1607,187,0,1,1625,7668,ITH,ITH5,8,Emilia-Romagna,Emilia-Romagna,4459477,286996,6.44,0.21
1571,2021-03-23,EMR,17813,7574,10239,1110,283,5938,179,8923,56,1324,11341,6472,ITH,ITH5,8,Emilia-Romagna,Emilia-Romagna,4459477,304809,6.84,0.4
1572,2021-01-24,EMR,2442,884,1558,2079,51,63,249,0,0,0,299,2143,ITH,ITH5,8,Emilia-Romagna,Emilia-Romagna,4459477,307251,6.89,0.05
1573,2021-03-04,EMR,16312,5316,10996,2598,482,717,239,6353,511,5412,13324,2988,ITH,ITH5,8,Emilia-Romagna,Emilia-Romagna,4459477,323563,7.26,0.37
1574,2021-03-22,EMR,16659,7150,9509,1119,316,4993,120,9449,65,597,9834,6825,ITH,ITH5,8,Emilia-Romagna,Emilia-Romagna,4459477,340222,7.63,0.37
1575,2021-03-24,EMR,19557,8571,10986,1192,268,6256,64,10081,88,1608,12556,7001,ITH,ITH5,8,Emilia-Romagna,Emilia-Romagna,4459477,359779,8.07,0.44
1576,2021-02-11,EMR,4244,1414,2830,2528,350,300,719,345,0,2,3406,838,ITH,ITH5,8,Emilia-Romagna,Emilia-Romagna,4459477,364023,8.16,0.1
1577,2021-01-17,EMR,2890,887,2003,1914,278,147,547,0,0,4,2644,246,ITH,ITH5,8,Emilia-Romagna,Emilia-Romagna,4459477,366913,8.23,0.06
1578,2020-12-31,EMR,2204,776,1428,1675,31,171,327,0,0,0,2204,0,ITH,ITH5,8,Emilia-Romagna,Emilia-Romagna,4459477,369117,8.28,0.05
1579,2021-03-19,EMR,13431,5641,7790,1034,269,1998,92,9636,78,324,6220,7211,ITH,ITH5,8,Emilia-Romagna,Emilia-Romagna,4459477,382548,8.58,0.3
1580,2021-01-19,EMR,2039,502,1537,745,84,51,1159,0,0,0,2022,17,ITH,ITH5,8,Emilia-Romagna,Emilia-Romagna,4459477,384587,8.62,0.05
1581,2021-01-18,EMR,3125,879,2246,1681,102,214,1128,0,0,0,2448,677,ITH,ITH5,8,Emilia-Romagna,Emilia-Romagna,4459477,387712,8.69,0.07
1582,2021-01-20,EMR,1321,269,1052,391,111,32,787,0,0,0,1320,1,ITH,ITH5,8,Emilia-Romagna,Emilia-Romagna,4459477,389033,8.72,0.03
1583,2020-12-27,EMR,968,372,596,824,1,117,26,0,0,0,968,0,ITH,ITH5,8,Emilia-Romagna,Emilia-Romagna,4459477,390001,8.75,0.02
1584,2021-02-01,EMR,10288,3595,6693,7445,787,797,1259,0,0,0,365,9923,ITH,ITH5,8,Emilia-Romagna,Emilia-Romagna,4459477,400289,8.98,0.23
1585,2021-02-13,EMR,3603,1077,2526,2779,238,255,145,186,0,0,3005,598,ITH,ITH5,8,Emilia-Romagna,Emilia-Romagna,4459477,403892,9.06,0.08
1586,2021-03-05,EMR,17535,5707,11828,3064,620,881,254,6253,530,5933,14136,3399,ITH,ITH5,8,Emilia-Romagna,Emilia-Romagna,4459477,421427,9.45,0.39
1587,2021-01-30,EMR,10037,3508,6529,7562,715,991,769,0,0,0,143,9894,ITH,ITH5,8,Emilia-Romagna,Emilia-Romagna,4459477,431464,9.68,0.23
1588,2021-03-20,EMR,15205,6277,8928,696,254,4103,93,9155,73,831,8375,6830,ITH,ITH5,8,Emilia-Romagna,Emilia-Romagna,4459477,446669,10.02,0.34
1589,2021-02-07,EMR,4786,1534,3252,3685,384,260,444,10,0,3,1727,3059,ITH,ITH5,8,Emilia-Romagna,Emilia-Romagna,4459477,451455,10.12,0.11
1590,2021-01-04,EMR,7258,2510,4748,6165,123,393,577,0,0,0,7258,0,ITH,ITH5,8,Emilia-Romagna,Emilia-Romagna,4459477,458713,10.29,0.16
1591,2021-03-12,EMR,17579,7187,10392,1577,360,1442,285,9798,1094,3023,10897,6682,ITH,ITH5,8,Emilia-Romagna,Emilia-Romagna,4459477,476292,10.68,0.39
1592,2021-02-03,EMR,9269,2972,6297,6227,701,639,1617,85,0,0,953,8316,ITH,ITH5,8,Emilia-Romagna,Emilia-Romagna,4459477,485561,10.89,0.21
1593,2021-02-19,EMR,7293,3002,4291,818,187,181,257,5850,0,0,6790,503,ITH,ITH5,8,Emilia-Romagna,Emilia-Romagna,4459477,492854,11.05,0.16
1594,2021-01-11,EMR,9323,3266,6057,6574,641,841,1267,0,0,0,9323,0,ITH,ITH5,8,Emilia-Romagna,Emilia-Romagna,4459477,502177,11.26,0.21
1595,2021-01-25,EMR,6413,2128,4285,5231,124,380,678,0,0,0,221,6192,ITH,ITH5,8,Emilia-Romagna,Emilia-Romagna,4459477,508590,11.4,0.14
1596,2021-01-07,EMR,10208,3381,6827,8181,287,672,1068,0,0,0,10208,0,ITH,ITH5,8,Emilia-Romagna,Emilia-Romagna,4459477,518798,11.63,0.23
1597,2021-02-23,EMR,8191,3213,4978,407,79,238,113,7353,0,1,7806,385,ITH,ITH5,8,Emilia-Romagna,Emilia-Romagna,4459477,526989,11.82,0.18
1598,2021-01-03,EMR,2729,934,1795,2479,12,68,170,0,0,0,2729,0,ITH,ITH5,8,Emilia-Romagna,Emilia-Romagna,4459477,529718,11.88,0.06
1599,2021-01-16,EMR,5592,1717,3875,3687,347,446,1108,0,3,1,5592,0,ITH,ITH5,8,Emilia-Romagna,Emilia-Romagna,4459477,535310,12.0,0.13
1600,2021-02-17,EMR,6533,2761,3772,803,205,1073,404,4048,0,0,5760,773,ITH,ITH5,8,Emilia-Romagna,Emilia-Romagna,4459477,541843,12.15,0.15
1601,2021-02-16,EMR,5728,2427,3301,743,241,667,437,3640,0,0,5198,530,ITH,ITH5,8,Emilia-Romagna,Emilia-Romagna,4459477,547571,12.28,0.13
1602,2021-02-18,EMR,7043,2892,4151,891,135,396,236,5385,0,0,6461,582,ITH,ITH5,8,Emilia-Romagna,Emilia-Romagna,4459477,554614,12.44,0.16
1603,2021-02-09,EMR,4150,1246,2904,2217,226,241,1198,268,0,0,2305,1845,ITH,ITH5,8,Emilia-Romagna,Emilia-Romagna,4459477,558764,12.53,0.09
1604,2021-03-18,EMR,13316,5636,7680,450,120,1995,38,10664,1,48,5533,7783,ITH,ITH5,8,Emilia-Romagna,Emilia-Romagna,4459477,572080,12.83,0.3
1605,2021-01-28,EMR,10220,3333,6887,8068,288,742,1122,0,0,0,348,9872,ITH,ITH5,8,Emilia-Romagna,Emilia-Romagna,4459477,582300,13.06,0.23
1606,2021-02-27,EMR,10942,3988,6954,1719,178,321,114,7671,0,939,9211,1731,ITH,ITH5,8,Emilia-Romagna,Emilia-Romagna,4459477,593242,13.3,0.25
1607,2021-03-03,EMR,15673,5187,10486,2527,345,727,141,6798,340,4795,13231,2442,ITH,ITH5,8,Emilia-Romagna,Emilia-Romagna,4459477,608915,13.65,0.35
1608,2021-03-25,EMR,19476,8429,11047,1052,213,6838,81,9376,61,1855,12897,6579,ITH,ITH5,8,Emilia-Romagna,Emilia-Romagna,4459477,628391,14.09,0.44
1609,2021-02-20,EMR,5309,2100,3209,406,92,147,155,4509,0,0,5045,264,ITH,ITH5,8,Emilia-Romagna,Emilia-Romagna,4459477,633700,14.21,0.12
1610,2021-02-15,EMR,2890,845,2045,1981,322,141,157,289,0,0,2764,126,ITH,ITH5,8,Emilia-Romagna,Emilia-Romagna,4459477,636590,14.27,0.06
1611,2021-02-10,EMR,3935,1353,2582,2330,215,359,775,256,0,0,2735,1200,ITH,ITH5,8,Emilia-Romagna,Emilia-Romagna,4459477,640525,14.36,0.09
1612,2021-01-27,EMR,8316,2934,5382,6886,224,551,654,0,1,0,463,7853,ITH,ITH5,8,Emilia-Romagna,Emilia-Romagna,4459477,648841,14.55,0.19
1613,2021-01-09,EMR,9874,3425,6449,7824,555,614,881,0,0,0,9874,0,ITH,ITH5,8,Emilia-Romagna,Emilia-Romagna,4459477,658715,14.77,0.22
1614,2021-01-08,EMR,10808,3555,7253,8454,423,851,1080,0,0,0,10808,0,ITH,ITH5,8,Emilia-Romagna,Emilia-Romagna,4459477,669523,15.01,0.24
1615,2021-02-24,EMR,9272,3542,5730,639,87,495,220,7768,0,63,8413,859,ITH,ITH5,8,Emilia-Romagna,Emilia-Romagna,4459477,678795,15.22,0.21
1616,2021-03-09,EMR,14336,5764,8572,1023,240,698,180,7563,1072,3560,10402,3934,ITH,ITH5,8,Emilia-Romagna,Emilia-Romagna,4459477,693131,15.54,0.32
1617,2021-02-14,EMR,1398,377,1021,858,337,145,39,19,0,0,1278,120,ITH,ITH5,8,Emilia-Romagna,Emilia-Romagna,4459477,694529,15.57,0.03
1618,2021-02-21,EMR,4406,1693,2713,394,82,187,190,3553,0,0,3969,437,ITH,ITH5,8,Emilia-Romagna,Emilia-Romagna,4459477,698935,15.67,0.1
1619,2021-02-28,EMR,6813,2524,4289,1769,226,235,53,4222,4,304,4970,1843,ITH,ITH5,8,Emilia-Romagna,Emilia-Romagna,4459477,705748,15.83,0.15
1620,2021-03-10,EMR,18181,7325,10856,1313,218,1020,128,9895,1113,4494,12558,5623,ITH,ITH5,8,Emilia-Romagna,Emilia-Romagna,4459477,723929,16.23,0.41
1621,2021-01-05,EMR,9324,3163,6161,7924,280,355,765,0,0,0,9324,0,ITH,ITH5,8,Emilia-Romagna,Emilia-Romagna,4459477,733253,16.44,0.21
1622,2021-03-11,EMR,16922,6937,9985,1131,294,1426,274,8799,1216,3782,11100,5822,ITH,ITH5,8,Emilia-Romagna,Emilia-Romagna,4459477,750175,16.82,0.38
1623,2021-01-21,EMR,2151,725,1426,1282,97,119,653,0,0,0,809,1342,ITH,ITH5,8,Emilia-Romagna,Emilia-Romagna,4459477,752326,16.87,0.05
1624,2021-02-16,CAM,5437,2410,3027,983,272,836,169,3176,0,1,4666,771,ITF,ITF3,15,Campania,Campania,5801692,5437,0.09,0.09
1625,2021-01-25,CAM,5744,2926,2818,4743,644,301,56,0,0,0,164,5580,ITF,ITF3,15,Campania,Campania,5801692,11181,0.19,0.1
1626,2021-02-27,CAM,13941,4470,9471,825,285,1280,82,3161,0,8308,12299,1642,ITF,ITF3,15,Campania,Campania,5801692,25122,0.43,0.24
1627,2021-02-18,CAM,9078,3811,5267,1752,228,1033,88,5540,0,437,8370,708,ITF,ITF3,15,Campania,Campania,5801692,34200,0.59,0.16
1628,2021-02-17,CAM,7388,3210,4178,1013,197,870,38,4908,0,362,6328,1060,ITF,ITF3,15,Campania,Campania,5801692,41588,0.72,0.13
1629,2021-01-09,CAM,10566,5024,5542,6759,1256,2282,269,0,0,0,10566,0,ITF,ITF3,15,Campania,Campania,5801692,52154,0.9,0.18
1630,2021-01-29,CAM,10052,4812,5240,6405,1052,2336,259,0,0,0,47,10005,ITF,ITF3,15,Campania,Campania,5801692,62206,1.07,0.17
1631,2021-03-20,CAM,13915,6435,7480,295,35,3813,35,6529,324,2884,10176,3739,ITF,ITF3,15,Campania,Campania,5801692,76121,1.31,0.24
1632,2021-02-15,CAM,5468,2514,2954,986,220,771,94,3395,1,1,5295,173,ITF,ITF3,15,Campania,Campania,5801692,81589,1.41,0.09
1633,2021-02-09,CAM,4643,2202,2441,1148,178,1973,6,1338,0,0,4391,252,ITF,ITF3,15,Campania,Campania,5801692,86232,1.49,0.08
1634,2021-02-07,CAM,2936,1386,1550,712,189,1519,226,290,0,0,2158,778,ITF,ITF3,15,Campania,Campania,5801692,89168,1.54,0.05
1635,2020-12-31,CAM,1490,811,679,1273,150,66,1,0,0,0,1490,0,ITF,ITF3,15,Campania,Campania,5801692,90658,1.56,0.03
1636,2021-02-20,CAM,8564,3079,5485,1023,60,788,145,4582,0,1966,8261,303,ITF,ITF3,15,Campania,Campania,5801692,99222,1.71,0.15
1637,2021-02-10,CAM,6904,3413,3491,1945,284,2419,98,2158,0,0,6728,176,ITF,ITF3,15,Campania,Campania,5801692,106126,1.83,0.12
1638,2021-01-14,CAM,7072,2976,4096,3706,1264,1752,350,0,0,0,7072,0,ITF,ITF3,15,Campania,Campania,5801692,113198,1.95,0.12
1639,2021-02-25,CAM,12422,4479,7943,803,119,907,124,5664,0,4805,11234,1188,ITF,ITF3,15,Campania,Campania,5801692,125620,2.17,0.21
1640,2021-01-08,CAM,10455,4969,5486,6714,1147,2382,212,0,0,0,10455,0,ITF,ITF3,15,Campania,Campania,5801692,136075,2.35,0.18
1641,2021-01-28,CAM,8832,4122,4710,6216,1093,1176,347,0,0,0,135,8697,ITF,ITF3,15,Campania,Campania,5801692,144907,2.5,0.15
1642,2021-01-19,CAM,1095,474,621,534,129,261,171,0,0,0,1092,3,ITF,ITF3,15,Campania,Campania,5801692,146002,2.52,0.02
1643,2021-03-11,CAM,17527,8638,8889,1048,254,3010,105,8932,1384,2794,10251,7276,ITF,ITF3,15,Campania,Campania,5801692,163529,2.82,0.3
1644,2021-02-02,CAM,5722,2804,2918,3640,828,900,354,0,0,0,443,5279,ITF,ITF3,15,Campania,Campania,5801692,169251,2.92,0.1
1645,2020-12-27,CAM,720,422,298,703,14,3,0,0,0,0,720,0,ITF,ITF3,15,Campania,Campania,5801692,169971,2.93,0.01
1646,2021-03-04,CAM,14644,5345,9299,1900,289,1922,136,5562,1,4834,8751,5893,ITF,ITF3,15,Campania,Campania,5801692,184615,3.18,0.25
1647,2021-03-24,CAM,17612,8079,9533,408,71,7679,63,6717,232,2442,14660,2952,ITF,ITF3,15,Campania,Campania,5801692,202227,3.49,0.3
1648,2021-01-24,CAM,4128,2123,2005,3140,410,412,166,0,0,0,383,3745,ITF,ITF3,15,Campania,Campania,5801692,206355,3.56,0.07
1649,2021-03-25,CAM,19925,9320,10605,307,37,9528,8,7396,170,2479,16423,3502,ITF,ITF3,15,Campania,Campania,5801692,226280,3.9,0.34
1650,2021-03-19,CAM,11015,4865,6150,391,67,1214,21,8425,44,853,7149,3866,ITF,ITF3,15,Campania,Campania,5801692,237295,4.09,0.19
1651,2021-02-24,CAM,11763,4143,7620,845,192,436,141,5960,0,4189,11075,688,ITF,ITF3,15,Campania,Campania,5801692,249058,4.29,0.2
1652,2021-02-28,CAM,10400,3204,7196,495,113,2047,22,2227,0,5496,8501,1899,ITF,ITF3,15,Campania,Campania,5801692,259458,4.47,0.18
1653,2021-02-21,CAM,5833,2239,3594,780,44,609,22,3870,0,508,5608,225,ITF,ITF3,15,Campania,Campania,5801692,265291,4.57,0.1
1654,2021-01-17,CAM,1155,551,604,718,54,232,151,0,0,0,702,453,ITF,ITF3,15,Campania,Campania,5801692,266446,4.59,0.02
1655,2021-01-11,CAM,4072,1871,2201,2386,681,753,252,0,0,0,4072,0,ITF,ITF3,15,Campania,Campania,5801692,270518,4.66,0.07
1656,2021-03-14,CAM,8507,3723,4784,328,97,666,2,4546,850,2018,4369,4138,ITF,ITF3,15,Campania,Campania,5801692,279025,4.81,0.15
1657,2021-02-14,CAM,3933,1926,2007,633,84,736,17,2463,0,0,3890,43,ITF,ITF3,15,Campania,Campania,5801692,282958,4.88,0.07
1658,2021-02-06,CAM,5341,2665,2676,1990,520,2357,459,15,0,0,2103,3238,ITF,ITF3,15,Campania,Campania,5801692,288299,4.97,0.09
1659,2021-01-10,CAM,8165,3736,4429,5179,1010,1879,97,0,0,0,8165,0,ITF,ITF3,15,Campania,Campania,5801692,296464,5.11,0.14
1660,2021-01-04,CAM,5826,2963,2863,4850,679,297,0,0,0,0,5826,0,ITF,ITF3,15,Campania,Campania,5801692,302290,5.21,0.1
1661,2021-01-15,CAM,4980,2381,2599,2740,832,1217,191,0,0,0,4980,0,ITF,ITF3,15,Campania,Campania,5801692,307270,5.3,0.09
1662,2021-03-15,CAM,12903,6077,6826,800,131,2535,82,6277,511,2567,8203,4700,ITF,ITF3,15,Campania,Campania,5801692,320173,5.52,0.22
1663,2021-02-03,CAM,8903,4002,4901,4736,1102,2350,714,1,0,0,878,8025,ITF,ITF3,15,Campania,Campania,5801692,329076,5.67,0.15
1664,2021-01-12,CAM,5213,2563,2650,3438,722,713,340,0,0,0,5213,0,ITF,ITF3,15,Campania,Campania,5801692,334289,5.76,0.09
1665,2021-02-19,CAM,9556,3557,5999,1663,141,943,161,4455,0,2193,8906,650,ITF,ITF3,15,Campania,Campania,5801692,343845,5.93,0.16
1666,2021-03-02,CAM,12745,4550,8195,1294,193,1978,147,3232,2,5899,8401,4344,ITF,ITF3,15,Campania,Campania,5801692,356590,6.15,0.22
1667,2021-03-22,CAM,12746,5921,6825,309,755,5169,71,3500,469,2473,10708,2038,ITF,ITF3,15,Campania,Campania,5801692,369336,6.37,0.22
1668,2021-01-23,CAM,3839,2029,1810,3161,344,265,69,0,0,0,273,3566,ITF,ITF3,15,Campania,Campania,5801692,373175,6.43,0.07
1669,2021-03-17,CAM,11573,5092,6481,490,123,746,49,10003,33,129,4996,6577,ITF,ITF3,15,Campania,Campania,5801692,384748,6.63,0.2
1670,2021-03-23,CAM,15333,7057,8276,359,488,6020,180,4731,261,3294,12829,2504,ITF,ITF3,15,Campania,Campania,5801692,400081,6.9,0.26
1671,2021-02-05,CAM,7261,3463,3798,3447,995,2502,308,9,0,0,2133,5128,ITF,ITF3,15,Campania,Campania,5801692,407342,7.02,0.13
1672,2021-01-05,CAM,7237,3638,3599,5810,923,398,106,0,0,0,7237,0,ITF,ITF3,15,Campania,Campania,5801692,414579,7.15,0.12
1673,2021-01-30,CAM,10721,5079,5642,6930,1278,2286,227,0,0,0,39,10682,ITF,ITF3,15,Campania,Campania,5801692,425300,7.33,0.18
1674,2021-01-18,CAM,957,399,558,576,93,101,187,0,0,0,713,244,ITF,ITF3,15,Campania,Campania,5801692,426257,7.35,0.02
1675,2021-03-13,CAM,14257,6793,7464,404,82,1879,193,6614,1397,3688,8972,5285,ITF,ITF3,15,Campania,Campania,5801692,440514,7.59,0.25
1676,2021-02-22,CAM,10610,3282,7328,522,46,472,138,3891,0,5541,10348,262,ITF,ITF3,15,Campania,Campania,5801692,451124,7.78,0.18
1677,2021-01-06,CAM,7652,3749,3903,5781,838,733,300,0,0,0,7652,0,ITF,ITF3,15,Campania,Campania,5801692,458776,7.91,0.13
1678,2021-03-16,CAM,8084,3519,4565,289,53,679,60,6866,23,114,3770,4314,ITF,ITF3,15,Campania,Campania,5801692,466860,8.05,0.14
1679,2021-01-01,CAM,919,506,413,831,85,3,0,0,0,0,919,0,ITF,ITF3,15,Campania,Campania,5801692,467779,8.06,0.02
1680,2021-02-11,CAM,6279,2705,3574,1862,279,1646,129,2363,0,0,6213,66,ITF,ITF3,15,Campania,Campania,5801692,474058,8.17,0.11
1681,2021-03-01,CAM,12119,4243,7876,1153,306,1665,145,3065,0,5785,8008,4111,ITF,ITF3,15,Campania,Campania,5801692,486177,8.38,0.21
1682,2021-02-04,CAM,7943,3429,4514,3965,1245,2440,292,1,0,0,1308,6635,ITF,ITF3,15,Campania,Campania,5801692,494120,8.52,0.14
1683,2021-03-12,CAM,14237,7087,7150,1022,151,2028,82,6591,1569,2794,8156,6081,ITF,ITF3,15,Campania,Campania,5801692,508357,8.76,0.25
1684,2021-01-16,CAM,3369,1675,1694,1355,230,1411,373,0,0,0,3369,0,ITF,ITF3,15,Campania,Campania,5801692,511726,8.82,0.06
1685,2021-02-08,CAM,5113,2449,2664,1388,320,1801,226,1378,0,0,4311,802,ITF,ITF3,15,Campania,Campania,5801692,516839,8.91,0.09
1686,2021-01-02,CAM,3674,1963,1711,3167,341,166,0,0,0,0,3674,0,ITF,ITF3,15,Campania,Campania,5801692,520513,8.97,0.06
1687,2021-01-27,CAM,7737,3820,3917,5838,875,754,270,0,0,0,162,7575,ITF,ITF3,15,Campania,Campania,5801692,528250,9.11,0.13
1688,2021-03-09,CAM,13827,6613,7214,797,266,2761,184,4494,1148,4177,10046,3781,ITF,ITF3,15,Campania,Campania,5801692,542077,9.34,0.24
1689,2021-01-21,CAM,2093,1116,977,1379,153,486,75,0,0,0,677,1416,ITF,ITF3,15,Campania,Campania,5801692,544170,9.38,0.04
1690,2021-03-06,CAM,16295,6746,9549,993,132,1359,171,7127,1027,5486,10629,5666,ITF,ITF3,15,Campania,Campania,5801692,560465,9.66,0.28
1691,2021-03-21,CAM,9955,4576,5379,167,27,4968,17,2914,188,1674,7586,2369,ITF,ITF3,15,Campania,Campania,5801692,570420,9.83,0.17
1692,2021-03-08,CAM,14500,6703,7797,886,245,2179,36,4863,1334,4957,9725,4775,ITF,ITF3,15,Campania,Campania,5801692,584920,10.08,0.25
1693,2021-03-10,CAM,15235,7370,7865,704,240,2311,26,8430,1058,2466,8407,6828,ITF,ITF3,15,Campania,Campania,5801692,600155,10.34,0.26
1694,2021-02-23,CAM,10985,3382,7603,520,85,401,286,3755,0,5938,10459,526,ITF,ITF3,15,Campania,Campania,5801692,611140,10.53,0.19
1695,2021-03-03,CAM,13917,5494,8423,2088,234,2458,156,4746,3,4232,7288,6629,ITF,ITF3,15,Campania,Campania,5801692,625057,10.77,0.24
1696,2021-01-20,CAM,1257,650,607,395,146,615,101,0,0,0,1257,0,ITF,ITF3,15,Campania,Campania,5801692,626314,10.8,0.02
1697,2021-01-31,CAM,8066,3711,4355,5106,1012,1881,67,0,0,0,23,8043,ITF,ITF3,15,Campania,Campania,5801692,634380,10.93,0.14
1698,2021-03-18,CAM,12153,5373,6780,460,76,1097,34,9951,76,459,5966,6187,ITF,ITF3,15,Campania,Campania,5801692,646533,11.14,0.21
1699,2021-03-05,CAM,16472,6347,10125,1681,224,2364,64,6348,4,5787,9814,6658,ITF,ITF3,15,Campania,Campania,5801692,663005,11.43,0.28
1700,2021-02-26,CAM,13324,4228,9096,950,125,798,219,3403,1,7828,11989,1335,ITF,ITF3,15,Campania,Campania,5801692,676329,11.66,0.23
1701,2021-02-01,CAM,3985,1813,2172,2504,656,673,152,0,0,0,110,3875,ITF,ITF3,15,Campania,Campania,5801692,680314,11.73,0.07
1702,2021-01-13,CAM,8019,3665,4354,4350,1031,2051,587,0,0,0,8019,0,ITF,ITF3,15,Campania,Campania,5801692,688333,11.86,0.14
1703,2021-01-03,CAM,3837,2009,1828,3191,401,245,0,0,0,0,3837,0,ITF,ITF3,15,Campania,Campania,5801692,692170,11.93,0.07
1704,2021-01-07,CAM,8910,4166,4744,6313,1087,1178,332,0,0,0,8910,0,ITF,ITF3,15,Campania,Campania,5801692,701080,12.08,0.15
1705,2021-03-07,CAM,11911,5344,6567,533,109,1302,85,4019,1512,4351,8070,3841,ITF,ITF3,15,Campania,Campania,5801692,712991,12.29,0.21
1706,2021-02-12,CAM,6555,2876,3679,1905,263,1111,214,3058,0,4,6343,212,ITF,ITF3,15,Campania,Campania,5801692,719546,12.4,0.11
1707,2021-01-22,CAM,1523,775,748,970,120,224,209,0,0,0,673,850,ITF,ITF3,15,Campania,Campania,5801692,721069,12.43,0.03
1708,2021-02-13,CAM,5508,2549,2959,960,99,701,131,3615,0,2,5291,217,ITF,ITF3,15,Campania,Campania,5801692,726577,12.52,0.09
1709,2021-01-26,CAM,7297,3701,3596,5742,846,487,222,0,0,0,352,6945,ITF,ITF3,15,Campania,Campania,5801692,733874,12.65,0.13
1710,2021-03-17,LOM,25825,10319,15506,2488,1297,1014,1899,19044,44,39,15006,10819,ITC,ITC4,3,Lombardia,Lombardia,10060574,25825,0.26,0.26
1711,2021-02-17,LOM,11793,3707,8086,7590,2149,107,1860,39,38,10,10438,1355,ITC,ITC4,3,Lombardia,Lombardia,10060574,37618,0.37,0.12
1712,2020-12-27,LOM,702,407,295,601,45,41,14,1,0,0,702,0,ITC,ITC4,3,Lombardia,Lombardia,10060574,38320,0.38,0.01
1713,2021-03-08,LOM,29326,11019,18307,6512,1962,2443,1014,11298,1575,4522,22407,6919,ITC,ITC4,3,Lombardia,Lombardia,10060574,67646,0.67,0.29
1714,2021-01-22,LOM,2942,829,2113,1569,595,34,735,9,0,0,2882,60,ITC,ITC4,3,Lombardia,Lombardia,10060574,70588,0.7,0.03
1715,2021-03-12,LOM,34238,12683,21555,5036,2146,2298,1405,15388,1086,6879,24202,10036,ITC,ITC4,3,Lombardia,Lombardia,10060574,104826,1.04,0.34
1716,2021-02-08,LOM,9802,2859,6943,5195,2170,69,2315,53,0,0,2089,7713,ITC,ITC4,3,Lombardia,Lombardia,10060574,114628,1.14,0.1
1717,2021-03-20,LOM,31605,11739,19866,1890,1157,1853,520,18133,284,7768,21861,9744,ITC,ITC4,3,Lombardia,Lombardia,10060574,146233,1.45,0.31
1718,2021-02-03,LOM,25427,7863,17564,15556,5553,152,4015,142,8,1,1120,24307,ITC,ITC4,3,Lombardia,Lombardia,10060574,171660,1.71,0.25
1719,2021-01-03,LOM,852,316,536,744,87,16,4,1,0,0,852,0,ITC,ITC4,3,Lombardia,Lombardia,10060574,172512,1.71,0.01
1720,2021-01-04,LOM,5979,2059,3920,4917,692,186,173,11,0,0,5979,0,ITC,ITC4,3,Lombardia,Lombardia,10060574,178491,1.77,0.06
1721,2021-01-28,LOM,12156,3684,8472,9172,1784,199,971,28,1,1,775,11381,ITC,ITC4,3,Lombardia,Lombardia,10060574,190647,1.89,0.12
1722,2021-01-31,LOM,9727,3754,5973,7568,1996,67,87,7,2,0,33,9694,ITC,ITC4,3,Lombardia,Lombardia,10060574,200374,1.99,0.1
1723,2021-02-01,LOM,16029,5308,10721,11661,3315,106,902,43,1,1,324,15705,ITC,ITC4,3,Lombardia,Lombardia,10060574,216403,2.15,0.16
1724,2021-02-04,LOM,27237,7980,19257,15652,5732,150,5502,194,7,0,1940,25297,ITC,ITC4,3,Lombardia,Lombardia,10060574,243640,2.42,0.27
1725,2021-03-11,LOM,35623,13294,22329,5768,2379,2504,2080,15024,1216,6652,25930,9693,ITC,ITC4,3,Lombardia,Lombardia,10060574,279263,2.78,0.35
1726,2021-02-02,LOM,19807,6568,13239,13481,4408,155,1679,76,7,1,489,19318,ITC,ITC4,3,Lombardia,Lombardia,10060574,299070,2.97,0.2
1727,2021-01-20,LOM,5578,1364,4214,2743,1174,45,1557,59,0,0,5463,115,ITC,ITC4,3,Lombardia,Lombardia,10060574,304648,3.03,0.06
1728,2021-03-10,LOM,32336,12367,19969,6787,2497,2625,1947,11508,1531,5441,24707,7629,ITC,ITC4,3,Lombardia,Lombardia,10060574,336984,3.35,0.32
1729,2021-02-23,LOM,11696,4772,6924,3936,1350,266,841,4310,990,3,11388,308,ITC,ITC4,3,Lombardia,Lombardia,10060574,348680,3.47,0.12
1730,2021-01-13,LOM,25930,7950,17980,15644,5675,297,4122,189,2,1,25930,0,ITC,ITC4,3,Lombardia,Lombardia,10060574,374610,3.72,0.26
1731,2021-01-29,LOM,13436,4114,9322,10485,2256,113,573,9,0,0,654,12782,ITC,ITC4,3,Lombardia,Lombardia,10060574,388046,3.86,0.13
1732,2021-02-24,LOM,14627,5909,8718,3576,1441,306,1784,6315,1181,24,13704,923,ITC,ITC4,3,Lombardia,Lombardia,10060574,402673,4.0,0.15
1733,2021-01-17,LOM,8249,3321,4928,5547,699,1751,211,36,5,0,8049,200,ITC,ITC4,3,Lombardia,Lombardia,10060574,410922,4.08,0.08
1734,2021-03-04,LOM,28899,11958,16941,6897,2179,4655,2059,10786,1947,376,20010,8889,ITC,ITC4,3,Lombardia,Lombardia,10060574,439821,4.37,0.29
1735,2021-02-25,LOM,15095,6268,8827,2948,1286,329,1292,8014,1216,10,13551,1544,ITC,ITC4,3,Lombardia,Lombardia,10060574,454916,4.52,0.15
1736,2021-03-25,LOM,37673,13897,23776,3279,1148,3573,973,18025,185,10490,27500,10173,ITC,ITC4,3,Lombardia,Lombardia,10060574,492589,4.9,0.37
1737,2021-02-07,LOM,7172,2793,4379,5540,1285,60,263,17,2,5,339,6833,ITC,ITC4,3,Lombardia,Lombardia,10060574,499761,4.97,0.07
1738,2021-01-02,LOM,199,72,127,178,16,5,0,0,0,0,199,0,ITC,ITC4,3,Lombardia,Lombardia,10060574,499960,4.97,0.0
1739,2021-01-11,LOM,16016,5321,10695,11811,3303,158,699,42,1,2,16016,0,ITC,ITC4,3,Lombardia,Lombardia,10060574,515976,5.13,0.16
1740,2021-01-15,LOM,24542,7236,17306,13585,5772,428,4453,302,2,0,24542,0,ITC,ITC4,3,Lombardia,Lombardia,10060574,540518,5.37,0.24
1741,2020-12-31,LOM,713,300,413,657,56,0,0,0,0,0,713,0,ITC,ITC4,3,Lombardia,Lombardia,10060574,541231,5.38,0.01
1742,2021-02-28,LOM,7834,3234,4600,1106,694,1586,76,4259,82,31,7618,216,ITC,ITC4,3,Lombardia,Lombardia,10060574,549065,5.46,0.08
1743,2021-03-19,LOM,31933,12715,19218,2710,1696,1204,1287,21881,150,3005,18966,12967,ITC,ITC4,3,Lombardia,Lombardia,10060574,580998,5.77,0.32
1744,2021-02-15,LOM,8795,3079,5716,6012,1603,150,986,4,31,9,8375,420,ITC,ITC4,3,Lombardia,Lombardia,10060574,589793,5.86,0.09
1745,2021-02-18,LOM,13949,4904,9045,6113,1790,157,1567,3437,857,28,12926,1023,ITC,ITC4,3,Lombardia,Lombardia,10060574,603742,6.0,0.14
1746,2021-03-06,LOM,21161,9031,12130,4750,1850,4319,438,7432,1025,1347,16651,4510,ITC,ITC4,3,Lombardia,Lombardia,10060574,624903,6.21,0.21
1747,2021-01-18,LOM,9092,2948,6144,5159,1940,107,1830,54,2,0,8110,982,ITC,ITC4,3,Lombardia,Lombardia,10060574,633995,6.3,0.09
1748,2021-01-05,LOM,7692,2524,5168,6178,1108,227,172,7,0,0,7692,0,ITC,ITC4,3,Lombardia,Lombardia,10060574,641687,6.38,0.08
1749,2021-02-22,LOM,11655,4713,6942,4165,1393,143,932,4029,965,28,11346,309,ITC,ITC4,3,Lombardia,Lombardia,10060574,653342,6.49,0.12
1750,2021-03-14,LOM,14268,5044,9224,1497,566,1194,80,5258,396,5277,10998,3270,ITC,ITC4,3,Lombardia,Lombardia,10060574,667610,6.64,0.14
1751,2021-02-10,LOM,14192,4447,9745,8450,2270,109,3283,71,3,6,7452,6740,ITC,ITC4,3,Lombardia,Lombardia,10060574,681802,6.78,0.14
1752,2021-01-24,LOM,1186,454,732,830,134,197,24,1,0,0,523,663,ITC,ITC4,3,Lombardia,Lombardia,10060574,682988,6.79,0.01
1753,2021-03-24,LOM,40172,14339,25833,2922,1260,3827,1313,18108,433,12309,30197,9975,ITC,ITC4,3,Lombardia,Lombardia,10060574,723160,7.19,0.4
1754,2021-03-22,LOM,39066,13719,25347,2406,1301,2336,680,19844,443,12056,29061,10005,ITC,ITC4,3,Lombardia,Lombardia,10060574,762226,7.58,0.39
1755,2021-01-26,LOM,8325,2704,5621,6640,1270,170,223,22,0,0,334,7991,ITC,ITC4,3,Lombardia,Lombardia,10060574,770551,7.66,0.08
1756,2021-03-07,LOM,11081,4891,6190,2998,895,1387,73,4520,552,656,8529,2552,ITC,ITC4,3,Lombardia,Lombardia,10060574,781632,7.77,0.11
1757,2020-12-28,LOM,103,44,59,102,1,0,0,0,0,0,103,0,ITC,ITC4,3,Lombardia,Lombardia,10060574,781735,7.77,0.0
1758,2021-03-15,LOM,31134,11165,19969,4650,2139,1826,832,12867,594,8226,22747,8387,ITC,ITC4,3,Lombardia,Lombardia,10060574,812869,8.08,0.31
1759,2021-02-19,LOM,14035,5357,8678,5529,1618,268,1136,4540,928,16,13358,677,ITC,ITC4,3,Lombardia,Lombardia,10060574,826904,8.22,0.14
1760,2021-01-12,LOM,19733,6581,13152,13405,4437,235,1563,92,1,0,19733,0,ITC,ITC4,3,Lombardia,Lombardia,10060574,846637,8.42,0.2
1761,2021-01-01,LOM,24,7,17,24,0,0,0,0,0,0,24,0,ITC,ITC4,3,Lombardia,Lombardia,10060574,846661,8.42,0.0
1762,2021-01-08,LOM,12599,3898,8701,9962,2175,143,314,5,0,0,12599,0,ITC,ITC4,3,Lombardia,Lombardia,10060574,859260,8.54,0.13
1763,2021-02-21,LOM,5004,1851,3153,1743,807,152,32,2227,40,3,4984,20,ITC,ITC4,3,Lombardia,Lombardia,10060574,864264,8.59,0.05
1764,2020-12-30,LOM,113,42,71,105,7,1,0,0,0,0,113,0,ITC,ITC4,3,Lombardia,Lombardia,10060574,864377,8.59,0.0
1765,2021-02-09,LOM,12104,3298,8806,5716,2206,92,4009,75,2,4,4001,8103,ITC,ITC4,3,Lombardia,Lombardia,10060574,876481,8.71,0.12
1766,2021-01-16,LOM,15316,5695,9621,8599,1230,3850,1482,152,3,0,15316,0,ITC,ITC4,3,Lombardia,Lombardia,10060574,891797,8.86,0.15
1767,2021-01-30,LOM,12309,4565,7744,9902,2048,189,160,8,1,1,192,12117,ITC,ITC4,3,Lombardia,Lombardia,10060574,904106,8.99,0.12
1768,2021-03-23,LOM,40723,14676,26047,2023,1282,3225,1172,20379,321,12321,28798,11925,ITC,ITC4,3,Lombardia,Lombardia,10060574,944829,9.39,0.4
1769,2021-02-05,LOM,25028,7282,17746,14114,6041,183,4431,258,1,0,2132,22896,ITC,ITC4,3,Lombardia,Lombardia,10060574,969857,9.64,0.25
1770,2021-03-16,LOM,25271,10028,15243,3290,1344,1542,1391,17612,17,75,16290,8981,ITC,ITC4,3,Lombardia,Lombardia,10060574,995128,9.89,0.25
1771,2021-03-09,LOM,32417,12462,19955,6031,2530,2727,2266,12025,1427,5411,25090,7327,ITC,ITC4,3,Lombardia,Lombardia,10060574,1027545,10.21,0.32
1772,2021-02-12,LOM,13481,4216,9265,7978,2565,93,2735,102,5,3,8742,4739,ITC,ITC4,3,Lombardia,Lombardia,10060574,1041026,10.35,0.13
1773,2021-01-25,LOM,7020,2370,4650,5629,911,248,218,14,0,0,486,6534,ITC,ITC4,3,Lombardia,Lombardia,10060574,1048046,10.42,0.07
1774,2021-01-27,LOM,8028,2675,5353,6192,1244,155,434,1,0,2,820,7208,ITC,ITC4,3,Lombardia,Lombardia,10060574,1056074,10.5,0.08
1775,2021-02-06,LOM,15070,5467,9603,9736,2910,488,1861,71,1,3,977,14093,ITC,ITC4,3,Lombardia,Lombardia,10060574,1071144,10.65,0.15
1776,2021-03-01,LOM,18579,8140,10439,2635,1017,1598,900,10792,1609,28,16875,1704,ITC,ITC4,3,Lombardia,Lombardia,10060574,1089723,10.83,0.18
1777,2021-01-06,LOM,7051,2487,4564,5841,1020,150,38,0,0,2,7051,0,ITC,ITC4,3,Lombardia,Lombardia,10060574,1096774,10.9,0.07
1778,2021-02-20,LOM,9387,3880,5507,4275,973,137,216,2919,863,4,9094,293,ITC,ITC4,3,Lombardia,Lombardia,10060574,1106161,11.0,0.09
1779,2021-03-21,LOM,22636,8067,14569,1046,551,1265,410,9711,734,8919,17384,5252,ITC,ITC4,3,Lombardia,Lombardia,10060574,1128797,11.22,0.22
1780,2021-02-13,LOM,6380,2431,3949,4172,1416,85,682,17,4,4,4931,1449,ITC,ITC4,3,Lombardia,Lombardia,10060574,1135177,11.28,0.06
1781,2021-02-16,LOM,9462,3074,6388,5832,2098,159,1338,8,8,19,9011,451,ITC,ITC4,3,Lombardia,Lombardia,10060574,1144639,11.38,0.09
1782,2021-01-09,LOM,12381,4560,7821,9503,2051,624,196,6,1,0,12381,0,ITC,ITC4,3,Lombardia,Lombardia,10060574,1157020,11.5,0.12
1783,2021-01-07,LOM,11696,3621,8075,8959,1718,212,773,32,1,1,11696,0,ITC,ITC4,3,Lombardia,Lombardia,10060574,1168716,11.62,0.12
1784,2021-02-11,LOM,16783,4938,11845,9647,3188,58,3848,32,4,6,9458,7325,ITC,ITC4,3,Lombardia,Lombardia,10060574,1185499,11.78,0.17
1785,2021-03-02,LOM,22485,9579,12906,3046,1297,2898,2098,11238,1778,130,19547,2938,ITC,ITC4,3,Lombardia,Lombardia,10060574,1207984,12.01,0.22
1786,2021-03-13,LOM,26242,9416,16826,3726,933,2602,251,10223,617,7890,20256,5986,ITC,ITC4,3,Lombardia,Lombardia,10060574,1234226,12.27,0.26
1787,2021-01-14,LOM,26416,7706,18710,15072,5448,305,5362,228,1,0,26416,0,ITC,ITC4,3,Lombardia,Lombardia,10060574,1260642,12.53,0.26
1788,2021-01-23,LOM,1114,357,757,644,258,74,138,0,0,0,916,198,ITC,ITC4,3,Lombardia,Lombardia,10060574,1261756,12.54,0.01
1789,2020-12-29,LOM,100,43,57,100,0,0,0,0,0,0,100,0,ITC,ITC4,3,Lombardia,Lombardia,10060574,1261856,12.54,0.0
1790,2021-02-26,LOM,17953,7424,10529,3085,1640,274,1155,10471,1304,24,16322,1631,ITC,ITC4,3,Lombardia,Lombardia,10060574,1279809,12.72,0.18
1791,2021-03-05,LOM,28335,11698,16637,7030,2454,4445,1480,10621,1900,405,20178,8157,ITC,ITC4,3,Lombardia,Lombardia,10060574,1308144,13.0,0.28
1792,2021-01-10,LOM,10516,3955,6561,8173,2159,85,85,11,2,1,10516,0,ITC,ITC4,3,Lombardia,Lombardia,10060574,1318660,13.11,0.1
1793,2021-03-03,LOM,26462,11296,15166,6332,1599,4779,1619,9800,1862,471,19306,7156,ITC,ITC4,3,Lombardia,Lombardia,10060574,1345122,13.37,0.26
1794,2021-01-21,LOM,5322,1566,3756,3008,1208,78,1024,4,0,0,4635,687,ITC,ITC4,3,Lombardia,Lombardia,10060574,1350444,13.42,0.05
1795,2021-01-19,LOM,8069,2340,5729,4041,1742,77,2143,65,1,0,7593,476,ITC,ITC4,3,Lombardia,Lombardia,10060574,1358513,13.5,0.08
1796,2021-02-14,LOM,3559,1540,2019,2749,491,282,24,3,0,10,2937,622,ITC,ITC4,3,Lombardia,Lombardia,10060574,1362072,13.54,0.04
1797,2021-02-27,LOM,13815,5818,7997,2001,1082,786,558,8249,1091,48,13271,544,ITC,ITC4,3,Lombardia,Lombardia,10060574,1375887,13.68,0.14
1798,2021-03-18,LOM,26675,10642,16033,2152,1080,1115,1452,20732,44,100,15808,10867,ITC,ITC4,3,Lombardia,Lombardia,10060574,1402562,13.94,0.27
