,data,area,Vaccinazioni giornaliere,sesso_maschile,sesso_femminile,prima_dose,seconda_dose,pregressa_infezione,codice_NUTS1,codice_NUTS2,codice_regione_ISTAT,nome_area,Regione,popolazione,Totale vaccinazioni,Totale vaccinazioni ogni cento ab,Vaccinazioni giornaliere ogni cento ab
0,2021-04-16,LAZ,34544,15752,18792,21966,12196,382,ITI,ITI4,12,Lazio,Lazio,5879082,34544,0.59,0.59
1,2021-01-23,LAZ,7214,2869,4345,585,6629,0,ITI,ITI4,12,Lazio,Lazio,5879082,41758,0.71,0.12
2,2021-01-06,LAZ,5194,1989,3205,5074,0,120,ITI,ITI4,12,Lazio,Lazio,5879082,46952,0.8,0.09
3,2021-02-25,LAZ,12779,5596,7183,11414,1180,185,ITI,ITI4,12,Lazio,Lazio,5879082,59731,1.02,0.22
4,2021-06-26,LAZ,56187,26479,29708,24707,30902,578,ITI,ITI4,12,Lazio,Lazio,5879082,115918,1.97,0.96
5,2021-04-30,LAZ,41687,18472,23215,26674,14358,655,ITI,ITI4,12,Lazio,Lazio,5879082,157605,2.68,0.71
6,2021-06-19,LAZ,66516,31381,35135,35276,30436,804,ITI,ITI4,12,Lazio,Lazio,5879082,224121,3.81,1.13
7,2021-05-26,LAZ,47628,21901,25727,34852,12125,651,ITI,ITI4,12,Lazio,Lazio,5879082,271749,4.62,0.81
8,2021-03-04,LAZ,19456,8740,10716,14189,5032,235,ITI,ITI4,12,Lazio,Lazio,5879082,291205,4.95,0.33
9,2021-06-12,LAZ,69903,32101,37802,39880,29393,630,ITI,ITI4,12,Lazio,Lazio,5879082,361108,6.14,1.19
10,2021-06-14,LAZ,63050,29539,33511,32321,30176,553,ITI,ITI4,12,Lazio,Lazio,5879082,424158,7.21,1.07
11,2021-03-21,LAZ,18288,7201,11087,13027,5070,191,ITI,ITI4,12,Lazio,Lazio,5879082,442446,7.53,0.31
12,2020-12-30,LAZ,1654,638,1016,1643,0,11,ITI,ITI4,12,Lazio,Lazio,5879082,444100,7.55,0.03
13,2021-03-16,LAZ,13595,5764,7831,7048,6467,80,ITI,ITI4,12,Lazio,Lazio,5879082,457695,7.79,0.23
14,2021-03-09,LAZ,22017,9943,12074,16446,5221,350,ITI,ITI4,12,Lazio,Lazio,5879082,479712,8.16,0.37
15,2021-01-11,LAZ,5656,2146,3510,5511,0,145,ITI,ITI4,12,Lazio,Lazio,5879082,485368,8.26,0.1
16,2021-07-22,LAZ,61047,30491,30556,28482,31076,1489,ITI,ITI4,12,Lazio,Lazio,5879082,546415,9.29,1.04
17,2021-05-17,LAZ,44615,20430,24185,35605,8602,408,ITI,ITI4,12,Lazio,Lazio,5879082,591030,10.05,0.76
18,2021-02-06,LAZ,6223,2538,3685,895,5324,4,ITI,ITI4,12,Lazio,Lazio,5879082,597253,10.16,0.11
19,2021-02-18,LAZ,10024,4978,5046,9100,819,105,ITI,ITI4,12,Lazio,Lazio,5879082,607277,10.33,0.17
20,2021-05-12,LAZ,47599,21608,25991,30284,16676,639,ITI,ITI4,12,Lazio,Lazio,5879082,654876,11.14,0.81
21,2021-02-01,LAZ,5679,2181,3498,353,5325,1,ITI,ITI4,12,Lazio,Lazio,5879082,660555,11.24,0.1
22,2021-07-15,LAZ,44921,21993,22928,6707,37809,405,ITI,ITI4,12,Lazio,Lazio,5879082,705476,12.0,0.76
23,2021-01-13,LAZ,5805,2191,3614,5643,0,162,ITI,ITI4,12,Lazio,Lazio,5879082,711281,12.1,0.1
24,2021-03-30,LAZ,27090,13171,13919,19538,7204,348,ITI,ITI4,12,Lazio,Lazio,5879082,738371,12.56,0.46
25,2021-07-08,LAZ,64242,31541,32701,28173,35411,658,ITI,ITI4,12,Lazio,Lazio,5879082,802613,13.65,1.09
26,2021-07-27,LAZ,56245,27286,28959,8032,47900,313,ITI,ITI4,12,Lazio,Lazio,5879082,858858,14.61,0.96
27,2021-04-18,LAZ,23862,10606,13256,15894,7696,272,ITI,ITI4,12,Lazio,Lazio,5879082,882720,15.01,0.41
28,2021-02-20,LAZ,9213,4275,4938,8367,775,71,ITI,ITI4,12,Lazio,Lazio,5879082,891933,15.17,0.16
29,2021-05-31,LAZ,51761,23045,28716,30864,19876,1021,ITI,ITI4,12,Lazio,Lazio,5879082,943694,16.05,0.88
30,2021-04-04,LAZ,17663,8197,9466,12261,5290,112,ITI,ITI4,12,Lazio,Lazio,5879082,961357,16.35,0.3
31,2021-01-25,LAZ,8118,3250,4868,776,7342,0,ITI,ITI4,12,Lazio,Lazio,5879082,969475,16.49,0.14
32,2021-05-05,LAZ,46834,21491,25343,30418,15858,558,ITI,ITI4,12,Lazio,Lazio,5879082,1016309,17.29,0.8
33,2021-03-02,LAZ,17231,7628,9603,13111,3955,165,ITI,ITI4,12,Lazio,Lazio,5879082,1033540,17.58,0.29
34,2021-01-18,LAZ,6387,2603,3784,5281,980,126,ITI,ITI4,12,Lazio,Lazio,5879082,1039927,17.69,0.11
35,2021-04-28,LAZ,33025,15068,17957,20980,11655,390,ITI,ITI4,12,Lazio,Lazio,5879082,1072952,18.25,0.56
36,2021-06-05,LAZ,66302,32670,33632,42880,22759,663,ITI,ITI4,12,Lazio,Lazio,5879082,1139254,19.38,1.13
37,2021-05-07,LAZ,48288,22635,25653,30091,17789,408,ITI,ITI4,12,Lazio,Lazio,5879082,1187542,20.2,0.82
38,2021-03-11,LAZ,25493,12022,13471,18868,6282,343,ITI,ITI4,12,Lazio,Lazio,5879082,1213035,20.63,0.43
39,2021-07-03,LAZ,53205,25050,28155,4645,48424,136,ITI,ITI4,12,Lazio,Lazio,5879082,1266240,21.54,0.9
40,2021-02-03,LAZ,6493,2491,4002,960,5526,7,ITI,ITI4,12,Lazio,Lazio,5879082,1272733,21.65,0.11
41,2021-01-20,LAZ,4818,1951,2867,3270,1544,4,ITI,ITI4,12,Lazio,Lazio,5879082,1277551,21.73,0.08
42,2021-07-01,LAZ,48472,23179,25293,7184,41081,207,ITI,ITI4,12,Lazio,Lazio,5879082,1326023,22.55,0.82
43,2021-04-09,LAZ,27700,12608,15092,19144,8271,285,ITI,ITI4,12,Lazio,Lazio,5879082,1353723,23.03,0.47
44,2021-03-23,LAZ,25454,11947,13507,18477,6632,345,ITI,ITI4,12,Lazio,Lazio,5879082,1379177,23.46,0.43
45,2021-02-15,LAZ,8038,3548,4490,7312,643,83,ITI,ITI4,12,Lazio,Lazio,5879082,1387215,23.6,0.14
46,2021-01-29,LAZ,8052,3084,4968,816,7234,2,ITI,ITI4,12,Lazio,Lazio,5879082,1395267,23.73,0.14
47,2021-02-11,LAZ,7000,3011,3989,6442,533,25,ITI,ITI4,12,Lazio,Lazio,5879082,1402267,23.85,0.12
48,2021-04-11,LAZ,19230,8524,10706,13144,5925,161,ITI,ITI4,12,Lazio,Lazio,5879082,1421497,24.18,0.33
49,2021-02-13,LAZ,6612,2627,3985,6147,419,46,ITI,ITI4,12,Lazio,Lazio,5879082,1428109,24.29,0.11
50,2021-07-20,LAZ,63283,31583,31700,28444,33671,1168,ITI,ITI4,12,Lazio,Lazio,5879082,1491392,25.37,1.08
51,2021-05-24,LAZ,44002,20180,23822,33548,9791,663,ITI,ITI4,12,Lazio,Lazio,5879082,1535394,26.12,0.75
52,2021-01-03,LAZ,5337,2011,3326,5278,0,59,ITI,ITI4,12,Lazio,Lazio,5879082,1540731,26.21,0.09
53,2021-04-13,LAZ,25822,11974,13848,17685,7745,392,ITI,ITI4,12,Lazio,Lazio,5879082,1566553,26.65,0.44
54,2021-04-23,LAZ,37965,18285,19680,22118,15394,453,ITI,ITI4,12,Lazio,Lazio,5879082,1604518,27.29,0.65
55,2021-01-30,LAZ,7018,2896,4122,811,6206,1,ITI,ITI4,12,Lazio,Lazio,5879082,1611536,27.41,0.12
56,2021-07-19,LAZ,63064,30997,32067,28312,33661,1091,ITI,ITI4,12,Lazio,Lazio,5879082,1674600,28.48,1.07
57,2021-01-15,LAZ,6706,2757,3949,6536,0,170,ITI,ITI4,12,Lazio,Lazio,5879082,1681306,28.6,0.11
58,2021-04-25,LAZ,24581,11281,13300,16424,7874,283,ITI,ITI4,12,Lazio,Lazio,5879082,1705887,29.02,0.42
59,2021-03-28,LAZ,19189,7831,11358,13542,5311,336,ITI,ITI4,12,Lazio,Lazio,5879082,1725076,29.34,0.33
60,2021-06-09,LAZ,70408,33320,37088,35964,33812,632,ITI,ITI4,12,Lazio,Lazio,5879082,1795484,30.54,1.2
61,2021-05-19,LAZ,47276,21714,25562,36527,10142,607,ITI,ITI4,12,Lazio,Lazio,5879082,1842760,31.34,0.8
62,2021-01-04,LAZ,7572,2939,4633,7468,0,104,ITI,ITI4,12,Lazio,Lazio,5879082,1850332,31.47,0.13
63,2021-06-24,LAZ,63979,30519,33460,28613,34720,646,ITI,ITI4,12,Lazio,Lazio,5879082,1914311,32.56,1.09
64,2021-06-07,LAZ,62606,29301,33305,32700,29319,587,ITI,ITI4,12,Lazio,Lazio,5879082,1976917,33.63,1.06
65,2021-06-21,LAZ,61977,28792,33185,28488,32884,605,ITI,ITI4,12,Lazio,Lazio,5879082,2038894,34.68,1.05
66,2021-03-13,LAZ,21847,8753,13094,15701,5913,233,ITI,ITI4,12,Lazio,Lazio,5879082,2060741,35.05,0.37
67,2021-03-27,LAZ,26544,10799,15745,19486,6515,543,ITI,ITI4,12,Lazio,Lazio,5879082,2087285,35.5,0.45
68,2021-07-05,LAZ,61543,29636,31907,25573,34919,1051,ITI,ITI4,12,Lazio,Lazio,5879082,2148828,36.55,1.05
69,2021-05-23,LAZ,47152,22884,24268,39100,7397,655,ITI,ITI4,12,Lazio,Lazio,5879082,2195980,37.35,0.8
70,2021-05-09,LAZ,37558,17266,20292,25830,11281,447,ITI,ITI4,12,Lazio,Lazio,5879082,2233538,37.99,0.64
71,2021-07-12,LAZ,41362,20695,20667,5856,35281,225,ITI,ITI4,12,Lazio,Lazio,5879082,2274900,38.69,0.7
72,2021-05-16,LAZ,51006,24564,26442,36960,13509,537,ITI,ITI4,12,Lazio,Lazio,5879082,2325906,39.56,0.87
73,2021-04-01,LAZ,29777,14125,15652,22230,7170,377,ITI,ITI4,12,Lazio,Lazio,5879082,2355683,40.07,0.51
74,2021-07-10,LAZ,70987,35625,35362,25033,45325,629,ITI,ITI4,12,Lazio,Lazio,5879082,2426670,41.28,1.21
75,2021-07-24,LAZ,30676,15469,15207,3217,27320,139,ITI,ITI4,12,Lazio,Lazio,5879082,2457346,41.8,0.52
76,2021-06-23,LAZ,62315,29347,32968,28438,33382,495,ITI,ITI4,12,Lazio,Lazio,5879082,2519661,42.86,1.06
77,2021-04-15,LAZ,32024,14346,17678,20704,10874,446,ITI,ITI4,12,Lazio,Lazio,5879082,2551685,43.4,0.54
78,2021-02-10,LAZ,8206,3413,4793,4847,3354,5,ITI,ITI4,12,Lazio,Lazio,5879082,2559891,43.54,0.14
79,2021-02-17,LAZ,9194,4606,4588,8240,885,69,ITI,ITI4,12,Lazio,Lazio,5879082,2569085,43.7,0.16
80,2021-05-28,LAZ,57233,26615,30618,43126,13319,788,ITI,ITI4,12,Lazio,Lazio,5879082,2626318,44.67,0.97
81,2021-03-06,LAZ,18392,7094,11298,13901,4272,219,ITI,ITI4,12,Lazio,Lazio,5879082,2644710,44.99,0.31
82,2021-01-31,LAZ,4463,1856,2607,478,3984,1,ITI,ITI4,12,Lazio,Lazio,5879082,2649173,45.06,0.08
83,2021-05-11,LAZ,48350,22205,26145,31191,16562,597,ITI,ITI4,12,Lazio,Lazio,5879082,2697523,45.88,0.82
84,2021-07-16,LAZ,43892,20949,22943,2911,40806,175,ITI,ITI4,12,Lazio,Lazio,5879082,2741415,46.63,0.75
85,2021-04-24,LAZ,33559,15144,18415,20185,12882,492,ITI,ITI4,12,Lazio,Lazio,5879082,2774974,47.2,0.57
86,2021-05-30,LAZ,41258,17650,23608,33223,7365,670,ITI,ITI4,12,Lazio,Lazio,5879082,2816232,47.9,0.7
87,2021-05-13,LAZ,50240,22576,27664,31717,17848,675,ITI,ITI4,12,Lazio,Lazio,5879082,2866472,48.76,0.85
88,2021-04-06,LAZ,24624,11270,13354,17141,7165,318,ITI,ITI4,12,Lazio,Lazio,5879082,2891096,49.18,0.42
89,2020-12-27,LAZ,274,132,142,274,0,0,ITI,ITI4,12,Lazio,Lazio,5879082,2891370,49.18,0.0
90,2021-03-20,LAZ,19275,7673,11602,13090,5923,262,ITI,ITI4,12,Lazio,Lazio,5879082,2910645,49.51,0.33
91,2021-07-17,LAZ,43845,22108,21737,2164,41577,104,ITI,ITI4,12,Lazio,Lazio,5879082,2954490,50.25,0.75
92,2021-06-30,LAZ,62991,29643,33348,29768,32688,535,ITI,ITI4,12,Lazio,Lazio,5879082,3017481,51.33,1.07
93,2021-05-14,LAZ,51599,23578,28021,32562,18375,662,ITI,ITI4,12,Lazio,Lazio,5879082,3069080,52.2,0.88
94,2021-03-18,LAZ,14287,6106,8181,7774,6429,84,ITI,ITI4,12,Lazio,Lazio,5879082,3083367,52.45,0.24
95,2021-06-28,LAZ,58933,28174,30759,27525,30982,426,ITI,ITI4,12,Lazio,Lazio,5879082,3142300,53.45,1.0
96,2021-02-12,LAZ,6855,2855,4000,6354,421,80,ITI,ITI4,12,Lazio,Lazio,5879082,3149155,53.57,0.12
97,2020-12-31,LAZ,5370,2149,3221,5310,0,60,ITI,ITI4,12,Lazio,Lazio,5879082,3154525,53.66,0.09
98,2021-04-10,LAZ,23941,10413,13528,16498,7196,247,ITI,ITI4,12,Lazio,Lazio,5879082,3178466,54.06,0.41
99,2021-02-05,LAZ,7330,2994,4336,1218,6109,3,ITI,ITI4,12,Lazio,Lazio,5879082,3185796,54.19,0.12
100,2021-04-03,LAZ,24847,11218,13629,17896,6733,218,ITI,ITI4,12,Lazio,Lazio,5879082,3210643,54.61,0.42
101,2021-04-27,LAZ,30827,13920,16907,19472,10952,403,ITI,ITI4,12,Lazio,Lazio,5879082,3241470,55.14,0.52
102,2021-03-01,LAZ,17126,7370,9756,13008,3886,232,ITI,ITI4,12,Lazio,Lazio,5879082,3258596,55.43,0.29
103,2021-02-22,LAZ,11464,4993,6471,10808,502,154,ITI,ITI4,12,Lazio,Lazio,5879082,3270060,55.62,0.19
104,2021-06-02,LAZ,43502,21589,21913,31431,11523,548,ITI,ITI4,12,Lazio,Lazio,5879082,3313562,56.36,0.74
105,2021-06-11,LAZ,69735,32811,36924,36679,32421,635,ITI,ITI4,12,Lazio,Lazio,5879082,3383297,57.55,1.19
106,2021-05-06,LAZ,48857,22768,26089,30614,17587,656,ITI,ITI4,12,Lazio,Lazio,5879082,3432154,58.38,0.83
107,2021-02-08,LAZ,9747,4158,5589,4507,5238,2,ITI,ITI4,12,Lazio,Lazio,5879082,3441901,58.54,0.17
108,2021-05-02,LAZ,32917,14453,18464,23002,9454,461,ITI,ITI4,12,Lazio,Lazio,5879082,3474818,59.1,0.56
109,2021-01-22,LAZ,4011,1639,2372,496,3515,0,ITI,ITI4,12,Lazio,Lazio,5879082,3478829,59.17,0.07
110,2021-06-29,LAZ,59447,28259,31188,27728,31155,564,ITI,ITI4,12,Lazio,Lazio,5879082,3538276,60.18,1.01
111,2021-01-14,LAZ,5592,2176,3416,5418,0,174,ITI,ITI4,12,Lazio,Lazio,5879082,3543868,60.28,0.1
112,2021-04-07,LAZ,26023,12177,13846,18362,7323,338,ITI,ITI4,12,Lazio,Lazio,5879082,3569891,60.72,0.44
113,2020-12-28,LAZ,960,413,547,955,0,5,ITI,ITI4,12,Lazio,Lazio,5879082,3570851,60.74,0.02
114,2021-01-16,LAZ,5769,2335,3434,5621,0,148,ITI,ITI4,12,Lazio,Lazio,5879082,3576620,60.84,0.1
115,2021-04-26,LAZ,29327,13496,15831,19611,9285,431,ITI,ITI4,12,Lazio,Lazio,5879082,3605947,61.34,0.5
116,2021-02-02,LAZ,5918,2219,3699,640,5275,3,ITI,ITI4,12,Lazio,Lazio,5879082,3611865,61.44,0.1
117,2021-01-17,LAZ,4954,2047,2907,4678,212,64,ITI,ITI4,12,Lazio,Lazio,5879082,3616819,61.52,0.08
118,2021-01-19,LAZ,4782,1965,2817,4325,454,3,ITI,ITI4,12,Lazio,Lazio,5879082,3621601,61.6,0.08
119,2021-04-29,LAZ,38832,17339,21493,24872,13353,607,ITI,ITI4,12,Lazio,Lazio,5879082,3660433,62.26,0.66
120,2021-03-03,LAZ,17898,7886,10012,13353,4311,234,ITI,ITI4,12,Lazio,Lazio,5879082,3678331,62.57,0.3
121,2021-01-26,LAZ,7973,3130,4843,731,7242,0,ITI,ITI4,12,Lazio,Lazio,5879082,3686304,62.7,0.14
122,2021-02-27,LAZ,11528,4333,7195,10348,1042,138,ITI,ITI4,12,Lazio,Lazio,5879082,3697832,62.9,0.2
123,2021-05-20,LAZ,51827,25011,26816,37145,13954,728,ITI,ITI4,12,Lazio,Lazio,5879082,3749659,63.78,0.88
124,2021-06-20,LAZ,55306,25435,29871,29614,24940,752,ITI,ITI4,12,Lazio,Lazio,5879082,3804965,64.72,0.94
125,2021-06-06,LAZ,58211,28056,30155,35107,22520,584,ITI,ITI4,12,Lazio,Lazio,5879082,3863176,65.71,0.99
126,2021-02-26,LAZ,13133,5738,7395,11555,1404,174,ITI,ITI4,12,Lazio,Lazio,5879082,3876309,65.93,0.22
127,2021-03-25,LAZ,29503,13696,15807,22367,6675,461,ITI,ITI4,12,Lazio,Lazio,5879082,3905812,66.44,0.5
128,2021-01-27,LAZ,6122,2390,3732,1005,5117,0,ITI,ITI4,12,Lazio,Lazio,5879082,3911934,66.54,0.1
129,2021-06-01,LAZ,49116,23701,25415,30081,18571,464,ITI,ITI4,12,Lazio,Lazio,5879082,3961050,67.38,0.84
130,2021-04-05,LAZ,19981,9152,10829,13615,6213,153,ITI,ITI4,12,Lazio,Lazio,5879082,3981031,67.72,0.34
131,2021-07-28,LAZ,57552,29119,28433,8041,49175,336,ITI,ITI4,12,Lazio,Lazio,5879082,4038583,68.69,0.98
132,2021-05-25,LAZ,47586,22335,25251,35290,11701,595,ITI,ITI4,12,Lazio,Lazio,5879082,4086169,69.5,0.81
133,2021-05-21,LAZ,52056,25037,27019,37267,14084,705,ITI,ITI4,12,Lazio,Lazio,5879082,4138225,70.39,0.89
134,2021-06-04,LAZ,61976,30234,31742,43520,17833,623,ITI,ITI4,12,Lazio,Lazio,5879082,4200201,71.44,1.05
135,2021-05-04,LAZ,40258,18522,21736,26111,13679,468,ITI,ITI4,12,Lazio,Lazio,5879082,4240459,72.13,0.68
136,2021-02-24,LAZ,12058,5213,6845,10938,997,123,ITI,ITI4,12,Lazio,Lazio,5879082,4252517,72.33,0.21
137,2021-07-07,LAZ,62603,31011,31592,28374,33648,581,ITI,ITI4,12,Lazio,Lazio,5879082,4315120,73.4,1.06
138,2021-03-29,LAZ,25567,12144,13423,18186,7080,301,ITI,ITI4,12,Lazio,Lazio,5879082,4340687,73.83,0.43
139,2021-04-08,LAZ,26862,12319,14543,18813,7701,348,ITI,ITI4,12,Lazio,Lazio,5879082,4367549,74.29,0.46
140,2021-07-02,LAZ,48495,23241,25254,6618,41699,178,ITI,ITI4,12,Lazio,Lazio,5879082,4416044,75.11,0.82
141,2021-03-22,LAZ,23412,10562,12850,16353,6730,329,ITI,ITI4,12,Lazio,Lazio,5879082,4439456,75.51,0.4
142,2020-12-29,LAZ,496,182,314,492,0,4,ITI,ITI4,12,Lazio,Lazio,5879082,4439952,75.52,0.01
143,2021-06-13,LAZ,58432,26219,32213,33084,24851,497,ITI,ITI4,12,Lazio,Lazio,5879082,4498384,76.52,0.99
144,2021-03-07,LAZ,14160,5479,8681,10350,3603,207,ITI,ITI4,12,Lazio,Lazio,5879082,4512544,76.76,0.24
145,2021-04-02,LAZ,29537,14162,15375,21759,7393,385,ITI,ITI4,12,Lazio,Lazio,5879082,4542081,77.26,0.5
146,2021-07-11,LAZ,44110,22233,21877,3763,40200,147,ITI,ITI4,12,Lazio,Lazio,5879082,4586191,78.01,0.75
147,2021-01-28,LAZ,8284,3168,5116,786,7497,1,ITI,ITI4,12,Lazio,Lazio,5879082,4594475,78.15,0.14
148,2021-07-04,LAZ,46571,21680,24891,4117,42370,84,ITI,ITI4,12,Lazio,Lazio,5879082,4641046,78.94,0.79
149,2021-05-08,LAZ,45496,20772,24724,29404,15443,649,ITI,ITI4,12,Lazio,Lazio,5879082,4686542,79.72,0.77
150,2021-07-13,LAZ,42660,20908,21752,5484,36846,330,ITI,ITI4,12,Lazio,Lazio,5879082,4729202,80.44,0.73
151,2021-03-26,LAZ,30346,14054,16292,23008,6896,442,ITI,ITI4,12,Lazio,Lazio,5879082,4759548,80.96,0.52
152,2021-02-19,LAZ,10056,5084,4972,9071,838,147,ITI,ITI4,12,Lazio,Lazio,5879082,4769604,81.13,0.17
153,2021-06-17,LAZ,66976,32223,34753,31802,34459,715,ITI,ITI4,12,Lazio,Lazio,5879082,4836580,82.27,1.14
154,2021-04-21,LAZ,33146,15064,18082,20310,12476,360,ITI,ITI4,12,Lazio,Lazio,5879082,4869726,82.83,0.56
155,2021-07-30,LAZ,54870,28344,26526,6947,47591,332,ITI,ITI4,12,Lazio,Lazio,5879082,4924596,83.76,0.93
156,2021-07-09,LAZ,64908,31331,33577,27595,36583,730,ITI,ITI4,12,Lazio,Lazio,5879082,4989504,84.87,1.1
157,2021-05-01,LAZ,38257,17202,21055,25747,12074,436,ITI,ITI4,12,Lazio,Lazio,5879082,5027761,85.52,0.65
158,2021-04-17,LAZ,32477,14245,18232,20018,12060,399,ITI,ITI4,12,Lazio,Lazio,5879082,5060238,86.07,0.55
159,2021-07-26,LAZ,50748,25005,25743,6636,43813,299,ITI,ITI4,12,Lazio,Lazio,5879082,5110986,86.94,0.86
160,2021-06-03,LAZ,56797,28692,28105,38265,17830,702,ITI,ITI4,12,Lazio,Lazio,5879082,5167783,87.9,0.97
161,2021-06-10,LAZ,72085,34053,38032,37292,33975,818,ITI,ITI4,12,Lazio,Lazio,5879082,5239868,89.13,1.23
162,2021-04-14,LAZ,29392,13325,16067,18882,10192,318,ITI,ITI4,12,Lazio,Lazio,5879082,5269260,89.63,0.5
163,2021-07-23,LAZ,58259,29206,29053,26721,29805,1733,ITI,ITI4,12,Lazio,Lazio,5879082,5327519,90.62,0.99
164,2021-07-18,LAZ,58312,29694,28618,22790,34749,773,ITI,ITI4,12,Lazio,Lazio,5879082,5385831,91.61,0.99
165,2021-06-15,LAZ,66121,31949,34172,33362,32201,558,ITI,ITI4,12,Lazio,Lazio,5879082,5451952,92.73,1.12
166,2021-03-24,LAZ,27976,13141,14835,21318,6273,385,ITI,ITI4,12,Lazio,Lazio,5879082,5479928,93.21,0.48
167,2021-05-29,LAZ,52081,23427,28654,40176,11038,867,ITI,ITI4,12,Lazio,Lazio,5879082,5532009,94.1,0.89
168,2021-05-10,LAZ,44490,20345,24145,30599,13435,456,ITI,ITI4,12,Lazio,Lazio,5879082,5576499,94.85,0.76
169,2021-05-27,LAZ,58475,27197,31278,43892,13787,796,ITI,ITI4,12,Lazio,Lazio,5879082,5634974,95.85,0.99
170,2021-03-05,LAZ,19601,8683,10918,14624,4751,226,ITI,ITI4,12,Lazio,Lazio,5879082,5654575,96.18,0.33
171,2021-02-16,LAZ,8360,4034,4326,7705,612,43,ITI,ITI4,12,Lazio,Lazio,5879082,5662935,96.32,0.14
172,2021-03-15,LAZ,21015,9868,11147,14004,6767,244,ITI,ITI4,12,Lazio,Lazio,5879082,5683950,96.68,0.36
173,2021-01-05,LAZ,7453,2831,4622,7350,0,103,ITI,ITI4,12,Lazio,Lazio,5879082,5691403,96.81,0.13
174,2021-01-24,LAZ,5699,2229,3470,615,5084,0,ITI,ITI4,12,Lazio,Lazio,5879082,5697102,96.9,0.1
175,2021-02-07,LAZ,4969,2046,2923,410,4558,1,ITI,ITI4,12,Lazio,Lazio,5879082,5702071,96.99,0.08
176,2021-05-18,LAZ,45037,20600,24437,34914,9566,557,ITI,ITI4,12,Lazio,Lazio,5879082,5747108,97.76,0.77
177,2021-07-06,LAZ,62477,30325,32152,28564,33433,480,ITI,ITI4,12,Lazio,Lazio,5879082,5809585,98.82,1.06
178,2021-04-12,LAZ,23933,10792,13141,16692,6961,280,ITI,ITI4,12,Lazio,Lazio,5879082,5833518,99.22,0.41
179,2021-07-21,LAZ,62708,31668,31040,28646,32747,1315,ITI,ITI4,12,Lazio,Lazio,5879082,5896226,100.29,1.07
180,2021-06-08,LAZ,66779,31877,34902,36159,29982,638,ITI,ITI4,12,Lazio,Lazio,5879082,5963005,101.43,1.14
181,2021-07-14,LAZ,42131,20531,21600,6199,35583,349,ITI,ITI4,12,Lazio,Lazio,5879082,6005136,102.14,0.72
182,2021-01-09,LAZ,6416,2609,3807,6303,0,113,ITI,ITI4,12,Lazio,Lazio,5879082,6011552,102.25,0.11
183,2021-04-19,LAZ,30148,13707,16441,19006,10722,420,ITI,ITI4,12,Lazio,Lazio,5879082,6041700,102.77,0.51
184,2021-02-21,LAZ,6996,3183,3813,6487,465,44,ITI,ITI4,12,Lazio,Lazio,5879082,6048696,102.89,0.12
185,2021-02-14,LAZ,5779,2372,3407,5277,472,30,ITI,ITI4,12,Lazio,Lazio,5879082,6054475,102.98,0.1
186,2021-02-28,LAZ,10284,4037,6247,9649,539,96,ITI,ITI4,12,Lazio,Lazio,5879082,6064759,103.16,0.17
187,2021-01-02,LAZ,6835,2680,4155,6755,0,80,ITI,ITI4,12,Lazio,Lazio,5879082,6071594,103.27,0.12
188,2021-03-12,LAZ,24093,11134,12959,17389,6355,349,ITI,ITI4,12,Lazio,Lazio,5879082,6095687,103.68,0.41
189,2021-02-09,LAZ,8819,3782,5037,4577,4236,6,ITI,ITI4,12,Lazio,Lazio,5879082,6104506,103.83,0.15
190,2021-02-23,LAZ,11098,4787,6311,10202,769,127,ITI,ITI4,12,Lazio,Lazio,5879082,6115604,104.02,0.19
191,2021-05-03,LAZ,39618,17888,21730,26274,12765,579,ITI,ITI4,12,Lazio,Lazio,5879082,6155222,104.7,0.67
192,2021-07-25,LAZ,24570,12063,12507,2030,22491,49,ITI,ITI4,12,Lazio,Lazio,5879082,6179792,105.11,0.42
193,2021-01-21,LAZ,5606,2350,3256,552,5054,0,ITI,ITI4,12,Lazio,Lazio,5879082,6185398,105.21,0.1
194,2021-03-31,LAZ,27867,13473,14394,20390,7145,332,ITI,ITI4,12,Lazio,Lazio,5879082,6213265,105.68,0.47
195,2021-01-07,LAZ,7933,2975,4958,7776,0,157,ITI,ITI4,12,Lazio,Lazio,5879082,6221198,105.82,0.13
196,2021-06-22,LAZ,62805,29051,33754,28596,33506,703,ITI,ITI4,12,Lazio,Lazio,5879082,6284003,106.89,1.07
197,2021-03-14,LAZ,17296,6777,10519,11858,5179,259,ITI,ITI4,12,Lazio,Lazio,5879082,6301299,107.18,0.29
198,2021-01-08,LAZ,7893,2959,4934,7696,0,197,ITI,ITI4,12,Lazio,Lazio,5879082,6309192,107.32,0.13
199,2021-07-29,LAZ,55724,28351,27373,7517,47842,365,ITI,ITI4,12,Lazio,Lazio,5879082,6364916,108.26,0.95
200,2021-01-01,LAZ,3596,1396,2200,3556,0,40,ITI,ITI4,12,Lazio,Lazio,5879082,6368512,108.32,0.06
201,2021-01-10,LAZ,4133,1737,2396,4066,0,67,ITI,ITI4,12,Lazio,Lazio,5879082,6372645,108.4,0.07
202,2021-06-16,LAZ,64657,31043,33614,32079,31962,616,ITI,ITI4,12,Lazio,Lazio,5879082,6437302,109.5,1.1
203,2021-04-20,LAZ,31146,14296,16850,19407,11363,376,ITI,ITI4,12,Lazio,Lazio,5879082,6468448,110.02,0.53
204,2021-03-08,LAZ,20938,9087,11851,15342,5305,291,ITI,ITI4,12,Lazio,Lazio,5879082,6489386,110.38,0.36
205,2021-04-22,LAZ,39198,19498,19700,23898,14710,590,ITI,ITI4,12,Lazio,Lazio,5879082,6528584,111.05,0.67
206,2021-03-10,LAZ,23360,10669,12691,17365,5659,336,ITI,ITI4,12,Lazio,Lazio,5879082,6551944,111.45,0.4
207,2021-01-12,LAZ,5513,2022,3491,5370,0,143,ITI,ITI4,12,Lazio,Lazio,5879082,6557457,111.54,0.09
208,2021-06-18,LAZ,64360,31004,33356,30308,33315,737,ITI,ITI4,12,Lazio,Lazio,5879082,6621817,112.63,1.09
209,2021-03-17,LAZ,13875,5947,7928,7474,6289,112,ITI,ITI4,12,Lazio,Lazio,5879082,6635692,112.87,0.24
210,2021-06-25,LAZ,63308,30565,32743,28094,34635,579,ITI,ITI4,12,Lazio,Lazio,5879082,6699000,113.95,1.08
211,2021-06-27,LAZ,47251,21611,25640,20609,26178,464,ITI,ITI4,12,Lazio,Lazio,5879082,6746251,114.75,0.8
212,2021-02-04,LAZ,6442,2567,3875,1123,5318,1,ITI,ITI4,12,Lazio,Lazio,5879082,6752693,114.86,0.11
213,2021-05-22,LAZ,55180,27033,28147,43603,10697,880,ITI,ITI4,12,Lazio,Lazio,5879082,6807873,115.8,0.94
214,2021-05-15,LAZ,57431,27437,29994,40069,16559,803,ITI,ITI4,12,Lazio,Lazio,5879082,6865304,116.78,0.98
215,2021-03-19,LAZ,17507,7597,9910,11005,6350,152,ITI,ITI4,12,Lazio,Lazio,5879082,6882811,117.07,0.3
216,2021-06-21,EMR,37548,18986,18562,16135,20873,540,ITH,ITH5,8,Emilia-Romagna,Emilia-Romagna,4459477,37548,0.84,0.84
217,2021-07-08,EMR,41291,20569,20722,4739,36151,401,ITH,ITH5,8,Emilia-Romagna,Emilia-Romagna,4459477,78839,1.77,0.93
218,2021-03-30,EMR,23345,10338,13007,18011,5041,293,ITH,ITH5,8,Emilia-Romagna,Emilia-Romagna,4459477,102184,2.29,0.52
219,2021-07-22,EMR,40064,21385,18679,15206,24015,843,ITH,ITH5,8,Emilia-Romagna,Emilia-Romagna,4459477,142248,3.19,0.9
220,2021-01-04,EMR,7314,2527,4787,7311,0,3,ITH,ITH5,8,Emilia-Romagna,Emilia-Romagna,4459477,149562,3.35,0.16
221,2021-05-12,EMR,38932,18298,20634,28430,9691,811,ITH,ITH5,8,Emilia-Romagna,Emilia-Romagna,4459477,188494,4.23,0.87
222,2021-02-01,EMR,10320,3610,6710,359,9959,2,ITH,ITH5,8,Emilia-Romagna,Emilia-Romagna,4459477,198814,4.46,0.23
223,2021-01-18,EMR,3128,879,2249,2446,679,3,ITH,ITH5,8,Emilia-Romagna,Emilia-Romagna,4459477,201942,4.53,0.07
224,2021-03-16,EMR,12246,5027,7219,4871,7309,66,ITH,ITH5,8,Emilia-Romagna,Emilia-Romagna,4459477,214188,4.8,0.27
225,2021-01-25,EMR,6463,2147,4316,206,6256,1,ITH,ITH5,8,Emilia-Romagna,Emilia-Romagna,4459477,220651,4.95,0.14
226,2021-07-01,EMR,34486,16857,17629,14933,18827,726,ITH,ITH5,8,Emilia-Romagna,Emilia-Romagna,4459477,255137,5.72,0.77
227,2021-03-23,EMR,18799,8145,10654,11951,6687,161,ITH,ITH5,8,Emilia-Romagna,Emilia-Romagna,4459477,273936,6.14,0.42
228,2021-01-30,EMR,10083,3521,6562,139,9943,1,ITH,ITH5,8,Emilia-Romagna,Emilia-Romagna,4459477,284019,6.37,0.23
229,2021-07-15,EMR,50075,26077,23998,7871,41511,693,ITH,ITH5,8,Emilia-Romagna,Emilia-Romagna,4459477,334094,7.49,1.12
230,2021-01-23,EMR,2448,871,1577,440,2008,0,ITH,ITH5,8,Emilia-Romagna,Emilia-Romagna,4459477,336542,7.55,0.05
231,2021-05-07,EMR,35299,16972,18327,22753,11876,670,ITH,ITH5,8,Emilia-Romagna,Emilia-Romagna,4459477,371841,8.34,0.79
232,2021-07-03,EMR,32057,15899,16158,11485,19983,589,ITH,ITH5,8,Emilia-Romagna,Emilia-Romagna,4459477,403898,9.06,0.72
233,2021-02-18,EMR,7039,2891,4148,6439,584,16,ITH,ITH5,8,Emilia-Romagna,Emilia-Romagna,4459477,410937,9.21,0.16
234,2021-06-07,EMR,40491,20780,19711,33585,6260,646,ITH,ITH5,8,Emilia-Romagna,Emilia-Romagna,4459477,451428,10.12,0.91
235,2021-05-26,EMR,33308,14740,18568,9955,22996,357,ITH,ITH5,8,Emilia-Romagna,Emilia-Romagna,4459477,484736,10.87,0.75
236,2021-06-12,EMR,41338,21865,19473,35609,4916,813,ITH,ITH5,8,Emilia-Romagna,Emilia-Romagna,4459477,526074,11.8,0.93
237,2021-03-04,EMR,16451,5349,11102,13344,3017,90,ITH,ITH5,8,Emilia-Romagna,Emilia-Romagna,4459477,542525,12.17,0.37
238,2021-05-24,EMR,29984,13730,16254,18038,11512,434,ITH,ITH5,8,Emilia-Romagna,Emilia-Romagna,4459477,572509,12.84,0.67
239,2021-02-13,EMR,3628,1084,2544,3015,598,15,ITH,ITH5,8,Emilia-Romagna,Emilia-Romagna,4459477,576137,12.92,0.08
240,2021-04-16,EMR,29230,13763,15467,20023,8838,369,ITH,ITH5,8,Emilia-Romagna,Emilia-Romagna,4459477,605367,13.57,0.66
241,2021-01-06,EMR,8288,2956,5332,8287,0,1,ITH,ITH5,8,Emilia-Romagna,Emilia-Romagna,4459477,613655,13.76,0.19
242,2021-04-30,EMR,36625,16793,19832,21217,14799,609,ITH,ITH5,8,Emilia-Romagna,Emilia-Romagna,4459477,650280,14.58,0.82
243,2021-03-28,EMR,13497,6026,7471,9505,3871,121,ITH,ITH5,8,Emilia-Romagna,Emilia-Romagna,4459477,663777,14.88,0.3
244,2021-07-20,EMR,42879,22426,20453,6630,35618,631,ITH,ITH5,8,Emilia-Romagna,Emilia-Romagna,4459477,706656,15.85,0.96
245,2021-04-11,EMR,15277,6935,8342,11981,3047,249,ITH,ITH5,8,Emilia-Romagna,Emilia-Romagna,4459477,721933,16.19,0.34
246,2021-02-11,EMR,4256,1415,2841,3395,843,18,ITH,ITH5,8,Emilia-Romagna,Emilia-Romagna,4459477,726189,16.28,0.1
247,2021-06-26,EMR,37436,18969,18467,21078,15528,830,ITH,ITH5,8,Emilia-Romagna,Emilia-Romagna,4459477,763625,17.12,0.84
248,2021-07-10,EMR,41979,21377,20602,6776,34547,656,ITH,ITH5,8,Emilia-Romagna,Emilia-Romagna,4459477,805604,18.06,0.94
249,2021-05-19,EMR,33769,14975,18794,18064,15217,488,ITH,ITH5,8,Emilia-Romagna,Emilia-Romagna,4459477,839373,18.82,0.76
250,2021-06-02,EMR,24101,12063,12038,18760,4972,369,ITH,ITH5,8,Emilia-Romagna,Emilia-Romagna,4459477,863474,19.36,0.54
251,2021-03-13,EMR,16138,6361,9777,10590,5313,235,ITH,ITH5,8,Emilia-Romagna,Emilia-Romagna,4459477,879612,19.72,0.36
252,2021-07-05,EMR,33190,16188,17002,11289,21351,550,ITH,ITH5,8,Emilia-Romagna,Emilia-Romagna,4459477,912802,20.47,0.74
253,2021-03-09,EMR,14761,6020,8741,10713,3953,95,ITH,ITH5,8,Emilia-Romagna,Emilia-Romagna,4459477,927563,20.8,0.33
254,2021-05-05,EMR,30122,13996,16126,18295,11268,559,ITH,ITH5,8,Emilia-Romagna,Emilia-Romagna,4459477,957685,21.48,0.68
255,2021-05-23,EMR,25487,11860,13627,13637,11597,253,ITH,ITH5,8,Emilia-Romagna,Emilia-Romagna,4459477,983172,22.05,0.57
256,2021-07-19,EMR,41847,22044,19803,6603,34660,584,ITH,ITH5,8,Emilia-Romagna,Emilia-Romagna,4459477,1025019,22.99,0.94
257,2021-04-23,EMR,29566,13812,15754,14304,14887,375,ITH,ITH5,8,Emilia-Romagna,Emilia-Romagna,4459477,1054585,23.65,0.66
258,2021-01-13,EMR,9076,2941,6135,9071,0,5,ITH,ITH5,8,Emilia-Romagna,Emilia-Romagna,4459477,1063661,23.85,0.2
259,2021-04-04,EMR,9877,4716,5161,7526,2267,84,ITH,ITH5,8,Emilia-Romagna,Emilia-Romagna,4459477,1073538,24.07,0.22
260,2021-01-11,EMR,9346,3273,6073,9337,0,9,ITH,ITH5,8,Emilia-Romagna,Emilia-Romagna,4459477,1082884,24.28,0.21
261,2021-05-31,EMR,29774,13769,16005,17794,11506,474,ITH,ITH5,8,Emilia-Romagna,Emilia-Romagna,4459477,1112658,24.95,0.67
262,2021-02-20,EMR,5319,2094,3225,5049,263,7,ITH,ITH5,8,Emilia-Romagna,Emilia-Romagna,4459477,1117977,25.07,0.12
263,2021-01-15,EMR,7746,2401,5345,7738,0,8,ITH,ITH5,8,Emilia-Romagna,Emilia-Romagna,4459477,1125723,25.24,0.17
264,2021-06-09,EMR,43050,21872,21178,35825,6381,844,ITH,ITH5,8,Emilia-Romagna,Emilia-Romagna,4459477,1168773,26.21,0.97
265,2021-03-01,EMR,10099,3583,6516,7814,2260,25,ITH,ITH5,8,Emilia-Romagna,Emilia-Romagna,4459477,1178872,26.44,0.23
266,2021-05-09,EMR,25615,12255,13360,18252,6968,395,ITH,ITH5,8,Emilia-Romagna,Emilia-Romagna,4459477,1204487,27.01,0.57
267,2021-01-29,EMR,10416,3496,6920,289,10126,1,ITH,ITH5,8,Emilia-Romagna,Emilia-Romagna,4459477,1214903,27.24,0.23
268,2021-02-15,EMR,2904,851,2053,2712,125,67,ITH,ITH5,8,Emilia-Romagna,Emilia-Romagna,4459477,1217807,27.31,0.07
269,2021-01-27,EMR,8363,2949,5414,462,7901,0,ITH,ITH5,8,Emilia-Romagna,Emilia-Romagna,4459477,1226170,27.5,0.19
270,2021-07-29,EMR,40435,21356,19079,14369,25411,655,ITH,ITH5,8,Emilia-Romagna,Emilia-Romagna,4459477,1266605,28.4,0.91
271,2021-07-27,EMR,40813,21682,19131,16898,23193,722,ITH,ITH5,8,Emilia-Romagna,Emilia-Romagna,4459477,1307418,29.32,0.92
272,2021-04-18,EMR,17505,8396,9109,12361,4919,225,ITH,ITH5,8,Emilia-Romagna,Emilia-Romagna,4459477,1324923,29.71,0.39
273,2021-06-14,EMR,41295,21348,19947,27600,13072,623,ITH,ITH5,8,Emilia-Romagna,Emilia-Romagna,4459477,1366218,30.64,0.93
274,2021-02-25,EMR,9249,3499,5750,8273,954,22,ITH,ITH5,8,Emilia-Romagna,Emilia-Romagna,4459477,1375467,30.84,0.21
275,2021-06-19,EMR,36649,18347,18302,16826,19390,433,ITH,ITH5,8,Emilia-Romagna,Emilia-Romagna,4459477,1412116,31.67,0.82
276,2021-03-11,EMR,17472,7320,10152,11437,5851,184,ITH,ITH5,8,Emilia-Romagna,Emilia-Romagna,4459477,1429588,32.06,0.39
277,2021-02-06,EMR,7594,2404,5190,2105,5485,4,ITH,ITH5,8,Emilia-Romagna,Emilia-Romagna,4459477,1437182,32.23,0.17
278,2021-03-25,EMR,21480,9416,12064,14233,6990,257,ITH,ITH5,8,Emilia-Romagna,Emilia-Romagna,4459477,1458662,32.71,0.48
279,2021-05-21,EMR,39337,17544,21793,21723,17091,523,ITH,ITH5,8,Emilia-Romagna,Emilia-Romagna,4459477,1497999,33.59,0.88
280,2021-02-10,EMR,4023,1385,2638,2761,1256,6,ITH,ITH5,8,Emilia-Romagna,Emilia-Romagna,4459477,1502022,33.68,0.09
281,2021-04-08,EMR,31215,14331,16884,25207,5304,704,ITH,ITH5,8,Emilia-Romagna,Emilia-Romagna,4459477,1533237,34.38,0.7
282,2021-03-27,EMR,21657,9058,12599,14506,6908,243,ITH,ITH5,8,Emilia-Romagna,Emilia-Romagna,4459477,1554894,34.87,0.49
283,2021-04-13,EMR,23717,11127,12590,19029,4342,346,ITH,ITH5,8,Emilia-Romagna,Emilia-Romagna,4459477,1578611,35.4,0.53
284,2021-01-03,EMR,2764,944,1820,2764,0,0,ITH,ITH5,8,Emilia-Romagna,Emilia-Romagna,4459477,1581375,35.46,0.06
285,2021-05-02,EMR,25582,11653,13929,13191,11992,399,ITH,ITH5,8,Emilia-Romagna,Emilia-Romagna,4459477,1606957,36.03,0.57
286,2021-01-22,EMR,1829,477,1352,1086,741,2,ITH,ITH5,8,Emilia-Romagna,Emilia-Romagna,4459477,1608786,36.08,0.04
287,2021-02-08,EMR,5232,1535,3697,2315,2914,3,ITH,ITH5,8,Emilia-Romagna,Emilia-Romagna,4459477,1614018,36.19,0.12
288,2021-05-16,EMR,25860,12176,13684,18364,7122,374,ITH,ITH5,8,Emilia-Romagna,Emilia-Romagna,4459477,1639878,36.77,0.58
289,2021-02-22,EMR,7482,3091,4391,7197,272,13,ITH,ITH5,8,Emilia-Romagna,Emilia-Romagna,4459477,1647360,36.94,0.17
290,2021-06-30,EMR,34227,17276,16951,17789,15657,781,ITH,ITH5,8,Emilia-Romagna,Emilia-Romagna,4459477,1681587,37.71,0.77
291,2021-07-17,EMR,43466,22934,20532,7167,35572,727,ITH,ITH5,8,Emilia-Romagna,Emilia-Romagna,4459477,1725053,38.68,0.97
292,2021-06-11,EMR,45887,23826,22061,38446,6517,924,ITH,ITH5,8,Emilia-Romagna,Emilia-Romagna,4459477,1770940,39.71,1.03
293,2021-06-28,EMR,40022,19635,20387,19645,19565,812,ITH,ITH5,8,Emilia-Romagna,Emilia-Romagna,4459477,1810962,40.61,0.9
294,2021-03-20,EMR,16087,6830,9257,8956,6965,166,ITH,ITH5,8,Emilia-Romagna,Emilia-Romagna,4459477,1827049,40.97,0.36
295,2021-04-06,EMR,24752,11174,13578,19718,4747,287,ITH,ITH5,8,Emilia-Romagna,Emilia-Romagna,4459477,1851801,41.53,0.56
296,2020-12-27,EMR,972,373,599,972,0,0,ITH,ITH5,8,Emilia-Romagna,Emilia-Romagna,4459477,1852773,41.55,0.02
297,2021-06-13,EMR,28710,14972,13738,23859,4280,571,ITH,ITH5,8,Emilia-Romagna,Emilia-Romagna,4459477,1881483,42.19,0.64
298,2021-03-05,EMR,17871,5844,12027,14286,3466,119,ITH,ITH5,8,Emilia-Romagna,Emilia-Romagna,4459477,1899354,42.59,0.4
299,2021-03-22,EMR,17648,7813,9835,10615,6864,169,ITH,ITH5,8,Emilia-Romagna,Emilia-Romagna,4459477,1917002,42.99,0.4
300,2021-03-03,EMR,15869,5253,10616,13331,2486,52,ITH,ITH5,8,Emilia-Romagna,Emilia-Romagna,4459477,1932871,43.34,0.36
301,2021-05-25,EMR,25176,11216,13960,11315,13453,408,ITH,ITH5,8,Emilia-Romagna,Emilia-Romagna,4459477,1958047,43.91,0.56
302,2021-02-14,EMR,1403,378,1025,1275,120,8,ITH,ITH5,8,Emilia-Romagna,Emilia-Romagna,4459477,1959450,43.94,0.03
303,2021-07-12,EMR,43968,22277,21691,5410,38049,509,ITH,ITH5,8,Emilia-Romagna,Emilia-Romagna,4459477,2003418,44.92,0.99
304,2021-03-18,EMR,13677,5807,7870,5583,8002,92,ITH,ITH5,8,Emilia-Romagna,Emilia-Romagna,4459477,2017095,45.23,0.31
305,2021-05-14,EMR,37297,17184,20113,26767,9640,890,ITH,ITH5,8,Emilia-Romagna,Emilia-Romagna,4459477,2054392,46.07,0.84
306,2021-02-03,EMR,9340,2989,6351,963,8376,1,ITH,ITH5,8,Emilia-Romagna,Emilia-Romagna,4459477,2063732,46.28,0.21
307,2021-04-01,EMR,23951,10771,13180,19063,4551,337,ITH,ITH5,8,Emilia-Romagna,Emilia-Romagna,4459477,2087683,46.81,0.54
308,2021-02-17,EMR,6539,2764,3775,5755,772,12,ITH,ITH5,8,Emilia-Romagna,Emilia-Romagna,4459477,2094222,46.96,0.15
309,2021-06-01,EMR,27156,13097,14059,16920,9909,327,ITH,ITH5,8,Emilia-Romagna,Emilia-Romagna,4459477,2121378,47.57,0.61
310,2021-07-28,EMR,38255,20494,17761,13800,23853,602,ITH,ITH5,8,Emilia-Romagna,Emilia-Romagna,4459477,2159633,48.43,0.86
311,2021-04-12,EMR,19248,9008,10240,14448,4448,352,ITH,ITH5,8,Emilia-Romagna,Emilia-Romagna,4459477,2178881,48.86,0.43
312,2021-06-08,EMR,45035,23048,21987,36978,7472,585,ITH,ITH5,8,Emilia-Romagna,Emilia-Romagna,4459477,2223916,49.87,1.01
313,2021-01-10,EMR,7170,2683,4487,7169,0,1,ITH,ITH5,8,Emilia-Romagna,Emilia-Romagna,4459477,2231086,50.03,0.16
314,2021-06-16,EMR,45749,23382,22367,25182,19938,629,ITH,ITH5,8,Emilia-Romagna,Emilia-Romagna,4459477,2276835,51.06,1.03
315,2021-03-08,EMR,12190,5092,7098,9463,2647,80,ITH,ITH5,8,Emilia-Romagna,Emilia-Romagna,4459477,2289025,51.33,0.27
316,2021-04-20,EMR,22625,10406,12219,13883,8354,388,ITH,ITH5,8,Emilia-Romagna,Emilia-Romagna,4459477,2311650,51.84,0.51
317,2021-06-23,EMR,37768,18896,18872,18356,18841,571,ITH,ITH5,8,Emilia-Romagna,Emilia-Romagna,4459477,2349418,52.68,0.85
318,2021-01-08,EMR,10866,3579,7287,10863,0,3,ITH,ITH5,8,Emilia-Romagna,Emilia-Romagna,4459477,2360284,52.93,0.24
319,2021-03-06,EMR,20922,5941,14981,18059,2739,124,ITH,ITH5,8,Emilia-Romagna,Emilia-Romagna,4459477,2381206,53.4,0.47
320,2021-05-20,EMR,40327,18326,22001,18456,21422,449,ITH,ITH5,8,Emilia-Romagna,Emilia-Romagna,4459477,2421533,54.3,0.9
321,2021-06-04,EMR,45703,23001,22702,36973,8183,547,ITH,ITH5,8,Emilia-Romagna,Emilia-Romagna,4459477,2467236,55.33,1.02
322,2021-01-20,EMR,1327,270,1057,1325,1,1,ITH,ITH5,8,Emilia-Romagna,Emilia-Romagna,4459477,2468563,55.36,0.03
323,2021-05-27,EMR,42300,18755,23545,13629,28247,424,ITH,ITH5,8,Emilia-Romagna,Emilia-Romagna,4459477,2510863,56.3,0.95
324,2021-02-16,EMR,5772,2446,3326,5227,531,14,ITH,ITH5,8,Emilia-Romagna,Emilia-Romagna,4459477,2516635,56.43,0.13
325,2021-06-25,EMR,42529,21537,20992,19540,22296,693,ITH,ITH5,8,Emilia-Romagna,Emilia-Romagna,4459477,2559164,57.39,0.95
326,2021-03-17,EMR,13723,5692,8031,5814,7851,58,ITH,ITH5,8,Emilia-Romagna,Emilia-Romagna,4459477,2572887,57.69,0.31
327,2021-05-13,EMR,35839,16509,19330,27277,7845,717,ITH,ITH5,8,Emilia-Romagna,Emilia-Romagna,4459477,2608726,58.5,0.8
328,2021-03-15,EMR,13450,6250,7200,6849,6500,101,ITH,ITH5,8,Emilia-Romagna,Emilia-Romagna,4459477,2622176,58.8,0.3
329,2021-07-24,EMR,24522,13102,11420,10860,13051,611,ITH,ITH5,8,Emilia-Romagna,Emilia-Romagna,4459477,2646698,59.35,0.55
330,2021-04-15,EMR,29353,13982,15371,19248,9676,429,ITH,ITH5,8,Emilia-Romagna,Emilia-Romagna,4459477,2676051,60.01,0.66
331,2021-06-18,EMR,42555,21295,21260,16173,25897,485,ITH,ITH5,8,Emilia-Romagna,Emilia-Romagna,4459477,2718606,60.96,0.95
332,2021-03-10,EMR,18803,7742,11061,12976,5646,181,ITH,ITH5,8,Emilia-Romagna,Emilia-Romagna,4459477,2737409,61.38,0.42
333,2021-05-18,EMR,29204,13268,15936,18100,10621,483,ITH,ITH5,8,Emilia-Romagna,Emilia-Romagna,4459477,2766613,62.04,0.65
334,2021-02-07,EMR,4785,1536,3249,1722,3061,2,ITH,ITH5,8,Emilia-Romagna,Emilia-Romagna,4459477,2771398,62.15,0.11
335,2021-02-24,EMR,9352,3567,5785,8450,885,17,ITH,ITH5,8,Emilia-Romagna,Emilia-Romagna,4459477,2780750,62.36,0.21
336,2021-02-12,EMR,5314,1672,3642,3887,1403,24,ITH,ITH5,8,Emilia-Romagna,Emilia-Romagna,4459477,2786064,62.48,0.12
337,2021-04-10,EMR,20922,9301,11621,16449,4143,330,ITH,ITH5,8,Emilia-Romagna,Emilia-Romagna,4459477,2806986,62.94,0.47
338,2021-04-17,EMR,27305,13077,14228,17573,9346,386,ITH,ITH5,8,Emilia-Romagna,Emilia-Romagna,4459477,2834291,63.56,0.61
339,2021-01-07,EMR,10273,3405,6868,10269,0,4,ITH,ITH5,8,Emilia-Romagna,Emilia-Romagna,4459477,2844564,63.79,0.23
340,2021-05-01,EMR,28423,12779,15644,15276,12792,355,ITH,ITH5,8,Emilia-Romagna,Emilia-Romagna,4459477,2872987,64.42,0.64
341,2021-05-28,EMR,41251,18948,22303,17319,23388,544,ITH,ITH5,8,Emilia-Romagna,Emilia-Romagna,4459477,2914238,65.35,0.93
342,2021-04-22,EMR,29053,13452,15601,14615,14077,361,ITH,ITH5,8,Emilia-Romagna,Emilia-Romagna,4459477,2943291,66.0,0.65
343,2021-01-12,EMR,9475,3124,6351,9465,0,10,ITH,ITH5,8,Emilia-Romagna,Emilia-Romagna,4459477,2952766,66.21,0.21
344,2021-07-16,EMR,49705,26234,23471,7071,41997,637,ITH,ITH5,8,Emilia-Romagna,Emilia-Romagna,4459477,3002471,67.33,1.11
345,2021-06-27,EMR,29541,14860,14681,16211,12722,608,ITH,ITH5,8,Emilia-Romagna,Emilia-Romagna,4459477,3032012,67.99,0.66
346,2021-07-14,EMR,47872,24486,23386,5582,41753,537,ITH,ITH5,8,Emilia-Romagna,Emilia-Romagna,4459477,3079884,69.06,1.07
347,2021-04-05,EMR,14846,6803,8043,11779,2893,174,ITH,ITH5,8,Emilia-Romagna,Emilia-Romagna,4459477,3094730,69.4,0.33
348,2021-04-24,EMR,28637,13244,15393,14059,14232,346,ITH,ITH5,8,Emilia-Romagna,Emilia-Romagna,4459477,3123367,70.04,0.64
349,2021-05-11,EMR,35797,16801,18996,27827,7259,711,ITH,ITH5,8,Emilia-Romagna,Emilia-Romagna,4459477,3159164,70.84,0.8
350,2021-01-31,EMR,7697,2763,4934,240,7457,0,ITH,ITH5,8,Emilia-Romagna,Emilia-Romagna,4459477,3166861,71.01,0.17
351,2021-02-09,EMR,4154,1249,2905,2306,1847,1,ITH,ITH5,8,Emilia-Romagna,Emilia-Romagna,4459477,3171015,71.11,0.09
352,2021-05-15,EMR,33276,14992,18284,22214,10425,637,ITH,ITH5,8,Emilia-Romagna,Emilia-Romagna,4459477,3204291,71.85,0.75
353,2021-02-04,EMR,9920,3201,6719,1230,8689,1,ITH,ITH5,8,Emilia-Romagna,Emilia-Romagna,4459477,3214211,72.08,0.22
354,2021-05-22,EMR,33089,14142,18947,16513,16171,405,ITH,ITH5,8,Emilia-Romagna,Emilia-Romagna,4459477,3247300,72.82,0.74
355,2021-07-18,EMR,34468,17858,16610,8186,25750,532,ITH,ITH5,8,Emilia-Romagna,Emilia-Romagna,4459477,3281768,73.59,0.77
356,2021-04-09,EMR,25733,11669,14064,19528,5702,503,ITH,ITH5,8,Emilia-Romagna,Emilia-Romagna,4459477,3307501,74.17,0.58
357,2021-02-02,EMR,9484,3049,6435,525,8959,0,ITH,ITH5,8,Emilia-Romagna,Emilia-Romagna,4459477,3316985,74.38,0.21
358,2021-07-21,EMR,43453,23184,20269,10717,32157,579,ITH,ITH5,8,Emilia-Romagna,Emilia-Romagna,4459477,3360438,75.35,0.97
359,2021-04-19,EMR,20907,9800,11107,14336,6278,293,ITH,ITH5,8,Emilia-Romagna,Emilia-Romagna,4459477,3381345,75.82,0.47
360,2021-01-09,EMR,9987,3453,6534,9982,0,5,ITH,ITH5,8,Emilia-Romagna,Emilia-Romagna,4459477,3391332,76.05,0.22
361,2021-06-15,EMR,43684,22515,21169,27924,15038,722,ITH,ITH5,8,Emilia-Romagna,Emilia-Romagna,4459477,3435016,77.03,0.98
362,2021-03-07,EMR,7841,2959,4882,6288,1521,32,ITH,ITH5,8,Emilia-Romagna,Emilia-Romagna,4459477,3442857,77.2,0.18
363,2021-05-03,EMR,28726,13569,15157,17398,10880,448,ITH,ITH5,8,Emilia-Romagna,Emilia-Romagna,4459477,3471583,77.85,0.64
364,2021-01-05,EMR,9363,3172,6191,9359,0,4,ITH,ITH5,8,Emilia-Romagna,Emilia-Romagna,4459477,3480946,78.06,0.21
365,2021-04-29,EMR,44963,21142,23821,26594,17556,813,ITH,ITH5,8,Emilia-Romagna,Emilia-Romagna,4459477,3525909,79.07,1.01
366,2021-01-19,EMR,2046,505,1541,2028,17,1,ITH,ITH5,8,Emilia-Romagna,Emilia-Romagna,4459477,3527955,79.11,0.05
367,2021-07-07,EMR,37861,19127,18734,13483,23674,704,ITH,ITH5,8,Emilia-Romagna,Emilia-Romagna,4459477,3565816,79.96,0.85
368,2021-03-29,EMR,21432,9619,11813,16543,4650,239,ITH,ITH5,8,Emilia-Romagna,Emilia-Romagna,4459477,3587248,80.44,0.48
369,2021-02-21,EMR,4450,1708,2742,4000,440,10,ITH,ITH5,8,Emilia-Romagna,Emilia-Romagna,4459477,3591698,80.54,0.1
370,2021-02-28,EMR,6821,2527,4294,4955,1846,20,ITH,ITH5,8,Emilia-Romagna,Emilia-Romagna,4459477,3598519,80.69,0.15
371,2021-04-26,EMR,27908,12938,14970,18036,9323,549,ITH,ITH5,8,Emilia-Romagna,Emilia-Romagna,4459477,3626427,81.32,0.63
372,2021-01-16,EMR,5628,1718,3910,5627,0,1,ITH,ITH5,8,Emilia-Romagna,Emilia-Romagna,4459477,3632055,81.45,0.13
373,2021-03-14,EMR,8802,3839,4963,4941,3798,63,ITH,ITH5,8,Emilia-Romagna,Emilia-Romagna,4459477,3640857,81.64,0.2
374,2021-05-10,EMR,33867,16142,17725,26064,7259,544,ITH,ITH5,8,Emilia-Romagna,Emilia-Romagna,4459477,3674724,82.4,0.76
375,2021-07-30,EMR,38660,20753,17907,14884,23115,661,ITH,ITH5,8,Emilia-Romagna,Emilia-Romagna,4459477,3713384,83.27,0.87
376,2021-04-21,EMR,23963,10966,12997,13856,9747,360,ITH,ITH5,8,Emilia-Romagna,Emilia-Romagna,4459477,3737347,83.81,0.54
377,2021-05-08,EMR,32353,15099,17254,20389,11421,543,ITH,ITH5,8,Emilia-Romagna,Emilia-Romagna,4459477,3769700,84.53,0.73
378,2021-01-28,EMR,10256,3340,6916,347,9909,0,ITH,ITH5,8,Emilia-Romagna,Emilia-Romagna,4459477,3779956,84.76,0.23
379,2021-06-29,EMR,37616,18554,19062,18188,18781,647,ITH,ITH5,8,Emilia-Romagna,Emilia-Romagna,4459477,3817572,85.61,0.84
380,2021-03-21,EMR,11957,5296,6661,7262,4605,90,ITH,ITH5,8,Emilia-Romagna,Emilia-Romagna,4459477,3829529,85.87,0.27
381,2021-06-10,EMR,45009,23113,21896,38829,5360,820,ITH,ITH5,8,Emilia-Romagna,Emilia-Romagna,4459477,3874538,86.88,1.01
382,2021-03-02,EMR,12659,4272,8387,10515,2087,57,ITH,ITH5,8,Emilia-Romagna,Emilia-Romagna,4459477,3887197,87.17,0.28
383,2021-03-19,EMR,15925,6972,8953,7799,7969,157,ITH,ITH5,8,Emilia-Romagna,Emilia-Romagna,4459477,3903122,87.52,0.36
384,2021-04-07,EMR,26118,11891,14227,19790,6014,314,ITH,ITH5,8,Emilia-Romagna,Emilia-Romagna,4459477,3929240,88.11,0.59
385,2021-01-14,EMR,8129,2593,5536,8119,0,10,ITH,ITH5,8,Emilia-Romagna,Emilia-Romagna,4459477,3937369,88.29,0.18
386,2021-02-05,EMR,9299,2959,6340,1610,7683,6,ITH,ITH5,8,Emilia-Romagna,Emilia-Romagna,4459477,3946668,88.5,0.21
387,2021-06-20,EMR,30714,15585,15129,15686,14655,373,ITH,ITH5,8,Emilia-Romagna,Emilia-Romagna,4459477,3977382,89.19,0.69
388,2021-04-03,EMR,19932,8762,11170,15952,3740,240,ITH,ITH5,8,Emilia-Romagna,Emilia-Romagna,4459477,3997314,89.64,0.45
389,2021-05-30,EMR,27084,12796,14288,13064,13699,321,ITH,ITH5,8,Emilia-Romagna,Emilia-Romagna,4459477,4024398,90.24,0.61
390,2021-02-19,EMR,7326,3010,4316,6799,514,13,ITH,ITH5,8,Emilia-Romagna,Emilia-Romagna,4459477,4031724,90.41,0.16
391,2021-07-26,EMR,39314,20971,18343,15854,22738,722,ITH,ITH5,8,Emilia-Romagna,Emilia-Romagna,4459477,4071038,91.29,0.88
392,2020-12-31,EMR,2214,779,1435,2213,0,1,ITH,ITH5,8,Emilia-Romagna,Emilia-Romagna,4459477,4073252,91.34,0.05
393,2021-06-06,EMR,36569,18984,17585,31686,4408,475,ITH,ITH5,8,Emilia-Romagna,Emilia-Romagna,4459477,4109821,92.16,0.82
394,2021-02-26,EMR,9636,3673,5963,8564,1050,22,ITH,ITH5,8,Emilia-Romagna,Emilia-Romagna,4459477,4119457,92.38,0.22
395,2021-04-28,EMR,33729,15595,18134,20257,12893,579,ITH,ITH5,8,Emilia-Romagna,Emilia-Romagna,4459477,4153186,93.13,0.76
396,2021-06-24,EMR,40340,20184,20156,20135,19552,653,ITH,ITH5,8,Emilia-Romagna,Emilia-Romagna,4459477,4193526,94.04,0.9
397,2021-06-17,EMR,46458,23483,22975,21729,24189,540,ITH,ITH5,8,Emilia-Romagna,Emilia-Romagna,4459477,4239984,95.08,1.04
398,2021-07-25,EMR,28248,15068,13180,10450,17361,437,ITH,ITH5,8,Emilia-Romagna,Emilia-Romagna,4459477,4268232,95.71,0.63
399,2021-01-02,EMR,2378,917,1461,2378,0,0,ITH,ITH5,8,Emilia-Romagna,Emilia-Romagna,4459477,4270610,95.76,0.05
400,2021-06-05,EMR,44266,22365,21901,36742,6910,614,ITH,ITH5,8,Emilia-Romagna,Emilia-Romagna,4459477,4314876,96.76,0.99
401,2021-07-23,EMR,39232,21239,17993,19394,18866,972,ITH,ITH5,8,Emilia-Romagna,Emilia-Romagna,4459477,4354108,97.64,0.88
402,2021-04-14,EMR,27043,12844,14199,20511,6105,427,ITH,ITH5,8,Emilia-Romagna,Emilia-Romagna,4459477,4381151,98.24,0.61
403,2021-01-21,EMR,2165,729,1436,819,1346,0,ITH,ITH5,8,Emilia-Romagna,Emilia-Romagna,4459477,4383316,98.29,0.05
404,2021-06-22,EMR,36451,18153,18298,16300,19623,528,ITH,ITH5,8,Emilia-Romagna,Emilia-Romagna,4459477,4419767,99.11,0.82
405,2021-07-06,EMR,36753,18474,18279,12983,23165,605,ITH,ITH5,8,Emilia-Romagna,Emilia-Romagna,4459477,4456520,99.93,0.82
406,2021-05-17,EMR,32455,15404,17051,22365,9547,543,ITH,ITH5,8,Emilia-Romagna,Emilia-Romagna,4459477,4488975,100.66,0.73
407,2021-06-03,EMR,37912,18436,19476,29870,7551,491,ITH,ITH5,8,Emilia-Romagna,Emilia-Romagna,4459477,4526887,101.51,0.85
408,2021-02-23,EMR,8216,3219,4997,7818,386,12,ITH,ITH5,8,Emilia-Romagna,Emilia-Romagna,4459477,4535103,101.7,0.18
409,2021-03-12,EMR,18312,7703,10609,11305,6718,289,ITH,ITH5,8,Emilia-Romagna,Emilia-Romagna,4459477,4553415,102.11,0.41
410,2021-05-04,EMR,29299,13720,15579,15163,13662,474,ITH,ITH5,8,Emilia-Romagna,Emilia-Romagna,4459477,4582714,102.76,0.66
411,2021-02-27,EMR,10961,3998,6963,9192,1738,31,ITH,ITH5,8,Emilia-Romagna,Emilia-Romagna,4459477,4593675,103.01,0.25
412,2021-04-25,EMR,22352,10240,12112,14401,7512,439,ITH,ITH5,8,Emilia-Romagna,Emilia-Romagna,4459477,4616027,103.51,0.5
413,2021-04-27,EMR,32114,14867,17247,19227,12465,422,ITH,ITH5,8,Emilia-Romagna,Emilia-Romagna,4459477,4648141,104.23,0.72
414,2021-05-06,EMR,35940,16608,19332,22172,13064,704,ITH,ITH5,8,Emilia-Romagna,Emilia-Romagna,4459477,4684081,105.04,0.81
415,2021-01-26,EMR,8335,3001,5334,210,8124,1,ITH,ITH5,8,Emilia-Romagna,Emilia-Romagna,4459477,4692416,105.22,0.19
416,2021-07-02,EMR,34707,17067,17640,12432,21696,579,ITH,ITH5,8,Emilia-Romagna,Emilia-Romagna,4459477,4727123,106.0,0.78
417,2021-03-24,EMR,21221,9401,11820,13620,7382,219,ITH,ITH5,8,Emilia-Romagna,Emilia-Romagna,4459477,4748344,106.48,0.48
418,2021-01-24,EMR,2444,886,1558,298,2146,0,ITH,ITH5,8,Emilia-Romagna,Emilia-Romagna,4459477,4750788,106.53,0.05
419,2021-07-09,EMR,44783,22869,21914,5415,38959,409,ITH,ITH5,8,Emilia-Romagna,Emilia-Romagna,4459477,4795571,107.54,1.0
420,2021-01-17,EMR,2890,887,2003,2642,247,1,ITH,ITH5,8,Emilia-Romagna,Emilia-Romagna,4459477,4798461,107.6,0.06
421,2021-04-02,EMR,23392,10552,12840,18560,4482,350,ITH,ITH5,8,Emilia-Romagna,Emilia-Romagna,4459477,4821853,108.13,0.52
422,2021-05-29,EMR,37895,16501,21394,16730,20731,434,ITH,ITH5,8,Emilia-Romagna,Emilia-Romagna,4459477,4859748,108.98,0.85
423,2021-07-11,EMR,30316,15200,15116,2760,27292,264,ITH,ITH5,8,Emilia-Romagna,Emilia-Romagna,4459477,4890064,109.66,0.68
424,2021-03-31,EMR,25267,11044,14223,19495,5453,319,ITH,ITH5,8,Emilia-Romagna,Emilia-Romagna,4459477,4915331,110.22,0.57
425,2021-07-13,EMR,48372,24778,23594,6464,41231,677,ITH,ITH5,8,Emilia-Romagna,Emilia-Romagna,4459477,4963703,111.31,1.08
426,2021-07-04,EMR,24242,12052,12190,10190,13596,456,ITH,ITH5,8,Emilia-Romagna,Emilia-Romagna,4459477,4987945,111.85,0.54
427,2021-03-26,EMR,23716,10117,13599,17004,6440,272,ITH,ITH5,8,Emilia-Romagna,Emilia-Romagna,4459477,5011661,112.38,0.53
428,2021-04-18,CAL,5862,2801,3061,4922,918,22,ITF,ITF6,18,Calabria,Calabria,1947131,5862,0.3,0.3
429,2021-04-04,CAL,1573,787,786,1142,421,10,ITF,ITF6,18,Calabria,Calabria,1947131,7435,0.38,0.08
430,2021-06-26,CAL,15579,7194,8385,7568,7944,67,ITF,ITF6,18,Calabria,Calabria,1947131,23014,1.18,0.8
431,2021-02-06,CAL,2920,1345,1575,444,2475,1,ITF,ITF6,18,Calabria,Calabria,1947131,25934,1.33,0.15
432,2021-07-10,CAL,15932,7531,8401,3243,12646,43,ITF,ITF6,18,Calabria,Calabria,1947131,41866,2.15,0.82
433,2021-01-23,CAL,402,187,215,359,43,0,ITF,ITF6,18,Calabria,Calabria,1947131,42268,2.17,0.02
434,2021-03-28,CAL,2693,1234,1459,1567,1122,4,ITF,ITF6,18,Calabria,Calabria,1947131,44961,2.31,0.14
435,2021-03-09,CAL,6522,3402,3120,5468,989,65,ITF,ITF6,18,Calabria,Calabria,1947131,51483,2.64,0.33
436,2021-02-20,CAL,1461,770,691,1124,323,14,ITF,ITF6,18,Calabria,Calabria,1947131,52944,2.72,0.08
437,2021-05-31,CAL,15294,7344,7950,7310,7903,81,ITF,ITF6,18,Calabria,Calabria,1947131,68238,3.5,0.79
438,2021-07-01,CAL,12313,5805,6508,5402,6828,83,ITF,ITF6,18,Calabria,Calabria,1947131,80551,4.14,0.63
439,2021-02-01,CAL,2547,1210,1337,240,2304,3,ITF,ITF6,18,Calabria,Calabria,1947131,83098,4.27,0.13
440,2021-07-08,CAL,12044,5617,6427,2695,9307,42,ITF,ITF6,18,Calabria,Calabria,1947131,95142,4.89,0.62
441,2021-05-12,CAL,16450,8025,8425,10836,5521,93,ITF,ITF6,18,Calabria,Calabria,1947131,111592,5.73,0.84
442,2021-05-26,CAL,18718,9320,9398,10315,8310,93,ITF,ITF6,18,Calabria,Calabria,1947131,130310,6.69,0.96
443,2021-07-27,CAL,17573,8989,8584,5026,12465,82,ITF,ITF6,18,Calabria,Calabria,1947131,147883,7.59,0.9
444,2021-01-06,CAL,943,509,434,943,0,0,ITF,ITF6,18,Calabria,Calabria,1947131,148826,7.64,0.05
445,2021-04-16,CAL,10283,5021,5262,8614,1616,53,ITF,ITF6,18,Calabria,Calabria,1947131,159109,8.17,0.53
446,2021-02-18,CAL,1866,859,1007,1616,233,17,ITF,ITF6,18,Calabria,Calabria,1947131,160975,8.27,0.1
447,2021-06-21,CAL,15395,7088,8307,7993,7363,39,ITF,ITF6,18,Calabria,Calabria,1947131,176370,9.06,0.79
448,2021-07-22,CAL,18314,9020,9294,3492,14733,89,ITF,ITF6,18,Calabria,Calabria,1947131,194684,10.0,0.94
449,2021-04-30,CAL,15067,7387,7680,10549,4446,72,ITF,ITF6,18,Calabria,Calabria,1947131,209751,10.77,0.77
450,2021-01-18,CAL,1301,591,710,1052,245,4,ITF,ITF6,18,Calabria,Calabria,1947131,211052,10.84,0.07
451,2021-01-11,CAL,2179,1057,1122,2177,0,2,ITF,ITF6,18,Calabria,Calabria,1947131,213231,10.95,0.11
452,2021-01-25,CAL,1085,521,564,150,935,0,ITF,ITF6,18,Calabria,Calabria,1947131,214316,11.01,0.06
453,2021-05-05,CAL,13557,6487,7070,8407,5077,73,ITF,ITF6,18,Calabria,Calabria,1947131,227873,11.7,0.7
454,2021-03-02,CAL,4375,2494,1881,3607,759,9,ITF,ITF6,18,Calabria,Calabria,1947131,232248,11.93,0.22
455,2021-03-16,CAL,3862,1894,1968,2185,1665,12,ITF,ITF6,18,Calabria,Calabria,1947131,236110,12.13,0.2
456,2021-06-14,CAL,14361,6512,7849,9635,4649,77,ITF,ITF6,18,Calabria,Calabria,1947131,250471,12.86,0.74
457,2021-03-04,CAL,5486,3193,2293,4668,798,20,ITF,ITF6,18,Calabria,Calabria,1947131,255957,13.15,0.28
458,2021-06-12,CAL,13246,6298,6948,10781,2398,67,ITF,ITF6,18,Calabria,Calabria,1947131,269203,13.83,0.68
459,2021-03-30,CAL,6446,2803,3643,3647,2780,19,ITF,ITF6,18,Calabria,Calabria,1947131,275649,14.16,0.33
460,2021-05-19,CAL,18305,9067,9238,11250,6980,75,ITF,ITF6,18,Calabria,Calabria,1947131,293954,15.1,0.94
461,2021-03-23,CAL,5260,2469,2791,3423,1816,21,ITF,ITF6,18,Calabria,Calabria,1947131,299214,15.37,0.27
462,2021-07-15,CAL,18291,8811,9480,2529,15716,46,ITF,ITF6,18,Calabria,Calabria,1947131,317505,16.31,0.94
463,2021-06-07,CAL,18001,8420,9581,14712,3209,80,ITF,ITF6,18,Calabria,Calabria,1947131,335506,17.23,0.92
464,2021-05-24,CAL,17765,8897,8868,9934,7749,82,ITF,ITF6,18,Calabria,Calabria,1947131,353271,18.14,0.91
465,2021-05-07,CAL,16157,7612,8545,9655,6427,75,ITF,ITF6,18,Calabria,Calabria,1947131,369428,18.97,0.83
466,2021-02-13,CAL,1400,605,795,1031,366,3,ITF,ITF6,18,Calabria,Calabria,1947131,370828,19.04,0.07
467,2021-06-11,CAL,17824,8759,9065,15126,2577,121,ITF,ITF6,18,Calabria,Calabria,1947131,388652,19.96,0.92
468,2021-01-08,CAL,2185,1042,1143,2178,0,7,ITF,ITF6,18,Calabria,Calabria,1947131,390837,20.07,0.11
469,2021-01-30,CAL,2202,1164,1038,327,1872,3,ITF,ITF6,18,Calabria,Calabria,1947131,393039,20.19,0.11
470,2021-02-17,CAL,1870,826,1044,1645,211,14,ITF,ITF6,18,Calabria,Calabria,1947131,394909,20.28,0.1
471,2021-07-24,CAL,18013,9269,8744,4594,13325,94,ITF,ITF6,18,Calabria,Calabria,1947131,412922,21.21,0.93
472,2021-05-28,CAL,20975,10195,10780,11409,9454,112,ITF,ITF6,18,Calabria,Calabria,1947131,433897,22.28,1.08
473,2021-04-15,CAL,7765,3808,3957,5981,1744,40,ITF,ITF6,18,Calabria,Calabria,1947131,441662,22.68,0.4
474,2021-04-01,CAL,8680,3951,4729,4160,4485,35,ITF,ITF6,18,Calabria,Calabria,1947131,450342,23.13,0.45
475,2021-03-11,CAL,7279,3462,3817,5952,1282,45,ITF,ITF6,18,Calabria,Calabria,1947131,457621,23.5,0.37
476,2021-06-19,CAL,15855,7417,8438,8506,7283,66,ITF,ITF6,18,Calabria,Calabria,1947131,473476,24.32,0.81
477,2021-01-04,CAL,1071,531,540,1068,0,3,ITF,ITF6,18,Calabria,Calabria,1947131,474547,24.37,0.06
478,2021-04-23,CAL,13126,6443,6683,9430,3600,96,ITF,ITF6,18,Calabria,Calabria,1947131,487673,25.05,0.67
479,2021-01-13,CAL,2072,1045,1027,2059,0,13,ITF,ITF6,18,Calabria,Calabria,1947131,489745,25.15,0.11
480,2021-06-23,CAL,17200,7862,9338,8122,8997,81,ITF,ITF6,18,Calabria,Calabria,1947131,506945,26.04,0.88
481,2021-07-03,CAL,15147,7133,8014,5261,9811,75,ITF,ITF6,18,Calabria,Calabria,1947131,522092,26.81,0.78
482,2021-04-11,CAL,4199,1908,2291,2237,1946,16,ITF,ITF6,18,Calabria,Calabria,1947131,526291,27.03,0.22
483,2021-07-20,CAL,17477,8476,9001,3205,14204,68,ITF,ITF6,18,Calabria,Calabria,1947131,543768,27.93,0.9
484,2021-04-13,CAL,6928,3402,3526,5583,1324,21,ITF,ITF6,18,Calabria,Calabria,1947131,550696,28.28,0.36
485,2021-02-25,CAL,2902,1564,1338,2265,597,40,ITF,ITF6,18,Calabria,Calabria,1947131,553598,28.43,0.15
486,2021-03-06,CAL,8494,4373,4121,7674,800,20,ITF,ITF6,18,Calabria,Calabria,1947131,562092,28.87,0.44
487,2021-07-29,CAL,16785,8356,8429,4537,12153,95,ITF,ITF6,18,Calabria,Calabria,1947131,578877,29.73,0.86
488,2021-02-11,CAL,2347,1047,1300,1062,1263,22,ITF,ITF6,18,Calabria,Calabria,1947131,581224,29.85,0.12
489,2021-02-15,CAL,1161,554,607,1001,155,5,ITF,ITF6,18,Calabria,Calabria,1947131,582385,29.91,0.06
490,2021-03-18,CAL,4450,2083,2367,2333,2094,23,ITF,ITF6,18,Calabria,Calabria,1947131,586835,30.14,0.23
491,2021-02-27,CAL,4021,2070,1951,3631,383,7,ITF,ITF6,18,Calabria,Calabria,1947131,590856,30.34,0.21
492,2021-01-27,CAL,1483,749,734,389,1093,1,ITF,ITF6,18,Calabria,Calabria,1947131,592339,30.42,0.08
493,2021-05-14,CAL,19922,9569,10353,12942,6871,109,ITF,ITF6,18,Calabria,Calabria,1947131,612261,31.44,1.02
494,2021-04-27,CAL,9965,4900,5065,7961,1956,48,ITF,ITF6,18,Calabria,Calabria,1947131,622226,31.96,0.51
495,2021-02-03,CAL,2865,1472,1393,550,2309,6,ITF,ITF6,18,Calabria,Calabria,1947131,625091,32.1,0.15
496,2021-07-19,CAL,18993,9099,9894,3030,15916,47,ITF,ITF6,18,Calabria,Calabria,1947131,644084,33.08,0.98
497,2021-02-22,CAL,2070,1052,1018,1502,559,9,ITF,ITF6,18,Calabria,Calabria,1947131,646154,33.18,0.11
498,2021-06-02,CAL,12097,5800,6297,8785,3265,47,ITF,ITF6,18,Calabria,Calabria,1947131,658251,33.81,0.62
499,2021-05-16,CAL,13789,6729,7060,9916,3819,54,ITF,ITF6,18,Calabria,Calabria,1947131,672040,34.51,0.71
500,2021-07-21,CAL,22057,10595,11462,4500,17446,111,ITF,ITF6,18,Calabria,Calabria,1947131,694097,35.65,1.13
501,2021-01-17,CAL,899,433,466,798,95,6,ITF,ITF6,18,Calabria,Calabria,1947131,694996,35.69,0.05
502,2021-03-24,CAL,7848,3592,4256,4522,3304,22,ITF,ITF6,18,Calabria,Calabria,1947131,702844,36.1,0.4
503,2021-04-10,CAL,11689,5292,6397,6787,4858,44,ITF,ITF6,18,Calabria,Calabria,1947131,714533,36.7,0.6
504,2021-02-05,CAL,3851,1738,2113,472,3364,15,ITF,ITF6,18,Calabria,Calabria,1947131,718384,36.89,0.2
505,2021-04-29,CAL,12483,6069,6414,8660,3772,51,ITF,ITF6,18,Calabria,Calabria,1947131,730867,37.54,0.64
506,2021-04-12,CAL,7020,3418,3602,5347,1650,23,ITF,ITF6,18,Calabria,Calabria,1947131,737887,37.9,0.36
507,2021-01-19,CAL,1127,496,631,1113,12,2,ITF,ITF6,18,Calabria,Calabria,1947131,739014,37.95,0.06
508,2021-07-04,CAL,5934,2813,3121,1981,3918,35,ITF,ITF6,18,Calabria,Calabria,1947131,744948,38.26,0.3
509,2021-01-20,CAL,1407,629,778,1403,1,3,ITF,ITF6,18,Calabria,Calabria,1947131,746355,38.33,0.07
510,2021-01-03,CAL,6,3,3,6,0,0,ITF,ITF6,18,Calabria,Calabria,1947131,746361,38.33,0.0
511,2021-03-27,CAL,8798,4001,4797,4654,4100,44,ITF,ITF6,18,Calabria,Calabria,1947131,755159,38.78,0.45
512,2021-07-05,CAL,13388,6257,7131,4289,9042,57,ITF,ITF6,18,Calabria,Calabria,1947131,768547,39.47,0.69
513,2021-03-08,CAL,5501,2977,2524,4401,1070,30,ITF,ITF6,18,Calabria,Calabria,1947131,774048,39.75,0.28
514,2021-03-25,CAL,7504,3541,3963,4575,2898,31,ITF,ITF6,18,Calabria,Calabria,1947131,781552,40.14,0.39
515,2021-06-16,CAL,18333,8473,9860,12127,6115,91,ITF,ITF6,18,Calabria,Calabria,1947131,799885,41.08,0.94
516,2021-04-08,CAL,9322,4413,4909,5808,3469,45,ITF,ITF6,18,Calabria,Calabria,1947131,809207,41.56,0.48
517,2021-02-10,CAL,2517,1082,1435,870,1632,15,ITF,ITF6,18,Calabria,Calabria,1947131,811724,41.69,0.13
518,2021-07-17,CAL,18331,9045,9286,2713,15553,65,ITF,ITF6,18,Calabria,Calabria,1947131,830055,42.63,0.94
519,2021-06-04,CAL,17534,8156,9378,12954,4510,70,ITF,ITF6,18,Calabria,Calabria,1947131,847589,43.53,0.9
520,2021-05-21,CAL,21339,10868,10471,13862,7367,110,ITF,ITF6,18,Calabria,Calabria,1947131,868928,44.63,1.1
521,2020-12-27,CAL,312,168,144,312,0,0,ITF,ITF6,18,Calabria,Calabria,1947131,869240,44.64,0.02
522,2021-04-06,CAL,8152,3715,4437,4462,3664,26,ITF,ITF6,18,Calabria,Calabria,1947131,877392,45.06,0.42
523,2021-02-08,CAL,1863,742,1121,662,1198,3,ITF,ITF6,18,Calabria,Calabria,1947131,879255,45.16,0.1
524,2021-04-24,CAL,19276,9594,9682,15752,3439,85,ITF,ITF6,18,Calabria,Calabria,1947131,898531,46.15,0.99
525,2021-02-26,CAL,3113,1659,1454,2640,458,15,ITF,ITF6,18,Calabria,Calabria,1947131,901644,46.31,0.16
526,2021-06-20,CAL,6652,3152,3500,3815,2809,28,ITF,ITF6,18,Calabria,Calabria,1947131,908296,46.65,0.34
527,2021-06-06,CAL,13778,6622,7156,12006,1703,69,ITF,ITF6,18,Calabria,Calabria,1947131,922074,47.36,0.71
528,2021-01-07,CAL,2212,1084,1128,2208,0,4,ITF,ITF6,18,Calabria,Calabria,1947131,924286,47.47,0.11
529,2021-06-13,CAL,6840,3357,3483,5730,1056,54,ITF,ITF6,18,Calabria,Calabria,1947131,931126,47.82,0.35
530,2021-04-17,CAL,10819,5065,5754,9007,1767,45,ITF,ITF6,18,Calabria,Calabria,1947131,941945,48.38,0.56
531,2021-05-01,CAL,16730,7972,8758,12399,4245,86,ITF,ITF6,18,Calabria,Calabria,1947131,958675,49.24,0.86
532,2021-03-05,CAL,6239,3621,2618,5647,576,16,ITF,ITF6,18,Calabria,Calabria,1947131,964914,49.56,0.32
533,2021-05-09,CAL,9638,4498,5140,6053,3542,43,ITF,ITF6,18,Calabria,Calabria,1947131,974552,50.05,0.49
534,2021-01-29,CAL,2068,998,1070,226,1841,1,ITF,ITF6,18,Calabria,Calabria,1947131,976620,50.16,0.11
535,2021-05-04,CAL,16461,7592,8869,11644,4729,88,ITF,ITF6,18,Calabria,Calabria,1947131,993081,51.0,0.85
536,2021-01-22,CAL,659,275,384,657,2,0,ITF,ITF6,18,Calabria,Calabria,1947131,993740,51.04,0.03
537,2021-05-02,CAL,12563,5864,6699,10612,1891,60,ITF,ITF6,18,Calabria,Calabria,1947131,1006303,51.68,0.65
538,2021-03-29,CAL,5772,2496,3276,3980,1768,24,ITF,ITF6,18,Calabria,Calabria,1947131,1012075,51.98,0.3
539,2021-01-31,CAL,1120,558,562,152,968,0,ITF,ITF6,18,Calabria,Calabria,1947131,1013195,52.04,0.06
540,2021-07-07,CAL,13959,6578,7381,3906,9982,71,ITF,ITF6,18,Calabria,Calabria,1947131,1027154,52.75,0.72
541,2021-05-11,CAL,15096,7315,7781,10239,4790,67,ITF,ITF6,18,Calabria,Calabria,1947131,1042250,53.53,0.78
542,2021-07-16,CAL,21035,10023,11012,3383,17583,69,ITF,ITF6,18,Calabria,Calabria,1947131,1063285,54.61,1.08
543,2021-05-23,CAL,11388,5551,5837,6997,4348,43,ITF,ITF6,18,Calabria,Calabria,1947131,1074673,55.19,0.58
544,2021-03-01,CAL,2739,1555,1184,2276,459,4,ITF,ITF6,18,Calabria,Calabria,1947131,1077412,55.33,0.14
545,2021-06-09,CAL,18232,8605,9627,15909,2240,83,ITF,ITF6,18,Calabria,Calabria,1947131,1095644,56.27,0.94
546,2021-07-12,CAL,17968,8533,9435,2677,15242,49,ITF,ITF6,18,Calabria,Calabria,1947131,1113612,57.19,0.92
547,2021-01-10,CAL,940,530,410,940,0,0,ITF,ITF6,18,Calabria,Calabria,1947131,1114552,57.24,0.05
548,2021-06-17,CAL,15824,7227,8597,9604,6167,53,ITF,ITF6,18,Calabria,Calabria,1947131,1130376,58.05,0.81
549,2021-03-26,CAL,8095,3841,4254,4940,3127,28,ITF,ITF6,18,Calabria,Calabria,1947131,1138471,58.47,0.42
550,2021-01-24,CAL,46,19,27,40,6,0,ITF,ITF6,18,Calabria,Calabria,1947131,1138517,58.47,0.0
551,2021-07-09,CAL,15646,7299,8347,3623,11954,69,ITF,ITF6,18,Calabria,Calabria,1947131,1154163,59.28,0.8
552,2021-04-20,CAL,7867,3972,3895,6059,1736,72,ITF,ITF6,18,Calabria,Calabria,1947131,1162030,59.68,0.4
553,2021-02-12,CAL,1721,679,1042,942,773,6,ITF,ITF6,18,Calabria,Calabria,1947131,1163751,59.77,0.09
554,2021-01-05,CAL,1535,720,815,1533,0,2,ITF,ITF6,18,Calabria,Calabria,1947131,1165286,59.85,0.08
555,2021-01-12,CAL,2086,1032,1054,2077,0,9,ITF,ITF6,18,Calabria,Calabria,1947131,1167372,59.95,0.11
556,2021-02-24,CAL,1926,980,946,1442,478,6,ITF,ITF6,18,Calabria,Calabria,1947131,1169298,60.05,0.1
557,2021-02-14,CAL,480,219,261,448,31,1,ITF,ITF6,18,Calabria,Calabria,1947131,1169778,60.08,0.02
558,2021-05-25,CAL,16405,8032,8373,10210,6109,86,ITF,ITF6,18,Calabria,Calabria,1947131,1186183,60.92,0.84
559,2021-01-26,CAL,1874,898,976,273,1600,1,ITF,ITF6,18,Calabria,Calabria,1947131,1188057,61.02,0.1
560,2021-06-18,CAL,18861,8788,10073,11258,7490,113,ITF,ITF6,18,Calabria,Calabria,1947131,1206918,61.98,0.97
561,2021-03-10,CAL,6827,3469,3358,5450,1342,35,ITF,ITF6,18,Calabria,Calabria,1947131,1213745,62.34,0.35
562,2021-06-01,CAL,12868,5967,6901,7888,4922,58,ITF,ITF6,18,Calabria,Calabria,1947131,1226613,63.0,0.66
563,2021-05-13,CAL,15952,7674,8278,11173,4708,71,ITF,ITF6,18,Calabria,Calabria,1947131,1242565,63.82,0.82
564,2021-02-19,CAL,1511,683,828,1239,263,9,ITF,ITF6,18,Calabria,Calabria,1947131,1244076,63.89,0.08
565,2021-05-30,CAL,10972,5279,5693,6784,4152,36,ITF,ITF6,18,Calabria,Calabria,1947131,1255048,64.46,0.56
566,2020-12-28,CAL,6,2,4,6,0,0,ITF,ITF6,18,Calabria,Calabria,1947131,1255054,64.46,0.0
567,2021-06-03,CAL,14241,6651,7590,9591,4595,55,ITF,ITF6,18,Calabria,Calabria,1947131,1269295,65.19,0.73
568,2021-04-07,CAL,7163,3263,3900,4086,3031,46,ITF,ITF6,18,Calabria,Calabria,1947131,1276458,65.56,0.37
569,2021-02-23,CAL,1601,756,845,1480,116,5,ITF,ITF6,18,Calabria,Calabria,1947131,1278059,65.64,0.08
570,2021-07-26,CAL,18698,9296,9402,5197,13414,87,ITF,ITF6,18,Calabria,Calabria,1947131,1296757,66.6,0.96
571,2021-03-12,CAL,5154,2468,2686,4077,1058,19,ITF,ITF6,18,Calabria,Calabria,1947131,1301911,66.86,0.26
572,2021-01-14,CAL,2656,1261,1395,2650,0,6,ITF,ITF6,18,Calabria,Calabria,1947131,1304567,67.0,0.14
573,2021-06-27,CAL,8420,3942,4478,4985,3399,36,ITF,ITF6,18,Calabria,Calabria,1947131,1312987,67.43,0.43
574,2021-04-03,CAL,9421,4076,5345,4514,4849,58,ITF,ITF6,18,Calabria,Calabria,1947131,1322408,67.92,0.48
575,2021-01-28,CAL,2291,1137,1154,80,2211,0,ITF,ITF6,18,Calabria,Calabria,1947131,1324699,68.03,0.12
576,2021-05-08,CAL,18502,8409,10093,10535,7901,66,ITF,ITF6,18,Calabria,Calabria,1947131,1343201,68.98,0.95
577,2021-05-22,CAL,22195,10561,11634,14214,7891,90,ITF,ITF6,18,Calabria,Calabria,1947131,1365396,70.12,1.14
578,2021-01-21,CAL,975,456,519,939,33,3,ITF,ITF6,18,Calabria,Calabria,1947131,1366371,70.17,0.05
579,2021-07-06,CAL,11833,5460,6373,3613,8158,62,ITF,ITF6,18,Calabria,Calabria,1947131,1378204,70.78,0.61
580,2021-01-02,CAL,166,94,72,166,0,0,ITF,ITF6,18,Calabria,Calabria,1947131,1378370,70.79,0.01
581,2021-05-17,CAL,14923,7470,7453,10154,4717,52,ITF,ITF6,18,Calabria,Calabria,1947131,1393293,71.56,0.77
582,2021-02-21,CAL,636,299,337,558,77,1,ITF,ITF6,18,Calabria,Calabria,1947131,1393929,71.59,0.03
583,2021-04-28,CAL,12569,6094,6475,9626,2872,71,ITF,ITF6,18,Calabria,Calabria,1947131,1406498,72.23,0.65
584,2021-02-04,CAL,3661,1743,1918,647,3008,6,ITF,ITF6,18,Calabria,Calabria,1947131,1410159,72.42,0.19
585,2021-05-15,CAL,27248,13034,14214,20258,6859,131,ITF,ITF6,18,Calabria,Calabria,1947131,1437407,73.82,1.4
586,2021-02-02,CAL,2366,1164,1202,176,2190,0,ITF,ITF6,18,Calabria,Calabria,1947131,1439773,73.94,0.12
587,2021-01-16,CAL,2407,1130,1277,2404,0,3,ITF,ITF6,18,Calabria,Calabria,1947131,1442180,74.07,0.12
588,2021-07-28,CAL,21390,10731,10659,5932,15349,109,ITF,ITF6,18,Calabria,Calabria,1947131,1463570,75.17,1.1
589,2021-04-22,CAL,9804,4901,4903,6853,2905,46,ITF,ITF6,18,Calabria,Calabria,1947131,1473374,75.67,0.5
590,2021-05-06,CAL,13293,6293,7000,8934,4293,66,ITF,ITF6,18,Calabria,Calabria,1947131,1486667,76.35,0.68
591,2021-07-14,CAL,22610,10665,11945,4150,18386,74,ITF,ITF6,18,Calabria,Calabria,1947131,1509277,77.51,1.16
592,2021-04-05,CAL,3641,1727,1914,2670,959,12,ITF,ITF6,18,Calabria,Calabria,1947131,1512918,77.7,0.19
593,2021-03-31,CAL,9128,4164,4964,5048,4046,34,ITF,ITF6,18,Calabria,Calabria,1947131,1522046,78.17,0.47
594,2021-04-09,CAL,7986,3743,4243,5016,2890,80,ITF,ITF6,18,Calabria,Calabria,1947131,1530032,78.58,0.41
595,2021-07-18,CAL,8780,4205,4575,1274,7474,32,ITF,ITF6,18,Calabria,Calabria,1947131,1538812,79.03,0.45
596,2021-06-05,CAL,20707,9692,11015,17620,3008,79,ITF,ITF6,18,Calabria,Calabria,1947131,1559519,80.09,1.06
597,2021-03-03,CAL,5073,2772,2301,3979,1081,13,ITF,ITF6,18,Calabria,Calabria,1947131,1564592,80.35,0.26
598,2021-06-29,CAL,13030,6017,7013,5336,7644,50,ITF,ITF6,18,Calabria,Calabria,1947131,1577622,81.02,0.67
599,2021-05-03,CAL,14828,6794,8034,10467,4275,86,ITF,ITF6,18,Calabria,Calabria,1947131,1592450,81.78,0.76
600,2021-03-21,CAL,4450,1921,2529,2728,1712,10,ITF,ITF6,18,Calabria,Calabria,1947131,1596900,82.01,0.23
601,2021-03-07,CAL,3402,1736,1666,3297,92,13,ITF,ITF6,18,Calabria,Calabria,1947131,1600302,82.19,0.17
602,2021-06-15,CAL,9884,4576,5308,6465,3357,62,ITF,ITF6,18,Calabria,Calabria,1947131,1610186,82.7,0.51
603,2021-03-14,CAL,2733,1061,1672,2281,445,7,ITF,ITF6,18,Calabria,Calabria,1947131,1612919,82.84,0.14
604,2021-06-22,CAL,14622,6913,7709,7382,7145,95,ITF,ITF6,18,Calabria,Calabria,1947131,1627541,83.59,0.75
605,2021-05-10,CAL,13165,6124,7041,7706,5403,56,ITF,ITF6,18,Calabria,Calabria,1947131,1640706,84.26,0.68
606,2021-04-26,CAL,10186,5057,5129,7721,2421,44,ITF,ITF6,18,Calabria,Calabria,1947131,1650892,84.79,0.52
607,2021-04-21,CAL,11578,5814,5764,8617,2907,54,ITF,ITF6,18,Calabria,Calabria,1947131,1662470,85.38,0.59
608,2021-07-30,CAL,19650,10031,9619,5530,13998,122,ITF,ITF6,18,Calabria,Calabria,1947131,1682120,86.39,1.01
609,2021-04-02,CAL,8534,3909,4625,4579,3923,32,ITF,ITF6,18,Calabria,Calabria,1947131,1690654,86.83,0.44
610,2021-06-24,CAL,15364,6997,8367,6950,8336,78,ITF,ITF6,18,Calabria,Calabria,1947131,1706018,87.62,0.79
611,2021-03-19,CAL,4214,1969,2245,1888,2319,7,ITF,ITF6,18,Calabria,Calabria,1947131,1710232,87.83,0.22
612,2021-07-11,CAL,6425,2980,3445,843,5572,10,ITF,ITF6,18,Calabria,Calabria,1947131,1716657,88.16,0.33
613,2021-06-08,CAL,16678,7902,8776,14521,2035,122,ITF,ITF6,18,Calabria,Calabria,1947131,1733335,89.02,0.86
614,2021-03-17,CAL,4146,1847,2299,2187,1951,8,ITF,ITF6,18,Calabria,Calabria,1947131,1737481,89.23,0.21
615,2021-06-25,CAL,18822,8734,10088,8080,10663,79,ITF,ITF6,18,Calabria,Calabria,1947131,1756303,90.2,0.97
616,2021-07-13,CAL,17427,8154,9273,2313,15047,67,ITF,ITF6,18,Calabria,Calabria,1947131,1773730,91.09,0.9
617,2021-04-19,CAL,7882,3803,4079,6158,1678,46,ITF,ITF6,18,Calabria,Calabria,1947131,1781612,91.5,0.4
618,2021-01-09,CAL,2008,1083,925,2000,0,8,ITF,ITF6,18,Calabria,Calabria,1947131,1783620,91.6,0.1
619,2021-06-10,CAL,15891,7326,8565,12984,2807,100,ITF,ITF6,18,Calabria,Calabria,1947131,1799511,92.42,0.82
620,2021-02-28,CAL,2345,1066,1279,2188,154,3,ITF,ITF6,18,Calabria,Calabria,1947131,1801856,92.54,0.12
621,2021-03-13,CAL,6972,3023,3949,5938,1003,31,ITF,ITF6,18,Calabria,Calabria,1947131,1808828,92.9,0.36
622,2021-01-15,CAL,2811,1262,1549,2805,0,6,ITF,ITF6,18,Calabria,Calabria,1947131,1811639,93.04,0.14
623,2021-04-25,CAL,15894,8067,7827,14805,1025,64,ITF,ITF6,18,Calabria,Calabria,1947131,1827533,93.86,0.82
624,2021-06-30,CAL,16372,7497,8875,7008,9267,97,ITF,ITF6,18,Calabria,Calabria,1947131,1843905,94.7,0.84
625,2021-06-28,CAL,13283,6117,7166,5366,7852,65,ITF,ITF6,18,Calabria,Calabria,1947131,1857188,95.38,0.68
626,2021-03-20,CAL,6729,3081,3648,4179,2534,16,ITF,ITF6,18,Calabria,Calabria,1947131,1863917,95.73,0.35
627,2021-03-15,CAL,3634,1752,1882,2162,1462,10,ITF,ITF6,18,Calabria,Calabria,1947131,1867551,95.91,0.19
628,2021-07-02,CAL,16260,7531,8729,6241,9938,81,ITF,ITF6,18,Calabria,Calabria,1947131,1883811,96.75,0.84
629,2021-05-20,CAL,16980,8495,8485,11266,5647,67,ITF,ITF6,18,Calabria,Calabria,1947131,1900791,97.62,0.87
630,2021-02-07,CAL,863,430,433,145,716,2,ITF,ITF6,18,Calabria,Calabria,1947131,1901654,97.66,0.04
631,2021-05-18,CAL,15336,7672,7664,11848,3420,68,ITF,ITF6,18,Calabria,Calabria,1947131,1916990,98.45,0.79
632,2021-03-22,CAL,4974,2334,2640,3177,1772,25,ITF,ITF6,18,Calabria,Calabria,1947131,1921964,98.71,0.26
633,2021-02-09,CAL,2164,913,1251,947,1208,9,ITF,ITF6,18,Calabria,Calabria,1947131,1924128,98.82,0.11
634,2021-05-29,CAL,19277,8951,10326,9346,9855,76,ITF,ITF6,18,Calabria,Calabria,1947131,1943405,99.81,0.99
635,2021-07-25,CAL,6947,3569,3378,1468,5447,32,ITF,ITF6,18,Calabria,Calabria,1947131,1950352,100.17,0.36
636,2021-04-14,CAL,8079,3900,4179,6582,1450,47,ITF,ITF6,18,Calabria,Calabria,1947131,1958431,100.58,0.41
637,2021-02-16,CAL,1747,742,1005,1462,280,5,ITF,ITF6,18,Calabria,Calabria,1947131,1960178,100.67,0.09
638,2021-07-23,CAL,22645,11303,11342,5528,17022,95,ITF,ITF6,18,Calabria,Calabria,1947131,1982823,101.83,1.16
639,2021-05-27,CAL,17655,8729,8926,9770,7803,82,ITF,ITF6,18,Calabria,Calabria,1947131,2000478,102.74,0.91
640,2021-04-08,BAS,767,352,415,742,10,15,ITF,ITF5,17,Basilicata,Basilicata,559084,767,0.14,0.14
641,2021-04-22,BAS,5046,2351,2695,3381,1610,55,ITF,ITF5,17,Basilicata,Basilicata,559084,5813,1.04,0.9
642,2021-07-17,BAS,5855,2914,2941,1709,4107,39,ITF,ITF5,17,Basilicata,Basilicata,559084,11668,2.09,1.05
643,2021-06-30,BAS,3452,1668,1784,2315,1111,26,ITF,ITF5,17,Basilicata,Basilicata,559084,15120,2.7,0.62
644,2021-02-17,BAS,1137,493,644,1058,77,2,ITF,ITF5,17,Basilicata,Basilicata,559084,16257,2.91,0.2
645,2021-03-25,BAS,1883,603,1280,1517,344,22,ITF,ITF5,17,Basilicata,Basilicata,559084,18140,3.24,0.34
646,2021-01-27,BAS,418,176,242,113,305,0,ITF,ITF5,17,Basilicata,Basilicata,559084,18558,3.32,0.07
647,2021-02-10,BAS,550,239,311,495,53,2,ITF,ITF5,17,Basilicata,Basilicata,559084,19108,3.42,0.1
648,2021-05-21,BAS,4579,2323,2256,1480,3087,12,ITF,ITF5,17,Basilicata,Basilicata,559084,23687,4.24,0.82
649,2021-04-01,BAS,2720,1115,1605,1969,723,28,ITF,ITF5,17,Basilicata,Basilicata,559084,26407,4.72,0.49
650,2021-02-03,BAS,673,304,369,32,641,0,ITF,ITF5,17,Basilicata,Basilicata,559084,27080,4.84,0.12
651,2021-07-26,BAS,5415,2721,2694,1994,3383,38,ITF,ITF5,17,Basilicata,Basilicata,559084,32495,5.81,0.97
652,2021-01-22,BAS,67,24,43,67,0,0,ITF,ITF5,17,Basilicata,Basilicata,559084,32562,5.82,0.01
653,2021-07-24,BAS,5722,2927,2795,1753,3920,49,ITF,ITF5,17,Basilicata,Basilicata,559084,38284,6.85,1.02
654,2021-05-02,BAS,4180,2001,2179,3491,629,60,ITF,ITF5,17,Basilicata,Basilicata,559084,42464,7.6,0.75
655,2021-04-15,BAS,3389,1660,1729,2589,757,43,ITF,ITF5,17,Basilicata,Basilicata,559084,45853,8.2,0.61
656,2021-05-30,BAS,2778,1421,1357,920,1853,5,ITF,ITF5,17,Basilicata,Basilicata,559084,48631,8.7,0.5
657,2021-04-03,BAS,1814,755,1059,1466,336,12,ITF,ITF5,17,Basilicata,Basilicata,559084,50445,9.02,0.32
658,2021-02-05,BAS,995,447,548,63,931,1,ITF,ITF5,17,Basilicata,Basilicata,559084,51440,9.2,0.18
659,2021-07-12,BAS,5442,2593,2849,1606,3810,26,ITF,ITF5,17,Basilicata,Basilicata,559084,56882,10.17,0.97
660,2021-05-04,BAS,4139,1993,2146,3567,523,49,ITF,ITF5,17,Basilicata,Basilicata,559084,61021,10.91,0.74
661,2021-03-08,BAS,1468,719,749,820,618,30,ITF,ITF5,17,Basilicata,Basilicata,559084,62489,11.18,0.26
662,2021-06-16,BAS,4602,2084,2518,2126,2456,20,ITF,ITF5,17,Basilicata,Basilicata,559084,67091,12.0,0.82
663,2021-06-04,BAS,4831,2288,2543,3748,1046,37,ITF,ITF5,17,Basilicata,Basilicata,559084,71922,12.86,0.86
664,2021-02-24,BAS,1808,743,1065,1723,74,11,ITF,ITF5,17,Basilicata,Basilicata,559084,73730,13.19,0.32
665,2021-02-22,BAS,1792,774,1018,1731,53,8,ITF,ITF5,17,Basilicata,Basilicata,559084,75522,13.51,0.32
666,2021-01-15,BAS,819,353,466,819,0,0,ITF,ITF5,17,Basilicata,Basilicata,559084,76341,13.65,0.15
667,2020-12-27,BAS,106,41,65,106,0,0,ITF,ITF5,17,Basilicata,Basilicata,559084,76447,13.67,0.02
668,2021-03-20,BAS,1295,574,721,275,1013,7,ITF,ITF5,17,Basilicata,Basilicata,559084,77742,13.91,0.23
669,2021-06-28,BAS,3643,1748,1895,2115,1510,18,ITF,ITF5,17,Basilicata,Basilicata,559084,81385,14.56,0.65
670,2021-03-06,BAS,1367,541,826,751,603,13,ITF,ITF5,17,Basilicata,Basilicata,559084,82752,14.8,0.24
671,2021-01-10,BAS,77,24,53,77,0,0,ITF,ITF5,17,Basilicata,Basilicata,559084,82829,14.82,0.01
672,2021-04-20,BAS,4105,1958,2147,2182,1899,24,ITF,ITF5,17,Basilicata,Basilicata,559084,86934,15.55,0.73
673,2021-01-08,BAS,554,219,335,554,0,0,ITF,ITF5,17,Basilicata,Basilicata,559084,87488,15.65,0.1
674,2021-03-15,BAS,2365,989,1376,508,1841,16,ITF,ITF5,17,Basilicata,Basilicata,559084,89853,16.07,0.42
675,2021-01-17,BAS,329,133,196,328,1,0,ITF,ITF5,17,Basilicata,Basilicata,559084,90182,16.13,0.06
676,2021-05-16,BAS,4973,2468,2505,2812,2113,48,ITF,ITF5,17,Basilicata,Basilicata,559084,95155,17.02,0.89
677,2021-07-19,BAS,5924,2888,3036,1997,3886,41,ITF,ITF5,17,Basilicata,Basilicata,559084,101079,18.08,1.06
678,2021-05-23,BAS,4518,2302,2216,1527,2984,7,ITF,ITF5,17,Basilicata,Basilicata,559084,105597,18.89,0.81
679,2021-03-27,BAS,2255,865,1390,1809,432,14,ITF,ITF5,17,Basilicata,Basilicata,559084,107852,19.29,0.4
680,2021-05-28,BAS,3615,1810,1805,919,2663,33,ITF,ITF5,17,Basilicata,Basilicata,559084,111467,19.94,0.65
681,2021-06-11,BAS,4237,1982,2255,3168,1028,41,ITF,ITF5,17,Basilicata,Basilicata,559084,115704,20.7,0.76
682,2021-05-11,BAS,2654,1353,1301,1596,1034,24,ITF,ITF5,17,Basilicata,Basilicata,559084,118358,21.17,0.47
683,2021-07-14,BAS,5641,2719,2922,1627,3989,25,ITF,ITF5,17,Basilicata,Basilicata,559084,123999,22.18,1.01
684,2021-06-01,BAS,6136,2926,3210,3033,3076,27,ITF,ITF5,17,Basilicata,Basilicata,559084,130135,23.28,1.1
685,2021-07-07,BAS,5208,2474,2734,2022,3174,12,ITF,ITF5,17,Basilicata,Basilicata,559084,135343,24.21,0.93
686,2021-01-03,BAS,901,344,557,901,0,0,ITF,ITF5,17,Basilicata,Basilicata,559084,136244,24.37,0.16
687,2021-06-09,BAS,4424,2072,2352,3967,424,33,ITF,ITF5,17,Basilicata,Basilicata,559084,140668,25.16,0.79
688,2021-04-13,BAS,2118,1053,1065,1283,818,17,ITF,ITF5,17,Basilicata,Basilicata,559084,142786,25.54,0.38
689,2021-03-01,BAS,552,286,266,383,169,0,ITF,ITF5,17,Basilicata,Basilicata,559084,143338,25.64,0.1
690,2021-06-18,BAS,4466,2066,2400,2181,2259,26,ITF,ITF5,17,Basilicata,Basilicata,559084,147804,26.44,0.8
691,2021-01-24,BAS,852,310,542,58,793,1,ITF,ITF5,17,Basilicata,Basilicata,559084,148656,26.59,0.15
692,2021-06-23,BAS,3250,1528,1722,2342,876,32,ITF,ITF5,17,Basilicata,Basilicata,559084,151906,27.17,0.58
693,2021-03-13,BAS,1803,892,911,735,1048,20,ITF,ITF5,17,Basilicata,Basilicata,559084,153709,27.49,0.32
694,2021-02-07,BAS,380,160,220,49,331,0,ITF,ITF5,17,Basilicata,Basilicata,559084,154089,27.56,0.07
695,2021-05-18,BAS,5896,2856,3040,3384,2492,20,ITF,ITF5,17,Basilicata,Basilicata,559084,159985,28.62,1.05
696,2021-07-23,BAS,5550,2781,2769,1888,3617,45,ITF,ITF5,17,Basilicata,Basilicata,559084,165535,29.61,0.99
697,2021-05-01,BAS,4708,2139,2569,3888,753,67,ITF,ITF5,17,Basilicata,Basilicata,559084,170243,30.45,0.84
698,2021-04-27,BAS,4728,2243,2485,4351,326,51,ITF,ITF5,17,Basilicata,Basilicata,559084,174971,31.3,0.85
699,2021-05-09,BAS,4683,2339,2344,2940,1694,49,ITF,ITF5,17,Basilicata,Basilicata,559084,179654,32.13,0.84
700,2021-02-15,BAS,625,235,390,568,43,14,ITF,ITF5,17,Basilicata,Basilicata,559084,180279,32.25,0.11
701,2021-01-29,BAS,617,231,386,63,554,0,ITF,ITF5,17,Basilicata,Basilicata,559084,180896,32.36,0.11
702,2021-03-05,BAS,1859,860,999,1096,750,13,ITF,ITF5,17,Basilicata,Basilicata,559084,182755,32.69,0.33
703,2021-06-13,BAS,3014,1440,1574,2678,308,28,ITF,ITF5,17,Basilicata,Basilicata,559084,185769,33.23,0.54
704,2021-07-05,BAS,3269,1614,1655,2214,1022,33,ITF,ITF5,17,Basilicata,Basilicata,559084,189038,33.81,0.58
705,2021-01-07,BAS,641,319,322,641,0,0,ITF,ITF5,17,Basilicata,Basilicata,559084,189679,33.93,0.11
706,2021-02-19,BAS,1624,739,885,1557,62,5,ITF,ITF5,17,Basilicata,Basilicata,559084,191303,34.22,0.29
707,2021-04-05,BAS,724,233,491,412,302,10,ITF,ITF5,17,Basilicata,Basilicata,559084,192027,34.35,0.13
708,2021-03-22,BAS,1194,538,656,637,549,8,ITF,ITF5,17,Basilicata,Basilicata,559084,193221,34.56,0.21
709,2021-03-03,BAS,1749,819,930,1167,560,22,ITF,ITF5,17,Basilicata,Basilicata,559084,194970,34.87,0.31
710,2021-05-25,BAS,4199,2114,2085,867,3322,10,ITF,ITF5,17,Basilicata,Basilicata,559084,199169,35.62,0.75
711,2021-02-14,BAS,151,48,103,105,0,46,ITF,ITF5,17,Basilicata,Basilicata,559084,199320,35.65,0.03
712,2021-01-31,BAS,77,24,53,0,77,0,ITF,ITF5,17,Basilicata,Basilicata,559084,199397,35.66,0.01
713,2021-07-09,BAS,5345,2613,2732,1699,3637,9,ITF,ITF5,17,Basilicata,Basilicata,559084,204742,36.62,0.96
714,2021-04-17,BAS,3462,1656,1806,2172,1262,28,ITF,ITF5,17,Basilicata,Basilicata,559084,208204,37.24,0.62
715,2021-03-29,BAS,2472,892,1580,2133,288,51,ITF,ITF5,17,Basilicata,Basilicata,559084,210676,37.68,0.44
716,2021-01-05,BAS,948,410,538,948,0,0,ITF,ITF5,17,Basilicata,Basilicata,559084,211624,37.85,0.17
717,2021-06-20,BAS,4012,1885,2127,1942,2036,34,ITF,ITF5,17,Basilicata,Basilicata,559084,215636,38.57,0.72
718,2021-03-14,BAS,1010,477,533,529,469,12,ITF,ITF5,17,Basilicata,Basilicata,559084,216646,38.75,0.18
719,2021-03-31,BAS,3105,1264,1841,2292,783,30,ITF,ITF5,17,Basilicata,Basilicata,559084,219751,39.31,0.56
720,2021-06-22,BAS,4362,2067,2295,2229,2101,32,ITF,ITF5,17,Basilicata,Basilicata,559084,224113,40.09,0.78
721,2021-06-05,BAS,4800,2210,2590,3824,941,35,ITF,ITF5,17,Basilicata,Basilicata,559084,228913,40.94,0.86
722,2021-02-23,BAS,1903,772,1131,1746,139,18,ITF,ITF5,17,Basilicata,Basilicata,559084,230816,41.28,0.34
723,2021-06-03,BAS,4921,2258,2663,3703,1180,38,ITF,ITF5,17,Basilicata,Basilicata,559084,235737,42.16,0.88
724,2021-03-12,BAS,1914,984,930,783,1104,27,ITF,ITF5,17,Basilicata,Basilicata,559084,237651,42.51,0.34
725,2021-05-17,BAS,5546,2734,2812,3362,2135,49,ITF,ITF5,17,Basilicata,Basilicata,559084,243197,43.5,0.99
726,2021-02-26,BAS,2152,904,1248,2065,81,6,ITF,ITF5,17,Basilicata,Basilicata,559084,245349,43.88,0.38
727,2021-05-20,BAS,5880,2979,2901,2883,2969,28,ITF,ITF5,17,Basilicata,Basilicata,559084,251229,44.94,1.05
728,2021-06-08,BAS,4585,2194,2391,4190,357,38,ITF,ITF5,17,Basilicata,Basilicata,559084,255814,45.76,0.82
729,2021-04-12,BAS,2172,1051,1121,1653,490,29,ITF,ITF5,17,Basilicata,Basilicata,559084,257986,46.14,0.39
730,2021-07-21,BAS,5848,2944,2904,1613,4202,33,ITF,ITF5,17,Basilicata,Basilicata,559084,263834,47.19,1.05
731,2021-04-19,BAS,4170,1913,2257,2398,1641,131,ITF,ITF5,17,Basilicata,Basilicata,559084,268004,47.94,0.75
732,2021-07-28,BAS,5058,2587,2471,1942,3057,59,ITF,ITF5,17,Basilicata,Basilicata,559084,273062,48.84,0.9
733,2021-02-12,BAS,777,332,445,744,32,1,ITF,ITF5,17,Basilicata,Basilicata,559084,273839,48.98,0.14
734,2021-04-10,BAS,1033,378,655,924,83,26,ITF,ITF5,17,Basilicata,Basilicata,559084,274872,49.16,0.18
735,2021-06-24,BAS,4107,1945,2162,2167,1903,37,ITF,ITF5,17,Basilicata,Basilicata,559084,278979,49.9,0.73
736,2021-04-28,BAS,4708,2159,2549,4207,441,60,ITF,ITF5,17,Basilicata,Basilicata,559084,283687,50.74,0.84
737,2021-03-02,BAS,802,387,415,659,138,5,ITF,ITF5,17,Basilicata,Basilicata,559084,284489,50.88,0.14
738,2021-06-10,BAS,4346,2102,2244,3868,441,37,ITF,ITF5,17,Basilicata,Basilicata,559084,288835,51.66,0.78
739,2021-07-30,BAS,4771,2440,2331,1918,2805,48,ITF,ITF5,17,Basilicata,Basilicata,559084,293606,52.52,0.85
740,2021-06-17,BAS,4440,2043,2397,2087,2329,24,ITF,ITF5,17,Basilicata,Basilicata,559084,298046,53.31,0.79
741,2021-04-21,BAS,3939,1840,2099,2244,1666,29,ITF,ITF5,17,Basilicata,Basilicata,559084,301985,54.01,0.7
742,2021-06-27,BAS,3008,1478,1530,2379,615,14,ITF,ITF5,17,Basilicata,Basilicata,559084,304993,54.55,0.54
743,2021-04-29,BAS,4832,2385,2447,4339,421,72,ITF,ITF5,17,Basilicata,Basilicata,559084,309825,55.42,0.86
744,2021-03-17,BAS,1464,613,851,24,1436,4,ITF,ITF5,17,Basilicata,Basilicata,559084,311289,55.68,0.26
745,2021-01-19,BAS,199,84,115,199,0,0,ITF,ITF5,17,Basilicata,Basilicata,559084,311488,55.71,0.04
746,2021-06-25,BAS,3318,1573,1745,2451,832,35,ITF,ITF5,17,Basilicata,Basilicata,559084,314806,56.31,0.59
747,2021-07-04,BAS,3109,1562,1547,2163,921,25,ITF,ITF5,17,Basilicata,Basilicata,559084,317915,56.86,0.56
748,2021-03-24,BAS,1901,725,1176,1480,398,23,ITF,ITF5,17,Basilicata,Basilicata,559084,319816,57.2,0.34
749,2021-07-02,BAS,3691,1839,1852,2485,1177,29,ITF,ITF5,17,Basilicata,Basilicata,559084,323507,57.86,0.66
750,2021-05-27,BAS,3609,1858,1751,1066,2529,14,ITF,ITF5,17,Basilicata,Basilicata,559084,327116,58.51,0.65
751,2021-04-24,BAS,4548,2202,2346,3474,1019,55,ITF,ITF5,17,Basilicata,Basilicata,559084,331664,59.32,0.81
752,2021-02-08,BAS,561,193,368,152,409,0,ITF,ITF5,17,Basilicata,Basilicata,559084,332225,59.42,0.1
753,2021-05-19,BAS,2872,1499,1373,1183,1676,13,ITF,ITF5,17,Basilicata,Basilicata,559084,335097,59.94,0.51
754,2021-02-25,BAS,1789,738,1051,1732,46,11,ITF,ITF5,17,Basilicata,Basilicata,559084,336886,60.26,0.32
755,2021-02-11,BAS,953,402,551,868,83,2,ITF,ITF5,17,Basilicata,Basilicata,559084,337839,60.43,0.17
756,2021-05-22,BAS,5488,2723,2765,1926,3551,11,ITF,ITF5,17,Basilicata,Basilicata,559084,343327,61.41,0.98
757,2021-03-26,BAS,1956,703,1253,1669,260,27,ITF,ITF5,17,Basilicata,Basilicata,559084,345283,61.76,0.35
758,2021-07-16,BAS,5932,2900,3032,1802,4096,34,ITF,ITF5,17,Basilicata,Basilicata,559084,351215,62.82,1.06
759,2021-03-19,BAS,2299,996,1303,259,2033,7,ITF,ITF5,17,Basilicata,Basilicata,559084,353514,63.23,0.41
760,2021-02-16,BAS,907,377,530,790,98,19,ITF,ITF5,17,Basilicata,Basilicata,559084,354421,63.39,0.16
761,2021-06-15,BAS,3221,1416,1805,2226,975,20,ITF,ITF5,17,Basilicata,Basilicata,559084,357642,63.97,0.58
762,2021-02-28,BAS,811,346,465,771,36,4,ITF,ITF5,17,Basilicata,Basilicata,559084,358453,64.11,0.15
763,2021-01-02,BAS,950,381,569,949,0,1,ITF,ITF5,17,Basilicata,Basilicata,559084,359403,64.28,0.17
764,2021-01-16,BAS,722,304,418,722,0,0,ITF,ITF5,17,Basilicata,Basilicata,559084,360125,64.41,0.13
765,2021-04-26,BAS,4466,2165,2301,4199,221,46,ITF,ITF5,17,Basilicata,Basilicata,559084,364591,65.21,0.8
766,2021-01-12,BAS,217,88,129,217,0,0,ITF,ITF5,17,Basilicata,Basilicata,559084,364808,65.25,0.04
767,2021-05-10,BAS,4805,2383,2422,2719,2042,44,ITF,ITF5,17,Basilicata,Basilicata,559084,369613,66.11,0.86
768,2021-06-06,BAS,4512,2074,2438,3695,779,38,ITF,ITF5,17,Basilicata,Basilicata,559084,374125,66.92,0.81
769,2021-04-14,BAS,2044,1001,1043,1353,675,16,ITF,ITF5,17,Basilicata,Basilicata,559084,376169,67.28,0.37
770,2021-01-21,BAS,30,10,20,30,0,0,ITF,ITF5,17,Basilicata,Basilicata,559084,376199,67.29,0.01
771,2021-01-04,BAS,608,271,337,608,0,0,ITF,ITF5,17,Basilicata,Basilicata,559084,376807,67.4,0.11
772,2021-07-06,BAS,4073,1943,2130,2032,2007,34,ITF,ITF5,17,Basilicata,Basilicata,559084,380880,68.13,0.73
773,2021-01-23,BAS,735,315,420,33,702,0,ITF,ITF5,17,Basilicata,Basilicata,559084,381615,68.26,0.13
774,2021-05-03,BAS,4510,2043,2467,3621,827,62,ITF,ITF5,17,Basilicata,Basilicata,559084,386125,69.06,0.81
775,2021-02-09,BAS,492,213,279,317,175,0,ITF,ITF5,17,Basilicata,Basilicata,559084,386617,69.15,0.09
776,2021-07-25,BAS,4449,2229,2220,1577,2848,24,ITF,ITF5,17,Basilicata,Basilicata,559084,391066,69.95,0.8
777,2021-02-13,BAS,800,314,486,701,61,38,ITF,ITF5,17,Basilicata,Basilicata,559084,391866,70.09,0.14
778,2021-05-24,BAS,4835,2345,2490,1091,3731,13,ITF,ITF5,17,Basilicata,Basilicata,559084,396701,70.96,0.86
779,2021-07-29,BAS,4577,2379,2198,1813,2720,44,ITF,ITF5,17,Basilicata,Basilicata,559084,401278,71.77,0.82
780,2021-06-02,BAS,5960,2805,3155,4376,1543,41,ITF,ITF5,17,Basilicata,Basilicata,559084,407238,72.84,1.07
781,2021-04-18,BAS,3719,1843,1876,2329,1368,22,ITF,ITF5,17,Basilicata,Basilicata,559084,410957,73.51,0.67
782,2021-01-18,BAS,463,157,306,364,99,0,ITF,ITF5,17,Basilicata,Basilicata,559084,411420,73.59,0.08
783,2021-03-16,BAS,1914,806,1108,226,1685,3,ITF,ITF5,17,Basilicata,Basilicata,559084,413334,73.93,0.34
784,2021-01-28,BAS,914,405,509,119,795,0,ITF,ITF5,17,Basilicata,Basilicata,559084,414248,74.09,0.16
785,2021-01-14,BAS,969,413,556,969,0,0,ITF,ITF5,17,Basilicata,Basilicata,559084,415217,74.27,0.17
786,2021-04-07,BAS,1211,551,660,1155,36,20,ITF,ITF5,17,Basilicata,Basilicata,559084,416428,74.48,0.22
787,2021-04-25,BAS,2989,1458,1531,2905,52,32,ITF,ITF5,17,Basilicata,Basilicata,559084,419417,75.02,0.53
788,2021-05-05,BAS,4336,2049,2287,3380,890,66,ITF,ITF5,17,Basilicata,Basilicata,559084,423753,75.79,0.78
789,2021-03-09,BAS,1408,719,689,779,611,18,ITF,ITF5,17,Basilicata,Basilicata,559084,425161,76.05,0.25
790,2021-01-25,BAS,1032,431,601,73,958,1,ITF,ITF5,17,Basilicata,Basilicata,559084,426193,76.23,0.18
791,2021-01-11,BAS,183,66,117,183,0,0,ITF,ITF5,17,Basilicata,Basilicata,559084,426376,76.26,0.03
792,2021-02-06,BAS,921,379,542,146,775,0,ITF,ITF5,17,Basilicata,Basilicata,559084,427297,76.43,0.16
793,2021-04-30,BAS,5286,2376,2910,4066,1163,57,ITF,ITF5,17,Basilicata,Basilicata,559084,432583,77.37,0.95
794,2021-01-20,BAS,85,22,63,84,1,0,ITF,ITF5,17,Basilicata,Basilicata,559084,432668,77.39,0.02
795,2021-06-21,BAS,4254,2043,2211,2143,2092,19,ITF,ITF5,17,Basilicata,Basilicata,559084,436922,78.15,0.76
796,2021-06-19,BAS,4467,2179,2288,2371,2074,22,ITF,ITF5,17,Basilicata,Basilicata,559084,441389,78.95,0.8
797,2021-03-28,BAS,2144,743,1401,2110,17,17,ITF,ITF5,17,Basilicata,Basilicata,559084,443533,79.33,0.38
798,2021-03-11,BAS,1796,930,866,817,961,18,ITF,ITF5,17,Basilicata,Basilicata,559084,445329,79.65,0.32
799,2021-03-30,BAS,2815,1192,1623,2454,346,15,ITF,ITF5,17,Basilicata,Basilicata,559084,448144,80.16,0.5
800,2021-07-08,BAS,5137,2429,2708,1854,3259,24,ITF,ITF5,17,Basilicata,Basilicata,559084,453281,81.08,0.92
801,2021-01-06,BAS,295,129,166,295,0,0,ITF,ITF5,17,Basilicata,Basilicata,559084,453576,81.13,0.05
802,2021-04-16,BAS,3323,1635,1688,2400,900,23,ITF,ITF5,17,Basilicata,Basilicata,559084,456899,81.72,0.59
803,2021-07-18,BAS,4386,2162,2224,1576,2784,26,ITF,ITF5,17,Basilicata,Basilicata,559084,461285,82.51,0.78
804,2021-06-29,BAS,3857,1881,1976,2790,1041,26,ITF,ITF5,17,Basilicata,Basilicata,559084,465142,83.2,0.69
805,2021-03-21,BAS,1159,536,623,457,699,3,ITF,ITF5,17,Basilicata,Basilicata,559084,466301,83.4,0.21
806,2021-02-20,BAS,1165,534,631,1046,119,0,ITF,ITF5,17,Basilicata,Basilicata,559084,467466,83.61,0.21
807,2021-07-27,BAS,4715,2371,2344,1818,2854,43,ITF,ITF5,17,Basilicata,Basilicata,559084,472181,84.46,0.84
808,2021-05-31,BAS,4229,2009,2220,1713,2508,8,ITF,ITF5,17,Basilicata,Basilicata,559084,476410,85.21,0.76
809,2021-02-18,BAS,1071,401,670,852,216,3,ITF,ITF5,17,Basilicata,Basilicata,559084,477481,85.4,0.19
810,2021-02-21,BAS,284,113,171,284,0,0,ITF,ITF5,17,Basilicata,Basilicata,559084,477765,85.45,0.05
811,2021-03-07,BAS,892,311,581,843,39,10,ITF,ITF5,17,Basilicata,Basilicata,559084,478657,85.61,0.16
812,2021-01-09,BAS,557,160,397,557,0,0,ITF,ITF5,17,Basilicata,Basilicata,559084,479214,85.71,0.1
813,2021-07-03,BAS,3945,2102,1843,2757,1145,43,ITF,ITF5,17,Basilicata,Basilicata,559084,483159,86.42,0.71
814,2021-05-07,BAS,4636,2281,2355,3274,1338,24,ITF,ITF5,17,Basilicata,Basilicata,559084,487795,87.25,0.83
815,2021-07-10,BAS,5555,2681,2874,1597,3949,9,ITF,ITF5,17,Basilicata,Basilicata,559084,493350,88.24,0.99
816,2021-05-14,BAS,5907,2799,3108,3273,2531,103,ITF,ITF5,17,Basilicata,Basilicata,559084,499257,89.3,1.06
817,2021-03-18,BAS,1354,565,789,17,1328,9,ITF,ITF5,17,Basilicata,Basilicata,559084,500611,89.54,0.24
818,2021-06-26,BAS,3329,1611,1718,2742,558,29,ITF,ITF5,17,Basilicata,Basilicata,559084,503940,90.14,0.6
819,2021-05-12,BAS,4730,2331,2399,2800,1882,48,ITF,ITF5,17,Basilicata,Basilicata,559084,508670,90.98,0.85
820,2021-07-15,BAS,6477,3211,3266,1669,4783,25,ITF,ITF5,17,Basilicata,Basilicata,559084,515147,92.14,1.16
821,2021-04-06,BAS,1274,465,809,1075,184,15,ITF,ITF5,17,Basilicata,Basilicata,559084,516421,92.37,0.23
822,2021-06-14,BAS,4825,2156,2669,2092,2709,24,ITF,ITF5,17,Basilicata,Basilicata,559084,521246,93.23,0.86
823,2021-03-23,BAS,1595,611,984,1410,168,17,ITF,ITF5,17,Basilicata,Basilicata,559084,522841,93.52,0.29
824,2021-05-29,BAS,3060,1534,1526,826,2225,9,ITF,ITF5,17,Basilicata,Basilicata,559084,525901,94.06,0.55
825,2021-01-13,BAS,916,387,529,916,0,0,ITF,ITF5,17,Basilicata,Basilicata,559084,526817,94.23,0.16
826,2021-04-23,BAS,4548,2189,2359,3480,1008,60,ITF,ITF5,17,Basilicata,Basilicata,559084,531365,95.04,0.81
827,2021-01-30,BAS,707,229,478,129,578,0,ITF,ITF5,17,Basilicata,Basilicata,559084,532072,95.17,0.13
828,2021-07-01,BAS,3708,1856,1852,2564,1111,33,ITF,ITF5,17,Basilicata,Basilicata,559084,535780,95.83,0.66
829,2021-02-01,BAS,243,91,152,46,197,0,ITF,ITF5,17,Basilicata,Basilicata,559084,536023,95.88,0.04
830,2021-05-26,BAS,4487,2258,2229,1676,2782,29,ITF,ITF5,17,Basilicata,Basilicata,559084,540510,96.68,0.8
831,2021-03-04,BAS,1889,894,995,1064,802,23,ITF,ITF5,17,Basilicata,Basilicata,559084,542399,97.02,0.34
832,2021-06-12,BAS,3676,1688,1988,2959,678,39,ITF,ITF5,17,Basilicata,Basilicata,559084,546075,97.67,0.66
833,2021-05-13,BAS,5984,2967,3017,3299,2595,90,ITF,ITF5,17,Basilicata,Basilicata,559084,552059,98.74,1.07
834,2021-05-08,BAS,4840,2402,2438,3386,1410,44,ITF,ITF5,17,Basilicata,Basilicata,559084,556899,99.61,0.87
835,2021-03-10,BAS,1684,844,840,835,839,10,ITF,ITF5,17,Basilicata,Basilicata,559084,558583,99.91,0.3
836,2021-01-26,BAS,807,356,451,101,706,0,ITF,ITF5,17,Basilicata,Basilicata,559084,559390,100.05,0.14
837,2021-05-06,BAS,5068,2440,2628,3432,1585,51,ITF,ITF5,17,Basilicata,Basilicata,559084,564458,100.96,0.91
838,2021-05-15,BAS,6529,3344,3185,3874,2572,83,ITF,ITF5,17,Basilicata,Basilicata,559084,570987,102.13,1.17
839,2021-04-02,BAS,2342,1057,1285,1715,605,22,ITF,ITF5,17,Basilicata,Basilicata,559084,573329,102.55,0.42
840,2021-02-04,BAS,1103,445,658,64,1039,0,ITF,ITF5,17,Basilicata,Basilicata,559084,574432,102.75,0.2
841,2021-07-11,BAS,5032,2405,2627,1510,3497,25,ITF,ITF5,17,Basilicata,Basilicata,559084,579464,103.65,0.9
842,2021-02-02,BAS,368,144,224,174,193,1,ITF,ITF5,17,Basilicata,Basilicata,559084,579832,103.71,0.07
843,2021-04-09,BAS,1151,350,801,1064,63,24,ITF,ITF5,17,Basilicata,Basilicata,559084,580983,103.92,0.21
844,2021-07-13,BAS,5855,2825,3030,1773,4035,47,ITF,ITF5,17,Basilicata,Basilicata,559084,586838,104.96,1.05
845,2021-02-27,BAS,1993,861,1132,1812,164,17,ITF,ITF5,17,Basilicata,Basilicata,559084,588831,105.32,0.36
846,2021-07-20,BAS,5711,2805,2906,1696,3975,40,ITF,ITF5,17,Basilicata,Basilicata,559084,594542,106.34,1.02
847,2021-06-07,BAS,4238,1920,2318,3884,316,38,ITF,ITF5,17,Basilicata,Basilicata,559084,598780,107.1,0.76
848,2021-04-11,BAS,950,381,569,761,160,29,ITF,ITF5,17,Basilicata,Basilicata,559084,599730,107.27,0.17
849,2021-04-04,BAS,611,226,385,191,414,6,ITF,ITF5,17,Basilicata,Basilicata,559084,600341,107.38,0.11
850,2021-07-22,BAS,5797,2889,2908,1786,3950,61,ITF,ITF5,17,Basilicata,Basilicata,559084,606138,108.42,1.04
851,2021-07-01,TOS,32047,15511,16536,10723,21057,267,ITI,ITI1,9,Toscana,Toscana,3729641,32047,0.86,0.86
852,2021-03-26,TOS,20689,9397,11292,14717,5766,206,ITI,ITI1,9,Toscana,Toscana,3729641,52736,1.41,0.55
853,2021-03-09,TOS,11137,4574,6563,5506,5553,78,ITI,ITI1,9,Toscana,Toscana,3729641,63873,1.71,0.3
854,2021-04-09,TOS,24607,10582,14025,20751,3410,446,ITI,ITI1,9,Toscana,Toscana,3729641,88480,2.37,0.66
855,2021-07-18,TOS,30363,15264,15099,8336,21819,208,ITI,ITI1,9,Toscana,Toscana,3729641,118843,3.19,0.81
856,2021-06-17,TOS,32557,16677,15880,26679,5546,332,ITI,ITI1,9,Toscana,Toscana,3729641,151400,4.06,0.87
857,2021-02-04,TOS,4254,1594,2660,934,3293,27,ITI,ITI1,9,Toscana,Toscana,3729641,155654,4.17,0.11
858,2021-01-28,TOS,6283,1883,4400,346,5930,7,ITI,ITI1,9,Toscana,Toscana,3729641,161937,4.34,0.17
859,2021-03-19,TOS,10142,4459,5683,7128,2867,147,ITI,ITI1,9,Toscana,Toscana,3729641,172079,4.61,0.27
860,2021-05-22,TOS,26025,12662,13363,21486,4290,249,ITI,ITI1,9,Toscana,Toscana,3729641,198104,5.31,0.7
861,2021-05-05,TOS,30127,13447,16680,14864,14528,735,ITI,ITI1,9,Toscana,Toscana,3729641,228231,6.12,0.81
862,2021-02-28,TOS,1649,667,982,852,727,70,ITI,ITI1,9,Toscana,Toscana,3729641,229880,6.16,0.04
863,2021-02-11,TOS,5384,2022,3362,5061,242,81,ITI,ITI1,9,Toscana,Toscana,3729641,235264,6.31,0.14
864,2021-02-09,TOS,4489,1469,3020,3764,611,114,ITI,ITI1,9,Toscana,Toscana,3729641,239753,6.43,0.12
865,2021-06-22,TOS,31027,15613,15414,22442,8211,374,ITI,ITI1,9,Toscana,Toscana,3729641,270780,7.26,0.83
866,2021-05-17,TOS,29766,14875,14891,20557,8933,276,ITI,ITI1,9,Toscana,Toscana,3729641,300546,8.06,0.8
867,2021-03-21,TOS,3295,1629,1666,1819,1433,43,ITI,ITI1,9,Toscana,Toscana,3729641,303841,8.15,0.09
868,2021-01-23,TOS,3966,1360,2606,634,3326,6,ITI,ITI1,9,Toscana,Toscana,3729641,307807,8.25,0.11
869,2021-06-29,TOS,37018,18025,18993,7984,28892,142,ITI,ITI1,9,Toscana,Toscana,3729641,344825,9.25,0.99
870,2021-05-03,TOS,11932,5510,6422,10363,1322,247,ITI,ITI1,9,Toscana,Toscana,3729641,356757,9.57,0.32
871,2021-04-07,TOS,35828,15466,20362,28160,7251,417,ITI,ITI1,9,Toscana,Toscana,3729641,392585,10.53,0.96
872,2021-06-12,TOS,29391,15152,14239,24657,4388,346,ITI,ITI1,9,Toscana,Toscana,3729641,421976,11.31,0.79
873,2021-04-16,TOS,28956,12884,16072,21417,6906,633,ITI,ITI1,9,Toscana,Toscana,3729641,450932,12.09,0.78
874,2021-07-30,TOS,37284,20062,17222,10487,26458,339,ITI,ITI1,9,Toscana,Toscana,3729641,488216,13.09,1.0
875,2021-07-13,TOS,29325,14729,14596,7711,21444,170,ITI,ITI1,9,Toscana,Toscana,3729641,517541,13.88,0.79
876,2021-04-02,TOS,31992,13572,18420,23707,8030,255,ITI,ITI1,9,Toscana,Toscana,3729641,549533,14.73,0.86
877,2021-07-11,TOS,26120,12687,13433,9131,16822,167,ITI,ITI1,9,Toscana,Toscana,3729641,575653,15.43,0.7
878,2021-06-24,TOS,29436,14613,14823,19305,9743,388,ITI,ITI1,9,Toscana,Toscana,3729641,605089,16.22,0.79
879,2021-01-16,TOS,3271,1046,2225,3213,0,58,ITI,ITI1,9,Toscana,Toscana,3729641,608360,16.31,0.09
880,2021-04-26,TOS,10146,4933,5213,7454,2556,136,ITI,ITI1,9,Toscana,Toscana,3729641,618506,16.58,0.27
881,2021-01-02,TOS,3498,1096,2402,3454,0,44,ITI,ITI1,9,Toscana,Toscana,3729641,622004,16.68,0.09
882,2021-06-05,TOS,28441,13600,14841,20562,7615,264,ITI,ITI1,9,Toscana,Toscana,3729641,650445,17.44,0.76
883,2021-01-11,TOS,5095,1691,3404,4996,0,99,ITI,ITI1,9,Toscana,Toscana,3729641,655540,17.58,0.14
884,2021-04-21,TOS,29626,12680,16946,16855,12132,639,ITI,ITI1,9,Toscana,Toscana,3729641,685166,18.37,0.79
885,2021-02-23,TOS,7723,3325,4398,7212,161,350,ITI,ITI1,9,Toscana,Toscana,3729641,692889,18.58,0.21
886,2021-06-03,TOS,32056,15455,16601,27151,4583,322,ITI,ITI1,9,Toscana,Toscana,3729641,724945,19.44,0.86
887,2021-03-28,TOS,6212,2808,3404,5875,254,83,ITI,ITI1,9,Toscana,Toscana,3729641,731157,19.6,0.17
888,2021-01-30,TOS,4623,1622,3001,179,4426,18,ITI,ITI1,9,Toscana,Toscana,3729641,735780,19.73,0.12
889,2021-07-06,TOS,25775,13028,12747,11038,14518,219,ITI,ITI1,9,Toscana,Toscana,3729641,761555,20.42,0.69
890,2021-05-10,TOS,26209,12401,13808,15234,10633,342,ITI,ITI1,9,Toscana,Toscana,3729641,787764,21.12,0.7
891,2021-03-14,TOS,7175,2569,4606,3148,3935,92,ITI,ITI1,9,Toscana,Toscana,3729641,794939,21.31,0.19
892,2021-05-15,TOS,29353,13856,15497,22865,5894,594,ITI,ITI1,9,Toscana,Toscana,3729641,824292,22.1,0.79
893,2021-04-28,TOS,19128,8182,10946,3460,15315,353,ITI,ITI1,9,Toscana,Toscana,3729641,843420,22.61,0.51
894,2021-02-18,TOS,8822,3285,5537,7742,896,184,ITI,ITI1,9,Toscana,Toscana,3729641,852242,22.85,0.24
895,2021-05-29,TOS,31570,15261,16309,23175,8168,227,ITI,ITI1,9,Toscana,Toscana,3729641,883812,23.7,0.85
896,2021-03-23,TOS,9435,4408,5027,6964,2276,195,ITI,ITI1,9,Toscana,Toscana,3729641,893247,23.95,0.25
897,2021-01-21,TOS,1589,686,903,858,722,9,ITI,ITI1,9,Toscana,Toscana,3729641,894836,23.99,0.04
898,2021-06-02,TOS,27595,13621,13974,21860,5507,228,ITI,ITI1,9,Toscana,Toscana,3729641,922431,24.73,0.74
899,2021-04-06,TOS,22228,9825,12403,18090,3720,418,ITI,ITI1,9,Toscana,Toscana,3729641,944659,25.33,0.6
900,2021-02-08,TOS,4099,1362,2737,3529,459,111,ITI,ITI1,9,Toscana,Toscana,3729641,948758,25.44,0.11
901,2021-07-15,TOS,31209,15274,15935,8079,22891,239,ITI,ITI1,9,Toscana,Toscana,3729641,979967,26.28,0.84
902,2021-05-19,TOS,27963,13581,14382,18644,9057,262,ITI,ITI1,9,Toscana,Toscana,3729641,1007930,27.02,0.75
903,2021-04-13,TOS,8489,3506,4983,5748,2458,283,ITI,ITI1,9,Toscana,Toscana,3729641,1016419,27.25,0.23
904,2021-06-10,TOS,26396,13541,12855,25510,545,341,ITI,ITI1,9,Toscana,Toscana,3729641,1042815,27.96,0.71
905,2021-05-24,TOS,33749,16720,17029,23887,9582,280,ITI,ITI1,9,Toscana,Toscana,3729641,1076564,28.87,0.9
906,2021-01-25,TOS,5127,1895,3232,242,4880,5,ITI,ITI1,9,Toscana,Toscana,3729641,1081691,29.0,0.14
907,2021-04-18,TOS,8360,4091,4269,7056,1029,275,ITI,ITI1,9,Toscana,Toscana,3729641,1090051,29.23,0.22
908,2021-07-25,TOS,33887,16763,17124,7061,26649,177,ITI,ITI1,9,Toscana,Toscana,3729641,1123938,30.14,0.91
909,2021-03-02,TOS,10599,3799,6800,7043,3444,112,ITI,ITI1,9,Toscana,Toscana,3729641,1134537,30.42,0.28
910,2021-01-04,TOS,5067,1896,3171,5002,0,65,ITI,ITI1,9,Toscana,Toscana,3729641,1139604,30.56,0.14
911,2021-04-14,TOS,20190,8350,11840,14531,5113,546,ITI,ITI1,9,Toscana,Toscana,3729641,1159794,31.1,0.54
912,2021-06-14,TOS,31798,16330,15468,27409,4108,281,ITI,ITI1,9,Toscana,Toscana,3729641,1191592,31.95,0.85
913,2021-01-09,TOS,4485,1596,2889,4419,0,66,ITI,ITI1,9,Toscana,Toscana,3729641,1196077,32.07,0.12
914,2021-03-18,TOS,9983,3986,5997,5869,3973,141,ITI,ITI1,9,Toscana,Toscana,3729641,1206060,32.34,0.27
915,2021-06-26,TOS,34542,16758,17784,9992,24324,226,ITI,ITI1,9,Toscana,Toscana,3729641,1240602,33.26,0.93
916,2021-02-16,TOS,9281,3340,5941,8329,721,231,ITI,ITI1,9,Toscana,Toscana,3729641,1249883,33.51,0.25
917,2021-05-02,TOS,11177,4934,6243,8978,1965,234,ITI,ITI1,9,Toscana,Toscana,3729641,1261060,33.81,0.3
918,2021-02-25,TOS,10633,4306,6327,9465,998,170,ITI,ITI1,9,Toscana,Toscana,3729641,1271693,34.1,0.29
919,2021-03-07,TOS,5648,2357,3291,1992,3545,111,ITI,ITI1,9,Toscana,Toscana,3729641,1277341,34.25,0.15
920,2021-07-20,TOS,37264,19065,18199,7959,29118,187,ITI,ITI1,9,Toscana,Toscana,3729641,1314605,35.25,1.0
921,2021-02-06,TOS,4528,1550,2978,1262,3234,32,ITI,ITI1,9,Toscana,Toscana,3729641,1319133,35.37,0.12
922,2020-12-30,TOS,332,109,223,331,0,1,ITI,ITI1,9,Toscana,Toscana,3729641,1319465,35.38,0.01
923,2021-05-12,TOS,34206,15577,18629,13582,20038,586,ITI,ITI1,9,Toscana,Toscana,3729641,1353671,36.29,0.92
924,2021-01-18,TOS,1120,637,483,972,98,50,ITI,ITI1,9,Toscana,Toscana,3729641,1354791,36.32,0.03
925,2021-02-01,TOS,5509,1958,3551,511,4988,10,ITI,ITI1,9,Toscana,Toscana,3729641,1360300,36.47,0.15
926,2021-07-27,TOS,38611,20086,18525,11278,27004,329,ITI,ITI1,9,Toscana,Toscana,3729641,1398911,37.51,1.04
927,2021-07-10,TOS,29294,14177,15117,7956,21156,182,ITI,ITI1,9,Toscana,Toscana,3729641,1428205,38.29,0.79
928,2021-05-07,TOS,32149,14707,17442,11361,20179,609,ITI,ITI1,9,Toscana,Toscana,3729641,1460354,39.16,0.86
929,2021-07-29,TOS,39238,20455,18783,12592,26310,336,ITI,ITI1,9,Toscana,Toscana,3729641,1499592,40.21,1.05
930,2021-02-13,TOS,7786,2361,5425,7411,227,148,ITI,ITI1,9,Toscana,Toscana,3729641,1507378,40.42,0.21
931,2021-01-08,TOS,5947,1643,4304,5854,0,93,ITI,ITI1,9,Toscana,Toscana,3729641,1513325,40.58,0.16
932,2021-07-12,TOS,28262,13992,14270,9668,18300,294,ITI,ITI1,9,Toscana,Toscana,3729641,1541587,41.33,0.76
933,2021-04-01,TOS,27078,11240,15838,16161,10676,241,ITI,ITI1,9,Toscana,Toscana,3729641,1568665,42.06,0.73
934,2021-03-15,TOS,8701,3649,5052,4085,4444,172,ITI,ITI1,9,Toscana,Toscana,3729641,1577366,42.29,0.23
935,2021-06-23,TOS,31525,15279,16246,19796,11378,351,ITI,ITI1,9,Toscana,Toscana,3729641,1608891,43.14,0.85
936,2021-01-10,TOS,3002,1105,1897,2947,0,55,ITI,ITI1,9,Toscana,Toscana,3729641,1611893,43.22,0.08
937,2021-04-20,TOS,18153,8107,10046,12212,5577,364,ITI,ITI1,9,Toscana,Toscana,3729641,1630046,43.71,0.49
938,2021-04-03,TOS,15016,6646,8370,13674,1126,216,ITI,ITI1,9,Toscana,Toscana,3729641,1645062,44.11,0.4
939,2021-01-27,TOS,4835,1573,3262,201,4629,5,ITI,ITI1,9,Toscana,Toscana,3729641,1649897,44.24,0.13
940,2021-06-09,TOS,34831,17574,17257,33952,463,416,ITI,ITI1,9,Toscana,Toscana,3729641,1684728,45.17,0.93
941,2021-04-04,TOS,13926,6611,7315,13507,254,165,ITI,ITI1,9,Toscana,Toscana,3729641,1698654,45.54,0.37
942,2021-03-16,TOS,4901,1884,3017,2567,2253,81,ITI,ITI1,9,Toscana,Toscana,3729641,1703555,45.68,0.13
943,2021-02-27,TOS,1984,756,1228,1007,902,75,ITI,ITI1,9,Toscana,Toscana,3729641,1705539,45.73,0.05
944,2021-07-22,TOS,39270,19734,19536,4479,34627,164,ITI,ITI1,9,Toscana,Toscana,3729641,1744809,46.78,1.05
945,2021-05-26,TOS,35602,17106,18496,20137,15209,256,ITI,ITI1,9,Toscana,Toscana,3729641,1780411,47.74,0.95
946,2021-03-30,TOS,17033,7646,9387,13266,3569,198,ITI,ITI1,9,Toscana,Toscana,3729641,1797444,48.19,0.46
947,2021-07-08,TOS,21055,10346,10709,9252,11563,240,ITI,ITI1,9,Toscana,Toscana,3729641,1818499,48.76,0.56
948,2021-07-17,TOS,27737,14331,13406,8964,18536,237,ITI,ITI1,9,Toscana,Toscana,3729641,1846236,49.5,0.74
949,2021-06-11,TOS,29749,15490,14259,24737,4657,355,ITI,ITI1,9,Toscana,Toscana,3729641,1875985,50.3,0.8
950,2021-04-15,TOS,24409,10199,14210,15299,8580,530,ITI,ITI1,9,Toscana,Toscana,3729641,1900394,50.95,0.65
951,2021-02-17,TOS,8176,3170,5006,7303,752,121,ITI,ITI1,9,Toscana,Toscana,3729641,1908570,51.17,0.22
952,2021-07-24,TOS,38411,19350,19061,6851,31335,225,ITI,ITI1,9,Toscana,Toscana,3729641,1946981,52.2,1.03
953,2021-05-28,TOS,30129,13949,16180,17425,12477,227,ITI,ITI1,9,Toscana,Toscana,3729641,1977110,53.01,0.81
954,2021-04-22,TOS,35708,15297,20411,17386,17493,829,ITI,ITI1,9,Toscana,Toscana,3729641,2012818,53.97,0.96
955,2021-02-24,TOS,10371,4467,5904,10035,197,139,ITI,ITI1,9,Toscana,Toscana,3729641,2023189,54.25,0.28
956,2021-06-04,TOS,28323,13438,14885,20262,7799,262,ITI,ITI1,9,Toscana,Toscana,3729641,2051512,55.01,0.76
957,2021-04-08,TOS,29694,12561,17133,22941,6387,366,ITI,ITI1,9,Toscana,Toscana,3729641,2081206,55.8,0.8
958,2021-06-28,TOS,37676,18128,19548,8437,29074,165,ITI,ITI1,9,Toscana,Toscana,3729641,2118882,56.81,1.01
959,2021-01-20,TOS,1332,638,694,1021,248,63,ITI,ITI1,9,Toscana,Toscana,3729641,2120214,56.85,0.04
960,2021-04-30,TOS,40212,17797,22415,19662,19905,645,ITI,ITI1,9,Toscana,Toscana,3729641,2160426,57.93,1.08
961,2021-04-25,TOS,11061,5250,5811,8757,2143,161,ITI,ITI1,9,Toscana,Toscana,3729641,2171487,58.22,0.3
962,2021-01-13,TOS,4062,1398,2664,3998,0,64,ITI,ITI1,9,Toscana,Toscana,3729641,2175549,58.33,0.11
963,2021-04-23,TOS,25662,11425,14237,8810,16321,531,ITI,ITI1,9,Toscana,Toscana,3729641,2201211,59.02,0.69
964,2021-03-20,TOS,6588,2978,3610,5362,1136,90,ITI,ITI1,9,Toscana,Toscana,3729641,2207799,59.2,0.18
965,2021-01-22,TOS,2866,1064,1802,525,2338,3,ITI,ITI1,9,Toscana,Toscana,3729641,2210665,59.27,0.08
966,2021-02-20,TOS,4642,1790,2852,3993,515,134,ITI,ITI1,9,Toscana,Toscana,3729641,2215307,59.4,0.12
967,2021-05-31,TOS,30330,14637,15693,19261,10828,241,ITI,ITI1,9,Toscana,Toscana,3729641,2245637,60.21,0.81
968,2021-05-14,TOS,33368,15440,17928,20022,12708,638,ITI,ITI1,9,Toscana,Toscana,3729641,2279005,61.11,0.89
969,2021-03-17,TOS,11423,4588,6835,6800,4529,94,ITI,ITI1,9,Toscana,Toscana,3729641,2290428,61.41,0.31
970,2021-06-25,TOS,33626,16810,16816,12111,21240,275,ITI,ITI1,9,Toscana,Toscana,3729641,2324054,62.31,0.9
971,2021-06-08,TOS,32596,16720,15876,31750,489,357,ITI,ITI1,9,Toscana,Toscana,3729641,2356650,63.19,0.87
972,2021-02-26,TOS,10082,3835,6247,8658,1206,218,ITI,ITI1,9,Toscana,Toscana,3729641,2366732,63.46,0.27
973,2021-06-06,TOS,28312,13657,14655,22588,5365,359,ITI,ITI1,9,Toscana,Toscana,3729641,2395044,64.22,0.76
974,2021-07-07,TOS,25634,12604,13030,9339,16111,184,ITI,ITI1,9,Toscana,Toscana,3729641,2420678,64.9,0.69
975,2021-03-27,TOS,8865,4155,4710,8512,215,138,ITI,ITI1,9,Toscana,Toscana,3729641,2429543,65.14,0.24
976,2021-06-30,TOS,38254,18506,19748,8454,29587,213,ITI,ITI1,9,Toscana,Toscana,3729641,2467797,66.17,1.03
977,2021-02-14,TOS,9000,2569,6431,8737,110,153,ITI,ITI1,9,Toscana,Toscana,3729641,2476797,66.41,0.24
978,2021-01-01,TOS,2370,788,1582,2325,0,45,ITI,ITI1,9,Toscana,Toscana,3729641,2479167,66.47,0.06
979,2021-04-11,TOS,3646,1681,1965,3336,155,155,ITI,ITI1,9,Toscana,Toscana,3729641,2482813,66.57,0.1
980,2021-07-03,TOS,29393,14811,14582,11859,17160,374,ITI,ITI1,9,Toscana,Toscana,3729641,2512206,67.36,0.79
981,2021-03-06,TOS,7110,2852,4258,2829,4196,85,ITI,ITI1,9,Toscana,Toscana,3729641,2519316,67.55,0.19
982,2021-02-03,TOS,4222,1452,2770,237,3981,4,ITI,ITI1,9,Toscana,Toscana,3729641,2523538,67.66,0.11
983,2020-12-27,TOS,620,267,353,615,0,5,ITI,ITI1,9,Toscana,Toscana,3729641,2524158,67.68,0.02
984,2021-01-03,TOS,3336,1052,2284,3290,0,46,ITI,ITI1,9,Toscana,Toscana,3729641,2527494,67.77,0.09
985,2021-02-15,TOS,8770,3376,5394,7771,826,173,ITI,ITI1,9,Toscana,Toscana,3729641,2536264,68.0,0.24
986,2021-04-27,TOS,10358,4919,5439,3663,6491,204,ITI,ITI1,9,Toscana,Toscana,3729641,2546622,68.28,0.28
987,2021-07-19,TOS,37998,18939,19059,8840,28894,264,ITI,ITI1,9,Toscana,Toscana,3729641,2584620,69.3,1.02
988,2021-06-07,TOS,34949,17144,17805,30971,3647,331,ITI,ITI1,9,Toscana,Toscana,3729641,2619569,70.24,0.94
989,2021-05-21,TOS,28925,13480,15445,17223,11447,255,ITI,ITI1,9,Toscana,Toscana,3729641,2648494,71.01,0.78
990,2021-03-01,TOS,4474,1734,2740,767,3641,66,ITI,ITI1,9,Toscana,Toscana,3729641,2652968,71.13,0.12
991,2021-05-23,TOS,28421,13663,14758,25592,2560,269,ITI,ITI1,9,Toscana,Toscana,3729641,2681389,71.89,0.76
992,2021-07-26,TOS,38189,19816,18373,10087,27801,301,ITI,ITI1,9,Toscana,Toscana,3729641,2719578,72.92,1.02
993,2021-02-10,TOS,4264,1282,2982,3585,523,156,ITI,ITI1,9,Toscana,Toscana,3729641,2723842,73.03,0.11
994,2021-05-04,TOS,18316,8215,10101,12416,5455,445,ITI,ITI1,9,Toscana,Toscana,3729641,2742158,73.52,0.49
995,2021-05-25,TOS,34186,16503,17683,19281,14632,273,ITI,ITI1,9,Toscana,Toscana,3729641,2776344,74.44,0.92
996,2021-03-29,TOS,9701,4852,4849,9219,348,134,ITI,ITI1,9,Toscana,Toscana,3729641,2786045,74.7,0.26
997,2021-03-03,TOS,18229,6540,11689,14496,3606,127,ITI,ITI1,9,Toscana,Toscana,3729641,2804274,75.19,0.49
998,2021-01-05,TOS,5249,1755,3494,5193,0,56,ITI,ITI1,9,Toscana,Toscana,3729641,2809523,75.33,0.14
999,2021-01-19,TOS,1106,533,573,1064,0,42,ITI,ITI1,9,Toscana,Toscana,3729641,2810629,75.36,0.03
1000,2021-01-15,TOS,3879,1348,2531,3819,0,60,ITI,ITI1,9,Toscana,Toscana,3729641,2814508,75.46,0.1
1001,2021-06-18,TOS,30791,16250,14541,24994,5401,396,ITI,ITI1,9,Toscana,Toscana,3729641,2845299,76.29,0.83
1002,2021-03-25,TOS,23912,10383,13529,15300,8356,256,ITI,ITI1,9,Toscana,Toscana,3729641,2869211,76.93,0.64
1003,2021-04-12,TOS,2623,1191,1432,1799,655,169,ITI,ITI1,9,Toscana,Toscana,3729641,2871834,77.0,0.07
1004,2021-07-21,TOS,38433,19604,18829,7313,30889,231,ITI,ITI1,9,Toscana,Toscana,3729641,2910267,78.03,1.03
1005,2021-01-12,TOS,3581,1398,2183,3508,0,73,ITI,ITI1,9,Toscana,Toscana,3729641,2913848,78.13,0.1
1006,2021-02-12,TOS,7618,2694,4924,7292,213,113,ITI,ITI1,9,Toscana,Toscana,3729641,2921466,78.33,0.2
1007,2021-07-28,TOS,38457,20111,18346,12099,26028,330,ITI,ITI1,9,Toscana,Toscana,3729641,2959923,79.36,1.03
1008,2021-01-26,TOS,5393,1792,3601,216,5173,4,ITI,ITI1,9,Toscana,Toscana,3729641,2965316,79.51,0.14
1009,2021-05-06,TOS,31360,13641,17719,13469,17202,689,ITI,ITI1,9,Toscana,Toscana,3729641,2996676,80.35,0.84
1010,2021-04-19,TOS,9099,4512,4587,7750,1032,317,ITI,ITI1,9,Toscana,Toscana,3729641,3005775,80.59,0.24
1011,2021-04-17,TOS,20541,9209,11332,17914,2139,488,ITI,ITI1,9,Toscana,Toscana,3729641,3026316,81.14,0.55
1012,2021-01-24,TOS,3350,1073,2277,198,3149,3,ITI,ITI1,9,Toscana,Toscana,3729641,3029666,81.23,0.09
1013,2021-01-07,TOS,6018,1751,4267,5932,0,86,ITI,ITI1,9,Toscana,Toscana,3729641,3035684,81.39,0.16
1014,2021-01-17,TOS,2536,871,1665,1987,514,35,ITI,ITI1,9,Toscana,Toscana,3729641,3038220,81.46,0.07
1015,2021-07-05,TOS,30510,15079,15431,10341,19941,228,ITI,ITI1,9,Toscana,Toscana,3729641,3068730,82.28,0.82
1016,2021-03-08,TOS,6710,2948,3762,1844,4821,45,ITI,ITI1,9,Toscana,Toscana,3729641,3075440,82.46,0.18
1017,2021-06-16,TOS,31762,16261,15501,26267,5179,316,ITI,ITI1,9,Toscana,Toscana,3729641,3107202,83.31,0.85
1018,2021-05-30,TOS,28693,13951,14742,21502,6949,242,ITI,ITI1,9,Toscana,Toscana,3729641,3135895,84.08,0.77
1019,2021-05-27,TOS,28358,13200,15158,13273,14863,222,ITI,ITI1,9,Toscana,Toscana,3729641,3164253,84.84,0.76
1020,2021-03-31,TOS,32723,13261,19462,20212,12172,339,ITI,ITI1,9,Toscana,Toscana,3729641,3196976,85.72,0.88
1021,2021-07-09,TOS,29113,14100,15013,7693,21228,192,ITI,ITI1,9,Toscana,Toscana,3729641,3226089,86.5,0.78
1022,2021-03-22,TOS,5255,2767,2488,4675,446,134,ITI,ITI1,9,Toscana,Toscana,3729641,3231344,86.64,0.14
1023,2021-02-22,TOS,9819,4254,5565,9166,277,376,ITI,ITI1,9,Toscana,Toscana,3729641,3241163,86.9,0.26
1024,2021-05-08,TOS,29154,13113,16041,13278,15476,400,ITI,ITI1,9,Toscana,Toscana,3729641,3270317,87.68,0.78
1025,2021-03-12,TOS,16981,6619,10362,13266,3527,188,ITI,ITI1,9,Toscana,Toscana,3729641,3287298,88.14,0.46
1026,2021-01-14,TOS,3255,1179,2076,3219,0,36,ITI,ITI1,9,Toscana,Toscana,3729641,3290553,88.23,0.09
1027,2021-06-20,TOS,25175,12485,12690,15420,9517,238,ITI,ITI1,9,Toscana,Toscana,3729641,3315728,88.9,0.67
1028,2021-04-24,TOS,13436,6168,7268,5619,7448,369,ITI,ITI1,9,Toscana,Toscana,3729641,3329164,89.26,0.36
1029,2021-06-27,TOS,33300,16075,17225,5921,27251,128,ITI,ITI1,9,Toscana,Toscana,3729641,3362464,90.16,0.89
1030,2021-05-01,TOS,23332,10070,13262,13741,9206,385,ITI,ITI1,9,Toscana,Toscana,3729641,3385796,90.78,0.63
1031,2021-03-05,TOS,16878,6689,10189,11943,4755,180,ITI,ITI1,9,Toscana,Toscana,3729641,3402674,91.23,0.45
1032,2021-06-13,TOS,24616,12353,12263,22609,1659,348,ITI,ITI1,9,Toscana,Toscana,3729641,3427290,91.89,0.66
1033,2021-05-13,TOS,35128,15526,19602,13203,21286,639,ITI,ITI1,9,Toscana,Toscana,3729641,3462418,92.84,0.94
1034,2021-04-29,TOS,39325,17718,21607,18571,20098,656,ITI,ITI1,9,Toscana,Toscana,3729641,3501743,93.89,1.05
1035,2021-03-24,TOS,20023,8308,11715,10420,9460,143,ITI,ITI1,9,Toscana,Toscana,3729641,3521766,94.43,0.54
1036,2021-02-21,TOS,5105,2089,3016,4731,170,204,ITI,ITI1,9,Toscana,Toscana,3729641,3526871,94.56,0.14
1037,2021-06-01,TOS,26950,13395,13555,22871,3834,245,ITI,ITI1,9,Toscana,Toscana,3729641,3553821,95.29,0.72
1038,2021-07-04,TOS,31513,15297,16216,9367,21859,287,ITI,ITI1,9,Toscana,Toscana,3729641,3585334,96.13,0.84
1039,2020-12-31,TOS,802,201,601,798,0,4,ITI,ITI1,9,Toscana,Toscana,3729641,3586136,96.15,0.02
1040,2021-04-10,TOS,11738,5359,6379,10757,743,238,ITI,ITI1,9,Toscana,Toscana,3729641,3597874,96.47,0.31
1041,2021-07-02,TOS,28290,14189,14101,10820,17190,280,ITI,ITI1,9,Toscana,Toscana,3729641,3626164,97.23,0.76
1042,2021-06-15,TOS,31206,16063,15143,26301,4572,333,ITI,ITI1,9,Toscana,Toscana,3729641,3657370,98.06,0.84
1043,2021-03-10,TOS,18381,7415,10966,14256,4018,107,ITI,ITI1,9,Toscana,Toscana,3729641,3675751,98.56,0.49
1044,2021-02-02,TOS,3742,1475,2267,189,3546,7,ITI,ITI1,9,Toscana,Toscana,3729641,3679493,98.66,0.1
1045,2021-02-19,TOS,8292,2952,5340,7599,513,180,ITI,ITI1,9,Toscana,Toscana,3729641,3687785,98.88,0.22
1046,2021-03-04,TOS,17849,6952,10897,14612,3082,155,ITI,ITI1,9,Toscana,Toscana,3729641,3705634,99.36,0.48
1047,2021-06-21,TOS,31184,15481,15703,18137,12791,256,ITI,ITI1,9,Toscana,Toscana,3729641,3736818,100.19,0.84
1048,2021-01-06,TOS,4519,1460,3059,4467,0,52,ITI,ITI1,9,Toscana,Toscana,3729641,3741337,100.31,0.12
1049,2021-03-11,TOS,15906,6355,9551,12395,3332,179,ITI,ITI1,9,Toscana,Toscana,3729641,3757243,100.74,0.43
1050,2021-06-19,TOS,26495,13913,12582,21383,4784,328,ITI,ITI1,9,Toscana,Toscana,3729641,3783738,101.45,0.71
1051,2021-02-05,TOS,5750,2245,3505,1890,3826,34,ITI,ITI1,9,Toscana,Toscana,3729641,3789488,101.6,0.15
1052,2021-05-16,TOS,26680,12889,13791,23917,2467,296,ITI,ITI1,9,Toscana,Toscana,3729641,3816168,102.32,0.72
1053,2021-05-11,TOS,27949,12985,14964,12101,15471,377,ITI,ITI1,9,Toscana,Toscana,3729641,3844117,103.07,0.75
1054,2021-03-13,TOS,9288,3310,5978,5170,3964,154,ITI,ITI1,9,Toscana,Toscana,3729641,3853405,103.32,0.25
1055,2021-07-14,TOS,28822,14237,14585,8580,19995,247,ITI,ITI1,9,Toscana,Toscana,3729641,3882227,104.09,0.77
1056,2021-01-29,TOS,6144,1700,4444,292,5840,12,ITI,ITI1,9,Toscana,Toscana,3729641,3888371,104.26,0.16
1057,2021-05-09,TOS,22536,9770,12766,9414,12861,261,ITI,ITI1,9,Toscana,Toscana,3729641,3910907,104.86,0.6
1058,2021-07-16,TOS,27651,14033,13618,7706,19702,243,ITI,ITI1,9,Toscana,Toscana,3729641,3938558,105.6,0.74
1059,2021-05-20,TOS,29770,13917,15853,18640,10847,283,ITI,ITI1,9,Toscana,Toscana,3729641,3968328,106.4,0.8
1060,2021-01-31,TOS,3051,1130,1921,103,2945,3,ITI,ITI1,9,Toscana,Toscana,3729641,3971379,106.48,0.08
1061,2021-04-05,TOS,15286,6826,8460,14369,737,180,ITI,ITI1,9,Toscana,Toscana,3729641,3986665,106.89,0.41
1062,2021-02-07,TOS,2808,954,1854,867,1921,20,ITI,ITI1,9,Toscana,Toscana,3729641,3989473,106.97,0.08
1063,2021-07-23,TOS,38411,19279,19132,4397,33863,151,ITI,ITI1,9,Toscana,Toscana,3729641,4027884,108.0,1.03
1064,2021-05-18,TOS,28838,14275,14563,19759,8826,253,ITI,ITI1,9,Toscana,Toscana,3729641,4056722,108.77,0.77
1065,2021-01-27,VDA,152,72,80,79,73,0,ITC,ITC2,2,Valle d'Aosta / Vallée d'Aoste,Valle d'Aosta,125666,152,0.12,0.12
1066,2021-04-20,VDA,933,430,503,707,194,32,ITC,ITC2,2,Valle d'Aosta / Vallée d'Aoste,Valle d'Aosta,125666,1085,0.86,0.74
1067,2021-01-10,VDA,220,71,149,208,0,12,ITC,ITC2,2,Valle d'Aosta / Vallée d'Aoste,Valle d'Aosta,125666,1305,1.04,0.18
1068,2020-12-27,VDA,20,9,11,20,0,0,ITC,ITC2,2,Valle d'Aosta / Vallée d'Aoste,Valle d'Aosta,125666,1325,1.05,0.02
1069,2021-03-08,VDA,486,233,253,238,245,3,ITC,ITC2,2,Valle d'Aosta / Vallée d'Aoste,Valle d'Aosta,125666,1811,1.44,0.39
1070,2021-05-04,VDA,1135,510,625,434,673,28,ITC,ITC2,2,Valle d'Aosta / Vallée d'Aoste,Valle d'Aosta,125666,2946,2.34,0.9
1071,2021-06-16,VDA,704,374,330,639,61,4,ITC,ITC2,2,Valle d'Aosta / Vallée d'Aoste,Valle d'Aosta,125666,3650,2.9,0.56
1072,2021-03-15,VDA,362,123,239,150,203,9,ITC,ITC2,2,Valle d'Aosta / Vallée d'Aoste,Valle d'Aosta,125666,4012,3.19,0.29
1073,2021-05-11,VDA,647,325,322,468,151,28,ITC,ITC2,2,Valle d'Aosta / Vallée d'Aoste,Valle d'Aosta,125666,4659,3.71,0.51
1074,2021-04-27,VDA,978,423,555,650,292,36,ITC,ITC2,2,Valle d'Aosta / Vallée d'Aoste,Valle d'Aosta,125666,5637,4.49,0.78
1075,2021-01-17,VDA,131,56,75,131,0,0,ITC,ITC2,2,Valle d'Aosta / Vallée d'Aoste,Valle d'Aosta,125666,5768,4.59,0.1
1076,2021-06-23,VDA,1043,551,492,423,616,4,ITC,ITC2,2,Valle d'Aosta / Vallée d'Aoste,Valle d'Aosta,125666,6811,5.42,0.83
1077,2021-02-05,VDA,295,102,193,102,193,0,ITC,ITC2,2,Valle d'Aosta / Vallée d'Aoste,Valle d'Aosta,125666,7106,5.65,0.23
1078,2021-02-22,VDA,316,94,222,210,103,3,ITC,ITC2,2,Valle d'Aosta / Vallée d'Aoste,Valle d'Aosta,125666,7422,5.91,0.25
1079,2021-05-16,VDA,689,341,348,340,341,8,ITC,ITC2,2,Valle d'Aosta / Vallée d'Aoste,Valle d'Aosta,125666,8111,6.45,0.55
1080,2021-05-02,VDA,765,345,420,581,160,24,ITC,ITC2,2,Valle d'Aosta / Vallée d'Aoste,Valle d'Aosta,125666,8876,7.06,0.61
1081,2021-01-22,VDA,56,21,35,20,36,0,ITC,ITC2,2,Valle d'Aosta / Vallée d'Aoste,Valle d'Aosta,125666,8932,7.11,0.04
1082,2021-01-08,VDA,300,131,169,300,0,0,ITC,ITC2,2,Valle d'Aosta / Vallée d'Aoste,Valle d'Aosta,125666,9232,7.35,0.24
1083,2021-03-06,VDA,22,4,18,18,0,4,ITC,ITC2,2,Valle d'Aosta / Vallée d'Aoste,Valle d'Aosta,125666,9254,7.36,0.02
1084,2021-02-03,VDA,351,114,237,14,337,0,ITC,ITC2,2,Valle d'Aosta / Vallée d'Aoste,Valle d'Aosta,125666,9605,7.64,0.28
1085,2021-04-01,VDA,778,394,384,747,12,19,ITC,ITC2,2,Valle d'Aosta / Vallée d'Aoste,Valle d'Aosta,125666,10383,8.26,0.62
1086,2021-07-19,VDA,878,460,418,259,619,0,ITC,ITC2,2,Valle d'Aosta / Vallée d'Aoste,Valle d'Aosta,125666,11261,8.96,0.7
1087,2021-04-15,VDA,811,377,434,639,139,33,ITC,ITC2,2,Valle d'Aosta / Vallée d'Aoste,Valle d'Aosta,125666,12072,9.61,0.65
1088,2021-07-07,VDA,792,439,353,413,362,17,ITC,ITC2,2,Valle d'Aosta / Vallée d'Aoste,Valle d'Aosta,125666,12864,10.24,0.63
1089,2021-07-24,VDA,1016,534,482,335,681,0,ITC,ITC2,2,Valle d'Aosta / Vallée d'Aoste,Valle d'Aosta,125666,13880,11.05,0.81
1090,2021-07-12,VDA,978,483,495,239,731,8,ITC,ITC2,2,Valle d'Aosta / Vallée d'Aoste,Valle d'Aosta,125666,14858,11.82,0.78
1091,2021-04-03,VDA,676,341,335,649,15,12,ITC,ITC2,2,Valle d'Aosta / Vallée d'Aoste,Valle d'Aosta,125666,15534,12.36,0.54
1092,2021-03-20,VDA,208,86,122,167,36,5,ITC,ITC2,2,Valle d'Aosta / Vallée d'Aoste,Valle d'Aosta,125666,15742,12.53,0.17
1093,2021-06-28,VDA,986,496,490,326,657,3,ITC,ITC2,2,Valle d'Aosta / Vallée d'Aoste,Valle d'Aosta,125666,16728,13.31,0.78
1094,2021-06-11,VDA,1047,483,564,756,283,8,ITC,ITC2,2,Valle d'Aosta / Vallée d'Aoste,Valle d'Aosta,125666,17775,14.14,0.83
1095,2021-05-23,VDA,999,465,534,653,340,6,ITC,ITC2,2,Valle d'Aosta / Vallée d'Aoste,Valle d'Aosta,125666,18774,14.94,0.79
1096,2021-05-30,VDA,865,429,436,682,171,12,ITC,ITC2,2,Valle d'Aosta / Vallée d'Aoste,Valle d'Aosta,125666,19639,15.63,0.69
1097,2021-07-26,VDA,1004,512,492,319,685,0,ITC,ITC2,2,Valle d'Aosta / Vallée d'Aoste,Valle d'Aosta,125666,20643,16.43,0.8
1098,2021-05-28,VDA,975,414,561,544,412,19,ITC,ITC2,2,Valle d'Aosta / Vallée d'Aoste,Valle d'Aosta,125666,21618,17.2,0.78
1099,2021-02-17,VDA,327,144,183,223,100,4,ITC,ITC2,2,Valle d'Aosta / Vallée d'Aoste,Valle d'Aosta,125666,21945,17.46,0.26
1100,2021-03-13,VDA,147,88,59,141,0,6,ITC,ITC2,2,Valle d'Aosta / Vallée d'Aoste,Valle d'Aosta,125666,22092,17.58,0.12
1101,2021-01-15,VDA,218,82,136,218,0,0,ITC,ITC2,2,Valle d'Aosta / Vallée d'Aoste,Valle d'Aosta,125666,22310,17.75,0.17
1102,2021-06-09,VDA,1028,536,492,985,35,8,ITC,ITC2,2,Valle d'Aosta / Vallée d'Aoste,Valle d'Aosta,125666,23338,18.57,0.82
1103,2021-03-01,VDA,181,66,115,139,34,8,ITC,ITC2,2,Valle d'Aosta / Vallée d'Aoste,Valle d'Aosta,125666,23519,18.72,0.14
1104,2021-02-15,VDA,264,136,128,225,35,4,ITC,ITC2,2,Valle d'Aosta / Vallée d'Aoste,Valle d'Aosta,125666,23783,18.93,0.21
1105,2021-06-30,VDA,1117,542,575,415,692,10,ITC,ITC2,2,Valle d'Aosta / Vallée d'Aoste,Valle d'Aosta,125666,24900,19.81,0.89
1106,2021-06-04,VDA,908,383,525,470,433,5,ITC,ITC2,2,Valle d'Aosta / Vallée d'Aoste,Valle d'Aosta,125666,25808,20.54,0.72
1107,2021-07-23,VDA,970,484,486,365,605,0,ITC,ITC2,2,Valle d'Aosta / Vallée d'Aoste,Valle d'Aosta,125666,26778,21.31,0.77
1108,2021-02-24,VDA,183,82,101,162,19,2,ITC,ITC2,2,Valle d'Aosta / Vallée d'Aoste,Valle d'Aosta,125666,26961,21.45,0.15
1109,2021-04-08,VDA,584,282,302,419,143,22,ITC,ITC2,2,Valle d'Aosta / Vallée d'Aoste,Valle d'Aosta,125666,27545,21.92,0.46
1110,2021-06-13,VDA,852,400,452,371,478,3,ITC,ITC2,2,Valle d'Aosta / Vallée d'Aoste,Valle d'Aosta,125666,28397,22.6,0.68
1111,2021-04-13,VDA,373,171,202,311,44,18,ITC,ITC2,2,Valle d'Aosta / Vallée d'Aoste,Valle d'Aosta,125666,28770,22.89,0.3
1112,2021-07-05,VDA,834,355,479,312,508,14,ITC,ITC2,2,Valle d'Aosta / Vallée d'Aoste,Valle d'Aosta,125666,29604,23.56,0.66
1113,2021-03-27,VDA,333,164,169,289,31,13,ITC,ITC2,2,Valle d'Aosta / Vallée d'Aoste,Valle d'Aosta,125666,29937,23.82,0.26
1114,2021-06-18,VDA,998,443,555,589,399,10,ITC,ITC2,2,Valle d'Aosta / Vallée d'Aoste,Valle d'Aosta,125666,30935,24.62,0.79
1115,2021-02-10,VDA,248,77,171,141,107,0,ITC,ITC2,2,Valle d'Aosta / Vallée d'Aoste,Valle d'Aosta,125666,31183,24.81,0.2
1116,2021-03-25,VDA,389,154,235,364,10,15,ITC,ITC2,2,Valle d'Aosta / Vallée d'Aoste,Valle d'Aosta,125666,31572,25.12,0.31
1117,2021-05-21,VDA,919,434,485,515,388,16,ITC,ITC2,2,Valle d'Aosta / Vallée d'Aoste,Valle d'Aosta,125666,32491,25.86,0.73
1118,2021-04-17,VDA,638,407,231,593,2,43,ITC,ITC2,2,Valle d'Aosta / Vallée d'Aoste,Valle d'Aosta,125666,33129,26.36,0.51
1119,2021-01-07,VDA,276,111,165,276,0,0,ITC,ITC2,2,Valle d'Aosta / Vallée d'Aoste,Valle d'Aosta,125666,33405,26.58,0.22
1120,2021-02-19,VDA,292,102,190,266,24,2,ITC,ITC2,2,Valle d'Aosta / Vallée d'Aoste,Valle d'Aosta,125666,33697,26.81,0.23
1121,2021-01-29,VDA,320,139,181,2,318,0,ITC,ITC2,2,Valle d'Aosta / Vallée d'Aoste,Valle d'Aosta,125666,34017,27.07,0.25
1122,2021-04-22,VDA,1068,450,618,652,383,33,ITC,ITC2,2,Valle d'Aosta / Vallée d'Aoste,Valle d'Aosta,125666,35085,27.92,0.85
1123,2021-05-09,VDA,574,287,287,425,130,19,ITC,ITC2,2,Valle d'Aosta / Vallée d'Aoste,Valle d'Aosta,125666,35659,28.38,0.46
1124,2021-03-17,VDA,433,185,248,259,160,14,ITC,ITC2,2,Valle d'Aosta / Vallée d'Aoste,Valle d'Aosta,125666,36092,28.72,0.34
1125,2021-03-03,VDA,256,118,138,182,69,5,ITC,ITC2,2,Valle d'Aosta / Vallée d'Aoste,Valle d'Aosta,125666,36348,28.92,0.2
1126,2021-03-31,VDA,555,302,253,511,26,18,ITC,ITC2,2,Valle d'Aosta / Vallée d'Aoste,Valle d'Aosta,125666,36903,29.37,0.44
1127,2021-05-27,VDA,1089,497,592,574,503,12,ITC,ITC2,2,Valle d'Aosta / Vallée d'Aoste,Valle d'Aosta,125666,37992,30.23,0.87
1128,2021-05-13,VDA,1141,557,584,516,600,25,ITC,ITC2,2,Valle d'Aosta / Vallée d'Aoste,Valle d'Aosta,125666,39133,31.14,0.91
1129,2021-02-02,VDA,274,70,204,2,272,0,ITC,ITC2,2,Valle d'Aosta / Vallée d'Aoste,Valle d'Aosta,125666,39407,31.36,0.22
1130,2021-07-09,VDA,945,446,499,280,656,9,ITC,ITC2,2,Valle d'Aosta / Vallée d'Aoste,Valle d'Aosta,125666,40352,32.11,0.75
1131,2021-06-25,VDA,977,445,532,324,651,2,ITC,ITC2,2,Valle d'Aosta / Vallée d'Aoste,Valle d'Aosta,125666,41329,32.89,0.78
1132,2021-05-20,VDA,824,371,453,374,440,10,ITC,ITC2,2,Valle d'Aosta / Vallée d'Aoste,Valle d'Aosta,125666,42153,33.54,0.66
1133,2021-07-02,VDA,866,383,483,301,560,5,ITC,ITC2,2,Valle d'Aosta / Vallée d'Aoste,Valle d'Aosta,125666,43019,34.23,0.69
1134,2021-03-24,VDA,515,230,285,255,257,3,ITC,ITC2,2,Valle d'Aosta / Vallée d'Aoste,Valle d'Aosta,125666,43534,34.64,0.41
1135,2021-05-25,VDA,1115,530,585,529,574,12,ITC,ITC2,2,Valle d'Aosta / Vallée d'Aoste,Valle d'Aosta,125666,44649,35.53,0.89
1136,2021-02-14,VDA,48,16,32,1,47,0,ITC,ITC2,2,Valle d'Aosta / Vallée d'Aoste,Valle d'Aosta,125666,44697,35.57,0.04
1137,2021-05-08,VDA,904,540,364,497,378,29,ITC,ITC2,2,Valle d'Aosta / Vallée d'Aoste,Valle d'Aosta,125666,45601,36.29,0.72
1138,2021-01-19,VDA,256,77,179,256,0,0,ITC,ITC2,2,Valle d'Aosta / Vallée d'Aoste,Valle d'Aosta,125666,45857,36.49,0.2
1139,2021-04-12,VDA,486,186,300,306,163,17,ITC,ITC2,2,Valle d'Aosta / Vallée d'Aoste,Valle d'Aosta,125666,46343,36.88,0.39
1140,2021-04-29,VDA,1291,634,657,736,534,21,ITC,ITC2,2,Valle d'Aosta / Vallée d'Aoste,Valle d'Aosta,125666,47634,37.91,1.03
1141,2021-07-21,VDA,1164,635,529,315,849,0,ITC,ITC2,2,Valle d'Aosta / Vallée d'Aoste,Valle d'Aosta,125666,48798,38.83,0.93
1142,2021-07-04,VDA,1191,530,661,338,838,15,ITC,ITC2,2,Valle d'Aosta / Vallée d'Aoste,Valle d'Aosta,125666,49989,39.78,0.95
1143,2021-05-18,VDA,970,484,486,349,617,4,ITC,ITC2,2,Valle d'Aosta / Vallée d'Aoste,Valle d'Aosta,125666,50959,40.55,0.77
1144,2021-02-07,VDA,292,120,172,190,102,0,ITC,ITC2,2,Valle d'Aosta / Vallée d'Aoste,Valle d'Aosta,125666,51251,40.78,0.23
1145,2021-05-01,VDA,940,563,377,439,484,17,ITC,ITC2,2,Valle d'Aosta / Vallée d'Aoste,Valle d'Aosta,125666,52191,41.53,0.75
1146,2021-04-14,VDA,941,430,511,689,224,28,ITC,ITC2,2,Valle d'Aosta / Vallée d'Aoste,Valle d'Aosta,125666,53132,42.28,0.75
1147,2021-07-06,VDA,882,479,403,155,722,5,ITC,ITC2,2,Valle d'Aosta / Vallée d'Aoste,Valle d'Aosta,125666,54014,42.98,0.7
1148,2021-01-02,VDA,6,5,1,6,0,0,ITC,ITC2,2,Valle d'Aosta / Vallée d'Aoste,Valle d'Aosta,125666,54020,42.99,0.0
1149,2021-03-26,VDA,498,204,294,472,7,19,ITC,ITC2,2,Valle d'Aosta / Vallée d'Aoste,Valle d'Aosta,125666,54518,43.38,0.4
1150,2021-06-17,VDA,782,427,355,614,156,12,ITC,ITC2,2,Valle d'Aosta / Vallée d'Aoste,Valle d'Aosta,125666,55300,44.01,0.62
1151,2021-01-21,VDA,33,12,21,33,0,0,ITC,ITC2,2,Valle d'Aosta / Vallée d'Aoste,Valle d'Aosta,125666,55333,44.03,0.03
1152,2021-01-04,VDA,144,61,83,144,0,0,ITC,ITC2,2,Valle d'Aosta / Vallée d'Aoste,Valle d'Aosta,125666,55477,44.15,0.11
1153,2021-03-28,VDA,522,212,310,493,1,28,ITC,ITC2,2,Valle d'Aosta / Vallée d'Aoste,Valle d'Aosta,125666,55999,44.56,0.42
1154,2021-03-29,VDA,493,233,260,448,40,5,ITC,ITC2,2,Valle d'Aosta / Vallée d'Aoste,Valle d'Aosta,125666,56492,44.95,0.39
1155,2021-06-20,VDA,1131,545,586,478,643,10,ITC,ITC2,2,Valle d'Aosta / Vallée d'Aoste,Valle d'Aosta,125666,57623,45.85,0.9
1156,2021-03-12,VDA,531,175,356,291,226,14,ITC,ITC2,2,Valle d'Aosta / Vallée d'Aoste,Valle d'Aosta,125666,58154,46.28,0.42
1157,2021-03-10,VDA,438,183,255,220,213,5,ITC,ITC2,2,Valle d'Aosta / Vallée d'Aoste,Valle d'Aosta,125666,58592,46.63,0.35
1158,2021-02-21,VDA,18,3,15,0,18,0,ITC,ITC2,2,Valle d'Aosta / Vallée d'Aoste,Valle d'Aosta,125666,58610,46.64,0.01
1159,2021-01-31,VDA,291,91,200,58,233,0,ITC,ITC2,2,Valle d'Aosta / Vallée d'Aoste,Valle d'Aosta,125666,58901,46.87,0.23
1160,2021-05-06,VDA,1081,514,567,664,384,33,ITC,ITC2,2,Valle d'Aosta / Vallée d'Aoste,Valle d'Aosta,125666,59982,47.73,0.86
1161,2021-02-16,VDA,326,53,273,309,6,11,ITC,ITC2,2,Valle d'Aosta / Vallée d'Aoste,Valle d'Aosta,125666,60308,47.99,0.26
1162,2021-04-07,VDA,910,474,436,654,229,27,ITC,ITC2,2,Valle d'Aosta / Vallée d'Aoste,Valle d'Aosta,125666,61218,48.71,0.72
1163,2021-02-09,VDA,252,84,168,68,183,1,ITC,ITC2,2,Valle d'Aosta / Vallée d'Aoste,Valle d'Aosta,125666,61470,48.92,0.2
1164,2021-01-05,VDA,151,55,96,151,0,0,ITC,ITC2,2,Valle d'Aosta / Vallée d'Aoste,Valle d'Aosta,125666,61621,49.04,0.12
1165,2021-01-14,VDA,237,69,168,237,0,0,ITC,ITC2,2,Valle d'Aosta / Vallée d'Aoste,Valle d'Aosta,125666,61858,49.22,0.19
1166,2021-04-24,VDA,722,400,322,533,167,22,ITC,ITC2,2,Valle d'Aosta / Vallée d'Aoste,Valle d'Aosta,125666,62580,49.8,0.57
1167,2021-07-28,VDA,1388,742,646,353,1035,0,ITC,ITC2,2,Valle d'Aosta / Vallée d'Aoste,Valle d'Aosta,125666,63968,50.9,1.1
1168,2021-04-19,VDA,752,325,427,520,209,23,ITC,ITC2,2,Valle d'Aosta / Vallée d'Aoste,Valle d'Aosta,125666,64720,51.5,0.6
1169,2021-01-16,VDA,237,80,157,237,0,0,ITC,ITC2,2,Valle d'Aosta / Vallée d'Aoste,Valle d'Aosta,125666,64957,51.69,0.19
1170,2021-06-22,VDA,1189,666,523,529,648,12,ITC,ITC2,2,Valle d'Aosta / Vallée d'Aoste,Valle d'Aosta,125666,66146,52.64,0.95
1171,2021-03-14,VDA,392,200,192,373,0,19,ITC,ITC2,2,Valle d'Aosta / Vallée d'Aoste,Valle d'Aosta,125666,66538,52.95,0.31
1172,2021-04-26,VDA,715,327,388,512,170,33,ITC,ITC2,2,Valle d'Aosta / Vallée d'Aoste,Valle d'Aosta,125666,67253,53.52,0.57
1173,2021-07-01,VDA,962,473,489,328,621,13,ITC,ITC2,2,Valle d'Aosta / Vallée d'Aoste,Valle d'Aosta,125666,68215,54.28,0.77
1174,2021-07-16,VDA,1075,552,523,346,729,0,ITC,ITC2,2,Valle d'Aosta / Vallée d'Aoste,Valle d'Aosta,125666,69290,55.14,0.86
1175,2021-01-26,VDA,141,50,91,0,141,0,ITC,ITC2,2,Valle d'Aosta / Vallée d'Aoste,Valle d'Aosta,125666,69431,55.25,0.11
1176,2021-02-12,VDA,263,96,167,216,46,1,ITC,ITC2,2,Valle d'Aosta / Vallée d'Aoste,Valle d'Aosta,125666,69694,55.46,0.21
1177,2021-01-12,VDA,302,72,230,302,0,0,ITC,ITC2,2,Valle d'Aosta / Vallée d'Aoste,Valle d'Aosta,125666,69996,55.7,0.24
1178,2021-03-11,VDA,200,77,123,66,134,0,ITC,ITC2,2,Valle d'Aosta / Vallée d'Aoste,Valle d'Aosta,125666,70196,55.86,0.16
1179,2021-06-02,VDA,1215,688,527,811,401,3,ITC,ITC2,2,Valle d'Aosta / Vallée d'Aoste,Valle d'Aosta,125666,71411,56.83,0.97
1180,2021-06-19,VDA,1289,668,621,659,619,11,ITC,ITC2,2,Valle d'Aosta / Vallée d'Aoste,Valle d'Aosta,125666,72700,57.85,1.03
1181,2021-03-09,VDA,206,96,110,166,32,8,ITC,ITC2,2,Valle d'Aosta / Vallée d'Aoste,Valle d'Aosta,125666,72906,58.02,0.16
1182,2021-02-20,VDA,251,210,41,238,10,3,ITC,ITC2,2,Valle d'Aosta / Vallée d'Aoste,Valle d'Aosta,125666,73157,58.22,0.2
1183,2021-01-09,VDA,443,199,244,443,0,0,ITC,ITC2,2,Valle d'Aosta / Vallée d'Aoste,Valle d'Aosta,125666,73600,58.57,0.35
1184,2021-06-24,VDA,1221,629,592,379,833,9,ITC,ITC2,2,Valle d'Aosta / Vallée d'Aoste,Valle d'Aosta,125666,74821,59.54,0.97
1185,2021-07-03,VDA,935,484,451,390,536,9,ITC,ITC2,2,Valle d'Aosta / Vallée d'Aoste,Valle d'Aosta,125666,75756,60.28,0.74
1186,2021-05-24,VDA,1136,516,620,673,447,16,ITC,ITC2,2,Valle d'Aosta / Vallée d'Aoste,Valle d'Aosta,125666,76892,61.19,0.9
1187,2021-05-10,VDA,782,381,401,531,235,16,ITC,ITC2,2,Valle d'Aosta / Vallée d'Aoste,Valle d'Aosta,125666,77674,61.81,0.62
1188,2021-07-30,VDA,910,469,441,387,505,18,ITC,ITC2,2,Valle d'Aosta / Vallée d'Aoste,Valle d'Aosta,125666,78584,62.53,0.72
1189,2021-04-21,VDA,868,410,458,588,248,32,ITC,ITC2,2,Valle d'Aosta / Vallée d'Aoste,Valle d'Aosta,125666,79452,63.22,0.69
1190,2021-03-22,VDA,560,205,355,324,227,9,ITC,ITC2,2,Valle d'Aosta / Vallée d'Aoste,Valle d'Aosta,125666,80012,63.67,0.45
1191,2021-06-05,VDA,925,476,449,729,188,8,ITC,ITC2,2,Valle d'Aosta / Vallée d'Aoste,Valle d'Aosta,125666,80937,64.41,0.74
1192,2021-02-11,VDA,231,107,124,221,9,1,ITC,ITC2,2,Valle d'Aosta / Vallée d'Aoste,Valle d'Aosta,125666,81168,64.59,0.18
1193,2021-07-18,VDA,926,454,472,252,674,0,ITC,ITC2,2,Valle d'Aosta / Vallée d'Aoste,Valle d'Aosta,125666,82094,65.33,0.74
1194,2021-04-09,VDA,237,111,126,200,33,4,ITC,ITC2,2,Valle d'Aosta / Vallée d'Aoste,Valle d'Aosta,125666,82331,65.52,0.19
1195,2021-05-22,VDA,953,502,451,543,400,10,ITC,ITC2,2,Valle d'Aosta / Vallée d'Aoste,Valle d'Aosta,125666,83284,66.27,0.76
1196,2021-04-05,VDA,464,223,241,439,6,19,ITC,ITC2,2,Valle d'Aosta / Vallée d'Aoste,Valle d'Aosta,125666,83748,66.64,0.37
1197,2021-06-27,VDA,1250,607,643,312,928,10,ITC,ITC2,2,Valle d'Aosta / Vallée d'Aoste,Valle d'Aosta,125666,84998,67.64,0.99
1198,2021-07-14,VDA,1019,532,487,293,726,0,ITC,ITC2,2,Valle d'Aosta / Vallée d'Aoste,Valle d'Aosta,125666,86017,68.45,0.81
1199,2021-06-01,VDA,871,469,402,510,353,8,ITC,ITC2,2,Valle d'Aosta / Vallée d'Aoste,Valle d'Aosta,125666,86888,69.14,0.69
1200,2021-02-23,VDA,216,123,93,215,0,1,ITC,ITC2,2,Valle d'Aosta / Vallée d'Aoste,Valle d'Aosta,125666,87104,69.31,0.17
1201,2021-06-03,VDA,1306,667,639,884,410,12,ITC,ITC2,2,Valle d'Aosta / Vallée d'Aoste,Valle d'Aosta,125666,88410,70.35,1.04
1202,2021-05-17,VDA,809,417,392,367,434,8,ITC,ITC2,2,Valle d'Aosta / Vallée d'Aoste,Valle d'Aosta,125666,89219,71.0,0.64
1203,2021-05-15,VDA,1065,614,451,367,685,13,ITC,ITC2,2,Valle d'Aosta / Vallée d'Aoste,Valle d'Aosta,125666,90284,71.84,0.85
1204,2021-02-04,VDA,294,86,208,8,286,0,ITC,ITC2,2,Valle d'Aosta / Vallée d'Aoste,Valle d'Aosta,125666,90578,72.08,0.23
1205,2021-04-28,VDA,1218,632,586,681,503,34,ITC,ITC2,2,Valle d'Aosta / Vallée d'Aoste,Valle d'Aosta,125666,91796,73.05,0.97
1206,2021-02-08,VDA,223,83,140,25,198,0,ITC,ITC2,2,Valle d'Aosta / Vallée d'Aoste,Valle d'Aosta,125666,92019,73.23,0.18
1207,2021-03-23,VDA,379,150,229,228,134,17,ITC,ITC2,2,Valle d'Aosta / Vallée d'Aoste,Valle d'Aosta,125666,92398,73.53,0.3
1208,2021-05-19,VDA,993,498,495,411,575,7,ITC,ITC2,2,Valle d'Aosta / Vallée d'Aoste,Valle d'Aosta,125666,93391,74.32,0.79
1209,2021-07-20,VDA,1117,583,534,396,721,0,ITC,ITC2,2,Valle d'Aosta / Vallée d'Aoste,Valle d'Aosta,125666,94508,75.21,0.89
1210,2021-04-18,VDA,522,254,268,493,3,26,ITC,ITC2,2,Valle d'Aosta / Vallée d'Aoste,Valle d'Aosta,125666,95030,75.62,0.42
1211,2021-06-14,VDA,328,172,156,13,314,1,ITC,ITC2,2,Valle d'Aosta / Vallée d'Aoste,Valle d'Aosta,125666,95358,75.88,0.26
1212,2021-05-31,VDA,880,396,484,490,379,11,ITC,ITC2,2,Valle d'Aosta / Vallée d'Aoste,Valle d'Aosta,125666,96238,76.58,0.7
1213,2021-07-13,VDA,1061,567,494,307,748,6,ITC,ITC2,2,Valle d'Aosta / Vallée d'Aoste,Valle d'Aosta,125666,97299,77.43,0.84
1214,2021-03-21,VDA,355,165,190,346,0,9,ITC,ITC2,2,Valle d'Aosta / Vallée d'Aoste,Valle d'Aosta,125666,97654,77.71,0.28
1215,2021-06-29,VDA,780,390,390,235,542,3,ITC,ITC2,2,Valle d'Aosta / Vallée d'Aoste,Valle d'Aosta,125666,98434,78.33,0.62
1216,2021-06-10,VDA,1002,558,444,953,42,7,ITC,ITC2,2,Valle d'Aosta / Vallée d'Aoste,Valle d'Aosta,125666,99436,79.13,0.8
1217,2021-03-02,VDA,339,166,173,291,3,45,ITC,ITC2,2,Valle d'Aosta / Vallée d'Aoste,Valle d'Aosta,125666,99775,79.4,0.27
1218,2021-07-27,VDA,1111,591,520,561,550,0,ITC,ITC2,2,Valle d'Aosta / Vallée d'Aoste,Valle d'Aosta,125666,100886,80.28,0.88
1219,2021-04-25,VDA,849,408,441,674,139,36,ITC,ITC2,2,Valle d'Aosta / Vallée d'Aoste,Valle d'Aosta,125666,101735,80.96,0.68
1220,2021-06-21,VDA,1122,600,522,607,505,10,ITC,ITC2,2,Valle d'Aosta / Vallée d'Aoste,Valle d'Aosta,125666,102857,81.85,0.89
1221,2021-06-07,VDA,710,347,363,638,61,11,ITC,ITC2,2,Valle d'Aosta / Vallée d'Aoste,Valle d'Aosta,125666,103567,82.41,0.56
1222,2021-02-27,VDA,231,85,146,119,107,5,ITC,ITC2,2,Valle d'Aosta / Vallée d'Aoste,Valle d'Aosta,125666,103798,82.6,0.18
1223,2021-02-06,VDA,289,104,185,91,197,1,ITC,ITC2,2,Valle d'Aosta / Vallée d'Aoste,Valle d'Aosta,125666,104087,82.83,0.23
1224,2021-04-30,VDA,831,355,476,467,346,18,ITC,ITC2,2,Valle d'Aosta / Vallée d'Aoste,Valle d'Aosta,125666,104918,83.49,0.66
1225,2021-01-20,VDA,23,8,15,23,0,0,ITC,ITC2,2,Valle d'Aosta / Vallée d'Aoste,Valle d'Aosta,125666,104941,83.51,0.02
1226,2021-07-22,VDA,971,513,458,276,695,0,ITC,ITC2,2,Valle d'Aosta / Vallée d'Aoste,Valle d'Aosta,125666,105912,84.28,0.77
1227,2021-01-18,VDA,213,74,139,213,0,0,ITC,ITC2,2,Valle d'Aosta / Vallée d'Aoste,Valle d'Aosta,125666,106125,84.45,0.17
1228,2021-04-11,VDA,479,208,271,462,0,17,ITC,ITC2,2,Valle d'Aosta / Vallée d'Aoste,Valle d'Aosta,125666,106604,84.83,0.38
1229,2021-01-28,VDA,291,123,168,56,235,0,ITC,ITC2,2,Valle d'Aosta / Vallée d'Aoste,Valle d'Aosta,125666,106895,85.06,0.23
1230,2021-06-12,VDA,1233,599,634,1062,167,4,ITC,ITC2,2,Valle d'Aosta / Vallée d'Aoste,Valle d'Aosta,125666,108128,86.04,0.98
1231,2021-03-16,VDA,182,37,145,109,64,9,ITC,ITC2,2,Valle d'Aosta / Vallée d'Aoste,Valle d'Aosta,125666,108310,86.19,0.14
1232,2021-07-25,VDA,1016,492,524,264,752,0,ITC,ITC2,2,Valle d'Aosta / Vallée d'Aoste,Valle d'Aosta,125666,109326,87.0,0.81
1233,2021-04-16,VDA,599,261,338,565,2,32,ITC,ITC2,2,Valle d'Aosta / Vallée d'Aoste,Valle d'Aosta,125666,109925,87.47,0.48
1234,2021-04-02,VDA,874,344,530,595,226,53,ITC,ITC2,2,Valle d'Aosta / Vallée d'Aoste,Valle d'Aosta,125666,110799,88.17,0.7
1235,2021-05-29,VDA,798,434,364,553,237,8,ITC,ITC2,2,Valle d'Aosta / Vallée d'Aoste,Valle d'Aosta,125666,111597,88.8,0.64
1236,2021-07-11,VDA,907,471,436,254,642,11,ITC,ITC2,2,Valle d'Aosta / Vallée d'Aoste,Valle d'Aosta,125666,112504,89.53,0.72
1237,2021-02-25,VDA,201,101,100,190,7,4,ITC,ITC2,2,Valle d'Aosta / Vallée d'Aoste,Valle d'Aosta,125666,112705,89.69,0.16
1238,2021-01-06,VDA,65,33,32,65,0,0,ITC,ITC2,2,Valle d'Aosta / Vallée d'Aoste,Valle d'Aosta,125666,112770,89.74,0.05
1239,2021-02-18,VDA,349,153,196,255,88,6,ITC,ITC2,2,Valle d'Aosta / Vallée d'Aoste,Valle d'Aosta,125666,113119,90.02,0.28
1240,2021-01-11,VDA,325,112,213,325,0,0,ITC,ITC2,2,Valle d'Aosta / Vallée d'Aoste,Valle d'Aosta,125666,113444,90.27,0.26
1241,2021-04-04,VDA,572,253,319,550,1,21,ITC,ITC2,2,Valle d'Aosta / Vallée d'Aoste,Valle d'Aosta,125666,114016,90.73,0.46
1242,2021-03-19,VDA,322,85,237,277,35,10,ITC,ITC2,2,Valle d'Aosta / Vallée d'Aoste,Valle d'Aosta,125666,114338,90.99,0.26
1243,2021-05-07,VDA,564,245,319,517,31,16,ITC,ITC2,2,Valle d'Aosta / Vallée d'Aoste,Valle d'Aosta,125666,114902,91.43,0.45
1244,2021-04-23,VDA,922,443,479,511,383,28,ITC,ITC2,2,Valle d'Aosta / Vallée d'Aoste,Valle d'Aosta,125666,115824,92.17,0.73
1245,2021-01-13,VDA,337,110,227,337,0,0,ITC,ITC2,2,Valle d'Aosta / Vallée d'Aoste,Valle d'Aosta,125666,116161,92.44,0.27
1246,2021-07-29,VDA,947,480,467,297,643,7,ITC,ITC2,2,Valle d'Aosta / Vallée d'Aoste,Valle d'Aosta,125666,117108,93.19,0.75
1247,2021-07-15,VDA,1085,589,496,297,788,0,ITC,ITC2,2,Valle d'Aosta / Vallée d'Aoste,Valle d'Aosta,125666,118193,94.05,0.86
1248,2021-04-06,VDA,741,381,360,596,112,33,ITC,ITC2,2,Valle d'Aosta / Vallée d'Aoste,Valle d'Aosta,125666,118934,94.64,0.59
1249,2021-03-18,VDA,136,43,93,96,37,3,ITC,ITC2,2,Valle d'Aosta / Vallée d'Aoste,Valle d'Aosta,125666,119070,94.75,0.11
1250,2021-02-13,VDA,216,196,20,213,1,2,ITC,ITC2,2,Valle d'Aosta / Vallée d'Aoste,Valle d'Aosta,125666,119286,94.92,0.17
1251,2021-06-26,VDA,1061,509,552,350,704,7,ITC,ITC2,2,Valle d'Aosta / Vallée d'Aoste,Valle d'Aosta,125666,120347,95.77,0.84
1252,2021-03-04,VDA,291,139,152,39,250,2,ITC,ITC2,2,Valle d'Aosta / Vallée d'Aoste,Valle d'Aosta,125666,120638,96.0,0.23
1253,2021-05-26,VDA,1209,587,622,565,633,11,ITC,ITC2,2,Valle d'Aosta / Vallée d'Aoste,Valle d'Aosta,125666,121847,96.96,0.96
1254,2021-06-08,VDA,712,356,356,675,33,4,ITC,ITC2,2,Valle d'Aosta / Vallée d'Aoste,Valle d'Aosta,125666,122559,97.53,0.57
1255,2021-02-26,VDA,208,58,150,108,86,14,ITC,ITC2,2,Valle d'Aosta / Vallée d'Aoste,Valle d'Aosta,125666,122767,97.69,0.17
1256,2021-04-10,VDA,404,190,214,387,5,12,ITC,ITC2,2,Valle d'Aosta / Vallée d'Aoste,Valle d'Aosta,125666,123171,98.01,0.32
1257,2020-12-31,VDA,18,4,14,18,0,0,ITC,ITC2,2,Valle d'Aosta / Vallée d'Aoste,Valle d'Aosta,125666,123189,98.03,0.01
1258,2021-06-06,VDA,1160,582,578,782,373,5,ITC,ITC2,2,Valle d'Aosta / Vallée d'Aoste,Valle d'Aosta,125666,124349,98.95,0.92
1259,2021-06-15,VDA,876,479,397,608,255,13,ITC,ITC2,2,Valle d'Aosta / Vallée d'Aoste,Valle d'Aosta,125666,125225,99.65,0.7
1260,2021-03-05,VDA,276,124,152,52,223,1,ITC,ITC2,2,Valle d'Aosta / Vallée d'Aoste,Valle d'Aosta,125666,125501,99.87,0.22
1261,2021-02-28,VDA,260,86,174,73,183,4,ITC,ITC2,2,Valle d'Aosta / Vallée d'Aoste,Valle d'Aosta,125666,125761,100.08,0.21
1262,2021-05-05,VDA,1038,566,472,434,582,22,ITC,ITC2,2,Valle d'Aosta / Vallée d'Aoste,Valle d'Aosta,125666,126799,100.9,0.83
1263,2021-05-03,VDA,839,400,439,458,351,30,ITC,ITC2,2,Valle d'Aosta / Vallée d'Aoste,Valle d'Aosta,125666,127638,101.57,0.67
1264,2021-03-07,VDA,64,30,34,11,53,0,ITC,ITC2,2,Valle d'Aosta / Vallée d'Aoste,Valle d'Aosta,125666,127702,101.62,0.05
1265,2021-01-30,VDA,439,202,237,12,425,2,ITC,ITC2,2,Valle d'Aosta / Vallée d'Aoste,Valle d'Aosta,125666,128141,101.97,0.35
1266,2021-01-25,VDA,149,67,82,0,149,0,ITC,ITC2,2,Valle d'Aosta / Vallée d'Aoste,Valle d'Aosta,125666,128290,102.09,0.12
1267,2021-07-10,VDA,1289,667,622,321,957,11,ITC,ITC2,2,Valle d'Aosta / Vallée d'Aoste,Valle d'Aosta,125666,129579,103.11,1.03
1268,2021-05-14,VDA,960,442,518,251,668,41,ITC,ITC2,2,Valle d'Aosta / Vallée d'Aoste,Valle d'Aosta,125666,130539,103.88,0.76
1269,2021-02-01,VDA,405,127,278,84,318,3,ITC,ITC2,2,Valle d'Aosta / Vallée d'Aoste,Valle d'Aosta,125666,130944,104.2,0.32
1270,2021-07-08,VDA,1275,709,566,341,924,10,ITC,ITC2,2,Valle d'Aosta / Vallée d'Aoste,Valle d'Aosta,125666,132219,105.21,1.01
1271,2021-03-30,VDA,402,223,179,365,20,17,ITC,ITC2,2,Valle d'Aosta / Vallée d'Aoste,Valle d'Aosta,125666,132621,105.53,0.32
1272,2021-05-12,VDA,1143,550,593,442,670,31,ITC,ITC2,2,Valle d'Aosta / Vallée d'Aoste,Valle d'Aosta,125666,133764,106.44,0.91
1273,2021-07-17,VDA,985,519,466,255,730,0,ITC,ITC2,2,Valle d'Aosta / Vallée d'Aoste,Valle d'Aosta,125666,134749,107.23,0.78
1274,2021-02-06,PAT,575,299,276,434,141,0,ITH,ITH2,4,Provincia Autonoma Trento,P.A. Trento,541380,575,0.11,0.11
1275,2021-02-23,PAT,1112,395,717,878,213,21,ITH,ITH2,4,Provincia Autonoma Trento,P.A. Trento,541380,1687,0.31,0.21
1276,2021-05-17,PAT,4294,2122,2172,3710,351,233,ITH,ITH2,4,Provincia Autonoma Trento,P.A. Trento,541380,5981,1.1,0.79
1277,2021-04-14,PAT,3119,1465,1654,2231,737,151,ITH,ITH2,4,Provincia Autonoma Trento,P.A. Trento,541380,9100,1.68,0.58
1278,2021-07-27,PAT,4545,2411,2134,1561,2886,98,ITH,ITH2,4,Provincia Autonoma Trento,P.A. Trento,541380,13645,2.52,0.84
1279,2021-05-31,PAT,4726,2175,2551,1571,3048,107,ITH,ITH2,4,Provincia Autonoma Trento,P.A. Trento,541380,18371,3.39,0.87
1280,2021-07-20,PAT,4542,2460,2082,1600,2814,128,ITH,ITH2,4,Provincia Autonoma Trento,P.A. Trento,541380,22913,4.23,0.84
1281,2021-07-13,PAT,3647,1845,1802,1654,1877,116,ITH,ITH2,4,Provincia Autonoma Trento,P.A. Trento,541380,26560,4.91,0.67
1282,2021-04-21,PAT,2910,1359,1551,2710,50,150,ITH,ITH2,4,Provincia Autonoma Trento,P.A. Trento,541380,29470,5.44,0.54
1283,2021-01-28,PAT,533,147,386,49,484,0,ITH,ITH2,4,Provincia Autonoma Trento,P.A. Trento,541380,30003,5.54,0.1
1284,2021-01-11,PAT,732,223,509,732,0,0,ITH,ITH2,4,Provincia Autonoma Trento,P.A. Trento,541380,30735,5.68,0.14
1285,2021-02-16,PAT,668,246,422,652,5,11,ITH,ITH2,4,Provincia Autonoma Trento,P.A. Trento,541380,31403,5.8,0.12
1286,2021-04-09,PAT,2743,1163,1580,1475,1201,67,ITH,ITH2,4,Provincia Autonoma Trento,P.A. Trento,541380,34146,6.31,0.51
1287,2021-02-11,PAT,1137,366,771,796,340,1,ITH,ITH2,4,Provincia Autonoma Trento,P.A. Trento,541380,35283,6.52,0.21
1288,2021-07-18,PAT,450,239,211,111,334,5,ITH,ITH2,4,Provincia Autonoma Trento,P.A. Trento,541380,35733,6.6,0.08
1289,2021-02-25,PAT,1641,643,998,1190,441,10,ITH,ITH2,4,Provincia Autonoma Trento,P.A. Trento,541380,37374,6.9,0.3
1290,2020-12-30,PAT,7,3,4,7,0,0,ITH,ITH2,4,Provincia Autonoma Trento,P.A. Trento,541380,37381,6.9,0.0
1291,2021-06-05,PAT,4084,1917,2167,681,3334,69,ITH,ITH2,4,Provincia Autonoma Trento,P.A. Trento,541380,41465,7.66,0.75
1292,2021-05-22,PAT,3259,1598,1661,832,2334,93,ITH,ITH2,4,Provincia Autonoma Trento,P.A. Trento,541380,44724,8.26,0.6
1293,2021-03-09,PAT,1586,591,995,908,647,31,ITH,ITH2,4,Provincia Autonoma Trento,P.A. Trento,541380,46310,8.55,0.29
1294,2021-06-17,PAT,6607,3467,3140,1987,4461,159,ITH,ITH2,4,Provincia Autonoma Trento,P.A. Trento,541380,52917,9.77,1.22
1295,2021-03-14,PAT,108,65,43,19,87,2,ITH,ITH2,4,Provincia Autonoma Trento,P.A. Trento,541380,53025,9.79,0.02
1296,2021-06-29,PAT,6232,3140,3092,2667,3490,75,ITH,ITH2,4,Provincia Autonoma Trento,P.A. Trento,541380,59257,10.95,1.15
1297,2021-06-12,PAT,5365,2690,2675,430,4888,47,ITH,ITH2,4,Provincia Autonoma Trento,P.A. Trento,541380,64622,11.94,0.99
1298,2021-03-21,PAT,129,69,60,125,0,4,ITH,ITH2,4,Provincia Autonoma Trento,P.A. Trento,541380,64751,11.96,0.02
1299,2021-05-24,PAT,4388,2016,2372,1249,3026,113,ITH,ITH2,4,Provincia Autonoma Trento,P.A. Trento,541380,69139,12.77,0.81
1300,2021-03-02,PAT,1307,440,867,902,376,29,ITH,ITH2,4,Provincia Autonoma Trento,P.A. Trento,541380,70446,13.01,0.24
1301,2021-03-26,PAT,3234,1259,1975,2482,610,142,ITH,ITH2,4,Provincia Autonoma Trento,P.A. Trento,541380,73680,13.61,0.6
1302,2021-01-23,PAT,577,334,243,387,189,1,ITH,ITH2,4,Provincia Autonoma Trento,P.A. Trento,541380,74257,13.72,0.11
1303,2021-05-03,PAT,4264,2198,2066,3810,154,300,ITH,ITH2,4,Provincia Autonoma Trento,P.A. Trento,541380,78521,14.5,0.79
1304,2021-07-01,PAT,6938,3609,3329,3452,3308,178,ITH,ITH2,4,Provincia Autonoma Trento,P.A. Trento,541380,85459,15.79,1.28
1305,2021-05-05,PAT,4998,2583,2415,4388,301,309,ITH,ITH2,4,Provincia Autonoma Trento,P.A. Trento,541380,90457,16.71,0.92
1306,2021-01-16,PAT,319,148,171,319,0,0,ITH,ITH2,4,Provincia Autonoma Trento,P.A. Trento,541380,90776,16.77,0.06
1307,2021-05-29,PAT,2242,1169,1073,755,1403,84,ITH,ITH2,4,Provincia Autonoma Trento,P.A. Trento,541380,93018,17.18,0.41
1308,2021-04-02,PAT,2848,1158,1690,2011,676,161,ITH,ITH2,4,Provincia Autonoma Trento,P.A. Trento,541380,95866,17.71,0.53
1309,2021-04-16,PAT,2869,1362,1507,2568,145,156,ITH,ITH2,4,Provincia Autonoma Trento,P.A. Trento,541380,98735,18.24,0.53
1310,2021-02-18,PAT,1403,488,915,1325,64,14,ITH,ITH2,4,Provincia Autonoma Trento,P.A. Trento,541380,100138,18.5,0.26
1311,2021-07-25,PAT,342,192,150,122,211,9,ITH,ITH2,4,Provincia Autonoma Trento,P.A. Trento,541380,100480,18.56,0.06
1312,2021-03-28,PAT,753,294,459,705,2,46,ITH,ITH2,4,Provincia Autonoma Trento,P.A. Trento,541380,101233,18.7,0.14
1313,2021-01-04,PAT,872,229,643,870,0,2,ITH,ITH2,4,Provincia Autonoma Trento,P.A. Trento,541380,102105,18.86,0.16
1314,2021-07-06,PAT,5009,2636,2373,2953,1875,181,ITH,ITH2,4,Provincia Autonoma Trento,P.A. Trento,541380,107114,19.79,0.93
1315,2021-01-18,PAT,644,154,490,589,55,0,ITH,ITH2,4,Provincia Autonoma Trento,P.A. Trento,541380,107758,19.9,0.12
1316,2021-02-20,PAT,407,245,162,122,284,1,ITH,ITH2,4,Provincia Autonoma Trento,P.A. Trento,541380,108165,19.98,0.08
1317,2021-04-23,PAT,3641,1772,1869,3409,54,178,ITH,ITH2,4,Provincia Autonoma Trento,P.A. Trento,541380,111806,20.65,0.67
1318,2021-01-30,PAT,386,132,254,152,234,0,ITH,ITH2,4,Provincia Autonoma Trento,P.A. Trento,541380,112192,20.72,0.07
1319,2021-05-10,PAT,3214,1648,1566,2498,507,209,ITH,ITH2,4,Provincia Autonoma Trento,P.A. Trento,541380,115406,21.32,0.59
1320,2021-03-18,PAT,2325,959,1366,1218,1083,24,ITH,ITH2,4,Provincia Autonoma Trento,P.A. Trento,541380,117731,21.75,0.43
1321,2021-03-07,PAT,22,6,16,22,0,0,ITH,ITH2,4,Provincia Autonoma Trento,P.A. Trento,541380,117753,21.75,0.0
1322,2021-01-09,PAT,190,40,150,190,0,0,ITH,ITH2,4,Provincia Autonoma Trento,P.A. Trento,541380,117943,21.79,0.04
1323,2021-06-24,PAT,5928,3106,2822,3560,2180,188,ITH,ITH2,4,Provincia Autonoma Trento,P.A. Trento,541380,123871,22.88,1.09
1324,2021-05-12,PAT,3312,1497,1815,1953,1194,165,ITH,ITH2,4,Provincia Autonoma Trento,P.A. Trento,541380,127183,23.49,0.61
1325,2021-03-16,PAT,1392,507,885,577,783,32,ITH,ITH2,4,Provincia Autonoma Trento,P.A. Trento,541380,128575,23.75,0.26
1326,2021-05-14,PAT,5327,2544,2783,3642,1391,294,ITH,ITH2,4,Provincia Autonoma Trento,P.A. Trento,541380,133902,24.73,0.98
1327,2021-06-10,PAT,6130,2980,3150,1788,4213,129,ITH,ITH2,4,Provincia Autonoma Trento,P.A. Trento,541380,140032,25.87,1.13
1328,2021-03-04,PAT,2364,795,1569,1541,781,42,ITH,ITH2,4,Provincia Autonoma Trento,P.A. Trento,541380,142396,26.3,0.44
1329,2021-04-28,PAT,4255,1979,2276,3871,138,246,ITH,ITH2,4,Provincia Autonoma Trento,P.A. Trento,541380,146651,27.09,0.79
1330,2021-04-01,PAT,2913,1234,1679,1721,1101,91,ITH,ITH2,4,Provincia Autonoma Trento,P.A. Trento,541380,149564,27.63,0.54
1331,2021-07-10,PAT,1047,540,507,138,883,26,ITH,ITH2,4,Provincia Autonoma Trento,P.A. Trento,541380,150611,27.82,0.19
1332,2021-06-19,PAT,3100,1697,1403,229,2839,32,ITH,ITH2,4,Provincia Autonoma Trento,P.A. Trento,541380,153711,28.39,0.57
1333,2021-07-08,PAT,3969,2113,1856,2371,1435,163,ITH,ITH2,4,Provincia Autonoma Trento,P.A. Trento,541380,157680,29.13,0.73
1334,2021-02-04,PAT,976,304,672,421,554,1,ITH,ITH2,4,Provincia Autonoma Trento,P.A. Trento,541380,158656,29.31,0.18
1335,2021-04-13,PAT,2556,1059,1497,1970,507,79,ITH,ITH2,4,Provincia Autonoma Trento,P.A. Trento,541380,161212,29.78,0.47
1336,2021-01-20,PAT,292,73,219,280,12,0,ITH,ITH2,4,Provincia Autonoma Trento,P.A. Trento,541380,161504,29.83,0.05
1337,2021-04-30,PAT,4935,2406,2529,4415,152,368,ITH,ITH2,4,Provincia Autonoma Trento,P.A. Trento,541380,166439,30.74,0.91
1338,2021-05-19,PAT,5105,2461,2644,3601,1257,247,ITH,ITH2,4,Provincia Autonoma Trento,P.A. Trento,541380,171544,31.69,0.94
1339,2021-01-06,PAT,42,13,29,42,0,0,ITH,ITH2,4,Provincia Autonoma Trento,P.A. Trento,541380,171586,31.69,0.01
1340,2021-07-29,PAT,4688,2479,2209,2145,2446,97,ITH,ITH2,4,Provincia Autonoma Trento,P.A. Trento,541380,176274,32.56,0.87
1341,2021-06-16,PAT,6222,3353,2869,1944,4156,122,ITH,ITH2,4,Provincia Autonoma Trento,P.A. Trento,541380,182496,33.71,1.15
1342,2021-07-24,PAT,887,494,393,474,394,19,ITH,ITH2,4,Provincia Autonoma Trento,P.A. Trento,541380,183383,33.87,0.16
1343,2021-05-02,PAT,3514,1955,1559,3264,37,213,ITH,ITH2,4,Provincia Autonoma Trento,P.A. Trento,541380,186897,34.52,0.65
1344,2021-06-09,PAT,6249,3082,3167,2090,4082,77,ITH,ITH2,4,Provincia Autonoma Trento,P.A. Trento,541380,193146,35.68,1.15
1345,2021-06-26,PAT,1395,729,666,660,717,18,ITH,ITH2,4,Provincia Autonoma Trento,P.A. Trento,541380,194541,35.93,0.26
1346,2021-06-28,PAT,6764,3487,3277,2902,3800,62,ITH,ITH2,4,Provincia Autonoma Trento,P.A. Trento,541380,201305,37.18,1.25
1347,2021-04-06,PAT,2261,950,1311,1439,765,57,ITH,ITH2,4,Provincia Autonoma Trento,P.A. Trento,541380,203566,37.6,0.42
1348,2021-07-15,PAT,4017,2126,1891,1602,2289,126,ITH,ITH2,4,Provincia Autonoma Trento,P.A. Trento,541380,207583,38.34,0.74
1349,2021-01-13,PAT,421,123,298,421,0,0,ITH,ITH2,4,Provincia Autonoma Trento,P.A. Trento,541380,208004,38.42,0.08
1350,2021-02-12,PAT,1013,341,672,588,423,2,ITH,ITH2,4,Provincia Autonoma Trento,P.A. Trento,541380,209017,38.61,0.19
1351,2021-03-01,PAT,1237,454,783,918,295,24,ITH,ITH2,4,Provincia Autonoma Trento,P.A. Trento,541380,210254,38.84,0.23
1352,2021-03-20,PAT,874,403,471,658,203,13,ITH,ITH2,4,Provincia Autonoma Trento,P.A. Trento,541380,211128,39.0,0.16
1353,2021-03-03,PAT,1659,622,1037,1106,518,35,ITH,ITH2,4,Provincia Autonoma Trento,P.A. Trento,541380,212787,39.3,0.31
1354,2021-06-11,PAT,7213,3433,3780,1479,5635,99,ITH,ITH2,4,Provincia Autonoma Trento,P.A. Trento,541380,220000,40.64,1.33
1355,2021-06-13,PAT,3687,2033,1654,275,3389,23,ITH,ITH2,4,Provincia Autonoma Trento,P.A. Trento,541380,223687,41.32,0.68
1356,2020-12-27,PAT,103,40,63,103,0,0,ITH,ITH2,4,Provincia Autonoma Trento,P.A. Trento,541380,223790,41.34,0.02
1357,2021-01-27,PAT,811,281,530,92,717,2,ITH,ITH2,4,Provincia Autonoma Trento,P.A. Trento,541380,224601,41.49,0.15
1358,2021-02-13,PAT,538,333,205,172,366,0,ITH,ITH2,4,Provincia Autonoma Trento,P.A. Trento,541380,225139,41.59,0.1
1359,2021-05-07,PAT,6003,3088,2915,4798,841,364,ITH,ITH2,4,Provincia Autonoma Trento,P.A. Trento,541380,231142,42.69,1.11
1360,2021-04-20,PAT,2879,1377,1502,2668,36,175,ITH,ITH2,4,Provincia Autonoma Trento,P.A. Trento,541380,234021,43.23,0.53
1361,2021-05-09,PAT,2324,1210,1114,1848,344,132,ITH,ITH2,4,Provincia Autonoma Trento,P.A. Trento,541380,236345,43.66,0.43
1362,2021-02-15,PAT,534,188,346,418,114,2,ITH,ITH2,4,Provincia Autonoma Trento,P.A. Trento,541380,236879,43.75,0.1
1363,2021-01-08,PAT,1454,315,1139,1453,0,1,ITH,ITH2,4,Provincia Autonoma Trento,P.A. Trento,541380,238333,44.02,0.27
1364,2021-06-14,PAT,5745,2971,2774,2020,3614,111,ITH,ITH2,4,Provincia Autonoma Trento,P.A. Trento,541380,244078,45.08,1.06
1365,2021-04-18,PAT,1855,845,1010,1788,9,58,ITH,ITH2,4,Provincia Autonoma Trento,P.A. Trento,541380,245933,45.43,0.34
1366,2021-03-06,PAT,788,278,510,596,152,40,ITH,ITH2,4,Provincia Autonoma Trento,P.A. Trento,541380,246721,45.57,0.15
1367,2021-04-11,PAT,2340,1135,1205,2161,91,88,ITH,ITH2,4,Provincia Autonoma Trento,P.A. Trento,541380,249061,46.0,0.43
1368,2021-02-27,PAT,1032,458,574,590,422,20,ITH,ITH2,4,Provincia Autonoma Trento,P.A. Trento,541380,250093,46.2,0.19
1369,2021-01-01,PAT,214,50,164,214,0,0,ITH,ITH2,4,Provincia Autonoma Trento,P.A. Trento,541380,250307,46.23,0.04
1370,2021-06-07,PAT,5797,2885,2912,2638,2990,169,ITH,ITH2,4,Provincia Autonoma Trento,P.A. Trento,541380,256104,47.31,1.07
1371,2021-03-15,PAT,1412,545,867,894,464,54,ITH,ITH2,4,Provincia Autonoma Trento,P.A. Trento,541380,257516,47.57,0.26
1372,2021-01-17,PAT,252,196,56,252,0,0,ITH,ITH2,4,Provincia Autonoma Trento,P.A. Trento,541380,257768,47.61,0.05
1373,2021-06-23,PAT,6523,3454,3069,4471,1859,193,ITH,ITH2,4,Provincia Autonoma Trento,P.A. Trento,541380,264291,48.82,1.2
1374,2021-05-11,PAT,3708,1754,1954,2618,854,236,ITH,ITH2,4,Provincia Autonoma Trento,P.A. Trento,541380,267999,49.5,0.68
1375,2021-04-27,PAT,3916,1882,2034,3568,69,279,ITH,ITH2,4,Provincia Autonoma Trento,P.A. Trento,541380,271915,50.23,0.72
1376,2021-05-04,PAT,4512,2448,2064,4123,95,294,ITH,ITH2,4,Provincia Autonoma Trento,P.A. Trento,541380,276427,51.06,0.83
1377,2021-03-08,PAT,1411,434,977,1027,354,30,ITH,ITH2,4,Provincia Autonoma Trento,P.A. Trento,541380,277838,51.32,0.26
1378,2021-03-22,PAT,2306,973,1333,1374,875,57,ITH,ITH2,4,Provincia Autonoma Trento,P.A. Trento,541380,280144,51.75,0.43
1379,2021-01-24,PAT,549,277,272,225,324,0,ITH,ITH2,4,Provincia Autonoma Trento,P.A. Trento,541380,280693,51.85,0.1
1380,2021-06-30,PAT,6676,3435,3241,2606,3989,81,ITH,ITH2,4,Provincia Autonoma Trento,P.A. Trento,541380,287369,53.08,1.23
1381,2021-03-23,PAT,2450,945,1505,1609,742,99,ITH,ITH2,4,Provincia Autonoma Trento,P.A. Trento,541380,289819,53.53,0.45
1382,2021-05-28,PAT,3726,1739,1987,1360,2231,135,ITH,ITH2,4,Provincia Autonoma Trento,P.A. Trento,541380,293545,54.22,0.69
1383,2021-01-25,PAT,818,215,603,24,794,0,ITH,ITH2,4,Provincia Autonoma Trento,P.A. Trento,541380,294363,54.37,0.15
1384,2021-03-25,PAT,2877,1106,1771,1721,1049,107,ITH,ITH2,4,Provincia Autonoma Trento,P.A. Trento,541380,297240,54.9,0.53
1385,2021-07-03,PAT,1257,670,587,80,1171,6,ITH,ITH2,4,Provincia Autonoma Trento,P.A. Trento,541380,298497,55.14,0.23
1386,2021-03-30,PAT,2389,973,1416,1652,638,99,ITH,ITH2,4,Provincia Autonoma Trento,P.A. Trento,541380,300886,55.58,0.44
1387,2021-06-06,PAT,2233,1064,1169,425,1787,21,ITH,ITH2,4,Provincia Autonoma Trento,P.A. Trento,541380,303119,55.99,0.41
1388,2021-07-12,PAT,4062,2031,2031,1940,1946,176,ITH,ITH2,4,Provincia Autonoma Trento,P.A. Trento,541380,307181,56.74,0.75
1389,2021-02-17,PAT,1125,429,696,1029,91,5,ITH,ITH2,4,Provincia Autonoma Trento,P.A. Trento,541380,308306,56.95,0.21
1390,2021-06-02,PAT,2841,1360,1481,883,1895,63,ITH,ITH2,4,Provincia Autonoma Trento,P.A. Trento,541380,311147,57.47,0.52
1391,2021-03-11,PAT,2516,926,1590,1448,1016,52,ITH,ITH2,4,Provincia Autonoma Trento,P.A. Trento,541380,313663,57.94,0.46
1392,2021-07-30,PAT,4647,2455,2192,1703,2863,81,ITH,ITH2,4,Provincia Autonoma Trento,P.A. Trento,541380,318310,58.8,0.86
1393,2021-05-25,PAT,4773,2269,2504,1721,2905,147,ITH,ITH2,4,Provincia Autonoma Trento,P.A. Trento,541380,323083,59.68,0.88
1394,2021-05-08,PAT,3163,1726,1437,2548,422,193,ITH,ITH2,4,Provincia Autonoma Trento,P.A. Trento,541380,326246,60.26,0.58
1395,2021-02-14,PAT,247,187,60,11,236,0,ITH,ITH2,4,Provincia Autonoma Trento,P.A. Trento,541380,326493,60.31,0.05
1396,2021-05-30,PAT,1770,872,898,862,840,68,ITH,ITH2,4,Provincia Autonoma Trento,P.A. Trento,541380,328263,60.63,0.33
1397,2021-04-03,PAT,1144,471,673,905,172,67,ITH,ITH2,4,Provincia Autonoma Trento,P.A. Trento,541380,329407,60.85,0.21
1398,2021-04-24,PAT,3551,1701,1850,3337,15,199,ITH,ITH2,4,Provincia Autonoma Trento,P.A. Trento,541380,332958,61.5,0.66
1399,2021-02-26,PAT,1218,435,783,900,295,23,ITH,ITH2,4,Provincia Autonoma Trento,P.A. Trento,541380,334176,61.73,0.22
1400,2021-07-22,PAT,4536,2442,2094,1762,2648,126,ITH,ITH2,4,Provincia Autonoma Trento,P.A. Trento,541380,338712,62.56,0.84
1401,2021-07-07,PAT,4347,2330,2017,2766,1383,198,ITH,ITH2,4,Provincia Autonoma Trento,P.A. Trento,541380,343059,63.37,0.8
1402,2021-01-03,PAT,493,160,333,493,0,0,ITH,ITH2,4,Provincia Autonoma Trento,P.A. Trento,541380,343552,63.46,0.09
1403,2021-04-25,PAT,1971,940,1031,1849,7,115,ITH,ITH2,4,Provincia Autonoma Trento,P.A. Trento,541380,345523,63.82,0.36
1404,2021-06-25,PAT,7510,4024,3486,4046,3378,86,ITH,ITH2,4,Provincia Autonoma Trento,P.A. Trento,541380,353033,65.21,1.39
1405,2021-03-13,PAT,837,385,452,719,48,70,ITH,ITH2,4,Provincia Autonoma Trento,P.A. Trento,541380,353870,65.36,0.15
1406,2021-07-05,PAT,5243,2747,2496,3646,1361,236,ITH,ITH2,4,Provincia Autonoma Trento,P.A. Trento,541380,359113,66.33,0.97
1407,2021-06-21,PAT,6136,3314,2822,3566,2389,181,ITH,ITH2,4,Provincia Autonoma Trento,P.A. Trento,541380,365249,67.47,1.13
1408,2021-04-29,PAT,4648,2244,2404,4140,209,299,ITH,ITH2,4,Provincia Autonoma Trento,P.A. Trento,541380,369897,68.32,0.86
1409,2021-01-22,PAT,1676,436,1240,330,1345,1,ITH,ITH2,4,Provincia Autonoma Trento,P.A. Trento,541380,371573,68.63,0.31
1410,2021-02-05,PAT,805,272,533,283,522,0,ITH,ITH2,4,Provincia Autonoma Trento,P.A. Trento,541380,372378,68.78,0.15
1411,2021-05-16,PAT,1331,736,595,1025,239,67,ITH,ITH2,4,Provincia Autonoma Trento,P.A. Trento,541380,373709,69.03,0.25
1412,2021-05-26,PAT,3918,1843,2075,1105,2693,120,ITH,ITH2,4,Provincia Autonoma Trento,P.A. Trento,541380,377627,69.75,0.72
1413,2021-01-10,PAT,85,20,65,85,0,0,ITH,ITH2,4,Provincia Autonoma Trento,P.A. Trento,541380,377712,69.77,0.02
1414,2021-01-29,PAT,1360,334,1026,55,1305,0,ITH,ITH2,4,Provincia Autonoma Trento,P.A. Trento,541380,379072,70.02,0.25
1415,2021-07-14,PAT,3977,2071,1906,1596,2276,105,ITH,ITH2,4,Provincia Autonoma Trento,P.A. Trento,541380,383049,70.75,0.73
1416,2021-04-22,PAT,3152,1471,1681,2932,45,175,ITH,ITH2,4,Provincia Autonoma Trento,P.A. Trento,541380,386201,71.34,0.58
1417,2021-01-14,PAT,701,203,498,699,0,2,ITH,ITH2,4,Provincia Autonoma Trento,P.A. Trento,541380,386902,71.47,0.13
1418,2021-02-28,PAT,242,121,121,232,0,10,ITH,ITH2,4,Provincia Autonoma Trento,P.A. Trento,541380,387144,71.51,0.04
1419,2021-06-08,PAT,5924,2864,3060,1757,4053,114,ITH,ITH2,4,Provincia Autonoma Trento,P.A. Trento,541380,393068,72.6,1.09
1420,2021-04-26,PAT,2661,1255,1406,2401,95,165,ITH,ITH2,4,Provincia Autonoma Trento,P.A. Trento,541380,395729,73.1,0.49
1421,2021-01-31,PAT,76,16,60,1,75,0,ITH,ITH2,4,Provincia Autonoma Trento,P.A. Trento,541380,395805,73.11,0.01
1422,2021-07-04,PAT,213,120,93,61,150,2,ITH,ITH2,4,Provincia Autonoma Trento,P.A. Trento,541380,396018,73.15,0.04
1423,2021-07-21,PAT,4457,2387,2070,1403,2968,86,ITH,ITH2,4,Provincia Autonoma Trento,P.A. Trento,541380,400475,73.97,0.82
1424,2021-02-22,PAT,747,259,488,657,84,6,ITH,ITH2,4,Provincia Autonoma Trento,P.A. Trento,541380,401222,74.11,0.14
1425,2021-05-18,PAT,4256,2011,2245,3132,846,278,ITH,ITH2,4,Provincia Autonoma Trento,P.A. Trento,541380,405478,74.9,0.79
1426,2021-03-12,PAT,2520,941,1579,1642,807,71,ITH,ITH2,4,Provincia Autonoma Trento,P.A. Trento,541380,407998,75.36,0.47
1427,2021-07-11,PAT,999,550,449,121,869,9,ITH,ITH2,4,Provincia Autonoma Trento,P.A. Trento,541380,408997,75.55,0.18
1428,2021-05-27,PAT,4297,1993,2304,1124,3045,128,ITH,ITH2,4,Provincia Autonoma Trento,P.A. Trento,541380,413294,76.34,0.79
1429,2021-04-07,PAT,2631,1019,1612,1572,944,115,ITH,ITH2,4,Provincia Autonoma Trento,P.A. Trento,541380,415925,76.83,0.49
1430,2021-07-16,PAT,4372,2240,2132,1626,2606,140,ITH,ITH2,4,Provincia Autonoma Trento,P.A. Trento,541380,420297,77.63,0.81
1431,2021-06-27,PAT,1304,699,605,360,938,6,ITH,ITH2,4,Provincia Autonoma Trento,P.A. Trento,541380,421601,77.88,0.24
1432,2021-01-12,PAT,507,158,349,506,0,1,ITH,ITH2,4,Provincia Autonoma Trento,P.A. Trento,541380,422108,77.97,0.09
1433,2021-03-19,PAT,2424,915,1509,1492,853,79,ITH,ITH2,4,Provincia Autonoma Trento,P.A. Trento,541380,424532,78.42,0.45
1434,2021-04-05,PAT,35,17,18,30,2,3,ITH,ITH2,4,Provincia Autonoma Trento,P.A. Trento,541380,424567,78.42,0.01
1435,2021-01-05,PAT,712,234,478,712,0,0,ITH,ITH2,4,Provincia Autonoma Trento,P.A. Trento,541380,425279,78.55,0.13
1436,2021-04-15,PAT,3203,1444,1759,2811,154,238,ITH,ITH2,4,Provincia Autonoma Trento,P.A. Trento,541380,428482,79.15,0.59
1437,2021-06-18,PAT,6943,3693,3250,1746,5110,87,ITH,ITH2,4,Provincia Autonoma Trento,P.A. Trento,541380,435425,80.43,1.28
1438,2021-03-27,PAT,1621,711,910,1288,258,75,ITH,ITH2,4,Provincia Autonoma Trento,P.A. Trento,541380,437046,80.73,0.3
1439,2021-02-19,PAT,930,359,571,839,59,32,ITH,ITH2,4,Provincia Autonoma Trento,P.A. Trento,541380,437976,80.9,0.17
1440,2021-07-02,PAT,7173,3900,3273,3423,3528,222,ITH,ITH2,4,Provincia Autonoma Trento,P.A. Trento,541380,445149,82.22,1.32
1441,2021-01-15,PAT,597,132,465,596,0,1,ITH,ITH2,4,Provincia Autonoma Trento,P.A. Trento,541380,445746,82.34,0.11
1442,2021-05-20,PAT,5020,2360,2660,3107,1637,276,ITH,ITH2,4,Provincia Autonoma Trento,P.A. Trento,541380,450766,83.26,0.93
1443,2021-03-24,PAT,2380,940,1440,1447,820,113,ITH,ITH2,4,Provincia Autonoma Trento,P.A. Trento,541380,453146,83.7,0.44
1444,2021-02-09,PAT,919,288,631,442,476,1,ITH,ITH2,4,Provincia Autonoma Trento,P.A. Trento,541380,454065,83.87,0.17
1445,2021-03-17,PAT,2072,792,1280,1120,872,80,ITH,ITH2,4,Provincia Autonoma Trento,P.A. Trento,541380,456137,84.25,0.38
1446,2021-02-02,PAT,911,240,671,191,720,0,ITH,ITH2,4,Provincia Autonoma Trento,P.A. Trento,541380,457048,84.42,0.17
1447,2021-07-09,PAT,4924,2617,2307,2874,1840,210,ITH,ITH2,4,Provincia Autonoma Trento,P.A. Trento,541380,461972,85.33,0.91
1448,2021-05-13,PAT,3410,1580,1830,2088,1104,218,ITH,ITH2,4,Provincia Autonoma Trento,P.A. Trento,541380,465382,85.96,0.63
1449,2021-03-31,PAT,2588,983,1605,1632,859,97,ITH,ITH2,4,Provincia Autonoma Trento,P.A. Trento,541380,467970,86.44,0.48
1450,2021-01-26,PAT,543,154,389,27,516,0,ITH,ITH2,4,Provincia Autonoma Trento,P.A. Trento,541380,468513,86.54,0.1
1451,2021-05-06,PAT,5537,2743,2794,4389,780,368,ITH,ITH2,4,Provincia Autonoma Trento,P.A. Trento,541380,474050,87.56,1.02
1452,2021-06-20,PAT,1871,1035,836,28,1838,5,ITH,ITH2,4,Provincia Autonoma Trento,P.A. Trento,541380,475921,87.91,0.35
1453,2021-01-02,PAT,504,143,361,504,0,0,ITH,ITH2,4,Provincia Autonoma Trento,P.A. Trento,541380,476425,88.0,0.09
1454,2021-03-29,PAT,2495,968,1527,1640,735,120,ITH,ITH2,4,Provincia Autonoma Trento,P.A. Trento,541380,478920,88.46,0.46
1455,2021-04-12,PAT,3088,1411,1677,2469,497,122,ITH,ITH2,4,Provincia Autonoma Trento,P.A. Trento,541380,482008,89.03,0.57
1456,2021-01-21,PAT,353,95,258,229,124,0,ITH,ITH2,4,Provincia Autonoma Trento,P.A. Trento,541380,482361,89.1,0.07
1457,2021-06-04,PAT,5838,2610,3228,1716,4001,121,ITH,ITH2,4,Provincia Autonoma Trento,P.A. Trento,541380,488199,90.18,1.08
1458,2021-02-24,PAT,1326,525,801,906,399,21,ITH,ITH2,4,Provincia Autonoma Trento,P.A. Trento,541380,489525,90.42,0.24
1459,2021-06-03,PAT,4775,2238,2537,1210,3473,92,ITH,ITH2,4,Provincia Autonoma Trento,P.A. Trento,541380,494300,91.3,0.88
1460,2021-01-19,PAT,408,78,330,408,0,0,ITH,ITH2,4,Provincia Autonoma Trento,P.A. Trento,541380,494708,91.38,0.08
1461,2021-05-01,PAT,4854,2471,2383,4530,36,288,ITH,ITH2,4,Provincia Autonoma Trento,P.A. Trento,541380,499562,92.28,0.9
1462,2021-02-21,PAT,156,93,63,43,113,0,ITH,ITH2,4,Provincia Autonoma Trento,P.A. Trento,541380,499718,92.3,0.03
1463,2021-05-15,PAT,1570,815,755,638,891,41,ITH,ITH2,4,Provincia Autonoma Trento,P.A. Trento,541380,501288,92.59,0.29
1464,2021-06-01,PAT,4020,1879,2141,1054,2860,106,ITH,ITH2,4,Provincia Autonoma Trento,P.A. Trento,541380,505308,93.34,0.74
1465,2021-07-23,PAT,4452,2293,2159,1518,2819,115,ITH,ITH2,4,Provincia Autonoma Trento,P.A. Trento,541380,509760,94.16,0.82
1466,2021-03-10,PAT,2411,929,1482,1426,927,58,ITH,ITH2,4,Provincia Autonoma Trento,P.A. Trento,541380,512171,94.6,0.45
1467,2021-02-08,PAT,1153,319,834,342,811,0,ITH,ITH2,4,Provincia Autonoma Trento,P.A. Trento,541380,513324,94.82,0.21
1468,2021-07-17,PAT,1050,510,540,253,780,17,ITH,ITH2,4,Provincia Autonoma Trento,P.A. Trento,541380,514374,95.01,0.19
1469,2021-05-21,PAT,5067,2425,2642,3082,1719,266,ITH,ITH2,4,Provincia Autonoma Trento,P.A. Trento,541380,519441,95.95,0.94
1470,2021-02-01,PAT,1226,339,887,92,1134,0,ITH,ITH2,4,Provincia Autonoma Trento,P.A. Trento,541380,520667,96.17,0.23
1471,2021-02-03,PAT,847,315,532,414,433,0,ITH,ITH2,4,Provincia Autonoma Trento,P.A. Trento,541380,521514,96.33,0.16
1472,2021-07-19,PAT,4613,2418,2195,1349,3145,119,ITH,ITH2,4,Provincia Autonoma Trento,P.A. Trento,541380,526127,97.18,0.85
1473,2021-05-23,PAT,1958,995,963,420,1510,28,ITH,ITH2,4,Provincia Autonoma Trento,P.A. Trento,541380,528085,97.54,0.36
1474,2021-04-10,PAT,2825,1323,1502,1950,797,78,ITH,ITH2,4,Provincia Autonoma Trento,P.A. Trento,541380,530910,98.07,0.52
1475,2021-02-10,PAT,854,291,563,511,342,1,ITH,ITH2,4,Provincia Autonoma Trento,P.A. Trento,541380,531764,98.22,0.16
1476,2021-07-26,PAT,3740,1970,1770,774,2907,59,ITH,ITH2,4,Provincia Autonoma Trento,P.A. Trento,541380,535504,98.91,0.69
1477,2021-04-08,PAT,3143,1317,1826,1932,1119,92,ITH,ITH2,4,Provincia Autonoma Trento,P.A. Trento,541380,538647,99.5,0.58
1478,2020-12-31,PAT,1629,450,1179,1629,0,0,ITH,ITH2,4,Provincia Autonoma Trento,P.A. Trento,541380,540276,99.8,0.3
1479,2021-06-22,PAT,6212,3390,2822,3494,2531,187,ITH,ITH2,4,Provincia Autonoma Trento,P.A. Trento,541380,546488,100.94,1.15
1480,2021-03-05,PAT,2249,704,1545,1591,566,92,ITH,ITH2,4,Provincia Autonoma Trento,P.A. Trento,541380,548737,101.36,0.42
1481,2021-01-07,PAT,1272,310,962,1269,0,3,ITH,ITH2,4,Provincia Autonoma Trento,P.A. Trento,541380,550009,101.59,0.23
1482,2021-04-17,PAT,2233,1139,1094,2073,57,103,ITH,ITH2,4,Provincia Autonoma Trento,P.A. Trento,541380,552242,102.01,0.41
1483,2021-04-19,PAT,2625,1235,1390,2419,22,184,ITH,ITH2,4,Provincia Autonoma Trento,P.A. Trento,541380,554867,102.49,0.48
1484,2021-07-28,PAT,4589,2498,2091,1971,2503,115,ITH,ITH2,4,Provincia Autonoma Trento,P.A. Trento,541380,559456,103.34,0.85
1485,2021-06-15,PAT,6243,3285,2958,1603,4512,128,ITH,ITH2,4,Provincia Autonoma Trento,P.A. Trento,541380,565699,104.49,1.15
1486,2021-06-27,MOL,2366,1121,1245,1128,1228,10,ITF,ITF2,14,Molise,Molise,305617,2366,0.77,0.77
1487,2021-01-07,MOL,598,209,389,598,0,0,ITF,ITF2,14,Molise,Molise,305617,2964,0.97,0.2
1488,2021-02-12,MOL,333,150,183,208,124,1,ITF,ITF2,14,Molise,Molise,305617,3297,1.08,0.11
1489,2021-05-01,MOL,2651,1271,1380,407,2225,19,ITF,ITF2,14,Molise,Molise,305617,5948,1.95,0.87
1490,2021-03-05,MOL,1220,649,571,1002,205,13,ITF,ITF2,14,Molise,Molise,305617,7168,2.35,0.4
1491,2021-06-13,MOL,2865,1529,1336,2505,326,34,ITF,ITF2,14,Molise,Molise,305617,10033,3.28,0.94
1492,2021-04-17,MOL,3056,1502,1554,1542,1488,26,ITF,ITF2,14,Molise,Molise,305617,13089,4.28,1.0
1493,2021-06-20,MOL,422,174,248,47,371,4,ITF,ITF2,14,Molise,Molise,305617,13511,4.42,0.14
1494,2021-04-24,MOL,2551,1202,1349,695,1841,15,ITF,ITF2,14,Molise,Molise,305617,16062,5.26,0.83
1495,2021-02-26,MOL,563,260,303,489,73,1,ITF,ITF2,14,Molise,Molise,305617,16625,5.44,0.18
1496,2021-06-06,MOL,2065,1063,1002,1725,323,17,ITF,ITF2,14,Molise,Molise,305617,18690,6.12,0.68
1497,2021-03-24,MOL,1631,658,973,1214,402,15,ITF,ITF2,14,Molise,Molise,305617,20321,6.65,0.53
1498,2021-07-02,MOL,2631,1277,1354,121,2502,8,ITF,ITF2,14,Molise,Molise,305617,22952,7.51,0.86
1499,2021-07-04,MOL,2150,1085,1065,577,1550,23,ITF,ITF2,14,Molise,Molise,305617,25102,8.21,0.7
1500,2021-01-12,MOL,336,114,222,336,0,0,ITF,ITF2,14,Molise,Molise,305617,25438,8.32,0.11
1501,2021-02-24,MOL,667,279,388,325,334,8,ITF,ITF2,14,Molise,Molise,305617,26105,8.54,0.22
1502,2021-02-07,MOL,66,32,34,19,47,0,ITF,ITF2,14,Molise,Molise,305617,26171,8.56,0.02
1503,2021-05-18,MOL,1645,877,768,984,655,6,ITF,ITF2,14,Molise,Molise,305617,27816,9.1,0.54
1504,2021-03-22,MOL,1149,441,708,889,244,16,ITF,ITF2,14,Molise,Molise,305617,28965,9.48,0.38
1505,2021-07-23,MOL,2847,1481,1366,813,1980,54,ITF,ITF2,14,Molise,Molise,305617,31812,10.41,0.93
1506,2021-02-19,MOL,169,93,76,167,2,0,ITF,ITF2,14,Molise,Molise,305617,31981,10.46,0.06
1507,2021-03-10,MOL,1737,720,1017,1666,50,21,ITF,ITF2,14,Molise,Molise,305617,33718,11.03,0.57
1508,2021-06-01,MOL,2600,1322,1278,2457,108,35,ITF,ITF2,14,Molise,Molise,305617,36318,11.88,0.85
1509,2021-01-26,MOL,450,184,266,8,442,0,ITF,ITF2,14,Molise,Molise,305617,36768,12.03,0.15
1510,2021-05-06,MOL,2683,1214,1469,2044,600,39,ITF,ITF2,14,Molise,Molise,305617,39451,12.91,0.88
1511,2021-07-28,MOL,1988,1056,932,1036,929,23,ITF,ITF2,14,Molise,Molise,305617,41439,13.56,0.65
1512,2021-07-14,MOL,3399,1662,1737,194,3189,16,ITF,ITF2,14,Molise,Molise,305617,44838,14.67,1.11
1513,2021-04-05,MOL,391,189,202,292,99,0,ITF,ITF2,14,Molise,Molise,305617,45229,14.8,0.13
1514,2021-03-29,MOL,2033,835,1198,1518,486,29,ITF,ITF2,14,Molise,Molise,305617,47262,15.46,0.67
1515,2021-01-31,MOL,268,70,198,6,262,0,ITF,ITF2,14,Molise,Molise,305617,47530,15.55,0.09
1516,2021-03-03,MOL,672,316,356,586,82,4,ITF,ITF2,14,Molise,Molise,305617,48202,15.77,0.22
1517,2021-01-05,MOL,449,180,269,449,0,0,ITF,ITF2,14,Molise,Molise,305617,48651,15.92,0.15
1518,2021-03-15,MOL,832,338,494,570,245,17,ITF,ITF2,14,Molise,Molise,305617,49483,16.19,0.27
1519,2021-06-24,MOL,3327,1549,1778,433,2858,36,ITF,ITF2,14,Molise,Molise,305617,52810,17.28,1.09
1520,2021-03-02,MOL,667,383,284,503,158,6,ITF,ITF2,14,Molise,Molise,305617,53477,17.5,0.22
1521,2021-06-10,MOL,2571,1182,1389,1233,1301,37,ITF,ITF2,14,Molise,Molise,305617,56048,18.34,0.84
1522,2021-03-19,MOL,1184,482,702,740,427,17,ITF,ITF2,14,Molise,Molise,305617,57232,18.73,0.39
1523,2021-01-21,MOL,6,2,4,6,0,0,ITF,ITF2,14,Molise,Molise,305617,57238,18.73,0.0
1524,2021-01-17,MOL,78,38,40,48,30,0,ITF,ITF2,14,Molise,Molise,305617,57316,18.75,0.03
1525,2021-04-10,MOL,2641,1262,1379,2454,152,35,ITF,ITF2,14,Molise,Molise,305617,59957,19.62,0.86
1526,2021-02-05,MOL,593,269,324,55,538,0,ITF,ITF2,14,Molise,Molise,305617,60550,19.81,0.19
1527,2021-01-19,MOL,173,63,110,162,11,0,ITF,ITF2,14,Molise,Molise,305617,60723,19.87,0.06
1528,2021-04-29,MOL,2240,1147,1093,878,1348,14,ITF,ITF2,14,Molise,Molise,305617,62963,20.6,0.73
1529,2021-04-12,MOL,1299,557,742,1037,251,11,ITF,ITF2,14,Molise,Molise,305617,64262,21.03,0.43
1530,2021-07-21,MOL,1368,690,678,559,793,16,ITF,ITF2,14,Molise,Molise,305617,65630,21.47,0.45
1531,2021-05-20,MOL,2662,1371,1291,2398,186,78,ITF,ITF2,14,Molise,Molise,305617,68292,22.35,0.87
1532,2021-05-25,MOL,1964,888,1076,1299,631,34,ITF,ITF2,14,Molise,Molise,305617,70256,22.99,0.64
1533,2021-01-04,MOL,314,131,183,314,0,0,ITF,ITF2,14,Molise,Molise,305617,70570,23.09,0.1
1534,2021-04-14,MOL,1806,767,1039,1135,661,10,ITF,ITF2,14,Molise,Molise,305617,72376,23.68,0.59
1535,2021-02-16,MOL,156,70,86,149,6,1,ITF,ITF2,14,Molise,Molise,305617,72532,23.73,0.05
1536,2021-05-27,MOL,2835,1348,1487,1962,836,37,ITF,ITF2,14,Molise,Molise,305617,75367,24.66,0.93
1537,2021-05-13,MOL,3039,1410,1629,2529,457,53,ITF,ITF2,14,Molise,Molise,305617,78406,25.65,0.99
1538,2021-04-28,MOL,1697,925,772,471,1219,7,ITF,ITF2,14,Molise,Molise,305617,80103,26.21,0.56
1539,2021-07-16,MOL,2983,1513,1470,379,2576,28,ITF,ITF2,14,Molise,Molise,305617,83086,27.19,0.98
1540,2021-07-09,MOL,3436,1649,1787,166,3252,18,ITF,ITF2,14,Molise,Molise,305617,86522,28.31,1.12
1541,2021-03-17,MOL,908,385,523,518,332,58,ITF,ITF2,14,Molise,Molise,305617,87430,28.61,0.3
1542,2021-06-25,MOL,3433,1689,1744,1466,1915,52,ITF,ITF2,14,Molise,Molise,305617,90863,29.73,1.12
1543,2021-06-08,MOL,2896,1600,1296,2197,696,3,ITF,ITF2,14,Molise,Molise,305617,93759,30.68,0.95
1544,2021-07-06,MOL,3061,1428,1633,37,3020,4,ITF,ITF2,14,Molise,Molise,305617,96820,31.68,1.0
1545,2021-05-10,MOL,2894,1286,1608,2493,373,28,ITF,ITF2,14,Molise,Molise,305617,99714,32.63,0.95
1546,2021-06-29,MOL,2492,1160,1332,378,2088,26,ITF,ITF2,14,Molise,Molise,305617,102206,33.44,0.82
1547,2021-05-03,MOL,2488,1168,1320,2292,163,33,ITF,ITF2,14,Molise,Molise,305617,104694,34.26,0.81
1548,2021-05-17,MOL,2229,1092,1137,1706,496,27,ITF,ITF2,14,Molise,Molise,305617,106923,34.99,0.73
1549,2021-03-21,MOL,1247,543,704,477,768,2,ITF,ITF2,14,Molise,Molise,305617,108170,35.39,0.41
1550,2021-04-02,MOL,1456,710,746,663,778,15,ITF,ITF2,14,Molise,Molise,305617,109626,35.87,0.48
1551,2021-07-11,MOL,2455,1196,1259,179,2273,3,ITF,ITF2,14,Molise,Molise,305617,112081,36.67,0.8
1552,2021-05-08,MOL,2978,1456,1522,1700,1244,34,ITF,ITF2,14,Molise,Molise,305617,115059,37.65,0.97
1553,2021-04-21,MOL,1872,792,1080,970,896,6,ITF,ITF2,14,Molise,Molise,305617,116931,38.26,0.61
1554,2021-07-30,MOL,2332,1205,1127,1295,989,48,ITF,ITF2,14,Molise,Molise,305617,119263,39.02,0.76
1555,2021-03-07,MOL,1132,501,631,1127,2,3,ITF,ITF2,14,Molise,Molise,305617,120395,39.39,0.37
1556,2021-06-15,MOL,2215,1042,1173,748,1451,16,ITF,ITF2,14,Molise,Molise,305617,122610,40.12,0.72
1557,2021-06-17,MOL,2309,1018,1291,912,1370,27,ITF,ITF2,14,Molise,Molise,305617,124919,40.87,0.76
1558,2021-03-26,MOL,2575,1045,1530,1889,642,44,ITF,ITF2,14,Molise,Molise,305617,127494,41.72,0.84
1559,2021-02-18,MOL,319,74,245,302,13,4,ITF,ITF2,14,Molise,Molise,305617,127813,41.82,0.1
1560,2021-03-09,MOL,1329,579,750,1149,152,28,ITF,ITF2,14,Molise,Molise,305617,129142,42.26,0.43
1561,2021-02-20,MOL,1019,442,577,999,20,0,ITF,ITF2,14,Molise,Molise,305617,130161,42.59,0.33
1562,2021-05-31,MOL,2370,1151,1219,1903,426,41,ITF,ITF2,14,Molise,Molise,305617,132531,43.37,0.78
1563,2021-05-14,MOL,2644,1215,1429,1890,718,36,ITF,ITF2,14,Molise,Molise,305617,135175,44.23,0.87
1564,2021-06-02,MOL,2810,1356,1454,2691,99,20,ITF,ITF2,14,Molise,Molise,305617,137985,45.15,0.92
1565,2021-02-21,MOL,574,227,347,572,2,0,ITF,ITF2,14,Molise,Molise,305617,138559,45.34,0.19
1566,2021-02-04,MOL,759,295,464,77,682,0,ITF,ITF2,14,Molise,Molise,305617,139318,45.59,0.25
1567,2021-05-15,MOL,2980,1398,1582,2545,384,51,ITF,ITF2,14,Molise,Molise,305617,142298,46.56,0.98
1568,2021-02-02,MOL,540,176,364,216,323,1,ITF,ITF2,14,Molise,Molise,305617,142838,46.74,0.18
1569,2021-01-16,MOL,422,166,256,422,0,0,ITF,ITF2,14,Molise,Molise,305617,143260,46.88,0.14
1570,2021-01-28,MOL,613,217,396,17,596,0,ITF,ITF2,14,Molise,Molise,305617,143873,47.08,0.2
1571,2021-03-12,MOL,1459,637,822,1404,36,19,ITF,ITF2,14,Molise,Molise,305617,145332,47.55,0.48
1572,2021-01-14,MOL,647,239,408,647,0,0,ITF,ITF2,14,Molise,Molise,305617,145979,47.77,0.21
1573,2021-03-14,MOL,596,240,356,17,579,0,ITF,ITF2,14,Molise,Molise,305617,146575,47.96,0.2
1574,2021-06-22,MOL,2961,1368,1593,669,2275,17,ITF,ITF2,14,Molise,Molise,305617,149536,48.93,0.97
1575,2021-03-28,MOL,1628,749,879,519,1102,7,ITF,ITF2,14,Molise,Molise,305617,151164,49.46,0.53
1576,2021-01-30,MOL,461,158,303,12,449,0,ITF,ITF2,14,Molise,Molise,305617,151625,49.61,0.15
1577,2021-02-06,MOL,430,179,251,29,401,0,ITF,ITF2,14,Molise,Molise,305617,152055,49.75,0.14
1578,2021-03-31,MOL,2193,919,1274,1307,819,67,ITF,ITF2,14,Molise,Molise,305617,154248,50.47,0.72
1579,2021-02-23,MOL,585,223,362,362,221,2,ITF,ITF2,14,Molise,Molise,305617,154833,50.66,0.19
1580,2021-06-03,MOL,3295,1568,1727,2707,555,33,ITF,ITF2,14,Molise,Molise,305617,158128,51.74,1.08
1581,2021-04-07,MOL,1688,847,841,1368,275,45,ITF,ITF2,14,Molise,Molise,305617,159816,52.29,0.55
1582,2021-06-05,MOL,2984,1514,1470,2795,162,27,ITF,ITF2,14,Molise,Molise,305617,162800,53.27,0.98
1583,2021-07-18,MOL,1664,828,836,122,1533,9,ITF,ITF2,14,Molise,Molise,305617,164464,53.81,0.54
1584,2021-03-04,MOL,851,417,434,514,325,12,ITF,ITF2,14,Molise,Molise,305617,165315,54.09,0.28
1585,2021-06-12,MOL,3450,1779,1671,3274,124,52,ITF,ITF2,14,Molise,Molise,305617,168765,55.22,1.13
1586,2021-01-09,MOL,450,152,298,450,0,0,ITF,ITF2,14,Molise,Molise,305617,169215,55.37,0.15
1587,2021-04-19,MOL,1828,843,985,988,778,62,ITF,ITF2,14,Molise,Molise,305617,171043,55.97,0.6
1588,2021-07-13,MOL,2803,1424,1379,318,2468,17,ITF,ITF2,14,Molise,Molise,305617,173846,56.88,0.92
1589,2021-07-19,MOL,2721,1328,1393,503,2191,27,ITF,ITF2,14,Molise,Molise,305617,176567,57.77,0.89
1590,2021-02-03,MOL,736,251,485,342,394,0,ITF,ITF2,14,Molise,Molise,305617,177303,58.01,0.24
1591,2021-06-14,MOL,1634,811,823,542,1075,17,ITF,ITF2,14,Molise,Molise,305617,178937,58.55,0.53
1592,2021-01-20,MOL,18,8,10,18,0,0,ITF,ITF2,14,Molise,Molise,305617,178955,58.56,0.01
1593,2021-04-30,MOL,2941,1558,1383,819,2109,13,ITF,ITF2,14,Molise,Molise,305617,181896,59.52,0.96
1594,2021-02-25,MOL,542,239,303,471,68,3,ITF,ITF2,14,Molise,Molise,305617,182438,59.69,0.18
1595,2021-02-28,MOL,833,335,498,789,42,2,ITF,ITF2,14,Molise,Molise,305617,183271,59.97,0.27
1596,2021-02-27,MOL,1368,570,798,1344,19,5,ITF,ITF2,14,Molise,Molise,305617,184639,60.42,0.45
1597,2021-06-07,MOL,1954,859,1095,1113,819,22,ITF,ITF2,14,Molise,Molise,305617,186593,61.05,0.64
1598,2021-02-13,MOL,132,80,52,132,0,0,ITF,ITF2,14,Molise,Molise,305617,186725,61.1,0.04
1599,2021-05-24,MOL,1964,853,1111,1271,666,27,ITF,ITF2,14,Molise,Molise,305617,188689,61.74,0.64
1600,2021-05-07,MOL,2644,1228,1416,2021,598,25,ITF,ITF2,14,Molise,Molise,305617,191333,62.61,0.87
1601,2021-05-26,MOL,1551,699,852,770,754,27,ITF,ITF2,14,Molise,Molise,305617,192884,63.11,0.51
1602,2021-03-30,MOL,2003,857,1146,1472,512,19,ITF,ITF2,14,Molise,Molise,305617,194887,63.77,0.66
1603,2021-02-01,MOL,562,201,361,14,548,0,ITF,ITF2,14,Molise,Molise,305617,195449,63.95,0.18
1604,2021-07-08,MOL,3427,1649,1778,107,3297,23,ITF,ITF2,14,Molise,Molise,305617,198876,65.07,1.12
1605,2021-05-12,MOL,2855,1295,1560,2693,97,65,ITF,ITF2,14,Molise,Molise,305617,201731,66.01,0.93
1606,2021-02-11,MOL,295,133,162,258,37,0,ITF,ITF2,14,Molise,Molise,305617,202026,66.1,0.1
1607,2021-05-22,MOL,1323,717,606,1231,84,8,ITF,ITF2,14,Molise,Molise,305617,203349,66.54,0.43
1608,2021-04-26,MOL,1158,521,637,810,331,17,ITF,ITF2,14,Molise,Molise,305617,204507,66.92,0.38
1609,2021-04-09,MOL,2325,1252,1073,2106,191,28,ITF,ITF2,14,Molise,Molise,305617,206832,67.68,0.76
1610,2021-01-18,MOL,115,48,67,115,0,0,ITF,ITF2,14,Molise,Molise,305617,206947,67.71,0.04
1611,2021-04-11,MOL,1196,591,605,1168,14,14,ITF,ITF2,14,Molise,Molise,305617,208143,68.11,0.39
1612,2021-07-20,MOL,2163,1094,1069,1009,1107,47,ITF,ITF2,14,Molise,Molise,305617,210306,68.81,0.71
1613,2021-07-03,MOL,2741,1380,1361,567,2154,20,ITF,ITF2,14,Molise,Molise,305617,213047,69.71,0.9
1614,2021-07-22,MOL,1638,813,825,741,861,36,ITF,ITF2,14,Molise,Molise,305617,214685,70.25,0.54
1615,2021-01-29,MOL,422,136,286,6,416,0,ITF,ITF2,14,Molise,Molise,305617,215107,70.38,0.14
1616,2021-05-09,MOL,2056,934,1122,1925,97,34,ITF,ITF2,14,Molise,Molise,305617,217163,71.06,0.67
1617,2021-07-07,MOL,2959,1368,1591,57,2898,4,ITF,ITF2,14,Molise,Molise,305617,220122,72.03,0.97
1618,2021-05-11,MOL,3211,1415,1796,2911,252,48,ITF,ITF2,14,Molise,Molise,305617,223333,73.08,1.05
1619,2021-06-04,MOL,3058,1499,1559,2574,457,27,ITF,ITF2,14,Molise,Molise,305617,226391,74.08,1.0
1620,2021-04-08,MOL,1767,904,863,1540,202,25,ITF,ITF2,14,Molise,Molise,305617,228158,74.65,0.58
1621,2021-07-17,MOL,2845,1520,1325,292,2531,22,ITF,ITF2,14,Molise,Molise,305617,231003,75.59,0.93
1622,2021-04-22,MOL,1847,864,983,1060,779,8,ITF,ITF2,14,Molise,Molise,305617,232850,76.19,0.6
1623,2021-04-18,MOL,1084,484,600,143,935,6,ITF,ITF2,14,Molise,Molise,305617,233934,76.54,0.35
1624,2021-07-27,MOL,1865,1024,841,1284,522,59,ITF,ITF2,14,Molise,Molise,305617,235799,77.16,0.61
1625,2021-07-10,MOL,3721,1781,1940,321,3386,14,ITF,ITF2,14,Molise,Molise,305617,239520,78.37,1.22
1626,2021-04-04,MOL,253,141,112,233,15,5,ITF,ITF2,14,Molise,Molise,305617,239773,78.46,0.08
1627,2021-03-18,MOL,1157,476,681,633,465,59,ITF,ITF2,14,Molise,Molise,305617,240930,78.83,0.38
1628,2021-06-26,MOL,3120,1529,1591,524,2581,15,ITF,ITF2,14,Molise,Molise,305617,244050,79.85,1.02
1629,2021-02-10,MOL,151,79,72,131,20,0,ITF,ITF2,14,Molise,Molise,305617,244201,79.9,0.05
1630,2021-02-17,MOL,72,32,40,50,15,7,ITF,ITF2,14,Molise,Molise,305617,244273,79.93,0.02
1631,2021-07-24,MOL,3126,1679,1447,726,2371,29,ITF,ITF2,14,Molise,Molise,305617,247399,80.95,1.02
1632,2021-05-28,MOL,2651,1365,1286,2038,547,66,ITF,ITF2,14,Molise,Molise,305617,250050,81.82,0.87
1633,2021-06-11,MOL,3450,1657,1793,1975,1432,43,ITF,ITF2,14,Molise,Molise,305617,253500,82.95,1.13
1634,2021-04-15,MOL,1929,794,1135,1078,846,5,ITF,ITF2,14,Molise,Molise,305617,255429,83.58,0.63
1635,2021-04-27,MOL,1598,770,828,445,1131,22,ITF,ITF2,14,Molise,Molise,305617,257027,84.1,0.52
1636,2021-05-16,MOL,1248,572,676,1046,182,20,ITF,ITF2,14,Molise,Molise,305617,258275,84.51,0.41
1637,2021-03-25,MOL,1806,730,1076,1284,497,25,ITF,ITF2,14,Molise,Molise,305617,260081,85.1,0.59
1638,2021-03-08,MOL,1380,523,857,1203,140,37,ITF,ITF2,14,Molise,Molise,305617,261461,85.55,0.45
1639,2021-06-16,MOL,2009,1017,992,1136,859,14,ITF,ITF2,14,Molise,Molise,305617,263470,86.21,0.66
1640,2021-04-13,MOL,1632,718,914,1037,587,8,ITF,ITF2,14,Molise,Molise,305617,265102,86.74,0.53
1641,2021-03-27,MOL,2744,1273,1471,1295,1433,16,ITF,ITF2,14,Molise,Molise,305617,267846,87.64,0.9
1642,2021-07-05,MOL,2739,1282,1457,39,2698,2,ITF,ITF2,14,Molise,Molise,305617,270585,88.54,0.9
1643,2021-06-18,MOL,2768,1249,1519,1283,1458,27,ITF,ITF2,14,Molise,Molise,305617,273353,89.44,0.91
1644,2021-05-30,MOL,1864,929,935,1552,285,27,ITF,ITF2,14,Molise,Molise,305617,275217,90.05,0.61
1645,2021-03-16,MOL,615,230,385,265,348,2,ITF,ITF2,14,Molise,Molise,305617,275832,90.25,0.2
1646,2021-01-11,MOL,557,194,363,557,0,0,ITF,ITF2,14,Molise,Molise,305617,276389,90.44,0.18
1647,2021-07-29,MOL,2048,1042,1006,1411,605,32,ITF,ITF2,14,Molise,Molise,305617,278437,91.11,0.67
1648,2021-01-22,MOL,128,36,92,128,0,0,ITF,ITF2,14,Molise,Molise,305617,278565,91.15,0.04
1649,2021-05-02,MOL,1894,932,962,577,1306,11,ITF,ITF2,14,Molise,Molise,305617,280459,91.77,0.62
1650,2021-03-06,MOL,1728,807,921,1559,159,10,ITF,ITF2,14,Molise,Molise,305617,282187,92.33,0.57
1651,2021-04-06,MOL,1495,702,793,1132,343,20,ITF,ITF2,14,Molise,Molise,305617,283682,92.82,0.49
1652,2021-02-08,MOL,335,141,194,216,119,0,ITF,ITF2,14,Molise,Molise,305617,284017,92.93,0.11
1653,2021-07-15,MOL,3211,1614,1597,209,2988,14,ITF,ITF2,14,Molise,Molise,305617,287228,93.98,1.05
1654,2021-05-19,MOL,2347,1206,1141,1881,429,37,ITF,ITF2,14,Molise,Molise,305617,289575,94.75,0.77
1655,2021-03-23,MOL,1643,695,948,1411,208,24,ITF,ITF2,14,Molise,Molise,305617,291218,95.29,0.54
1656,2021-07-01,MOL,2661,1294,1367,270,2376,15,ITF,ITF2,14,Molise,Molise,305617,293879,96.16,0.87
1657,2021-07-26,MOL,2421,1248,1173,1249,1112,60,ITF,ITF2,14,Molise,Molise,305617,296300,96.95,0.79
1658,2021-02-15,MOL,144,70,74,141,3,0,ITF,ITF2,14,Molise,Molise,305617,296444,97.0,0.05
1659,2021-02-22,MOL,265,129,136,248,15,2,ITF,ITF2,14,Molise,Molise,305617,296709,97.09,0.09
1660,2020-12-27,MOL,50,20,30,50,0,0,ITF,ITF2,14,Molise,Molise,305617,296759,97.1,0.02
1661,2021-05-21,MOL,2102,1055,1047,1700,323,79,ITF,ITF2,14,Molise,Molise,305617,298861,97.79,0.69
1662,2021-01-27,MOL,675,251,424,8,667,0,ITF,ITF2,14,Molise,Molise,305617,299536,98.01,0.22
1663,2021-01-08,MOL,430,141,289,430,0,0,ITF,ITF2,14,Molise,Molise,305617,299966,98.15,0.14
1664,2021-04-01,MOL,1470,667,803,730,726,14,ITF,ITF2,14,Molise,Molise,305617,301436,98.63,0.48
1665,2021-01-25,MOL,319,130,189,3,316,0,ITF,ITF2,14,Molise,Molise,305617,301755,98.74,0.1
1666,2021-05-05,MOL,2419,1043,1376,2252,143,24,ITF,ITF2,14,Molise,Molise,305617,304174,99.53,0.79
1667,2021-05-04,MOL,2706,1181,1525,2546,128,32,ITF,ITF2,14,Molise,Molise,305617,306880,100.41,0.89
1668,2021-01-10,MOL,270,72,198,270,0,0,ITF,ITF2,14,Molise,Molise,305617,307150,100.5,0.09
1669,2021-04-20,MOL,2323,1029,1294,1213,1101,9,ITF,ITF2,14,Molise,Molise,305617,309473,101.26,0.76
1670,2021-06-09,MOL,1779,893,886,822,928,29,ITF,ITF2,14,Molise,Molise,305617,311252,101.84,0.58
1671,2021-05-23,MOL,1705,867,838,1691,6,8,ITF,ITF2,14,Molise,Molise,305617,312957,102.4,0.56
1672,2021-03-01,MOL,662,274,388,430,215,17,ITF,ITF2,14,Molise,Molise,305617,313619,102.62,0.22
1673,2021-04-03,MOL,1773,851,922,1716,35,22,ITF,ITF2,14,Molise,Molise,305617,315392,103.2,0.58
1674,2021-07-12,MOL,2671,1318,1353,353,2297,21,ITF,ITF2,14,Molise,Molise,305617,318063,104.07,0.87
1675,2021-07-25,MOL,2003,1055,948,353,1636,14,ITF,ITF2,14,Molise,Molise,305617,320066,104.73,0.66
1676,2021-05-29,MOL,2355,1226,1129,1925,390,40,ITF,ITF2,14,Molise,Molise,305617,322421,105.5,0.77
1677,2021-02-09,MOL,359,170,189,197,162,0,ITF,ITF2,14,Molise,Molise,305617,322780,105.62,0.12
1678,2021-03-11,MOL,1465,637,828,1445,6,14,ITF,ITF2,14,Molise,Molise,305617,324245,106.1,0.48
1679,2021-01-06,MOL,690,260,430,690,0,0,ITF,ITF2,14,Molise,Molise,305617,324935,106.32,0.23
1680,2021-04-16,MOL,2431,1033,1398,1176,1233,22,ITF,ITF2,14,Molise,Molise,305617,327366,107.12,0.8
1681,2021-06-21,MOL,2902,1350,1552,1624,1232,46,ITF,ITF2,14,Molise,Molise,305617,330268,108.07,0.95
1682,2021-04-25,MOL,794,397,397,557,233,4,ITF,ITF2,14,Molise,Molise,305617,331062,108.33,0.26
1683,2021-01-13,MOL,475,161,314,475,0,0,ITF,ITF2,14,Molise,Molise,305617,331537,108.48,0.16
1684,2021-06-19,MOL,2345,1166,1179,1280,1023,42,ITF,ITF2,14,Molise,Molise,305617,333882,109.25,0.77
1685,2021-04-23,MOL,2052,882,1170,1375,661,16,ITF,ITF2,14,Molise,Molise,305617,335934,109.92,0.67
1686,2021-06-30,MOL,2966,1408,1558,873,2011,82,ITF,ITF2,14,Molise,Molise,305617,338900,110.89,0.97
1687,2021-03-13,MOL,1189,594,595,183,989,17,ITF,ITF2,14,Molise,Molise,305617,340089,111.28,0.39
1688,2021-01-15,MOL,538,242,296,538,0,0,ITF,ITF2,14,Molise,Molise,305617,340627,111.46,0.18
1689,2021-06-23,MOL,2792,1287,1505,221,2561,10,ITF,ITF2,14,Molise,Molise,305617,343419,112.37,0.91
1690,2021-03-20,MOL,2323,970,1353,993,1322,8,ITF,ITF2,14,Molise,Molise,305617,345742,113.13,0.76
1691,2021-06-28,MOL,2904,1354,1550,999,1884,21,ITF,ITF2,14,Molise,Molise,305617,348646,114.08,0.95
1692,2021-03-24,MAR,7081,3009,4072,3297,3716,68,ITI,ITI3,11,Marche,Marche,1525271,7081,0.46,0.46
1693,2021-06-01,MAR,12057,6158,5899,9683,2090,284,ITI,ITI3,11,Marche,Marche,1525271,19138,1.25,0.79
1694,2021-03-10,MAR,5710,2440,3270,4480,1178,52,ITI,ITI3,11,Marche,Marche,1525271,24848,1.63,0.37
1695,2021-02-21,MAR,376,141,235,363,1,12,ITI,ITI3,11,Marche,Marche,1525271,25224,1.65,0.02
1696,2021-06-15,MAR,13195,6568,6627,9826,3052,317,ITI,ITI3,11,Marche,Marche,1525271,38419,2.52,0.87
1697,2021-01-12,MAR,1231,417,814,1218,0,13,ITI,ITI3,11,Marche,Marche,1525271,39650,2.6,0.08
1698,2021-06-22,MAR,13220,6483,6737,6476,6461,283,ITI,ITI3,11,Marche,Marche,1525271,52870,3.47,0.87
1699,2021-04-26,MAR,9170,4062,5108,6023,3022,125,ITI,ITI3,11,Marche,Marche,1525271,62040,4.07,0.6
1700,2021-01-26,MAR,2021,747,1274,77,1935,9,ITI,ITI3,11,Marche,Marche,1525271,64061,4.2,0.13
1701,2021-07-11,MAR,10398,5220,5178,1606,8656,136,ITI,ITI3,11,Marche,Marche,1525271,74459,4.88,0.68
1702,2021-04-19,MAR,9603,4498,5105,7902,1581,120,ITI,ITI3,11,Marche,Marche,1525271,84062,5.51,0.63
1703,2021-07-28,MAR,14197,7370,6827,3252,10714,231,ITI,ITI3,11,Marche,Marche,1525271,98259,6.44,0.93
1704,2021-01-21,MAR,919,261,658,574,328,17,ITI,ITI3,11,Marche,Marche,1525271,99178,6.5,0.06
1705,2021-05-01,MAR,9319,3924,5395,3500,5743,76,ITI,ITI3,11,Marche,Marche,1525271,108497,7.11,0.61
1706,2021-03-05,MAR,6225,2873,3352,4694,1468,63,ITI,ITI3,11,Marche,Marche,1525271,114722,7.52,0.41
1707,2021-05-27,MAR,13732,6817,6915,9180,4301,251,ITI,ITI3,11,Marche,Marche,1525271,128454,8.42,0.9
1708,2021-03-31,MAR,7374,3087,4287,4268,3023,83,ITI,ITI3,11,Marche,Marche,1525271,135828,8.91,0.48
1709,2021-07-09,MAR,14898,7500,7398,2556,12128,214,ITI,ITI3,11,Marche,Marche,1525271,150726,9.88,0.98
1710,2021-04-05,MAR,5702,2367,3335,4357,1269,76,ITI,ITI3,11,Marche,Marche,1525271,156428,10.26,0.37
1711,2021-06-27,MAR,9950,4820,5130,4487,5292,171,ITI,ITI3,11,Marche,Marche,1525271,166378,10.91,0.65
1712,2021-03-19,MAR,3881,1621,2260,325,3544,12,ITI,ITI3,11,Marche,Marche,1525271,170259,11.16,0.25
1713,2021-03-17,MAR,3477,1525,1952,105,3370,2,ITI,ITI3,11,Marche,Marche,1525271,173736,11.39,0.23
1714,2021-05-15,MAR,14113,6437,7676,7831,6037,245,ITI,ITI3,11,Marche,Marche,1525271,187849,12.32,0.93
1715,2021-02-19,MAR,2002,739,1263,1826,135,41,ITI,ITI3,11,Marche,Marche,1525271,189851,12.45,0.13
1716,2021-05-20,MAR,12681,5960,6721,7534,4896,251,ITI,ITI3,11,Marche,Marche,1525271,202532,13.28,0.83
1717,2021-02-07,MAR,1872,735,1137,332,1528,12,ITI,ITI3,11,Marche,Marche,1525271,204404,13.4,0.12
1718,2021-07-23,MAR,15538,8277,7261,2529,12785,224,ITI,ITI3,11,Marche,Marche,1525271,219942,14.42,1.02
1719,2021-01-07,MAR,1812,637,1175,1796,0,16,ITI,ITI3,11,Marche,Marche,1525271,221754,14.54,0.12
1720,2021-03-12,MAR,4682,2000,2682,3347,1280,55,ITI,ITI3,11,Marche,Marche,1525271,226436,14.85,0.31
1721,2021-01-14,MAR,2015,695,1320,1991,0,24,ITI,ITI3,11,Marche,Marche,1525271,228451,14.98,0.13
1722,2021-06-20,MAR,11160,5547,5613,5993,4985,182,ITI,ITI3,11,Marche,Marche,1525271,239611,15.71,0.73
1723,2021-04-24,MAR,12166,5363,6803,7559,4464,143,ITI,ITI3,11,Marche,Marche,1525271,251777,16.51,0.8
1724,2021-01-19,MAR,233,87,146,140,90,3,ITI,ITI3,11,Marche,Marche,1525271,252010,16.52,0.02
1725,2021-02-02,MAR,1193,398,795,71,1122,0,ITI,ITI3,11,Marche,Marche,1525271,253203,16.6,0.08
1726,2021-05-13,MAR,12607,5696,6911,6828,5502,277,ITI,ITI3,11,Marche,Marche,1525271,265810,17.43,0.83
1727,2021-04-12,MAR,8566,3772,4794,7937,482,147,ITI,ITI3,11,Marche,Marche,1525271,274376,17.99,0.56
1728,2021-01-02,MAR,457,142,315,455,0,2,ITI,ITI3,11,Marche,Marche,1525271,274833,18.02,0.03
1729,2021-03-07,MAR,5180,2107,3073,4379,754,47,ITI,ITI3,11,Marche,Marche,1525271,280013,18.36,0.34
1730,2021-01-23,MAR,557,190,367,119,435,3,ITI,ITI3,11,Marche,Marche,1525271,280570,18.39,0.04
1731,2021-06-29,MAR,13370,6599,6771,4927,8216,227,ITI,ITI3,11,Marche,Marche,1525271,293940,19.27,0.88
1732,2021-05-03,MAR,10408,4690,5718,4863,5411,134,ITI,ITI3,11,Marche,Marche,1525271,304348,19.95,0.68
1733,2021-03-28,MAR,4125,1739,2386,2396,1691,38,ITI,ITI3,11,Marche,Marche,1525271,308473,20.22,0.27
1734,2021-02-14,MAR,739,301,438,727,0,12,ITI,ITI3,11,Marche,Marche,1525271,309212,20.27,0.05
1735,2021-05-08,MAR,12279,5479,6800,4857,7252,170,ITI,ITI3,11,Marche,Marche,1525271,321491,21.08,0.81
1736,2021-07-30,MAR,14645,7829,6816,4809,9550,286,ITI,ITI3,11,Marche,Marche,1525271,336136,22.04,0.96
1737,2021-01-09,MAR,1717,606,1111,1697,0,20,ITI,ITI3,11,Marche,Marche,1525271,337853,22.15,0.11
1738,2021-03-29,MAR,5894,2581,3313,3392,2455,47,ITI,ITI3,11,Marche,Marche,1525271,343747,22.54,0.39
1739,2021-06-03,MAR,14634,7482,7152,12077,2252,305,ITI,ITI3,11,Marche,Marche,1525271,358381,23.5,0.96
1740,2021-02-18,MAR,2144,785,1359,1808,287,49,ITI,ITI3,11,Marche,Marche,1525271,360525,23.64,0.14
1741,2021-05-29,MAR,12860,6233,6627,8114,4528,218,ITI,ITI3,11,Marche,Marche,1525271,373385,24.48,0.84
1742,2021-02-28,MAR,2836,1251,1585,2822,6,8,ITI,ITI3,11,Marche,Marche,1525271,376221,24.67,0.19
1743,2021-06-08,MAR,14097,7094,7003,11197,2609,291,ITI,ITI3,11,Marche,Marche,1525271,390318,25.59,0.92
1744,2021-03-02,MAR,5002,1967,3035,4371,566,65,ITI,ITI3,11,Marche,Marche,1525271,395320,25.92,0.33
1745,2021-06-10,MAR,14930,7695,7235,12575,2013,342,ITI,ITI3,11,Marche,Marche,1525271,410250,26.9,0.98
1746,2021-07-18,MAR,12125,6310,5815,1336,10671,118,ITI,ITI3,11,Marche,Marche,1525271,422375,27.69,0.79
1747,2021-01-31,MAR,1920,772,1148,95,1821,4,ITI,ITI3,11,Marche,Marche,1525271,424295,27.82,0.13
1748,2021-04-07,MAR,8187,3621,4566,7719,347,121,ITI,ITI3,11,Marche,Marche,1525271,432482,28.35,0.54
1749,2021-02-09,MAR,125,42,83,46,79,0,ITI,ITI3,11,Marche,Marche,1525271,432607,28.36,0.01
1750,2021-07-16,MAR,15838,8238,7600,1845,13735,258,ITI,ITI3,11,Marche,Marche,1525271,448445,29.4,1.04
1751,2021-06-12,MAR,13775,7312,6463,12105,1339,331,ITI,ITI3,11,Marche,Marche,1525271,462220,30.3,0.9
1752,2021-04-16,MAR,10082,4702,5380,9361,525,196,ITI,ITI3,11,Marche,Marche,1525271,472302,30.97,0.66
1753,2021-07-04,MAR,10894,5444,5450,3203,7529,162,ITI,ITI3,11,Marche,Marche,1525271,483196,31.68,0.71
1754,2020-12-31,MAR,392,184,208,390,0,2,ITI,ITI3,11,Marche,Marche,1525271,483588,31.71,0.03
1755,2021-02-04,MAR,2388,845,1543,107,2276,5,ITI,ITI3,11,Marche,Marche,1525271,485976,31.86,0.16
1756,2021-02-26,MAR,3677,1523,2154,3097,476,104,ITI,ITI3,11,Marche,Marche,1525271,489653,32.1,0.24
1757,2021-05-12,MAR,10429,4691,5738,4736,5503,190,ITI,ITI3,11,Marche,Marche,1525271,500082,32.79,0.68
1758,2021-07-08,MAR,15040,7539,7501,2789,12026,225,ITI,ITI3,11,Marche,Marche,1525271,515122,33.77,0.99
1759,2021-07-01,MAR,14687,7366,7321,4658,9750,279,ITI,ITI3,11,Marche,Marche,1525271,529809,34.74,0.96
1760,2021-07-06,MAR,13962,6920,7042,3142,10597,223,ITI,ITI3,11,Marche,Marche,1525271,543771,35.65,0.92
1761,2021-07-20,MAR,14397,7435,6962,1772,12451,174,ITI,ITI3,11,Marche,Marche,1525271,558168,36.59,0.94
1762,2021-01-16,MAR,2037,734,1303,1987,0,50,ITI,ITI3,11,Marche,Marche,1525271,560205,36.73,0.13
1763,2021-06-19,MAR,14695,7404,7291,7752,6678,265,ITI,ITI3,11,Marche,Marche,1525271,574900,37.69,0.96
1764,2021-04-02,MAR,6886,2983,3903,6039,739,108,ITI,ITI3,11,Marche,Marche,1525271,581786,38.14,0.45
1765,2021-03-16,MAR,3520,1522,1998,285,3229,6,ITI,ITI3,11,Marche,Marche,1525271,585306,38.37,0.23
1766,2021-06-24,MAR,13830,6671,7159,6188,7371,271,ITI,ITI3,11,Marche,Marche,1525271,599136,39.28,0.91
1767,2021-01-11,MAR,1179,413,766,1161,0,18,ITI,ITI3,11,Marche,Marche,1525271,600315,39.36,0.08
1768,2021-04-21,MAR,10785,4968,5817,9437,1194,154,ITI,ITI3,11,Marche,Marche,1525271,611100,40.07,0.71
1769,2021-01-28,MAR,2087,725,1362,163,1923,1,ITI,ITI3,11,Marche,Marche,1525271,613187,40.2,0.14
1770,2021-04-04,MAR,3835,1797,2038,2617,1169,49,ITI,ITI3,11,Marche,Marche,1525271,617022,40.45,0.25
1771,2021-07-13,MAR,14854,7278,7576,1459,13265,130,ITI,ITI3,11,Marche,Marche,1525271,631876,41.43,0.97
1772,2021-06-09,MAR,14279,7417,6862,12108,1869,302,ITI,ITI3,11,Marche,Marche,1525271,646155,42.36,0.94
1773,2021-06-07,MAR,13320,6588,6732,10567,2450,303,ITI,ITI3,11,Marche,Marche,1525271,659475,43.24,0.87
1774,2021-02-27,MAR,3401,1457,1944,3158,209,34,ITI,ITI3,11,Marche,Marche,1525271,662876,43.46,0.22
1775,2021-03-18,MAR,3438,1505,1933,150,3276,12,ITI,ITI3,11,Marche,Marche,1525271,666314,43.68,0.23
1776,2021-06-26,MAR,13575,6905,6670,5689,7669,217,ITI,ITI3,11,Marche,Marche,1525271,679889,44.57,0.89
1777,2021-05-23,MAR,9209,4283,4926,7413,1672,124,ITI,ITI3,11,Marche,Marche,1525271,689098,45.18,0.6
1778,2021-05-24,MAR,10996,5192,5804,7956,2863,177,ITI,ITI3,11,Marche,Marche,1525271,700094,45.9,0.72
1779,2021-05-22,MAR,11937,5719,6218,7318,4448,171,ITI,ITI3,11,Marche,Marche,1525271,712031,46.68,0.78
1780,2021-02-11,MAR,1987,657,1330,1557,389,41,ITI,ITI3,11,Marche,Marche,1525271,714018,46.81,0.13
1781,2021-05-05,MAR,11691,5320,6371,5105,6429,157,ITI,ITI3,11,Marche,Marche,1525271,725709,47.58,0.77
1782,2021-01-30,MAR,1905,668,1237,25,1880,0,ITI,ITI3,11,Marche,Marche,1525271,727614,47.7,0.12
1783,2021-05-10,MAR,9453,4338,5115,4771,4554,128,ITI,ITI3,11,Marche,Marche,1525271,737067,48.32,0.62
1784,2021-03-14,MAR,2499,1032,1467,1897,592,10,ITI,ITI3,11,Marche,Marche,1525271,739566,48.49,0.16
1785,2021-03-21,MAR,4505,1873,2632,1614,2876,15,ITI,ITI3,11,Marche,Marche,1525271,744071,48.78,0.3
1786,2021-02-15,MAR,967,412,555,939,13,15,ITI,ITI3,11,Marche,Marche,1525271,745038,48.85,0.06
1787,2021-05-26,MAR,11889,5952,5937,8449,3226,214,ITI,ITI3,11,Marche,Marche,1525271,756927,49.63,0.78
1788,2021-03-30,MAR,7474,3075,4399,4579,2823,72,ITI,ITI3,11,Marche,Marche,1525271,764401,50.12,0.49
1789,2021-02-01,MAR,1362,479,883,93,1266,3,ITI,ITI3,11,Marche,Marche,1525271,765763,50.21,0.09
1790,2021-04-06,MAR,8874,3692,5182,7930,810,134,ITI,ITI3,11,Marche,Marche,1525271,774637,50.79,0.58
1791,2021-03-23,MAR,5839,2556,3283,2227,3576,36,ITI,ITI3,11,Marche,Marche,1525271,780476,51.17,0.38
1792,2021-02-08,MAR,833,258,575,366,462,5,ITI,ITI3,11,Marche,Marche,1525271,781309,51.22,0.05
1793,2021-07-15,MAR,16008,8286,7722,1750,14030,228,ITI,ITI3,11,Marche,Marche,1525271,797317,52.27,1.05
1794,2021-05-19,MAR,11661,5363,6298,8368,3097,196,ITI,ITI3,11,Marche,Marche,1525271,808978,53.04,0.76
1795,2021-07-25,MAR,9348,4931,4417,1004,8247,97,ITI,ITI3,11,Marche,Marche,1525271,818326,53.65,0.61
1796,2021-01-04,MAR,1518,573,945,1506,0,12,ITI,ITI3,11,Marche,Marche,1525271,819844,53.75,0.1
1797,2021-04-14,MAR,10216,4565,5651,9662,370,184,ITI,ITI3,11,Marche,Marche,1525271,830060,54.42,0.67
1798,2020-12-30,MAR,17,5,12,17,0,0,ITI,ITI3,11,Marche,Marche,1525271,830077,54.42,0.0
1799,2021-04-09,MAR,9572,4191,5381,9159,200,213,ITI,ITI3,11,Marche,Marche,1525271,839649,55.05,0.63
1800,2021-07-27,MAR,14352,7527,6825,3022,11104,226,ITI,ITI3,11,Marche,Marche,1525271,854001,55.99,0.94
1801,2021-01-06,MAR,2208,803,1405,2189,0,19,ITI,ITI3,11,Marche,Marche,1525271,856209,56.13,0.14
1802,2021-03-04,MAR,6539,2894,3645,5084,1395,60,ITI,ITI3,11,Marche,Marche,1525271,862748,56.56,0.43
1803,2021-03-13,MAR,5806,2681,3125,1765,4001,40,ITI,ITI3,11,Marche,Marche,1525271,868554,56.94,0.38
1804,2021-06-21,MAR,12605,6184,6421,5482,6877,246,ITI,ITI3,11,Marche,Marche,1525271,881159,57.77,0.83
1805,2021-05-09,MAR,8864,4021,4843,3559,5228,77,ITI,ITI3,11,Marche,Marche,1525271,890023,58.35,0.58
1806,2021-01-18,MAR,696,237,459,536,149,11,ITI,ITI3,11,Marche,Marche,1525271,890719,58.4,0.05
1807,2021-04-28,MAR,10928,4979,5949,6026,4733,169,ITI,ITI3,11,Marche,Marche,1525271,901647,59.11,0.72
1808,2021-03-26,MAR,6388,2626,3762,3476,2855,57,ITI,ITI3,11,Marche,Marche,1525271,908035,59.53,0.42
1809,2021-06-17,MAR,15200,7562,7638,8804,6100,296,ITI,ITI3,11,Marche,Marche,1525271,923235,60.53,1.0
1810,2021-05-06,MAR,12655,5822,6833,5363,7071,221,ITI,ITI3,11,Marche,Marche,1525271,935890,61.36,0.83
1811,2021-02-12,MAR,1581,618,963,1404,151,26,ITI,ITI3,11,Marche,Marche,1525271,937471,61.46,0.1
1812,2021-02-10,MAR,1440,452,988,1039,359,42,ITI,ITI3,11,Marche,Marche,1525271,938911,61.56,0.09
1813,2021-03-06,MAR,5737,2641,3096,4423,1267,47,ITI,ITI3,11,Marche,Marche,1525271,944648,61.93,0.38
1814,2021-06-14,MAR,12838,6486,6352,9259,3309,270,ITI,ITI3,11,Marche,Marche,1525271,957486,62.77,0.84
1815,2021-03-09,MAR,5431,2293,3138,4465,881,85,ITI,ITI3,11,Marche,Marche,1525271,962917,63.13,0.36
1816,2021-07-22,MAR,15747,8047,7700,2019,13487,241,ITI,ITI3,11,Marche,Marche,1525271,978664,64.16,1.03
1817,2021-04-13,MAR,9840,4260,5580,9412,233,195,ITI,ITI3,11,Marche,Marche,1525271,988504,64.81,0.65
1818,2021-07-05,MAR,13165,6507,6658,2919,10074,172,ITI,ITI3,11,Marche,Marche,1525271,1001669,65.67,0.86
1819,2021-06-16,MAR,13757,6914,6843,9129,4365,263,ITI,ITI3,11,Marche,Marche,1525271,1015426,66.57,0.9
1820,2021-02-06,MAR,2462,901,1561,512,1941,9,ITI,ITI3,11,Marche,Marche,1525271,1017888,66.73,0.16
1821,2021-07-17,MAR,15136,7792,7344,1384,13541,211,ITI,ITI3,11,Marche,Marche,1525271,1033024,67.73,0.99
1822,2021-05-21,MAR,13901,6590,7311,7226,6464,211,ITI,ITI3,11,Marche,Marche,1525271,1046925,68.64,0.91
1823,2021-05-31,MAR,11781,5944,5837,8600,2929,252,ITI,ITI3,11,Marche,Marche,1525271,1058706,69.41,0.77
1824,2021-05-17,MAR,12046,5649,6397,7472,4354,220,ITI,ITI3,11,Marche,Marche,1525271,1070752,70.2,0.79
1825,2021-04-30,MAR,14151,6199,7952,5403,8561,187,ITI,ITI3,11,Marche,Marche,1525271,1084903,71.13,0.93
1826,2021-04-11,MAR,7117,3116,4001,6692,287,138,ITI,ITI3,11,Marche,Marche,1525271,1092020,71.6,0.47
1827,2021-05-07,MAR,12831,5799,7032,3574,9179,78,ITI,ITI3,11,Marche,Marche,1525271,1104851,72.44,0.84
1828,2021-02-13,MAR,1092,461,631,987,82,23,ITI,ITI3,11,Marche,Marche,1525271,1105943,72.51,0.07
1829,2021-01-27,MAR,2119,779,1340,115,2002,2,ITI,ITI3,11,Marche,Marche,1525271,1108062,72.65,0.14
1830,2021-04-20,MAR,10754,5029,5725,9154,1470,130,ITI,ITI3,11,Marche,Marche,1525271,1118816,73.35,0.71
1831,2021-07-29,MAR,14096,7477,6619,4305,9494,297,ITI,ITI3,11,Marche,Marche,1525271,1132912,74.28,0.92
1832,2021-01-25,MAR,1596,558,1038,92,1504,0,ITI,ITI3,11,Marche,Marche,1525271,1134508,74.38,0.1
1833,2021-01-08,MAR,1582,592,990,1567,0,15,ITI,ITI3,11,Marche,Marche,1525271,1136090,74.48,0.1
1834,2021-04-18,MAR,8824,4131,4693,7735,921,168,ITI,ITI3,11,Marche,Marche,1525271,1144914,75.06,0.58
1835,2021-01-29,MAR,1994,731,1263,159,1830,5,ITI,ITI3,11,Marche,Marche,1525271,1146908,75.19,0.13
1836,2021-05-18,MAR,11268,5347,5921,7489,3601,178,ITI,ITI3,11,Marche,Marche,1525271,1158176,75.93,0.74
1837,2021-04-17,MAR,11704,5316,6388,10399,1073,232,ITI,ITI3,11,Marche,Marche,1525271,1169880,76.7,0.77
1838,2021-07-26,MAR,11030,5736,5294,2113,8713,204,ITI,ITI3,11,Marche,Marche,1525271,1180910,77.42,0.72
1839,2021-06-02,MAR,11900,5938,5962,11029,676,195,ITI,ITI3,11,Marche,Marche,1525271,1192810,78.2,0.78
1840,2021-02-22,MAR,3461,1532,1929,3352,75,34,ITI,ITI3,11,Marche,Marche,1525271,1196271,78.43,0.23
1841,2021-03-27,MAR,7416,3092,4324,4950,2393,73,ITI,ITI3,11,Marche,Marche,1525271,1203687,78.92,0.49
1842,2021-04-10,MAR,10929,4625,6304,10380,313,236,ITI,ITI3,11,Marche,Marche,1525271,1214616,79.63,0.72
1843,2021-01-03,MAR,912,358,554,902,0,10,ITI,ITI3,11,Marche,Marche,1525271,1215528,79.69,0.06
1844,2021-06-13,MAR,10749,5564,5185,9204,1296,249,ITI,ITI3,11,Marche,Marche,1525271,1226277,80.4,0.7
1845,2020-12-27,MAR,208,100,108,206,0,2,ITI,ITI3,11,Marche,Marche,1525271,1226485,80.41,0.01
1846,2021-06-06,MAR,12452,6137,6315,10639,1577,236,ITI,ITI3,11,Marche,Marche,1525271,1238937,81.23,0.82
1847,2021-06-11,MAR,13998,7155,6843,11372,2321,305,ITI,ITI3,11,Marche,Marche,1525271,1252935,82.15,0.92
1848,2021-05-25,MAR,11767,5798,5969,8497,3050,220,ITI,ITI3,11,Marche,Marche,1525271,1264702,82.92,0.77
1849,2021-03-01,MAR,3772,1520,2252,3503,248,21,ITI,ITI3,11,Marche,Marche,1525271,1268474,83.16,0.25
1850,2021-07-14,MAR,13854,6823,7031,1784,11879,191,ITI,ITI3,11,Marche,Marche,1525271,1282328,84.07,0.91
1851,2021-01-10,MAR,1746,702,1044,1732,0,14,ITI,ITI3,11,Marche,Marche,1525271,1284074,84.19,0.11
1852,2021-07-12,MAR,13722,6804,6918,1228,12376,118,ITI,ITI3,11,Marche,Marche,1525271,1297796,85.09,0.9
1853,2021-04-03,MAR,7574,3205,4369,6738,667,169,ITI,ITI3,11,Marche,Marche,1525271,1305370,85.58,0.5
1854,2021-06-25,MAR,14345,7172,7173,6423,7634,288,ITI,ITI3,11,Marche,Marche,1525271,1319715,86.52,0.94
1855,2021-03-11,MAR,6635,2824,3811,5148,1411,76,ITI,ITI3,11,Marche,Marche,1525271,1326350,86.96,0.44
1856,2021-03-25,MAR,6703,2794,3909,3191,3456,56,ITI,ITI3,11,Marche,Marche,1525271,1333053,87.4,0.44
1857,2021-07-03,MAR,13843,6991,6852,4136,9395,312,ITI,ITI3,11,Marche,Marche,1525271,1346896,88.31,0.91
1858,2021-02-20,MAR,4163,1733,2430,4042,111,10,ITI,ITI3,11,Marche,Marche,1525271,1351059,88.58,0.27
1859,2021-05-11,MAR,10623,4832,5791,5490,4943,190,ITI,ITI3,11,Marche,Marche,1525271,1361682,89.27,0.7
1860,2021-03-15,MAR,4450,2060,2390,1291,3138,21,ITI,ITI3,11,Marche,Marche,1525271,1366132,89.57,0.29
1861,2021-06-23,MAR,13894,6817,7077,6627,7012,255,ITI,ITI3,11,Marche,Marche,1525271,1380026,90.48,0.91
1862,2021-05-28,MAR,13957,6736,7221,8802,4857,298,ITI,ITI3,11,Marche,Marche,1525271,1393983,91.39,0.92
1863,2021-04-01,MAR,7576,3182,4394,4068,3416,92,ITI,ITI3,11,Marche,Marche,1525271,1401559,91.89,0.5
1864,2021-07-24,MAR,13273,7118,6155,2945,10071,257,ITI,ITI3,11,Marche,Marche,1525271,1414832,92.76,0.87
1865,2021-07-10,MAR,14160,7233,6927,1657,12300,203,ITI,ITI3,11,Marche,Marche,1525271,1428992,93.69,0.93
1866,2021-04-22,MAR,10799,4931,5868,9084,1579,136,ITI,ITI3,11,Marche,Marche,1525271,1439791,94.4,0.71
1867,2021-02-24,MAR,3534,1547,1987,3424,78,32,ITI,ITI3,11,Marche,Marche,1525271,1443325,94.63,0.23
1868,2021-06-04,MAR,14338,7290,7048,11590,2439,309,ITI,ITI3,11,Marche,Marche,1525271,1457663,95.57,0.94
1869,2021-04-08,MAR,8721,3815,4906,8226,348,147,ITI,ITI3,11,Marche,Marche,1525271,1466384,96.14,0.57
1870,2021-03-03,MAR,6700,3076,3624,5718,885,97,ITI,ITI3,11,Marche,Marche,1525271,1473084,96.58,0.44
1871,2021-01-05,MAR,1582,592,990,1563,0,19,ITI,ITI3,11,Marche,Marche,1525271,1474666,96.68,0.1
1872,2021-04-15,MAR,10377,4675,5702,9578,564,235,ITI,ITI3,11,Marche,Marche,1525271,1485043,97.36,0.68
1873,2021-02-17,MAR,1828,701,1127,1642,118,68,ITI,ITI3,11,Marche,Marche,1525271,1486871,97.48,0.12
1874,2021-07-19,MAR,14676,7531,7145,1927,12535,214,ITI,ITI3,11,Marche,Marche,1525271,1501547,98.44,0.96
1875,2021-03-08,MAR,6297,2759,3538,5186,1002,109,ITI,ITI3,11,Marche,Marche,1525271,1507844,98.86,0.41
1876,2021-02-05,MAR,2157,655,1502,437,1719,1,ITI,ITI3,11,Marche,Marche,1525271,1510001,99.0,0.14
1877,2021-05-16,MAR,10899,4957,5942,6551,4229,119,ITI,ITI3,11,Marche,Marche,1525271,1520900,99.71,0.71
1878,2021-05-30,MAR,9732,4690,5042,6546,2989,197,ITI,ITI3,11,Marche,Marche,1525271,1530632,100.35,0.64
1879,2021-01-20,MAR,406,100,306,384,20,2,ITI,ITI3,11,Marche,Marche,1525271,1531038,100.38,0.03
1880,2021-02-03,MAR,2126,742,1384,98,2007,21,ITI,ITI3,11,Marche,Marche,1525271,1533164,100.52,0.14
1881,2021-05-14,MAR,13633,6292,7341,6509,6912,212,ITI,ITI3,11,Marche,Marche,1525271,1546797,101.41,0.89
1882,2021-07-02,MAR,14544,7173,7371,4673,9641,230,ITI,ITI3,11,Marche,Marche,1525271,1561341,102.36,0.95
1883,2021-06-18,MAR,15353,7653,7700,8301,6752,300,ITI,ITI3,11,Marche,Marche,1525271,1576694,103.37,1.01
1884,2021-04-27,MAR,9591,4389,5202,5511,3987,93,ITI,ITI3,11,Marche,Marche,1525271,1586285,104.0,0.63
1885,2021-01-17,MAR,1622,695,927,1553,63,6,ITI,ITI3,11,Marche,Marche,1525271,1587907,104.11,0.11
1886,2021-07-21,MAR,14920,7617,7303,2064,12643,213,ITI,ITI3,11,Marche,Marche,1525271,1602827,105.08,0.98
1887,2021-04-29,MAR,13441,6154,7287,7165,6099,177,ITI,ITI3,11,Marche,Marche,1525271,1616268,105.97,0.88
1888,2021-02-16,MAR,1287,475,812,1225,30,32,ITI,ITI3,11,Marche,Marche,1525271,1617555,106.05,0.08
1889,2021-02-25,MAR,3560,1464,2096,3320,181,59,ITI,ITI3,11,Marche,Marche,1525271,1621115,106.28,0.23
1890,2021-06-05,MAR,13944,7011,6933,11520,2059,365,ITI,ITI3,11,Marche,Marche,1525271,1635059,107.2,0.91
1891,2021-04-23,MAR,11306,5218,6088,8091,3055,160,ITI,ITI3,11,Marche,Marche,1525271,1646365,107.94,0.74
1892,2021-02-23,MAR,3314,1432,1882,3243,56,15,ITI,ITI3,11,Marche,Marche,1525271,1649679,108.16,0.22
1893,2021-01-15,MAR,1772,500,1272,1755,0,17,ITI,ITI3,11,Marche,Marche,1525271,1651451,108.27,0.12
1894,2021-04-25,MAR,8600,3994,4606,6897,1575,128,ITI,ITI3,11,Marche,Marche,1525271,1660051,108.84,0.56
1895,2021-01-13,MAR,2110,746,1364,2069,0,41,ITI,ITI3,11,Marche,Marche,1525271,1662161,108.97,0.14
1896,2021-05-02,MAR,8901,3938,4963,3082,5739,80,ITI,ITI3,11,Marche,Marche,1525271,1671062,109.56,0.58
1897,2021-06-28,MAR,12353,6023,6330,4610,7506,237,ITI,ITI3,11,Marche,Marche,1525271,1683415,110.37,0.81
1898,2021-03-22,MAR,5701,2410,3291,2482,3175,44,ITI,ITI3,11,Marche,Marche,1525271,1689116,110.74,0.37
1899,2021-01-24,MAR,882,340,542,4,878,0,ITI,ITI3,11,Marche,Marche,1525271,1689998,110.8,0.06
1900,2021-06-30,MAR,13649,6664,6985,4452,8986,211,ITI,ITI3,11,Marche,Marche,1525271,1703647,111.69,0.89
1901,2021-05-04,MAR,10974,4840,6134,4928,5905,141,ITI,ITI3,11,Marche,Marche,1525271,1714621,112.41,0.72
1902,2021-03-20,MAR,4178,1759,2419,1035,3129,14,ITI,ITI3,11,Marche,Marche,1525271,1718799,112.69,0.27
1903,2021-01-22,MAR,489,168,321,193,294,2,ITI,ITI3,11,Marche,Marche,1525271,1719288,112.72,0.03
1904,2021-07-07,MAR,14257,7068,7189,2937,11080,240,ITI,ITI3,11,Marche,Marche,1525271,1733545,113.65,0.93
1905,2021-03-28,FVG,4940,2355,2585,4688,158,94,ITH,ITH4,6,Friuli-Venezia Giulia,Friuli Venezia Giulia,1215220,4940,0.41,0.41
1906,2021-01-18,FVG,1962,606,1356,1868,94,0,ITH,ITH4,6,Friuli-Venezia Giulia,Friuli Venezia Giulia,1215220,6902,0.57,0.16
1907,2021-01-04,FVG,1507,558,949,1507,0,0,ITH,ITH4,6,Friuli-Venezia Giulia,Friuli Venezia Giulia,1215220,8409,0.69,0.12
1908,2021-02-06,FVG,1154,338,816,21,1132,1,ITH,ITH4,6,Friuli-Venezia Giulia,Friuli Venezia Giulia,1215220,9563,0.79,0.09
1909,2021-02-23,FVG,2643,1277,1366,2457,180,6,ITH,ITH4,6,Friuli-Venezia Giulia,Friuli Venezia Giulia,1215220,12206,1.0,0.22
1910,2021-07-20,FVG,9119,4758,4361,2306,6509,304,ITH,ITH4,6,Friuli-Venezia Giulia,Friuli Venezia Giulia,1215220,21325,1.75,0.75
1911,2021-04-11,FVG,3432,1518,1914,2416,906,110,ITH,ITH4,6,Friuli-Venezia Giulia,Friuli Venezia Giulia,1215220,24757,2.04,0.28
1912,2021-06-07,FVG,9207,4772,4435,7849,994,364,ITH,ITH4,6,Friuli-Venezia Giulia,Friuli Venezia Giulia,1215220,33964,2.79,0.76
1913,2021-05-31,FVG,8907,4426,4481,6470,2190,247,ITH,ITH4,6,Friuli-Venezia Giulia,Friuli Venezia Giulia,1215220,42871,3.53,0.73
1914,2021-07-27,FVG,9205,4608,4597,2421,6546,238,ITH,ITH4,6,Friuli-Venezia Giulia,Friuli Venezia Giulia,1215220,52076,4.29,0.76
1915,2021-01-30,FVG,2278,745,1533,270,2008,0,ITH,ITH4,6,Friuli-Venezia Giulia,Friuli Venezia Giulia,1215220,54354,4.47,0.19
1916,2021-07-13,FVG,10955,5644,5311,1067,9732,156,ITH,ITH4,6,Friuli-Venezia Giulia,Friuli Venezia Giulia,1215220,65309,5.37,0.9
1917,2021-06-26,FVG,10271,5232,5039,4103,6154,14,ITH,ITH4,6,Friuli-Venezia Giulia,Friuli Venezia Giulia,1215220,75580,6.22,0.85
1918,2021-02-18,FVG,3220,1494,1726,2794,408,18,ITH,ITH4,6,Friuli-Venezia Giulia,Friuli Venezia Giulia,1215220,78800,6.48,0.26
1919,2021-04-02,FVG,6596,2928,3668,4635,1838,123,ITH,ITH4,6,Friuli-Venezia Giulia,Friuli Venezia Giulia,1215220,85396,7.03,0.54
1920,2021-04-16,FVG,6965,3027,3938,4908,1926,131,ITH,ITH4,6,Friuli-Venezia Giulia,Friuli Venezia Giulia,1215220,92361,7.6,0.57
1921,2021-01-06,FVG,716,265,451,716,0,0,ITH,ITH4,6,Friuli-Venezia Giulia,Friuli Venezia Giulia,1215220,93077,7.66,0.06
1922,2021-06-24,FVG,11086,5653,5433,1891,9089,106,ITH,ITH4,6,Friuli-Venezia Giulia,Friuli Venezia Giulia,1215220,104163,8.57,0.91
1923,2021-03-16,FVG,3188,1300,1888,1024,2082,82,ITH,ITH4,6,Friuli-Venezia Giulia,Friuli Venezia Giulia,1215220,107351,8.83,0.26
1924,2021-05-12,FVG,10904,5053,5851,9083,1418,403,ITH,ITH4,6,Friuli-Venezia Giulia,Friuli Venezia Giulia,1215220,118255,9.73,0.9
1925,2021-05-24,FVG,11443,5536,5907,7524,3622,297,ITH,ITH4,6,Friuli-Venezia Giulia,Friuli Venezia Giulia,1215220,129698,10.67,0.94
1926,2021-02-13,FVG,566,179,387,558,6,2,ITH,ITH4,6,Friuli-Venezia Giulia,Friuli Venezia Giulia,1215220,130264,10.72,0.05
1927,2021-03-02,FVG,4222,1519,2703,2701,1500,21,ITH,ITH4,6,Friuli-Venezia Giulia,Friuli Venezia Giulia,1215220,134486,11.07,0.35
1928,2021-03-04,FVG,3453,1599,1854,2764,660,29,ITH,ITH4,6,Friuli-Venezia Giulia,Friuli Venezia Giulia,1215220,137939,11.35,0.28
1929,2021-06-12,FVG,8212,4708,3504,6803,1160,249,ITH,ITH4,6,Friuli-Venezia Giulia,Friuli Venezia Giulia,1215220,146151,12.03,0.68
1930,2021-03-21,FVG,2674,1002,1672,2215,409,50,ITH,ITH4,6,Friuli-Venezia Giulia,Friuli Venezia Giulia,1215220,148825,12.25,0.22
1931,2021-07-08,FVG,12935,6993,5942,1287,11450,198,ITH,ITH4,6,Friuli-Venezia Giulia,Friuli Venezia Giulia,1215220,161760,13.31,1.06
1932,2021-02-04,FVG,2726,808,1918,35,2691,0,ITH,ITH4,6,Friuli-Venezia Giulia,Friuli Venezia Giulia,1215220,164486,13.54,0.22
1933,2021-04-30,FVG,7369,3254,4115,3541,3658,170,ITH,ITH4,6,Friuli-Venezia Giulia,Friuli Venezia Giulia,1215220,171855,14.14,0.61
1934,2021-04-28,FVG,7319,3234,4085,3682,3502,135,ITH,ITH4,6,Friuli-Venezia Giulia,Friuli Venezia Giulia,1215220,179174,14.74,0.6
1935,2021-01-23,FVG,814,323,491,4,810,0,ITH,ITH4,6,Friuli-Venezia Giulia,Friuli Venezia Giulia,1215220,179988,14.81,0.07
1936,2021-05-05,FVG,9786,4273,5513,6073,3471,242,ITH,ITH4,6,Friuli-Venezia Giulia,Friuli Venezia Giulia,1215220,189774,15.62,0.81
1937,2021-02-11,FVG,1931,664,1267,1735,193,3,ITH,ITH4,6,Friuli-Venezia Giulia,Friuli Venezia Giulia,1215220,191705,15.78,0.16
1938,2021-04-09,FVG,7921,3661,4260,6498,1250,173,ITH,ITH4,6,Friuli-Venezia Giulia,Friuli Venezia Giulia,1215220,199626,16.43,0.65
1939,2020-12-30,FVG,626,244,382,626,0,0,ITH,ITH4,6,Friuli-Venezia Giulia,Friuli Venezia Giulia,1215220,200252,16.48,0.05
1940,2021-06-05,FVG,10318,5333,4985,8410,1549,359,ITH,ITH4,6,Friuli-Venezia Giulia,Friuli Venezia Giulia,1215220,210570,17.33,0.85
1941,2021-02-25,FVG,3168,1653,1515,3108,29,31,ITH,ITH4,6,Friuli-Venezia Giulia,Friuli Venezia Giulia,1215220,213738,17.59,0.26
1942,2021-05-17,FVG,8815,4091,4724,6059,2490,266,ITH,ITH4,6,Friuli-Venezia Giulia,Friuli Venezia Giulia,1215220,222553,18.31,0.73
1943,2021-03-09,FVG,4013,1723,2290,1238,2750,25,ITH,ITH4,6,Friuli-Venezia Giulia,Friuli Venezia Giulia,1215220,226566,18.64,0.33
1944,2021-02-27,FVG,3532,1202,2330,3514,1,17,ITH,ITH4,6,Friuli-Venezia Giulia,Friuli Venezia Giulia,1215220,230098,18.93,0.29
1945,2021-04-25,FVG,2374,991,1383,2183,11,180,ITH,ITH4,6,Friuli-Venezia Giulia,Friuli Venezia Giulia,1215220,232472,19.13,0.2
1946,2021-01-15,FVG,2020,605,1415,2019,0,1,ITH,ITH4,6,Friuli-Venezia Giulia,Friuli Venezia Giulia,1215220,234492,19.3,0.17
1947,2021-04-21,FVG,7776,3469,4307,4015,3681,80,ITH,ITH4,6,Friuli-Venezia Giulia,Friuli Venezia Giulia,1215220,242268,19.94,0.64
1948,2021-01-11,FVG,1883,608,1275,1882,0,1,ITH,ITH4,6,Friuli-Venezia Giulia,Friuli Venezia Giulia,1215220,244151,20.09,0.15
1949,2021-07-15,FVG,10033,5111,4922,913,8868,252,ITH,ITH4,6,Friuli-Venezia Giulia,Friuli Venezia Giulia,1215220,254184,20.92,0.83
1950,2021-04-23,FVG,7481,3383,4098,3475,3869,137,ITH,ITH4,6,Friuli-Venezia Giulia,Friuli Venezia Giulia,1215220,261665,21.53,0.62
1951,2021-05-19,FVG,12054,5942,6112,9265,2347,442,ITH,ITH4,6,Friuli-Venezia Giulia,Friuli Venezia Giulia,1215220,273719,22.52,0.99
1952,2021-03-14,FVG,1399,551,848,1123,252,24,ITH,ITH4,6,Friuli-Venezia Giulia,Friuli Venezia Giulia,1215220,275118,22.64,0.12
1953,2021-04-08,FVG,7452,3223,4229,5401,1922,129,ITH,ITH4,6,Friuli-Venezia Giulia,Friuli Venezia Giulia,1215220,282570,23.25,0.61
1954,2021-05-21,FVG,11226,5023,6203,7907,2978,341,ITH,ITH4,6,Friuli-Venezia Giulia,Friuli Venezia Giulia,1215220,293796,24.18,0.92
1955,2021-02-10,FVG,1350,496,854,1264,86,0,ITH,ITH4,6,Friuli-Venezia Giulia,Friuli Venezia Giulia,1215220,295146,24.29,0.11
1956,2021-07-17,FVG,7261,3895,3366,553,6620,88,ITH,ITH4,6,Friuli-Venezia Giulia,Friuli Venezia Giulia,1215220,302407,24.88,0.6
1957,2021-02-01,FVG,2100,688,1412,16,2084,0,ITH,ITH4,6,Friuli-Venezia Giulia,Friuli Venezia Giulia,1215220,304507,25.06,0.17
1958,2021-01-27,FVG,1272,426,846,449,821,2,ITH,ITH4,6,Friuli-Venezia Giulia,Friuli Venezia Giulia,1215220,305779,25.16,0.1
1959,2021-05-07,FVG,10652,4879,5773,6940,3529,183,ITH,ITH4,6,Friuli-Venezia Giulia,Friuli Venezia Giulia,1215220,316431,26.04,0.88
1960,2021-05-09,FVG,7374,3314,4060,3376,3869,129,ITH,ITH4,6,Friuli-Venezia Giulia,Friuli Venezia Giulia,1215220,323805,26.65,0.61
1961,2021-01-25,FVG,1584,568,1016,194,1390,0,ITH,ITH4,6,Friuli-Venezia Giulia,Friuli Venezia Giulia,1215220,325389,26.78,0.13
1962,2021-07-01,FVG,12302,6403,5899,2581,9455,266,ITH,ITH4,6,Friuli-Venezia Giulia,Friuli Venezia Giulia,1215220,337691,27.79,1.01
1963,2021-03-23,FVG,3895,1688,2207,1734,2143,18,ITH,ITH4,6,Friuli-Venezia Giulia,Friuli Venezia Giulia,1215220,341586,28.11,0.32
1964,2021-01-16,FVG,1230,360,870,1230,0,0,ITH,ITH4,6,Friuli-Venezia Giulia,Friuli Venezia Giulia,1215220,342816,28.21,0.1
1965,2021-07-03,FVG,11388,6078,5310,1077,10157,154,ITH,ITH4,6,Friuli-Venezia Giulia,Friuli Venezia Giulia,1215220,354204,29.15,0.94
1966,2021-03-25,FVG,5535,2426,3109,3329,2138,68,ITH,ITH4,6,Friuli-Venezia Giulia,Friuli Venezia Giulia,1215220,359739,29.6,0.46
1967,2021-06-19,FVG,8540,4451,4089,1336,7139,65,ITH,ITH4,6,Friuli-Venezia Giulia,Friuli Venezia Giulia,1215220,368279,30.31,0.7
1968,2021-03-11,FVG,3480,1518,1962,1714,1752,14,ITH,ITH4,6,Friuli-Venezia Giulia,Friuli Venezia Giulia,1215220,371759,30.59,0.29
1969,2021-06-16,FVG,12168,5908,6260,3886,8022,260,ITH,ITH4,6,Friuli-Venezia Giulia,Friuli Venezia Giulia,1215220,383927,31.59,1.0
1970,2021-06-23,FVG,12072,5841,6231,1998,9938,136,ITH,ITH4,6,Friuli-Venezia Giulia,Friuli Venezia Giulia,1215220,395999,32.59,0.99
1971,2021-04-27,FVG,8134,3737,4397,3549,4487,98,ITH,ITH4,6,Friuli-Venezia Giulia,Friuli Venezia Giulia,1215220,404133,33.26,0.67
1972,2021-06-04,FVG,12069,6201,5868,10303,1388,378,ITH,ITH4,6,Friuli-Venezia Giulia,Friuli Venezia Giulia,1215220,416202,34.25,0.99
1973,2021-07-05,FVG,9520,4831,4689,1297,8075,148,ITH,ITH4,6,Friuli-Venezia Giulia,Friuli Venezia Giulia,1215220,425722,35.03,0.78
1974,2021-06-21,FVG,9200,4493,4707,1816,7245,139,ITH,ITH4,6,Friuli-Venezia Giulia,Friuli Venezia Giulia,1215220,434922,35.79,0.76
1975,2021-03-13,FVG,2943,1124,1819,1657,1273,13,ITH,ITH4,6,Friuli-Venezia Giulia,Friuli Venezia Giulia,1215220,437865,36.03,0.24
1976,2021-07-24,FVG,3868,2089,1779,1895,1864,109,ITH,ITH4,6,Friuli-Venezia Giulia,Friuli Venezia Giulia,1215220,441733,36.35,0.32
1977,2021-06-09,FVG,11324,5960,5364,9484,1395,445,ITH,ITH4,6,Friuli-Venezia Giulia,Friuli Venezia Giulia,1215220,453057,37.28,0.93
1978,2021-03-01,FVG,2960,1042,1918,2884,53,23,ITH,ITH4,6,Friuli-Venezia Giulia,Friuli Venezia Giulia,1215220,456017,37.53,0.24
1979,2021-03-18,FVG,3376,1423,1953,1683,1685,8,ITH,ITH4,6,Friuli-Venezia Giulia,Friuli Venezia Giulia,1215220,459393,37.8,0.28
1980,2021-06-28,FVG,9885,4983,4902,2171,7694,20,ITH,ITH4,6,Friuli-Venezia Giulia,Friuli Venezia Giulia,1215220,469278,38.62,0.81
1981,2021-03-20,FVG,3404,1411,1993,1299,2091,14,ITH,ITH4,6,Friuli-Venezia Giulia,Friuli Venezia Giulia,1215220,472682,38.9,0.28
1982,2021-01-13,FVG,2650,834,1816,2650,0,0,ITH,ITH4,6,Friuli-Venezia Giulia,Friuli Venezia Giulia,1215220,475332,39.11,0.22
1983,2021-04-06,FVG,6681,3135,3546,5423,1153,105,ITH,ITH4,6,Friuli-Venezia Giulia,Friuli Venezia Giulia,1215220,482013,39.66,0.55
1984,2020-12-27,FVG,262,149,113,261,0,1,ITH,ITH4,6,Friuli-Venezia Giulia,Friuli Venezia Giulia,1215220,482275,39.69,0.02
1985,2021-02-12,FVG,1193,428,765,1142,47,4,ITH,ITH4,6,Friuli-Venezia Giulia,Friuli Venezia Giulia,1215220,483468,39.78,0.1
1986,2021-05-25,FVG,12931,6392,6539,9279,3312,340,ITH,ITH4,6,Friuli-Venezia Giulia,Friuli Venezia Giulia,1215220,496399,40.85,1.06
1987,2021-06-11,FVG,10881,5936,4945,9611,835,435,ITH,ITH4,6,Friuli-Venezia Giulia,Friuli Venezia Giulia,1215220,507280,41.74,0.9
1988,2021-03-03,FVG,3646,1634,2012,2343,1275,28,ITH,ITH4,6,Friuli-Venezia Giulia,Friuli Venezia Giulia,1215220,510926,42.04,0.3
1989,2021-05-26,FVG,13435,6707,6728,9647,3442,346,ITH,ITH4,6,Friuli-Venezia Giulia,Friuli Venezia Giulia,1215220,524361,43.15,1.11
1990,2021-02-15,FVG,2455,911,1544,2195,254,6,ITH,ITH4,6,Friuli-Venezia Giulia,Friuli Venezia Giulia,1215220,526816,43.35,0.2
1991,2021-04-18,FVG,6050,2808,3242,5421,407,222,ITH,ITH4,6,Friuli-Venezia Giulia,Friuli Venezia Giulia,1215220,532866,43.85,0.5
1992,2021-01-08,FVG,2321,746,1575,2321,0,0,ITH,ITH4,6,Friuli-Venezia Giulia,Friuli Venezia Giulia,1215220,535187,44.04,0.19
1993,2021-06-14,FVG,10273,4987,5286,5182,4811,280,ITH,ITH4,6,Friuli-Venezia Giulia,Friuli Venezia Giulia,1215220,545460,44.89,0.85
1994,2021-02-20,FVG,2068,933,1135,1921,144,3,ITH,ITH4,6,Friuli-Venezia Giulia,Friuli Venezia Giulia,1215220,547528,45.06,0.17
1995,2021-01-22,FVG,89,29,60,0,89,0,ITH,ITH4,6,Friuli-Venezia Giulia,Friuli Venezia Giulia,1215220,547617,45.06,0.01
1996,2021-03-06,FVG,3500,1196,2304,3143,325,32,ITH,ITH4,6,Friuli-Venezia Giulia,Friuli Venezia Giulia,1215220,551117,45.35,0.29
1997,2021-05-04,FVG,9597,4327,5270,5993,3383,221,ITH,ITH4,6,Friuli-Venezia Giulia,Friuli Venezia Giulia,1215220,560714,46.14,0.79
1998,2021-01-24,FVG,306,120,186,1,305,0,ITH,ITH4,6,Friuli-Venezia Giulia,Friuli Venezia Giulia,1215220,561020,46.17,0.03
1999,2021-06-30,FVG,13160,6700,6460,1367,11609,184,ITH,ITH4,6,Friuli-Venezia Giulia,Friuli Venezia Giulia,1215220,574180,47.25,1.08
2000,2021-03-08,FVG,4124,1643,2481,2022,2087,15,ITH,ITH4,6,Friuli-Venezia Giulia,Friuli Venezia Giulia,1215220,578304,47.59,0.34
2001,2021-03-22,FVG,3663,1450,2213,1673,1954,36,ITH,ITH4,6,Friuli-Venezia Giulia,Friuli Venezia Giulia,1215220,581967,47.89,0.3
2002,2021-01-17,FVG,1715,522,1193,1713,0,2,ITH,ITH4,6,Friuli-Venezia Giulia,Friuli Venezia Giulia,1215220,583682,48.03,0.14
2003,2021-03-15,FVG,3951,1809,2142,1608,2321,22,ITH,ITH4,6,Friuli-Venezia Giulia,Friuli Venezia Giulia,1215220,587633,48.36,0.33
2004,2021-05-11,FVG,9136,4391,4745,7114,1806,216,ITH,ITH4,6,Friuli-Venezia Giulia,Friuli Venezia Giulia,1215220,596769,49.11,0.75
2005,2021-01-31,FVG,2721,839,1882,385,2336,0,ITH,ITH4,6,Friuli-Venezia Giulia,Friuli Venezia Giulia,1215220,599490,49.33,0.22
2006,2021-03-30,FVG,7248,3261,3987,6175,944,129,ITH,ITH4,6,Friuli-Venezia Giulia,Friuli Venezia Giulia,1215220,606738,49.93,0.6
2007,2021-07-10,FVG,8768,4518,4250,132,8608,28,ITH,ITH4,6,Friuli-Venezia Giulia,Friuli Venezia Giulia,1215220,615506,50.65,0.72
2008,2021-04-01,FVG,6423,3069,3354,5321,1015,87,ITH,ITH4,6,Friuli-Venezia Giulia,Friuli Venezia Giulia,1215220,621929,51.18,0.53
2009,2021-05-28,FVG,10620,5091,5529,6228,4116,276,ITH,ITH4,6,Friuli-Venezia Giulia,Friuli Venezia Giulia,1215220,632549,52.05,0.87
2010,2021-07-12,FVG,9946,5102,4844,1051,8736,159,ITH,ITH4,6,Friuli-Venezia Giulia,Friuli Venezia Giulia,1215220,642495,52.87,0.82
2011,2021-02-19,FVG,3258,1293,1965,2816,427,15,ITH,ITH4,6,Friuli-Venezia Giulia,Friuli Venezia Giulia,1215220,645753,53.14,0.27
2012,2021-04-13,FVG,7380,3294,4086,5652,1604,124,ITH,ITH4,6,Friuli-Venezia Giulia,Friuli Venezia Giulia,1215220,653133,53.75,0.61
2013,2021-01-03,FVG,313,123,190,313,0,0,ITH,ITH4,6,Friuli-Venezia Giulia,Friuli Venezia Giulia,1215220,653446,53.77,0.03
2014,2021-07-22,FVG,7606,4026,3580,3161,4120,325,ITH,ITH4,6,Friuli-Venezia Giulia,Friuli Venezia Giulia,1215220,661052,54.4,0.63
2015,2021-01-20,FVG,748,320,428,13,735,0,ITH,ITH4,6,Friuli-Venezia Giulia,Friuli Venezia Giulia,1215220,661800,54.46,0.06
2016,2021-05-27,FVG,12838,6147,6691,7389,5231,218,ITH,ITH4,6,Friuli-Venezia Giulia,Friuli Venezia Giulia,1215220,674638,55.52,1.06
2017,2021-07-30,FVG,8156,4192,3964,2241,5669,246,ITH,ITH4,6,Friuli-Venezia Giulia,Friuli Venezia Giulia,1215220,682794,56.19,0.67
2018,2021-04-24,FVG,6688,2952,3736,5208,1245,235,ITH,ITH4,6,Friuli-Venezia Giulia,Friuli Venezia Giulia,1215220,689482,56.74,0.55
2019,2021-06-06,FVG,9485,4628,4857,7652,1563,270,ITH,ITH4,6,Friuli-Venezia Giulia,Friuli Venezia Giulia,1215220,698967,57.52,0.78
2020,2021-02-26,FVG,3736,2094,1642,3554,148,34,ITH,ITH4,6,Friuli-Venezia Giulia,Friuli Venezia Giulia,1215220,702703,57.83,0.31
2021,2021-02-17,FVG,2360,1003,1357,1874,484,2,ITH,ITH4,6,Friuli-Venezia Giulia,Friuli Venezia Giulia,1215220,705063,58.02,0.19
2022,2021-05-30,FVG,11064,4992,6072,7230,3588,246,ITH,ITH4,6,Friuli-Venezia Giulia,Friuli Venezia Giulia,1215220,716127,58.93,0.91
2023,2021-02-22,FVG,2485,1193,1292,2063,418,4,ITH,ITH4,6,Friuli-Venezia Giulia,Friuli Venezia Giulia,1215220,718612,59.13,0.2
2024,2021-06-02,FVG,9418,4954,4464,8837,282,299,ITH,ITH4,6,Friuli-Venezia Giulia,Friuli Venezia Giulia,1215220,728030,59.91,0.78
2025,2021-02-07,FVG,1564,482,1082,384,1179,1,ITH,ITH4,6,Friuli-Venezia Giulia,Friuli Venezia Giulia,1215220,729594,60.04,0.13
2026,2021-05-18,FVG,10807,5403,5404,8357,2087,363,ITH,ITH4,6,Friuli-Venezia Giulia,Friuli Venezia Giulia,1215220,740401,60.93,0.89
2027,2021-06-01,FVG,10111,5120,4991,7701,2124,286,ITH,ITH4,6,Friuli-Venezia Giulia,Friuli Venezia Giulia,1215220,750512,61.76,0.83
2028,2021-05-06,FVG,11943,5547,6396,7697,3972,274,ITH,ITH4,6,Friuli-Venezia Giulia,Friuli Venezia Giulia,1215220,762455,62.74,0.98
2029,2021-07-02,FVG,11011,5696,5315,2020,8793,198,ITH,ITH4,6,Friuli-Venezia Giulia,Friuli Venezia Giulia,1215220,773466,63.65,0.91
2030,2021-05-02,FVG,6900,3248,3652,3802,2959,139,ITH,ITH4,6,Friuli-Venezia Giulia,Friuli Venezia Giulia,1215220,780366,64.22,0.57
2031,2021-05-16,FVG,10005,4787,5218,8361,1401,243,ITH,ITH4,6,Friuli-Venezia Giulia,Friuli Venezia Giulia,1215220,790371,65.04,0.82
2032,2021-06-18,FVG,10940,5401,5539,3394,7295,251,ITH,ITH4,6,Friuli-Venezia Giulia,Friuli Venezia Giulia,1215220,801311,65.94,0.9
2033,2021-03-10,FVG,3592,1702,1890,1741,1795,56,ITH,ITH4,6,Friuli-Venezia Giulia,Friuli Venezia Giulia,1215220,804903,66.24,0.3
2034,2021-02-24,FVG,2525,1089,1436,2496,18,11,ITH,ITH4,6,Friuli-Venezia Giulia,Friuli Venezia Giulia,1215220,807428,66.44,0.21
2035,2021-07-29,FVG,8906,4523,4383,3011,5594,301,ITH,ITH4,6,Friuli-Venezia Giulia,Friuli Venezia Giulia,1215220,816334,67.18,0.73
2036,2021-04-20,FVG,7133,3073,4060,3095,3911,127,ITH,ITH4,6,Friuli-Venezia Giulia,Friuli Venezia Giulia,1215220,823467,67.76,0.59
2037,2021-01-10,FVG,2941,918,2023,2941,0,0,ITH,ITH4,6,Friuli-Venezia Giulia,Friuli Venezia Giulia,1215220,826408,68.0,0.24
2038,2021-07-14,FVG,10788,5510,5278,1166,9420,202,ITH,ITH4,6,Friuli-Venezia Giulia,Friuli Venezia Giulia,1215220,837196,68.89,0.89
2039,2021-04-05,FVG,2896,1439,1457,2822,15,59,ITH,ITH4,6,Friuli-Venezia Giulia,Friuli Venezia Giulia,1215220,840092,69.13,0.24
2040,2021-01-12,FVG,2257,713,1544,2257,0,0,ITH,ITH4,6,Friuli-Venezia Giulia,Friuli Venezia Giulia,1215220,842349,69.32,0.19
2041,2021-01-29,FVG,2412,813,1599,264,2148,0,ITH,ITH4,6,Friuli-Venezia Giulia,Friuli Venezia Giulia,1215220,844761,69.52,0.2
2042,2021-04-22,FVG,6792,3089,3703,3034,3690,68,ITH,ITH4,6,Friuli-Venezia Giulia,Friuli Venezia Giulia,1215220,851553,70.07,0.56
2043,2021-04-03,FVG,4020,1992,2028,2625,1337,58,ITH,ITH4,6,Friuli-Venezia Giulia,Friuli Venezia Giulia,1215220,855573,70.4,0.33
2044,2021-06-10,FVG,11123,5823,5300,9713,1040,370,ITH,ITH4,6,Friuli-Venezia Giulia,Friuli Venezia Giulia,1215220,866696,71.32,0.92
2045,2021-05-03,FVG,7243,3296,3947,3339,3785,119,ITH,ITH4,6,Friuli-Venezia Giulia,Friuli Venezia Giulia,1215220,873939,71.92,0.6
2046,2021-01-14,FVG,2584,789,1795,2581,0,3,ITH,ITH4,6,Friuli-Venezia Giulia,Friuli Venezia Giulia,1215220,876523,72.13,0.21
2047,2021-05-29,FVG,12031,5851,6180,6790,4987,254,ITH,ITH4,6,Friuli-Venezia Giulia,Friuli Venezia Giulia,1215220,888554,73.12,0.99
2048,2021-07-25,FVG,3841,1998,1843,1893,1843,105,ITH,ITH4,6,Friuli-Venezia Giulia,Friuli Venezia Giulia,1215220,892395,73.43,0.32
2049,2021-07-11,FVG,6664,3497,3167,2182,4167,315,ITH,ITH4,6,Friuli-Venezia Giulia,Friuli Venezia Giulia,1215220,899059,73.98,0.55
2050,2021-06-20,FVG,6514,3230,3284,1491,4935,88,ITH,ITH4,6,Friuli-Venezia Giulia,Friuli Venezia Giulia,1215220,905573,74.52,0.54
2051,2021-03-29,FVG,7024,3127,3897,5366,1583,75,ITH,ITH4,6,Friuli-Venezia Giulia,Friuli Venezia Giulia,1215220,912597,75.1,0.58
2052,2021-07-07,FVG,11247,5762,5485,1396,9719,132,ITH,ITH4,6,Friuli-Venezia Giulia,Friuli Venezia Giulia,1215220,923844,76.02,0.93
2053,2021-07-21,FVG,8329,4233,4096,1964,6092,273,ITH,ITH4,6,Friuli-Venezia Giulia,Friuli Venezia Giulia,1215220,932173,76.71,0.69
2054,2021-05-22,FVG,11587,5203,6384,7085,4240,262,ITH,ITH4,6,Friuli-Venezia Giulia,Friuli Venezia Giulia,1215220,943760,77.66,0.95
2055,2021-07-18,FVG,5407,2924,2483,397,4985,25,ITH,ITH4,6,Friuli-Venezia Giulia,Friuli Venezia Giulia,1215220,949167,78.11,0.44
2056,2021-01-28,FVG,2242,795,1447,355,1887,0,ITH,ITH4,6,Friuli-Venezia Giulia,Friuli Venezia Giulia,1215220,951409,78.29,0.18
2057,2021-05-08,FVG,10317,4667,5650,5349,4785,183,ITH,ITH4,6,Friuli-Venezia Giulia,Friuli Venezia Giulia,1215220,961726,79.14,0.85
2058,2021-02-14,FVG,1,0,1,0,1,0,ITH,ITH4,6,Friuli-Venezia Giulia,Friuli Venezia Giulia,1215220,961727,79.14,0.0
2059,2021-05-10,FVG,7998,3553,4445,6223,1544,231,ITH,ITH4,6,Friuli-Venezia Giulia,Friuli Venezia Giulia,1215220,969725,79.8,0.66
2060,2021-03-19,FVG,3252,1350,1902,1300,1936,16,ITH,ITH4,6,Friuli-Venezia Giulia,Friuli Venezia Giulia,1215220,972977,80.07,0.27
2061,2021-06-27,FVG,7433,3708,3725,3610,3818,5,ITH,ITH4,6,Friuli-Venezia Giulia,Friuli Venezia Giulia,1215220,980410,80.68,0.61
2062,2021-06-29,FVG,11313,5767,5546,1174,10023,116,ITH,ITH4,6,Friuli-Venezia Giulia,Friuli Venezia Giulia,1215220,991723,81.61,0.93
2063,2021-07-16,FVG,9669,5168,4501,1594,7908,167,ITH,ITH4,6,Friuli-Venezia Giulia,Friuli Venezia Giulia,1215220,1001392,82.4,0.8
2064,2021-04-07,FVG,7846,3637,4209,6948,783,115,ITH,ITH4,6,Friuli-Venezia Giulia,Friuli Venezia Giulia,1215220,1009238,83.05,0.65
2065,2021-03-27,FVG,5380,2920,2460,3921,1411,48,ITH,ITH4,6,Friuli-Venezia Giulia,Friuli Venezia Giulia,1215220,1014618,83.49,0.44
2066,2021-04-15,FVG,6516,2879,3637,5092,1271,153,ITH,ITH4,6,Friuli-Venezia Giulia,Friuli Venezia Giulia,1215220,1021134,84.03,0.54
2067,2021-04-29,FVG,6789,2988,3801,4012,2594,183,ITH,ITH4,6,Friuli-Venezia Giulia,Friuli Venezia Giulia,1215220,1027923,84.59,0.56
2068,2021-01-05,FVG,1678,551,1127,1676,0,2,ITH,ITH4,6,Friuli-Venezia Giulia,Friuli Venezia Giulia,1215220,1029601,84.73,0.14
2069,2021-06-08,FVG,10487,5489,4998,9646,448,393,ITH,ITH4,6,Friuli-Venezia Giulia,Friuli Venezia Giulia,1215220,1040088,85.59,0.86
2070,2021-02-28,FVG,2687,1003,1684,2265,394,28,ITH,ITH4,6,Friuli-Venezia Giulia,Friuli Venezia Giulia,1215220,1042775,85.81,0.22
2071,2021-04-26,FVG,5472,2455,3017,3704,1651,117,ITH,ITH4,6,Friuli-Venezia Giulia,Friuli Venezia Giulia,1215220,1048247,86.26,0.45
2072,2021-06-25,FVG,10966,5513,5453,2410,8546,10,ITH,ITH4,6,Friuli-Venezia Giulia,Friuli Venezia Giulia,1215220,1059213,87.16,0.9
2073,2021-07-09,FVG,11836,6283,5553,2033,9505,298,ITH,ITH4,6,Friuli-Venezia Giulia,Friuli Venezia Giulia,1215220,1071049,88.14,0.97
2074,2021-03-17,FVG,3238,1268,1970,737,2492,9,ITH,ITH4,6,Friuli-Venezia Giulia,Friuli Venezia Giulia,1215220,1074287,88.4,0.27
2075,2021-05-13,FVG,11182,5397,5785,8728,2066,388,ITH,ITH4,6,Friuli-Venezia Giulia,Friuli Venezia Giulia,1215220,1085469,89.32,0.92
2076,2021-02-16,FVG,2516,1135,1381,2396,116,4,ITH,ITH4,6,Friuli-Venezia Giulia,Friuli Venezia Giulia,1215220,1087985,89.53,0.21
2077,2021-03-24,FVG,3979,1721,2258,2462,1482,35,ITH,ITH4,6,Friuli-Venezia Giulia,Friuli Venezia Giulia,1215220,1091964,89.86,0.33
2078,2021-05-20,FVG,12712,6322,6390,9791,2521,400,ITH,ITH4,6,Friuli-Venezia Giulia,Friuli Venezia Giulia,1215220,1104676,90.9,1.05
2079,2021-01-26,FVG,1977,647,1330,216,1760,1,ITH,ITH4,6,Friuli-Venezia Giulia,Friuli Venezia Giulia,1215220,1106653,91.07,0.16
2080,2021-02-09,FVG,1842,555,1287,1555,286,1,ITH,ITH4,6,Friuli-Venezia Giulia,Friuli Venezia Giulia,1215220,1108495,91.22,0.15
2081,2021-02-02,FVG,2468,806,1662,217,2251,0,ITH,ITH4,6,Friuli-Venezia Giulia,Friuli Venezia Giulia,1215220,1110963,91.42,0.2
2082,2021-03-31,FVG,8141,3571,4570,7171,847,123,ITH,ITH4,6,Friuli-Venezia Giulia,Friuli Venezia Giulia,1215220,1119104,92.09,0.67
2083,2021-05-15,FVG,12673,6113,6560,7678,4701,294,ITH,ITH4,6,Friuli-Venezia Giulia,Friuli Venezia Giulia,1215220,1131777,93.13,1.04
2084,2021-05-01,FVG,7205,3247,3958,5909,1045,251,ITH,ITH4,6,Friuli-Venezia Giulia,Friuli Venezia Giulia,1215220,1138982,93.73,0.59
2085,2021-01-21,FVG,897,345,552,1,896,0,ITH,ITH4,6,Friuli-Venezia Giulia,Friuli Venezia Giulia,1215220,1139879,93.8,0.07
2086,2021-02-21,FVG,801,281,520,421,378,2,ITH,ITH4,6,Friuli-Venezia Giulia,Friuli Venezia Giulia,1215220,1140680,93.87,0.07
2087,2021-02-05,FVG,2611,784,1827,89,2522,0,ITH,ITH4,6,Friuli-Venezia Giulia,Friuli Venezia Giulia,1215220,1143291,94.08,0.21
2088,2021-04-14,FVG,7245,3130,4115,5409,1714,122,ITH,ITH4,6,Friuli-Venezia Giulia,Friuli Venezia Giulia,1215220,1150536,94.68,0.6
2089,2021-07-06,FVG,11176,5836,5340,1325,9737,114,ITH,ITH4,6,Friuli-Venezia Giulia,Friuli Venezia Giulia,1215220,1161712,95.6,0.92
2090,2021-07-23,FVG,8737,4430,4307,2857,5427,453,ITH,ITH4,6,Friuli-Venezia Giulia,Friuli Venezia Giulia,1215220,1170449,96.32,0.72
2091,2021-06-03,FVG,12406,6732,5674,9930,2086,390,ITH,ITH4,6,Friuli-Venezia Giulia,Friuli Venezia Giulia,1215220,1182855,97.34,1.02
2092,2021-07-04,FVG,9185,4711,4474,2734,6187,264,ITH,ITH4,6,Friuli-Venezia Giulia,Friuli Venezia Giulia,1215220,1192040,98.09,0.76
2093,2021-03-26,FVG,6014,2609,3405,3824,2019,171,ITH,ITH4,6,Friuli-Venezia Giulia,Friuli Venezia Giulia,1215220,1198054,98.59,0.49
2094,2021-03-12,FVG,4103,1696,2407,2696,1381,26,ITH,ITH4,6,Friuli-Venezia Giulia,Friuli Venezia Giulia,1215220,1202157,98.93,0.34
2095,2021-01-02,FVG,1217,470,747,1217,0,0,ITH,ITH4,6,Friuli-Venezia Giulia,Friuli Venezia Giulia,1215220,1203374,99.03,0.1
2096,2021-04-12,FVG,7278,3192,4086,5995,1133,150,ITH,ITH4,6,Friuli-Venezia Giulia,Friuli Venezia Giulia,1215220,1210652,99.62,0.6
2097,2021-01-19,FVG,6,2,4,6,0,0,ITH,ITH4,6,Friuli-Venezia Giulia,Friuli Venezia Giulia,1215220,1210658,99.62,0.0
2098,2021-05-14,FVG,10781,5366,5415,7886,2598,297,ITH,ITH4,6,Friuli-Venezia Giulia,Friuli Venezia Giulia,1215220,1221439,100.51,0.89
2099,2021-02-03,FVG,2648,791,1857,22,2625,1,ITH,ITH4,6,Friuli-Venezia Giulia,Friuli Venezia Giulia,1215220,1224087,100.73,0.22
2100,2021-02-08,FVG,2357,694,1663,90,2266,1,ITH,ITH4,6,Friuli-Venezia Giulia,Friuli Venezia Giulia,1215220,1226444,100.92,0.19
2101,2021-06-13,FVG,8690,4523,4167,5206,3324,160,ITH,ITH4,6,Friuli-Venezia Giulia,Friuli Venezia Giulia,1215220,1235134,101.64,0.72
2102,2021-07-26,FVG,8418,4191,4227,1691,6511,216,ITH,ITH4,6,Friuli-Venezia Giulia,Friuli Venezia Giulia,1215220,1243552,102.33,0.69
2103,2021-04-17,FVG,7460,3238,4222,5814,1483,163,ITH,ITH4,6,Friuli-Venezia Giulia,Friuli Venezia Giulia,1215220,1251012,102.95,0.61
2104,2021-07-28,FVG,9967,5108,4859,3687,5813,467,ITH,ITH4,6,Friuli-Venezia Giulia,Friuli Venezia Giulia,1215220,1260979,103.77,0.82
2105,2021-07-19,FVG,9392,4915,4477,816,8414,162,ITH,ITH4,6,Friuli-Venezia Giulia,Friuli Venezia Giulia,1215220,1270371,104.54,0.77
2106,2021-04-10,FVG,5054,2213,2841,3751,1228,75,ITH,ITH4,6,Friuli-Venezia Giulia,Friuli Venezia Giulia,1215220,1275425,104.95,0.42
2107,2021-05-23,FVG,10280,4859,5421,5917,4152,211,ITH,ITH4,6,Friuli-Venezia Giulia,Friuli Venezia Giulia,1215220,1285705,105.8,0.85
2108,2021-01-07,FVG,2099,722,1377,2099,0,0,ITH,ITH4,6,Friuli-Venezia Giulia,Friuli Venezia Giulia,1215220,1287804,105.97,0.17
2109,2021-03-05,FVG,3776,1513,2263,2632,1076,68,ITH,ITH4,6,Friuli-Venezia Giulia,Friuli Venezia Giulia,1215220,1291580,106.28,0.31
2110,2021-04-19,FVG,6721,3136,3585,3213,3417,91,ITH,ITH4,6,Friuli-Venezia Giulia,Friuli Venezia Giulia,1215220,1298301,106.84,0.55
2111,2021-01-09,FVG,2513,841,1672,2511,0,2,ITH,ITH4,6,Friuli-Venezia Giulia,Friuli Venezia Giulia,1215220,1300814,107.04,0.21
2112,2021-06-15,FVG,12118,6160,5958,5348,6510,260,ITH,ITH4,6,Friuli-Venezia Giulia,Friuli Venezia Giulia,1215220,1312932,108.04,1.0
2113,2021-03-07,FVG,2545,933,1612,2487,1,57,ITH,ITH4,6,Friuli-Venezia Giulia,Friuli Venezia Giulia,1215220,1315477,108.25,0.21
2114,2020-12-31,FVG,1048,381,667,1047,0,1,ITH,ITH4,6,Friuli-Venezia Giulia,Friuli Venezia Giulia,1215220,1316525,108.34,0.09
2115,2021-06-17,FVG,11415,5770,5645,2287,9026,102,ITH,ITH4,6,Friuli-Venezia Giulia,Friuli Venezia Giulia,1215220,1327940,109.28,0.94
2116,2021-06-22,FVG,11572,5959,5613,2365,9085,122,ITH,ITH4,6,Friuli-Venezia Giulia,Friuli Venezia Giulia,1215220,1339512,110.23,0.95
2117,2021-04-05,PUG,12762,6199,6563,12086,533,143,ITF,ITF4,16,Puglia,Puglia,4029053,12762,0.32,0.32
2118,2021-03-19,PUG,7974,3659,4315,3369,4569,36,ITF,ITF4,16,Puglia,Puglia,4029053,20736,0.51,0.2
2119,2021-06-27,PUG,18503,9190,9313,9921,8305,277,ITF,ITF4,16,Puglia,Puglia,4029053,39239,0.97,0.46
2120,2021-07-11,PUG,12143,5741,6402,2628,9412,103,ITF,ITF4,16,Puglia,Puglia,4029053,51382,1.28,0.3
2121,2021-01-31,PUG,1818,832,986,75,1743,0,ITF,ITF4,16,Puglia,Puglia,4029053,53200,1.32,0.05
2122,2021-02-07,PUG,1581,669,912,253,1328,0,ITF,ITF4,16,Puglia,Puglia,4029053,54781,1.36,0.04
2123,2021-01-21,PUG,2133,905,1228,1269,862,2,ITF,ITF4,16,Puglia,Puglia,4029053,56914,1.41,0.05
2124,2021-05-01,PUG,27655,12672,14983,16701,10682,272,ITF,ITF4,16,Puglia,Puglia,4029053,84569,2.1,0.69
2125,2021-01-02,PUG,2954,1303,1651,2954,0,0,ITF,ITF4,16,Puglia,Puglia,4029053,87523,2.17,0.07
2126,2021-04-12,PUG,29445,13856,15589,26118,3016,311,ITF,ITF4,16,Puglia,Puglia,4029053,116968,2.9,0.73
2127,2021-07-21,PUG,43654,21537,22117,11948,30844,862,ITF,ITF4,16,Puglia,Puglia,4029053,160622,3.99,1.08
2128,2021-02-09,PUG,3841,1570,2271,2147,1676,18,ITF,ITF4,16,Puglia,Puglia,4029053,164463,4.08,0.1
2129,2021-05-20,PUG,33646,15282,18364,20739,12389,518,ITF,ITF4,16,Puglia,Puglia,4029053,198109,4.92,0.84
2130,2021-03-24,PUG,13589,6525,7064,6035,7438,116,ITF,ITF4,16,Puglia,Puglia,4029053,211698,5.25,0.34
2131,2021-01-26,PUG,5373,2402,2971,563,4809,1,ITF,ITF4,16,Puglia,Puglia,4029053,217071,5.39,0.13
2132,2021-07-02,PUG,47029,22343,24686,17194,28881,954,ITF,ITF4,16,Puglia,Puglia,4029053,264100,6.55,1.17
2133,2021-05-06,PUG,39678,17362,22316,19304,19820,554,ITF,ITF4,16,Puglia,Puglia,4029053,303778,7.54,0.98
2134,2021-03-05,PUG,17708,7184,10524,15181,2310,217,ITF,ITF4,16,Puglia,Puglia,4029053,321486,7.98,0.44
2135,2021-02-26,PUG,13780,5062,8718,12516,1069,195,ITF,ITF4,16,Puglia,Puglia,4029053,335266,8.32,0.34
2136,2020-12-31,PUG,1637,784,853,1637,0,0,ITF,ITF4,16,Puglia,Puglia,4029053,336903,8.36,0.04
2137,2021-06-15,PUG,42627,20846,21781,22394,19644,589,ITF,ITF4,16,Puglia,Puglia,4029053,379530,9.42,1.06
2138,2021-06-08,PUG,39314,19144,20170,20930,17827,557,ITF,ITF4,16,Puglia,Puglia,4029053,418844,10.4,0.98
2139,2021-02-21,PUG,2177,474,1703,2065,63,49,ITF,ITF4,16,Puglia,Puglia,4029053,421021,10.45,0.05
2140,2021-06-01,PUG,34946,17503,17443,21616,12943,387,ITF,ITF4,16,Puglia,Puglia,4029053,455967,11.32,0.87
2141,2021-05-15,PUG,43634,19000,24634,22805,20120,709,ITF,ITF4,16,Puglia,Puglia,4029053,499601,12.4,1.08
2142,2021-06-03,PUG,50574,24530,26044,30489,19363,722,ITF,ITF4,16,Puglia,Puglia,4029053,550175,13.66,1.26
2143,2021-03-10,PUG,14826,6626,8200,11543,3129,154,ITF,ITF4,16,Puglia,Puglia,4029053,565001,14.02,0.37
2144,2021-01-12,PUG,4215,1771,2444,4214,0,1,ITF,ITF4,16,Puglia,Puglia,4029053,569216,14.13,0.1
2145,2021-04-07,PUG,15715,7134,8581,8822,6691,202,ITF,ITF4,16,Puglia,Puglia,4029053,584931,14.52,0.39
2146,2021-07-16,PUG,46063,22342,23721,13015,32212,836,ITF,ITF4,16,Puglia,Puglia,4029053,630994,15.66,1.14
2147,2021-04-19,PUG,27733,12887,14846,24353,3042,338,ITF,ITF4,16,Puglia,Puglia,4029053,658727,16.35,0.69
2148,2021-07-28,PUG,42211,21312,20899,13747,27595,869,ITF,ITF4,16,Puglia,Puglia,4029053,700938,17.4,1.05
2149,2021-04-24,PUG,29429,13397,16032,25148,3950,331,ITF,ITF4,16,Puglia,Puglia,4029053,730367,18.13,0.73
2150,2021-03-31,PUG,14570,6829,7741,8839,5582,149,ITF,ITF4,16,Puglia,Puglia,4029053,744937,18.49,0.36
2151,2021-02-02,PUG,4351,1850,2501,574,3776,1,ITF,ITF4,16,Puglia,Puglia,4029053,749288,18.6,0.11
2152,2021-07-09,PUG,36894,17765,19129,6514,29693,687,ITF,ITF4,16,Puglia,Puglia,4029053,786182,19.51,0.92
2153,2021-05-13,PUG,38783,17296,21487,20968,17247,568,ITF,ITF4,16,Puglia,Puglia,4029053,824965,20.48,0.96
2154,2021-03-17,PUG,10351,4705,5646,4106,6183,62,ITF,ITF4,16,Puglia,Puglia,4029053,835316,20.73,0.26
2155,2021-02-14,PUG,787,347,440,657,125,5,ITF,ITF4,16,Puglia,Puglia,4029053,836103,20.75,0.02
2156,2021-05-25,PUG,34750,16218,18532,20558,13605,587,ITF,ITF4,16,Puglia,Puglia,4029053,870853,21.61,0.86
2157,2021-05-08,PUG,54339,23000,31339,23971,29843,525,ITF,ITF4,16,Puglia,Puglia,4029053,925192,22.96,1.35
2158,2021-05-29,PUG,30602,14425,16177,20559,9497,546,ITF,ITF4,16,Puglia,Puglia,4029053,955794,23.72,0.76
2159,2021-04-02,PUG,12849,6001,6848,8174,4523,152,ITF,ITF4,16,Puglia,Puglia,4029053,968643,24.04,0.32
2160,2021-07-04,PUG,19792,9631,10161,7874,11618,300,ITF,ITF4,16,Puglia,Puglia,4029053,988435,24.53,0.49
2161,2021-07-23,PUG,41437,20909,20528,13598,26881,958,ITF,ITF4,16,Puglia,Puglia,4029053,1029872,25.56,1.03
2162,2021-01-19,PUG,1222,453,769,1211,10,1,ITF,ITF4,16,Puglia,Puglia,4029053,1031094,25.59,0.03
2163,2021-07-08,PUG,41340,19155,22185,5499,35368,473,ITF,ITF4,16,Puglia,Puglia,4029053,1072434,26.62,1.03
2164,2021-06-13,PUG,21813,10924,10889,16323,5203,287,ITF,ITF4,16,Puglia,Puglia,4029053,1094247,27.16,0.54
2165,2021-02-28,PUG,6061,1807,4254,5795,191,75,ITF,ITF4,16,Puglia,Puglia,4029053,1100308,27.31,0.15
2166,2021-05-12,PUG,36600,16324,20276,23495,12521,584,ITF,ITF4,16,Puglia,Puglia,4029053,1136908,28.22,0.91
2167,2021-03-29,PUG,13552,6611,6941,6604,6753,195,ITF,ITF4,16,Puglia,Puglia,4029053,1150460,28.55,0.34
2168,2021-03-12,PUG,14293,6443,7850,10220,3936,137,ITF,ITF4,16,Puglia,Puglia,4029053,1164753,28.91,0.35
2169,2021-06-20,PUG,21533,10827,10706,14024,7184,325,ITF,ITF4,16,Puglia,Puglia,4029053,1186286,29.44,0.53
2170,2021-02-04,PUG,5932,2366,3566,1135,4794,3,ITF,ITF4,16,Puglia,Puglia,4029053,1192218,29.59,0.15
2171,2021-01-14,PUG,4076,1593,2483,4070,0,6,ITF,ITF4,16,Puglia,Puglia,4029053,1196294,29.69,0.1
2172,2021-01-07,PUG,5725,2465,3260,5725,0,0,ITF,ITF4,16,Puglia,Puglia,4029053,1202019,29.83,0.14
2173,2021-04-17,PUG,40038,18975,21063,36040,3577,421,ITF,ITF4,16,Puglia,Puglia,4029053,1242057,30.83,0.99
2174,2021-02-19,PUG,4738,2013,2725,4293,391,54,ITF,ITF4,16,Puglia,Puglia,4029053,1246795,30.95,0.12
2175,2021-06-22,PUG,42385,20548,21837,19051,22762,572,ITF,ITF4,16,Puglia,Puglia,4029053,1289180,32.0,1.05
2176,2021-04-26,PUG,26317,12059,14258,22693,3236,388,ITF,ITF4,16,Puglia,Puglia,4029053,1315497,32.65,0.65
2177,2021-03-16,PUG,9881,4691,5190,3450,6374,57,ITF,ITF4,16,Puglia,Puglia,4029053,1325378,32.9,0.25
2178,2021-07-30,PUG,32132,16492,15640,11599,19788,745,ITF,ITF4,16,Puglia,Puglia,4029053,1357510,33.69,0.8
2179,2021-05-27,PUG,40916,19337,21579,22884,17357,675,ITF,ITF4,16,Puglia,Puglia,4029053,1398426,34.71,1.02
2180,2021-03-02,PUG,16398,6098,10300,14852,1305,241,ITF,ITF4,16,Puglia,Puglia,4029053,1414824,35.12,0.41
2181,2021-06-10,PUG,47146,23180,23966,29355,17074,717,ITF,ITF4,16,Puglia,Puglia,4029053,1461970,36.29,1.17
2182,2021-07-20,PUG,46647,22883,23764,8398,37725,524,ITF,ITF4,16,Puglia,Puglia,4029053,1508617,37.44,1.16
2183,2021-07-27,PUG,45901,22797,23104,13047,32069,785,ITF,ITF4,16,Puglia,Puglia,4029053,1554518,38.58,1.14
2184,2021-06-12,PUG,34566,17231,17335,25032,8944,590,ITF,ITF4,16,Puglia,Puglia,4029053,1589084,39.44,0.86
2185,2021-01-28,PUG,5479,2280,3199,450,5029,0,ITF,ITF4,16,Puglia,Puglia,4029053,1594563,39.58,0.14
2186,2021-01-04,PUG,4509,2016,2493,4507,0,2,ITF,ITF4,16,Puglia,Puglia,4029053,1599072,39.69,0.11
2187,2021-03-26,PUG,12013,5846,6167,7218,4667,128,ITF,ITF4,16,Puglia,Puglia,4029053,1611085,39.99,0.3
2188,2021-03-09,PUG,13644,6098,7546,11451,2015,178,ITF,ITF4,16,Puglia,Puglia,4029053,1624729,40.33,0.34
2189,2021-04-14,PUG,32011,15101,16910,28418,3286,307,ITF,ITF4,16,Puglia,Puglia,4029053,1656740,41.12,0.79
2190,2021-03-28,PUG,3547,1657,1890,1181,2332,34,ITF,ITF4,16,Puglia,Puglia,4029053,1660287,41.21,0.09
2191,2021-07-06,PUG,42285,19474,22811,6163,35685,437,ITF,ITF4,16,Puglia,Puglia,4029053,1702572,42.26,1.05
2192,2021-06-19,PUG,34721,17415,17306,22188,11879,654,ITF,ITF4,16,Puglia,Puglia,4029053,1737293,43.12,0.86
2193,2021-06-21,PUG,41778,20374,21404,21445,19695,638,ITF,ITF4,16,Puglia,Puglia,4029053,1779071,44.16,1.04
2194,2021-03-11,PUG,14830,6587,8243,11442,3187,201,ITF,ITF4,16,Puglia,Puglia,4029053,1793901,44.52,0.37
2195,2021-06-02,PUG,27044,13224,13820,21851,4836,357,ITF,ITF4,16,Puglia,Puglia,4029053,1820945,45.2,0.67
2196,2021-05-17,PUG,32893,15245,17648,20445,11950,498,ITF,ITF4,16,Puglia,Puglia,4029053,1853838,46.01,0.82
2197,2021-02-23,PUG,9380,4431,4949,8797,492,91,ITF,ITF4,16,Puglia,Puglia,4029053,1863218,46.24,0.23
2198,2021-04-16,PUG,36089,16964,19125,32383,3280,426,ITF,ITF4,16,Puglia,Puglia,4029053,1899307,47.14,0.9
2199,2021-02-18,PUG,4382,1847,2535,3714,608,60,ITF,ITF4,16,Puglia,Puglia,4029053,1903689,47.25,0.11
2200,2021-07-25,PUG,13586,7036,6550,4017,9392,177,ITF,ITF4,16,Puglia,Puglia,4029053,1917275,47.59,0.34
2201,2021-04-09,PUG,22081,9517,12564,17062,4634,385,ITF,ITF4,16,Puglia,Puglia,4029053,1939356,48.13,0.55
2202,2021-02-11,PUG,3697,1401,2296,2391,1279,27,ITF,ITF4,16,Puglia,Puglia,4029053,1943053,48.23,0.09
2203,2021-07-18,PUG,18756,9607,9149,6251,12164,341,ITF,ITF4,16,Puglia,Puglia,4029053,1961809,48.69,0.47
2204,2021-05-22,PUG,34694,15894,18800,23620,10531,543,ITF,ITF4,16,Puglia,Puglia,4029053,1996503,49.55,0.86
2205,2021-05-31,PUG,37899,18271,19628,23131,14216,552,ITF,ITF4,16,Puglia,Puglia,4029053,2034402,50.49,0.94
2206,2021-04-25,PUG,11310,5236,6074,10036,1142,132,ITF,ITF4,16,Puglia,Puglia,4029053,2045712,50.77,0.28
2207,2021-02-27,PUG,14236,4821,9415,12822,1233,181,ITF,ITF4,16,Puglia,Puglia,4029053,2059948,51.13,0.35
2208,2021-01-01,PUG,150,61,89,150,0,0,ITF,ITF4,16,Puglia,Puglia,4029053,2060098,51.13,0.0
2209,2021-06-07,PUG,44358,21661,22697,30331,13267,760,ITF,ITF4,16,Puglia,Puglia,4029053,2104456,52.23,1.1
2210,2021-04-11,PUG,16474,7259,9215,14645,1649,180,ITF,ITF4,16,Puglia,Puglia,4029053,2120930,52.64,0.41
2211,2021-03-06,PUG,16160,6131,10029,13884,2109,167,ITF,ITF4,16,Puglia,Puglia,4029053,2137090,53.04,0.4
2212,2021-01-08,PUG,5671,2383,3288,5669,0,2,ITF,ITF4,16,Puglia,Puglia,4029053,2142761,53.18,0.14
2213,2021-06-14,PUG,42015,20559,21456,28833,12396,786,ITF,ITF4,16,Puglia,Puglia,4029053,2184776,54.23,1.04
2214,2021-04-18,PUG,22653,10838,11815,21401,1056,196,ITF,ITF4,16,Puglia,Puglia,4029053,2207429,54.79,0.56
2215,2021-02-20,PUG,2973,1080,1893,2686,257,30,ITF,ITF4,16,Puglia,Puglia,4029053,2210402,54.86,0.07
2216,2021-06-24,PUG,52725,25503,27222,23543,28390,792,ITF,ITF4,16,Puglia,Puglia,4029053,2263127,56.17,1.31
2217,2021-04-28,PUG,19840,8899,10941,14805,4770,265,ITF,ITF4,16,Puglia,Puglia,4029053,2282967,56.66,0.49
2218,2021-01-09,PUG,4890,2251,2639,4886,0,4,ITF,ITF4,16,Puglia,Puglia,4029053,2287857,56.78,0.12
2219,2021-07-01,PUG,48132,22537,25595,11354,36120,658,ITF,ITF4,16,Puglia,Puglia,4029053,2335989,57.98,1.19
2220,2021-03-14,PUG,3375,1460,1915,2474,864,37,ITF,ITF4,16,Puglia,Puglia,4029053,2339364,58.06,0.08
2221,2021-01-16,PUG,2508,1036,1472,2506,0,2,ITF,ITF4,16,Puglia,Puglia,4029053,2341872,58.12,0.06
2222,2021-05-21,PUG,39161,18594,20567,28242,10127,792,ITF,ITF4,16,Puglia,Puglia,4029053,2381033,59.1,0.97
2223,2021-04-04,PUG,5981,2969,3012,5896,5,80,ITF,ITF4,16,Puglia,Puglia,4029053,2387014,59.25,0.15
2224,2021-07-13,PUG,48551,22898,25653,7934,40017,600,ITF,ITF4,16,Puglia,Puglia,4029053,2435565,60.45,1.21
2225,2021-03-21,PUG,2696,1228,1468,579,2106,11,ITF,ITF4,16,Puglia,Puglia,4029053,2438261,60.52,0.07
2226,2021-06-29,PUG,46405,22241,24164,15243,30448,714,ITF,ITF4,16,Puglia,Puglia,4029053,2484666,61.67,1.15
2227,2021-01-11,PUG,3756,1590,2166,3755,0,1,ITF,ITF4,16,Puglia,Puglia,4029053,2488422,61.76,0.09
2228,2021-04-21,PUG,23141,10688,12453,19097,3742,302,ITF,ITF4,16,Puglia,Puglia,4029053,2511563,62.34,0.57
2229,2021-05-24,PUG,36143,17054,19089,24480,11050,613,ITF,ITF4,16,Puglia,Puglia,4029053,2547706,63.23,0.9
2230,2021-02-16,PUG,3385,1454,1931,2707,648,30,ITF,ITF4,16,Puglia,Puglia,4029053,2551091,63.32,0.08
2231,2021-01-30,PUG,5535,2515,3020,386,5148,1,ITF,ITF4,16,Puglia,Puglia,4029053,2556626,63.45,0.14
2232,2021-03-13,PUG,10474,4137,6337,8564,1814,96,ITF,ITF4,16,Puglia,Puglia,4029053,2567100,63.71,0.26
2233,2021-02-24,PUG,10056,4713,5343,9367,596,93,ITF,ITF4,16,Puglia,Puglia,4029053,2577156,63.96,0.25
2234,2021-06-04,PUG,52726,25514,27212,34130,17770,826,ITF,ITF4,16,Puglia,Puglia,4029053,2629882,65.27,1.31
2235,2021-05-18,PUG,28920,13456,15464,15822,12838,260,ITF,ITF4,16,Puglia,Puglia,4029053,2658802,65.99,0.72
2236,2021-04-29,PUG,26270,12148,14122,19159,6690,421,ITF,ITF4,16,Puglia,Puglia,4029053,2685072,66.64,0.65
2237,2021-05-19,PUG,26424,12777,13647,19526,6465,433,ITF,ITF4,16,Puglia,Puglia,4029053,2711496,67.3,0.66
2238,2021-03-23,PUG,11131,5652,5479,4529,6510,92,ITF,ITF4,16,Puglia,Puglia,4029053,2722627,67.57,0.28
2239,2021-03-25,PUG,11743,6016,5727,5248,6397,98,ITF,ITF4,16,Puglia,Puglia,4029053,2734370,67.87,0.29
2240,2021-07-03,PUG,33041,16569,16472,13346,19170,525,ITF,ITF4,16,Puglia,Puglia,4029053,2767411,68.69,0.82
2241,2021-02-08,PUG,4003,1617,2386,1580,2408,15,ITF,ITF4,16,Puglia,Puglia,4029053,2771414,68.79,0.1
2242,2021-05-10,PUG,37833,16717,21116,19311,18046,476,ITF,ITF4,16,Puglia,Puglia,4029053,2809247,69.72,0.94
2243,2021-02-13,PUG,3731,1460,2271,3020,695,16,ITF,ITF4,16,Puglia,Puglia,4029053,2812978,69.82,0.09
2244,2021-02-25,PUG,11974,5062,6912,10662,1177,135,ITF,ITF4,16,Puglia,Puglia,4029053,2824952,70.11,0.3
2245,2021-06-05,PUG,42540,20843,21697,29127,12692,721,ITF,ITF4,16,Puglia,Puglia,4029053,2867492,71.17,1.06
2246,2021-01-06,PUG,3950,1674,2276,3949,0,1,ITF,ITF4,16,Puglia,Puglia,4029053,2871442,71.27,0.1
2247,2021-04-23,PUG,29569,13740,15829,23897,5260,412,ITF,ITF4,16,Puglia,Puglia,4029053,2901011,72.0,0.73
2248,2021-03-18,PUG,9591,4356,5235,3330,6195,66,ITF,ITF4,16,Puglia,Puglia,4029053,2910602,72.24,0.24
2249,2021-06-26,PUG,32310,16267,16043,15817,15903,590,ITF,ITF4,16,Puglia,Puglia,4029053,2942912,73.04,0.8
2250,2021-03-04,PUG,15360,6103,9257,13711,1426,223,ITF,ITF4,16,Puglia,Puglia,4029053,2958272,73.42,0.38
2251,2021-01-18,PUG,1847,772,1075,1495,351,1,ITF,ITF4,16,Puglia,Puglia,4029053,2960119,73.47,0.05
2252,2021-02-06,PUG,4553,1934,2619,1575,2963,15,ITF,ITF4,16,Puglia,Puglia,4029053,2964672,73.58,0.11
2253,2021-01-20,PUG,1548,542,1006,1537,8,3,ITF,ITF4,16,Puglia,Puglia,4029053,2966220,73.62,0.04
2254,2021-04-30,PUG,35000,15683,19317,22454,11982,564,ITF,ITF4,16,Puglia,Puglia,4029053,3001220,74.49,0.87
2255,2021-04-13,PUG,28760,13642,15118,24920,3530,310,ITF,ITF4,16,Puglia,Puglia,4029053,3029980,75.2,0.71
2256,2021-07-22,PUG,47122,23360,23762,8637,37796,689,ITF,ITF4,16,Puglia,Puglia,4029053,3077102,76.37,1.17
2257,2021-07-05,PUG,38688,18161,20527,7326,30798,564,ITF,ITF4,16,Puglia,Puglia,4029053,3115790,77.33,0.96
2258,2021-05-02,PUG,21342,9673,11669,13896,7270,176,ITF,ITF4,16,Puglia,Puglia,4029053,3137132,77.86,0.53
2259,2021-07-24,PUG,25802,13348,12454,7813,17544,445,ITF,ITF4,16,Puglia,Puglia,4029053,3162934,78.5,0.64
2260,2021-02-10,PUG,3651,1440,2211,2117,1513,21,ITF,ITF4,16,Puglia,Puglia,4029053,3166585,78.59,0.09
2261,2021-05-23,PUG,17938,8385,9553,13855,3823,260,ITF,ITF4,16,Puglia,Puglia,4029053,3184523,79.04,0.45
2262,2021-02-17,PUG,4289,1751,2538,3615,635,39,ITF,ITF4,16,Puglia,Puglia,4029053,3188812,79.15,0.11
2263,2021-05-28,PUG,44039,20853,23186,27405,15831,803,ITF,ITF4,16,Puglia,Puglia,4029053,3232851,80.24,1.09
2264,2021-01-15,PUG,4552,1865,2687,4547,0,5,ITF,ITF4,16,Puglia,Puglia,4029053,3237403,80.35,0.11
2265,2021-06-28,PUG,48432,23495,24937,21520,26040,872,ITF,ITF4,16,Puglia,Puglia,4029053,3285835,81.55,1.2
2266,2021-05-09,PUG,30787,12633,18154,14774,15647,366,ITF,ITF4,16,Puglia,Puglia,4029053,3316622,82.32,0.76
2267,2021-01-22,PUG,1413,579,834,991,421,1,ITF,ITF4,16,Puglia,Puglia,4029053,3318035,82.35,0.04
2268,2021-06-25,PUG,50696,24976,25720,23799,25989,908,ITF,ITF4,16,Puglia,Puglia,4029053,3368731,83.61,1.26
2269,2021-02-22,PUG,9637,4536,5101,9213,336,88,ITF,ITF4,16,Puglia,Puglia,4029053,3378368,83.85,0.24
2270,2021-02-05,PUG,5639,2274,3365,1310,4324,5,ITF,ITF4,16,Puglia,Puglia,4029053,3384007,83.99,0.14
2271,2021-05-16,PUG,24584,11084,13500,12445,11917,222,ITF,ITF4,16,Puglia,Puglia,4029053,3408591,84.6,0.61
2272,2021-06-18,PUG,47743,23501,24242,28840,17974,929,ITF,ITF4,16,Puglia,Puglia,4029053,3456334,85.79,1.18
2273,2021-01-03,PUG,2007,943,1064,2006,0,1,ITF,ITF4,16,Puglia,Puglia,4029053,3458341,85.84,0.05
2274,2021-03-27,PUG,12166,5718,6448,6878,5178,110,ITF,ITF4,16,Puglia,Puglia,4029053,3470507,86.14,0.3
2275,2021-01-05,PUG,5113,2252,2861,5110,0,3,ITF,ITF4,16,Puglia,Puglia,4029053,3475620,86.26,0.13
2276,2021-04-15,PUG,32725,15270,17455,28564,3760,401,ITF,ITF4,16,Puglia,Puglia,4029053,3508345,87.08,0.81
2277,2021-07-07,PUG,38541,18455,20086,6172,31849,520,ITF,ITF4,16,Puglia,Puglia,4029053,3546886,88.03,0.96
2278,2021-06-09,PUG,41873,20731,21142,29904,11263,706,ITF,ITF4,16,Puglia,Puglia,4029053,3588759,89.07,1.04
2279,2021-02-15,PUG,3262,1271,1991,2596,622,44,ITF,ITF4,16,Puglia,Puglia,4029053,3592021,89.15,0.08
2280,2021-05-26,PUG,38604,18551,20053,26175,11776,653,ITF,ITF4,16,Puglia,Puglia,4029053,3630625,90.11,0.96
2281,2021-01-27,PUG,4603,1942,2661,624,3979,0,ITF,ITF4,16,Puglia,Puglia,4029053,3635228,90.23,0.11
2282,2021-05-07,PUG,50139,22380,27759,25977,23604,558,ITF,ITF4,16,Puglia,Puglia,4029053,3685367,91.47,1.24
2283,2021-07-29,PUG,39708,20072,19636,11545,27429,734,ITF,ITF4,16,Puglia,Puglia,4029053,3725075,92.46,0.99
2284,2021-01-13,PUG,4549,1731,2818,4548,0,1,ITF,ITF4,16,Puglia,Puglia,4029053,3729624,92.57,0.11
2285,2021-07-26,PUG,45020,22495,22525,16360,27738,922,ITF,ITF4,16,Puglia,Puglia,4029053,3774644,93.69,1.12
2286,2021-05-30,PUG,21019,10063,10956,15701,5062,256,ITF,ITF4,16,Puglia,Puglia,4029053,3795663,94.21,0.52
2287,2021-06-16,PUG,42030,20674,21356,26868,14438,724,ITF,ITF4,16,Puglia,Puglia,4029053,3837693,95.25,1.04
2288,2020-12-30,PUG,1,0,1,1,0,0,ITF,ITF4,16,Puglia,Puglia,4029053,3837694,95.25,0.0
2289,2021-03-22,PUG,9970,5129,4841,4242,5661,67,ITF,ITF4,16,Puglia,Puglia,4029053,3847664,95.5,0.25
2290,2021-01-24,PUG,1670,751,919,151,1519,0,ITF,ITF4,16,Puglia,Puglia,4029053,3849334,95.54,0.04
2291,2021-06-30,PUG,47570,23093,24477,18721,27968,881,ITF,ITF4,16,Puglia,Puglia,4029053,3896904,96.72,1.18
2292,2021-03-15,PUG,12344,6151,6193,5734,6507,103,ITF,ITF4,16,Puglia,Puglia,4029053,3909248,97.03,0.31
2293,2021-01-17,PUG,1310,592,718,1240,70,0,ITF,ITF4,16,Puglia,Puglia,4029053,3910558,97.06,0.03
2294,2021-06-23,PUG,29366,14347,15019,16970,11784,612,ITF,ITF4,16,Puglia,Puglia,4029053,3939924,97.79,0.73
2295,2021-04-27,PUG,26695,12075,14620,20766,5608,321,ITF,ITF4,16,Puglia,Puglia,4029053,3966619,98.45,0.66
2296,2021-05-11,PUG,32653,14429,18224,13674,18494,485,ITF,ITF4,16,Puglia,Puglia,4029053,3999272,99.26,0.81
2297,2021-05-04,PUG,35157,14872,20285,18225,16520,412,ITF,ITF4,16,Puglia,Puglia,4029053,4034429,100.13,0.87
2298,2021-03-08,PUG,15004,6443,8561,12441,2408,155,ITF,ITF4,16,Puglia,Puglia,4029053,4049433,100.51,0.37
2299,2021-04-22,PUG,23054,10552,12502,17739,4931,384,ITF,ITF4,16,Puglia,Puglia,4029053,4072487,101.08,0.57
2300,2021-02-12,PUG,4215,1673,2542,3099,1094,22,ITF,ITF4,16,Puglia,Puglia,4029053,4076702,101.18,0.1
2301,2021-01-29,PUG,6205,2665,3540,241,5964,0,ITF,ITF4,16,Puglia,Puglia,4029053,4082907,101.34,0.15
2302,2021-03-20,PUG,8424,3885,4539,3767,4613,44,ITF,ITF4,16,Puglia,Puglia,4029053,4091331,101.55,0.21
2303,2021-03-03,PUG,16793,6809,9984,14719,1927,147,ITF,ITF4,16,Puglia,Puglia,4029053,4108124,101.96,0.42
2304,2021-06-11,PUG,47901,23436,24465,32968,14023,910,ITF,ITF4,16,Puglia,Puglia,4029053,4156025,103.15,1.19
2305,2021-04-06,PUG,13855,6258,7597,6924,6762,169,ITF,ITF4,16,Puglia,Puglia,4029053,4169880,103.5,0.34
2306,2021-07-15,PUG,44582,21569,23013,8959,34924,699,ITF,ITF4,16,Puglia,Puglia,4029053,4214462,104.6,1.11
2307,2021-07-14,PUG,45880,21998,23882,13510,31517,853,ITF,ITF4,16,Puglia,Puglia,4029053,4260342,105.74,1.14
2308,2021-03-01,PUG,15113,5871,9242,13584,1378,151,ITF,ITF4,16,Puglia,Puglia,4029053,4275455,106.12,0.38
2309,2021-04-03,PUG,10571,4653,5918,6813,3565,193,ITF,ITF4,16,Puglia,Puglia,4029053,4286026,106.38,0.26
2310,2021-01-10,PUG,2349,1062,1287,2348,0,1,ITF,ITF4,16,Puglia,Puglia,4029053,4288375,106.44,0.06
2311,2021-04-20,PUG,21191,9843,11348,17453,3474,264,ITF,ITF4,16,Puglia,Puglia,4029053,4309566,106.96,0.53
2312,2020-12-27,PUG,510,252,258,510,0,0,ITF,ITF4,16,Puglia,Puglia,4029053,4310076,106.97,0.01
2313,2021-01-23,PUG,3042,1294,1748,882,2159,1,ITF,ITF4,16,Puglia,Puglia,4029053,4313118,107.05,0.08
2314,2021-05-03,PUG,33368,14917,18451,22141,10664,563,ITF,ITF4,16,Puglia,Puglia,4029053,4346486,107.88,0.83
2315,2021-03-07,PUG,4987,2003,2984,4369,576,42,ITF,ITF4,16,Puglia,Puglia,4029053,4351473,108.0,0.12
2316,2021-05-05,PUG,39278,17237,22041,24468,14227,583,ITF,ITF4,16,Puglia,Puglia,4029053,4390751,108.98,0.97
2317,2021-06-17,PUG,42822,20926,21896,21400,20861,561,ITF,ITF4,16,Puglia,Puglia,4029053,4433573,110.04,1.06
2318,2021-03-30,PUG,12380,5932,6448,6183,6048,149,ITF,ITF4,16,Puglia,Puglia,4029053,4445953,110.35,0.31
2319,2021-02-01,PUG,3969,1662,2307,355,3613,1,ITF,ITF4,16,Puglia,Puglia,4029053,4449922,110.45,0.1
2320,2021-07-17,PUG,30221,15169,15052,9451,20137,633,ITF,ITF4,16,Puglia,Puglia,4029053,4480143,111.2,0.75
2321,2021-05-14,PUG,45007,20574,24433,27960,16190,857,ITF,ITF4,16,Puglia,Puglia,4029053,4525150,112.31,1.12
2322,2021-01-25,PUG,3831,1682,2149,423,3407,1,ITF,ITF4,16,Puglia,Puglia,4029053,4528981,112.41,0.1
2323,2021-07-10,PUG,22284,10976,11308,4477,17503,304,ITF,ITF4,16,Puglia,Puglia,4029053,4551265,112.96,0.55
2324,2021-04-08,PUG,17495,7593,9902,11097,6185,213,ITF,ITF4,16,Puglia,Puglia,4029053,4568760,113.4,0.43
2325,2021-06-06,PUG,30698,15455,15243,25326,5049,323,ITF,ITF4,16,Puglia,Puglia,4029053,4599458,114.16,0.76
2326,2021-04-10,PUG,30922,13117,17805,26090,4454,378,ITF,ITF4,16,Puglia,Puglia,4029053,4630380,114.92,0.77
2327,2021-07-19,PUG,48680,23924,24756,11078,36825,777,ITF,ITF4,16,Puglia,Puglia,4029053,4679060,116.13,1.21
2328,2021-04-01,PUG,13951,6551,7400,7373,6363,215,ITF,ITF4,16,Puglia,Puglia,4029053,4693011,116.48,0.35
2329,2021-02-03,PUG,5045,2006,3039,711,4333,1,ITF,ITF4,16,Puglia,Puglia,4029053,4698056,116.6,0.13
2330,2021-07-12,PUG,45526,21507,24019,12769,31983,774,ITF,ITF4,16,Puglia,Puglia,4029053,4743582,117.73,1.13
2331,2021-07-29,UMB,8066,4148,3918,2137,5857,72,ITI,ITI2,10,Umbria,Umbria,882015,8066,0.91,0.91
2332,2021-05-07,UMB,10116,4709,5407,6706,3191,219,ITI,ITI2,10,Umbria,Umbria,882015,18182,2.06,1.15
2333,2021-04-23,UMB,6615,2787,3828,3299,3120,196,ITI,ITI2,10,Umbria,Umbria,882015,24797,2.81,0.75
2334,2021-02-25,UMB,1332,495,837,1272,52,8,ITI,ITI2,10,Umbria,Umbria,882015,26129,2.96,0.15
2335,2021-03-11,UMB,3583,1723,1860,2564,1006,13,ITI,ITI2,10,Umbria,Umbria,882015,29712,3.37,0.41
2336,2021-01-13,UMB,449,139,310,449,0,0,ITI,ITI2,10,Umbria,Umbria,882015,30161,3.42,0.05
2337,2021-06-19,UMB,4568,2199,2369,2536,2030,2,ITI,ITI2,10,Umbria,Umbria,882015,34729,3.94,0.52
2338,2021-01-06,UMB,846,325,521,846,0,0,ITI,ITI2,10,Umbria,Umbria,882015,35575,4.03,0.1
2339,2021-06-12,UMB,7711,3685,4026,6121,1579,11,ITI,ITI2,10,Umbria,Umbria,882015,43286,4.91,0.87
2340,2021-04-16,UMB,8097,3741,4356,6081,1838,178,ITI,ITI2,10,Umbria,Umbria,882015,51383,5.83,0.92
2341,2021-04-30,UMB,6253,2971,3282,2735,3397,121,ITI,ITI2,10,Umbria,Umbria,882015,57636,6.53,0.71
2342,2021-03-04,UMB,4484,1855,2629,3643,827,14,ITI,ITI2,10,Umbria,Umbria,882015,62120,7.04,0.51
2343,2021-01-20,UMB,602,221,381,602,0,0,ITI,ITI2,10,Umbria,Umbria,882015,62722,7.11,0.07
2344,2021-07-03,UMB,6468,3243,3225,2921,3492,55,ITI,ITI2,10,Umbria,Umbria,882015,69190,7.84,0.73
2345,2021-07-20,UMB,8260,4105,4155,1146,7081,33,ITI,ITI2,10,Umbria,Umbria,882015,77450,8.78,0.94
2346,2021-07-22,UMB,9908,4814,5094,1647,8207,54,ITI,ITI2,10,Umbria,Umbria,882015,87358,9.9,1.12
2347,2021-06-14,UMB,5378,2745,2633,3362,2010,6,ITI,ITI2,10,Umbria,Umbria,882015,92736,10.51,0.61
2348,2021-03-23,UMB,3824,1713,2111,2158,1629,37,ITI,ITI2,10,Umbria,Umbria,882015,96560,10.95,0.43
2349,2021-07-01,UMB,9681,4792,4889,3358,6281,42,ITI,ITI2,10,Umbria,Umbria,882015,106241,12.05,1.1
2350,2021-02-08,UMB,635,203,432,88,547,0,ITI,ITI2,10,Umbria,Umbria,882015,106876,12.12,0.07
2351,2021-05-19,UMB,9419,4216,5203,5590,3743,86,ITI,ITI2,10,Umbria,Umbria,882015,116295,13.19,1.07
2352,2021-02-06,UMB,396,138,258,34,362,0,ITI,ITI2,10,Umbria,Umbria,882015,116691,13.23,0.04
2353,2021-06-02,UMB,3918,1884,2034,3876,42,0,ITI,ITI2,10,Umbria,Umbria,882015,120609,13.67,0.44
2354,2021-02-20,UMB,283,101,182,259,24,0,ITI,ITI2,10,Umbria,Umbria,882015,120892,13.71,0.03
2355,2021-03-09,UMB,4088,2000,2088,2791,1288,9,ITI,ITI2,10,Umbria,Umbria,882015,124980,14.17,0.46
2356,2021-02-13,UMB,114,27,87,111,3,0,ITI,ITI2,10,Umbria,Umbria,882015,125094,14.18,0.01
2357,2021-05-24,UMB,9060,4511,4549,8015,879,166,ITI,ITI2,10,Umbria,Umbria,882015,134154,15.21,1.03
2358,2021-04-18,UMB,1531,681,850,578,930,23,ITI,ITI2,10,Umbria,Umbria,882015,135685,15.38,0.17
2359,2021-01-11,UMB,1303,341,962,1303,0,0,ITI,ITI2,10,Umbria,Umbria,882015,136988,15.53,0.15
2360,2021-07-27,UMB,8115,4079,4036,2754,5308,53,ITI,ITI2,10,Umbria,Umbria,882015,145103,16.45,0.92
2361,2021-05-05,UMB,7220,3305,3915,3833,3306,81,ITI,ITI2,10,Umbria,Umbria,882015,152323,17.27,0.82
2362,2021-01-25,UMB,648,323,325,5,643,0,ITI,ITI2,10,Umbria,Umbria,882015,152971,17.34,0.07
2363,2021-04-06,UMB,5289,2166,3123,2863,2389,37,ITI,ITI2,10,Umbria,Umbria,882015,158260,17.94,0.6
2364,2021-03-28,UMB,1095,441,654,1040,24,31,ITI,ITI2,10,Umbria,Umbria,882015,159355,18.07,0.12
2365,2021-01-30,UMB,1575,486,1089,44,1531,0,ITI,ITI2,10,Umbria,Umbria,882015,160930,18.25,0.18
2366,2021-07-15,UMB,10562,5175,5387,608,9902,52,ITI,ITI2,10,Umbria,Umbria,882015,171492,19.44,1.2
2367,2021-04-25,UMB,4357,1684,2673,3866,82,409,ITI,ITI2,10,Umbria,Umbria,882015,175849,19.94,0.49
2368,2021-06-21,UMB,7500,3932,3568,5160,2338,2,ITI,ITI2,10,Umbria,Umbria,882015,183349,20.79,0.85
2369,2021-03-18,UMB,2965,1171,1794,1699,1262,4,ITI,ITI2,10,Umbria,Umbria,882015,186314,21.12,0.34
2370,2021-06-26,UMB,9314,4730,4584,5690,3623,1,ITI,ITI2,10,Umbria,Umbria,882015,195628,22.18,1.06
2371,2021-07-10,UMB,7681,3808,3873,71,7602,8,ITI,ITI2,10,Umbria,Umbria,882015,203309,23.05,0.87
2372,2021-04-20,UMB,5450,2364,3086,3430,1947,73,ITI,ITI2,10,Umbria,Umbria,882015,208759,23.67,0.62
2373,2021-06-30,UMB,10478,5297,5181,3767,6709,2,ITI,ITI2,10,Umbria,Umbria,882015,219237,24.86,1.19
2374,2021-07-07,UMB,9487,4498,4989,92,9369,26,ITI,ITI2,10,Umbria,Umbria,882015,228724,25.93,1.08
2375,2021-01-01,UMB,273,104,169,273,0,0,ITI,ITI2,10,Umbria,Umbria,882015,228997,25.96,0.03
2376,2021-04-11,UMB,3099,1505,1594,3033,49,17,ITI,ITI2,10,Umbria,Umbria,882015,232096,26.31,0.35
2377,2021-01-18,UMB,614,218,396,529,85,0,ITI,ITI2,10,Umbria,Umbria,882015,232710,26.38,0.07
2378,2021-05-30,UMB,5982,2999,2983,5664,202,116,ITI,ITI2,10,Umbria,Umbria,882015,238692,27.06,0.68
2379,2021-05-26,UMB,9649,4565,5084,8204,1250,195,ITI,ITI2,10,Umbria,Umbria,882015,248341,28.16,1.09
2380,2021-07-26,UMB,8851,4590,4261,3945,4853,53,ITI,ITI2,10,Umbria,Umbria,882015,257192,29.16,1.0
2381,2021-05-28,UMB,9590,4437,5153,7111,2297,182,ITI,ITI2,10,Umbria,Umbria,882015,266782,30.25,1.09
2382,2021-05-31,UMB,5814,2845,2969,4852,884,78,ITI,ITI2,10,Umbria,Umbria,882015,272596,30.91,0.66
2383,2021-05-14,UMB,5328,2509,2819,3353,1817,158,ITI,ITI2,10,Umbria,Umbria,882015,277924,31.51,0.6
2384,2021-02-01,UMB,1284,341,943,48,1236,0,ITI,ITI2,10,Umbria,Umbria,882015,279208,31.66,0.15
2385,2021-02-18,UMB,1496,582,914,1029,466,1,ITI,ITI2,10,Umbria,Umbria,882015,280704,31.83,0.17
2386,2021-07-08,UMB,9560,4628,4932,177,9338,45,ITI,ITI2,10,Umbria,Umbria,882015,290264,32.91,1.08
2387,2021-05-12,UMB,6491,3026,3465,4197,2146,148,ITI,ITI2,10,Umbria,Umbria,882015,296755,33.65,0.74
2388,2021-03-30,UMB,3976,1730,2246,2400,1540,36,ITI,ITI2,10,Umbria,Umbria,882015,300731,34.1,0.45
2389,2020-12-27,UMB,85,44,41,85,0,0,ITI,ITI2,10,Umbria,Umbria,882015,300816,34.11,0.01
2390,2021-02-22,UMB,1889,807,1082,1803,86,0,ITI,ITI2,10,Umbria,Umbria,882015,302705,34.32,0.21
2391,2021-04-04,UMB,57,20,37,22,35,0,ITI,ITI2,10,Umbria,Umbria,882015,302762,34.33,0.01
2392,2021-06-07,UMB,6945,3427,3518,6245,695,5,ITI,ITI2,10,Umbria,Umbria,882015,309707,35.11,0.79
2393,2021-03-16,UMB,3538,1454,2084,1909,1627,2,ITI,ITI2,10,Umbria,Umbria,882015,313245,35.51,0.4
2394,2021-02-27,UMB,1658,354,1304,1642,16,0,ITI,ITI2,10,Umbria,Umbria,882015,314903,35.7,0.19
2395,2021-04-03,UMB,2097,712,1385,1034,1052,11,ITI,ITI2,10,Umbria,Umbria,882015,317000,35.94,0.24
2396,2021-07-12,UMB,4603,2225,2378,107,4487,9,ITI,ITI2,10,Umbria,Umbria,882015,321603,36.46,0.52
2397,2021-03-06,UMB,4303,1146,3157,4133,138,32,ITI,ITI2,10,Umbria,Umbria,882015,325906,36.95,0.49
2398,2021-01-22,UMB,276,105,171,32,244,0,ITI,ITI2,10,Umbria,Umbria,882015,326182,36.98,0.03
2399,2021-06-28,UMB,9753,4811,4942,3791,5962,0,ITI,ITI2,10,Umbria,Umbria,882015,335935,38.09,1.11
2400,2021-05-02,UMB,3780,1866,1914,1298,2454,28,ITI,ITI2,10,Umbria,Umbria,882015,339715,38.52,0.43
2401,2021-03-20,UMB,2319,845,1474,2290,25,4,ITI,ITI2,10,Umbria,Umbria,882015,342034,38.78,0.26
2402,2021-01-27,UMB,840,330,510,13,827,0,ITI,ITI2,10,Umbria,Umbria,882015,342874,38.87,0.1
2403,2021-01-10,UMB,1065,274,791,1065,0,0,ITI,ITI2,10,Umbria,Umbria,882015,343939,38.99,0.12
2404,2021-05-21,UMB,8976,3670,5306,4062,4829,85,ITI,ITI2,10,Umbria,Umbria,882015,352915,40.01,1.02
2405,2021-05-04,UMB,5539,2545,2994,2354,3125,60,ITI,ITI2,10,Umbria,Umbria,882015,358454,40.64,0.63
2406,2021-04-01,UMB,4373,1837,2536,2326,2010,37,ITI,ITI2,10,Umbria,Umbria,882015,362827,41.14,0.5
2407,2021-03-01,UMB,1504,774,730,1384,114,6,ITI,ITI2,10,Umbria,Umbria,882015,364331,41.31,0.17
2408,2021-06-09,UMB,8151,3948,4203,7420,722,9,ITI,ITI2,10,Umbria,Umbria,882015,372482,42.23,0.92
2409,2021-06-23,UMB,11201,5722,5479,7796,3404,1,ITI,ITI2,10,Umbria,Umbria,882015,383683,43.5,1.27
2410,2021-03-15,UMB,4597,1941,2656,2828,1766,3,ITI,ITI2,10,Umbria,Umbria,882015,388280,44.02,0.52
2411,2021-02-10,UMB,714,348,366,699,15,0,ITI,ITI2,10,Umbria,Umbria,882015,388994,44.1,0.08
2412,2021-03-08,UMB,3696,1822,1874,2323,1361,12,ITI,ITI2,10,Umbria,Umbria,882015,392690,44.52,0.42
2413,2021-06-16,UMB,6318,3093,3225,3222,3095,1,ITI,ITI2,10,Umbria,Umbria,882015,399008,45.24,0.72
2414,2021-03-25,UMB,3929,1724,2205,2821,1063,45,ITI,ITI2,10,Umbria,Umbria,882015,402937,45.68,0.45
2415,2021-03-27,UMB,4251,1513,2738,3855,340,56,ITI,ITI2,10,Umbria,Umbria,882015,407188,46.17,0.48
2416,2021-06-18,UMB,4762,2349,2413,1603,3158,1,ITI,ITI2,10,Umbria,Umbria,882015,411950,46.71,0.54
2417,2021-07-05,UMB,8413,4078,4335,161,8245,7,ITI,ITI2,10,Umbria,Umbria,882015,420363,47.66,0.95
2418,2021-05-13,UMB,5919,2658,3261,3706,2084,129,ITI,ITI2,10,Umbria,Umbria,882015,426282,48.33,0.67
2419,2021-02-19,UMB,743,293,450,525,217,1,ITI,ITI2,10,Umbria,Umbria,882015,427025,48.41,0.08
2420,2021-06-01,UMB,4381,2089,2292,4224,155,2,ITI,ITI2,10,Umbria,Umbria,882015,431406,48.91,0.5
2421,2021-03-10,UMB,4030,1942,2088,2759,1256,15,ITI,ITI2,10,Umbria,Umbria,882015,435436,49.37,0.46
2422,2021-05-16,UMB,5219,2493,2726,5087,50,82,ITI,ITI2,10,Umbria,Umbria,882015,440655,49.96,0.59
2423,2021-07-19,UMB,7618,3801,3817,1542,6027,49,ITI,ITI2,10,Umbria,Umbria,882015,448273,50.82,0.86
2424,2021-04-27,UMB,5666,2401,3265,3054,2579,33,ITI,ITI2,10,Umbria,Umbria,882015,453939,51.47,0.64
2425,2021-02-03,UMB,724,174,550,67,657,0,ITI,ITI2,10,Umbria,Umbria,882015,454663,51.55,0.08
2426,2021-05-11,UMB,6237,2836,3401,3904,2193,140,ITI,ITI2,10,Umbria,Umbria,882015,460900,52.26,0.71
2427,2021-03-13,UMB,1735,524,1211,1486,249,0,ITI,ITI2,10,Umbria,Umbria,882015,462635,52.45,0.2
2428,2021-01-15,UMB,695,213,482,695,0,0,ITI,ITI2,10,Umbria,Umbria,882015,463330,52.53,0.08
2429,2021-01-29,UMB,1230,348,882,79,1151,0,ITI,ITI2,10,Umbria,Umbria,882015,464560,52.67,0.14
2430,2021-05-09,UMB,5755,2753,3002,5244,391,120,ITI,ITI2,10,Umbria,Umbria,882015,470315,53.32,0.65
2431,2021-07-09,UMB,9536,4619,4917,123,9399,14,ITI,ITI2,10,Umbria,Umbria,882015,479851,54.4,1.08
2432,2021-07-23,UMB,10411,5252,5159,1370,8987,54,ITI,ITI2,10,Umbria,Umbria,882015,490262,55.58,1.18
2433,2021-07-16,UMB,9616,4894,4722,703,8874,39,ITI,ITI2,10,Umbria,Umbria,882015,499878,56.67,1.09
2434,2021-05-20,UMB,9841,4591,5250,6104,3651,86,ITI,ITI2,10,Umbria,Umbria,882015,509719,57.79,1.12
2435,2021-06-11,UMB,6991,3514,3477,6218,768,5,ITI,ITI2,10,Umbria,Umbria,882015,516710,58.58,0.79
2436,2021-04-08,UMB,5866,2509,3357,4007,1791,68,ITI,ITI2,10,Umbria,Umbria,882015,522576,59.25,0.67
2437,2021-07-17,UMB,7656,3851,3805,1366,6223,67,ITI,ITI2,10,Umbria,Umbria,882015,530232,60.12,0.87
2438,2021-06-04,UMB,8913,4405,4508,7706,1198,9,ITI,ITI2,10,Umbria,Umbria,882015,539145,61.13,1.01
2439,2021-06-13,UMB,6763,3556,3207,6528,230,5,ITI,ITI2,10,Umbria,Umbria,882015,545908,61.89,0.77
2440,2021-05-01,UMB,5370,2638,2732,2096,3230,44,ITI,ITI2,10,Umbria,Umbria,882015,551278,62.5,0.61
2441,2021-03-05,UMB,4618,1402,3216,3947,656,15,ITI,ITI2,10,Umbria,Umbria,882015,555896,63.03,0.52
2442,2021-03-03,UMB,4431,1770,2661,3718,710,3,ITI,ITI2,10,Umbria,Umbria,882015,560327,63.53,0.5
2443,2021-01-08,UMB,1187,344,843,1187,0,0,ITI,ITI2,10,Umbria,Umbria,882015,561514,63.66,0.13
2444,2021-05-23,UMB,5068,1854,3214,635,4416,17,ITI,ITI2,10,Umbria,Umbria,882015,566582,64.24,0.57
2445,2021-01-16,UMB,217,71,146,216,0,1,ITI,ITI2,10,Umbria,Umbria,882015,566799,64.26,0.02
2446,2021-02-02,UMB,942,272,670,32,910,0,ITI,ITI2,10,Umbria,Umbria,882015,567741,64.37,0.11
2447,2021-04-26,UMB,5397,2341,3056,3103,2254,40,ITI,ITI2,10,Umbria,Umbria,882015,573138,64.98,0.61
2448,2021-04-09,UMB,6733,3126,3607,6406,210,117,ITI,ITI2,10,Umbria,Umbria,882015,579871,65.74,0.76
2449,2021-06-06,UMB,7608,3904,3704,6912,693,3,ITI,ITI2,10,Umbria,Umbria,882015,587479,66.61,0.86
2450,2021-02-24,UMB,1518,563,955,1503,15,0,ITI,ITI2,10,Umbria,Umbria,882015,588997,66.78,0.17
2451,2021-03-17,UMB,3329,1313,2016,1855,1472,2,ITI,ITI2,10,Umbria,Umbria,882015,592326,67.16,0.38
2452,2021-01-07,UMB,1300,387,913,1300,0,0,ITI,ITI2,10,Umbria,Umbria,882015,593626,67.3,0.15
2453,2021-06-25,UMB,10163,5283,4880,5385,4772,6,ITI,ITI2,10,Umbria,Umbria,882015,603789,68.46,1.15
2454,2021-03-29,UMB,3630,1600,2030,2152,1420,58,ITI,ITI2,10,Umbria,Umbria,882015,607419,68.87,0.41
2455,2021-01-31,UMB,1058,276,782,25,1033,0,ITI,ITI2,10,Umbria,Umbria,882015,608477,68.99,0.12
2456,2021-05-25,UMB,8815,4301,4514,7584,1063,168,ITI,ITI2,10,Umbria,Umbria,882015,617292,69.99,1.0
2457,2021-01-24,UMB,258,106,152,1,257,0,ITI,ITI2,10,Umbria,Umbria,882015,617550,70.02,0.03
2458,2021-06-08,UMB,7377,3641,3736,6819,546,12,ITI,ITI2,10,Umbria,Umbria,882015,624927,70.85,0.84
2459,2021-02-05,UMB,780,234,546,18,762,0,ITI,ITI2,10,Umbria,Umbria,882015,625707,70.94,0.09
2460,2021-07-21,UMB,9457,4585,4872,1082,8331,44,ITI,ITI2,10,Umbria,Umbria,882015,635164,72.01,1.07
2461,2021-07-04,UMB,3407,1740,1667,2409,968,30,ITI,ITI2,10,Umbria,Umbria,882015,638571,72.4,0.39
2462,2021-04-12,UMB,7085,3081,4004,5311,1717,57,ITI,ITI2,10,Umbria,Umbria,882015,645656,73.2,0.8
2463,2021-01-19,UMB,102,23,79,102,0,0,ITI,ITI2,10,Umbria,Umbria,882015,645758,73.21,0.01
2464,2021-04-29,UMB,5216,2250,2966,2808,2320,88,ITI,ITI2,10,Umbria,Umbria,882015,650974,73.81,0.59
2465,2021-03-24,UMB,4104,1792,2312,2744,1323,37,ITI,ITI2,10,Umbria,Umbria,882015,655078,74.27,0.47
2466,2021-07-02,UMB,8737,4322,4415,3047,5600,90,ITI,ITI2,10,Umbria,Umbria,882015,663815,75.26,0.99
2467,2021-04-10,UMB,7392,3478,3914,7176,84,132,ITI,ITI2,10,Umbria,Umbria,882015,671207,76.1,0.84
2468,2021-01-17,UMB,54,17,37,54,0,0,ITI,ITI2,10,Umbria,Umbria,882015,671261,76.11,0.01
2469,2020-12-31,UMB,322,127,195,322,0,0,ITI,ITI2,10,Umbria,Umbria,882015,671583,76.14,0.04
2470,2021-06-15,UMB,5973,3011,2962,3903,2067,3,ITI,ITI2,10,Umbria,Umbria,882015,677556,76.82,0.68
2471,2021-07-06,UMB,8592,4093,4499,152,8419,21,ITI,ITI2,10,Umbria,Umbria,882015,686148,77.79,0.97
2472,2021-05-10,UMB,5993,2801,3192,3772,2148,73,ITI,ITI2,10,Umbria,Umbria,882015,692141,78.47,0.68
2473,2021-05-08,UMB,8133,3740,4393,4803,3228,102,ITI,ITI2,10,Umbria,Umbria,882015,700274,79.39,0.92
2474,2021-01-28,UMB,1248,394,854,19,1229,0,ITI,ITI2,10,Umbria,Umbria,882015,701522,79.54,0.14
2475,2021-05-03,UMB,5086,2270,2816,2098,2887,101,ITI,ITI2,10,Umbria,Umbria,882015,706608,80.11,0.58
2476,2021-01-23,UMB,280,100,180,2,278,0,ITI,ITI2,10,Umbria,Umbria,882015,706888,80.14,0.03
2477,2021-03-31,UMB,3896,1727,2169,2179,1685,32,ITI,ITI2,10,Umbria,Umbria,882015,710784,80.59,0.44
2478,2021-02-16,UMB,1308,655,653,1299,9,0,ITI,ITI2,10,Umbria,Umbria,882015,712092,80.73,0.15
2479,2021-05-27,UMB,9972,4865,5107,8475,1318,179,ITI,ITI2,10,Umbria,Umbria,882015,722064,81.87,1.13
2480,2021-01-04,UMB,809,398,411,809,0,0,ITI,ITI2,10,Umbria,Umbria,882015,722873,81.96,0.09
2481,2021-04-14,UMB,8153,3680,4473,6097,1979,77,ITI,ITI2,10,Umbria,Umbria,882015,731026,82.88,0.92
2482,2021-01-26,UMB,815,389,426,17,798,0,ITI,ITI2,10,Umbria,Umbria,882015,731841,82.97,0.09
2483,2021-02-12,UMB,670,224,446,664,6,0,ITI,ITI2,10,Umbria,Umbria,882015,732511,83.05,0.08
2484,2021-02-26,UMB,660,253,407,650,8,2,ITI,ITI2,10,Umbria,Umbria,882015,733171,83.12,0.07
2485,2021-05-06,UMB,9458,4318,5140,6024,3314,120,ITI,ITI2,10,Umbria,Umbria,882015,742629,84.2,1.07
2486,2021-06-03,UMB,9040,4470,4570,8749,289,2,ITI,ITI2,10,Umbria,Umbria,882015,751669,85.22,1.02
2487,2021-04-07,UMB,5574,2291,3283,3484,2005,85,ITI,ITI2,10,Umbria,Umbria,882015,757243,85.85,0.63
2488,2021-02-23,UMB,1691,657,1034,1649,42,0,ITI,ITI2,10,Umbria,Umbria,882015,758934,86.05,0.19
2489,2021-04-28,UMB,5384,2327,3057,2943,2396,45,ITI,ITI2,10,Umbria,Umbria,882015,764318,86.66,0.61
2490,2021-02-04,UMB,734,226,508,26,708,0,ITI,ITI2,10,Umbria,Umbria,882015,765052,86.74,0.08
2491,2021-05-15,UMB,4991,1883,3108,1764,3164,63,ITI,ITI2,10,Umbria,Umbria,882015,770043,87.3,0.57
2492,2021-06-17,UMB,6968,3542,3426,4875,2079,14,ITI,ITI2,10,Umbria,Umbria,882015,777011,88.09,0.79
2493,2021-03-26,UMB,4592,1715,2877,4345,172,75,ITI,ITI2,10,Umbria,Umbria,882015,781603,88.62,0.52
2494,2021-01-02,UMB,304,111,193,304,0,0,ITI,ITI2,10,Umbria,Umbria,882015,781907,88.65,0.03
2495,2021-03-07,UMB,845,180,665,837,7,1,ITI,ITI2,10,Umbria,Umbria,882015,782752,88.75,0.1
2496,2021-05-29,UMB,7857,3612,4245,6176,1567,114,ITI,ITI2,10,Umbria,Umbria,882015,790609,89.64,0.89
2497,2021-06-27,UMB,7456,3730,3726,1769,5686,1,ITI,ITI2,10,Umbria,Umbria,882015,798065,90.48,0.85
2498,2021-01-21,UMB,608,202,406,338,269,1,ITI,ITI2,10,Umbria,Umbria,882015,798673,90.55,0.07
2499,2021-05-18,UMB,7751,3358,4393,3828,3841,82,ITI,ITI2,10,Umbria,Umbria,882015,806424,91.43,0.88
2500,2021-03-22,UMB,3561,1656,1905,2305,1246,10,ITI,ITI2,10,Umbria,Umbria,882015,809985,91.83,0.4
2501,2021-04-05,UMB,4249,1729,2520,2182,2055,12,ITI,ITI2,10,Umbria,Umbria,882015,814234,92.32,0.48
2502,2021-02-07,UMB,54,17,37,1,53,0,ITI,ITI2,10,Umbria,Umbria,882015,814288,92.32,0.01
2503,2021-07-14,UMB,6194,3006,3188,1750,4259,185,ITI,ITI2,10,Umbria,Umbria,882015,820482,93.02,0.7
2504,2021-07-18,UMB,7853,4063,3790,296,7553,4,ITI,ITI2,10,Umbria,Umbria,882015,828335,93.91,0.89
2505,2021-06-05,UMB,8224,3775,4449,5565,2654,5,ITI,ITI2,10,Umbria,Umbria,882015,836559,94.85,0.93
2506,2021-07-25,UMB,7305,3849,3456,1197,6095,13,ITI,ITI2,10,Umbria,Umbria,882015,843864,95.67,0.83
2507,2021-06-10,UMB,7546,3760,3786,6758,778,10,ITI,ITI2,10,Umbria,Umbria,882015,851410,96.53,0.86
2508,2021-07-28,UMB,8023,4151,3872,3015,4951,57,ITI,ITI2,10,Umbria,Umbria,882015,859433,97.44,0.91
2509,2021-02-11,UMB,839,348,491,834,5,0,ITI,ITI2,10,Umbria,Umbria,882015,860272,97.53,0.1
2510,2021-05-22,UMB,6969,2755,4214,2598,4324,47,ITI,ITI2,10,Umbria,Umbria,882015,867241,98.32,0.79
2511,2021-07-13,UMB,4223,2004,2219,81,4136,6,ITI,ITI2,10,Umbria,Umbria,882015,871464,98.8,0.48
2512,2021-04-21,UMB,5324,2318,3006,3057,2229,38,ITI,ITI2,10,Umbria,Umbria,882015,876788,99.41,0.6
2513,2021-07-30,UMB,6070,3172,2898,3230,2786,54,ITI,ITI2,10,Umbria,Umbria,882015,882858,100.1,0.69
2514,2021-03-02,UMB,3641,1346,2295,3634,4,3,ITI,ITI2,10,Umbria,Umbria,882015,886499,100.51,0.41
2515,2021-06-24,UMB,10142,5114,5028,6138,4000,4,ITI,ITI2,10,Umbria,Umbria,882015,896641,101.66,1.15
2516,2021-07-11,UMB,5864,2956,2908,83,5780,1,ITI,ITI2,10,Umbria,Umbria,882015,902505,102.32,0.66
2517,2021-04-02,UMB,4343,1778,2565,3545,755,43,ITI,ITI2,10,Umbria,Umbria,882015,906848,102.82,0.49
2518,2021-01-09,UMB,1717,495,1222,1717,0,0,ITI,ITI2,10,Umbria,Umbria,882015,908565,103.01,0.19
2519,2021-04-19,UMB,5034,2227,2807,2931,2048,55,ITI,ITI2,10,Umbria,Umbria,882015,913599,103.58,0.57
2520,2021-04-15,UMB,7652,3500,4152,5695,1887,70,ITI,ITI2,10,Umbria,Umbria,882015,921251,104.45,0.87
2521,2021-02-17,UMB,1618,748,870,1266,351,1,ITI,ITI2,10,Umbria,Umbria,882015,922869,104.63,0.18
2522,2021-07-24,UMB,8682,4362,4320,1384,7270,28,ITI,ITI2,10,Umbria,Umbria,882015,931551,105.62,0.98
2523,2021-04-13,UMB,7677,3398,4279,5920,1668,89,ITI,ITI2,10,Umbria,Umbria,882015,939228,106.49,0.87
2524,2021-02-15,UMB,1367,692,675,1364,1,2,ITI,ITI2,10,Umbria,Umbria,882015,940595,106.64,0.15
2525,2021-01-03,UMB,270,112,158,270,0,0,ITI,ITI2,10,Umbria,Umbria,882015,940865,106.67,0.03
2526,2021-04-22,UMB,5452,2249,3203,2701,2669,82,ITI,ITI2,10,Umbria,Umbria,882015,946317,107.29,0.62
2527,2021-04-17,UMB,6678,3069,3609,5172,1341,165,ITI,ITI2,10,Umbria,Umbria,882015,952995,108.05,0.76
2528,2021-01-05,UMB,854,429,425,854,0,0,ITI,ITI2,10,Umbria,Umbria,882015,953849,108.14,0.1
2529,2021-06-20,UMB,6213,3001,3212,1593,4620,0,ITI,ITI2,10,Umbria,Umbria,882015,960062,108.85,0.7
2530,2021-04-24,UMB,4562,1961,2601,3276,1183,103,ITI,ITI2,10,Umbria,Umbria,882015,964624,109.37,0.52
2531,2021-01-12,UMB,834,247,587,834,0,0,ITI,ITI2,10,Umbria,Umbria,882015,965458,109.46,0.09
2532,2021-03-14,UMB,66,48,18,66,0,0,ITI,ITI2,10,Umbria,Umbria,882015,965524,109.47,0.01
2533,2021-06-22,UMB,8035,4080,3955,5242,2789,4,ITI,ITI2,10,Umbria,Umbria,882015,973559,110.38,0.91
2534,2021-03-12,UMB,2694,1081,1613,2191,495,8,ITI,ITI2,10,Umbria,Umbria,882015,976253,110.68,0.31
2535,2021-03-21,UMB,675,338,337,672,0,3,ITI,ITI2,10,Umbria,Umbria,882015,976928,110.76,0.08
2536,2021-06-29,UMB,9880,5032,4848,4194,5683,3,ITI,ITI2,10,Umbria,Umbria,882015,986808,111.88,1.12
2537,2021-05-17,UMB,6370,3062,3308,4139,2177,54,ITI,ITI2,10,Umbria,Umbria,882015,993178,112.6,0.72
2538,2021-01-14,UMB,722,192,530,722,0,0,ITI,ITI2,10,Umbria,Umbria,882015,993900,112.69,0.08
2539,2021-03-19,UMB,1741,565,1176,1080,656,5,ITI,ITI2,10,Umbria,Umbria,882015,995641,112.88,0.2
2540,2021-01-11,VEN,7244,2102,5142,7243,0,1,ITH,ITH3,5,Veneto,Veneto,4905854,7244,0.15,0.15
2541,2021-04-21,VEN,32416,13206,19210,15583,16061,772,ITH,ITH3,5,Veneto,Veneto,4905854,39660,0.81,0.66
2542,2021-05-22,VEN,34830,16704,18126,12718,21444,668,ITH,ITH3,5,Veneto,Veneto,4905854,74490,1.52,0.71
2543,2021-02-11,VEN,4014,1238,2776,3347,628,39,ITH,ITH3,5,Veneto,Veneto,4905854,78504,1.6,0.08
2544,2021-01-28,VEN,9216,2666,6550,168,9046,2,ITH,ITH3,5,Veneto,Veneto,4905854,87720,1.79,0.19
2545,2021-05-05,VEN,44415,21277,23138,36234,6568,1613,ITH,ITH3,5,Veneto,Veneto,4905854,132135,2.69,0.91
2546,2021-07-01,VEN,50938,25999,24939,20690,29207,1041,ITH,ITH3,5,Veneto,Veneto,4905854,183073,3.73,1.04
2547,2021-05-12,VEN,36984,17901,19083,30237,5129,1618,ITH,ITH3,5,Veneto,Veneto,4905854,220057,4.49,0.75
2548,2021-05-17,VEN,26522,12985,13537,15667,10034,821,ITH,ITH3,5,Veneto,Veneto,4905854,246579,5.03,0.54
2549,2021-02-06,VEN,4096,1354,2742,708,3388,0,ITH,ITH3,5,Veneto,Veneto,4905854,250675,5.11,0.08
2550,2021-02-23,VEN,7383,3253,4130,7029,270,84,ITH,ITH3,5,Veneto,Veneto,4905854,258058,5.26,0.15
2551,2021-01-23,VEN,4055,1249,2806,31,4024,0,ITH,ITH3,5,Veneto,Veneto,4905854,262113,5.34,0.08
2552,2021-06-29,VEN,45567,22730,22837,19025,25829,713,ITH,ITH3,5,Veneto,Veneto,4905854,307680,6.27,0.93
2553,2021-03-21,VEN,11985,4754,7231,8281,3464,240,ITH,ITH3,5,Veneto,Veneto,4905854,319665,6.52,0.24
2554,2021-01-16,VEN,4611,1542,3069,4611,0,0,ITH,ITH3,5,Veneto,Veneto,4905854,324276,6.61,0.09
2555,2021-03-14,VEN,15178,5942,9236,13847,894,437,ITH,ITH3,5,Veneto,Veneto,4905854,339454,6.92,0.31
2556,2021-07-18,VEN,41805,22004,19801,7605,33700,500,ITH,ITH3,5,Veneto,Veneto,4905854,381259,7.77,0.85
2557,2021-02-25,VEN,7900,3341,4559,7158,605,137,ITH,ITH3,5,Veneto,Veneto,4905854,389159,7.93,0.16
2558,2021-04-09,VEN,31206,13770,17436,21919,8349,938,ITH,ITH3,5,Veneto,Veneto,4905854,420365,8.57,0.64
2559,2021-06-05,VEN,46884,24149,22735,37340,8099,1445,ITH,ITH3,5,Veneto,Veneto,4905854,467249,9.52,0.96
2560,2021-06-17,VEN,51805,25971,25834,25648,25009,1148,ITH,ITH3,5,Veneto,Veneto,4905854,519054,10.58,1.06
2561,2021-03-09,VEN,16547,7450,9097,9828,6323,396,ITH,ITH3,5,Veneto,Veneto,4905854,535601,10.92,0.34
2562,2021-05-31,VEN,31651,16248,15403,20901,9928,822,ITH,ITH3,5,Veneto,Veneto,4905854,567252,11.56,0.65
2563,2021-03-26,VEN,29620,13162,16458,23294,5464,862,ITH,ITH3,5,Veneto,Veneto,4905854,596872,12.17,0.6
2564,2021-03-28,VEN,31311,13609,17702,26884,3616,811,ITH,ITH3,5,Veneto,Veneto,4905854,628183,12.8,0.64
2565,2021-06-19,VEN,49305,25085,24220,25702,22574,1029,ITH,ITH3,5,Veneto,Veneto,4905854,677488,13.81,1.01
2566,2021-07-13,VEN,49222,25622,23600,10677,37923,622,ITH,ITH3,5,Veneto,Veneto,4905854,726710,14.81,1.0
2567,2021-04-04,VEN,7790,3533,4257,6516,1148,126,ITH,ITH3,5,Veneto,Veneto,4905854,734500,14.97,0.16
2568,2021-05-24,VEN,33095,16438,16657,7633,25055,407,ITH,ITH3,5,Veneto,Veneto,4905854,767595,15.65,0.67
2569,2021-07-27,VEN,43754,23011,20743,12479,30440,835,ITH,ITH3,5,Veneto,Veneto,4905854,811349,16.54,0.89
2570,2021-04-23,VEN,31280,13853,17427,21424,8706,1150,ITH,ITH3,5,Veneto,Veneto,4905854,842629,17.18,0.64
2571,2021-02-16,VEN,6644,2870,3774,6438,176,30,ITH,ITH3,5,Veneto,Veneto,4905854,849273,17.31,0.14
2572,2021-05-10,VEN,36550,17117,19433,25465,9850,1235,ITH,ITH3,5,Veneto,Veneto,4905854,885823,18.06,0.75
2573,2021-01-30,VEN,8758,2676,6082,695,8063,0,ITH,ITH3,5,Veneto,Veneto,4905854,894581,18.23,0.18
2574,2021-03-07,VEN,4498,1772,2726,3868,561,69,ITH,ITH3,5,Veneto,Veneto,4905854,899079,18.33,0.09
2575,2021-05-03,VEN,40720,19813,20907,32825,6438,1457,ITH,ITH3,5,Veneto,Veneto,4905854,939799,19.16,0.83
2576,2021-03-02,VEN,11495,4629,6866,7935,3313,247,ITH,ITH3,5,Veneto,Veneto,4905854,951294,19.39,0.23
2577,2021-06-10,VEN,52431,27048,25383,41398,9343,1690,ITH,ITH3,5,Veneto,Veneto,4905854,1003725,20.46,1.07
2578,2021-04-02,VEN,24102,10625,13477,17128,6331,643,ITH,ITH3,5,Veneto,Veneto,4905854,1027827,20.95,0.49
2579,2021-06-09,VEN,42919,22019,20900,33934,7438,1547,ITH,ITH3,5,Veneto,Veneto,4905854,1070746,21.83,0.87
2580,2021-07-08,VEN,51289,26824,24465,8767,41941,581,ITH,ITH3,5,Veneto,Veneto,4905854,1122035,22.87,1.05
2581,2021-06-24,VEN,56206,28469,27737,17679,37831,696,ITH,ITH3,5,Veneto,Veneto,4905854,1178241,24.02,1.15
2582,2021-03-16,VEN,12529,5354,7175,6640,5622,267,ITH,ITH3,5,Veneto,Veneto,4905854,1190770,24.27,0.26
2583,2021-03-23,VEN,22220,10243,11977,16871,4713,636,ITH,ITH3,5,Veneto,Veneto,4905854,1212990,24.73,0.45
2584,2021-05-19,VEN,33155,15182,17973,16228,15990,937,ITH,ITH3,5,Veneto,Veneto,4905854,1246145,25.4,0.68
2585,2021-04-28,VEN,32446,15191,17255,22253,9017,1176,ITH,ITH3,5,Veneto,Veneto,4905854,1278591,26.06,0.66
2586,2021-07-20,VEN,45502,24350,21152,7561,36934,1007,ITH,ITH3,5,Veneto,Veneto,4905854,1324093,26.99,0.93
2587,2021-01-18,VEN,2765,776,1989,2561,199,5,ITH,ITH3,5,Veneto,Veneto,4905854,1326858,27.05,0.06
2588,2021-02-04,VEN,7395,2029,5366,550,6844,1,ITH,ITH3,5,Veneto,Veneto,4905854,1334253,27.2,0.15
2589,2021-04-30,VEN,50216,23590,26626,33149,15666,1401,ITH,ITH3,5,Veneto,Veneto,4905854,1384469,28.22,1.02
2590,2021-01-20,VEN,1038,368,670,386,652,0,ITH,ITH3,5,Veneto,Veneto,4905854,1385507,28.24,0.02
2591,2021-06-12,VEN,48738,24531,24207,36478,10799,1461,ITH,ITH3,5,Veneto,Veneto,4905854,1434245,29.24,0.99
2592,2021-05-02,VEN,37248,17265,19983,25620,10334,1294,ITH,ITH3,5,Veneto,Veneto,4905854,1471493,29.99,0.76
2593,2021-07-06,VEN,49764,25868,23896,26097,22373,1294,ITH,ITH3,5,Veneto,Veneto,4905854,1521257,31.01,1.01
2594,2021-04-14,VEN,15931,6906,9025,8762,6630,539,ITH,ITH3,5,Veneto,Veneto,4905854,1537188,31.33,0.32
2595,2021-01-04,VEN,6738,2036,4702,6736,0,2,ITH,ITH3,5,Veneto,Veneto,4905854,1543926,31.47,0.14
2596,2021-05-14,VEN,46837,22286,24551,24339,20924,1574,ITH,ITH3,5,Veneto,Veneto,4905854,1590763,32.43,0.95
2597,2021-02-20,VEN,6428,2018,4410,6275,72,81,ITH,ITH3,5,Veneto,Veneto,4905854,1597191,32.56,0.13
2598,2021-05-29,VEN,33039,16692,16347,24249,7674,1116,ITH,ITH3,5,Veneto,Veneto,4905854,1630230,33.23,0.67
2599,2021-02-18,VEN,5828,2455,3373,5725,64,39,ITH,ITH3,5,Veneto,Veneto,4905854,1636058,33.35,0.12
2600,2021-07-25,VEN,34468,18204,16264,11683,21854,931,ITH,ITH3,5,Veneto,Veneto,4905854,1670526,34.05,0.7
2601,2021-04-16,VEN,24455,10497,13958,11893,11888,674,ITH,ITH3,5,Veneto,Veneto,4905854,1694981,34.55,0.5
2602,2021-01-09,VEN,7933,2539,5394,7927,0,6,ITH,ITH3,5,Veneto,Veneto,4905854,1702914,34.71,0.16
2603,2021-03-18,VEN,12617,5143,7474,7033,5231,353,ITH,ITH3,5,Veneto,Veneto,4905854,1715531,34.97,0.26
2604,2021-06-26,VEN,48090,24528,23562,13589,34000,501,ITH,ITH3,5,Veneto,Veneto,4905854,1763621,35.95,0.98
2605,2021-05-28,VEN,46864,22939,23925,23702,21965,1197,ITH,ITH3,5,Veneto,Veneto,4905854,1810485,36.9,0.96
2606,2021-07-24,VEN,43155,23196,19959,14236,27662,1257,ITH,ITH3,5,Veneto,Veneto,4905854,1853640,37.78,0.88
2607,2021-07-10,VEN,49709,26902,22807,12473,36534,702,ITH,ITH3,5,Veneto,Veneto,4905854,1903349,38.8,1.01
2608,2021-07-17,VEN,44963,23871,21092,8396,35903,664,ITH,ITH3,5,Veneto,Veneto,4905854,1948312,39.71,0.92
2609,2021-05-21,VEN,44864,22053,22811,19834,23928,1102,ITH,ITH3,5,Veneto,Veneto,4905854,1993176,40.63,0.91
2610,2021-06-28,VEN,47595,24089,23506,18374,28500,721,ITH,ITH3,5,Veneto,Veneto,4905854,2040771,41.6,0.97
2611,2021-01-25,VEN,6469,2077,4392,157,6312,0,ITH,ITH3,5,Veneto,Veneto,4905854,2047240,41.73,0.13
2612,2021-07-29,VEN,48821,25804,23017,20890,26347,1584,ITH,ITH3,5,Veneto,Veneto,4905854,2096061,42.73,1.0
2613,2021-07-15,VEN,57502,30171,27331,11813,44996,693,ITH,ITH3,5,Veneto,Veneto,4905854,2153563,43.9,1.17
2614,2021-04-20,VEN,22458,9500,12958,7886,14005,567,ITH,ITH3,5,Veneto,Veneto,4905854,2176021,44.36,0.46
2615,2021-07-03,VEN,38707,20120,18587,11026,27094,587,ITH,ITH3,5,Veneto,Veneto,4905854,2214728,45.14,0.79
2616,2021-06-16,VEN,47896,23635,24261,25390,21414,1092,ITH,ITH3,5,Veneto,Veneto,4905854,2262624,46.12,0.98
2617,2021-01-01,VEN,1528,471,1057,1527,0,1,ITH,ITH3,5,Veneto,Veneto,4905854,2264152,46.15,0.03
2618,2021-03-25,VEN,25976,11063,14913,18975,6103,898,ITH,ITH3,5,Veneto,Veneto,4905854,2290128,46.68,0.53
2619,2021-04-11,VEN,21012,8873,12139,14232,6295,485,ITH,ITH3,5,Veneto,Veneto,4905854,2311140,47.11,0.43
2620,2021-07-22,VEN,50044,25991,24053,14501,34316,1227,ITH,ITH3,5,Veneto,Veneto,4905854,2361184,48.13,1.02
2621,2021-04-13,VEN,14034,6325,7709,8057,5477,500,ITH,ITH3,5,Veneto,Veneto,4905854,2375218,48.42,0.29
2622,2021-07-05,VEN,39216,20329,18887,14192,24195,829,ITH,ITH3,5,Veneto,Veneto,4905854,2414434,49.22,0.8
2623,2021-01-03,VEN,5157,1562,3595,5157,0,0,ITH,ITH3,5,Veneto,Veneto,4905854,2419591,49.32,0.11
2624,2021-03-08,VEN,13636,6273,7363,9303,4069,264,ITH,ITH3,5,Veneto,Veneto,4905854,2433227,49.6,0.28
2625,2021-06-18,VEN,53693,26779,26914,24057,28607,1029,ITH,ITH3,5,Veneto,Veneto,4905854,2486920,50.69,1.09
2626,2021-03-27,VEN,32086,14015,18071,25374,5807,905,ITH,ITH3,5,Veneto,Veneto,4905854,2519006,51.35,0.65
2627,2021-06-02,VEN,20310,10235,10075,15357,4340,613,ITH,ITH3,5,Veneto,Veneto,4905854,2539316,51.76,0.41
2628,2021-03-11,VEN,19832,8893,10939,13798,5570,464,ITH,ITH3,5,Veneto,Veneto,4905854,2559148,52.17,0.4
2629,2021-02-08,VEN,5007,1559,3448,1923,3078,6,ITH,ITH3,5,Veneto,Veneto,4905854,2564155,52.27,0.1
2630,2021-04-06,VEN,29005,13351,15654,23239,5043,723,ITH,ITH3,5,Veneto,Veneto,4905854,2593160,52.86,0.59
2631,2021-02-01,VEN,8564,2502,6062,157,8407,0,ITH,ITH3,5,Veneto,Veneto,4905854,2601724,53.03,0.17
2632,2021-02-15,VEN,4391,1826,2565,4142,240,9,ITH,ITH3,5,Veneto,Veneto,4905854,2606115,53.12,0.09
2633,2021-02-17,VEN,6022,2772,3250,5900,94,28,ITH,ITH3,5,Veneto,Veneto,4905854,2612137,53.25,0.12
2634,2021-04-01,VEN,25388,11190,14198,18202,6411,775,ITH,ITH3,5,Veneto,Veneto,4905854,2637525,53.76,0.52
2635,2021-04-15,VEN,20933,8646,12287,9360,10828,745,ITH,ITH3,5,Veneto,Veneto,4905854,2658458,54.19,0.43
2636,2021-01-05,VEN,7333,2186,5147,7331,0,2,ITH,ITH3,5,Veneto,Veneto,4905854,2665791,54.34,0.15
2637,2021-02-10,VEN,4758,1591,3167,3693,1056,9,ITH,ITH3,5,Veneto,Veneto,4905854,2670549,54.44,0.1
2638,2021-04-08,VEN,32382,14373,18009,23335,7879,1168,ITH,ITH3,5,Veneto,Veneto,4905854,2702931,55.1,0.66
2639,2021-04-18,VEN,17523,7258,10265,9505,7567,451,ITH,ITH3,5,Veneto,Veneto,4905854,2720454,55.45,0.36
2640,2021-01-08,VEN,9410,2836,6574,9396,0,14,ITH,ITH3,5,Veneto,Veneto,4905854,2729864,55.65,0.19
2641,2021-01-13,VEN,5988,1606,4382,5985,0,3,ITH,ITH3,5,Veneto,Veneto,4905854,2735852,55.77,0.12
2642,2021-04-25,VEN,18340,8158,10182,12912,4835,593,ITH,ITH3,5,Veneto,Veneto,4905854,2754192,56.14,0.37
2643,2021-06-21,VEN,44346,22196,22150,20484,22959,903,ITH,ITH3,5,Veneto,Veneto,4905854,2798538,57.04,0.9
2644,2021-01-06,VEN,8140,2390,5750,8137,0,3,ITH,ITH3,5,Veneto,Veneto,4905854,2806678,57.21,0.17
2645,2021-06-23,VEN,49418,24480,24938,14623,33985,810,ITH,ITH3,5,Veneto,Veneto,4905854,2856096,58.22,1.01
2646,2021-03-15,VEN,16673,7330,9343,10960,5211,502,ITH,ITH3,5,Veneto,Veneto,4905854,2872769,58.56,0.34
2647,2021-05-07,VEN,48651,23304,25347,37633,8668,2350,ITH,ITH3,5,Veneto,Veneto,4905854,2921420,59.55,0.99
2648,2021-01-27,VEN,7142,2065,5077,240,6901,1,ITH,ITH3,5,Veneto,Veneto,4905854,2928562,59.7,0.15
2649,2021-02-13,VEN,3266,1473,1793,3230,20,16,ITH,ITH3,5,Veneto,Veneto,4905854,2931828,59.76,0.07
2650,2021-06-03,VEN,54588,28066,26522,40967,11982,1639,ITH,ITH3,5,Veneto,Veneto,4905854,2986416,60.87,1.11
2651,2021-06-20,VEN,41287,20110,21177,19011,21533,743,ITH,ITH3,5,Veneto,Veneto,4905854,3027703,61.72,0.84
2652,2021-02-19,VEN,7324,3140,4184,6995,204,125,ITH,ITH3,5,Veneto,Veneto,4905854,3035027,61.87,0.15
2653,2021-05-18,VEN,27110,12565,14545,12656,13629,825,ITH,ITH3,5,Veneto,Veneto,4905854,3062137,62.42,0.55
2654,2021-06-30,VEN,45822,23113,22709,17895,27148,779,ITH,ITH3,5,Veneto,Veneto,4905854,3107959,63.35,0.93
2655,2021-03-22,VEN,18154,8181,9973,12588,5048,518,ITH,ITH3,5,Veneto,Veneto,4905854,3126113,63.72,0.37
2656,2021-03-13,VEN,17235,7309,9926,13733,3131,371,ITH,ITH3,5,Veneto,Veneto,4905854,3143348,64.07,0.35
2657,2021-01-15,VEN,5878,1821,4057,5872,0,6,ITH,ITH3,5,Veneto,Veneto,4905854,3149226,64.19,0.12
2658,2021-03-03,VEN,12099,4647,7452,8387,3500,212,ITH,ITH3,5,Veneto,Veneto,4905854,3161325,64.44,0.25
2659,2021-06-11,VEN,47345,24629,22716,34749,11178,1418,ITH,ITH3,5,Veneto,Veneto,4905854,3208670,65.4,0.97
2660,2021-06-25,VEN,51734,26174,25560,15090,35998,646,ITH,ITH3,5,Veneto,Veneto,4905854,3260404,66.46,1.05
2661,2021-03-30,VEN,35992,15307,20685,29736,5248,1008,ITH,ITH3,5,Veneto,Veneto,4905854,3296396,67.19,0.73
2662,2021-04-10,VEN,27487,11988,15499,18392,8470,625,ITH,ITH3,5,Veneto,Veneto,4905854,3323883,67.75,0.56
2663,2021-06-06,VEN,37449,19172,18277,31498,4730,1221,ITH,ITH3,5,Veneto,Veneto,4905854,3361332,68.52,0.76
2664,2020-12-27,VEN,880,395,485,880,0,0,ITH,ITH3,5,Veneto,Veneto,4905854,3362212,68.53,0.02
2665,2021-05-30,VEN,22542,11266,11276,15205,6687,650,ITH,ITH3,5,Veneto,Veneto,4905854,3384754,68.99,0.46
2666,2021-07-26,VEN,45464,23928,21536,18258,25941,1265,ITH,ITH3,5,Veneto,Veneto,4905854,3430218,69.92,0.93
2667,2021-05-09,VEN,35113,16159,18954,23820,10054,1239,ITH,ITH3,5,Veneto,Veneto,4905854,3465331,70.64,0.72
2668,2021-05-26,VEN,31157,15229,15928,13993,16488,676,ITH,ITH3,5,Veneto,Veneto,4905854,3496488,71.27,0.64
2669,2021-03-01,VEN,9394,3716,5678,7409,1822,163,ITH,ITH3,5,Veneto,Veneto,4905854,3505882,71.46,0.19
2670,2021-04-27,VEN,28240,12810,15430,20172,6915,1153,ITH,ITH3,5,Veneto,Veneto,4905854,3534122,72.04,0.58
2671,2021-01-17,VEN,1933,781,1152,1584,349,0,ITH,ITH3,5,Veneto,Veneto,4905854,3536055,72.08,0.04
2672,2021-02-03,VEN,5951,1670,4281,474,5473,4,ITH,ITH3,5,Veneto,Veneto,4905854,3542006,72.2,0.12
2673,2021-04-29,VEN,50321,23410,26911,35425,13173,1723,ITH,ITH3,5,Veneto,Veneto,4905854,3592327,73.23,1.03
2674,2021-07-21,VEN,44331,22953,21378,9399,33982,950,ITH,ITH3,5,Veneto,Veneto,4905854,3636658,74.13,0.9
2675,2021-02-05,VEN,8384,2537,5847,1409,6966,9,ITH,ITH3,5,Veneto,Veneto,4905854,3645042,74.3,0.17
2676,2021-02-22,VEN,7019,3044,3975,6581,391,47,ITH,ITH3,5,Veneto,Veneto,4905854,3652061,74.44,0.14
2677,2021-05-16,VEN,28419,14013,14406,20315,7079,1025,ITH,ITH3,5,Veneto,Veneto,4905854,3680480,75.02,0.58
2678,2021-05-20,VEN,44834,21254,23580,19372,24360,1102,ITH,ITH3,5,Veneto,Veneto,4905854,3725314,75.94,0.91
2679,2021-02-09,VEN,5249,1892,3357,3430,1806,13,ITH,ITH3,5,Veneto,Veneto,4905854,3730563,76.04,0.11
2680,2021-05-27,VEN,46629,22903,23726,22370,23222,1037,ITH,ITH3,5,Veneto,Veneto,4905854,3777192,76.99,0.95
2681,2021-02-07,VEN,2317,864,1453,715,1601,1,ITH,ITH3,5,Veneto,Veneto,4905854,3779509,77.04,0.05
2682,2021-06-04,VEN,49702,25860,23842,39890,8145,1667,ITH,ITH3,5,Veneto,Veneto,4905854,3829211,78.05,1.01
2683,2021-02-24,VEN,8620,3679,4941,7998,488,134,ITH,ITH3,5,Veneto,Veneto,4905854,3837831,78.23,0.18
2684,2021-06-22,VEN,43770,21642,22128,18524,24387,859,ITH,ITH3,5,Veneto,Veneto,4905854,3881601,79.12,0.89
2685,2021-04-26,VEN,20730,9460,11270,14918,5139,673,ITH,ITH3,5,Veneto,Veneto,4905854,3902331,79.54,0.42
2686,2021-07-14,VEN,49246,25373,23873,10410,38075,761,ITH,ITH3,5,Veneto,Veneto,4905854,3951577,80.55,1.0
2687,2021-04-22,VEN,32071,13941,18130,15489,15761,821,ITH,ITH3,5,Veneto,Veneto,4905854,3983648,81.2,0.65
2688,2021-06-15,VEN,47899,24336,23563,29224,17526,1149,ITH,ITH3,5,Veneto,Veneto,4905854,4031547,82.18,0.98
2689,2021-02-21,VEN,4640,1212,3428,4516,5,119,ITH,ITH3,5,Veneto,Veneto,4905854,4036187,82.27,0.09
2690,2021-05-15,VEN,36284,17525,18759,24830,10021,1433,ITH,ITH3,5,Veneto,Veneto,4905854,4072471,83.01,0.74
2691,2021-06-01,VEN,26994,13571,13423,15792,10559,643,ITH,ITH3,5,Veneto,Veneto,4905854,4099465,83.56,0.55
2692,2021-03-10,VEN,19040,8727,10313,12963,5683,394,ITH,ITH3,5,Veneto,Veneto,4905854,4118505,83.95,0.39
2693,2020-12-31,VEN,3219,1042,2177,3219,0,0,ITH,ITH3,5,Veneto,Veneto,4905854,4121724,84.02,0.07
2694,2021-07-04,VEN,33893,17586,16307,14993,18281,619,ITH,ITH3,5,Veneto,Veneto,4905854,4155617,84.71,0.69
2695,2021-04-12,VEN,14919,6345,8574,6405,8215,299,ITH,ITH3,5,Veneto,Veneto,4905854,4170536,85.01,0.3
2696,2021-01-02,VEN,5744,1767,3977,5743,0,1,ITH,ITH3,5,Veneto,Veneto,4905854,4176280,85.13,0.12
2697,2021-01-19,VEN,1312,474,838,1161,150,1,ITH,ITH3,5,Veneto,Veneto,4905854,4177592,85.16,0.03
2698,2021-07-23,VEN,45788,24132,21656,16044,28612,1132,ITH,ITH3,5,Veneto,Veneto,4905854,4223380,86.09,0.93
2699,2021-05-01,VEN,38863,18244,20619,28710,8931,1222,ITH,ITH3,5,Veneto,Veneto,4905854,4262243,86.88,0.79
2700,2021-07-12,VEN,47543,25113,22430,7904,39001,638,ITH,ITH3,5,Veneto,Veneto,4905854,4309786,87.85,0.97
2701,2021-04-03,VEN,21971,9639,12332,13854,7713,404,ITH,ITH3,5,Veneto,Veneto,4905854,4331757,88.3,0.45
2702,2021-03-20,VEN,13027,5390,7637,10654,2082,291,ITH,ITH3,5,Veneto,Veneto,4905854,4344784,88.56,0.27
2703,2021-01-10,VEN,5037,1674,3363,5036,0,1,ITH,ITH3,5,Veneto,Veneto,4905854,4349821,88.67,0.1
2704,2021-05-23,VEN,34496,16469,18027,10621,23406,469,ITH,ITH3,5,Veneto,Veneto,4905854,4384317,89.37,0.7
2705,2021-07-02,VEN,49525,25127,24398,16272,32450,803,ITH,ITH3,5,Veneto,Veneto,4905854,4433842,90.38,1.01
2706,2021-03-24,VEN,22118,9576,12542,14664,6803,651,ITH,ITH3,5,Veneto,Veneto,4905854,4455960,90.83,0.45
2707,2021-07-19,VEN,45792,24127,21665,8573,36425,794,ITH,ITH3,5,Veneto,Veneto,4905854,4501752,91.76,0.93
2708,2021-02-26,VEN,8299,3275,5024,6945,1260,94,ITH,ITH3,5,Veneto,Veneto,4905854,4510051,91.93,0.17
2709,2021-04-24,VEN,24765,10829,13936,14967,9078,720,ITH,ITH3,5,Veneto,Veneto,4905854,4534816,92.44,0.5
2710,2021-01-14,VEN,7067,1926,5141,7047,0,20,ITH,ITH3,5,Veneto,Veneto,4905854,4541883,92.58,0.14
2711,2021-03-12,VEN,18660,8194,10466,11331,6749,580,ITH,ITH3,5,Veneto,Veneto,4905854,4560543,92.96,0.38
2712,2021-04-17,VEN,22447,9096,13351,14373,7276,798,ITH,ITH3,5,Veneto,Veneto,4905854,4582990,93.42,0.46
2713,2021-01-07,VEN,8360,2317,6043,8359,0,1,ITH,ITH3,5,Veneto,Veneto,4905854,4591350,93.59,0.17
2714,2021-06-13,VEN,37350,19261,18089,29331,6956,1063,ITH,ITH3,5,Veneto,Veneto,4905854,4628700,94.35,0.76
2715,2021-01-21,VEN,2293,719,1574,21,2272,0,ITH,ITH3,5,Veneto,Veneto,4905854,4630993,94.4,0.05
2716,2021-03-05,VEN,13337,5020,8317,9223,3670,444,ITH,ITH3,5,Veneto,Veneto,4905854,4644330,94.67,0.27
2717,2021-06-08,VEN,43881,22686,21195,36221,6145,1515,ITH,ITH3,5,Veneto,Veneto,4905854,4688211,95.56,0.89
2718,2021-05-25,VEN,27852,13442,14410,11280,16074,498,ITH,ITH3,5,Veneto,Veneto,4905854,4716063,96.13,0.57
2719,2021-02-14,VEN,126,56,70,113,13,0,ITH,ITH3,5,Veneto,Veneto,4905854,4716189,96.13,0.0
2720,2021-02-28,VEN,4136,1389,2747,3225,837,74,ITH,ITH3,5,Veneto,Veneto,4905854,4720325,96.22,0.08
2721,2021-03-17,VEN,14645,5992,8653,7526,6796,323,ITH,ITH3,5,Veneto,Veneto,4905854,4734970,96.52,0.3
2722,2021-02-12,VEN,4314,1447,2867,3671,572,71,ITH,ITH3,5,Veneto,Veneto,4905854,4739284,96.6,0.09
2723,2021-01-29,VEN,9023,2788,6235,366,8657,0,ITH,ITH3,5,Veneto,Veneto,4905854,4748307,96.79,0.18
2724,2021-05-08,VEN,41521,18787,22734,28257,11832,1432,ITH,ITH3,5,Veneto,Veneto,4905854,4789828,97.63,0.85
2725,2021-07-30,VEN,46239,24625,21614,23043,22073,1123,ITH,ITH3,5,Veneto,Veneto,4905854,4836067,98.58,0.94
2726,2021-07-28,VEN,42029,21860,20169,12901,28259,869,ITH,ITH3,5,Veneto,Veneto,4905854,4878096,99.43,0.86
2727,2021-01-12,VEN,5231,1517,3714,5223,0,8,ITH,ITH3,5,Veneto,Veneto,4905854,4883327,99.54,0.11
2728,2021-04-19,VEN,21548,8926,12622,4712,16409,427,ITH,ITH3,5,Veneto,Veneto,4905854,4904875,99.98,0.44
2729,2021-04-05,VEN,19166,8377,10789,13428,5437,301,ITH,ITH3,5,Veneto,Veneto,4905854,4924041,100.37,0.39
2730,2021-01-26,VEN,6922,2092,4830,149,6773,0,ITH,ITH3,5,Veneto,Veneto,4905854,4930963,100.51,0.14
2731,2021-05-06,VEN,47040,22057,24983,36589,8482,1969,ITH,ITH3,5,Veneto,Veneto,4905854,4978003,101.47,0.96
2732,2021-06-27,VEN,40240,20558,19682,15338,24310,592,ITH,ITH3,5,Veneto,Veneto,4905854,5018243,102.29,0.82
2733,2021-03-19,VEN,13793,5669,8124,7404,6097,292,ITH,ITH3,5,Veneto,Veneto,4905854,5032036,102.57,0.28
2734,2021-06-14,VEN,42646,21578,21068,26317,15325,1004,ITH,ITH3,5,Veneto,Veneto,4905854,5074682,103.44,0.87
2735,2021-03-06,VEN,10671,4356,6315,7222,3262,187,ITH,ITH3,5,Veneto,Veneto,4905854,5085353,103.66,0.22
2736,2020-12-30,VEN,699,245,454,699,0,0,ITH,ITH3,5,Veneto,Veneto,4905854,5086052,103.67,0.01
2737,2021-06-07,VEN,44724,23340,21384,36225,7023,1476,ITH,ITH3,5,Veneto,Veneto,4905854,5130776,104.58,0.91
2738,2021-02-27,VEN,8994,2694,6300,7963,849,182,ITH,ITH3,5,Veneto,Veneto,4905854,5139770,104.77,0.18
2739,2021-03-04,VEN,12987,4888,8099,9123,3475,389,ITH,ITH3,5,Veneto,Veneto,4905854,5152757,105.03,0.26
2740,2021-07-07,VEN,57190,30075,27115,30987,24625,1578,ITH,ITH3,5,Veneto,Veneto,4905854,5209947,106.2,1.17
2741,2021-05-11,VEN,33192,16510,16682,27154,4725,1313,ITH,ITH3,5,Veneto,Veneto,4905854,5243139,106.88,0.68
2742,2021-01-22,VEN,1080,332,748,25,1055,0,ITH,ITH3,5,Veneto,Veneto,4905854,5244219,106.9,0.02
2743,2021-05-04,VEN,43057,20399,22658,33391,8036,1630,ITH,ITH3,5,Veneto,Veneto,4905854,5287276,107.77,0.88
2744,2021-01-24,VEN,4117,1219,2898,28,4089,0,ITH,ITH3,5,Veneto,Veneto,4905854,5291393,107.86,0.08
2745,2021-04-07,VEN,36033,16196,19837,27591,7336,1106,ITH,ITH3,5,Veneto,Veneto,4905854,5327426,108.59,0.73
2746,2021-07-16,VEN,51925,27949,23976,13648,37348,929,ITH,ITH3,5,Veneto,Veneto,4905854,5379351,109.65,1.06
2747,2021-01-31,VEN,4772,1566,3206,390,4382,0,ITH,ITH3,5,Veneto,Veneto,4905854,5384123,109.75,0.1
2748,2021-03-29,VEN,31456,13696,17760,26641,3820,995,ITH,ITH3,5,Veneto,Veneto,4905854,5415579,110.39,0.64
2749,2021-05-13,VEN,44308,21855,22453,32595,9887,1826,ITH,ITH3,5,Veneto,Veneto,4905854,5459887,111.29,0.9
2750,2021-02-02,VEN,6512,1881,4631,396,6116,0,ITH,ITH3,5,Veneto,Veneto,4905854,5466399,111.43,0.13
2751,2021-07-09,VEN,49283,26042,23241,7983,40740,560,ITH,ITH3,5,Veneto,Veneto,4905854,5515682,112.43,1.0
2752,2021-03-31,VEN,38954,16447,22507,30410,7500,1044,ITH,ITH3,5,Veneto,Veneto,4905854,5554636,113.22,0.79
2753,2021-07-11,VEN,38175,20050,18125,7331,30341,503,ITH,ITH3,5,Veneto,Veneto,4905854,5592811,114.0,0.78
2754,2021-02-28,LIG,1059,580,479,1043,9,7,ITC,ITC3,7,Liguria,Liguria,1550640,1059,0.07,0.07
2755,2021-03-14,LIG,1659,752,907,1032,605,22,ITC,ITC3,7,Liguria,Liguria,1550640,2718,0.18,0.11
2756,2021-06-22,LIG,15799,7456,8343,7638,8124,37,ITC,ITC3,7,Liguria,Liguria,1550640,18517,1.19,1.02
2757,2021-07-06,LIG,12334,6058,6276,5685,6614,35,ITC,ITC3,7,Liguria,Liguria,1550640,30851,1.99,0.8
2758,2021-05-10,LIG,12651,5643,7008,6208,6376,67,ITC,ITC3,7,Liguria,Liguria,1550640,43502,2.81,0.82
2759,2021-05-03,LIG,13260,5920,7340,6336,6818,106,ITC,ITC3,7,Liguria,Liguria,1550640,56762,3.66,0.86
2760,2021-03-26,LIG,9341,4031,5310,6073,3156,112,ITC,ITC3,7,Liguria,Liguria,1550640,66103,4.26,0.6
2761,2021-07-04,LIG,4853,2583,2270,3843,993,17,ITC,ITC3,7,Liguria,Liguria,1550640,70956,4.58,0.31
2762,2021-01-02,LIG,693,247,446,693,0,0,ITC,ITC3,7,Liguria,Liguria,1550640,71649,4.62,0.04
2763,2021-01-28,LIG,2849,972,1877,40,2809,0,ITC,ITC3,7,Liguria,Liguria,1550640,74498,4.8,0.18
2764,2021-02-16,LIG,2428,957,1471,1996,424,8,ITC,ITC3,7,Liguria,Liguria,1550640,76926,4.96,0.16
2765,2021-07-23,LIG,19957,10286,9671,5169,14728,60,ITC,ITC3,7,Liguria,Liguria,1550640,96883,6.25,1.29
2766,2021-05-27,LIG,16976,8709,8267,12648,4159,169,ITC,ITC3,7,Liguria,Liguria,1550640,113859,7.34,1.09
2767,2021-04-14,LIG,13075,5670,7405,10750,2201,124,ITC,ITC3,7,Liguria,Liguria,1550640,126934,8.19,0.84
2768,2021-05-29,LIG,6865,3251,3614,3975,2870,20,ITC,ITC3,7,Liguria,Liguria,1550640,133799,8.63,0.44
2769,2021-07-25,LIG,6386,3260,3126,648,5729,9,ITC,ITC3,7,Liguria,Liguria,1550640,140185,9.04,0.41
2770,2021-04-26,LIG,10571,4986,5585,7849,2637,85,ITC,ITC3,7,Liguria,Liguria,1550640,150756,9.72,0.68
2771,2021-01-16,LIG,1278,557,721,1273,0,5,ITC,ITC3,7,Liguria,Liguria,1550640,152034,9.8,0.08
2772,2021-02-02,LIG,2673,1007,1666,127,2544,2,ITC,ITC3,7,Liguria,Liguria,1550640,154707,9.98,0.17
2773,2021-04-28,LIG,14462,6524,7938,6381,7990,91,ITC,ITC3,7,Liguria,Liguria,1550640,169169,10.91,0.93
2774,2021-02-04,LIG,2818,988,1830,178,2640,0,ITC,ITC3,7,Liguria,Liguria,1550640,171987,11.09,0.18
2775,2021-05-15,LIG,7321,3272,4049,4285,2958,78,ITC,ITC3,7,Liguria,Liguria,1550640,179308,11.56,0.47
2776,2021-02-21,LIG,869,491,378,858,4,7,ITC,ITC3,7,Liguria,Liguria,1550640,180177,11.62,0.06
2777,2021-02-11,LIG,1990,772,1218,1094,887,9,ITC,ITC3,7,Liguria,Liguria,1550640,182167,11.75,0.13
2778,2021-05-22,LIG,6652,3220,3432,4874,1685,93,ITC,ITC3,7,Liguria,Liguria,1550640,188819,12.18,0.43
2779,2021-06-10,LIG,18813,9703,9110,13160,5640,13,ITC,ITC3,7,Liguria,Liguria,1550640,207632,13.39,1.21
2780,2021-03-19,LIG,5298,2234,3064,2094,3149,55,ITC,ITC3,7,Liguria,Liguria,1550640,212930,13.73,0.34
2781,2021-03-02,LIG,4076,1691,2385,3755,310,11,ITC,ITC3,7,Liguria,Liguria,1550640,217006,13.99,0.26
2782,2021-07-11,LIG,2147,1191,956,1235,903,9,ITC,ITC3,7,Liguria,Liguria,1550640,219153,14.13,0.14
2783,2021-06-24,LIG,11146,5438,5708,6288,4843,15,ITC,ITC3,7,Liguria,Liguria,1550640,230299,14.85,0.72
2784,2021-04-02,LIG,11792,5222,6570,9211,2487,94,ITC,ITC3,7,Liguria,Liguria,1550640,242091,15.61,0.76
2785,2021-07-18,LIG,2382,1222,1160,391,1980,11,ITC,ITC3,7,Liguria,Liguria,1550640,244473,15.77,0.15
2786,2021-06-05,LIG,8091,4114,3977,4935,3152,4,ITC,ITC3,7,Liguria,Liguria,1550640,252564,16.29,0.52
2787,2021-04-09,LIG,12470,5563,6907,10553,1777,140,ITC,ITC3,7,Liguria,Liguria,1550640,265034,17.09,0.8
2788,2021-03-31,LIG,11932,5278,6654,9054,2770,108,ITC,ITC3,7,Liguria,Liguria,1550640,276966,17.86,0.77
2789,2021-01-21,LIG,1107,385,722,675,431,1,ITC,ITC3,7,Liguria,Liguria,1550640,278073,17.93,0.07
2790,2021-01-14,LIG,2983,1056,1927,2982,0,1,ITC,ITC3,7,Liguria,Liguria,1550640,281056,18.13,0.19
2791,2021-01-09,LIG,1335,481,854,1334,0,1,ITC,ITC3,7,Liguria,Liguria,1550640,282391,18.21,0.09
2792,2021-04-19,LIG,12838,5620,7218,8919,3831,88,ITC,ITC3,7,Liguria,Liguria,1550640,295229,19.04,0.83
2793,2021-07-13,LIG,13063,6423,6640,3495,9545,23,ITC,ITC3,7,Liguria,Liguria,1550640,308292,19.88,0.84
2794,2021-03-21,LIG,551,220,331,69,482,0,ITC,ITC3,7,Liguria,Liguria,1550640,308843,19.92,0.04
2795,2021-01-23,LIG,812,298,514,155,657,0,ITC,ITC3,7,Liguria,Liguria,1550640,309655,19.97,0.05
2796,2021-06-29,LIG,15175,7226,7949,8708,6434,33,ITC,ITC3,7,Liguria,Liguria,1550640,324830,20.95,0.98
2797,2021-05-17,LIG,12040,5525,6515,8648,3340,52,ITC,ITC3,7,Liguria,Liguria,1550640,336870,21.72,0.78
2798,2021-01-30,LIG,1661,567,1094,23,1637,1,ITC,ITC3,7,Liguria,Liguria,1550640,338531,21.83,0.11
2799,2021-03-28,LIG,1142,511,631,378,752,12,ITC,ITC3,7,Liguria,Liguria,1550640,339673,21.91,0.07
2800,2021-06-15,LIG,17413,8465,8948,9316,8081,16,ITC,ITC3,7,Liguria,Liguria,1550640,357086,23.03,1.12
2801,2021-03-07,LIG,1915,1138,777,1590,301,24,ITC,ITC3,7,Liguria,Liguria,1550640,359001,23.15,0.12
2802,2021-06-17,LIG,16698,7931,8767,9143,7528,27,ITC,ITC3,7,Liguria,Liguria,1550640,375699,24.23,1.08
2803,2021-02-09,LIG,1953,694,1259,264,1687,2,ITC,ITC3,7,Liguria,Liguria,1550640,377652,24.35,0.13
2804,2021-04-23,LIG,14687,6646,8041,8455,6123,109,ITC,ITC3,7,Liguria,Liguria,1550640,392339,25.3,0.95
2805,2021-03-11,LIG,6401,3091,3310,4331,2012,58,ITC,ITC3,7,Liguria,Liguria,1550640,398740,25.71,0.41
2806,2021-01-13,LIG,2758,1014,1744,2757,0,1,ITC,ITC3,7,Liguria,Liguria,1550640,401498,25.89,0.18
2807,2020-12-30,LIG,12,5,7,12,0,0,ITC,ITC3,7,Liguria,Liguria,1550640,401510,25.89,0.0
2808,2020-12-28,LIG,80,30,50,80,0,0,ITC,ITC3,7,Liguria,Liguria,1550640,401590,25.9,0.01
2809,2021-06-03,LIG,15528,7694,7834,9136,6382,10,ITC,ITC3,7,Liguria,Liguria,1550640,417118,26.9,1.0
2810,2021-04-07,LIG,13684,6109,7575,11304,2289,91,ITC,ITC3,7,Liguria,Liguria,1550640,430802,27.78,0.88
2811,2021-02-23,LIG,3807,1559,2248,3658,109,40,ITC,ITC3,7,Liguria,Liguria,1550640,434609,28.03,0.25
2812,2021-06-14,LIG,15141,7311,7830,8269,6865,7,ITC,ITC3,7,Liguria,Liguria,1550640,449750,29.0,0.98
2813,2021-04-21,LIG,14272,6447,7825,8845,5329,98,ITC,ITC3,7,Liguria,Liguria,1550640,464022,29.92,0.92
2814,2021-07-30,LIG,15313,7876,7437,4172,11083,58,ITC,ITC3,7,Liguria,Liguria,1550640,479335,30.91,0.99
2815,2021-05-08,LIG,7535,3335,4200,2272,5222,41,ITC,ITC3,7,Liguria,Liguria,1550640,486870,31.4,0.49
2816,2021-01-25,LIG,2729,890,1839,475,2253,1,ITC,ITC3,7,Liguria,Liguria,1550640,489599,31.57,0.18
2817,2021-05-05,LIG,13717,6137,7580,5175,8453,89,ITC,ITC3,7,Liguria,Liguria,1550640,503316,32.46,0.88
2818,2021-07-29,LIG,17944,9173,8771,4441,13451,52,ITC,ITC3,7,Liguria,Liguria,1550640,521260,33.62,1.16
2819,2021-03-12,LIG,6216,2873,3343,3689,2470,57,ITC,ITC3,7,Liguria,Liguria,1550640,527476,34.02,0.4
2820,2021-07-01,LIG,13527,6519,7008,7351,6139,37,ITC,ITC3,7,Liguria,Liguria,1550640,541003,34.89,0.87
2821,2021-05-19,LIG,13570,5960,7610,10303,3123,144,ITC,ITC3,7,Liguria,Liguria,1550640,554573,35.76,0.88
2822,2021-03-23,LIG,9274,4222,5052,5977,3211,86,ITC,ITC3,7,Liguria,Liguria,1550640,563847,36.36,0.6
2823,2021-07-15,LIG,14746,7456,7290,5201,9471,74,ITC,ITC3,7,Liguria,Liguria,1550640,578593,37.31,0.95
2824,2021-02-01,LIG,2559,923,1636,90,2469,0,ITC,ITC3,7,Liguria,Liguria,1550640,581152,37.48,0.17
2825,2021-07-08,LIG,13610,6701,6909,6193,7377,40,ITC,ITC3,7,Liguria,Liguria,1550640,594762,38.36,0.88
2826,2021-05-12,LIG,12109,5487,6622,6594,5403,112,ITC,ITC3,7,Liguria,Liguria,1550640,606871,39.14,0.78
2827,2021-05-26,LIG,16678,8423,8255,12145,4377,156,ITC,ITC3,7,Liguria,Liguria,1550640,623549,40.21,1.08
2828,2021-03-30,LIG,12217,5429,6788,8741,3388,88,ITC,ITC3,7,Liguria,Liguria,1550640,635766,41.0,0.79
2829,2021-05-24,LIG,11874,5586,6288,9264,2507,103,ITC,ITC3,7,Liguria,Liguria,1550640,647640,41.77,0.77
2830,2021-05-07,LIG,13607,6045,7562,5740,7803,64,ITC,ITC3,7,Liguria,Liguria,1550640,661247,42.64,0.88
2831,2021-02-13,LIG,1080,508,572,797,280,3,ITC,ITC3,7,Liguria,Liguria,1550640,662327,42.71,0.07
2832,2021-06-07,LIG,15689,7657,8032,8653,7026,10,ITC,ITC3,7,Liguria,Liguria,1550640,678016,43.72,1.01
2833,2021-06-26,LIG,7214,3354,3860,4490,2709,15,ITC,ITC3,7,Liguria,Liguria,1550640,685230,44.19,0.47
2834,2021-06-02,LIG,8531,4341,4190,5357,3173,1,ITC,ITC3,7,Liguria,Liguria,1550640,693761,44.74,0.55
2835,2021-06-19,LIG,7412,3776,3636,5726,1667,19,ITC,ITC3,7,Liguria,Liguria,1550640,701173,45.22,0.48
2836,2021-02-18,LIG,2771,1128,1643,2423,337,11,ITC,ITC3,7,Liguria,Liguria,1550640,703944,45.4,0.18
2837,2021-05-14,LIG,13152,5865,7287,8634,4333,185,ITC,ITC3,7,Liguria,Liguria,1550640,717096,46.25,0.85
2838,2021-05-31,LIG,14713,7379,7334,9113,5518,82,ITC,ITC3,7,Liguria,Liguria,1550640,731809,47.19,0.95
2839,2021-03-09,LIG,5932,2754,3178,4440,1431,61,ITC,ITC3,7,Liguria,Liguria,1550640,737741,47.58,0.38
2840,2021-02-20,LIG,1335,637,698,1329,1,5,ITC,ITC3,7,Liguria,Liguria,1550640,739076,47.66,0.09
2841,2021-05-16,LIG,3704,1861,1843,2117,1560,27,ITC,ITC3,7,Liguria,Liguria,1550640,742780,47.9,0.24
2842,2021-02-22,LIG,3343,1476,1867,3191,142,10,ITC,ITC3,7,Liguria,Liguria,1550640,746123,48.12,0.22
2843,2021-07-19,LIG,12067,6017,6050,3377,8651,39,ITC,ITC3,7,Liguria,Liguria,1550640,758190,48.9,0.78
2844,2021-04-27,LIG,14804,6691,8113,7149,7589,66,ITC,ITC3,7,Liguria,Liguria,1550640,772994,49.85,0.95
2845,2021-02-03,LIG,2318,792,1526,53,2265,0,ITC,ITC3,7,Liguria,Liguria,1550640,775312,50.0,0.15
2846,2021-07-21,LIG,19158,9494,9664,3837,15278,43,ITC,ITC3,7,Liguria,Liguria,1550640,794470,51.23,1.24
2847,2021-07-03,LIG,8802,4358,4444,5480,3309,13,ITC,ITC3,7,Liguria,Liguria,1550640,803272,51.8,0.57
2848,2021-04-11,LIG,4248,1929,2319,3944,249,55,ITC,ITC3,7,Liguria,Liguria,1550640,807520,52.08,0.27
2849,2021-07-20,LIG,13930,6865,7065,2749,11146,35,ITC,ITC3,7,Liguria,Liguria,1550640,821450,52.97,0.9
2850,2021-01-18,LIG,2143,747,1396,1984,157,2,ITC,ITC3,7,Liguria,Liguria,1550640,823593,53.11,0.14
2851,2021-07-22,LIG,21341,10847,10494,4607,16677,57,ITC,ITC3,7,Liguria,Liguria,1550640,844934,54.49,1.38
2852,2021-02-06,LIG,1892,768,1124,145,1747,0,ITC,ITC3,7,Liguria,Liguria,1550640,846826,54.61,0.12
2853,2021-04-06,LIG,13251,5903,7348,10884,2262,105,ITC,ITC3,7,Liguria,Liguria,1550640,860077,55.47,0.85
2854,2021-02-08,LIG,1979,742,1237,306,1673,0,ITC,ITC3,7,Liguria,Liguria,1550640,862056,55.59,0.13
2855,2020-12-27,LIG,135,56,79,134,0,1,ITC,ITC3,7,Liguria,Liguria,1550640,862191,55.6,0.01
2856,2021-02-15,LIG,2263,839,1424,1855,398,10,ITC,ITC3,7,Liguria,Liguria,1550640,864454,55.75,0.15
2857,2021-01-03,LIG,736,231,505,734,0,2,ITC,ITC3,7,Liguria,Liguria,1550640,865190,55.8,0.05
2858,2021-02-25,LIG,3458,1349,2109,3308,130,20,ITC,ITC3,7,Liguria,Liguria,1550640,868648,56.02,0.22
2859,2021-03-04,LIG,4740,2118,2622,3834,849,57,ITC,ITC3,7,Liguria,Liguria,1550640,873388,56.32,0.31
2860,2021-06-12,LIG,10240,4981,5259,7482,2755,3,ITC,ITC3,7,Liguria,Liguria,1550640,883628,56.98,0.66
2861,2021-04-30,LIG,14427,6444,7983,5758,8571,98,ITC,ITC3,7,Liguria,Liguria,1550640,898055,57.92,0.93
2862,2021-03-06,LIG,3306,1843,1463,2552,705,49,ITC,ITC3,7,Liguria,Liguria,1550640,901361,58.13,0.21
2863,2021-01-22,LIG,1821,604,1217,1331,487,3,ITC,ITC3,7,Liguria,Liguria,1550640,903182,58.25,0.12
2864,2021-05-02,LIG,3978,1836,2142,504,3468,6,ITC,ITC3,7,Liguria,Liguria,1550640,907160,58.5,0.26
2865,2021-05-04,LIG,13656,6090,7566,5357,8230,69,ITC,ITC3,7,Liguria,Liguria,1550640,920816,59.38,0.88
2866,2021-03-16,LIG,6085,2731,3354,2311,3733,41,ITC,ITC3,7,Liguria,Liguria,1550640,926901,59.78,0.39
2867,2021-04-29,LIG,15590,6983,8607,6619,8844,127,ITC,ITC3,7,Liguria,Liguria,1550640,942491,60.78,1.01
2868,2021-04-12,LIG,12392,5478,6914,10277,2020,95,ITC,ITC3,7,Liguria,Liguria,1550640,954883,61.58,0.8
2869,2021-01-19,LIG,1374,439,935,1280,90,4,ITC,ITC3,7,Liguria,Liguria,1550640,956257,61.67,0.09
2870,2021-02-05,LIG,2685,989,1696,304,2380,1,ITC,ITC3,7,Liguria,Liguria,1550640,958942,61.84,0.17
2871,2021-05-09,LIG,2825,1244,1581,1086,1710,29,ITC,ITC3,7,Liguria,Liguria,1550640,961767,62.02,0.18
2872,2021-01-29,LIG,3097,1067,2030,68,3029,0,ITC,ITC3,7,Liguria,Liguria,1550640,964864,62.22,0.2
2873,2021-01-20,LIG,1554,556,998,1541,12,1,ITC,ITC3,7,Liguria,Liguria,1550640,966418,62.32,0.1
2874,2021-01-11,LIG,2656,993,1663,2655,0,1,ITC,ITC3,7,Liguria,Liguria,1550640,969074,62.5,0.17
2875,2021-07-12,LIG,13395,6428,6967,4165,9201,29,ITC,ITC3,7,Liguria,Liguria,1550640,982469,63.36,0.86
2876,2021-01-10,LIG,648,262,386,644,0,4,ITC,ITC3,7,Liguria,Liguria,1550640,983117,63.4,0.04
2877,2021-04-20,LIG,14240,6520,7720,9731,4354,155,ITC,ITC3,7,Liguria,Liguria,1550640,997357,64.32,0.92
2878,2021-06-11,LIG,17836,9081,8755,11756,6072,8,ITC,ITC3,7,Liguria,Liguria,1550640,1015193,65.47,1.15
2879,2021-04-15,LIG,11844,5237,6607,9888,1851,105,ITC,ITC3,7,Liguria,Liguria,1550640,1027037,66.23,0.76
2880,2021-04-08,LIG,13786,6179,7607,11586,2045,155,ITC,ITC3,7,Liguria,Liguria,1550640,1040823,67.12,0.89
2881,2021-07-17,LIG,6508,3358,3150,1816,4685,7,ITC,ITC3,7,Liguria,Liguria,1550640,1047331,67.54,0.42
2882,2021-06-04,LIG,14789,7260,7529,9287,5493,9,ITC,ITC3,7,Liguria,Liguria,1550640,1062120,68.5,0.95
2883,2021-07-10,LIG,6893,3474,3419,2758,4126,9,ITC,ITC3,7,Liguria,Liguria,1550640,1069013,68.94,0.44
2884,2021-04-04,LIG,758,366,392,499,251,8,ITC,ITC3,7,Liguria,Liguria,1550640,1069771,68.99,0.05
2885,2021-04-18,LIG,2613,1164,1449,2072,468,73,ITC,ITC3,7,Liguria,Liguria,1550640,1072384,69.16,0.17
2886,2021-07-27,LIG,17406,8875,8531,4383,12976,47,ITC,ITC3,7,Liguria,Liguria,1550640,1089790,70.28,1.12
2887,2021-01-08,LIG,2936,1000,1936,2934,0,2,ITC,ITC3,7,Liguria,Liguria,1550640,1092726,70.47,0.19
2888,2021-01-27,LIG,1745,604,1141,139,1605,1,ITC,ITC3,7,Liguria,Liguria,1550640,1094471,70.58,0.11
2889,2021-06-16,LIG,16395,7921,8474,9259,7118,18,ITC,ITC3,7,Liguria,Liguria,1550640,1110866,71.64,1.06
2890,2021-03-08,LIG,5625,2460,3165,3895,1689,41,ITC,ITC3,7,Liguria,Liguria,1550640,1116491,72.0,0.36
2891,2021-03-25,LIG,9769,4233,5536,6227,3392,150,ITC,ITC3,7,Liguria,Liguria,1550640,1126260,72.63,0.63
2892,2021-01-01,LIG,145,55,90,145,0,0,ITC,ITC3,7,Liguria,Liguria,1550640,1126405,72.64,0.01
2893,2021-03-27,LIG,3933,1549,2384,2484,1397,52,ITC,ITC3,7,Liguria,Liguria,1550640,1130338,72.89,0.25
2894,2021-07-05,LIG,11876,5761,6115,5344,6495,37,ITC,ITC3,7,Liguria,Liguria,1550640,1142214,73.66,0.77
2895,2021-04-13,LIG,13083,5870,7213,10945,2025,113,ITC,ITC3,7,Liguria,Liguria,1550640,1155297,74.5,0.84
2896,2021-07-09,LIG,12797,6312,6485,4230,8546,21,ITC,ITC3,7,Liguria,Liguria,1550640,1168094,75.33,0.83
2897,2021-04-05,LIG,3978,1753,2225,2303,1649,26,ITC,ITC3,7,Liguria,Liguria,1550640,1172072,75.59,0.26
2898,2021-07-26,LIG,17461,8912,8549,4717,12681,63,ITC,ITC3,7,Liguria,Liguria,1550640,1189533,76.71,1.13
2899,2021-01-07,LIG,3226,1095,2131,3223,0,3,ITC,ITC3,7,Liguria,Liguria,1550640,1192759,76.92,0.21
2900,2021-06-13,LIG,5623,2697,2926,5163,456,4,ITC,ITC3,7,Liguria,Liguria,1550640,1198382,77.28,0.36
2901,2021-04-17,LIG,7387,3219,4168,6565,752,70,ITC,ITC3,7,Liguria,Liguria,1550640,1205769,77.76,0.48
2902,2021-05-01,LIG,7145,3257,3888,1306,5801,38,ITC,ITC3,7,Liguria,Liguria,1550640,1212914,78.22,0.46
2903,2021-03-05,LIG,4869,2150,2719,3674,1132,63,ITC,ITC3,7,Liguria,Liguria,1550640,1217783,78.53,0.31
2904,2021-05-23,LIG,2306,1120,1186,1169,1123,14,ITC,ITC3,7,Liguria,Liguria,1550640,1220089,78.68,0.15
2905,2021-03-01,LIG,3540,1447,2093,3384,136,20,ITC,ITC3,7,Liguria,Liguria,1550640,1223629,78.91,0.23
2906,2021-06-09,LIG,19054,9561,9493,12473,6563,18,ITC,ITC3,7,Liguria,Liguria,1550640,1242683,80.14,1.23
2907,2021-06-06,LIG,3811,2032,1779,2947,862,2,ITC,ITC3,7,Liguria,Liguria,1550640,1246494,80.39,0.25
2908,2021-04-24,LIG,8218,3795,4423,4977,3152,89,ITC,ITC3,7,Liguria,Liguria,1550640,1254712,80.92,0.53
2909,2021-02-26,LIG,3769,1524,2245,3415,329,25,ITC,ITC3,7,Liguria,Liguria,1550640,1258481,81.16,0.24
2910,2021-06-20,LIG,1336,658,678,1054,275,7,ITC,ITC3,7,Liguria,Liguria,1550640,1259817,81.24,0.09
2911,2021-03-24,LIG,9181,4033,5148,5809,3287,85,ITC,ITC3,7,Liguria,Liguria,1550640,1268998,81.84,0.59
2912,2021-07-02,LIG,12941,6354,6587,6438,6470,33,ITC,ITC3,7,Liguria,Liguria,1550640,1281939,82.67,0.83
2913,2020-12-31,LIG,990,353,637,990,0,0,ITC,ITC3,7,Liguria,Liguria,1550640,1282929,82.74,0.06
2914,2021-04-10,LIG,7888,3561,4327,6890,914,84,ITC,ITC3,7,Liguria,Liguria,1550640,1290817,83.24,0.51
2915,2021-01-17,LIG,866,301,565,865,0,1,ITC,ITC3,7,Liguria,Liguria,1550640,1291683,83.3,0.06
2916,2021-05-13,LIG,13316,6088,7228,8889,4262,165,ITC,ITC3,7,Liguria,Liguria,1550640,1304999,84.16,0.86
2917,2021-02-19,LIG,3218,1306,1912,2988,176,54,ITC,ITC3,7,Liguria,Liguria,1550640,1308217,84.37,0.21
2918,2021-05-30,LIG,3296,1609,1687,1338,1944,14,ITC,ITC3,7,Liguria,Liguria,1550640,1311513,84.58,0.21
2919,2021-06-01,LIG,16332,8221,8111,10955,5368,9,ITC,ITC3,7,Liguria,Liguria,1550640,1327845,85.63,1.05
2920,2021-06-18,LIG,15399,7492,7907,8183,7196,20,ITC,ITC3,7,Liguria,Liguria,1550640,1343244,86.63,0.99
2921,2021-03-10,LIG,5904,2865,3039,3929,1910,65,ITC,ITC3,7,Liguria,Liguria,1550640,1349148,87.01,0.38
2922,2021-05-21,LIG,12848,5956,6892,9574,3130,144,ITC,ITC3,7,Liguria,Liguria,1550640,1361996,87.83,0.83
2923,2021-02-27,LIG,1888,921,967,1750,129,9,ITC,ITC3,7,Liguria,Liguria,1550640,1363884,87.96,0.12
2924,2021-02-10,LIG,2316,837,1479,1014,1298,4,ITC,ITC3,7,Liguria,Liguria,1550640,1366200,88.11,0.15
2925,2021-03-18,LIG,4988,2125,2863,1971,2981,36,ITC,ITC3,7,Liguria,Liguria,1550640,1371188,88.43,0.32
2926,2021-04-01,LIG,12431,5513,6918,9571,2770,90,ITC,ITC3,7,Liguria,Liguria,1550640,1383619,89.23,0.8
2927,2021-07-16,LIG,12597,6210,6387,3147,9409,41,ITC,ITC3,7,Liguria,Liguria,1550640,1396216,90.04,0.81
2928,2021-05-11,LIG,13921,6392,7529,7182,6621,118,ITC,ITC3,7,Liguria,Liguria,1550640,1410137,90.94,0.9
2929,2021-03-29,LIG,10582,4621,5961,7344,3133,105,ITC,ITC3,7,Liguria,Liguria,1550640,1420719,91.62,0.68
2930,2021-01-31,LIG,624,270,354,7,617,0,ITC,ITC3,7,Liguria,Liguria,1550640,1421343,91.66,0.04
2931,2021-07-07,LIG,11739,5634,6105,4969,6749,21,ITC,ITC3,7,Liguria,Liguria,1550640,1433082,92.42,0.76
2932,2021-02-17,LIG,2694,1184,1510,2253,429,12,ITC,ITC3,7,Liguria,Liguria,1550640,1435776,92.59,0.17
2933,2021-07-24,LIG,11568,6019,5549,2315,9225,28,ITC,ITC3,7,Liguria,Liguria,1550640,1447344,93.34,0.75
2934,2021-05-28,LIG,16298,8141,8157,11600,4553,145,ITC,ITC3,7,Liguria,Liguria,1550640,1463642,94.39,1.05
2935,2021-01-05,LIG,2880,896,1984,2880,0,0,ITC,ITC3,7,Liguria,Liguria,1550640,1466522,94.58,0.19
2936,2021-03-03,LIG,4581,1847,2734,3444,1027,110,ITC,ITC3,7,Liguria,Liguria,1550640,1471103,94.87,0.3
2937,2021-02-24,LIG,3764,1560,2204,3448,258,58,ITC,ITC3,7,Liguria,Liguria,1550640,1474867,95.11,0.24
2938,2020-12-29,LIG,125,33,92,125,0,0,ITC,ITC3,7,Liguria,Liguria,1550640,1474992,95.12,0.01
2939,2021-01-12,LIG,2474,890,1584,2473,0,1,ITC,ITC3,7,Liguria,Liguria,1550640,1477466,95.28,0.16
2940,2021-04-22,LIG,13866,6211,7655,8642,5086,138,ITC,ITC3,7,Liguria,Liguria,1550640,1491332,96.18,0.89
2941,2021-04-03,LIG,5407,2499,2908,4428,943,36,ITC,ITC3,7,Liguria,Liguria,1550640,1496739,96.52,0.35
2942,2021-01-24,LIG,757,238,519,113,644,0,ITC,ITC3,7,Liguria,Liguria,1550640,1497496,96.57,0.05
2943,2021-06-27,LIG,1943,891,1052,691,1242,10,ITC,ITC3,7,Liguria,Liguria,1550640,1499439,96.7,0.13
2944,2021-06-08,LIG,18099,9027,9072,11447,6639,13,ITC,ITC3,7,Liguria,Liguria,1550640,1517538,97.87,1.17
2945,2021-03-17,LIG,5554,2369,3185,2451,3081,22,ITC,ITC3,7,Liguria,Liguria,1550640,1523092,98.22,0.36
2946,2021-06-25,LIG,13832,6616,7216,6907,6910,15,ITC,ITC3,7,Liguria,Liguria,1550640,1536924,99.12,0.89
2947,2021-07-14,LIG,11466,5647,5819,3439,8000,27,ITC,ITC3,7,Liguria,Liguria,1550640,1548390,99.85,0.74
2948,2021-02-12,LIG,1937,690,1247,893,1042,2,ITC,ITC3,7,Liguria,Liguria,1550640,1550327,99.98,0.12
2949,2021-03-15,LIG,7357,3117,4240,4494,2813,50,ITC,ITC3,7,Liguria,Liguria,1550640,1557684,100.45,0.47
2950,2021-07-28,LIG,18384,9474,8910,5822,12476,86,ITC,ITC3,7,Liguria,Liguria,1550640,1576068,101.64,1.19
2951,2021-05-06,LIG,14528,6442,8086,6067,8330,131,ITC,ITC3,7,Liguria,Liguria,1550640,1590596,102.58,0.94
2952,2021-01-26,LIG,2506,818,1688,34,2472,0,ITC,ITC3,7,Liguria,Liguria,1550640,1593102,102.74,0.16
2953,2021-01-04,LIG,2619,856,1763,2618,0,1,ITC,ITC3,7,Liguria,Liguria,1550640,1595721,102.91,0.17
2954,2021-06-21,LIG,14839,7034,7805,8577,6239,23,ITC,ITC3,7,Liguria,Liguria,1550640,1610560,103.86,0.96
2955,2021-04-16,LIG,12001,5292,6709,10010,1829,162,ITC,ITC3,7,Liguria,Liguria,1550640,1622561,104.64,0.77
2956,2021-01-06,LIG,1665,619,1046,1662,0,3,ITC,ITC3,7,Liguria,Liguria,1550640,1624226,104.75,0.11
2957,2021-06-28,LIG,11601,5609,5992,7256,4302,43,ITC,ITC3,7,Liguria,Liguria,1550640,1635827,105.49,0.75
2958,2021-03-20,LIG,2316,995,1321,1124,1174,18,ITC,ITC3,7,Liguria,Liguria,1550640,1638143,105.64,0.15
2959,2021-06-30,LIG,15068,7188,7880,8229,6794,45,ITC,ITC3,7,Liguria,Liguria,1550640,1653211,106.61,0.97
2960,2021-01-15,LIG,2257,755,1502,2252,0,5,ITC,ITC3,7,Liguria,Liguria,1550640,1655468,106.76,0.15
2961,2021-04-25,LIG,1935,920,1015,1506,415,14,ITC,ITC3,7,Liguria,Liguria,1550640,1657403,106.89,0.12
2962,2021-03-13,LIG,3850,1637,2213,2949,856,45,ITC,ITC3,7,Liguria,Liguria,1550640,1661253,107.13,0.25
2963,2021-06-23,LIG,14315,6850,7465,9104,5192,19,ITC,ITC3,7,Liguria,Liguria,1550640,1675568,108.06,0.92
2964,2021-02-14,LIG,233,122,111,233,0,0,ITC,ITC3,7,Liguria,Liguria,1550640,1675801,108.07,0.02
2965,2021-05-25,LIG,14264,6953,7311,10948,3186,130,ITC,ITC3,7,Liguria,Liguria,1550640,1690065,108.99,0.92
2966,2021-03-22,LIG,7754,3474,4280,4738,2943,73,ITC,ITC3,7,Liguria,Liguria,1550640,1697819,109.49,0.5
2967,2021-02-07,LIG,407,153,254,2,405,0,ITC,ITC3,7,Liguria,Liguria,1550640,1698226,109.52,0.03
2968,2021-05-18,LIG,13482,6125,7357,10036,3309,137,ITC,ITC3,7,Liguria,Liguria,1550640,1711708,110.39,0.87
2969,2021-05-20,LIG,12938,6004,6934,8777,4034,127,ITC,ITC3,7,Liguria,Liguria,1550640,1724646,111.22,0.83
2970,2021-06-20,PAB,5233,2846,2387,592,4594,47,ITH,ITH1,4,Provincia Autonoma Bolzano / Bozen,P.A. Bolzano,533050,5233,0.98,0.98
2971,2021-02-07,PAB,2362,1058,1304,14,2348,0,ITH,ITH1,4,Provincia Autonoma Bolzano / Bozen,P.A. Bolzano,533050,7595,1.42,0.44
2972,2021-05-18,PAB,3344,1755,1589,2052,1187,105,ITH,ITH1,4,Provincia Autonoma Bolzano / Bozen,P.A. Bolzano,533050,10939,2.05,0.63
2973,2021-01-24,PAB,12,10,2,0,12,0,ITH,ITH1,4,Provincia Autonoma Bolzano / Bozen,P.A. Bolzano,533050,10951,2.05,0.0
2974,2021-07-04,PAB,4413,2130,2283,188,4225,0,ITH,ITH1,4,Provincia Autonoma Bolzano / Bozen,P.A. Bolzano,533050,15364,2.88,0.83
2975,2021-07-16,PAB,4492,2435,2057,1180,3312,0,ITH,ITH1,4,Provincia Autonoma Bolzano / Bozen,P.A. Bolzano,533050,19856,3.72,0.84
2976,2021-04-24,PAB,5110,2452,2658,4287,485,338,ITH,ITH1,4,Provincia Autonoma Bolzano / Bozen,P.A. Bolzano,533050,24966,4.68,0.96
2977,2021-07-14,PAB,867,449,418,508,359,0,ITH,ITH1,4,Provincia Autonoma Bolzano / Bozen,P.A. Bolzano,533050,25833,4.85,0.16
2978,2021-04-05,PAB,301,144,157,22,278,1,ITH,ITH1,4,Provincia Autonoma Bolzano / Bozen,P.A. Bolzano,533050,26134,4.9,0.06
2979,2021-06-27,PAB,4425,2314,2111,573,3807,45,ITH,ITH1,4,Provincia Autonoma Bolzano / Bozen,P.A. Bolzano,533050,30559,5.73,0.83
2980,2021-01-12,PAB,1709,459,1250,1709,0,0,ITH,ITH1,4,Provincia Autonoma Bolzano / Bozen,P.A. Bolzano,533050,32268,6.05,0.32
2981,2021-01-26,PAB,810,291,519,1,809,0,ITH,ITH1,4,Provincia Autonoma Bolzano / Bozen,P.A. Bolzano,533050,33078,6.21,0.15
2982,2021-07-02,PAB,3200,1657,1543,1028,2172,0,ITH,ITH1,4,Provincia Autonoma Bolzano / Bozen,P.A. Bolzano,533050,36278,6.81,0.6
2983,2021-03-24,PAB,2064,999,1065,1997,13,54,ITH,ITH1,4,Provincia Autonoma Bolzano / Bozen,P.A. Bolzano,533050,38342,7.19,0.39
2984,2021-03-10,PAB,1269,530,739,1074,143,52,ITH,ITH1,4,Provincia Autonoma Bolzano / Bozen,P.A. Bolzano,533050,39611,7.43,0.24
2985,2021-05-06,PAB,5186,2749,2437,2349,2568,269,ITH,ITH1,4,Provincia Autonoma Bolzano / Bozen,P.A. Bolzano,533050,44797,8.4,0.97
2986,2021-06-06,PAB,4536,2179,2357,808,3678,50,ITH,ITH1,4,Provincia Autonoma Bolzano / Bozen,P.A. Bolzano,533050,49333,9.25,0.85
2987,2021-02-26,PAB,1528,551,977,1470,30,28,ITH,ITH1,4,Provincia Autonoma Bolzano / Bozen,P.A. Bolzano,533050,50861,9.54,0.29
2988,2021-06-01,PAB,3639,2368,1271,2023,1473,143,ITH,ITH1,4,Provincia Autonoma Bolzano / Bozen,P.A. Bolzano,533050,54500,10.22,0.68
2989,2021-02-19,PAB,2252,512,1740,2192,11,49,ITH,ITH1,4,Provincia Autonoma Bolzano / Bozen,P.A. Bolzano,533050,56752,10.65,0.42
2990,2021-03-22,PAB,1162,528,634,1110,21,31,ITH,ITH1,4,Provincia Autonoma Bolzano / Bozen,P.A. Bolzano,533050,57914,10.86,0.22
2991,2021-05-20,PAB,4934,2479,2455,3285,1470,179,ITH,ITH1,4,Provincia Autonoma Bolzano / Bozen,P.A. Bolzano,533050,62848,11.79,0.93
2992,2021-07-09,PAB,5218,2609,2609,1056,4162,0,ITH,ITH1,4,Provincia Autonoma Bolzano / Bozen,P.A. Bolzano,533050,68066,12.77,0.98
2993,2021-03-31,PAB,1832,694,1138,727,1011,94,ITH,ITH1,4,Provincia Autonoma Bolzano / Bozen,P.A. Bolzano,533050,69898,13.11,0.34
2994,2021-02-12,PAB,730,217,513,464,248,18,ITH,ITH1,4,Provincia Autonoma Bolzano / Bozen,P.A. Bolzano,533050,70628,13.25,0.14
2995,2021-04-10,PAB,5397,2667,2730,4633,588,176,ITH,ITH1,4,Provincia Autonoma Bolzano / Bozen,P.A. Bolzano,533050,76025,14.26,1.01
2996,2020-12-31,PAB,929,528,401,929,0,0,ITH,ITH1,4,Provincia Autonoma Bolzano / Bozen,P.A. Bolzano,533050,76954,14.44,0.17
2997,2021-04-19,PAB,1873,859,1014,1600,182,91,ITH,ITH1,4,Provincia Autonoma Bolzano / Bozen,P.A. Bolzano,533050,78827,14.79,0.35
2998,2021-06-15,PAB,2041,1181,860,478,1532,31,ITH,ITH1,4,Provincia Autonoma Bolzano / Bozen,P.A. Bolzano,533050,80868,15.17,0.38
2999,2021-07-28,PAB,869,484,385,628,241,0,ITH,ITH1,4,Provincia Autonoma Bolzano / Bozen,P.A. Bolzano,533050,81737,15.33,0.16
3000,2021-03-17,PAB,582,213,369,546,2,34,ITH,ITH1,4,Provincia Autonoma Bolzano / Bozen,P.A. Bolzano,533050,82319,15.44,0.11
3001,2021-05-13,PAB,2995,1355,1640,1009,1930,56,ITH,ITH1,4,Provincia Autonoma Bolzano / Bozen,P.A. Bolzano,533050,85314,16.0,0.56
3002,2021-04-29,PAB,2631,1351,1280,1731,694,206,ITH,ITH1,4,Provincia Autonoma Bolzano / Bozen,P.A. Bolzano,533050,87945,16.5,0.49
3003,2021-01-19,PAB,853,371,482,723,130,0,ITH,ITH1,4,Provincia Autonoma Bolzano / Bozen,P.A. Bolzano,533050,88798,16.66,0.16
3004,2021-06-25,PAB,4176,2306,1870,1023,3014,139,ITH,ITH1,4,Provincia Autonoma Bolzano / Bozen,P.A. Bolzano,533050,92974,17.44,0.78
3005,2021-05-01,PAB,2105,1067,1038,1811,160,134,ITH,ITH1,4,Provincia Autonoma Bolzano / Bozen,P.A. Bolzano,533050,95079,17.84,0.39
3006,2021-03-12,PAB,1665,734,931,1220,413,32,ITH,ITH1,4,Provincia Autonoma Bolzano / Bozen,P.A. Bolzano,533050,96744,18.15,0.31
3007,2021-03-29,PAB,1172,500,672,390,760,22,ITH,ITH1,4,Provincia Autonoma Bolzano / Bozen,P.A. Bolzano,533050,97916,18.37,0.22
3008,2021-05-15,PAB,7010,3691,3319,6294,294,422,ITH,ITH1,4,Provincia Autonoma Bolzano / Bozen,P.A. Bolzano,533050,104926,19.68,1.32
3009,2021-02-04,PAB,1963,596,1367,8,1955,0,ITH,ITH1,4,Provincia Autonoma Bolzano / Bozen,P.A. Bolzano,533050,106889,20.05,0.37
3010,2021-07-11,PAB,6062,3090,2972,1192,4870,0,ITH,ITH1,4,Provincia Autonoma Bolzano / Bozen,P.A. Bolzano,533050,112951,21.19,1.14
3011,2021-06-29,PAB,1877,1013,864,239,1617,21,ITH,ITH1,4,Provincia Autonoma Bolzano / Bozen,P.A. Bolzano,533050,114828,21.54,0.35
3012,2021-03-21,PAB,768,285,483,13,754,1,ITH,ITH1,4,Provincia Autonoma Bolzano / Bozen,P.A. Bolzano,533050,115596,21.69,0.14
3013,2021-06-12,PAB,5064,2750,2314,1646,3288,130,ITH,ITH1,4,Provincia Autonoma Bolzano / Bozen,P.A. Bolzano,533050,120660,22.64,0.95
3014,2021-06-08,PAB,4210,2151,2059,862,3320,28,ITH,ITH1,4,Provincia Autonoma Bolzano / Bozen,P.A. Bolzano,533050,124870,23.43,0.79
3015,2021-03-05,PAB,1841,625,1216,1381,443,17,ITH,ITH1,4,Provincia Autonoma Bolzano / Bozen,P.A. Bolzano,533050,126711,23.77,0.35
3016,2021-05-27,PAB,6174,3251,2923,3823,2012,339,ITH,ITH1,4,Provincia Autonoma Bolzano / Bozen,P.A. Bolzano,533050,132885,24.93,1.16
3017,2021-06-13,PAB,3682,2049,1633,451,3191,40,ITH,ITH1,4,Provincia Autonoma Bolzano / Bozen,P.A. Bolzano,533050,136567,25.62,0.69
3018,2021-05-25,PAB,3868,2006,1862,2863,886,119,ITH,ITH1,4,Provincia Autonoma Bolzano / Bozen,P.A. Bolzano,533050,140435,26.35,0.73
3019,2021-02-14,PAB,297,130,167,295,0,2,ITH,ITH1,4,Provincia Autonoma Bolzano / Bozen,P.A. Bolzano,533050,140732,26.4,0.06
3020,2021-05-08,PAB,4427,2382,2045,3558,663,206,ITH,ITH1,4,Provincia Autonoma Bolzano / Bozen,P.A. Bolzano,533050,145159,27.23,0.83
3021,2021-03-03,PAB,1181,395,786,1144,13,24,ITH,ITH1,4,Provincia Autonoma Bolzano / Bozen,P.A. Bolzano,533050,146340,27.45,0.22
3022,2021-04-17,PAB,5239,2602,2637,4941,44,254,ITH,ITH1,4,Provincia Autonoma Bolzano / Bozen,P.A. Bolzano,533050,151579,28.44,0.98
3023,2021-01-07,PAB,918,327,591,918,0,0,ITH,ITH1,4,Provincia Autonoma Bolzano / Bozen,P.A. Bolzano,533050,152497,28.61,0.17
3024,2021-07-21,PAB,3215,1879,1336,573,2642,0,ITH,ITH1,4,Provincia Autonoma Bolzano / Bozen,P.A. Bolzano,533050,155712,29.21,0.6
3025,2021-04-12,PAB,2105,946,1159,2022,7,76,ITH,ITH1,4,Provincia Autonoma Bolzano / Bozen,P.A. Bolzano,533050,157817,29.61,0.39
3026,2021-03-07,PAB,114,13,101,9,105,0,ITH,ITH1,4,Provincia Autonoma Bolzano / Bozen,P.A. Bolzano,533050,157931,29.63,0.02
3027,2021-07-23,PAB,4345,2368,1977,1955,2390,0,ITH,ITH1,4,Provincia Autonoma Bolzano / Bozen,P.A. Bolzano,533050,162276,30.44,0.82
3028,2021-01-05,PAB,830,286,544,829,0,1,ITH,ITH1,4,Provincia Autonoma Bolzano / Bozen,P.A. Bolzano,533050,163106,30.6,0.16
3029,2021-01-23,PAB,197,117,80,0,197,0,ITH,ITH1,4,Provincia Autonoma Bolzano / Bozen,P.A. Bolzano,533050,163303,30.64,0.04
3030,2021-05-03,PAB,1832,848,984,397,1414,21,ITH,ITH1,4,Provincia Autonoma Bolzano / Bozen,P.A. Bolzano,533050,165135,30.98,0.34
3031,2021-02-23,PAB,769,324,445,760,6,3,ITH,ITH1,4,Provincia Autonoma Bolzano / Bozen,P.A. Bolzano,533050,165904,31.12,0.14
3032,2021-05-17,PAB,3141,1518,1623,2268,694,179,ITH,ITH1,4,Provincia Autonoma Bolzano / Bozen,P.A. Bolzano,533050,169045,31.71,0.59
3033,2021-06-03,PAB,4821,2621,2200,3646,947,228,ITH,ITH1,4,Provincia Autonoma Bolzano / Bozen,P.A. Bolzano,533050,173866,32.62,0.9
3034,2021-02-09,PAB,317,126,191,1,316,0,ITH,ITH1,4,Provincia Autonoma Bolzano / Bozen,P.A. Bolzano,533050,174183,32.68,0.06
3035,2021-07-13,PAB,3376,1729,1647,1450,1926,0,ITH,ITH1,4,Provincia Autonoma Bolzano / Bozen,P.A. Bolzano,533050,177559,33.31,0.63
3036,2021-02-02,PAB,1752,509,1243,8,1744,0,ITH,ITH1,4,Provincia Autonoma Bolzano / Bozen,P.A. Bolzano,533050,179311,33.64,0.33
3037,2021-07-20,PAB,3128,1727,1401,1606,1522,0,ITH,ITH1,4,Provincia Autonoma Bolzano / Bozen,P.A. Bolzano,533050,182439,34.23,0.59
3038,2021-01-21,PAB,967,450,517,139,828,0,ITH,ITH1,4,Provincia Autonoma Bolzano / Bozen,P.A. Bolzano,533050,183406,34.41,0.18
3039,2021-07-25,PAB,1891,1127,764,745,1146,0,ITH,ITH1,4,Provincia Autonoma Bolzano / Bozen,P.A. Bolzano,533050,185297,34.76,0.35
3040,2021-01-14,PAB,1952,578,1374,1952,0,0,ITH,ITH1,4,Provincia Autonoma Bolzano / Bozen,P.A. Bolzano,533050,187249,35.13,0.37
3041,2021-04-07,PAB,1798,823,975,1162,540,96,ITH,ITH1,4,Provincia Autonoma Bolzano / Bozen,P.A. Bolzano,533050,189047,35.47,0.34
3042,2021-03-02,PAB,695,200,495,673,2,20,ITH,ITH1,4,Provincia Autonoma Bolzano / Bozen,P.A. Bolzano,533050,189742,35.6,0.13
3043,2021-03-19,PAB,1920,777,1143,749,1120,51,ITH,ITH1,4,Provincia Autonoma Bolzano / Bozen,P.A. Bolzano,533050,191662,35.96,0.36
3044,2021-07-01,PAB,4633,2301,2332,1334,3165,134,ITH,ITH1,4,Provincia Autonoma Bolzano / Bozen,P.A. Bolzano,533050,196295,36.82,0.87
3045,2021-03-04,PAB,1716,1006,710,1431,229,56,ITH,ITH1,4,Provincia Autonoma Bolzano / Bozen,P.A. Bolzano,533050,198011,37.15,0.32
3046,2021-05-26,PAB,4996,2521,2475,2832,1974,190,ITH,ITH1,4,Provincia Autonoma Bolzano / Bozen,P.A. Bolzano,533050,203007,38.08,0.94
3047,2021-06-14,PAB,2976,1612,1364,573,2357,46,ITH,ITH1,4,Provincia Autonoma Bolzano / Bozen,P.A. Bolzano,533050,205983,38.64,0.56
3048,2021-05-10,PAB,3018,1300,1718,1331,1605,82,ITH,ITH1,4,Provincia Autonoma Bolzano / Bozen,P.A. Bolzano,533050,209001,39.21,0.57
3049,2021-02-16,PAB,530,205,325,529,0,1,ITH,ITH1,4,Provincia Autonoma Bolzano / Bozen,P.A. Bolzano,533050,209531,39.31,0.1
3050,2021-01-28,PAB,871,308,563,9,862,0,ITH,ITH1,4,Provincia Autonoma Bolzano / Bozen,P.A. Bolzano,533050,210402,39.47,0.16
3051,2021-04-02,PAB,2088,839,1249,589,1357,142,ITH,ITH1,4,Provincia Autonoma Bolzano / Bozen,P.A. Bolzano,533050,212490,39.86,0.39
3052,2021-05-29,PAB,7320,3894,3426,4002,3139,179,ITH,ITH1,4,Provincia Autonoma Bolzano / Bozen,P.A. Bolzano,533050,219810,41.24,1.37
3053,2021-03-26,PAB,1659,734,925,504,1135,20,ITH,ITH1,4,Provincia Autonoma Bolzano / Bozen,P.A. Bolzano,533050,221469,41.55,0.31
3054,2021-04-09,PAB,2937,1301,1636,1936,730,271,ITH,ITH1,4,Provincia Autonoma Bolzano / Bozen,P.A. Bolzano,533050,224406,42.1,0.55
3055,2021-05-31,PAB,3031,1494,1537,2039,867,125,ITH,ITH1,4,Provincia Autonoma Bolzano / Bozen,P.A. Bolzano,533050,227437,42.67,0.57
3056,2021-01-01,PAB,6,5,1,6,0,0,ITH,ITH1,4,Provincia Autonoma Bolzano / Bozen,P.A. Bolzano,533050,227443,42.67,0.0
3057,2021-06-07,PAB,2956,1539,1417,2499,318,139,ITH,ITH1,4,Provincia Autonoma Bolzano / Bozen,P.A. Bolzano,533050,230399,43.22,0.55
3058,2021-02-27,PAB,2458,759,1699,2411,10,37,ITH,ITH1,4,Provincia Autonoma Bolzano / Bozen,P.A. Bolzano,533050,232857,43.68,0.46
3059,2021-02-13,PAB,318,79,239,310,6,2,ITH,ITH1,4,Provincia Autonoma Bolzano / Bozen,P.A. Bolzano,533050,233175,43.74,0.06
3060,2021-04-11,PAB,2724,1294,1430,2446,177,101,ITH,ITH1,4,Provincia Autonoma Bolzano / Bozen,P.A. Bolzano,533050,235899,44.25,0.51
3061,2021-05-24,PAB,1455,767,688,1039,334,82,ITH,ITH1,4,Provincia Autonoma Bolzano / Bozen,P.A. Bolzano,533050,237354,44.53,0.27
3062,2021-07-30,PAB,4567,2436,2131,3263,1304,0,ITH,ITH1,4,Provincia Autonoma Bolzano / Bozen,P.A. Bolzano,533050,241921,45.38,0.86
3063,2021-04-21,PAB,3013,1468,1545,2032,848,133,ITH,ITH1,4,Provincia Autonoma Bolzano / Bozen,P.A. Bolzano,533050,244934,45.95,0.57
3064,2021-06-24,PAB,3931,2034,1897,1560,2197,174,ITH,ITH1,4,Provincia Autonoma Bolzano / Bozen,P.A. Bolzano,533050,248865,46.69,0.74
3065,2021-01-09,PAB,612,326,286,612,0,0,ITH,ITH1,4,Provincia Autonoma Bolzano / Bozen,P.A. Bolzano,533050,249477,46.8,0.11
3066,2021-06-17,PAB,1768,980,788,616,1079,73,ITH,ITH1,4,Provincia Autonoma Bolzano / Bozen,P.A. Bolzano,533050,251245,47.13,0.33
3067,2021-01-02,PAB,91,48,43,91,0,0,ITH,ITH1,4,Provincia Autonoma Bolzano / Bozen,P.A. Bolzano,533050,251336,47.15,0.02
3068,2021-06-26,PAB,4541,2328,2213,1362,3072,107,ITH,ITH1,4,Provincia Autonoma Bolzano / Bozen,P.A. Bolzano,533050,255877,48.0,0.85
3069,2021-03-18,PAB,1302,531,771,216,1076,10,ITH,ITH1,4,Provincia Autonoma Bolzano / Bozen,P.A. Bolzano,533050,257179,48.25,0.24
3070,2021-05-14,PAB,5136,2321,2815,2889,2039,208,ITH,ITH1,4,Provincia Autonoma Bolzano / Bozen,P.A. Bolzano,533050,262315,49.21,0.96
3071,2021-03-16,PAB,1290,532,758,116,1166,8,ITH,ITH1,4,Provincia Autonoma Bolzano / Bozen,P.A. Bolzano,533050,263605,49.45,0.24
3072,2021-07-06,PAB,1719,924,795,738,981,0,ITH,ITH1,4,Provincia Autonoma Bolzano / Bozen,P.A. Bolzano,533050,265324,49.77,0.32
3073,2021-06-22,PAB,2468,1421,1047,317,2125,26,ITH,ITH1,4,Provincia Autonoma Bolzano / Bozen,P.A. Bolzano,533050,267792,50.24,0.46
3074,2021-03-14,PAB,758,336,422,14,733,11,ITH,ITH1,4,Provincia Autonoma Bolzano / Bozen,P.A. Bolzano,533050,268550,50.38,0.14
3075,2021-04-14,PAB,3593,1645,1948,3215,91,287,ITH,ITH1,4,Provincia Autonoma Bolzano / Bozen,P.A. Bolzano,533050,272143,51.05,0.67
3076,2021-01-04,PAB,508,201,307,508,0,0,ITH,ITH1,4,Provincia Autonoma Bolzano / Bozen,P.A. Bolzano,533050,272651,51.15,0.1
3077,2021-02-15,PAB,72,42,30,23,46,3,ITH,ITH1,4,Provincia Autonoma Bolzano / Bozen,P.A. Bolzano,533050,272723,51.16,0.01
3078,2021-05-11,PAB,2845,1336,1509,1242,1522,81,ITH,ITH1,4,Provincia Autonoma Bolzano / Bozen,P.A. Bolzano,533050,275568,51.7,0.53
3079,2021-01-29,PAB,1498,511,987,24,1474,0,ITH,ITH1,4,Provincia Autonoma Bolzano / Bozen,P.A. Bolzano,533050,277066,51.98,0.28
3080,2021-04-22,PAB,2925,1502,1423,1853,942,130,ITH,ITH1,4,Provincia Autonoma Bolzano / Bozen,P.A. Bolzano,533050,279991,52.53,0.55
3081,2021-05-09,PAB,4242,2411,1831,2924,1152,166,ITH,ITH1,4,Provincia Autonoma Bolzano / Bozen,P.A. Bolzano,533050,284233,53.32,0.8
3082,2021-05-12,PAB,3792,2058,1734,3393,153,246,ITH,ITH1,4,Provincia Autonoma Bolzano / Bozen,P.A. Bolzano,533050,288025,54.03,0.71
3083,2021-02-01,PAB,1458,443,1015,11,1446,1,ITH,ITH1,4,Provincia Autonoma Bolzano / Bozen,P.A. Bolzano,533050,289483,54.31,0.27
3084,2021-03-09,PAB,1194,543,651,1164,2,28,ITH,ITH1,4,Provincia Autonoma Bolzano / Bozen,P.A. Bolzano,533050,290677,54.53,0.22
3085,2021-02-06,PAB,2628,1173,1455,18,2609,1,ITH,ITH1,4,Provincia Autonoma Bolzano / Bozen,P.A. Bolzano,533050,293305,55.02,0.49
3086,2021-06-21,PAB,3167,1614,1553,260,2867,40,ITH,ITH1,4,Provincia Autonoma Bolzano / Bozen,P.A. Bolzano,533050,296472,55.62,0.59
3087,2021-05-22,PAB,6838,3568,3270,4445,2166,227,ITH,ITH1,4,Provincia Autonoma Bolzano / Bozen,P.A. Bolzano,533050,303310,56.9,1.28
3088,2021-02-11,PAB,1094,432,662,238,855,1,ITH,ITH1,4,Provincia Autonoma Bolzano / Bozen,P.A. Bolzano,533050,304404,57.11,0.21
3089,2021-07-18,PAB,1860,1031,829,713,1147,0,ITH,ITH1,4,Provincia Autonoma Bolzano / Bozen,P.A. Bolzano,533050,306264,57.46,0.35
3090,2021-02-18,PAB,1839,457,1382,1810,7,22,ITH,ITH1,4,Provincia Autonoma Bolzano / Bozen,P.A. Bolzano,533050,308103,57.8,0.34
3091,2021-07-29,PAB,938,496,442,548,390,0,ITH,ITH1,4,Provincia Autonoma Bolzano / Bozen,P.A. Bolzano,533050,309041,57.98,0.18
3092,2021-06-05,PAB,6080,3030,3050,4696,1096,288,ITH,ITH1,4,Provincia Autonoma Bolzano / Bozen,P.A. Bolzano,533050,315121,59.12,1.14
3093,2021-04-30,PAB,3342,1594,1748,1431,1776,135,ITH,ITH1,4,Provincia Autonoma Bolzano / Bozen,P.A. Bolzano,533050,318463,59.74,0.63
3094,2021-01-20,PAB,618,253,365,410,208,0,ITH,ITH1,4,Provincia Autonoma Bolzano / Bozen,P.A. Bolzano,533050,319081,59.86,0.12
3095,2021-07-22,PAB,3719,1932,1787,1932,1787,0,ITH,ITH1,4,Provincia Autonoma Bolzano / Bozen,P.A. Bolzano,533050,322800,60.56,0.7
3096,2021-01-06,PAB,59,18,41,59,0,0,ITH,ITH1,4,Provincia Autonoma Bolzano / Bozen,P.A. Bolzano,533050,322859,60.57,0.01
3097,2021-03-30,PAB,1299,532,767,204,1080,15,ITH,ITH1,4,Provincia Autonoma Bolzano / Bozen,P.A. Bolzano,533050,324158,60.81,0.24
3098,2021-04-25,PAB,3073,1497,1576,2274,672,127,ITH,ITH1,4,Provincia Autonoma Bolzano / Bozen,P.A. Bolzano,533050,327231,61.39,0.58
3099,2021-01-13,PAB,1718,565,1153,1718,0,0,ITH,ITH1,4,Provincia Autonoma Bolzano / Bozen,P.A. Bolzano,533050,328949,61.71,0.32
3100,2021-01-30,PAB,498,245,253,4,494,0,ITH,ITH1,4,Provincia Autonoma Bolzano / Bozen,P.A. Bolzano,533050,329447,61.8,0.09
3101,2021-04-23,PAB,4546,2152,2394,3043,1291,212,ITH,ITH1,4,Provincia Autonoma Bolzano / Bozen,P.A. Bolzano,533050,333993,62.66,0.85
3102,2021-01-11,PAB,1589,520,1069,1589,0,0,ITH,ITH1,4,Provincia Autonoma Bolzano / Bozen,P.A. Bolzano,533050,335582,62.96,0.3
3103,2021-07-15,PAB,4381,2311,2070,1685,2696,0,ITH,ITH1,4,Provincia Autonoma Bolzano / Bozen,P.A. Bolzano,533050,339963,63.78,0.82
3104,2021-04-06,PAB,2251,1118,1133,1940,104,207,ITH,ITH1,4,Provincia Autonoma Bolzano / Bozen,P.A. Bolzano,533050,342214,64.2,0.42
3105,2021-05-23,PAB,4338,2303,2035,4116,8,214,ITH,ITH1,4,Provincia Autonoma Bolzano / Bozen,P.A. Bolzano,533050,346552,65.01,0.81
3106,2021-07-19,PAB,2772,1389,1383,726,2046,0,ITH,ITH1,4,Provincia Autonoma Bolzano / Bozen,P.A. Bolzano,533050,349324,65.53,0.52
3107,2021-02-03,PAB,1504,478,1026,5,1499,0,ITH,ITH1,4,Provincia Autonoma Bolzano / Bozen,P.A. Bolzano,533050,350828,65.82,0.28
3108,2021-02-10,PAB,1636,605,1031,25,1610,1,ITH,ITH1,4,Provincia Autonoma Bolzano / Bozen,P.A. Bolzano,533050,352464,66.12,0.31
3109,2021-05-21,PAB,6958,3825,3133,4800,1847,311,ITH,ITH1,4,Provincia Autonoma Bolzano / Bozen,P.A. Bolzano,533050,359422,67.43,1.31
3110,2021-02-20,PAB,1802,540,1262,1753,18,31,ITH,ITH1,4,Provincia Autonoma Bolzano / Bozen,P.A. Bolzano,533050,361224,67.77,0.34
3111,2021-07-27,PAB,3104,1856,1248,957,2147,0,ITH,ITH1,4,Provincia Autonoma Bolzano / Bozen,P.A. Bolzano,533050,364328,68.35,0.58
3112,2021-04-18,PAB,3110,1607,1503,2004,1010,96,ITH,ITH1,4,Provincia Autonoma Bolzano / Bozen,P.A. Bolzano,533050,367438,68.93,0.58
3113,2021-01-15,PAB,3282,1228,2054,3281,0,1,ITH,ITH1,4,Provincia Autonoma Bolzano / Bozen,P.A. Bolzano,533050,370720,69.55,0.62
3114,2021-06-18,PAB,4158,2163,1995,1132,2899,127,ITH,ITH1,4,Provincia Autonoma Bolzano / Bozen,P.A. Bolzano,533050,374878,70.33,0.78
3115,2021-03-28,PAB,569,212,357,11,558,0,ITH,ITH1,4,Provincia Autonoma Bolzano / Bozen,P.A. Bolzano,533050,375447,70.43,0.11
3116,2021-01-08,PAB,1523,479,1044,1523,0,0,ITH,ITH1,4,Provincia Autonoma Bolzano / Bozen,P.A. Bolzano,533050,376970,70.72,0.29
3117,2021-03-06,PAB,3973,2081,1892,3674,211,88,ITH,ITH1,4,Provincia Autonoma Bolzano / Bozen,P.A. Bolzano,533050,380943,71.46,0.75
3118,2021-05-28,PAB,7130,3749,3381,5020,1891,219,ITH,ITH1,4,Provincia Autonoma Bolzano / Bozen,P.A. Bolzano,533050,388073,72.8,1.34
3119,2021-02-17,PAB,156,51,105,139,17,0,ITH,ITH1,4,Provincia Autonoma Bolzano / Bozen,P.A. Bolzano,533050,388229,72.83,0.03
3120,2021-07-17,PAB,3138,1795,1343,792,2346,0,ITH,ITH1,4,Provincia Autonoma Bolzano / Bozen,P.A. Bolzano,533050,391367,73.42,0.59
3121,2021-04-08,PAB,2769,1348,1421,2475,204,90,ITH,ITH1,4,Provincia Autonoma Bolzano / Bozen,P.A. Bolzano,533050,394136,73.94,0.52
3122,2020-12-27,PAB,144,65,79,144,0,0,ITH,ITH1,4,Provincia Autonoma Bolzano / Bozen,P.A. Bolzano,533050,394280,73.97,0.03
3123,2021-06-30,PAB,3060,1564,1496,397,2604,59,ITH,ITH1,4,Provincia Autonoma Bolzano / Bozen,P.A. Bolzano,533050,397340,74.54,0.57
3124,2021-06-11,PAB,5802,2984,2818,2102,3480,220,ITH,ITH1,4,Provincia Autonoma Bolzano / Bozen,P.A. Bolzano,533050,403142,75.63,1.09
3125,2021-03-20,PAB,1759,850,909,1108,625,26,ITH,ITH1,4,Provincia Autonoma Bolzano / Bozen,P.A. Bolzano,533050,404901,75.96,0.33
3126,2021-06-28,PAB,4607,2304,2303,216,4367,24,ITH,ITH1,4,Provincia Autonoma Bolzano / Bozen,P.A. Bolzano,533050,409508,76.82,0.86
3127,2021-04-16,PAB,2951,1419,1532,2275,511,165,ITH,ITH1,4,Provincia Autonoma Bolzano / Bozen,P.A. Bolzano,533050,412459,77.38,0.55
3128,2021-07-08,PAB,5503,2780,2723,623,4880,0,ITH,ITH1,4,Provincia Autonoma Bolzano / Bozen,P.A. Bolzano,533050,417962,78.41,1.03
3129,2021-06-19,PAB,5660,3014,2646,555,5033,72,ITH,ITH1,4,Provincia Autonoma Bolzano / Bozen,P.A. Bolzano,533050,423622,79.47,1.06
3130,2021-03-11,PAB,1686,826,860,1092,539,55,ITH,ITH1,4,Provincia Autonoma Bolzano / Bozen,P.A. Bolzano,533050,425308,79.79,0.32
3131,2021-02-25,PAB,1498,549,949,1487,1,10,ITH,ITH1,4,Provincia Autonoma Bolzano / Bozen,P.A. Bolzano,533050,426806,80.07,0.28
3132,2021-06-02,PAB,1465,823,642,975,458,32,ITH,ITH1,4,Provincia Autonoma Bolzano / Bozen,P.A. Bolzano,533050,428271,80.34,0.27
3133,2021-02-08,PAB,2,1,1,1,1,0,ITH,ITH1,4,Provincia Autonoma Bolzano / Bozen,P.A. Bolzano,533050,428273,80.34,0.0
3134,2021-05-16,PAB,2025,932,1093,1279,692,54,ITH,ITH1,4,Provincia Autonoma Bolzano / Bozen,P.A. Bolzano,533050,430298,80.72,0.38
3135,2020-12-30,PAB,388,182,206,388,0,0,ITH,ITH1,4,Provincia Autonoma Bolzano / Bozen,P.A. Bolzano,533050,430686,80.8,0.07
3136,2021-06-09,PAB,3820,1901,1919,1237,2475,108,ITH,ITH1,4,Provincia Autonoma Bolzano / Bozen,P.A. Bolzano,533050,434506,81.51,0.72
3137,2021-03-01,PAB,923,222,701,887,1,35,ITH,ITH1,4,Provincia Autonoma Bolzano / Bozen,P.A. Bolzano,533050,435429,81.69,0.17
3138,2021-03-15,PAB,1193,452,741,696,482,15,ITH,ITH1,4,Provincia Autonoma Bolzano / Bozen,P.A. Bolzano,533050,436622,81.91,0.22
3139,2021-04-27,PAB,2226,1013,1213,1051,1077,98,ITH,ITH1,4,Provincia Autonoma Bolzano / Bozen,P.A. Bolzano,533050,438848,82.33,0.42
3140,2021-01-17,PAB,2328,1044,1284,2317,11,0,ITH,ITH1,4,Provincia Autonoma Bolzano / Bozen,P.A. Bolzano,533050,441176,82.76,0.44
3141,2021-06-23,PAB,1151,594,557,333,767,51,ITH,ITH1,4,Provincia Autonoma Bolzano / Bozen,P.A. Bolzano,533050,442327,82.98,0.22
3142,2021-04-20,PAB,1563,785,778,1486,3,74,ITH,ITH1,4,Provincia Autonoma Bolzano / Bozen,P.A. Bolzano,533050,443890,83.27,0.29
3143,2021-01-10,PAB,2,2,0,2,0,0,ITH,ITH1,4,Provincia Autonoma Bolzano / Bozen,P.A. Bolzano,533050,443892,83.27,0.0
3144,2021-06-16,PAB,3819,2025,1794,11,3804,4,ITH,ITH1,4,Provincia Autonoma Bolzano / Bozen,P.A. Bolzano,533050,447711,83.99,0.72
3145,2021-03-08,PAB,1210,534,676,1161,27,22,ITH,ITH1,4,Provincia Autonoma Bolzano / Bozen,P.A. Bolzano,533050,448921,84.22,0.23
3146,2021-05-04,PAB,3451,1844,1607,2256,1037,158,ITH,ITH1,4,Provincia Autonoma Bolzano / Bozen,P.A. Bolzano,533050,452372,84.86,0.65
3147,2021-06-04,PAB,6600,3314,3286,4835,1531,234,ITH,ITH1,4,Provincia Autonoma Bolzano / Bozen,P.A. Bolzano,533050,458972,86.1,1.24
3148,2021-02-24,PAB,1367,406,961,1316,12,39,ITH,ITH1,4,Provincia Autonoma Bolzano / Bozen,P.A. Bolzano,533050,460339,86.36,0.26
3149,2021-03-27,PAB,3051,1554,1497,1477,1508,66,ITH,ITH1,4,Provincia Autonoma Bolzano / Bozen,P.A. Bolzano,533050,463390,86.93,0.57
3150,2021-03-13,PAB,2886,1460,1426,2725,101,60,ITH,ITH1,4,Provincia Autonoma Bolzano / Bozen,P.A. Bolzano,533050,466276,87.47,0.54
3151,2021-02-05,PAB,3198,1184,2014,8,3190,0,ITH,ITH1,4,Provincia Autonoma Bolzano / Bozen,P.A. Bolzano,533050,469474,88.07,0.6
3152,2021-05-19,PAB,3851,1978,1873,1922,1786,143,ITH,ITH1,4,Provincia Autonoma Bolzano / Bozen,P.A. Bolzano,533050,473325,88.8,0.72
3153,2021-01-03,PAB,41,16,25,41,0,0,ITH,ITH1,4,Provincia Autonoma Bolzano / Bozen,P.A. Bolzano,533050,473366,88.8,0.01
3154,2021-04-13,PAB,2394,1132,1262,2298,7,89,ITH,ITH1,4,Provincia Autonoma Bolzano / Bozen,P.A. Bolzano,533050,475760,89.25,0.45
3155,2021-04-15,PAB,4399,2307,2092,3899,263,237,ITH,ITH1,4,Provincia Autonoma Bolzano / Bozen,P.A. Bolzano,533050,480159,90.08,0.83
3156,2021-07-24,PAB,4798,2832,1966,1476,3322,0,ITH,ITH1,4,Provincia Autonoma Bolzano / Bozen,P.A. Bolzano,533050,484957,90.98,0.9
3157,2021-05-02,PAB,2457,1288,1169,1423,921,113,ITH,ITH1,4,Provincia Autonoma Bolzano / Bozen,P.A. Bolzano,533050,487414,91.44,0.46
3158,2021-01-22,PAB,248,143,105,124,124,0,ITH,ITH1,4,Provincia Autonoma Bolzano / Bozen,P.A. Bolzano,533050,487662,91.49,0.05
3159,2021-07-26,PAB,1624,937,687,1213,411,0,ITH,ITH1,4,Provincia Autonoma Bolzano / Bozen,P.A. Bolzano,533050,489286,91.79,0.3
3160,2021-02-22,PAB,526,143,383,496,12,18,ITH,ITH1,4,Provincia Autonoma Bolzano / Bozen,P.A. Bolzano,533050,489812,91.89,0.1
3161,2021-07-07,PAB,1984,1030,954,648,1336,0,ITH,ITH1,4,Provincia Autonoma Bolzano / Bozen,P.A. Bolzano,533050,491796,92.26,0.37
3162,2021-04-28,PAB,2464,1302,1162,2241,5,218,ITH,ITH1,4,Provincia Autonoma Bolzano / Bozen,P.A. Bolzano,533050,494260,92.72,0.46
3163,2021-01-16,PAB,2840,1265,1575,2840,0,0,ITH,ITH1,4,Provincia Autonoma Bolzano / Bozen,P.A. Bolzano,533050,497100,93.26,0.53
3164,2021-06-10,PAB,4475,2320,2155,1289,3094,92,ITH,ITH1,4,Provincia Autonoma Bolzano / Bozen,P.A. Bolzano,533050,501575,94.1,0.84
3165,2021-04-26,PAB,1543,771,772,1446,5,92,ITH,ITH1,4,Provincia Autonoma Bolzano / Bozen,P.A. Bolzano,533050,503118,94.38,0.29
3166,2021-07-10,PAB,5796,2994,2802,1060,4736,0,ITH,ITH1,4,Provincia Autonoma Bolzano / Bozen,P.A. Bolzano,533050,508914,95.47,1.09
3167,2021-01-18,PAB,1772,687,1085,1766,5,1,ITH,ITH1,4,Provincia Autonoma Bolzano / Bozen,P.A. Bolzano,533050,510686,95.8,0.33
3168,2021-05-07,PAB,4194,2062,2132,3375,528,291,ITH,ITH1,4,Provincia Autonoma Bolzano / Bozen,P.A. Bolzano,533050,514880,96.59,0.79
3169,2021-07-03,PAB,5632,2790,2842,1072,4560,0,ITH,ITH1,4,Provincia Autonoma Bolzano / Bozen,P.A. Bolzano,533050,520512,97.65,1.06
3170,2021-05-05,PAB,4155,1945,2210,1810,2116,229,ITH,ITH1,4,Provincia Autonoma Bolzano / Bozen,P.A. Bolzano,533050,524667,98.43,0.78
3171,2021-01-25,PAB,488,184,304,3,485,0,ITH,ITH1,4,Provincia Autonoma Bolzano / Bozen,P.A. Bolzano,533050,525155,98.52,0.09
3172,2021-03-23,PAB,1555,760,795,1516,1,38,ITH,ITH1,4,Provincia Autonoma Bolzano / Bozen,P.A. Bolzano,533050,526710,98.81,0.29
3173,2021-04-01,PAB,2787,1407,1380,2498,144,145,ITH,ITH1,4,Provincia Autonoma Bolzano / Bozen,P.A. Bolzano,533050,529497,99.33,0.52
3174,2021-07-05,PAB,2935,1406,1529,951,1984,0,ITH,ITH1,4,Provincia Autonoma Bolzano / Bozen,P.A. Bolzano,533050,532432,99.88,0.55
3175,2021-05-30,PAB,4774,2521,2253,724,4015,35,ITH,ITH1,4,Provincia Autonoma Bolzano / Bozen,P.A. Bolzano,533050,537206,100.78,0.9
3176,2021-07-12,PAB,3530,1754,1776,289,3241,0,ITH,ITH1,4,Provincia Autonoma Bolzano / Bozen,P.A. Bolzano,533050,540736,101.44,0.66
3177,2021-04-03,PAB,833,366,467,13,811,9,ITH,ITH1,4,Provincia Autonoma Bolzano / Bozen,P.A. Bolzano,533050,541569,101.6,0.16
3178,2021-03-25,PAB,2152,1064,1088,1645,443,64,ITH,ITH1,4,Provincia Autonoma Bolzano / Bozen,P.A. Bolzano,533050,543721,102.0,0.4
3179,2021-01-27,PAB,85,29,56,2,83,0,ITH,ITH1,4,Provincia Autonoma Bolzano / Bozen,P.A. Bolzano,533050,543806,102.02,0.02
3180,2021-03-03,ABR,4640,1898,2742,3711,906,23,ITF,ITF1,13,Abruzzo,Abruzzo,1304970,4640,0.36,0.36
3181,2021-07-14,ABR,13718,6795,6923,2435,11132,151,ITF,ITF1,13,Abruzzo,Abruzzo,1304970,18358,1.41,1.05
3182,2021-04-08,ABR,7394,3336,4058,4935,2330,129,ITF,ITF1,13,Abruzzo,Abruzzo,1304970,25752,1.97,0.57
3183,2021-04-22,ABR,6733,3249,3484,4830,1729,174,ITF,ITF1,13,Abruzzo,Abruzzo,1304970,32485,2.49,0.52
3184,2021-03-22,ABR,4344,1908,2436,2311,1970,63,ITF,ITF1,13,Abruzzo,Abruzzo,1304970,36829,2.82,0.33
3185,2021-06-30,ABR,11164,5427,5737,4494,6504,166,ITF,ITF1,13,Abruzzo,Abruzzo,1304970,47993,3.68,0.86
3186,2021-02-10,ABR,946,311,635,492,444,10,ITF,ITF1,13,Abruzzo,Abruzzo,1304970,48939,3.75,0.07
3187,2021-01-22,ABR,118,57,61,118,0,0,ITF,ITF1,13,Abruzzo,Abruzzo,1304970,49057,3.76,0.01
3188,2021-01-03,ABR,471,185,286,469,0,2,ITF,ITF1,13,Abruzzo,Abruzzo,1304970,49528,3.8,0.04
3189,2021-05-30,ABR,8659,4110,4549,5326,3254,79,ITF,ITF1,13,Abruzzo,Abruzzo,1304970,58187,4.46,0.66
3190,2021-04-03,ABR,5160,2257,2903,3484,1597,79,ITF,ITF1,13,Abruzzo,Abruzzo,1304970,63347,4.85,0.4
3191,2021-07-26,ABR,14207,7423,6784,3849,10159,199,ITF,ITF1,13,Abruzzo,Abruzzo,1304970,77554,5.94,1.09
3192,2021-07-12,ABR,15074,7456,7618,2361,12598,115,ITF,ITF1,13,Abruzzo,Abruzzo,1304970,92628,7.1,1.16
3193,2021-05-04,ABR,10858,5098,5760,7055,3615,188,ITF,ITF1,13,Abruzzo,Abruzzo,1304970,103486,7.93,0.83
3194,2021-03-08,ABR,5152,1693,3459,4089,972,91,ITF,ITF1,13,Abruzzo,Abruzzo,1304970,108638,8.32,0.39
3195,2021-01-24,ABR,50,22,28,6,44,0,ITF,ITF1,13,Abruzzo,Abruzzo,1304970,108688,8.33,0.0
3196,2021-03-01,ABR,3478,1385,2093,2704,751,23,ITF,ITF1,13,Abruzzo,Abruzzo,1304970,112166,8.6,0.27
3197,2021-06-18,ABR,10186,5003,5183,6550,3488,148,ITF,ITF1,13,Abruzzo,Abruzzo,1304970,122352,9.38,0.78
3198,2021-02-22,ABR,2643,1174,1469,2588,30,25,ITF,ITF1,13,Abruzzo,Abruzzo,1304970,124995,9.58,0.2
3199,2021-02-05,ABR,1534,521,1013,772,746,16,ITF,ITF1,13,Abruzzo,Abruzzo,1304970,126529,9.7,0.12
3200,2021-05-16,ABR,9578,4136,5442,5646,3813,119,ITF,ITF1,13,Abruzzo,Abruzzo,1304970,136107,10.43,0.73
3201,2021-06-04,ABR,15636,7391,8245,10758,4693,185,ITF,ITF1,13,Abruzzo,Abruzzo,1304970,151743,11.63,1.2
3202,2021-05-18,ABR,12109,5660,6449,7563,4379,167,ITF,ITF1,13,Abruzzo,Abruzzo,1304970,163852,12.56,0.93
3203,2021-02-24,ABR,3306,1442,1864,3112,177,17,ITF,ITF1,13,Abruzzo,Abruzzo,1304970,167158,12.81,0.25
3204,2020-12-27,ABR,43,22,21,43,0,0,ITF,ITF1,13,Abruzzo,Abruzzo,1304970,167201,12.81,0.0
3205,2021-03-20,ABR,4794,2199,2595,2560,2172,62,ITF,ITF1,13,Abruzzo,Abruzzo,1304970,171995,13.18,0.37
3206,2021-06-13,ABR,9842,4923,4919,7846,1831,165,ITF,ITF1,13,Abruzzo,Abruzzo,1304970,181837,13.93,0.75
3207,2021-01-10,ABR,1140,409,731,1136,0,4,ITF,ITF1,13,Abruzzo,Abruzzo,1304970,182977,14.02,0.09
3208,2021-04-29,ABR,12678,5852,6826,9280,3095,303,ITF,ITF1,13,Abruzzo,Abruzzo,1304970,195655,14.99,0.97
3209,2021-06-25,ABR,11063,5478,5585,4907,6012,144,ITF,ITF1,13,Abruzzo,Abruzzo,1304970,206718,15.84,0.85
3210,2021-01-15,ABR,380,150,230,366,0,14,ITF,ITF1,13,Abruzzo,Abruzzo,1304970,207098,15.87,0.03
3211,2021-04-27,ABR,9084,4367,4717,6506,2466,112,ITF,ITF1,13,Abruzzo,Abruzzo,1304970,216182,16.57,0.7
3212,2021-02-12,ABR,1228,567,661,1026,189,13,ITF,ITF1,13,Abruzzo,Abruzzo,1304970,217410,16.66,0.09
3213,2021-07-19,ABR,11776,5984,5792,2665,8941,170,ITF,ITF1,13,Abruzzo,Abruzzo,1304970,229186,17.56,0.9
3214,2021-05-23,ABR,9881,4695,5186,7068,2692,121,ITF,ITF1,13,Abruzzo,Abruzzo,1304970,239067,18.32,0.76
3215,2021-06-06,ABR,11149,5307,5842,8778,2242,129,ITF,ITF1,13,Abruzzo,Abruzzo,1304970,250216,19.17,0.85
3216,2021-04-10,ABR,8776,4058,4718,6128,2509,139,ITF,ITF1,13,Abruzzo,Abruzzo,1304970,258992,19.85,0.67
3217,2021-02-17,ABR,2071,948,1123,1780,282,9,ITF,ITF1,13,Abruzzo,Abruzzo,1304970,261063,20.01,0.16
3218,2021-06-11,ABR,11779,5851,5928,8834,2761,184,ITF,ITF1,13,Abruzzo,Abruzzo,1304970,272842,20.91,0.9
3219,2021-05-11,ABR,10760,5118,5642,5733,4851,176,ITF,ITF1,13,Abruzzo,Abruzzo,1304970,283602,21.73,0.82
3220,2021-07-21,ABR,11079,5719,5360,2429,8516,134,ITF,ITF1,13,Abruzzo,Abruzzo,1304970,294681,22.58,0.85
3221,2021-02-03,ABR,2064,717,1347,411,1645,8,ITF,ITF1,13,Abruzzo,Abruzzo,1304970,296745,22.74,0.16
3222,2021-02-28,ABR,1704,510,1194,1668,2,34,ITF,ITF1,13,Abruzzo,Abruzzo,1304970,298449,22.87,0.13
3223,2021-01-02,ABR,552,220,332,551,0,1,ITF,ITF1,13,Abruzzo,Abruzzo,1304970,299001,22.91,0.04
3224,2021-06-08,ABR,12868,6623,6245,10434,2195,239,ITF,ITF1,13,Abruzzo,Abruzzo,1304970,311869,23.9,0.99
3225,2021-04-26,ABR,8564,4068,4496,7143,1213,208,ITF,ITF1,13,Abruzzo,Abruzzo,1304970,320433,24.55,0.66
3226,2021-06-01,ABR,11000,4878,6122,6513,4367,120,ITF,ITF1,13,Abruzzo,Abruzzo,1304970,331433,25.4,0.84
3227,2021-03-27,ABR,6123,2621,3502,3565,2487,71,ITF,ITF1,13,Abruzzo,Abruzzo,1304970,337556,25.87,0.47
3228,2021-01-05,ABR,1617,605,1012,1612,0,5,ITF,ITF1,13,Abruzzo,Abruzzo,1304970,339173,25.99,0.12
3229,2021-04-15,ABR,7820,3680,4140,5830,1841,149,ITF,ITF1,13,Abruzzo,Abruzzo,1304970,346993,26.59,0.6
3230,2021-07-07,ABR,12028,5893,6135,4032,7758,238,ITF,ITF1,13,Abruzzo,Abruzzo,1304970,359021,27.51,0.92
3231,2021-07-09,ABR,13609,6794,6815,2895,10580,134,ITF,ITF1,13,Abruzzo,Abruzzo,1304970,372630,28.55,1.04
3232,2021-02-02,ABR,1763,668,1095,218,1541,4,ITF,ITF1,13,Abruzzo,Abruzzo,1304970,374393,28.69,0.14
3233,2021-05-13,ABR,11148,5042,6106,6960,3960,228,ITF,ITF1,13,Abruzzo,Abruzzo,1304970,385541,29.54,0.85
3234,2021-03-31,ABR,6717,2941,3776,4556,2069,92,ITF,ITF1,13,Abruzzo,Abruzzo,1304970,392258,30.06,0.51
3235,2021-05-15,ABR,11429,5180,6249,5947,5306,176,ITF,ITF1,13,Abruzzo,Abruzzo,1304970,403687,30.93,0.88
3236,2021-01-19,ABR,111,55,56,90,20,1,ITF,ITF1,13,Abruzzo,Abruzzo,1304970,403798,30.94,0.01
3237,2021-02-07,ABR,779,308,471,200,578,1,ITF,ITF1,13,Abruzzo,Abruzzo,1304970,404577,31.0,0.06
3238,2021-07-02,ABR,11860,5954,5906,4843,6834,183,ITF,ITF1,13,Abruzzo,Abruzzo,1304970,416437,31.91,0.91
3239,2021-03-15,ABR,3680,1444,2236,1842,1807,31,ITF,ITF1,13,Abruzzo,Abruzzo,1304970,420117,32.19,0.28
3240,2021-01-17,ABR,188,59,129,180,7,1,ITF,ITF1,13,Abruzzo,Abruzzo,1304970,420305,32.21,0.01
3241,2021-06-23,ABR,11014,5284,5730,5582,5286,146,ITF,ITF1,13,Abruzzo,Abruzzo,1304970,431319,33.05,0.84
3242,2021-01-29,ABR,1388,449,939,73,1314,1,ITF,ITF1,13,Abruzzo,Abruzzo,1304970,432707,33.16,0.11
3243,2021-05-27,ABR,13320,6105,7215,8316,4829,175,ITF,ITF1,13,Abruzzo,Abruzzo,1304970,446027,34.18,1.02
3244,2021-04-17,ABR,7356,3401,3955,4215,3051,90,ITF,ITF1,13,Abruzzo,Abruzzo,1304970,453383,34.74,0.56
3245,2021-02-19,ABR,3299,1551,1748,3160,100,39,ITF,ITF1,13,Abruzzo,Abruzzo,1304970,456682,35.0,0.25
3246,2021-01-07,ABR,1605,553,1052,1598,0,7,ITF,ITF1,13,Abruzzo,Abruzzo,1304970,458287,35.12,0.12
3247,2021-04-05,ABR,2693,1147,1546,1732,879,82,ITF,ITF1,13,Abruzzo,Abruzzo,1304970,460980,35.32,0.21
3248,2021-01-12,ABR,1805,667,1138,1791,0,14,ITF,ITF1,13,Abruzzo,Abruzzo,1304970,462785,35.46,0.14
3249,2021-05-25,ABR,11422,5325,6097,8085,3139,198,ITF,ITF1,13,Abruzzo,Abruzzo,1304970,474207,36.34,0.88
3250,2021-06-22,ABR,10413,4879,5534,5387,4847,179,ITF,ITF1,13,Abruzzo,Abruzzo,1304970,484620,37.14,0.8
3251,2021-03-29,ABR,5708,2599,3109,3020,2639,49,ITF,ITF1,13,Abruzzo,Abruzzo,1304970,490328,37.57,0.44
3252,2021-06-03,ABR,13195,6284,6911,9248,3776,171,ITF,ITF1,13,Abruzzo,Abruzzo,1304970,503523,38.59,1.01
3253,2021-03-12,ABR,6044,1994,4050,4355,1611,78,ITF,ITF1,13,Abruzzo,Abruzzo,1304970,509567,39.05,0.46
3254,2021-06-20,ABR,8440,4236,4204,5409,2929,102,ITF,ITF1,13,Abruzzo,Abruzzo,1304970,518007,39.69,0.65
3255,2021-03-14,ABR,1885,731,1154,1201,667,17,ITF,ITF1,13,Abruzzo,Abruzzo,1304970,519892,39.84,0.14
3256,2021-02-25,ABR,3054,1342,1712,2505,530,19,ITF,ITF1,13,Abruzzo,Abruzzo,1304970,522946,40.07,0.23
3257,2021-06-05,ABR,14615,6863,7752,10370,4045,200,ITF,ITF1,13,Abruzzo,Abruzzo,1304970,537561,41.19,1.12
3258,2021-05-17,ABR,11034,5036,5998,6023,4853,158,ITF,ITF1,13,Abruzzo,Abruzzo,1304970,548595,42.04,0.85
3259,2021-02-23,ABR,2780,1273,1507,2754,11,15,ITF,ITF1,13,Abruzzo,Abruzzo,1304970,551375,42.25,0.21
3260,2021-02-06,ABR,1611,743,868,595,1009,7,ITF,ITF1,13,Abruzzo,Abruzzo,1304970,552986,42.38,0.12
3261,2021-07-23,ABR,12537,6442,6095,2855,9524,158,ITF,ITF1,13,Abruzzo,Abruzzo,1304970,565523,43.34,0.96
3262,2021-01-21,ABR,157,47,110,157,0,0,ITF,ITF1,13,Abruzzo,Abruzzo,1304970,565680,43.35,0.01
3263,2021-05-01,ABR,10739,5044,5695,5629,4978,132,ITF,ITF1,13,Abruzzo,Abruzzo,1304970,576419,44.17,0.82
3264,2021-05-20,ABR,12806,5927,6879,7413,5266,127,ITF,ITF1,13,Abruzzo,Abruzzo,1304970,589225,45.15,0.98
3265,2021-04-19,ABR,6233,2862,3371,3787,2373,73,ITF,ITF1,13,Abruzzo,Abruzzo,1304970,595458,45.63,0.48
3266,2021-02-21,ABR,1218,550,668,1193,1,24,ITF,ITF1,13,Abruzzo,Abruzzo,1304970,596676,45.72,0.09
3267,2021-07-28,ABR,13262,6946,6316,3445,9653,164,ITF,ITF1,13,Abruzzo,Abruzzo,1304970,609938,46.74,1.02
3268,2021-06-15,ABR,11330,5562,5768,8684,2437,209,ITF,ITF1,13,Abruzzo,Abruzzo,1304970,621268,47.61,0.87
3269,2021-04-12,ABR,6239,2958,3281,4986,1174,79,ITF,ITF1,13,Abruzzo,Abruzzo,1304970,627507,48.09,0.48
3270,2021-07-30,ABR,12000,6392,5608,3784,7995,221,ITF,ITF1,13,Abruzzo,Abruzzo,1304970,639507,49.01,0.92
3271,2021-02-26,ABR,3926,1680,2246,2931,969,26,ITF,ITF1,13,Abruzzo,Abruzzo,1304970,643433,49.31,0.3
3272,2021-01-18,ABR,139,59,80,46,93,0,ITF,ITF1,13,Abruzzo,Abruzzo,1304970,643572,49.32,0.01
3273,2021-06-24,ABR,10866,5412,5454,5725,4971,170,ITF,ITF1,13,Abruzzo,Abruzzo,1304970,654438,50.15,0.83
3274,2021-04-28,ABR,9511,4587,4924,7316,2022,173,ITF,ITF1,13,Abruzzo,Abruzzo,1304970,663949,50.88,0.73
3275,2021-05-12,ABR,9628,4600,5028,5873,3581,174,ITF,ITF1,13,Abruzzo,Abruzzo,1304970,673577,51.62,0.74
3276,2021-03-16,ABR,3484,1452,2032,1802,1654,28,ITF,ITF1,13,Abruzzo,Abruzzo,1304970,677061,51.88,0.27
3277,2021-05-05,ABR,11633,5571,6062,6269,5205,159,ITF,ITF1,13,Abruzzo,Abruzzo,1304970,688694,52.77,0.89
3278,2021-03-09,ABR,5179,1806,3373,4155,938,86,ITF,ITF1,13,Abruzzo,Abruzzo,1304970,693873,53.17,0.4
3279,2021-03-17,ABR,4540,1873,2667,2777,1740,23,ITF,ITF1,13,Abruzzo,Abruzzo,1304970,698413,53.52,0.35
3280,2021-03-24,ABR,6387,2786,3601,3998,2251,138,ITF,ITF1,13,Abruzzo,Abruzzo,1304970,704800,54.01,0.49
3281,2021-02-09,ABR,909,312,597,499,409,1,ITF,ITF1,13,Abruzzo,Abruzzo,1304970,705709,54.08,0.07
3282,2021-07-04,ABR,8375,4214,4161,3334,4916,125,ITF,ITF1,13,Abruzzo,Abruzzo,1304970,714084,54.72,0.64
3283,2021-02-11,ABR,816,262,554,771,43,2,ITF,ITF1,13,Abruzzo,Abruzzo,1304970,714900,54.78,0.06
3284,2021-03-19,ABR,5796,2584,3212,2732,3023,41,ITF,ITF1,13,Abruzzo,Abruzzo,1304970,720696,55.23,0.44
3285,2021-03-05,ABR,5348,1958,3390,4591,697,60,ITF,ITF1,13,Abruzzo,Abruzzo,1304970,726044,55.64,0.41
3286,2021-06-27,ABR,8375,4306,4069,5020,3214,141,ITF,ITF1,13,Abruzzo,Abruzzo,1304970,734419,56.28,0.64
3287,2021-04-07,ABR,7223,3334,3889,4314,2784,125,ITF,ITF1,13,Abruzzo,Abruzzo,1304970,741642,56.83,0.55
3288,2021-07-16,ABR,16145,8236,7909,2469,13560,116,ITF,ITF1,13,Abruzzo,Abruzzo,1304970,757787,58.07,1.24
3289,2021-05-08,ABR,10290,4870,5420,6338,3832,120,ITF,ITF1,13,Abruzzo,Abruzzo,1304970,768077,58.86,0.79
3290,2021-02-08,ABR,1195,394,801,486,709,0,ITF,ITF1,13,Abruzzo,Abruzzo,1304970,769272,58.95,0.09
3291,2021-05-19,ABR,10730,5125,5605,7570,3037,123,ITF,ITF1,13,Abruzzo,Abruzzo,1304970,780002,59.77,0.82
3292,2021-04-30,ABR,12505,5868,6637,6517,5723,265,ITF,ITF1,13,Abruzzo,Abruzzo,1304970,792507,60.73,0.96
3293,2021-04-13,ABR,5894,2754,3140,4562,1237,95,ITF,ITF1,13,Abruzzo,Abruzzo,1304970,798401,61.18,0.45
3294,2021-01-20,ABR,447,156,291,425,2,20,ITF,ITF1,13,Abruzzo,Abruzzo,1304970,798848,61.22,0.03
3295,2021-05-24,ABR,12222,5837,6385,8724,3339,159,ITF,ITF1,13,Abruzzo,Abruzzo,1304970,811070,62.15,0.94
3296,2021-02-18,ABR,2288,933,1355,2141,130,17,ITF,ITF1,13,Abruzzo,Abruzzo,1304970,813358,62.33,0.18
3297,2021-05-29,ABR,10319,4431,5888,4458,5772,89,ITF,ITF1,13,Abruzzo,Abruzzo,1304970,823677,63.12,0.79
3298,2021-05-22,ABR,13159,6392,6767,8132,4914,113,ITF,ITF1,13,Abruzzo,Abruzzo,1304970,836836,64.13,1.01
3299,2021-03-26,ABR,5354,2312,3042,3178,2074,102,ITF,ITF1,13,Abruzzo,Abruzzo,1304970,842190,64.54,0.41
3300,2021-07-27,ABR,15079,7868,7211,3349,11556,174,ITF,ITF1,13,Abruzzo,Abruzzo,1304970,857269,65.69,1.16
3301,2021-05-31,ABR,11340,5115,6225,6767,4445,128,ITF,ITF1,13,Abruzzo,Abruzzo,1304970,868609,66.56,0.87
3302,2021-04-20,ABR,5637,2715,2922,4109,1455,73,ITF,ITF1,13,Abruzzo,Abruzzo,1304970,874246,66.99,0.43
3303,2021-07-29,ABR,13983,7335,6648,3545,10250,188,ITF,ITF1,13,Abruzzo,Abruzzo,1304970,888229,68.07,1.07
3304,2021-04-24,ABR,8729,3975,4754,6944,1531,254,ITF,ITF1,13,Abruzzo,Abruzzo,1304970,896958,68.73,0.67
3305,2021-01-14,ABR,530,189,341,528,0,2,ITF,ITF1,13,Abruzzo,Abruzzo,1304970,897488,68.77,0.04
3306,2021-02-16,ABR,1916,841,1075,1891,12,13,ITF,ITF1,13,Abruzzo,Abruzzo,1304970,899404,68.92,0.15
3307,2021-03-02,ABR,3967,1676,2291,3261,686,20,ITF,ITF1,13,Abruzzo,Abruzzo,1304970,903371,69.23,0.3
3308,2021-06-10,ABR,12705,6318,6387,10307,2161,237,ITF,ITF1,13,Abruzzo,Abruzzo,1304970,916076,70.2,0.97
3309,2021-01-16,ABR,937,430,507,929,0,8,ITF,ITF1,13,Abruzzo,Abruzzo,1304970,917013,70.27,0.07
3310,2021-01-31,ABR,1522,494,1028,288,1233,1,ITF,ITF1,13,Abruzzo,Abruzzo,1304970,918535,70.39,0.12
3311,2021-05-10,ABR,10107,4782,5325,5372,4648,87,ITF,ITF1,13,Abruzzo,Abruzzo,1304970,928642,71.16,0.77
3312,2021-04-23,ABR,7393,3395,3998,4925,2305,163,ITF,ITF1,13,Abruzzo,Abruzzo,1304970,936035,71.73,0.57
3313,2021-01-30,ABR,1511,568,943,68,1442,1,ITF,ITF1,13,Abruzzo,Abruzzo,1304970,937546,71.84,0.12
3314,2021-06-19,ABR,10557,5201,5356,6486,3899,172,ITF,ITF1,13,Abruzzo,Abruzzo,1304970,948103,72.65,0.81
3315,2021-03-28,ABR,2422,1018,1404,1994,378,50,ITF,ITF1,13,Abruzzo,Abruzzo,1304970,950525,72.84,0.19
3316,2021-07-06,ABR,9925,4948,4977,4097,5663,165,ITF,ITF1,13,Abruzzo,Abruzzo,1304970,960450,73.6,0.76
3317,2021-04-14,ABR,6596,2951,3645,4342,2122,132,ITF,ITF1,13,Abruzzo,Abruzzo,1304970,967046,74.1,0.51
3318,2021-01-04,ABR,1403,576,827,1397,0,6,ITF,ITF1,13,Abruzzo,Abruzzo,1304970,968449,74.21,0.11
3319,2021-01-23,ABR,264,115,149,51,207,6,ITF,ITF1,13,Abruzzo,Abruzzo,1304970,968713,74.23,0.02
3320,2021-05-03,ABR,11145,5256,5889,7134,3832,179,ITF,ITF1,13,Abruzzo,Abruzzo,1304970,979858,75.09,0.85
3321,2021-07-25,ABR,9864,5219,4645,2177,7564,123,ITF,ITF1,13,Abruzzo,Abruzzo,1304970,989722,75.84,0.76
3322,2021-07-08,ABR,13497,6682,6815,3419,9914,164,ITF,ITF1,13,Abruzzo,Abruzzo,1304970,1003219,76.88,1.03
3323,2021-04-16,ABR,7537,3487,4050,5497,1916,124,ITF,ITF1,13,Abruzzo,Abruzzo,1304970,1010756,77.45,0.58
3324,2021-04-25,ABR,9069,4624,4445,8061,809,199,ITF,ITF1,13,Abruzzo,Abruzzo,1304970,1019825,78.15,0.69
3325,2021-07-01,ABR,12771,6291,6480,5775,6772,224,ITF,ITF1,13,Abruzzo,Abruzzo,1304970,1032596,79.13,0.98
3326,2021-06-17,ABR,10919,5461,5458,7306,3453,160,ITF,ITF1,13,Abruzzo,Abruzzo,1304970,1043515,79.96,0.84
3327,2021-01-28,ABR,1433,495,938,12,1421,0,ITF,ITF1,13,Abruzzo,Abruzzo,1304970,1044948,80.07,0.11
3328,2021-01-11,ABR,1553,557,996,1549,0,4,ITF,ITF1,13,Abruzzo,Abruzzo,1304970,1046501,80.19,0.12
3329,2021-04-21,ABR,6389,3102,3287,4640,1672,77,ITF,ITF1,13,Abruzzo,Abruzzo,1304970,1052890,80.68,0.49
3330,2021-02-01,ABR,1631,573,1058,269,1361,1,ITF,ITF1,13,Abruzzo,Abruzzo,1304970,1054521,80.81,0.12
3331,2021-03-23,ABR,4834,2190,2644,2213,2567,54,ITF,ITF1,13,Abruzzo,Abruzzo,1304970,1059355,81.18,0.37
3332,2021-01-25,ABR,1605,633,972,15,1588,2,ITF,ITF1,13,Abruzzo,Abruzzo,1304970,1060960,81.3,0.12
3333,2021-07-05,ABR,10911,5348,5563,4052,6671,188,ITF,ITF1,13,Abruzzo,Abruzzo,1304970,1071871,82.14,0.84
3334,2021-07-22,ABR,14481,7410,7071,3512,10761,208,ITF,ITF1,13,Abruzzo,Abruzzo,1304970,1086352,83.25,1.11
3335,2021-07-24,ABR,12544,6761,5783,3725,8586,233,ITF,ITF1,13,Abruzzo,Abruzzo,1304970,1098896,84.21,0.96
3336,2021-05-02,ABR,10460,5112,5348,5090,5228,142,ITF,ITF1,13,Abruzzo,Abruzzo,1304970,1109356,85.01,0.8
3337,2021-03-11,ABR,5490,2215,3275,4268,1138,84,ITF,ITF1,13,Abruzzo,Abruzzo,1304970,1114846,85.43,0.42
3338,2021-06-02,ABR,9764,4744,5020,6837,2810,117,ITF,ITF1,13,Abruzzo,Abruzzo,1304970,1124610,86.18,0.75
3339,2021-03-13,ABR,4124,1420,2704,3013,1043,68,ITF,ITF1,13,Abruzzo,Abruzzo,1304970,1128734,86.5,0.32
3340,2021-06-21,ABR,11056,5389,5667,4939,5988,129,ITF,ITF1,13,Abruzzo,Abruzzo,1304970,1139790,87.34,0.85
3341,2021-03-30,ABR,5128,2261,2867,3148,1822,158,ITF,ITF1,13,Abruzzo,Abruzzo,1304970,1144918,87.74,0.39
3342,2021-01-06,ABR,1833,664,1169,1823,0,10,ITF,ITF1,13,Abruzzo,Abruzzo,1304970,1146751,87.88,0.14
3343,2021-06-29,ABR,11431,5641,5790,5250,5994,187,ITF,ITF1,13,Abruzzo,Abruzzo,1304970,1158182,88.75,0.88
3344,2021-03-21,ABR,2133,913,1220,839,1290,4,ITF,ITF1,13,Abruzzo,Abruzzo,1304970,1160315,88.92,0.16
3345,2021-06-12,ABR,11422,5916,5506,9890,1353,179,ITF,ITF1,13,Abruzzo,Abruzzo,1304970,1171737,89.79,0.88
3346,2021-01-08,ABR,1527,507,1020,1518,0,9,ITF,ITF1,13,Abruzzo,Abruzzo,1304970,1173264,89.91,0.12
3347,2021-04-18,ABR,5813,2727,3086,4725,943,145,ITF,ITF1,13,Abruzzo,Abruzzo,1304970,1179077,90.35,0.45
3348,2021-02-20,ABR,4776,1843,2933,4658,76,42,ITF,ITF1,13,Abruzzo,Abruzzo,1304970,1183853,90.72,0.37
3349,2021-03-07,ABR,2521,630,1891,2481,0,40,ITF,ITF1,13,Abruzzo,Abruzzo,1304970,1186374,90.91,0.19
3350,2021-01-09,ABR,1484,566,918,1472,0,12,ITF,ITF1,13,Abruzzo,Abruzzo,1304970,1187858,91.03,0.11
3351,2021-05-07,ABR,12204,5714,6490,7669,4413,122,ITF,ITF1,13,Abruzzo,Abruzzo,1304970,1200062,91.96,0.94
3352,2021-03-25,ABR,5794,2662,3132,3066,2618,110,ITF,ITF1,13,Abruzzo,Abruzzo,1304970,1205856,92.4,0.44
3353,2021-01-27,ABR,1366,516,850,38,1328,0,ITF,ITF1,13,Abruzzo,Abruzzo,1304970,1207222,92.51,0.1
3354,2021-07-03,ABR,10208,5152,5056,3501,6559,148,ITF,ITF1,13,Abruzzo,Abruzzo,1304970,1217430,93.29,0.78
3355,2021-05-21,ABR,13017,6328,6689,7862,4981,174,ITF,ITF1,13,Abruzzo,Abruzzo,1304970,1230447,94.29,1.0
3356,2021-03-18,ABR,3896,1651,2245,2039,1831,26,ITF,ITF1,13,Abruzzo,Abruzzo,1304970,1234343,94.59,0.3
3357,2021-06-26,ABR,10048,5020,5028,5689,4198,161,ITF,ITF1,13,Abruzzo,Abruzzo,1304970,1244391,95.36,0.77
3358,2021-07-10,ABR,13132,6637,6495,3016,9952,164,ITF,ITF1,13,Abruzzo,Abruzzo,1304970,1257523,96.36,1.01
3359,2021-05-14,ABR,10594,5070,5524,5284,5149,161,ITF,ITF1,13,Abruzzo,Abruzzo,1304970,1268117,97.18,0.81
3360,2021-04-01,ABR,5593,2506,3087,3432,2087,74,ITF,ITF1,13,Abruzzo,Abruzzo,1304970,1273710,97.6,0.43
3361,2021-07-15,ABR,15943,8087,7856,3133,12635,175,ITF,ITF1,13,Abruzzo,Abruzzo,1304970,1289653,98.83,1.22
3362,2021-06-28,ABR,10053,4837,5216,5310,4574,169,ITF,ITF1,13,Abruzzo,Abruzzo,1304970,1299706,99.6,0.77
3363,2021-04-06,ABR,7675,3577,4098,5231,2318,126,ITF,ITF1,13,Abruzzo,Abruzzo,1304970,1307381,100.18,0.59
3364,2021-01-13,ABR,1260,441,819,1252,0,8,ITF,ITF1,13,Abruzzo,Abruzzo,1304970,1308641,100.28,0.1
3365,2021-02-13,ABR,860,389,471,435,421,4,ITF,ITF1,13,Abruzzo,Abruzzo,1304970,1309501,100.35,0.07
3366,2021-07-17,ABR,14096,7386,6710,2661,11259,176,ITF,ITF1,13,Abruzzo,Abruzzo,1304970,1323597,101.43,1.08
3367,2021-05-09,ABR,9157,4090,5067,4176,4870,111,ITF,ITF1,13,Abruzzo,Abruzzo,1304970,1332754,102.13,0.7
3368,2021-02-15,ABR,1795,832,963,1736,42,17,ITF,ITF1,13,Abruzzo,Abruzzo,1304970,1334549,102.27,0.14
3369,2021-05-26,ABR,13545,6042,7503,8392,4992,161,ITF,ITF1,13,Abruzzo,Abruzzo,1304970,1348094,103.3,1.04
3370,2021-06-14,ABR,10978,5433,5545,7428,3377,173,ITF,ITF1,13,Abruzzo,Abruzzo,1304970,1359072,104.15,0.84
3371,2021-03-04,ABR,5936,2360,3576,4974,922,40,ITF,ITF1,13,Abruzzo,Abruzzo,1304970,1365008,104.6,0.45
3372,2021-05-28,ABR,14020,6310,7710,7491,6360,169,ITF,ITF1,13,Abruzzo,Abruzzo,1304970,1379028,105.68,1.07
3373,2021-07-11,ABR,9882,4971,4911,2366,7386,130,ITF,ITF1,13,Abruzzo,Abruzzo,1304970,1388910,106.43,0.76
3374,2021-03-10,ABR,5049,1683,3366,4027,957,65,ITF,ITF1,13,Abruzzo,Abruzzo,1304970,1393959,106.82,0.39
3375,2021-01-26,ABR,1543,568,975,29,1514,0,ITF,ITF1,13,Abruzzo,Abruzzo,1304970,1395502,106.94,0.12
3376,2021-05-06,ABR,12986,6079,6907,7791,5041,154,ITF,ITF1,13,Abruzzo,Abruzzo,1304970,1408488,107.93,1.0
3377,2021-04-09,ABR,8989,4258,4731,6247,2602,140,ITF,ITF1,13,Abruzzo,Abruzzo,1304970,1417477,108.62,0.69
3378,2021-07-18,ABR,12203,6309,5894,2003,10081,119,ITF,ITF1,13,Abruzzo,Abruzzo,1304970,1429680,109.56,0.94
3379,2021-04-02,ABR,6694,3104,3590,5117,1487,90,ITF,ITF1,13,Abruzzo,Abruzzo,1304970,1436374,110.07,0.51
3380,2021-02-04,ABR,1683,617,1066,599,1072,12,ITF,ITF1,13,Abruzzo,Abruzzo,1304970,1438057,110.2,0.13
3381,2021-07-20,ABR,12588,6388,6200,3227,9175,186,ITF,ITF1,13,Abruzzo,Abruzzo,1304970,1450645,111.16,0.96
3382,2021-04-04,ABR,1632,768,864,1460,129,43,ITF,ITF1,13,Abruzzo,Abruzzo,1304970,1452277,111.29,0.13
3383,2021-07-13,ABR,15523,7750,7773,2825,12520,178,ITF,ITF1,13,Abruzzo,Abruzzo,1304970,1467800,112.48,1.19
3384,2021-06-16,ABR,10887,5449,5438,7992,2680,215,ITF,ITF1,13,Abruzzo,Abruzzo,1304970,1478687,113.31,0.83
3385,2021-02-27,ABR,2813,1339,1474,2513,267,33,ITF,ITF1,13,Abruzzo,Abruzzo,1304970,1481500,113.53,0.22
3386,2021-06-07,ABR,11098,5289,5809,9071,1842,185,ITF,ITF1,13,Abruzzo,Abruzzo,1304970,1492598,114.38,0.85
3387,2021-04-11,ABR,5380,2628,2752,4842,487,51,ITF,ITF1,13,Abruzzo,Abruzzo,1304970,1497978,114.79,0.41
3388,2021-06-09,ABR,11572,6094,5478,9706,1685,181,ITF,ITF1,13,Abruzzo,Abruzzo,1304970,1509550,115.68,0.89
3389,2021-03-06,ABR,4179,1359,2820,3569,570,40,ITF,ITF1,13,Abruzzo,Abruzzo,1304970,1513729,116.0,0.32
3390,2021-05-24,CAM,31358,15151,16207,15863,15150,345,ITF,ITF3,15,Campania,Campania,5801692,31358,0.54,0.54
3391,2021-02-13,CAM,5508,2550,2958,5109,217,182,ITF,ITF3,15,Campania,Campania,5801692,36866,0.64,0.09
3392,2021-04-23,CAM,32329,15524,16805,22479,9155,695,ITF,ITF3,15,Campania,Campania,5801692,69195,1.19,0.56
3393,2021-01-30,CAM,10725,5082,5643,36,10687,2,ITF,ITF3,15,Campania,Campania,5801692,79920,1.38,0.18
3394,2021-07-03,CAM,67286,32498,34788,8198,58709,379,ITF,ITF3,15,Campania,Campania,5801692,147206,2.54,1.16
3395,2021-01-16,CAM,3372,1677,1695,3262,0,110,ITF,ITF3,15,Campania,Campania,5801692,150578,2.6,0.06
3396,2021-03-28,CAM,15566,7511,8055,13610,1625,331,ITF,ITF3,15,Campania,Campania,5801692,166144,2.86,0.27
3397,2021-01-04,CAM,5826,2963,2863,5727,0,99,ITF,ITF3,15,Campania,Campania,5801692,171970,2.96,0.1
3398,2021-06-19,CAM,62398,29706,32692,24254,37761,383,ITF,ITF3,15,Campania,Campania,5801692,234368,4.04,1.08
3399,2021-03-09,CAM,14128,6870,7258,9955,3785,388,ITF,ITF3,15,Campania,Campania,5801692,248496,4.28,0.24
3400,2021-06-24,CAM,66064,31826,34238,13472,52259,333,ITF,ITF3,15,Campania,Campania,5801692,314560,5.42,1.14
3401,2021-03-16,CAM,8087,3519,4568,3700,4315,72,ITF,ITF3,15,Campania,Campania,5801692,322647,5.56,0.14
3402,2021-01-25,CAM,5746,2927,2819,163,5583,0,ITF,ITF3,15,Campania,Campania,5801692,328393,5.66,0.1
3403,2021-07-01,CAM,61502,29843,31659,19843,41007,652,ITF,ITF3,15,Campania,Campania,5801692,389895,6.72,1.06
3404,2021-03-23,CAM,15741,7445,8296,12913,2513,315,ITF,ITF3,15,Campania,Campania,5801692,405636,6.99,0.27
3405,2021-05-19,CAM,51161,22605,28556,33823,16616,722,ITF,ITF3,15,Campania,Campania,5801692,456797,7.87,0.88
3406,2021-02-11,CAM,6280,2705,3575,5925,66,289,ITF,ITF3,15,Campania,Campania,5801692,463077,7.98,0.11
3407,2021-07-27,CAM,49068,24381,24687,12763,35693,612,ITF,ITF3,15,Campania,Campania,5801692,512145,8.83,0.85
3408,2021-04-11,CAM,17525,8607,8918,15063,2084,378,ITF,ITF3,15,Campania,Campania,5801692,529670,9.13,0.3
3409,2021-04-28,CAM,36435,17640,18795,25916,9757,762,ITF,ITF3,15,Campania,Campania,5801692,566105,9.76,0.63
3410,2021-01-18,CAM,959,399,560,683,244,32,ITF,ITF3,15,Campania,Campania,5801692,567064,9.77,0.02
3411,2021-07-20,CAM,40107,19793,20314,6370,33318,419,ITF,ITF3,15,Campania,Campania,5801692,607171,10.47,0.69
3412,2021-03-02,CAM,12761,4558,8203,8213,4345,203,ITF,ITF3,15,Campania,Campania,5801692,619932,10.69,0.22
3413,2021-07-15,CAM,66689,32038,34651,9377,57044,268,ITF,ITF3,15,Campania,Campania,5801692,686621,11.83,1.15
3414,2021-01-11,CAM,4070,1871,2199,3961,0,109,ITF,ITF3,15,Campania,Campania,5801692,690691,11.9,0.07
3415,2021-06-07,CAM,57586,27721,29865,52868,4036,682,ITF,ITF3,15,Campania,Campania,5801692,748277,12.9,0.99
3416,2021-02-25,CAM,12426,4479,7947,10965,1188,273,ITF,ITF3,15,Campania,Campania,5801692,760703,13.11,0.21
3417,2021-04-09,CAM,30015,14132,15883,23281,6134,600,ITF,ITF3,15,Campania,Campania,5801692,790718,13.63,0.52
3418,2021-06-05,CAM,77632,37584,40048,70894,6024,714,ITF,ITF3,15,Campania,Campania,5801692,868350,14.97,1.34
3419,2021-06-14,CAM,37120,17919,19201,18792,18014,314,ITF,ITF3,15,Campania,Campania,5801692,905470,15.61,0.64
3420,2021-05-05,CAM,51175,24859,26316,43277,6388,1510,ITF,ITF3,15,Campania,Campania,5801692,956645,16.49,0.88
3421,2021-05-12,CAM,40904,19955,20949,30596,9165,1143,ITF,ITF3,15,Campania,Campania,5801692,997549,17.19,0.71
3422,2021-07-08,CAM,61103,29409,31694,5663,55134,306,ITF,ITF3,15,Campania,Campania,5801692,1058652,18.25,1.05
3423,2021-06-26,CAM,62941,30691,32250,14667,47854,420,ITF,ITF3,15,Campania,Campania,5801692,1121593,19.33,1.08
3424,2021-07-13,CAM,53682,25791,27891,4930,48498,254,ITF,ITF3,15,Campania,Campania,5801692,1175275,20.26,0.93
3425,2021-04-04,CAM,7966,4017,3949,6700,1047,219,ITF,ITF3,15,Campania,Campania,5801692,1183241,20.39,0.14
3426,2021-06-12,CAM,64002,31550,32452,55940,7218,844,ITF,ITF3,15,Campania,Campania,5801692,1247243,21.5,1.1
3427,2021-03-04,CAM,14708,5396,9312,8552,5895,261,ITF,ITF3,15,Campania,Campania,5801692,1261951,21.75,0.25
3428,2021-01-23,CAM,3842,2031,1811,267,3569,6,ITF,ITF3,15,Campania,Campania,5801692,1265793,21.82,0.07
3429,2021-03-21,CAM,10073,4675,5398,7507,2391,175,ITF,ITF3,15,Campania,Campania,5801692,1275866,21.99,0.17
3430,2021-02-10,CAM,6905,3413,3492,6483,177,245,ITF,ITF3,15,Campania,Campania,5801692,1282771,22.11,0.12
3431,2021-07-17,CAM,55254,27556,27698,3526,51538,190,ITF,ITF3,15,Campania,Campania,5801692,1338025,23.06,0.95
3432,2021-04-08,CAM,28402,13755,14647,21997,5848,557,ITF,ITF3,15,Campania,Campania,5801692,1366427,23.55,0.49
3433,2021-06-04,CAM,74505,35812,38693,64787,9069,649,ITF,ITF3,15,Campania,Campania,5801692,1440932,24.84,1.28
3434,2021-05-21,CAM,63715,29607,34108,42176,20534,1005,ITF,ITF3,15,Campania,Campania,5801692,1504647,25.93,1.1
3435,2021-05-31,CAM,40730,20665,20065,29850,10314,566,ITF,ITF3,15,Campania,Campania,5801692,1545377,26.64,0.7
3436,2021-04-16,CAM,34352,16579,17773,23045,10665,642,ITF,ITF3,15,Campania,Campania,5801692,1579729,27.23,0.59
3437,2021-01-06,CAM,7649,3749,3900,7505,0,144,ITF,ITF3,15,Campania,Campania,5801692,1587378,27.36,0.13
3438,2021-02-18,CAM,9080,3813,5267,8151,707,222,ITF,ITF3,15,Campania,Campania,5801692,1596458,27.52,0.16
3439,2021-04-25,CAM,30743,15177,15566,24595,5405,743,ITF,ITF3,15,Campania,Campania,5801692,1627201,28.05,0.53
3440,2021-05-17,CAM,49375,21706,27669,23655,25268,452,ITF,ITF3,15,Campania,Campania,5801692,1676576,28.9,0.85
3441,2021-02-06,CAM,5341,2666,2675,2006,3239,96,ITF,ITF3,15,Campania,Campania,5801692,1681917,28.99,0.09
3442,2021-07-22,CAM,61753,30488,31265,6549,54708,496,ITF,ITF3,15,Campania,Campania,5801692,1743670,30.05,1.06
3443,2021-04-30,CAM,42333,20198,22135,25036,16502,795,ITF,ITF3,15,Campania,Campania,5801692,1786003,30.78,0.73
3444,2021-02-04,CAM,7943,3429,4514,1249,6635,59,ITF,ITF3,15,Campania,Campania,5801692,1793946,30.92,0.14
3445,2021-01-01,CAM,918,505,413,899,0,19,ITF,ITF3,15,Campania,Campania,5801692,1794864,30.94,0.02
3446,2021-03-25,CAM,20322,9654,10668,16389,3505,428,ITF,ITF3,15,Campania,Campania,5801692,1815186,31.29,0.35
3447,2021-02-27,CAM,13947,4472,9475,12004,1642,301,ITF,ITF3,15,Campania,Campania,5801692,1829133,31.53,0.24
3448,2021-06-16,CAM,31630,14999,16631,20566,10764,300,ITF,ITF3,15,Campania,Campania,5801692,1860763,32.07,0.55
3449,2021-05-26,CAM,52684,25843,26841,21113,31107,464,ITF,ITF3,15,Campania,Campania,5801692,1913447,32.98,0.91
3450,2021-04-06,CAM,24512,11562,12950,19505,4523,484,ITF,ITF3,15,Campania,Campania,5801692,1937959,33.4,0.42
3451,2021-02-08,CAM,5113,2449,2664,4164,803,146,ITF,ITF3,15,Campania,Campania,5801692,1943072,33.49,0.09
3452,2021-05-07,CAM,59777,29210,30567,42753,15953,1071,ITF,ITF3,15,Campania,Campania,5801692,2002849,34.52,1.03
3453,2021-01-27,CAM,7738,3820,3918,157,7576,5,ITF,ITF3,15,Campania,Campania,5801692,2010587,34.66,0.13
3454,2021-03-18,CAM,12178,5382,6796,5796,6190,192,ITF,ITF3,15,Campania,Campania,5801692,2022765,34.87,0.21
3455,2021-06-02,CAM,42874,20161,22713,37761,4679,434,ITF,ITF3,15,Campania,Campania,5801692,2065639,35.6,0.74
3456,2021-02-22,CAM,10683,3295,7388,10191,264,228,ITF,ITF3,15,Campania,Campania,5801692,2076322,35.79,0.18
3457,2021-03-11,CAM,18001,9058,8943,10325,7280,396,ITF,ITF3,15,Campania,Campania,5801692,2094323,36.1,0.31
3458,2021-05-16,CAM,51150,23228,27922,32869,17575,706,ITF,ITF3,15,Campania,Campania,5801692,2145473,36.98,0.88
3459,2021-02-20,CAM,8573,3080,5493,8108,303,162,ITF,ITF3,15,Campania,Campania,5801692,2154046,37.13,0.15
3460,2021-02-03,CAM,8903,4003,4900,842,8025,36,ITF,ITF3,15,Campania,Campania,5801692,2162949,37.28,0.15
3461,2021-05-18,CAM,52184,23229,28955,31870,19661,653,ITF,ITF3,15,Campania,Campania,5801692,2215133,38.18,0.9
3462,2021-02-05,CAM,7261,3463,3798,2019,5128,114,ITF,ITF3,15,Campania,Campania,5801692,2222394,38.31,0.13
3463,2021-04-29,CAM,41390,20077,21313,24092,16541,757,ITF,ITF3,15,Campania,Campania,5801692,2263784,39.02,0.71
3464,2021-01-19,CAM,1095,474,621,1042,3,50,ITF,ITF3,15,Campania,Campania,5801692,2264879,39.04,0.02
3465,2021-07-21,CAM,50179,24444,25735,8681,40862,636,ITF,ITF3,15,Campania,Campania,5801692,2315058,39.9,0.86
3466,2021-01-21,CAM,2093,1116,977,670,1417,6,ITF,ITF3,15,Campania,Campania,5801692,2317151,39.94,0.04
3467,2021-07-24,CAM,47973,24862,23111,6767,40875,331,ITF,ITF3,15,Campania,Campania,5801692,2365124,40.77,0.83
3468,2021-01-20,CAM,1257,650,607,1226,0,31,ITF,ITF3,15,Campania,Campania,5801692,2366381,40.79,0.02
3469,2021-04-13,CAM,26608,12685,13923,20576,5534,498,ITF,ITF3,15,Campania,Campania,5801692,2392989,41.25,0.46
3470,2021-01-03,CAM,3836,2009,1827,3787,0,49,ITF,ITF3,15,Campania,Campania,5801692,2396825,41.31,0.07
3471,2021-04-01,CAM,24681,12011,12670,20082,4133,466,ITF,ITF3,15,Campania,Campania,5801692,2421506,41.74,0.43
3472,2021-05-28,CAM,73058,35315,37743,26283,46161,614,ITF,ITF3,15,Campania,Campania,5801692,2494564,43.0,1.26
3473,2021-05-14,CAM,61038,27582,33456,34837,24719,1482,ITF,ITF3,15,Campania,Campania,5801692,2555602,44.05,1.05
3474,2021-07-10,CAM,66888,32662,34226,2748,63941,199,ITF,ITF3,15,Campania,Campania,5801692,2622490,45.2,1.15
3475,2021-02-01,CAM,3984,1813,2171,102,3874,8,ITF,ITF3,15,Campania,Campania,5801692,2626474,45.27,0.07
3476,2021-03-30,CAM,22052,10577,11475,18595,2957,500,ITF,ITF3,15,Campania,Campania,5801692,2648526,45.65,0.38
3477,2021-04-17,CAM,36196,17514,18682,23993,11514,689,ITF,ITF3,15,Campania,Campania,5801692,2684722,46.27,0.62
3478,2021-06-13,CAM,43431,21244,22187,38090,4730,611,ITF,ITF3,15,Campania,Campania,5801692,2728153,47.02,0.75
3479,2021-05-30,CAM,52156,25444,26712,37962,13315,879,ITF,ITF3,15,Campania,Campania,5801692,2780309,47.92,0.9
3480,2021-02-19,CAM,9573,3561,6012,8713,650,210,ITF,ITF3,15,Campania,Campania,5801692,2789882,48.09,0.17
3481,2021-07-26,CAM,48845,24324,24521,10446,37913,486,ITF,ITF3,15,Campania,Campania,5801692,2838727,48.93,0.84
3482,2020-12-31,CAM,1490,811,679,1471,0,19,ITF,ITF3,15,Campania,Campania,5801692,2840217,48.95,0.03
3483,2021-06-06,CAM,63230,31447,31783,61922,648,660,ITF,ITF3,15,Campania,Campania,5801692,2903447,50.04,1.09
3484,2021-02-26,CAM,13335,4227,9108,11727,1336,272,ITF,ITF3,15,Campania,Campania,5801692,2916782,50.27,0.23
3485,2021-04-24,CAM,36364,17528,18836,24359,11248,757,ITF,ITF3,15,Campania,Campania,5801692,2953146,50.9,0.63
3486,2021-05-02,CAM,43493,21540,21953,31279,11360,854,ITF,ITF3,15,Campania,Campania,5801692,2996639,51.65,0.75
3487,2021-01-22,CAM,1525,776,749,659,852,14,ITF,ITF3,15,Campania,Campania,5801692,2998164,51.68,0.03
3488,2021-03-06,CAM,16373,6816,9557,10406,5669,298,ITF,ITF3,15,Campania,Campania,5801692,3014537,51.96,0.28
3489,2021-03-08,CAM,14688,6846,7842,9503,4777,408,ITF,ITF3,15,Campania,Campania,5801692,3029225,52.21,0.25
3490,2021-05-04,CAM,48487,23351,25136,38341,8904,1242,ITF,ITF3,15,Campania,Campania,5801692,3077712,53.05,0.84
3491,2021-01-24,CAM,4122,2119,2003,360,3745,17,ITF,ITF3,15,Campania,Campania,5801692,3081834,53.12,0.07
3492,2021-05-13,CAM,55449,24829,30620,37864,16015,1570,ITF,ITF3,15,Campania,Campania,5801692,3137283,54.08,0.96
3493,2021-07-09,CAM,61456,29753,31703,4365,56797,294,ITF,ITF3,15,Campania,Campania,5801692,3198739,55.13,1.06
3494,2021-07-12,CAM,56682,27364,29318,3765,52598,319,ITF,ITF3,15,Campania,Campania,5801692,3255421,56.11,0.98
3495,2020-12-27,CAM,720,422,298,716,0,4,ITF,ITF3,15,Campania,Campania,5801692,3256141,56.12,0.01
3496,2021-07-29,CAM,48396,24302,24094,13784,33901,711,ITF,ITF3,15,Campania,Campania,5801692,3304537,56.96,0.83
3497,2021-04-20,CAM,32041,15500,16541,20162,11312,567,ITF,ITF3,15,Campania,Campania,5801692,3336578,57.51,0.55
3498,2021-06-28,CAM,46519,22740,23779,20587,25406,526,ITF,ITF3,15,Campania,Campania,5801692,3383097,58.31,0.8
3499,2021-03-20,CAM,13989,6529,7460,10007,3739,243,ITF,ITF3,15,Campania,Campania,5801692,3397086,58.55,0.24
3500,2021-02-15,CAM,5472,2516,2956,5159,175,138,ITF,ITF3,15,Campania,Campania,5801692,3402558,58.65,0.09
3501,2021-07-23,CAM,61778,30781,30997,8471,52846,461,ITF,ITF3,15,Campania,Campania,5801692,3464336,59.71,1.06
3502,2021-04-14,CAM,27650,13338,14312,18668,8570,412,ITF,ITF3,15,Campania,Campania,5801692,3491986,60.19,0.48
3503,2021-05-01,CAM,46349,22663,23686,29330,16107,912,ITF,ITF3,15,Campania,Campania,5801692,3538335,60.99,0.8
3504,2021-07-06,CAM,56577,27010,29567,16189,39939,449,ITF,ITF3,15,Campania,Campania,5801692,3594912,61.96,0.98
3505,2021-04-12,CAM,23308,10921,12387,19772,3035,501,ITF,ITF3,15,Campania,Campania,5801692,3618220,62.36,0.4
3506,2021-01-02,CAM,3673,1963,1710,3615,0,58,ITF,ITF3,15,Campania,Campania,5801692,3621893,62.43,0.06
3507,2021-06-17,CAM,60180,28854,31326,32907,26768,505,ITF,ITF3,15,Campania,Campania,5801692,3682073,63.47,1.04
3508,2021-07-04,CAM,48819,23764,25055,6322,42313,184,ITF,ITF3,15,Campania,Campania,5801692,3730892,64.31,0.84
3509,2021-03-26,CAM,19865,9324,10541,15651,3815,399,ITF,ITF3,15,Campania,Campania,5801692,3750757,64.65,0.34
3510,2021-01-31,CAM,8070,3712,4358,22,8047,1,ITF,ITF3,15,Campania,Campania,5801692,3758827,64.79,0.14
3511,2021-05-11,CAM,39876,19245,20631,29558,9404,914,ITF,ITF3,15,Campania,Campania,5801692,3798703,65.48,0.69
3512,2021-06-09,CAM,53061,26054,27007,41702,10905,454,ITF,ITF3,15,Campania,Campania,5801692,3851764,66.39,0.91
3513,2021-03-01,CAM,12131,4248,7883,7782,4112,237,ITF,ITF3,15,Campania,Campania,5801692,3863895,66.6,0.21
3514,2021-05-09,CAM,43205,20287,22918,30962,11100,1143,ITF,ITF3,15,Campania,Campania,5801692,3907100,67.34,0.74
3515,2021-01-10,CAM,8165,3736,4429,7963,0,202,ITF,ITF3,15,Campania,Campania,5801692,3915265,67.48,0.14
3516,2021-04-03,CAM,21117,10316,10801,18279,2381,457,ITF,ITF3,15,Campania,Campania,5801692,3936382,67.85,0.36
3517,2021-02-24,CAM,11785,4150,7635,10848,688,249,ITF,ITF3,15,Campania,Campania,5801692,3948167,68.05,0.2
3518,2021-01-05,CAM,7237,3637,3600,7075,0,162,ITF,ITF3,15,Campania,Campania,5801692,3955404,68.18,0.12
3519,2021-02-17,CAM,7394,3215,4179,6209,1061,124,ITF,ITF3,15,Campania,Campania,5801692,3962798,68.3,0.13
3520,2021-04-15,CAM,34345,16664,17681,23812,9903,630,ITF,ITF3,15,Campania,Campania,5801692,3997143,68.9,0.59
3521,2021-07-14,CAM,51090,24569,26521,4330,46481,279,ITF,ITF3,15,Campania,Campania,5801692,4048233,69.78,0.88
3522,2021-04-05,CAM,11640,5542,6098,8939,2424,277,ITF,ITF3,15,Campania,Campania,5801692,4059873,69.98,0.2
3523,2021-03-17,CAM,11589,5100,6489,4858,6581,150,ITF,ITF3,15,Campania,Campania,5801692,4071462,70.18,0.2
3524,2021-06-11,CAM,70806,34398,36408,63902,6037,867,ITF,ITF3,15,Campania,Campania,5801692,4142268,71.4,1.22
3525,2021-07-05,CAM,63291,30507,32784,12738,49875,678,ITF,ITF3,15,Campania,Campania,5801692,4205559,72.49,1.09
3526,2021-07-07,CAM,52272,24807,27465,7268,44612,392,ITF,ITF3,15,Campania,Campania,5801692,4257831,73.39,0.9
3527,2021-03-29,CAM,19405,9578,9827,17469,1547,389,ITF,ITF3,15,Campania,Campania,5801692,4277236,73.72,0.33
3528,2021-06-20,CAM,47606,22745,24861,14334,32987,285,ITF,ITF3,15,Campania,Campania,5801692,4324842,74.54,0.82
3529,2021-03-27,CAM,21512,10241,11271,17252,3866,394,ITF,ITF3,15,Campania,Campania,5801692,4346354,74.92,0.37
3530,2021-06-01,CAM,42182,20932,21250,31458,10503,221,ITF,ITF3,15,Campania,Campania,5801692,4388536,75.64,0.73
3531,2021-06-18,CAM,65892,31405,34487,35091,30301,500,ITF,ITF3,15,Campania,Campania,5801692,4454428,76.78,1.14
3532,2021-03-10,CAM,15617,7724,7893,8459,6839,319,ITF,ITF3,15,Campania,Campania,5801692,4470045,77.05,0.27
3533,2021-07-11,CAM,40863,19665,21198,1010,39771,82,ITF,ITF3,15,Campania,Campania,5801692,4510908,77.75,0.7
3534,2021-02-02,CAM,5724,2805,2919,413,5280,31,ITF,ITF3,15,Campania,Campania,5801692,4516632,77.85,0.1
3535,2021-03-31,CAM,23191,11373,11818,19362,3440,389,ITF,ITF3,15,Campania,Campania,5801692,4539823,78.25,0.4
3536,2021-07-18,CAM,31334,15761,15573,3844,27158,332,ITF,ITF3,15,Campania,Campania,5801692,4571157,78.79,0.54
3537,2021-04-07,CAM,24973,11987,12986,19712,4725,536,ITF,ITF3,15,Campania,Campania,5801692,4596130,79.22,0.43
3538,2021-07-19,CAM,43966,21526,22440,5225,38346,395,ITF,ITF3,15,Campania,Campania,5801692,4640096,79.98,0.76
3539,2021-04-10,CAM,28356,13492,14864,22821,4914,621,ITF,ITF3,15,Campania,Campania,5801692,4668452,80.47,0.49
3540,2021-01-07,CAM,8910,4168,4742,8737,0,173,ITF,ITF3,15,Campania,Campania,5801692,4677362,80.62,0.15
3541,2021-03-05,CAM,16814,6667,10147,9864,6663,287,ITF,ITF3,15,Campania,Campania,5801692,4694176,80.91,0.29
3542,2021-05-23,CAM,58747,28638,30109,37216,20898,633,ITF,ITF3,15,Campania,Campania,5801692,4752923,81.92,1.01
3543,2021-02-12,CAM,6531,2861,3670,6091,188,252,ITF,ITF3,15,Campania,Campania,5801692,4759454,82.04,0.11
3544,2021-01-29,CAM,10055,4812,5243,43,10008,4,ITF,ITF3,15,Campania,Campania,5801692,4769509,82.21,0.17
3545,2021-06-27,CAM,43551,21449,22102,14103,29067,381,ITF,ITF3,15,Campania,Campania,5801692,4813060,82.96,0.75
3546,2021-03-19,CAM,11143,4973,6170,7095,3873,175,ITF,ITF3,15,Campania,Campania,5801692,4824203,83.15,0.19
3547,2021-01-14,CAM,7074,2978,4096,6809,0,265,ITF,ITF3,15,Campania,Campania,5801692,4831277,83.27,0.12
3548,2021-05-15,CAM,62659,29040,33619,42150,18719,1790,ITF,ITF3,15,Campania,Campania,5801692,4893936,84.35,1.08
3549,2021-03-12,CAM,14575,7411,7164,8195,6084,296,ITF,ITF3,15,Campania,Campania,5801692,4908511,84.6,0.25
3550,2021-06-03,CAM,72640,35232,37408,61151,10677,812,ITF,ITF3,15,Campania,Campania,5801692,4981151,85.86,1.25
3551,2021-02-23,CAM,11002,3388,7614,10203,526,273,ITF,ITF3,15,Campania,Campania,5801692,4992153,86.05,0.19
3552,2021-02-21,CAM,5837,2241,3596,5495,225,117,ITF,ITF3,15,Campania,Campania,5801692,4997990,86.15,0.1
3553,2021-03-03,CAM,13924,5496,8428,7099,6630,195,ITF,ITF3,15,Campania,Campania,5801692,5011914,86.39,0.24
3554,2021-06-25,CAM,65511,31803,33708,13787,51341,383,ITF,ITF3,15,Campania,Campania,5801692,5077425,87.52,1.13
3555,2021-05-25,CAM,46506,22386,24120,22544,23414,548,ITF,ITF3,15,Campania,Campania,5801692,5123931,88.32,0.8
3556,2021-04-22,CAM,33994,16562,17432,20934,12434,626,ITF,ITF3,15,Campania,Campania,5801692,5157925,88.9,0.59
3557,2021-07-16,CAM,60992,29834,31158,6745,53868,379,ITF,ITF3,15,Campania,Campania,5801692,5218917,89.96,1.05
3558,2021-04-02,CAM,21866,10525,11341,19092,2324,450,ITF,ITF3,15,Campania,Campania,5801692,5240783,90.33,0.38
3559,2021-07-28,CAM,49395,24540,24855,13922,34774,699,ITF,ITF3,15,Campania,Campania,5801692,5290178,91.18,0.85
3560,2021-06-22,CAM,52447,25010,27437,13195,39004,248,ITF,ITF3,15,Campania,Campania,5801692,5342625,92.09,0.9
3561,2021-03-14,CAM,8616,3827,4789,4375,4140,101,ITF,ITF3,15,Campania,Campania,5801692,5351241,92.24,0.15
3562,2021-05-10,CAM,35474,16393,19081,24990,9927,557,ITF,ITF3,15,Campania,Campania,5801692,5386715,92.85,0.61
3563,2021-06-08,CAM,53046,25855,27191,45454,7004,588,ITF,ITF3,15,Campania,Campania,5801692,5439761,93.76,0.91
3564,2021-04-26,CAM,34035,16649,17386,27568,5623,844,ITF,ITF3,15,Campania,Campania,5801692,5473796,94.35,0.59
3565,2021-03-07,CAM,11973,5404,6569,7814,3843,316,ITF,ITF3,15,Campania,Campania,5801692,5485769,94.55,0.21
3566,2021-05-03,CAM,40789,19906,20883,27957,11861,971,ITF,ITF3,15,Campania,Campania,5801692,5526558,95.26,0.7
3567,2021-06-29,CAM,49321,23988,25333,19768,29091,462,ITF,ITF3,15,Campania,Campania,5801692,5575879,96.11,0.85
3568,2021-06-15,CAM,18674,9087,9587,11026,7413,235,ITF,ITF3,15,Campania,Campania,5801692,5594553,96.43,0.32
3569,2021-06-10,CAM,75926,36683,39243,68004,7035,887,ITF,ITF3,15,Campania,Campania,5801692,5670479,97.74,1.31
3570,2021-05-08,CAM,56439,27145,29294,39143,15836,1460,ITF,ITF3,15,Campania,Campania,5801692,5726918,98.71,0.97
3571,2021-01-28,CAM,8835,4124,4711,126,8701,8,ITF,ITF3,15,Campania,Campania,5801692,5735753,98.86,0.15
3572,2021-01-12,CAM,5215,2564,2651,5076,0,139,ITF,ITF3,15,Campania,Campania,5801692,5740968,98.95,0.09
3573,2021-05-06,CAM,57352,27953,29399,41309,14515,1528,ITF,ITF3,15,Campania,Campania,5801692,5798320,99.94,0.99
3574,2021-02-28,CAM,10412,3207,7205,8309,1900,203,ITF,ITF3,15,Campania,Campania,5801692,5808732,100.12,0.18
3575,2021-07-30,CAM,44538,22661,21877,14394,29377,767,ITF,ITF3,15,Campania,Campania,5801692,5853270,100.89,0.77
3576,2021-04-21,CAM,30239,14730,15509,17486,12228,525,ITF,ITF3,15,Campania,Campania,5801692,5883509,101.41,0.52
3577,2021-02-14,CAM,3929,1923,2006,3845,34,50,ITF,ITF3,15,Campania,Campania,5801692,5887438,101.48,0.07
3578,2021-01-26,CAM,7342,3727,3615,331,6990,21,ITF,ITF3,15,Campania,Campania,5801692,5894780,101.6,0.13
3579,2021-04-19,CAM,30768,14827,15941,18686,11573,509,ITF,ITF3,15,Campania,Campania,5801692,5925548,102.13,0.53
3580,2021-01-09,CAM,10566,5024,5542,10305,0,261,ITF,ITF3,15,Campania,Campania,5801692,5936114,102.32,0.18
3581,2021-01-13,CAM,8020,3666,4354,7780,0,240,ITF,ITF3,15,Campania,Campania,5801692,5944134,102.46,0.14
3582,2021-04-18,CAM,27222,13287,13935,17818,8902,502,ITF,ITF3,15,Campania,Campania,5801692,5971356,102.92,0.47
3583,2021-01-08,CAM,10453,4967,5486,10193,0,260,ITF,ITF3,15,Campania,Campania,5801692,5981809,103.1,0.18
3584,2021-04-27,CAM,32161,15625,16536,23495,7924,742,ITF,ITF3,15,Campania,Campania,5801692,6013970,103.66,0.55
3585,2021-06-23,CAM,46757,22086,24671,10751,35795,211,ITF,ITF3,15,Campania,Campania,5801692,6060727,104.46,0.81
3586,2021-01-15,CAM,4979,2381,2598,4823,0,156,ITF,ITF3,15,Campania,Campania,5801692,6065706,104.55,0.09
3587,2021-06-21,CAM,46874,22639,24235,11338,35243,293,ITF,ITF3,15,Campania,Campania,5801692,6112580,105.36,0.81
3588,2021-03-13,CAM,14520,7039,7481,8987,5283,250,ITF,ITF3,15,Campania,Campania,5801692,6127100,105.61,0.25
3589,2021-03-22,CAM,13182,6345,6837,10862,2042,278,ITF,ITF3,15,Campania,Campania,5801692,6140282,105.84,0.23
3590,2021-02-07,CAM,2928,1381,1547,2067,771,90,ITF,ITF3,15,Campania,Campania,5801692,6143210,105.89,0.05
3591,2021-06-30,CAM,47625,22750,24875,18377,28634,614,ITF,ITF3,15,Campania,Campania,5801692,6190835,106.71,0.82
3592,2021-01-17,CAM,1155,551,604,682,453,20,ITF,ITF3,15,Campania,Campania,5801692,6191990,106.73,0.02
3593,2021-03-15,CAM,13346,6491,6855,8343,4746,257,ITF,ITF3,15,Campania,Campania,5801692,6205336,106.96,0.23
3594,2021-07-02,CAM,55874,26998,28876,14440,40949,485,ITF,ITF3,15,Campania,Campania,5801692,6261210,107.92,0.96
3595,2021-05-27,CAM,72921,35355,37566,25815,46548,558,ITF,ITF3,15,Campania,Campania,5801692,6334131,109.18,1.26
3596,2021-02-16,CAM,5440,2412,3028,4494,771,175,ITF,ITF3,15,Campania,Campania,5801692,6339571,109.27,0.09
3597,2021-05-22,CAM,67970,32517,35453,45623,21500,847,ITF,ITF3,15,Campania,Campania,5801692,6407541,110.44,1.17
3598,2021-03-24,CAM,17922,8369,9553,14621,2958,343,ITF,ITF3,15,Campania,Campania,5801692,6425463,110.75,0.31
3599,2021-05-20,CAM,60861,28164,32697,42234,17662,965,ITF,ITF3,15,Campania,Campania,5801692,6486324,111.8,1.05
3600,2021-02-09,CAM,4643,2202,2441,4234,252,157,ITF,ITF3,15,Campania,Campania,5801692,6490967,111.88,0.08
3601,2021-05-29,CAM,67819,32261,35558,43105,23875,839,ITF,ITF3,15,Campania,Campania,5801692,6558786,113.05,1.17
3602,2021-07-25,CAM,23158,11745,11413,4294,18730,134,ITF,ITF3,15,Campania,Campania,5801692,6581944,113.45,0.4
3603,2021-07-06,PIE,38270,19381,18889,8661,29090,519,ITC,ITC1,1,Piemonte,Piemonte,4356406,38270,0.88,0.88
3604,2021-03-28,PIE,16058,6897,9161,8111,7622,325,ITC,ITC1,1,Piemonte,Piemonte,4356406,54328,1.25,0.37
3605,2021-07-20,PIE,38886,20447,18439,5745,32598,543,ITC,ITC1,1,Piemonte,Piemonte,4356406,93214,2.14,0.89
3606,2021-04-11,PIE,20823,9319,11504,18222,2148,453,ITC,ITC1,1,Piemonte,Piemonte,4356406,114037,2.62,0.48
3607,2021-01-04,PIE,5560,1677,3883,5559,0,1,ITC,ITC1,1,Piemonte,Piemonte,4356406,119597,2.75,0.13
3608,2021-04-28,PIE,26031,11731,14300,15462,10034,535,ITC,ITC1,1,Piemonte,Piemonte,4356406,145628,3.34,0.6
3609,2021-01-18,PIE,6165,2046,4119,5912,249,4,ITC,ITC1,1,Piemonte,Piemonte,4356406,151793,3.48,0.14
3610,2021-06-07,PIE,34901,17865,17036,29502,4796,603,ITC,ITC1,1,Piemonte,Piemonte,4356406,186694,4.29,0.8
3611,2021-07-15,PIE,42466,21961,20505,4077,37943,446,ITC,ITC1,1,Piemonte,Piemonte,4356406,229160,5.26,0.97
3612,2021-04-23,PIE,27421,12598,14823,19977,6760,684,ITC,ITC1,1,Piemonte,Piemonte,4356406,256581,5.89,0.63
3613,2021-02-11,PIE,6760,2105,4655,2981,3760,19,ITC,ITC1,1,Piemonte,Piemonte,4356406,263341,6.04,0.16
3614,2021-04-09,PIE,25869,11391,14478,20809,4503,557,ITC,ITC1,1,Piemonte,Piemonte,4356406,289210,6.64,0.59
3615,2020-12-30,PIE,731,322,409,731,0,0,ITC,ITC1,1,Piemonte,Piemonte,4356406,289941,6.66,0.02
3616,2021-06-05,PIE,36936,18923,18013,31871,4456,609,ITC,ITC1,1,Piemonte,Piemonte,4356406,326877,7.5,0.85
3617,2021-02-25,PIE,12208,5246,6962,11483,544,181,ITC,ITC1,1,Piemonte,Piemonte,4356406,339085,7.78,0.28
3618,2021-05-19,PIE,33105,15283,17822,21398,11125,582,ITC,ITC1,1,Piemonte,Piemonte,4356406,372190,8.54,0.76
3619,2021-03-14,PIE,8203,3337,4866,5171,2897,135,ITC,ITC1,1,Piemonte,Piemonte,4356406,380393,8.73,0.19
3620,2021-05-10,PIE,28969,13961,15008,15246,13121,602,ITC,ITC1,1,Piemonte,Piemonte,4356406,409362,9.4,0.66
3621,2021-01-30,PIE,5981,2136,3845,216,5764,1,ITC,ITC1,1,Piemonte,Piemonte,4356406,415343,9.53,0.14
3622,2021-06-24,PIE,39187,19672,19515,18296,20308,583,ITC,ITC1,1,Piemonte,Piemonte,4356406,454530,10.43,0.9
3623,2021-03-16,PIE,10514,4270,6244,4368,6054,92,ITC,ITC1,1,Piemonte,Piemonte,4356406,465044,10.67,0.24
3624,2021-05-12,PIE,31883,15183,16700,18366,12905,612,ITC,ITC1,1,Piemonte,Piemonte,4356406,496927,11.41,0.73
3625,2021-05-24,PIE,28980,13418,15562,16635,11965,380,ITC,ITC1,1,Piemonte,Piemonte,4356406,525907,12.07,0.67
3626,2021-03-02,PIE,11248,4549,6699,10247,813,188,ITC,ITC1,1,Piemonte,Piemonte,4356406,537155,12.33,0.26
3627,2021-06-19,PIE,40044,20314,19730,22852,16659,533,ITC,ITC1,1,Piemonte,Piemonte,4356406,577199,13.25,0.92
3628,2021-02-04,PIE,10204,3340,6864,581,9621,2,ITC,ITC1,1,Piemonte,Piemonte,4356406,587403,13.48,0.23
3629,2021-03-23,PIE,13185,5558,7627,6634,6241,310,ITC,ITC1,1,Piemonte,Piemonte,4356406,600588,13.79,0.3
3630,2021-01-16,PIE,7761,2624,5137,7754,0,7,ITC,ITC1,1,Piemonte,Piemonte,4356406,608349,13.96,0.18
3631,2021-07-08,PIE,40920,20931,19989,7460,32932,528,ITC,ITC1,1,Piemonte,Piemonte,4356406,649269,14.9,0.94
3632,2021-04-02,PIE,20149,8320,11829,11330,8427,392,ITC,ITC1,1,Piemonte,Piemonte,4356406,669418,15.37,0.46
3633,2021-05-29,PIE,32798,15227,17571,20270,12169,359,ITC,ITC1,1,Piemonte,Piemonte,4356406,702216,16.12,0.75
3634,2021-02-18,PIE,4788,2094,2694,4273,429,86,ITC,ITC1,1,Piemonte,Piemonte,4356406,707004,16.23,0.11
3635,2021-07-25,PIE,28603,15177,13426,6797,21550,256,ITC,ITC1,1,Piemonte,Piemonte,4356406,735607,16.89,0.66
3636,2021-04-16,PIE,28398,13208,15190,22652,4992,754,ITC,ITC1,1,Piemonte,Piemonte,4356406,764005,17.54,0.65
3637,2021-05-17,PIE,30921,14608,16313,17365,13155,401,ITC,ITC1,1,Piemonte,Piemonte,4356406,794926,18.25,0.71
3638,2021-02-06,PIE,7993,2665,5328,396,7595,2,ITC,ITC1,1,Piemonte,Piemonte,4356406,802919,18.43,0.18
3639,2021-02-23,PIE,9233,3713,5520,8478,583,172,ITC,ITC1,1,Piemonte,Piemonte,4356406,812152,18.64,0.21
3640,2021-05-31,PIE,29114,14060,15054,20129,8579,406,ITC,ITC1,1,Piemonte,Piemonte,4356406,841266,19.31,0.67
3641,2021-06-17,PIE,41078,20623,20455,24152,16320,606,ITC,ITC1,1,Piemonte,Piemonte,4356406,882344,20.25,0.94
3642,2021-03-09,PIE,14207,5652,8555,11640,2340,227,ITC,ITC1,1,Piemonte,Piemonte,4356406,896551,20.58,0.33
3643,2020-12-28,PIE,1,1,0,1,0,0,ITC,ITC1,1,Piemonte,Piemonte,4356406,896552,20.58,0.0
3644,2021-07-27,PIE,33146,17306,15840,8232,24626,288,ITC,ITC1,1,Piemonte,Piemonte,4356406,929698,21.34,0.76
3645,2021-05-02,PIE,25082,11268,13814,13956,10743,383,ITC,ITC1,1,Piemonte,Piemonte,4356406,954780,21.92,0.58
3646,2021-06-26,PIE,41153,20937,20216,21935,18541,677,ITC,ITC1,1,Piemonte,Piemonte,4356406,995933,22.86,0.94
3647,2021-07-13,PIE,38827,20035,18792,3662,34845,320,ITC,ITC1,1,Piemonte,Piemonte,4356406,1034760,23.75,0.89
3648,2021-04-04,PIE,9252,4057,5195,6393,2710,149,ITC,ITC1,1,Piemonte,Piemonte,4356406,1044012,23.96,0.21
3649,2021-04-21,PIE,25739,11831,13908,19740,5344,655,ITC,ITC1,1,Piemonte,Piemonte,4356406,1069751,24.56,0.59
3650,2021-01-11,PIE,8737,2978,5759,8731,0,6,ITC,ITC1,1,Piemonte,Piemonte,4356406,1078488,24.76,0.2
3651,2021-06-28,PIE,38397,19068,19329,15108,22725,564,ITC,ITC1,1,Piemonte,Piemonte,4356406,1116885,25.64,0.88
3652,2021-04-06,PIE,20239,8808,11431,14594,5197,448,ITC,ITC1,1,Piemonte,Piemonte,4356406,1137124,26.1,0.46
3653,2020-12-27,PIE,913,369,544,913,0,0,ITC,ITC1,1,Piemonte,Piemonte,4356406,1138037,26.12,0.02
3654,2021-02-08,PIE,6916,2354,4562,661,6251,4,ITC,ITC1,1,Piemonte,Piemonte,4356406,1144953,26.28,0.16
3655,2021-06-12,PIE,42591,22454,20137,39199,2627,765,ITC,ITC1,1,Piemonte,Piemonte,4356406,1187544,27.26,0.98
3656,2021-07-12,PIE,39150,20198,18952,4549,34151,450,ITC,ITC1,1,Piemonte,Piemonte,4356406,1226694,28.16,0.9
3657,2021-07-29,PIE,36025,18720,17305,9463,26212,350,ITC,ITC1,1,Piemonte,Piemonte,4356406,1262719,28.99,0.83
3658,2021-04-20,PIE,25485,11669,13816,18525,6346,614,ITC,ITC1,1,Piemonte,Piemonte,4356406,1288204,29.57,0.59
3659,2021-05-07,PIE,33080,15648,17432,18359,14124,597,ITC,ITC1,1,Piemonte,Piemonte,4356406,1321284,30.33,0.76
3660,2021-01-27,PIE,4193,1451,2742,994,3197,2,ITC,ITC1,1,Piemonte,Piemonte,4356406,1325477,30.43,0.1
3661,2021-01-23,PIE,4255,1326,2929,877,3376,2,ITC,ITC1,1,Piemonte,Piemonte,4356406,1329732,30.52,0.1
3662,2021-03-21,PIE,10724,4739,5985,4023,6532,169,ITC,ITC1,1,Piemonte,Piemonte,4356406,1340456,30.77,0.25
3663,2021-05-05,PIE,32237,15143,17094,18562,13062,613,ITC,ITC1,1,Piemonte,Piemonte,4356406,1372693,31.51,0.74
3664,2021-07-01,PIE,41853,20949,20904,19812,21126,915,ITC,ITC1,1,Piemonte,Piemonte,4356406,1414546,32.47,0.96
3665,2021-04-30,PIE,31834,14321,17513,17839,13328,667,ITC,ITC1,1,Piemonte,Piemonte,4356406,1446380,33.2,0.73
3666,2021-06-02,PIE,26534,13001,13533,21624,4469,441,ITC,ITC1,1,Piemonte,Piemonte,4356406,1472914,33.81,0.61
3667,2021-02-22,PIE,8478,3468,5010,7788,589,101,ITC,ITC1,1,Piemonte,Piemonte,4356406,1481392,34.0,0.19
3668,2021-03-11,PIE,13901,5205,8696,10561,3093,247,ITC,ITC1,1,Piemonte,Piemonte,4356406,1495293,34.32,0.32
3669,2021-01-13,PIE,10074,3226,6848,10065,0,9,ITC,ITC1,1,Piemonte,Piemonte,4356406,1505367,34.56,0.23
3670,2021-06-16,PIE,40383,20242,20141,23518,16255,610,ITC,ITC1,1,Piemonte,Piemonte,4356406,1545750,35.48,0.93
3671,2021-01-06,PIE,3107,1103,2004,3106,0,1,ITC,ITC1,1,Piemonte,Piemonte,4356406,1548857,35.55,0.07
3672,2021-01-01,PIE,1038,395,643,1037,0,1,ITC,ITC1,1,Piemonte,Piemonte,4356406,1549895,35.58,0.02
3673,2021-07-05,PIE,35573,17794,17779,11711,23215,647,ITC,ITC1,1,Piemonte,Piemonte,4356406,1585468,36.39,0.82
3674,2021-06-09,PIE,38589,20341,18248,35108,2715,766,ITC,ITC1,1,Piemonte,Piemonte,4356406,1624057,37.28,0.89
3675,2021-03-18,PIE,11761,4806,6955,3836,7733,192,ITC,ITC1,1,Piemonte,Piemonte,4356406,1635818,37.55,0.27
3676,2021-03-03,PIE,12257,4771,7486,11249,818,190,ITC,ITC1,1,Piemonte,Piemonte,4356406,1648075,37.83,0.28
3677,2021-03-20,PIE,11918,4896,7022,5777,5897,244,ITC,ITC1,1,Piemonte,Piemonte,4356406,1659993,38.1,0.27
3678,2021-05-06,PIE,33392,15767,17625,19283,13522,587,ITC,ITC1,1,Piemonte,Piemonte,4356406,1693385,38.87,0.77
3679,2021-05-23,PIE,28723,13142,15581,15462,12950,311,ITC,ITC1,1,Piemonte,Piemonte,4356406,1722108,39.53,0.66
3680,2021-02-12,PIE,6887,2214,4673,3906,2958,23,ITC,ITC1,1,Piemonte,Piemonte,4356406,1728995,39.69,0.16
3681,2021-03-01,PIE,12111,4912,7199,11134,808,169,ITC,ITC1,1,Piemonte,Piemonte,4356406,1741106,39.97,0.28
3682,2021-05-25,PIE,31144,14451,16693,15610,15144,390,ITC,ITC1,1,Piemonte,Piemonte,4356406,1772250,40.68,0.71
3683,2021-06-11,PIE,43546,23054,20492,39920,2832,794,ITC,ITC1,1,Piemonte,Piemonte,4356406,1815796,41.68,1.0
3684,2021-02-13,PIE,4156,1338,2818,2918,1224,14,ITC,ITC1,1,Piemonte,Piemonte,4356406,1819952,41.78,0.1
3685,2021-05-09,PIE,27148,12929,14219,13150,13619,379,ITC,ITC1,1,Piemonte,Piemonte,4356406,1847100,42.4,0.62
3686,2021-05-26,PIE,32750,15104,17646,15315,17082,353,ITC,ITC1,1,Piemonte,Piemonte,4356406,1879850,43.15,0.75
3687,2021-02-15,PIE,4426,1597,2829,3197,1206,23,ITC,ITC1,1,Piemonte,Piemonte,4356406,1884276,43.25,0.1
3688,2021-03-04,PIE,14635,5860,8775,11476,2941,218,ITC,ITC1,1,Piemonte,Piemonte,4356406,1898911,43.59,0.34
3689,2021-02-27,PIE,12674,4845,7829,12111,336,227,ITC,ITC1,1,Piemonte,Piemonte,4356406,1911585,43.88,0.29
3690,2021-04-25,PIE,20230,9306,10924,17283,2501,446,ITC,ITC1,1,Piemonte,Piemonte,4356406,1931815,44.34,0.46
3691,2021-01-15,PIE,9103,3007,6096,9097,0,6,ITC,ITC1,1,Piemonte,Piemonte,4356406,1940918,44.55,0.21
3692,2021-06-21,PIE,38376,19162,19214,17110,20713,553,ITC,ITC1,1,Piemonte,Piemonte,4356406,1979294,45.43,0.88
3693,2021-03-13,PIE,13023,4714,8309,11325,1430,268,ITC,ITC1,1,Piemonte,Piemonte,4356406,1992317,45.73,0.3
3694,2021-04-18,PIE,22928,10797,12131,19622,2748,558,ITC,ITC1,1,Piemonte,Piemonte,4356406,2015245,46.26,0.53
3695,2021-06-23,PIE,39700,19714,19986,16383,22836,481,ITC,ITC1,1,Piemonte,Piemonte,4356406,2054945,47.17,0.91
3696,2021-03-08,PIE,14131,5462,8669,11189,2707,235,ITC,ITC1,1,Piemonte,Piemonte,4356406,2069076,47.5,0.32
3697,2021-05-04,PIE,28592,13152,15440,15897,12190,505,ITC,ITC1,1,Piemonte,Piemonte,4356406,2097668,48.15,0.66
3698,2021-01-24,PIE,3153,959,2194,432,2719,2,ITC,ITC1,1,Piemonte,Piemonte,4356406,2100821,48.22,0.07
3699,2021-06-30,PIE,41229,20161,21068,18453,21946,830,ITC,ITC1,1,Piemonte,Piemonte,4356406,2142050,49.17,0.95
3700,2021-03-22,PIE,11525,4892,6633,3715,7599,211,ITC,ITC1,1,Piemonte,Piemonte,4356406,2153575,49.43,0.26
3701,2021-04-27,PIE,22611,10217,12394,16829,5145,637,ITC,ITC1,1,Piemonte,Piemonte,4356406,2176186,49.95,0.52
3702,2021-07-03,PIE,40045,20108,19937,15339,24026,680,ITC,ITC1,1,Piemonte,Piemonte,4356406,2216231,50.87,0.92
3703,2021-03-30,PIE,16981,7112,9869,8725,7870,386,ITC,ITC1,1,Piemonte,Piemonte,4356406,2233212,51.26,0.39
3704,2021-07-10,PIE,41135,20841,20294,6713,33905,517,ITC,ITC1,1,Piemonte,Piemonte,4356406,2274347,52.21,0.94
3705,2021-04-01,PIE,19377,8110,11267,10939,8126,312,ITC,ITC1,1,Piemonte,Piemonte,4356406,2293724,52.65,0.44
3706,2021-05-28,PIE,35051,16607,18444,18661,15983,407,ITC,ITC1,1,Piemonte,Piemonte,4356406,2328775,53.46,0.8
3707,2021-01-25,PIE,6211,1935,4276,975,5234,2,ITC,ITC1,1,Piemonte,Piemonte,4356406,2334986,53.6,0.14
3708,2021-05-30,PIE,27721,13194,14527,18019,9331,371,ITC,ITC1,1,Piemonte,Piemonte,4356406,2362707,54.24,0.64
3709,2021-02-19,PIE,5533,2175,3358,4912,501,120,ITC,ITC1,1,Piemonte,Piemonte,4356406,2368240,54.36,0.13
3710,2021-03-25,PIE,17127,7268,9859,8055,8634,438,ITC,ITC1,1,Piemonte,Piemonte,4356406,2385367,54.76,0.39
3711,2021-07-22,PIE,41223,21692,19531,6993,33666,564,ITC,ITC1,1,Piemonte,Piemonte,4356406,2426590,55.7,0.95
3712,2021-04-13,PIE,25942,11615,14327,21833,3460,649,ITC,ITC1,1,Piemonte,Piemonte,4356406,2452532,56.3,0.6
3713,2021-01-20,PIE,6601,2084,4517,5881,713,7,ITC,ITC1,1,Piemonte,Piemonte,4356406,2459133,56.45,0.15
3714,2021-04-19,PIE,22541,10763,11778,17641,4350,550,ITC,ITC1,1,Piemonte,Piemonte,4356406,2481674,56.97,0.52
3715,2021-01-09,PIE,6178,2183,3995,6177,0,1,ITC,ITC1,1,Piemonte,Piemonte,4356406,2487852,57.11,0.14
3716,2021-06-04,PIE,37556,19635,17921,34025,2953,578,ITC,ITC1,1,Piemonte,Piemonte,4356406,2525408,57.97,0.86
3717,2021-02-24,PIE,11376,4602,6774,10729,503,144,ITC,ITC1,1,Piemonte,Piemonte,4356406,2536784,58.23,0.26
3718,2021-06-06,PIE,35079,18331,16748,32046,2489,544,ITC,ITC1,1,Piemonte,Piemonte,4356406,2571863,59.04,0.81
3719,2021-02-17,PIE,4793,2157,2636,3744,990,59,ITC,ITC1,1,Piemonte,Piemonte,4356406,2576656,59.15,0.11
3720,2021-06-08,PIE,37650,19496,18154,34119,2840,691,ITC,ITC1,1,Piemonte,Piemonte,4356406,2614306,60.01,0.86
3721,2021-02-03,PIE,10202,3306,6896,606,9594,2,ITC,ITC1,1,Piemonte,Piemonte,4356406,2624508,60.24,0.23
3722,2021-05-18,PIE,32139,14841,17298,19042,12661,436,ITC,ITC1,1,Piemonte,Piemonte,4356406,2656647,60.98,0.74
3723,2021-01-08,PIE,5525,1759,3766,5523,0,2,ITC,ITC1,1,Piemonte,Piemonte,4356406,2662172,61.11,0.13
3724,2021-06-14,PIE,37963,19562,18401,30197,7089,677,ITC,ITC1,1,Piemonte,Piemonte,4356406,2700135,61.98,0.87
3725,2021-03-06,PIE,13999,5219,8780,11038,2789,172,ITC,ITC1,1,Piemonte,Piemonte,4356406,2714134,62.3,0.32
3726,2021-01-22,PIE,3865,1249,2616,2523,1340,2,ITC,ITC1,1,Piemonte,Piemonte,4356406,2717999,62.39,0.09
3727,2021-02-20,PIE,3832,1254,2578,3560,173,99,ITC,ITC1,1,Piemonte,Piemonte,4356406,2721831,62.48,0.09
3728,2021-07-24,PIE,34746,18283,16463,8078,26294,374,ITC,ITC1,1,Piemonte,Piemonte,4356406,2756577,63.28,0.8
3729,2021-04-29,PIE,48422,21947,26475,34652,12613,1157,ITC,ITC1,1,Piemonte,Piemonte,4356406,2804999,64.39,1.11
3730,2021-05-16,PIE,28163,12787,15376,14736,13055,372,ITC,ITC1,1,Piemonte,Piemonte,4356406,2833162,65.03,0.65
3731,2021-02-05,PIE,9601,3137,6464,652,8947,2,ITC,ITC1,1,Piemonte,Piemonte,4356406,2842763,65.25,0.22
3732,2021-06-25,PIE,45466,22662,22804,20261,24528,677,ITC,ITC1,1,Piemonte,Piemonte,4356406,2888229,66.3,1.04
3733,2021-04-03,PIE,19447,8179,11268,10595,8546,306,ITC,ITC1,1,Piemonte,Piemonte,4356406,2907676,66.74,0.45
3734,2021-01-10,PIE,5205,2272,2933,5203,0,2,ITC,ITC1,1,Piemonte,Piemonte,4356406,2912881,66.86,0.12
3735,2021-07-14,PIE,38945,20036,18909,3570,34957,418,ITC,ITC1,1,Piemonte,Piemonte,4356406,2951826,67.76,0.89
3736,2021-04-22,PIE,27660,12739,14921,20194,6688,778,ITC,ITC1,1,Piemonte,Piemonte,4356406,2979486,68.39,0.63
3737,2021-01-12,PIE,10077,3411,6666,10070,0,7,ITC,ITC1,1,Piemonte,Piemonte,4356406,2989563,68.62,0.23
3738,2021-01-29,PIE,5938,1884,4054,452,5486,0,ITC,ITC1,1,Piemonte,Piemonte,4356406,2995501,68.76,0.14
3739,2021-04-26,PIE,19802,8753,11049,14908,4398,496,ITC,ITC1,1,Piemonte,Piemonte,4356406,3015303,69.22,0.45
3740,2021-05-03,PIE,26681,12204,14477,12043,14207,431,ITC,ITC1,1,Piemonte,Piemonte,4356406,3041984,69.83,0.61
3741,2021-01-17,PIE,3515,1168,2347,2864,649,2,ITC,ITC1,1,Piemonte,Piemonte,4356406,3045499,69.91,0.08
3742,2021-03-15,PIE,10683,4193,6490,4928,5601,154,ITC,ITC1,1,Piemonte,Piemonte,4356406,3056182,70.15,0.25
3743,2021-05-11,PIE,32061,15451,16610,18199,13230,632,ITC,ITC1,1,Piemonte,Piemonte,4356406,3088243,70.89,0.74
3744,2021-01-31,PIE,4114,1754,2360,111,4003,0,ITC,ITC1,1,Piemonte,Piemonte,4356406,3092357,70.98,0.09
3745,2021-07-18,PIE,32864,17240,15624,3241,29306,317,ITC,ITC1,1,Piemonte,Piemonte,4356406,3125221,71.74,0.75
3746,2021-02-07,PIE,3083,972,2111,440,2642,1,ITC,ITC1,1,Piemonte,Piemonte,4356406,3128304,71.81,0.07
3747,2021-01-03,PIE,3059,965,2094,3057,0,2,ITC,ITC1,1,Piemonte,Piemonte,4356406,3131363,71.88,0.07
3748,2021-07-07,PIE,37925,18851,19074,9668,27706,551,ITC,ITC1,1,Piemonte,Piemonte,4356406,3169288,72.75,0.87
3749,2021-03-29,PIE,15245,6470,8775,8378,6611,256,ITC,ITC1,1,Piemonte,Piemonte,4356406,3184533,73.1,0.35
3750,2021-07-21,PIE,37898,20118,17780,6533,30874,491,ITC,ITC1,1,Piemonte,Piemonte,4356406,3222431,73.97,0.87
3751,2021-04-12,PIE,22935,10359,12576,19434,2992,509,ITC,ITC1,1,Piemonte,Piemonte,4356406,3245366,74.5,0.53
3752,2021-01-02,PIE,3539,1132,2407,3538,0,1,ITC,ITC1,1,Piemonte,Piemonte,4356406,3248905,74.58,0.08
3753,2021-07-11,PIE,33141,16896,16245,4519,28318,304,ITC,ITC1,1,Piemonte,Piemonte,4356406,3282046,75.34,0.76
3754,2021-05-22,PIE,33515,15131,18384,16894,16218,403,ITC,ITC1,1,Piemonte,Piemonte,4356406,3315561,76.11,0.77
3755,2021-01-26,PIE,6332,1881,4451,731,5600,1,ITC,ITC1,1,Piemonte,Piemonte,4356406,3321893,76.25,0.15
3756,2021-07-30,PIE,33408,17467,15941,8944,24059,405,ITC,ITC1,1,Piemonte,Piemonte,4356406,3355301,77.02,0.77
3757,2021-05-08,PIE,34266,16261,18005,18126,15634,506,ITC,ITC1,1,Piemonte,Piemonte,4356406,3389567,77.81,0.79
3758,2021-01-28,PIE,5589,1809,3780,380,5209,0,ITC,ITC1,1,Piemonte,Piemonte,4356406,3395156,77.93,0.13
3759,2021-02-14,PIE,1476,498,978,869,600,7,ITC,ITC1,1,Piemonte,Piemonte,4356406,3396632,77.97,0.03
3760,2021-02-28,PIE,10809,4057,6752,10395,240,174,ITC,ITC1,1,Piemonte,Piemonte,4356406,3407441,78.22,0.25
3761,2021-03-17,PIE,12517,5055,7462,5040,7295,182,ITC,ITC1,1,Piemonte,Piemonte,4356406,3419958,78.5,0.29
3762,2021-06-10,PIE,40415,21124,19291,36996,2572,847,ITC,ITC1,1,Piemonte,Piemonte,4356406,3460373,79.43,0.93
3763,2021-06-27,PIE,37510,18596,18914,15188,21745,577,ITC,ITC1,1,Piemonte,Piemonte,4356406,3497883,80.29,0.86
3764,2021-03-19,PIE,11028,4518,6510,4217,6605,206,ITC,ITC1,1,Piemonte,Piemonte,4356406,3508911,80.55,0.25
3765,2021-04-05,PIE,14746,6236,8510,11938,2556,252,ITC,ITC1,1,Piemonte,Piemonte,4356406,3523657,80.88,0.34
3766,2021-06-29,PIE,40508,20240,20268,19193,20663,652,ITC,ITC1,1,Piemonte,Piemonte,4356406,3564165,81.81,0.93
3767,2021-06-18,PIE,40581,20282,20299,25746,14178,657,ITC,ITC1,1,Piemonte,Piemonte,4356406,3604746,82.75,0.93
3768,2021-03-10,PIE,13812,5338,8474,11266,2290,256,ITC,ITC1,1,Piemonte,Piemonte,4356406,3618558,83.06,0.32
3769,2021-03-27,PIE,18388,7823,10565,9129,8824,435,ITC,ITC1,1,Piemonte,Piemonte,4356406,3636946,83.49,0.42
3770,2021-02-26,PIE,12285,4929,7356,11344,736,205,ITC,ITC1,1,Piemonte,Piemonte,4356406,3649231,83.77,0.28
3771,2021-04-24,PIE,27497,12431,15066,21289,5657,551,ITC,ITC1,1,Piemonte,Piemonte,4356406,3676728,84.4,0.63
3772,2021-01-14,PIE,9756,3146,6610,9750,0,6,ITC,ITC1,1,Piemonte,Piemonte,4356406,3686484,84.62,0.22
3773,2021-07-02,PIE,43735,22007,21728,17385,25546,804,ITC,ITC1,1,Piemonte,Piemonte,4356406,3730219,85.63,1.0
3774,2021-05-13,PIE,35686,17532,18154,19861,15124,701,ITC,ITC1,1,Piemonte,Piemonte,4356406,3765905,86.45,0.82
3775,2021-02-02,PIE,10253,3514,6739,807,9445,1,ITC,ITC1,1,Piemonte,Piemonte,4356406,3776158,86.68,0.24
3776,2021-07-09,PIE,40379,20601,19778,5753,34117,509,ITC,ITC1,1,Piemonte,Piemonte,4356406,3816537,87.61,0.93
3777,2021-03-31,PIE,19125,8120,11005,10099,8690,336,ITC,ITC1,1,Piemonte,Piemonte,4356406,3835662,88.05,0.44
3778,2021-05-27,PIE,37396,17389,20007,18813,18149,434,ITC,ITC1,1,Piemonte,Piemonte,4356406,3873058,88.9,0.86
3779,2021-02-16,PIE,3966,1756,2210,3160,758,48,ITC,ITC1,1,Piemonte,Piemonte,4356406,3877024,89.0,0.09
3780,2021-03-24,PIE,15562,6396,9166,6103,9130,329,ITC,ITC1,1,Piemonte,Piemonte,4356406,3892586,89.35,0.36
3781,2021-05-20,PIE,38621,17943,20678,13320,24949,352,ITC,ITC1,1,Piemonte,Piemonte,4356406,3931207,90.24,0.89
3782,2021-02-09,PIE,7387,2313,5074,714,6671,2,ITC,ITC1,1,Piemonte,Piemonte,4356406,3938594,90.41,0.17
3783,2021-07-16,PIE,41917,21903,20014,3609,37921,387,ITC,ITC1,1,Piemonte,Piemonte,4356406,3980511,91.37,0.96
3784,2021-04-07,PIE,23593,9988,13605,17616,5460,517,ITC,ITC1,1,Piemonte,Piemonte,4356406,4004104,91.91,0.54
3785,2021-05-01,PIE,28545,12997,15548,16324,11789,432,ITC,ITC1,1,Piemonte,Piemonte,4356406,4032649,92.57,0.66
3786,2021-01-21,PIE,6870,2311,4559,3368,3496,6,ITC,ITC1,1,Piemonte,Piemonte,4356406,4039519,92.73,0.16
3787,2021-05-15,PIE,33769,15741,18028,19394,13719,656,ITC,ITC1,1,Piemonte,Piemonte,4356406,4073288,93.5,0.78
3788,2021-06-01,PIE,29305,14703,14602,24457,4425,423,ITC,ITC1,1,Piemonte,Piemonte,4356406,4102593,94.17,0.67
3789,2021-02-21,PIE,5088,2083,3005,4936,102,50,ITC,ITC1,1,Piemonte,Piemonte,4356406,4107681,94.29,0.12
3790,2021-01-19,PIE,6454,2103,4351,6436,9,9,ITC,ITC1,1,Piemonte,Piemonte,4356406,4114135,94.44,0.15
3791,2021-07-23,PIE,37966,20030,17936,8209,29387,370,ITC,ITC1,1,Piemonte,Piemonte,4356406,4152101,95.31,0.87
3792,2021-04-14,PIE,27674,12547,15127,22455,4519,700,ITC,ITC1,1,Piemonte,Piemonte,4356406,4179775,95.95,0.64
3793,2021-06-20,PIE,34055,17080,16975,18728,14775,552,ITC,ITC1,1,Piemonte,Piemonte,4356406,4213830,96.73,0.78
3794,2021-03-12,PIE,14102,5328,8774,10892,2932,278,ITC,ITC1,1,Piemonte,Piemonte,4356406,4227932,97.05,0.32
3795,2021-07-04,PIE,33733,17004,16729,11234,21912,587,ITC,ITC1,1,Piemonte,Piemonte,4356406,4261665,97.83,0.77
3796,2021-03-26,PIE,17884,7104,10780,8477,8883,524,ITC,ITC1,1,Piemonte,Piemonte,4356406,4279549,98.24,0.41
3797,2021-06-03,PIE,34633,17893,16740,29702,4415,516,ITC,ITC1,1,Piemonte,Piemonte,4356406,4314182,99.03,0.79
3798,2021-05-21,PIE,36081,16744,19337,19933,15640,508,ITC,ITC1,1,Piemonte,Piemonte,4356406,4350263,99.86,0.83
3799,2021-07-17,PIE,41902,22065,19837,4941,36484,477,ITC,ITC1,1,Piemonte,Piemonte,4356406,4392165,100.82,0.96
3800,2021-02-01,PIE,8655,3052,5603,575,8079,1,ITC,ITC1,1,Piemonte,Piemonte,4356406,4400820,101.02,0.2
3801,2021-05-14,PIE,33415,16278,17137,17331,15424,660,ITC,ITC1,1,Piemonte,Piemonte,4356406,4434235,101.79,0.77
3802,2021-07-26,PIE,32371,16838,15533,8346,23732,293,ITC,ITC1,1,Piemonte,Piemonte,4356406,4466606,102.53,0.74
3803,2021-04-17,PIE,30450,14147,16303,26449,3306,695,ITC,ITC1,1,Piemonte,Piemonte,4356406,4497056,103.23,0.7
3804,2021-06-13,PIE,37972,20044,17928,33102,4123,747,ITC,ITC1,1,Piemonte,Piemonte,4356406,4535028,104.1,0.87
3805,2021-02-10,PIE,7534,2371,5163,1298,6221,15,ITC,ITC1,1,Piemonte,Piemonte,4356406,4542562,104.27,0.17
3806,2021-04-08,PIE,25292,11004,14288,20016,4721,555,ITC,ITC1,1,Piemonte,Piemonte,4356406,4567854,104.85,0.58
3807,2021-07-19,PIE,39515,20571,18944,4466,34644,405,ITC,ITC1,1,Piemonte,Piemonte,4356406,4607369,105.76,0.91
3808,2021-04-10,PIE,30150,13404,16746,25243,4264,643,ITC,ITC1,1,Piemonte,Piemonte,4356406,4637519,106.45,0.69
3809,2021-04-15,PIE,29528,13531,15997,23384,5480,664,ITC,ITC1,1,Piemonte,Piemonte,4356406,4667047,107.13,0.68
3810,2021-01-05,PIE,5373,1601,3772,5368,0,5,ITC,ITC1,1,Piemonte,Piemonte,4356406,4672420,107.25,0.12
3811,2021-06-22,PIE,40569,20045,20524,17782,22255,532,ITC,ITC1,1,Piemonte,Piemonte,4356406,4712989,108.19,0.93
3812,2021-01-07,PIE,5370,1731,3639,5368,0,2,ITC,ITC1,1,Piemonte,Piemonte,4356406,4718359,108.31,0.12
3813,2021-03-05,PIE,15557,6229,9328,11464,3822,271,ITC,ITC1,1,Piemonte,Piemonte,4356406,4733916,108.67,0.36
3814,2021-07-28,PIE,34234,17775,16459,9083,24824,327,ITC,ITC1,1,Piemonte,Piemonte,4356406,4768150,109.45,0.79
3815,2021-06-15,PIE,38919,20045,18874,26494,11766,659,ITC,ITC1,1,Piemonte,Piemonte,4356406,4807069,110.34,0.89
3816,2021-03-07,PIE,11979,4664,7315,10859,877,243,ITC,ITC1,1,Piemonte,Piemonte,4356406,4819048,110.62,0.27
3817,2020-12-31,PIE,3878,1320,2558,3878,0,0,ITC,ITC1,1,Piemonte,Piemonte,4356406,4822926,110.71,0.09
3818,2021-02-25,SIC,9942,5204,4738,8691,1164,87,ITG,ITG1,19,Sicilia,Sicilia,4999891,9942,0.2,0.2
3819,2021-06-05,SIC,59943,28514,31429,48736,10588,619,ITG,ITG1,19,Sicilia,Sicilia,4999891,69885,1.4,1.2
3820,2021-03-14,SIC,8773,3927,4846,4886,3836,51,ITG,ITG1,19,Sicilia,Sicilia,4999891,78658,1.57,0.18
3821,2021-02-11,SIC,5238,2060,3178,4656,465,117,ITG,ITG1,19,Sicilia,Sicilia,4999891,83896,1.68,0.1
3822,2021-06-19,SIC,44263,21045,23218,18753,25193,317,ITG,ITG1,19,Sicilia,Sicilia,4999891,128159,2.56,0.89
3823,2021-04-23,SIC,28566,13696,14870,22361,5836,369,ITG,ITG1,19,Sicilia,Sicilia,4999891,156725,3.13,0.57
3824,2021-06-26,SIC,37256,17774,19482,16356,20599,301,ITG,ITG1,19,Sicilia,Sicilia,4999891,193981,3.88,0.75
3825,2021-04-30,SIC,35021,16342,18679,23538,11031,452,ITG,ITG1,19,Sicilia,Sicilia,4999891,229002,4.58,0.7
3826,2021-04-11,SIC,15371,7591,7780,8234,7033,104,ITG,ITG1,19,Sicilia,Sicilia,4999891,244373,4.89,0.31
3827,2021-07-20,SIC,48423,23583,24840,12782,35291,350,ITG,ITG1,19,Sicilia,Sicilia,4999891,292796,5.86,0.97
3828,2020-12-30,SIC,185,109,76,184,0,1,ITG,ITG1,19,Sicilia,Sicilia,4999891,292981,5.86,0.0
3829,2021-01-16,SIC,2716,1211,1505,2695,0,21,ITG,ITG1,19,Sicilia,Sicilia,4999891,295697,5.91,0.05
3830,2021-07-01,SIC,30965,14066,16899,10726,19984,255,ITG,ITG1,19,Sicilia,Sicilia,4999891,326662,6.53,0.62
3831,2021-04-09,SIC,20273,9877,10396,10946,9077,250,ITG,ITG1,19,Sicilia,Sicilia,4999891,346935,6.94,0.41
3832,2021-03-23,SIC,20941,10079,10862,15221,5564,156,ITG,ITG1,19,Sicilia,Sicilia,4999891,367876,7.36,0.42
3833,2021-03-02,SIC,14755,6369,8386,11864,2778,113,ITG,ITG1,19,Sicilia,Sicilia,4999891,382631,7.65,0.3
3834,2021-01-04,SIC,8445,4218,4227,8400,0,45,ITG,ITG1,19,Sicilia,Sicilia,4999891,391076,7.82,0.17
3835,2021-01-18,SIC,1599,656,943,1431,157,11,ITG,ITG1,19,Sicilia,Sicilia,4999891,392675,7.85,0.03
3836,2021-04-28,SIC,29277,13719,15558,19731,9158,388,ITG,ITG1,19,Sicilia,Sicilia,4999891,421952,8.44,0.59
3837,2021-02-13,SIC,2978,1123,1855,2687,255,36,ITG,ITG1,19,Sicilia,Sicilia,4999891,424930,8.5,0.06
3838,2021-05-24,SIC,35872,17437,18435,15589,20050,233,ITG,ITG1,19,Sicilia,Sicilia,4999891,460802,9.22,0.72
3839,2021-05-17,SIC,31902,15396,16506,18998,12618,286,ITG,ITG1,19,Sicilia,Sicilia,4999891,492704,9.85,0.64
3840,2021-03-21,SIC,15217,7340,7877,11180,3969,68,ITG,ITG1,19,Sicilia,Sicilia,4999891,507921,10.16,0.3
3841,2021-05-31,SIC,38089,17149,20940,21275,16517,297,ITG,ITG1,19,Sicilia,Sicilia,4999891,546010,10.92,0.76
3842,2021-06-24,SIC,42323,19647,22676,17617,24349,357,ITG,ITG1,19,Sicilia,Sicilia,4999891,588333,11.77,0.85
3843,2021-06-07,SIC,49680,23411,26269,41116,8035,529,ITG,ITG1,19,Sicilia,Sicilia,4999891,638013,12.76,0.99
3844,2021-01-25,SIC,7441,3683,3758,278,7156,7,ITG,ITG1,19,Sicilia,Sicilia,4999891,645454,12.91,0.15
3845,2021-05-05,SIC,26310,12190,14120,16252,9629,429,ITG,ITG1,19,Sicilia,Sicilia,4999891,671764,13.44,0.53
3846,2021-05-19,SIC,42860,20762,22098,28187,14304,369,ITG,ITG1,19,Sicilia,Sicilia,4999891,714624,14.29,0.86
3847,2021-07-27,SIC,43278,21473,21805,19254,23564,460,ITG,ITG1,19,Sicilia,Sicilia,4999891,757902,15.16,0.87
3848,2021-01-30,SIC,7732,3553,4179,160,7570,2,ITG,ITG1,19,Sicilia,Sicilia,4999891,765634,15.31,0.15
3849,2021-03-28,SIC,10979,5146,5833,6902,4011,66,ITG,ITG1,19,Sicilia,Sicilia,4999891,776613,15.53,0.22
3850,2021-07-15,SIC,48333,22439,25894,7984,40088,261,ITG,ITG1,19,Sicilia,Sicilia,4999891,824946,16.5,0.97
3851,2021-02-23,SIC,8746,4635,4111,8199,466,81,ITG,ITG1,19,Sicilia,Sicilia,4999891,833692,16.67,0.17
3852,2021-03-09,SIC,13157,5764,7393,10832,2200,125,ITG,ITG1,19,Sicilia,Sicilia,4999891,846849,16.94,0.26
3853,2021-01-11,SIC,5904,2607,3297,5846,0,58,ITG,ITG1,19,Sicilia,Sicilia,4999891,852753,17.06,0.12
3854,2021-04-16,SIC,28848,14491,14357,20251,8293,304,ITG,ITG1,19,Sicilia,Sicilia,4999891,881601,17.63,0.58
3855,2021-01-23,SIC,4447,2289,2158,190,4247,10,ITG,ITG1,19,Sicilia,Sicilia,4999891,886048,17.72,0.09
3856,2021-01-06,SIC,6251,3291,2960,6191,0,60,ITG,ITG1,19,Sicilia,Sicilia,4999891,892299,17.85,0.13
3857,2021-04-02,SIC,13885,6548,7337,9043,4734,108,ITG,ITG1,19,Sicilia,Sicilia,4999891,906184,18.12,0.28
3858,2021-02-10,SIC,4354,1776,2578,3888,381,85,ITG,ITG1,19,Sicilia,Sicilia,4999891,910538,18.21,0.09
3859,2021-05-21,SIC,48674,23062,25612,26659,21594,421,ITG,ITG1,19,Sicilia,Sicilia,4999891,959212,19.18,0.97
3860,2021-03-04,SIC,15229,6690,8539,10985,4118,126,ITG,ITG1,19,Sicilia,Sicilia,4999891,974441,19.49,0.3
3861,2021-06-12,SIC,45784,22396,23388,39370,5889,525,ITG,ITG1,19,Sicilia,Sicilia,4999891,1020225,20.4,0.92
3862,2021-05-07,SIC,36563,17262,19301,24617,11614,332,ITG,ITG1,19,Sicilia,Sicilia,4999891,1056788,21.14,0.73
3863,2021-03-11,SIC,15438,6702,8736,12875,2418,145,ITG,ITG1,19,Sicilia,Sicilia,4999891,1072226,21.44,0.31
3864,2021-01-27,SIC,7293,3713,3580,174,7118,1,ITG,ITG1,19,Sicilia,Sicilia,4999891,1079519,21.59,0.15
3865,2021-01-13,SIC,5181,2441,2740,5147,0,34,ITG,ITG1,19,Sicilia,Sicilia,4999891,1084700,21.69,0.1
3866,2020-12-28,SIC,219,133,86,218,0,1,ITG,ITG1,19,Sicilia,Sicilia,4999891,1084919,21.7,0.0
3867,2021-02-06,SIC,4701,2099,2602,1444,3236,21,ITG,ITG1,19,Sicilia,Sicilia,4999891,1089620,21.79,0.09
3868,2021-02-04,SIC,6754,3077,3677,1423,5302,29,ITG,ITG1,19,Sicilia,Sicilia,4999891,1096374,21.93,0.14
3869,2021-01-01,SIC,820,439,381,816,0,4,ITG,ITG1,19,Sicilia,Sicilia,4999891,1097194,21.94,0.02
3870,2021-04-20,SIC,18992,9003,9989,13453,5248,291,ITG,ITG1,19,Sicilia,Sicilia,4999891,1116186,22.32,0.38
3871,2021-02-18,SIC,5332,3139,2193,4837,430,65,ITG,ITG1,19,Sicilia,Sicilia,4999891,1121518,22.43,0.11
3872,2021-05-12,SIC,36827,17366,19461,21390,14917,520,ITG,ITG1,19,Sicilia,Sicilia,4999891,1158345,23.17,0.74
3873,2021-07-17,SIC,49306,24288,25018,9316,39691,299,ITG,ITG1,19,Sicilia,Sicilia,4999891,1207651,24.15,0.99
3874,2021-04-08,SIC,18077,8897,9180,8766,9154,157,ITG,ITG1,19,Sicilia,Sicilia,4999891,1225728,24.52,0.36
3875,2021-04-04,SIC,6804,3321,3483,5449,1292,63,ITG,ITG1,19,Sicilia,Sicilia,4999891,1232532,24.65,0.14
3876,2021-07-13,SIC,46060,21148,24912,6894,38952,214,ITG,ITG1,19,Sicilia,Sicilia,4999891,1278592,25.57,0.92
3877,2021-06-04,SIC,57852,26761,31091,45405,11946,501,ITG,ITG1,19,Sicilia,Sicilia,4999891,1336444,26.73,1.16
3878,2021-03-16,SIC,9621,4322,5299,3556,5996,69,ITG,ITG1,19,Sicilia,Sicilia,4999891,1346065,26.92,0.19
3879,2021-07-08,SIC,38352,17471,20881,6532,31602,218,ITG,ITG1,19,Sicilia,Sicilia,4999891,1384417,27.69,0.77
3880,2021-02-27,SIC,12234,5501,6733,10934,1204,96,ITG,ITG1,19,Sicilia,Sicilia,4999891,1396651,27.93,0.24
3881,2021-05-16,SIC,33699,16439,17260,21892,11514,293,ITG,ITG1,19,Sicilia,Sicilia,4999891,1430350,28.61,0.67
3882,2021-05-02,SIC,24604,11429,13175,17705,6601,298,ITG,ITG1,19,Sicilia,Sicilia,4999891,1454954,29.1,0.49
3883,2021-03-20,SIC,18587,8978,9609,13362,5138,87,ITG,ITG1,19,Sicilia,Sicilia,4999891,1473541,29.47,0.37
3884,2021-06-28,SIC,31907,14859,17048,14885,16731,291,ITG,ITG1,19,Sicilia,Sicilia,4999891,1505448,30.11,0.64
3885,2021-04-01,SIC,14296,6618,7678,9495,4666,135,ITG,ITG1,19,Sicilia,Sicilia,4999891,1519744,30.4,0.29
3886,2021-07-10,SIC,46895,22349,24546,6058,40634,203,ITG,ITG1,19,Sicilia,Sicilia,4999891,1566639,31.33,0.94
3887,2021-06-23,SIC,44475,20698,23777,17905,26235,335,ITG,ITG1,19,Sicilia,Sicilia,4999891,1611114,32.22,0.89
3888,2021-06-16,SIC,40401,18787,21614,21240,18804,357,ITG,ITG1,19,Sicilia,Sicilia,4999891,1651515,33.03,0.81
3889,2021-03-25,SIC,20461,9530,10931,14747,5544,170,ITG,ITG1,19,Sicilia,Sicilia,4999891,1671976,33.44,0.41
3890,2021-07-03,SIC,33900,16290,17610,9036,24625,239,ITG,ITG1,19,Sicilia,Sicilia,4999891,1705876,34.12,0.68
3891,2021-03-06,SIC,12639,5058,7581,9759,2782,98,ITG,ITG1,19,Sicilia,Sicilia,4999891,1718515,34.37,0.25
3892,2021-06-14,SIC,43478,20652,22826,28163,14890,425,ITG,ITG1,19,Sicilia,Sicilia,4999891,1761993,35.24,0.87
3893,2021-05-28,SIC,51248,22978,28270,24311,26521,416,ITG,ITG1,19,Sicilia,Sicilia,4999891,1813241,36.27,1.02
3894,2021-02-19,SIC,4979,2695,2284,4331,564,84,ITG,ITG1,19,Sicilia,Sicilia,4999891,1818220,36.37,0.1
3895,2021-03-08,SIC,13496,5953,7543,10767,2613,116,ITG,ITG1,19,Sicilia,Sicilia,4999891,1831716,36.64,0.27
3896,2021-05-30,SIC,35765,16170,19595,17423,18046,296,ITG,ITG1,19,Sicilia,Sicilia,4999891,1867481,37.35,0.72
3897,2021-05-13,SIC,47457,22254,25203,30297,16539,621,ITG,ITG1,19,Sicilia,Sicilia,4999891,1914938,38.3,0.95
3898,2021-01-31,SIC,4060,1941,2119,110,3948,2,ITG,ITG1,19,Sicilia,Sicilia,4999891,1918998,38.38,0.08
3899,2021-05-11,SIC,32679,15500,17179,19696,12490,493,ITG,ITG1,19,Sicilia,Sicilia,4999891,1951677,39.03,0.65
3900,2021-02-17,SIC,5218,3203,2015,4501,671,46,ITG,ITG1,19,Sicilia,Sicilia,4999891,1956895,39.14,0.1
3901,2021-04-24,SIC,31142,14698,16444,23120,7632,390,ITG,ITG1,19,Sicilia,Sicilia,4999891,1988037,39.76,0.62
3902,2021-02-20,SIC,7139,3692,3447,6801,241,97,ITG,ITG1,19,Sicilia,Sicilia,4999891,1995176,39.9,0.14
3903,2021-02-03,SIC,5936,2787,3149,714,5214,8,ITG,ITG1,19,Sicilia,Sicilia,4999891,2001112,40.02,0.12
3904,2021-04-27,SIC,26422,12672,13750,15168,10926,328,ITG,ITG1,19,Sicilia,Sicilia,4999891,2027534,40.55,0.53
3905,2021-05-14,SIC,52183,24467,27716,35759,15669,755,ITG,ITG1,19,Sicilia,Sicilia,4999891,2079717,41.6,1.04
3906,2021-01-20,SIC,963,511,452,690,270,3,ITG,ITG1,19,Sicilia,Sicilia,4999891,2080680,41.61,0.02
3907,2021-03-18,SIC,15366,7719,7647,9742,5573,51,ITG,ITG1,19,Sicilia,Sicilia,4999891,2096046,41.92,0.31
3908,2021-07-05,SIC,37508,17605,19903,8917,28359,232,ITG,ITG1,19,Sicilia,Sicilia,4999891,2133554,42.67,0.75
3909,2021-06-21,SIC,40250,18634,21616,18427,21495,328,ITG,ITG1,19,Sicilia,Sicilia,4999891,2173804,43.48,0.81
3910,2021-05-09,SIC,28411,13309,15102,19774,8288,349,ITG,ITG1,19,Sicilia,Sicilia,4999891,2202215,44.05,0.57
3911,2021-02-05,SIC,6744,2982,3762,2089,4617,38,ITG,ITG1,19,Sicilia,Sicilia,4999891,2208959,44.18,0.13
3912,2021-04-03,SIC,16414,7817,8597,13421,2835,158,ITG,ITG1,19,Sicilia,Sicilia,4999891,2225373,44.51,0.33
3913,2021-03-27,SIC,15656,7378,8278,10684,4852,120,ITG,ITG1,19,Sicilia,Sicilia,4999891,2241029,44.82,0.31
3914,2021-04-06,SIC,17744,8480,9264,13259,4283,202,ITG,ITG1,19,Sicilia,Sicilia,4999891,2258773,45.18,0.35
3915,2021-02-22,SIC,7949,4134,3815,7376,493,80,ITG,ITG1,19,Sicilia,Sicilia,4999891,2266722,45.34,0.16
3916,2020-12-27,SIC,92,55,37,91,0,1,ITG,ITG1,19,Sicilia,Sicilia,4999891,2266814,45.34,0.0
3917,2021-06-02,SIC,35280,16298,18982,27108,7778,394,ITG,ITG1,19,Sicilia,Sicilia,4999891,2302094,46.04,0.71
3918,2021-03-01,SIC,12761,6070,6691,10980,1657,124,ITG,ITG1,19,Sicilia,Sicilia,4999891,2314855,46.3,0.26
3919,2021-06-09,SIC,49776,23676,26100,41913,7255,608,ITG,ITG1,19,Sicilia,Sicilia,4999891,2364631,47.29,1.0
3920,2021-01-19,SIC,1511,668,843,1264,233,14,ITG,ITG1,19,Sicilia,Sicilia,4999891,2366142,47.32,0.03
3921,2021-07-12,SIC,48994,22611,26383,6451,42348,195,ITG,ITG1,19,Sicilia,Sicilia,4999891,2415136,48.3,0.98
3922,2021-02-08,SIC,3887,1680,2207,2080,1758,49,ITG,ITG1,19,Sicilia,Sicilia,4999891,2419023,48.38,0.08
3923,2021-01-22,SIC,1289,641,648,261,1026,2,ITG,ITG1,19,Sicilia,Sicilia,4999891,2420312,48.41,0.03
3924,2021-01-08,SIC,8133,3788,4345,8044,0,89,ITG,ITG1,19,Sicilia,Sicilia,4999891,2428445,48.57,0.16
3925,2021-04-18,SIC,19827,9914,9913,15286,4361,180,ITG,ITG1,19,Sicilia,Sicilia,4999891,2448272,48.97,0.4
3926,2021-04-26,SIC,21674,10262,11412,13287,8080,307,ITG,ITG1,19,Sicilia,Sicilia,4999891,2469946,49.4,0.43
3927,2021-02-02,SIC,5288,2479,2809,617,4661,10,ITG,ITG1,19,Sicilia,Sicilia,4999891,2475234,49.51,0.11
3928,2021-07-18,SIC,39265,19779,19486,8103,30933,229,ITG,ITG1,19,Sicilia,Sicilia,4999891,2514499,50.29,0.79
3929,2021-01-14,SIC,5253,2485,2768,5191,0,62,ITG,ITG1,19,Sicilia,Sicilia,4999891,2519752,50.4,0.11
3930,2021-06-11,SIC,49960,23841,26119,41603,7702,655,ITG,ITG1,19,Sicilia,Sicilia,4999891,2569712,51.4,1.0
3931,2021-04-29,SIC,31800,14835,16965,21803,9558,439,ITG,ITG1,19,Sicilia,Sicilia,4999891,2601512,52.03,0.64
3932,2021-03-03,SIC,14564,6545,8019,11373,3067,124,ITG,ITG1,19,Sicilia,Sicilia,4999891,2616076,52.32,0.29
3933,2021-02-24,SIC,9376,4804,4572,8706,565,105,ITG,ITG1,19,Sicilia,Sicilia,4999891,2625452,52.51,0.19
3934,2021-01-21,SIC,1448,711,737,490,947,11,ITG,ITG1,19,Sicilia,Sicilia,4999891,2626900,52.54,0.03
3935,2021-05-01,SIC,24443,11313,13130,19003,5165,275,ITG,ITG1,19,Sicilia,Sicilia,4999891,2651343,53.03,0.49
3936,2021-03-30,SIC,14565,6762,7803,9702,4767,96,ITG,ITG1,19,Sicilia,Sicilia,4999891,2665908,53.32,0.29
3937,2021-03-13,SIC,12212,5387,6825,7628,4493,91,ITG,ITG1,19,Sicilia,Sicilia,4999891,2678120,53.56,0.24
3938,2021-04-17,SIC,25999,13151,12848,18669,7064,266,ITG,ITG1,19,Sicilia,Sicilia,4999891,2704119,54.08,0.52
3939,2021-07-26,SIC,44489,22171,22318,16687,27436,366,ITG,ITG1,19,Sicilia,Sicilia,4999891,2748608,54.97,0.89
3940,2021-03-17,SIC,15056,7440,7616,9085,5846,125,ITG,ITG1,19,Sicilia,Sicilia,4999891,2763664,55.27,0.3
3941,2021-06-25,SIC,39792,18677,21115,17388,22067,337,ITG,ITG1,19,Sicilia,Sicilia,4999891,2803456,56.07,0.8
3942,2021-07-09,SIC,44797,20670,24127,6407,38216,174,ITG,ITG1,19,Sicilia,Sicilia,4999891,2848253,56.97,0.9
3943,2021-02-07,SIC,2321,982,1339,664,1648,9,ITG,ITG1,19,Sicilia,Sicilia,4999891,2850574,57.01,0.05
3944,2021-07-14,SIC,47481,21994,25487,7925,39302,254,ITG,ITG1,19,Sicilia,Sicilia,4999891,2898055,57.96,0.95
3945,2021-05-18,SIC,36113,17385,18728,23243,12474,396,ITG,ITG1,19,Sicilia,Sicilia,4999891,2934168,58.68,0.72
3946,2021-07-21,SIC,42914,20945,21969,10630,31975,309,ITG,ITG1,19,Sicilia,Sicilia,4999891,2977082,59.54,0.86
3947,2021-07-07,SIC,35435,16210,19225,6059,29139,237,ITG,ITG1,19,Sicilia,Sicilia,4999891,3012517,60.25,0.71
3948,2021-05-25,SIC,33544,15422,18122,13938,19348,258,ITG,ITG1,19,Sicilia,Sicilia,4999891,3046061,60.92,0.67
3949,2021-03-29,SIC,15034,7076,7958,10399,4497,138,ITG,ITG1,19,Sicilia,Sicilia,4999891,3061095,61.22,0.3
3950,2021-01-24,SIC,4327,2263,2064,130,4195,2,ITG,ITG1,19,Sicilia,Sicilia,4999891,3065422,61.31,0.09
3951,2021-05-04,SIC,26845,12471,14374,17157,9292,396,ITG,ITG1,19,Sicilia,Sicilia,4999891,3092267,61.85,0.54
3952,2021-01-15,SIC,5271,2304,2967,5204,0,67,ITG,ITG1,19,Sicilia,Sicilia,4999891,3097538,61.95,0.11
3953,2021-04-25,SIC,21398,10206,11192,16154,5015,229,ITG,ITG1,19,Sicilia,Sicilia,4999891,3118936,62.38,0.43
3954,2021-02-01,SIC,5907,2626,3281,302,5592,13,ITG,ITG1,19,Sicilia,Sicilia,4999891,3124843,62.5,0.12
3955,2021-03-22,SIC,16679,7915,8764,11164,5423,92,ITG,ITG1,19,Sicilia,Sicilia,4999891,3141522,62.83,0.33
3956,2021-06-30,SIC,32548,15010,17538,11398,20832,318,ITG,ITG1,19,Sicilia,Sicilia,4999891,3174070,63.48,0.65
3957,2020-12-29,SIC,244,152,92,244,0,0,ITG,ITG1,19,Sicilia,Sicilia,4999891,3174314,63.49,0.0
3958,2021-06-13,SIC,34541,17161,17380,30603,3506,432,ITG,ITG1,19,Sicilia,Sicilia,4999891,3208855,64.18,0.69
3959,2021-04-10,SIC,20437,9973,10464,11312,8965,160,ITG,ITG1,19,Sicilia,Sicilia,4999891,3229292,64.59,0.41
3960,2021-01-17,SIC,1310,596,714,1238,63,9,ITG,ITG1,19,Sicilia,Sicilia,4999891,3230602,64.61,0.03
3961,2021-07-02,SIC,30538,14220,16318,9921,20335,282,ITG,ITG1,19,Sicilia,Sicilia,4999891,3261140,65.22,0.61
3962,2021-07-19,SIC,48876,23527,25349,11649,36872,355,ITG,ITG1,19,Sicilia,Sicilia,4999891,3310016,66.2,0.98
3963,2021-07-06,SIC,37082,17146,19936,10280,26502,300,ITG,ITG1,19,Sicilia,Sicilia,4999891,3347098,66.94,0.74
3964,2021-05-10,SIC,28731,13791,14940,16233,12213,285,ITG,ITG1,19,Sicilia,Sicilia,4999891,3375829,67.52,0.57
3965,2021-03-26,SIC,17992,8357,9635,12353,5499,140,ITG,ITG1,19,Sicilia,Sicilia,4999891,3393821,67.88,0.36
3966,2021-01-28,SIC,9036,4273,4763,382,8653,1,ITG,ITG1,19,Sicilia,Sicilia,4999891,3402857,68.06,0.18
3967,2021-07-04,SIC,26493,12795,13698,7606,18718,169,ITG,ITG1,19,Sicilia,Sicilia,4999891,3429350,68.59,0.53
3968,2021-05-08,SIC,35636,17030,18606,24974,10302,360,ITG,ITG1,19,Sicilia,Sicilia,4999891,3464986,69.3,0.71
3969,2021-01-29,SIC,9184,4257,4927,411,8761,12,ITG,ITG1,19,Sicilia,Sicilia,4999891,3474170,69.48,0.18
3970,2021-02-12,SIC,4586,1811,2775,4242,266,78,ITG,ITG1,19,Sicilia,Sicilia,4999891,3478756,69.58,0.09
3971,2021-05-23,SIC,34088,16595,17493,19843,14015,230,ITG,ITG1,19,Sicilia,Sicilia,4999891,3512844,70.26,0.68
3972,2021-06-10,SIC,53017,24889,28128,45147,7220,650,ITG,ITG1,19,Sicilia,Sicilia,4999891,3565861,71.32,1.06
3973,2021-05-27,SIC,47573,21905,25668,24463,22696,414,ITG,ITG1,19,Sicilia,Sicilia,4999891,3613434,72.27,0.95
3974,2021-04-14,SIC,20572,9936,10636,11628,8759,185,ITG,ITG1,19,Sicilia,Sicilia,4999891,3634006,72.68,0.41
3975,2021-07-23,SIC,41402,20773,20629,14339,26742,321,ITG,ITG1,19,Sicilia,Sicilia,4999891,3675408,73.51,0.83
3976,2021-06-06,SIC,49524,23918,25606,41145,7823,556,ITG,ITG1,19,Sicilia,Sicilia,4999891,3724932,74.5,0.99
3977,2021-02-26,SIC,11978,5875,6103,10182,1683,113,ITG,ITG1,19,Sicilia,Sicilia,4999891,3736910,74.74,0.24
3978,2021-05-06,SIC,29470,14008,15462,18168,10830,472,ITG,ITG1,19,Sicilia,Sicilia,4999891,3766380,75.33,0.59
3979,2021-04-21,SIC,22387,10746,11641,15996,6121,270,ITG,ITG1,19,Sicilia,Sicilia,4999891,3788767,75.78,0.45
3980,2021-04-07,SIC,16154,7973,8181,8451,7524,179,ITG,ITG1,19,Sicilia,Sicilia,4999891,3804921,76.1,0.32
3981,2021-07-16,SIC,49250,23296,25954,8712,40257,281,ITG,ITG1,19,Sicilia,Sicilia,4999891,3854171,77.09,0.99
3982,2021-07-30,SIC,31892,15781,16111,11834,19795,263,ITG,ITG1,19,Sicilia,Sicilia,4999891,3886063,77.72,0.64
3983,2021-06-03,SIC,45995,21096,24899,33766,11714,515,ITG,ITG1,19,Sicilia,Sicilia,4999891,3932058,78.64,0.92
3984,2021-03-05,SIC,15761,6838,8923,11379,4236,146,ITG,ITG1,19,Sicilia,Sicilia,4999891,3947819,78.96,0.32
3985,2021-02-16,SIC,4201,2207,1994,3665,465,71,ITG,ITG1,19,Sicilia,Sicilia,4999891,3952020,79.04,0.08
3986,2021-06-17,SIC,41827,19477,22350,20322,21139,366,ITG,ITG1,19,Sicilia,Sicilia,4999891,3993847,79.88,0.84
3987,2020-12-31,SIC,891,474,417,883,0,8,ITG,ITG1,19,Sicilia,Sicilia,4999891,3994738,79.9,0.02
3988,2021-03-07,SIC,9259,3454,5805,8116,1083,60,ITG,ITG1,19,Sicilia,Sicilia,4999891,4003997,80.08,0.19
3989,2021-06-15,SIC,46179,21760,24419,28228,17520,431,ITG,ITG1,19,Sicilia,Sicilia,4999891,4050176,81.01,0.92
3990,2021-03-24,SIC,20966,9869,11097,15038,5737,191,ITG,ITG1,19,Sicilia,Sicilia,4999891,4071142,81.42,0.42
3991,2021-05-29,SIC,47170,21461,25709,23529,23194,447,ITG,ITG1,19,Sicilia,Sicilia,4999891,4118312,82.37,0.94
3992,2021-03-15,SIC,10676,4727,5949,5648,4950,78,ITG,ITG1,19,Sicilia,Sicilia,4999891,4128988,82.58,0.21
3993,2021-01-26,SIC,9574,4739,4835,240,9333,1,ITG,ITG1,19,Sicilia,Sicilia,4999891,4138562,82.77,0.19
3994,2021-06-01,SIC,38986,17721,21265,24598,14038,350,ITG,ITG1,19,Sicilia,Sicilia,4999891,4177548,83.55,0.78
3995,2021-04-05,SIC,8015,3954,4061,6511,1440,64,ITG,ITG1,19,Sicilia,Sicilia,4999891,4185563,83.71,0.16
3996,2021-04-12,SIC,19002,9210,9792,11487,7274,241,ITG,ITG1,19,Sicilia,Sicilia,4999891,4204565,84.09,0.38
3997,2021-02-14,SIC,1055,402,653,907,140,8,ITG,ITG1,19,Sicilia,Sicilia,4999891,4205620,84.11,0.02
3998,2021-01-02,SIC,4862,2535,2327,4832,0,30,ITG,ITG1,19,Sicilia,Sicilia,4999891,4210482,84.21,0.1
3999,2021-02-21,SIC,5168,2501,2667,5047,106,15,ITG,ITG1,19,Sicilia,Sicilia,4999891,4215650,84.31,0.1
4000,2021-03-31,SIC,14519,6706,7813,9447,4932,140,ITG,ITG1,19,Sicilia,Sicilia,4999891,4230169,84.61,0.29
4001,2021-01-07,SIC,8953,4140,4813,8873,0,80,ITG,ITG1,19,Sicilia,Sicilia,4999891,4239122,84.78,0.18
4002,2021-07-28,SIC,37570,18837,18733,14628,22624,318,ITG,ITG1,19,Sicilia,Sicilia,4999891,4276692,85.54,0.75
4003,2021-06-22,SIC,39975,18371,21604,18296,21305,374,ITG,ITG1,19,Sicilia,Sicilia,4999891,4316667,86.34,0.8
4004,2021-05-22,SIC,48011,22806,25205,28303,19311,397,ITG,ITG1,19,Sicilia,Sicilia,4999891,4364678,87.3,0.96
4005,2021-02-28,SIC,7166,3062,4104,6485,630,51,ITG,ITG1,19,Sicilia,Sicilia,4999891,4371844,87.44,0.14
4006,2021-06-08,SIC,47697,22401,25296,40457,6707,533,ITG,ITG1,19,Sicilia,Sicilia,4999891,4419541,88.39,0.95
4007,2021-02-09,SIC,4347,1799,2548,3247,1035,65,ITG,ITG1,19,Sicilia,Sicilia,4999891,4423888,88.48,0.09
4008,2021-05-20,SIC,44065,21115,22950,27737,15914,414,ITG,ITG1,19,Sicilia,Sicilia,4999891,4467953,89.36,0.88
4009,2021-01-09,SIC,7228,3408,3820,7168,0,60,ITG,ITG1,19,Sicilia,Sicilia,4999891,4475181,89.51,0.14
4010,2021-05-03,SIC,23298,10790,12508,13256,9788,254,ITG,ITG1,19,Sicilia,Sicilia,4999891,4498479,89.97,0.47
4011,2021-07-11,SIC,36030,16868,19162,3663,32272,95,ITG,ITG1,19,Sicilia,Sicilia,4999891,4534509,90.69,0.72
4012,2021-07-25,SIC,31799,16758,15041,11847,19696,256,ITG,ITG1,19,Sicilia,Sicilia,4999891,4566308,91.33,0.64
4013,2021-04-19,SIC,18284,8664,9620,12478,5581,225,ITG,ITG1,19,Sicilia,Sicilia,4999891,4584592,91.69,0.37
4014,2021-07-29,SIC,33929,16766,17163,13501,20110,318,ITG,ITG1,19,Sicilia,Sicilia,4999891,4618521,92.37,0.68
4015,2021-07-24,SIC,40721,21201,19520,16799,23620,302,ITG,ITG1,19,Sicilia,Sicilia,4999891,4659242,93.19,0.81
4016,2021-02-15,SIC,3730,1733,1997,3092,564,74,ITG,ITG1,19,Sicilia,Sicilia,4999891,4662972,93.26,0.07
4017,2021-07-22,SIC,40594,19939,20655,11221,29084,289,ITG,ITG1,19,Sicilia,Sicilia,4999891,4703566,94.07,0.81
4018,2021-05-26,SIC,44695,21017,23678,23899,20452,344,ITG,ITG1,19,Sicilia,Sicilia,4999891,4748261,94.97,0.89
4019,2021-01-03,SIC,4795,2504,2291,4765,0,30,ITG,ITG1,19,Sicilia,Sicilia,4999891,4753056,95.06,0.1
4020,2021-04-13,SIC,20240,9865,10375,11240,8836,164,ITG,ITG1,19,Sicilia,Sicilia,4999891,4773296,95.47,0.4
4021,2021-01-10,SIC,3559,1595,1964,3538,0,21,ITG,ITG1,19,Sicilia,Sicilia,4999891,4776855,95.54,0.07
4022,2021-01-05,SIC,10369,5095,5274,10293,0,76,ITG,ITG1,19,Sicilia,Sicilia,4999891,4787224,95.75,0.21
4023,2021-04-15,SIC,21553,10486,11067,12002,9343,208,ITG,ITG1,19,Sicilia,Sicilia,4999891,4808777,96.18,0.43
4024,2021-06-20,SIC,33412,15813,17599,15116,18037,259,ITG,ITG1,19,Sicilia,Sicilia,4999891,4842189,96.85,0.67
4025,2021-04-22,SIC,26736,12630,14106,19879,6458,399,ITG,ITG1,19,Sicilia,Sicilia,4999891,4868925,97.38,0.53
4026,2021-03-10,SIC,13931,6123,7808,11615,2183,133,ITG,ITG1,19,Sicilia,Sicilia,4999891,4882856,97.66,0.28
4027,2021-01-12,SIC,4360,2132,2228,4316,0,44,ITG,ITG1,19,Sicilia,Sicilia,4999891,4887216,97.75,0.09
4028,2021-06-18,SIC,43579,20140,23439,18847,24363,369,ITG,ITG1,19,Sicilia,Sicilia,4999891,4930795,98.62,0.87
4029,2021-06-27,SIC,25303,12199,13104,12101,12976,226,ITG,ITG1,19,Sicilia,Sicilia,4999891,4956098,99.12,0.51
4030,2021-05-15,SIC,56488,26390,30098,40351,15243,894,ITG,ITG1,19,Sicilia,Sicilia,4999891,5012586,100.25,1.13
4031,2021-03-19,SIC,16310,8052,8258,10649,5573,88,ITG,ITG1,19,Sicilia,Sicilia,4999891,5028896,100.58,0.33
4032,2021-03-12,SIC,12866,5560,7306,10648,2067,151,ITG,ITG1,19,Sicilia,Sicilia,4999891,5041762,100.84,0.26
4033,2021-06-29,SIC,31353,14683,16670,15646,15309,398,ITG,ITG1,19,Sicilia,Sicilia,4999891,5073115,101.46,0.63
4034,2021-04-23,SAR,12872,5750,7122,7245,5486,141,ITG,ITG2,20,Sardegna,Sardegna,1639591,12872,0.79,0.79
4035,2021-05-10,SAR,9741,4341,5400,7033,2538,170,ITG,ITG2,20,Sardegna,Sardegna,1639591,22613,1.38,0.59
4036,2021-01-30,SAR,3868,1393,2475,363,3505,0,ITG,ITG2,20,Sardegna,Sardegna,1639591,26481,1.62,0.24
4037,2021-01-16,SAR,1491,525,966,1491,0,0,ITG,ITG2,20,Sardegna,Sardegna,1639591,27972,1.71,0.09
4038,2021-05-19,SAR,17041,8673,8368,12628,4254,159,ITG,ITG2,20,Sardegna,Sardegna,1639591,45013,2.75,1.04
4039,2021-06-05,SAR,17881,8438,9443,11286,6461,134,ITG,ITG2,20,Sardegna,Sardegna,1639591,62894,3.84,1.09
4040,2021-02-25,SAR,2899,1256,1643,2264,604,31,ITG,ITG2,20,Sardegna,Sardegna,1639591,65793,4.01,0.18
4041,2021-03-14,SAR,605,377,228,596,0,9,ITG,ITG2,20,Sardegna,Sardegna,1639591,66398,4.05,0.04
4042,2021-03-09,SAR,5531,2740,2791,4746,728,57,ITG,ITG2,20,Sardegna,Sardegna,1639591,71929,4.39,0.34
4043,2021-05-05,SAR,10180,4652,5528,7954,2029,197,ITG,ITG2,20,Sardegna,Sardegna,1639591,82109,5.01,0.62
4044,2021-04-09,SAR,12312,5474,6838,7830,4359,123,ITG,ITG2,20,Sardegna,Sardegna,1639591,94421,5.76,0.75
4045,2021-07-20,SAR,16145,7929,8216,3651,12404,90,ITG,ITG2,20,Sardegna,Sardegna,1639591,110566,6.74,0.98
4046,2021-04-11,SAR,5398,2444,2954,4251,1121,26,ITG,ITG2,20,Sardegna,Sardegna,1639591,115964,7.07,0.33
4047,2021-06-07,SAR,12563,6143,6420,9437,3004,122,ITG,ITG2,20,Sardegna,Sardegna,1639591,128527,7.84,0.77
4048,2021-02-04,SAR,2270,814,1456,910,1357,3,ITG,ITG2,20,Sardegna,Sardegna,1639591,130797,7.98,0.14
4049,2021-04-02,SAR,8985,3549,5436,5591,3244,150,ITG,ITG2,20,Sardegna,Sardegna,1639591,139782,8.53,0.55
4050,2021-06-19,SAR,15344,7515,7829,9122,6123,99,ITG,ITG2,20,Sardegna,Sardegna,1639591,155126,9.46,0.94
4051,2021-07-06,SAR,15928,7722,8206,4665,11167,96,ITG,ITG2,20,Sardegna,Sardegna,1639591,171054,10.43,0.97
4052,2021-03-28,SAR,4536,1794,2742,4393,78,65,ITG,ITG2,20,Sardegna,Sardegna,1639591,175590,10.71,0.28
4053,2021-01-04,SAR,587,215,372,587,0,0,ITG,ITG2,20,Sardegna,Sardegna,1639591,176177,10.75,0.04
4054,2021-07-01,SAR,19833,9763,10070,7257,12484,92,ITG,ITG2,20,Sardegna,Sardegna,1639591,196010,11.95,1.21
4055,2021-03-23,SAR,6417,2884,3533,5179,1080,158,ITG,ITG2,20,Sardegna,Sardegna,1639591,202427,12.35,0.39
4056,2021-07-15,SAR,18778,9238,9540,4647,14032,99,ITG,ITG2,20,Sardegna,Sardegna,1639591,221205,13.49,1.15
4057,2021-05-12,SAR,11138,5262,5876,7793,3139,206,ITG,ITG2,20,Sardegna,Sardegna,1639591,232343,14.17,0.68
4058,2021-02-11,SAR,1311,488,823,1200,111,0,ITG,ITG2,20,Sardegna,Sardegna,1639591,233654,14.25,0.08
4059,2021-05-24,SAR,14471,7257,7214,8355,5984,132,ITG,ITG2,20,Sardegna,Sardegna,1639591,248125,15.13,0.88
4060,2021-02-13,SAR,1446,562,884,1440,2,4,ITG,ITG2,20,Sardegna,Sardegna,1639591,249571,15.22,0.09
4061,2021-05-29,SAR,17993,8648,9345,13234,4592,167,ITG,ITG2,20,Sardegna,Sardegna,1639591,267564,16.32,1.1
4062,2021-03-02,SAR,3034,1630,1404,1814,1153,67,ITG,ITG2,20,Sardegna,Sardegna,1639591,270598,16.5,0.19
4063,2021-04-28,SAR,9017,4279,4738,5166,3704,147,ITG,ITG2,20,Sardegna,Sardegna,1639591,279615,17.05,0.55
4064,2021-01-18,SAR,903,324,579,779,124,0,ITG,ITG2,20,Sardegna,Sardegna,1639591,280518,17.11,0.06
4065,2021-06-24,SAR,19202,9216,9986,8122,10979,101,ITG,ITG2,20,Sardegna,Sardegna,1639591,299720,18.28,1.17
4066,2021-03-16,SAR,4398,1954,2444,3434,922,42,ITG,ITG2,20,Sardegna,Sardegna,1639591,304118,18.55,0.27
4067,2021-04-21,SAR,12072,5553,6519,6440,5534,98,ITG,ITG2,20,Sardegna,Sardegna,1639591,316190,19.28,0.74
4068,2021-01-11,SAR,1182,504,678,1181,0,1,ITG,ITG2,20,Sardegna,Sardegna,1639591,317372,19.36,0.07
4069,2021-06-12,SAR,14756,7194,7562,9938,4702,116,ITG,ITG2,20,Sardegna,Sardegna,1639591,332128,20.26,0.9
4070,2021-03-04,SAR,4366,2295,2071,3056,1256,54,ITG,ITG2,20,Sardegna,Sardegna,1639591,336494,20.52,0.27
4071,2021-03-21,SAR,4032,1810,2222,2572,1440,20,ITG,ITG2,20,Sardegna,Sardegna,1639591,340526,20.77,0.25
4072,2021-06-26,SAR,19140,9008,10132,5450,13615,75,ITG,ITG2,20,Sardegna,Sardegna,1639591,359666,21.94,1.17
4073,2021-05-07,SAR,14476,6637,7839,9720,4526,230,ITG,ITG2,20,Sardegna,Sardegna,1639591,374142,22.82,0.88
4074,2021-01-27,SAR,1414,498,916,78,1336,0,ITG,ITG2,20,Sardegna,Sardegna,1639591,375556,22.91,0.09
4075,2021-04-30,SAR,11137,5302,5835,6757,4206,174,ITG,ITG2,20,Sardegna,Sardegna,1639591,386693,23.58,0.68
4076,2021-05-17,SAR,12817,6260,6557,9126,3545,146,ITG,ITG2,20,Sardegna,Sardegna,1639591,399510,24.37,0.78
4077,2021-02-06,SAR,1973,700,1273,565,1405,3,ITG,ITG2,20,Sardegna,Sardegna,1639591,401483,24.49,0.12
4078,2021-02-23,SAR,1565,1043,522,1270,280,15,ITG,ITG2,20,Sardegna,Sardegna,1639591,403048,24.58,0.1
4079,2021-07-24,SAR,12385,6385,6000,1996,10362,27,ITG,ITG2,20,Sardegna,Sardegna,1639591,415433,25.34,0.76
4080,2021-05-02,SAR,5957,2694,3263,5214,651,92,ITG,ITG2,20,Sardegna,Sardegna,1639591,421390,25.7,0.36
4081,2021-07-13,SAR,17806,8524,9282,3253,14476,77,ITG,ITG2,20,Sardegna,Sardegna,1639591,439196,26.79,1.09
4082,2021-04-04,SAR,2,1,1,0,2,0,ITG,ITG2,20,Sardegna,Sardegna,1639591,439198,26.79,0.0
4083,2021-07-08,SAR,18444,8969,9475,3834,14526,84,ITG,ITG2,20,Sardegna,Sardegna,1639591,457642,27.91,1.12
4084,2021-07-25,SAR,4344,2143,2201,865,3464,15,ITG,ITG2,20,Sardegna,Sardegna,1639591,461986,28.18,0.26
4085,2021-04-16,SAR,14445,6489,7956,8941,5340,164,ITG,ITG2,20,Sardegna,Sardegna,1639591,476431,29.06,0.88
4086,2021-01-23,SAR,60,22,38,0,60,0,ITG,ITG2,20,Sardegna,Sardegna,1639591,476491,29.06,0.0
4087,2021-02-22,SAR,1638,948,690,1384,228,26,ITG,ITG2,20,Sardegna,Sardegna,1639591,478129,29.16,0.1
4088,2021-02-18,SAR,1877,731,1146,1775,64,38,ITG,ITG2,20,Sardegna,Sardegna,1639591,480006,29.28,0.11
4089,2021-05-31,SAR,11366,5409,5957,8157,3110,99,ITG,ITG2,20,Sardegna,Sardegna,1639591,491372,29.97,0.69
4090,2021-07-27,SAR,16476,8351,8125,4206,12160,110,ITG,ITG2,20,Sardegna,Sardegna,1639591,507848,30.97,1.0
4091,2021-04-18,SAR,5131,2225,2906,2230,2873,28,ITG,ITG2,20,Sardegna,Sardegna,1639591,512979,31.29,0.31
4092,2021-01-08,SAR,3257,1184,2073,3255,0,2,ITG,ITG2,20,Sardegna,Sardegna,1639591,516236,31.49,0.2
4093,2020-12-28,SAR,66,26,40,66,0,0,ITG,ITG2,20,Sardegna,Sardegna,1639591,516302,31.49,0.0
4094,2021-06-14,SAR,13751,6643,7108,9998,3611,142,ITG,ITG2,20,Sardegna,Sardegna,1639591,530053,32.33,0.84
4095,2021-03-06,SAR,2635,1078,1557,781,1781,73,ITG,ITG2,20,Sardegna,Sardegna,1639591,532688,32.49,0.16
4096,2021-06-28,SAR,14994,7042,7952,3051,11877,66,ITG,ITG2,20,Sardegna,Sardegna,1639591,547682,33.4,0.91
4097,2021-04-06,SAR,7457,3121,4336,4971,2428,58,ITG,ITG2,20,Sardegna,Sardegna,1639591,555139,33.86,0.45
4098,2020-12-27,SAR,65,34,31,65,0,0,ITG,ITG2,20,Sardegna,Sardegna,1639591,555204,33.86,0.0
4099,2021-06-17,SAR,18461,8531,9930,9918,8422,121,ITG,ITG2,20,Sardegna,Sardegna,1639591,573665,34.99,1.13
4100,2021-01-25,SAR,591,214,377,22,569,0,ITG,ITG2,20,Sardegna,Sardegna,1639591,574256,35.02,0.04
4101,2021-05-16,SAR,8221,3831,4390,5985,2160,76,ITG,ITG2,20,Sardegna,Sardegna,1639591,582477,35.53,0.5
4102,2021-07-12,SAR,15334,7413,7921,2403,12876,55,ITG,ITG2,20,Sardegna,Sardegna,1639591,597811,36.46,0.94
4103,2021-07-05,SAR,15584,7573,8011,3327,12208,49,ITG,ITG2,20,Sardegna,Sardegna,1639591,613395,37.41,0.95
4104,2021-01-13,SAR,574,178,396,574,0,0,ITG,ITG2,20,Sardegna,Sardegna,1639591,613969,37.45,0.04
4105,2021-07-17,SAR,12871,6301,6570,3179,9625,67,ITG,ITG2,20,Sardegna,Sardegna,1639591,626840,38.23,0.79
4106,2021-02-08,SAR,1468,533,935,852,615,1,ITG,ITG2,20,Sardegna,Sardegna,1639591,628308,38.32,0.09
4107,2021-01-20,SAR,210,77,133,208,2,0,ITG,ITG2,20,Sardegna,Sardegna,1639591,628518,38.33,0.01
4108,2021-03-29,SAR,4739,1847,2892,4071,591,77,ITG,ITG2,20,Sardegna,Sardegna,1639591,633257,38.62,0.29
4109,2021-04-15,SAR,11847,5539,6308,6778,4955,114,ITG,ITG2,20,Sardegna,Sardegna,1639591,645104,39.35,0.72
4110,2021-01-05,SAR,1321,443,878,1321,0,0,ITG,ITG2,20,Sardegna,Sardegna,1639591,646425,39.43,0.08
4111,2021-01-22,SAR,83,47,36,55,28,0,ITG,ITG2,20,Sardegna,Sardegna,1639591,646508,39.43,0.01
4112,2021-07-26,SAR,14597,7286,7311,4122,10399,76,ITG,ITG2,20,Sardegna,Sardegna,1639591,661105,40.32,0.89
4113,2021-04-17,SAR,10082,4502,5580,5403,4601,78,ITG,ITG2,20,Sardegna,Sardegna,1639591,671187,40.94,0.61
4114,2021-01-03,SAR,90,36,54,90,0,0,ITG,ITG2,20,Sardegna,Sardegna,1639591,671277,40.94,0.01
4115,2021-07-07,SAR,15906,7728,8178,4086,11769,51,ITG,ITG2,20,Sardegna,Sardegna,1639591,687183,41.91,0.97
4116,2021-03-11,SAR,6415,3085,3330,5147,1200,68,ITG,ITG2,20,Sardegna,Sardegna,1639591,693598,42.3,0.39
4117,2021-06-04,SAR,14491,6937,7554,9776,4558,157,ITG,ITG2,20,Sardegna,Sardegna,1639591,708089,43.19,0.88
4118,2021-06-21,SAR,14027,6736,7291,5129,8825,73,ITG,ITG2,20,Sardegna,Sardegna,1639591,722116,44.04,0.86
4119,2021-03-13,SAR,2756,1075,1681,2436,281,39,ITG,ITG2,20,Sardegna,Sardegna,1639591,724872,44.21,0.17
4120,2021-03-30,SAR,8758,3583,5175,6346,2274,138,ITG,ITG2,20,Sardegna,Sardegna,1639591,733630,44.74,0.53
4121,2021-01-06,SAR,1613,547,1066,1613,0,0,ITG,ITG2,20,Sardegna,Sardegna,1639591,735243,44.84,0.1
4122,2021-07-03,SAR,15841,7563,8278,3236,12574,31,ITG,ITG2,20,Sardegna,Sardegna,1639591,751084,45.81,0.97
4123,2021-03-25,SAR,9109,3971,5138,7687,1303,119,ITG,ITG2,20,Sardegna,Sardegna,1639591,760193,46.36,0.56
4124,2021-05-21,SAR,22642,11205,11437,16262,6100,280,ITG,ITG2,20,Sardegna,Sardegna,1639591,782835,47.75,1.38
4125,2021-03-18,SAR,7256,3074,4182,5575,1607,74,ITG,ITG2,20,Sardegna,Sardegna,1639591,790091,48.19,0.44
4126,2021-05-14,SAR,14573,6867,7706,10765,3645,163,ITG,ITG2,20,Sardegna,Sardegna,1639591,804664,49.08,0.89
4127,2021-02-03,SAR,1119,419,700,424,694,1,ITG,ITG2,20,Sardegna,Sardegna,1639591,805783,49.15,0.07
4128,2021-07-10,SAR,14233,6887,7346,2705,11495,33,ITG,ITG2,20,Sardegna,Sardegna,1639591,820016,50.01,0.87
4129,2021-02-05,SAR,1899,750,1149,430,1467,2,ITG,ITG2,20,Sardegna,Sardegna,1639591,821915,50.13,0.12
4130,2021-04-03,SAR,4676,1810,2866,2641,1970,65,ITG,ITG2,20,Sardegna,Sardegna,1639591,826591,50.41,0.29
4131,2021-05-30,SAR,9727,4836,4891,7300,2357,70,ITG,ITG2,20,Sardegna,Sardegna,1639591,836318,51.01,0.59
4132,2021-02-19,SAR,1498,471,1027,1398,56,44,ITG,ITG2,20,Sardegna,Sardegna,1639591,837816,51.1,0.09
4133,2021-03-27,SAR,5734,2191,3543,5225,422,87,ITG,ITG2,20,Sardegna,Sardegna,1639591,843550,51.45,0.35
4134,2021-05-23,SAR,9968,4808,5160,7626,2246,96,ITG,ITG2,20,Sardegna,Sardegna,1639591,853518,52.06,0.61
4135,2021-02-12,SAR,2236,933,1303,2172,59,5,ITG,ITG2,20,Sardegna,Sardegna,1639591,855754,52.19,0.14
4136,2021-07-19,SAR,14730,7394,7336,2705,11975,50,ITG,ITG2,20,Sardegna,Sardegna,1639591,870484,53.09,0.9
4137,2021-06-02,SAR,9787,4693,5094,8061,1640,86,ITG,ITG2,20,Sardegna,Sardegna,1639591,880271,53.69,0.6
4138,2021-07-29,SAR,16696,8364,8332,5966,10582,148,ITG,ITG2,20,Sardegna,Sardegna,1639591,896967,54.71,1.02
4139,2021-04-20,SAR,11004,4996,6008,7693,3219,92,ITG,ITG2,20,Sardegna,Sardegna,1639591,907971,55.38,0.67
4140,2021-02-20,SAR,2040,854,1186,1683,334,23,ITG,ITG2,20,Sardegna,Sardegna,1639591,910011,55.5,0.12
4141,2021-04-29,SAR,11120,5107,6013,6615,4353,152,ITG,ITG2,20,Sardegna,Sardegna,1639591,921131,56.18,0.68
4142,2021-06-25,SAR,16509,7809,8700,3897,12554,58,ITG,ITG2,20,Sardegna,Sardegna,1639591,937640,57.19,1.01
4143,2021-01-10,SAR,2177,748,1429,2177,0,0,ITG,ITG2,20,Sardegna,Sardegna,1639591,939817,57.32,0.13
4144,2021-04-25,SAR,4500,2271,2229,3674,780,46,ITG,ITG2,20,Sardegna,Sardegna,1639591,944317,57.59,0.27
4145,2021-01-15,SAR,1560,572,988,1558,0,2,ITG,ITG2,20,Sardegna,Sardegna,1639591,945877,57.69,0.1
4146,2021-02-01,SAR,1523,605,918,224,1299,0,ITG,ITG2,20,Sardegna,Sardegna,1639591,947400,57.78,0.09
4147,2021-05-09,SAR,6129,2875,3254,5117,925,87,ITG,ITG2,20,Sardegna,Sardegna,1639591,953529,58.16,0.37
4148,2021-05-26,SAR,15533,8189,7344,9702,5647,184,ITG,ITG2,20,Sardegna,Sardegna,1639591,969062,59.1,0.95
4149,2021-02-15,SAR,955,347,608,918,31,6,ITG,ITG2,20,Sardegna,Sardegna,1639591,970017,59.16,0.06
4150,2021-06-22,SAR,19340,8990,10350,7168,12071,101,ITG,ITG2,20,Sardegna,Sardegna,1639591,989357,60.34,1.18
4151,2021-07-09,SAR,15876,7600,8276,3433,12363,80,ITG,ITG2,20,Sardegna,Sardegna,1639591,1005233,61.31,0.97
4152,2021-03-31,SAR,10260,4149,6111,7705,2433,122,ITG,ITG2,20,Sardegna,Sardegna,1639591,1015493,61.94,0.63
4153,2021-07-02,SAR,18931,8890,10041,4406,14429,96,ITG,ITG2,20,Sardegna,Sardegna,1639591,1034424,63.09,1.15
4154,2021-04-27,SAR,7621,3556,4065,5478,2042,101,ITG,ITG2,20,Sardegna,Sardegna,1639591,1042045,63.56,0.46
4155,2021-01-17,SAR,859,277,582,858,1,0,ITG,ITG2,20,Sardegna,Sardegna,1639591,1042904,63.61,0.05
4156,2021-03-15,SAR,2797,1317,1480,2383,374,40,ITG,ITG2,20,Sardegna,Sardegna,1639591,1045701,63.78,0.17
4157,2021-07-04,SAR,8207,3988,4219,2069,6123,15,ITG,ITG2,20,Sardegna,Sardegna,1639591,1053908,64.28,0.5
4158,2021-03-26,SAR,8463,3517,4946,6811,1529,123,ITG,ITG2,20,Sardegna,Sardegna,1639591,1062371,64.79,0.52
4159,2021-03-20,SAR,5195,2076,3119,2891,2277,27,ITG,ITG2,20,Sardegna,Sardegna,1639591,1067566,65.11,0.32
4160,2021-06-13,SAR,9500,4676,4824,6160,3260,80,ITG,ITG2,20,Sardegna,Sardegna,1639591,1077066,65.69,0.58
4161,2021-04-01,SAR,10157,4070,6087,7006,3013,138,ITG,ITG2,20,Sardegna,Sardegna,1639591,1087223,66.31,0.62
4162,2021-07-21,SAR,19393,9499,9894,3912,15397,84,ITG,ITG2,20,Sardegna,Sardegna,1639591,1106616,67.49,1.18
4163,2021-02-10,SAR,1960,765,1195,1434,520,6,ITG,ITG2,20,Sardegna,Sardegna,1639591,1108576,67.61,0.12
4164,2021-05-28,SAR,17954,8698,9256,13490,4276,188,ITG,ITG2,20,Sardegna,Sardegna,1639591,1126530,68.71,1.1
4165,2021-02-17,SAR,1404,577,827,1273,74,57,ITG,ITG2,20,Sardegna,Sardegna,1639591,1127934,68.79,0.09
4166,2021-05-25,SAR,15142,7704,7438,8490,6476,176,ITG,ITG2,20,Sardegna,Sardegna,1639591,1143076,69.72,0.92
4167,2021-06-11,SAR,14779,7024,7755,9089,5537,153,ITG,ITG2,20,Sardegna,Sardegna,1639591,1157855,70.62,0.9
4168,2021-03-03,SAR,4113,2277,1836,2739,1297,77,ITG,ITG2,20,Sardegna,Sardegna,1639591,1161968,70.87,0.25
4169,2021-06-23,SAR,20549,9672,10877,6196,14261,92,ITG,ITG2,20,Sardegna,Sardegna,1639591,1182517,72.12,1.25
4170,2021-05-18,SAR,14754,7379,7375,9444,5202,108,ITG,ITG2,20,Sardegna,Sardegna,1639591,1197271,73.02,0.9
4171,2021-02-24,SAR,2412,1295,1117,2183,193,36,ITG,ITG2,20,Sardegna,Sardegna,1639591,1199683,73.17,0.15
4172,2021-06-06,SAR,10034,5001,5033,6314,3651,69,ITG,ITG2,20,Sardegna,Sardegna,1639591,1209717,73.78,0.61
4173,2021-05-22,SAR,24842,11954,12888,19398,5140,304,ITG,ITG2,20,Sardegna,Sardegna,1639591,1234559,75.3,1.52
4174,2021-01-19,SAR,747,269,478,691,55,1,ITG,ITG2,20,Sardegna,Sardegna,1639591,1235306,75.34,0.05
4175,2021-03-17,SAR,6549,2846,3703,4904,1608,37,ITG,ITG2,20,Sardegna,Sardegna,1639591,1241855,75.74,0.4
4176,2021-06-27,SAR,9019,4310,4709,2957,6034,28,ITG,ITG2,20,Sardegna,Sardegna,1639591,1250874,76.29,0.55
4177,2021-04-10,SAR,10496,4748,5748,8455,1940,101,ITG,ITG2,20,Sardegna,Sardegna,1639591,1261370,76.93,0.64
4178,2021-01-07,SAR,3103,1072,2031,3099,0,4,ITG,ITG2,20,Sardegna,Sardegna,1639591,1264473,77.12,0.19
4179,2021-06-10,SAR,17810,8478,9332,11643,6041,126,ITG,ITG2,20,Sardegna,Sardegna,1639591,1282283,78.21,1.09
4180,2021-01-29,SAR,2958,1071,1887,45,2911,2,ITG,ITG2,20,Sardegna,Sardegna,1639591,1285241,78.39,0.18
4181,2021-01-28,SAR,2974,1045,1929,69,2905,0,ITG,ITG2,20,Sardegna,Sardegna,1639591,1288215,78.57,0.18
4182,2020-12-31,SAR,32,16,16,32,0,0,ITG,ITG2,20,Sardegna,Sardegna,1639591,1288247,78.57,0.0
4183,2021-07-30,SAR,15219,7857,7362,6625,8428,166,ITG,ITG2,20,Sardegna,Sardegna,1639591,1303466,79.5,0.93
4184,2021-06-03,SAR,16395,7644,8751,10566,5689,140,ITG,ITG2,20,Sardegna,Sardegna,1639591,1319861,80.5,1.0
4185,2021-06-20,SAR,6292,2805,3487,3636,2624,32,ITG,ITG2,20,Sardegna,Sardegna,1639591,1326153,80.88,0.38
4186,2021-03-12,SAR,5972,2618,3354,4520,1307,145,ITG,ITG2,20,Sardegna,Sardegna,1639591,1332125,81.25,0.36
4187,2021-07-23,SAR,15753,7783,7970,3400,12275,78,ITG,ITG2,20,Sardegna,Sardegna,1639591,1347878,82.21,0.96
4188,2021-04-14,SAR,8264,3907,4357,6966,1238,60,ITG,ITG2,20,Sardegna,Sardegna,1639591,1356142,82.71,0.5
4189,2021-05-01,SAR,9917,4765,5152,5369,4455,93,ITG,ITG2,20,Sardegna,Sardegna,1639591,1366059,83.32,0.6
4190,2021-01-21,SAR,127,61,66,94,33,0,ITG,ITG2,20,Sardegna,Sardegna,1639591,1366186,83.32,0.01
4191,2021-02-07,SAR,1119,396,723,227,891,1,ITG,ITG2,20,Sardegna,Sardegna,1639591,1367305,83.39,0.07
4192,2021-05-03,SAR,8194,3824,4370,6490,1600,104,ITG,ITG2,20,Sardegna,Sardegna,1639591,1375499,83.89,0.5
4193,2021-05-20,SAR,16365,7883,8482,11267,4897,201,ITG,ITG2,20,Sardegna,Sardegna,1639591,1391864,84.89,1.0
4194,2021-02-09,SAR,2286,835,1451,1284,997,5,ITG,ITG2,20,Sardegna,Sardegna,1639591,1394150,85.03,0.14
4195,2021-02-26,SAR,2798,1105,1693,2444,306,48,ITG,ITG2,20,Sardegna,Sardegna,1639591,1396948,85.2,0.17
4196,2021-06-30,SAR,17773,8514,9259,4806,12885,82,ITG,ITG2,20,Sardegna,Sardegna,1639591,1414721,86.28,1.08
4197,2021-03-22,SAR,3687,1492,2195,3099,513,75,ITG,ITG2,20,Sardegna,Sardegna,1639591,1418408,86.51,0.22
4198,2021-04-08,SAR,13438,5936,7502,8208,5121,109,ITG,ITG2,20,Sardegna,Sardegna,1639591,1431846,87.33,0.82
4199,2021-07-14,SAR,16910,8191,8719,3775,13024,111,ITG,ITG2,20,Sardegna,Sardegna,1639591,1448756,88.36,1.03
4200,2020-12-29,SAR,57,32,25,57,0,0,ITG,ITG2,20,Sardegna,Sardegna,1639591,1448813,88.36,0.0
4201,2021-04-22,SAR,10505,4662,5843,5502,4919,84,ITG,ITG2,20,Sardegna,Sardegna,1639591,1459318,89.01,0.64
4202,2021-01-12,SAR,865,408,457,865,0,0,ITG,ITG2,20,Sardegna,Sardegna,1639591,1460183,89.06,0.05
4203,2021-03-24,SAR,7396,3105,4291,5905,1356,135,ITG,ITG2,20,Sardegna,Sardegna,1639591,1467579,89.51,0.45
4204,2021-04-12,SAR,6993,3179,3814,5215,1713,65,ITG,ITG2,20,Sardegna,Sardegna,1639591,1474572,89.94,0.43
4205,2021-01-02,SAR,60,21,39,60,0,0,ITG,ITG2,20,Sardegna,Sardegna,1639591,1474632,89.94,0.0
4206,2021-06-08,SAR,14832,7070,7762,11172,3507,153,ITG,ITG2,20,Sardegna,Sardegna,1639591,1489464,90.84,0.9
4207,2021-02-28,SAR,367,169,198,139,226,2,ITG,ITG2,20,Sardegna,Sardegna,1639591,1489831,90.87,0.02
4208,2021-04-26,SAR,6856,3274,3582,5865,903,88,ITG,ITG2,20,Sardegna,Sardegna,1639591,1496687,91.28,0.42
4209,2021-06-01,SAR,14322,6655,7667,9639,4589,94,ITG,ITG2,20,Sardegna,Sardegna,1639591,1511009,92.16,0.87
4210,2021-02-21,SAR,1588,709,879,1557,30,1,ITG,ITG2,20,Sardegna,Sardegna,1639591,1512597,92.25,0.1
4211,2021-07-28,SAR,16789,8619,8170,6314,10326,149,ITG,ITG2,20,Sardegna,Sardegna,1639591,1529386,93.28,1.02
4212,2021-04-19,SAR,10186,4622,5564,8626,1427,133,ITG,ITG2,20,Sardegna,Sardegna,1639591,1539572,93.9,0.62
4213,2021-01-09,SAR,4013,1414,2599,4013,0,0,ITG,ITG2,20,Sardegna,Sardegna,1639591,1543585,94.14,0.24
4214,2021-06-15,SAR,14689,6806,7883,9816,4739,134,ITG,ITG2,20,Sardegna,Sardegna,1639591,1558274,95.04,0.9
4215,2021-03-07,SAR,1658,751,907,1113,541,4,ITG,ITG2,20,Sardegna,Sardegna,1639591,1559932,95.14,0.1
4216,2021-05-27,SAR,17828,9263,8565,12086,5534,208,ITG,ITG2,20,Sardegna,Sardegna,1639591,1577760,96.23,1.09
4217,2021-02-16,SAR,699,289,410,663,27,9,ITG,ITG2,20,Sardegna,Sardegna,1639591,1578459,96.27,0.04
4218,2021-03-05,SAR,5205,2602,2603,2813,2355,37,ITG,ITG2,20,Sardegna,Sardegna,1639591,1583664,96.59,0.32
4219,2021-03-19,SAR,7260,3045,4215,4991,2216,53,ITG,ITG2,20,Sardegna,Sardegna,1639591,1590924,97.03,0.44
4220,2021-05-11,SAR,8928,4155,4773,6401,2400,127,ITG,ITG2,20,Sardegna,Sardegna,1639591,1599852,97.58,0.54
4221,2021-01-31,SAR,2117,749,1368,45,2072,0,ITG,ITG2,20,Sardegna,Sardegna,1639591,1601969,97.71,0.13
4222,2021-02-14,SAR,538,263,275,536,2,0,ITG,ITG2,20,Sardegna,Sardegna,1639591,1602507,97.74,0.03
4223,2021-07-18,SAR,5691,2873,2818,981,4700,10,ITG,ITG2,20,Sardegna,Sardegna,1639591,1608198,98.09,0.35
4224,2021-07-16,SAR,16934,8474,8460,4551,12249,134,ITG,ITG2,20,Sardegna,Sardegna,1639591,1625132,99.12,1.03
4225,2021-04-07,SAR,13546,6051,7495,7824,5654,68,ITG,ITG2,20,Sardegna,Sardegna,1639591,1638678,99.94,0.83
4226,2021-04-24,SAR,10364,4851,5513,7890,2346,128,ITG,ITG2,20,Sardegna,Sardegna,1639591,1649042,100.58,0.63
4227,2021-01-14,SAR,1105,425,680,1105,0,0,ITG,ITG2,20,Sardegna,Sardegna,1639591,1650147,100.64,0.07
4228,2021-04-05,SAR,2035,783,1252,2003,1,31,ITG,ITG2,20,Sardegna,Sardegna,1639591,1652182,100.77,0.12
4229,2021-06-29,SAR,17891,8605,9286,3755,14088,48,ITG,ITG2,20,Sardegna,Sardegna,1639591,1670073,101.86,1.09
4230,2021-06-16,SAR,17636,8277,9359,12169,5305,162,ITG,ITG2,20,Sardegna,Sardegna,1639591,1687709,102.93,1.08
4231,2021-01-01,SAR,32,17,15,32,0,0,ITG,ITG2,20,Sardegna,Sardegna,1639591,1687741,102.94,0.0
4232,2021-02-27,SAR,1916,642,1274,1318,557,41,ITG,ITG2,20,Sardegna,Sardegna,1639591,1689657,103.05,0.12
4233,2021-07-22,SAR,18329,9263,9066,4508,13712,109,ITG,ITG2,20,Sardegna,Sardegna,1639591,1707986,104.17,1.12
4234,2021-04-13,SAR,7618,3597,4021,5734,1825,59,ITG,ITG2,20,Sardegna,Sardegna,1639591,1715604,104.64,0.46
4235,2021-06-09,SAR,15463,7368,8095,11575,3739,149,ITG,ITG2,20,Sardegna,Sardegna,1639591,1731067,105.58,0.94
4236,2021-03-08,SAR,4687,2434,2253,3421,1222,44,ITG,ITG2,20,Sardegna,Sardegna,1639591,1735754,105.87,0.29
4237,2021-05-04,SAR,9545,4387,5158,7542,1854,149,ITG,ITG2,20,Sardegna,Sardegna,1639591,1745299,106.45,0.58
4238,2021-01-24,SAR,90,34,56,5,85,0,ITG,ITG2,20,Sardegna,Sardegna,1639591,1745389,106.45,0.01
4239,2021-06-18,SAR,16485,7506,8979,8604,7766,115,ITG,ITG2,20,Sardegna,Sardegna,1639591,1761874,107.46,1.01
4240,2021-03-10,SAR,6055,2957,3098,5136,853,66,ITG,ITG2,20,Sardegna,Sardegna,1639591,1767929,107.83,0.37
4241,2021-05-06,SAR,12955,6012,6943,9567,3148,240,ITG,ITG2,20,Sardegna,Sardegna,1639591,1780884,108.62,0.79
4242,2021-03-01,SAR,2269,1157,1112,1582,659,28,ITG,ITG2,20,Sardegna,Sardegna,1639591,1783153,108.76,0.14
4243,2021-05-13,SAR,12375,5863,6512,8728,3446,201,ITG,ITG2,20,Sardegna,Sardegna,1639591,1795528,109.51,0.75
4244,2021-02-02,SAR,1500,670,830,257,1243,0,ITG,ITG2,20,Sardegna,Sardegna,1639591,1797028,109.6,0.09
4245,2021-05-15,SAR,13795,6425,7370,10199,3433,163,ITG,ITG2,20,Sardegna,Sardegna,1639591,1810823,110.44,0.84
4246,2021-07-11,SAR,6378,3118,3260,1424,4919,35,ITG,ITG2,20,Sardegna,Sardegna,1639591,1817201,110.83,0.39
4247,2021-01-26,SAR,1337,454,883,27,1310,0,ITG,ITG2,20,Sardegna,Sardegna,1639591,1818538,110.91,0.08
4248,2021-05-08,SAR,13089,5973,7116,10668,2285,136,ITG,ITG2,20,Sardegna,Sardegna,1639591,1831627,111.71,0.8
4249,2021-04-23,LOM,73590,33346,40244,55582,16620,1388,ITC,ITC4,3,Lombardia,Lombardia,10060574,73590,0.73,0.73
4250,2021-05-10,LOM,85287,40892,44395,62037,21586,1664,ITC,ITC4,3,Lombardia,Lombardia,10060574,158877,1.58,0.85
4251,2021-01-30,LOM,12326,4570,7756,146,12171,9,ITC,ITC4,3,Lombardia,Lombardia,10060574,171203,1.7,0.12
4252,2021-01-16,LOM,15620,5779,9841,15609,0,11,ITC,ITC4,3,Lombardia,Lombardia,10060574,186823,1.86,0.16
4253,2021-03-28,LOM,20626,7876,12750,13963,6278,385,ITC,ITC4,3,Lombardia,Lombardia,10060574,207449,2.06,0.21
4254,2021-04-14,LOM,47205,21036,26169,33543,12976,686,ITC,ITC4,3,Lombardia,Lombardia,10060574,254654,2.53,0.47
4255,2021-01-04,LOM,6120,2112,4008,6114,0,6,ITC,ITC4,3,Lombardia,Lombardia,10060574,260774,2.59,0.06
4256,2021-06-19,LOM,104309,51988,52321,56244,46643,1422,ITC,ITC4,3,Lombardia,Lombardia,10060574,365083,3.63,1.04
4257,2021-07-06,LOM,101811,50687,51124,23067,77326,1418,ITC,ITC4,3,Lombardia,Lombardia,10060574,466894,4.64,1.01
4258,2021-04-28,LOM,95769,43679,52090,66932,26923,1914,ITC,ITC4,3,Lombardia,Lombardia,10060574,562663,5.59,0.95
4259,2021-06-24,LOM,109542,56638,52904,78345,28821,2376,ITC,ITC4,3,Lombardia,Lombardia,10060574,672205,6.68,1.09
4260,2021-03-16,LOM,25522,10124,15398,16303,9097,122,ITC,ITC4,3,Lombardia,Lombardia,10060574,697727,6.94,0.25
4261,2021-05-12,LOM,87521,41761,45760,57422,27577,2522,ITC,ITC4,3,Lombardia,Lombardia,10060574,785248,7.81,0.87
4262,2021-05-24,LOM,89570,43504,46066,48594,40039,937,ITC,ITC4,3,Lombardia,Lombardia,10060574,874818,8.7,0.89
4263,2021-02-11,LOM,17093,5014,12079,9632,7382,79,ITC,ITC4,3,Lombardia,Lombardia,10060574,891911,8.87,0.17
4264,2021-05-31,LOM,95672,47403,48269,78350,16219,1103,ITC,ITC4,3,Lombardia,Lombardia,10060574,987583,9.82,0.95
4265,2021-07-27,LOM,104693,56671,48022,7430,96556,707,ITC,ITC4,3,Lombardia,Lombardia,10060574,1092276,10.86,1.04
4266,2021-06-05,LOM,102431,52954,49477,91103,9817,1511,ITC,ITC4,3,Lombardia,Lombardia,10060574,1194707,11.88,1.02
4267,2021-03-14,LOM,14875,5349,9526,11218,3284,373,ITC,ITC4,3,Lombardia,Lombardia,10060574,1209582,12.02,0.15
4268,2021-02-23,LOM,11830,4804,7026,11292,332,206,ITC,ITC4,3,Lombardia,Lombardia,10060574,1221412,12.14,0.12
4269,2021-02-16,LOM,9513,3075,6438,8965,448,100,ITC,ITC4,3,Lombardia,Lombardia,10060574,1230925,12.24,0.09
4270,2021-06-10,LOM,102649,52245,50404,86407,14447,1795,ITC,ITC4,3,Lombardia,Lombardia,10060574,1333574,13.26,1.02
4271,2021-03-02,LOM,22837,9708,13129,19531,3044,262,ITC,ITC4,3,Lombardia,Lombardia,10060574,1356411,13.48,0.23
4272,2020-12-28,LOM,108,47,61,108,0,0,ITC,ITC4,3,Lombardia,Lombardia,10060574,1356519,13.48,0.0
4273,2021-04-21,LOM,71840,32566,39274,55835,14670,1335,ITC,ITC4,3,Lombardia,Lombardia,10060574,1428359,14.2,0.71
4274,2021-01-11,LOM,16298,5390,10908,16288,0,10,ITC,ITC4,3,Lombardia,Lombardia,10060574,1444657,14.36,0.16
4275,2021-07-20,LOM,95010,49090,45920,6903,87351,756,ITC,ITC4,3,Lombardia,Lombardia,10060574,1539667,15.3,0.94
4276,2021-02-04,LOM,27913,8136,19777,2042,25866,5,ITC,ITC4,3,Lombardia,Lombardia,10060574,1567580,15.58,0.28
4277,2021-07-18,LOM,97100,50590,46510,8544,87863,693,ITC,ITC4,3,Lombardia,Lombardia,10060574,1664680,16.55,0.97
4278,2021-04-09,LOM,52404,22373,30031,35570,15998,836,ITC,ITC4,3,Lombardia,Lombardia,10060574,1717084,17.07,0.52
4279,2021-07-13,LOM,108435,56678,51757,15420,91774,1241,ITC,ITC4,3,Lombardia,Lombardia,10060574,1825519,18.15,1.08
4280,2021-04-04,LOM,7612,3230,4382,3682,3896,34,ITC,ITC4,3,Lombardia,Lombardia,10060574,1833131,18.22,0.08
4281,2021-06-17,LOM,108543,52707,55836,50886,56479,1178,ITC,ITC4,3,Lombardia,Lombardia,10060574,1941674,19.3,1.08
4282,2021-03-09,LOM,33238,12868,20370,25246,7406,586,ITC,ITC4,3,Lombardia,Lombardia,10060574,1974912,19.63,0.33
4283,2021-05-05,LOM,87956,41931,46025,70359,15330,2267,ITC,ITC4,3,Lombardia,Lombardia,10060574,2062868,20.5,0.87
4284,2021-07-01,LOM,104943,52821,52122,53337,49214,2392,ITC,ITC4,3,Lombardia,Lombardia,10060574,2167811,21.55,1.04
4285,2021-06-12,LOM,89313,48061,41252,84316,3158,1839,ITC,ITC4,3,Lombardia,Lombardia,10060574,2257124,22.44,0.89
4286,2021-06-29,LOM,107142,53146,53996,57402,47735,2005,ITC,ITC4,3,Lombardia,Lombardia,10060574,2364266,23.5,1.06
4287,2021-03-21,LOM,23520,8498,15022,17732,5196,592,ITC,ITC4,3,Lombardia,Lombardia,10060574,2387786,23.73,0.23
4288,2021-02-13,LOM,6421,2441,3980,4884,1477,60,ITC,ITC4,3,Lombardia,Lombardia,10060574,2394207,23.8,0.06
4289,2021-07-17,LOM,108489,57286,51203,10217,97348,924,ITC,ITC4,3,Lombardia,Lombardia,10060574,2502696,24.88,1.08
4290,2021-01-09,LOM,12490,4605,7885,12482,0,8,ITC,ITC4,3,Lombardia,Lombardia,10060574,2515186,25.0,0.12
4291,2021-03-07,LOM,12093,5364,6729,9339,2562,192,ITC,ITC4,3,Lombardia,Lombardia,10060574,2527279,25.12,0.12
4292,2021-01-27,LOM,8048,2678,5370,807,7239,2,ITC,ITC4,3,Lombardia,Lombardia,10060574,2535327,25.2,0.08
4293,2021-07-03,LOM,102348,51630,50718,44535,55705,2108,ITC,ITC4,3,Lombardia,Lombardia,10060574,2637675,26.22,1.02
4294,2021-03-25,LOM,42950,16063,26887,29246,12799,905,ITC,ITC4,3,Lombardia,Lombardia,10060574,2680625,26.64,0.43
4295,2021-05-21,LOM,93863,45247,48616,28381,64721,761,ITC,ITC4,3,Lombardia,Lombardia,10060574,2774488,27.58,0.93
4296,2021-07-08,LOM,114381,58290,56091,13173,100181,1027,ITC,ITC4,3,Lombardia,Lombardia,10060574,2888869,28.71,1.14
4297,2021-07-25,LOM,86631,45734,40897,9424,76428,779,ITC,ITC4,3,Lombardia,Lombardia,10060574,2975500,29.58,0.86
4298,2021-04-16,LOM,53704,23934,29770,38440,14376,888,ITC,ITC4,3,Lombardia,Lombardia,10060574,3029204,30.11,0.53
4299,2021-05-03,LOM,83717,39763,43954,69459,12134,2124,ITC,ITC4,3,Lombardia,Lombardia,10060574,3112921,30.94,0.83
4300,2021-01-23,LOM,1126,360,766,924,199,3,ITC,ITC4,3,Lombardia,Lombardia,10060574,3114047,30.95,0.01
4301,2021-03-26,LOM,41336,15711,25625,27508,13154,674,ITC,ITC4,3,Lombardia,Lombardia,10060574,3155383,31.36,0.41
4302,2021-05-22,LOM,70612,33843,36769,31724,38173,715,ITC,ITC4,3,Lombardia,Lombardia,10060574,3225995,32.07,0.7
4303,2021-05-29,LOM,88325,42417,45908,41397,46085,843,ITC,ITC4,3,Lombardia,Lombardia,10060574,3314320,32.94,0.88
4304,2021-02-18,LOM,14054,4926,9128,12820,1037,197,ITC,ITC4,3,Lombardia,Lombardia,10060574,3328374,33.08,0.14
4305,2021-05-17,LOM,94679,45366,49313,29545,64431,703,ITC,ITC4,3,Lombardia,Lombardia,10060574,3423053,34.02,0.94
4306,2021-05-19,LOM,83278,39774,43504,33109,49362,807,ITC,ITC4,3,Lombardia,Lombardia,10060574,3506331,34.85,0.83
4307,2021-04-02,LOM,41371,16930,24441,26207,14611,553,ITC,ITC4,3,Lombardia,Lombardia,10060574,3547702,35.26,0.41
4308,2021-04-11,LOM,32222,13944,18278,24316,7395,511,ITC,ITC4,3,Lombardia,Lombardia,10060574,3579924,35.58,0.32
4309,2021-01-01,LOM,24,7,17,24,0,0,ITC,ITC4,3,Lombardia,Lombardia,10060574,3579948,35.58,0.0
4310,2021-06-07,LOM,98987,50433,48554,84027,13341,1619,ITC,ITC4,3,Lombardia,Lombardia,10060574,3678935,36.57,0.98
4311,2021-01-28,LOM,12242,3711,8531,795,11440,7,ITC,ITC4,3,Lombardia,Lombardia,10060574,3691177,36.69,0.12
4312,2021-04-25,LOM,51586,23655,27931,45543,4825,1218,ITC,ITC4,3,Lombardia,Lombardia,10060574,3742763,37.2,0.51
4313,2021-01-18,LOM,9238,2978,6260,8248,975,15,ITC,ITC4,3,Lombardia,Lombardia,10060574,3752001,37.29,0.09
4314,2021-03-23,LOM,42603,15480,27123,28867,12881,855,ITC,ITC4,3,Lombardia,Lombardia,10060574,3794604,37.72,0.42
4315,2021-01-13,LOM,26452,8085,18367,26427,0,25,ITC,ITC4,3,Lombardia,Lombardia,10060574,3821056,37.98,0.26
4316,2021-06-21,LOM,113294,58040,55254,78374,32747,2173,ITC,ITC4,3,Lombardia,Lombardia,10060574,3934350,39.11,1.13
4317,2021-06-02,LOM,84647,43580,41067,76985,6344,1318,ITC,ITC4,3,Lombardia,Lombardia,10060574,4018997,39.95,0.84
4318,2021-03-11,LOM,36245,13489,22756,25633,9929,683,ITC,ITC4,3,Lombardia,Lombardia,10060574,4055242,40.31,0.36
4319,2021-03-30,LOM,39651,15597,24054,24251,14792,608,ITC,ITC4,3,Lombardia,Lombardia,10060574,4094893,40.7,0.39
4320,2021-01-06,LOM,7160,2529,4631,7153,0,7,ITC,ITC4,3,Lombardia,Lombardia,10060574,4102053,40.77,0.07
4321,2021-05-18,LOM,88239,42172,46067,31886,55584,769,ITC,ITC4,3,Lombardia,Lombardia,10060574,4190292,41.65,0.88
4322,2021-06-04,LOM,104634,54315,50319,93200,9648,1786,ITC,ITC4,3,Lombardia,Lombardia,10060574,4294926,42.69,1.04
4323,2021-02-24,LOM,14723,5959,8764,13575,955,193,ITC,ITC4,3,Lombardia,Lombardia,10060574,4309649,42.84,0.15
4324,2021-05-16,LOM,68701,32507,36194,35586,32204,911,ITC,ITC4,3,Lombardia,Lombardia,10060574,4378350,43.52,0.68
4325,2021-02-05,LOM,25739,7471,18268,2425,23300,14,ITC,ITC4,3,Lombardia,Lombardia,10060574,4404089,43.78,0.26
4326,2021-02-22,LOM,11908,4810,7098,11404,306,198,ITC,ITC4,3,Lombardia,Lombardia,10060574,4415997,43.89,0.12
4327,2021-03-13,LOM,27202,9786,17416,20547,6104,551,ITC,ITC4,3,Lombardia,Lombardia,10060574,4443199,44.16,0.27
4328,2021-02-08,LOM,10094,2919,7175,2122,7963,9,ITC,ITC4,3,Lombardia,Lombardia,10060574,4453293,44.26,0.1
4329,2021-02-25,LOM,15337,6365,8972,13528,1609,200,ITC,ITC4,3,Lombardia,Lombardia,10060574,4468630,44.42,0.15
4330,2021-02-06,LOM,15273,5543,9730,1010,14258,5,ITC,ITC4,3,Lombardia,Lombardia,10060574,4483903,44.57,0.15
4331,2021-07-24,LOM,95862,50649,45213,9737,85265,860,ITC,ITC4,3,Lombardia,Lombardia,10060574,4579765,45.52,0.95
4332,2021-05-02,LOM,83513,38339,45174,59262,22469,1782,ITC,ITC4,3,Lombardia,Lombardia,10060574,4663278,46.35,0.83
4333,2021-05-07,LOM,92350,43717,48633,68389,22405,1556,ITC,ITC4,3,Lombardia,Lombardia,10060574,4755628,47.27,0.92
4334,2021-03-18,LOM,27412,10964,16448,15935,11250,227,ITC,ITC4,3,Lombardia,Lombardia,10060574,4783040,47.54,0.27
4335,2021-05-14,LOM,85989,41412,44577,53267,30340,2382,ITC,ITC4,3,Lombardia,Lombardia,10060574,4869029,48.4,0.85
4336,2021-07-10,LOM,107108,54218,52890,13911,92016,1181,ITC,ITC4,3,Lombardia,Lombardia,10060574,4976137,49.46,1.06
4337,2021-01-25,LOM,7077,2388,4689,511,6563,3,ITC,ITC4,3,Lombardia,Lombardia,10060574,4983214,49.53,0.07
4338,2021-02-01,LOM,16084,5326,10758,307,15775,2,ITC,ITC4,3,Lombardia,Lombardia,10060574,4999298,49.69,0.16
4339,2021-07-05,LOM,101427,49544,51883,31231,68306,1890,ITC,ITC4,3,Lombardia,Lombardia,10060574,5100725,50.7,1.01
4340,2021-07-12,LOM,111667,57411,54256,14802,95720,1145,ITC,ITC4,3,Lombardia,Lombardia,10060574,5212392,51.81,1.11
4341,2021-04-03,LOM,36270,14871,21399,25780,10110,380,ITC,ITC4,3,Lombardia,Lombardia,10060574,5248662,52.17,0.36
4342,2021-05-30,LOM,74370,35587,38783,33792,39959,619,ITC,ITC4,3,Lombardia,Lombardia,10060574,5323032,52.91,0.74
4343,2021-07-26,LOM,109506,58854,50652,7676,101071,759,ITC,ITC4,3,Lombardia,Lombardia,10060574,5432538,54.0,1.09
4344,2021-02-27,LOM,13951,5875,8076,13153,642,156,ITC,ITC4,3,Lombardia,Lombardia,10060574,5446489,54.14,0.14
4345,2020-12-30,LOM,114,42,72,114,0,0,ITC,ITC4,3,Lombardia,Lombardia,10060574,5446603,54.14,0.0
4346,2021-06-16,LOM,99257,50431,48826,49863,48243,1151,ITC,ITC4,3,Lombardia,Lombardia,10060574,5545860,55.12,0.99
4347,2021-03-06,LOM,21349,9100,12249,16534,4517,298,ITC,ITC4,3,Lombardia,Lombardia,10060574,5567209,55.34,0.21
4348,2021-06-09,LOM,103667,52231,51436,87435,14513,1719,ITC,ITC4,3,Lombardia,Lombardia,10060574,5670876,56.37,1.03
4349,2021-03-08,LOM,29771,11194,18577,22164,7090,517,ITC,ITC4,3,Lombardia,Lombardia,10060574,5700647,56.66,0.3
4350,2021-05-04,LOM,86822,41076,45746,70277,14400,2145,ITC,ITC4,3,Lombardia,Lombardia,10060574,5787469,57.53,0.86
4351,2021-01-24,LOM,1201,458,743,538,663,0,ITC,ITC4,3,Lombardia,Lombardia,10060574,5788670,57.54,0.01
4352,2021-06-28,LOM,107954,55002,52952,74285,31060,2609,ITC,ITC4,3,Lombardia,Lombardia,10060574,5896624,58.61,1.07
4353,2021-07-15,LOM,109274,56204,53070,13351,94708,1215,ITC,ITC4,3,Lombardia,Lombardia,10060574,6005898,59.7,1.09
4354,2021-04-06,LOM,43080,17590,25490,24441,17948,691,ITC,ITC4,3,Lombardia,Lombardia,10060574,6048978,60.13,0.43
4355,2021-06-14,LOM,94778,48150,46628,49130,44532,1116,ITC,ITC4,3,Lombardia,Lombardia,10060574,6143756,61.07,0.94
4356,2021-07-23,LOM,95494,50056,45438,11411,82822,1261,ITC,ITC4,3,Lombardia,Lombardia,10060574,6239250,62.02,0.95
4357,2021-05-01,LOM,95995,43682,52313,65054,29227,1714,ITC,ITC4,3,Lombardia,Lombardia,10060574,6335245,62.97,0.95
4358,2021-01-21,LOM,5496,1604,3892,4788,691,17,ITC,ITC4,3,Lombardia,Lombardia,10060574,6340741,63.03,0.05
4359,2021-02-07,LOM,7313,2825,4488,335,6975,3,ITC,ITC4,3,Lombardia,Lombardia,10060574,6348054,63.1,0.07
4360,2021-01-19,LOM,8054,2330,5724,7571,469,14,ITC,ITC4,3,Lombardia,Lombardia,10060574,6356108,63.18,0.08
4361,2021-06-18,LOM,107612,52857,54755,51947,54428,1237,ITC,ITC4,3,Lombardia,Lombardia,10060574,6463720,64.25,1.07
4362,2021-03-01,LOM,18797,8233,10564,16884,1707,206,ITC,ITC4,3,Lombardia,Lombardia,10060574,6482517,64.43,0.19
4363,2021-05-26,LOM,93718,44661,49057,42736,50093,889,ITC,ITC4,3,Lombardia,Lombardia,10060574,6576235,65.37,0.93
4364,2021-02-15,LOM,9002,3151,5851,8361,462,179,ITC,ITC4,3,Lombardia,Lombardia,10060574,6585237,65.46,0.09
4365,2021-03-20,LOM,32599,12166,20433,22245,9853,501,ITC,ITC4,3,Lombardia,Lombardia,10060574,6617836,65.78,0.32
4366,2020-12-27,LOM,718,414,304,718,0,0,ITC,ITC4,3,Lombardia,Lombardia,10060574,6618554,65.79,0.01
4367,2021-06-26,LOM,105870,55425,50445,77783,25686,2401,ITC,ITC4,3,Lombardia,Lombardia,10060574,6724424,66.84,1.05
4368,2021-02-10,LOM,14420,4514,9906,7564,6827,29,ITC,ITC4,3,Lombardia,Lombardia,10060574,6738844,66.98,0.14
4369,2021-02-03,LOM,25671,7931,17740,1077,24589,5,ITC,ITC4,3,Lombardia,Lombardia,10060574,6764515,67.24,0.26
4370,2021-04-01,LOM,43144,17299,25845,26078,16353,713,ITC,ITC4,3,Lombardia,Lombardia,10060574,6807659,67.67,0.43
4371,2021-03-04,LOM,29346,12123,17223,20051,9075,220,ITC,ITC4,3,Lombardia,Lombardia,10060574,6837005,67.96,0.29
4372,2021-06-30,LOM,106778,52909,53869,56580,48097,2101,ITC,ITC4,3,Lombardia,Lombardia,10060574,6943783,69.02,1.06
4373,2021-03-22,LOM,40343,14306,26037,28948,10561,834,ITC,ITC4,3,Lombardia,Lombardia,10060574,6984126,69.42,0.4
4374,2021-04-08,LOM,52416,21778,30638,35274,16470,672,ITC,ITC4,3,Lombardia,Lombardia,10060574,7036542,69.94,0.52
4375,2020-12-29,LOM,106,45,61,106,0,0,ITC,ITC4,3,Lombardia,Lombardia,10060574,7036648,69.94,0.0
4376,2021-07-14,LOM,109233,56759,52474,14336,93484,1413,ITC,ITC4,3,Lombardia,Lombardia,10060574,7145881,71.03,1.09
4377,2021-04-22,LOM,73989,33415,40574,56210,16398,1381,ITC,ITC4,3,Lombardia,Lombardia,10060574,7219870,71.76,0.74
4378,2021-03-03,LOM,26999,11521,15478,19481,7301,217,ITC,ITC4,3,Lombardia,Lombardia,10060574,7246869,72.03,0.27
4379,2021-07-22,LOM,99357,52024,47333,12492,85410,1455,ITC,ITC4,3,Lombardia,Lombardia,10060574,7346226,73.02,0.99
4380,2021-04-13,LOM,47671,21281,26390,32932,14095,644,ITC,ITC4,3,Lombardia,Lombardia,10060574,7393897,73.49,0.47
4381,2021-04-30,LOM,117467,54874,62593,87244,27646,2577,ITC,ITC4,3,Lombardia,Lombardia,10060574,7511364,74.66,1.17
4382,2021-01-20,LOM,5682,1383,4299,5563,114,5,ITC,ITC4,3,Lombardia,Lombardia,10060574,7517046,74.72,0.06
4383,2021-01-22,LOM,3195,883,2312,3121,69,5,ITC,ITC4,3,Lombardia,Lombardia,10060574,7520241,74.75,0.03
4384,2021-07-07,LOM,111825,56058,55767,17984,92672,1169,ITC,ITC4,3,Lombardia,Lombardia,10060574,7632066,75.86,1.11
4385,2021-04-15,LOM,49464,21867,27597,34887,13827,750,ITC,ITC4,3,Lombardia,Lombardia,10060574,7681530,76.35,0.49
4386,2021-01-05,LOM,7866,2577,5289,7860,0,6,ITC,ITC4,3,Lombardia,Lombardia,10060574,7689396,76.43,0.08
4387,2021-03-27,LOM,32454,12382,20072,23104,8718,632,ITC,ITC4,3,Lombardia,Lombardia,10060574,7721850,76.75,0.32
4388,2021-01-03,LOM,854,316,538,853,0,1,ITC,ITC4,3,Lombardia,Lombardia,10060574,7722704,76.76,0.01
4389,2021-05-15,LOM,80953,38801,42152,45490,33416,2047,ITC,ITC4,3,Lombardia,Lombardia,10060574,7803657,77.57,0.8
4390,2021-07-11,LOM,90177,45614,44563,11766,77353,1058,ITC,ITC4,3,Lombardia,Lombardia,10060574,7893834,78.46,0.9
4391,2021-05-13,LOM,87211,41788,45423,55737,28879,2595,ITC,ITC4,3,Lombardia,Lombardia,10060574,7981045,79.33,0.87
4392,2021-02-02,LOM,19924,6609,13315,497,19424,3,ITC,ITC4,3,Lombardia,Lombardia,10060574,8000969,79.53,0.2
4393,2021-03-31,LOM,42208,17122,25086,26198,15332,678,ITC,ITC4,3,Lombardia,Lombardia,10060574,8043177,79.95,0.42
4394,2021-05-23,LOM,60765,28929,31836,26293,33958,514,ITC,ITC4,3,Lombardia,Lombardia,10060574,8103942,80.55,0.6
4395,2021-02-12,LOM,14007,4378,9629,8873,4974,160,ITC,ITC4,3,Lombardia,Lombardia,10060574,8117949,80.69,0.14
4396,2021-07-19,LOM,96894,50306,46588,10799,85012,1083,ITC,ITC4,3,Lombardia,Lombardia,10060574,8214843,81.65,0.96
4397,2021-04-10,LOM,52758,21850,30908,40049,11958,751,ITC,ITC4,3,Lombardia,Lombardia,10060574,8267601,82.18,0.52
4398,2021-06-06,LOM,90129,46347,43782,79529,9222,1378,ITC,ITC4,3,Lombardia,Lombardia,10060574,8357730,83.07,0.9
4399,2021-01-07,LOM,11791,3648,8143,11751,0,40,ITC,ITC4,3,Lombardia,Lombardia,10060574,8369521,83.19,0.12
4400,2021-02-19,LOM,14222,5401,8821,13325,724,173,ITC,ITC4,3,Lombardia,Lombardia,10060574,8383743,83.33,0.14
4401,2021-04-17,LOM,48537,21315,27222,36966,10854,717,ITC,ITC4,3,Lombardia,Lombardia,10060574,8432280,83.82,0.48
4402,2021-05-09,LOM,69718,32890,36828,54471,13274,1973,ITC,ITC4,3,Lombardia,Lombardia,10060574,8501998,84.51,0.69
4403,2021-01-29,LOM,13513,4134,9379,686,12824,3,ITC,ITC4,3,Lombardia,Lombardia,10060574,8515511,84.64,0.13
4404,2021-06-13,LOM,75996,40560,35436,72285,2125,1586,ITC,ITC4,3,Lombardia,Lombardia,10060574,8591507,85.4,0.76
4405,2021-03-05,LOM,28968,11951,17017,20244,8424,300,ITC,ITC4,3,Lombardia,Lombardia,10060574,8620475,85.69,0.29
4406,2021-02-26,LOM,18433,7564,10869,16325,1904,204,ITC,ITC4,3,Lombardia,Lombardia,10060574,8638908,85.87,0.18
4407,2021-07-30,LOM,73136,39718,33418,35010,36009,2117,ITC,ITC4,3,Lombardia,Lombardia,10060574,8712044,86.6,0.73
4408,2020-12-31,LOM,714,302,412,714,0,0,ITC,ITC4,3,Lombardia,Lombardia,10060574,8712758,86.6,0.01
4409,2021-05-20,LOM,94492,45651,48841,31261,62583,648,ITC,ITC4,3,Lombardia,Lombardia,10060574,8807250,87.54,0.94
4410,2021-06-22,LOM,111020,57940,53080,79013,29888,2119,ITC,ITC4,3,Lombardia,Lombardia,10060574,8918270,88.65,1.1
4411,2021-07-09,LOM,115536,58892,56644,11725,102925,886,ITC,ITC4,3,Lombardia,Lombardia,10060574,9033806,89.79,1.15
4412,2021-06-03,LOM,97146,49719,47427,84606,10877,1663,ITC,ITC4,3,Lombardia,Lombardia,10060574,9130952,90.76,0.97
4413,2021-06-20,LOM,88965,44340,44625,52838,34887,1240,ITC,ITC4,3,Lombardia,Lombardia,10060574,9219917,91.64,0.88
4414,2021-03-12,LOM,35291,12972,22319,24457,10218,616,ITC,ITC4,3,Lombardia,Lombardia,10060574,9255208,91.99,0.35
4415,2021-03-29,LOM,40057,15545,24512,24534,14844,679,ITC,ITC4,3,Lombardia,Lombardia,10060574,9295265,92.39,0.4
4416,2021-05-11,LOM,86915,41451,45464,58264,26237,2414,ITC,ITC4,3,Lombardia,Lombardia,10060574,9382180,93.26,0.86
4417,2021-05-28,LOM,93628,44856,48772,42035,50679,914,ITC,ITC4,3,Lombardia,Lombardia,10060574,9475808,94.19,0.93
4418,2021-02-17,LOM,12000,3759,8241,10417,1390,193,ITC,ITC4,3,Lombardia,Lombardia,10060574,9487808,94.31,0.12
4419,2021-06-11,LOM,101465,51690,49775,84928,14649,1888,ITC,ITC4,3,Lombardia,Lombardia,10060574,9589273,95.32,1.01
4420,2021-03-10,LOM,33307,12737,20570,24845,7873,589,ITC,ITC4,3,Lombardia,Lombardia,10060574,9622580,95.65,0.33
4421,2021-05-06,LOM,89886,42210,47676,70988,16530,2368,ITC,ITC4,3,Lombardia,Lombardia,10060574,9712466,96.54,0.89
4422,2021-01-26,LOM,8353,2708,5645,348,8005,0,ITC,ITC4,3,Lombardia,Lombardia,10060574,9720819,96.62,0.08
4423,2021-06-01,LOM,93963,46105,47858,75755,17103,1105,ITC,ITC4,3,Lombardia,Lombardia,10060574,9814782,97.56,0.93
4424,2021-01-02,LOM,202,74,128,202,0,0,ITC,ITC4,3,Lombardia,Lombardia,10060574,9814984,97.56,0.0
4425,2021-06-08,LOM,102907,52304,50603,87158,14073,1676,ITC,ITC4,3,Lombardia,Lombardia,10060574,9917891,98.58,1.02
4426,2021-02-28,LOM,7885,3255,4630,7603,210,72,ITC,ITC4,3,Lombardia,Lombardia,10060574,9925776,98.66,0.08
4427,2021-04-26,LOM,88006,40942,47064,67070,19167,1769,ITC,ITC4,3,Lombardia,Lombardia,10060574,10013782,99.53,0.87
4428,2021-07-21,LOM,93957,48443,45514,8585,84491,881,ITC,ITC4,3,Lombardia,Lombardia,10060574,10107739,100.47,0.93
4429,2021-04-12,LOM,47261,20589,26672,32268,14357,636,ITC,ITC4,3,Lombardia,Lombardia,10060574,10155000,100.94,0.47
4430,2021-02-21,LOM,5053,1864,3189,4942,17,94,ITC,ITC4,3,Lombardia,Lombardia,10060574,10160053,100.99,0.05
4431,2021-07-28,LOM,77358,41685,35673,19084,56523,1751,ITC,ITC4,3,Lombardia,Lombardia,10060574,10237411,101.76,0.77
4432,2021-04-19,LOM,60127,27351,32776,49449,9408,1270,ITC,ITC4,3,Lombardia,Lombardia,10060574,10297538,102.36,0.6
4433,2021-06-15,LOM,95983,48849,47134,49019,45905,1059,ITC,ITC4,3,Lombardia,Lombardia,10060574,10393521,103.31,0.95
4434,2021-06-27,LOM,90908,46796,44112,69781,18831,2296,ITC,ITC4,3,Lombardia,Lombardia,10060574,10484429,104.21,0.9
4435,2021-03-19,LOM,32466,12933,19533,18910,13233,323,ITC,ITC4,3,Lombardia,Lombardia,10060574,10516895,104.54,0.32
4436,2021-05-27,LOM,94894,45457,49437,40619,53484,791,ITC,ITC4,3,Lombardia,Lombardia,10060574,10611789,105.48,0.94
4437,2021-04-24,LOM,75823,33602,42221,53439,21144,1240,ITC,ITC4,3,Lombardia,Lombardia,10060574,10687612,106.23,0.75
4438,2021-01-14,LOM,26945,7812,19133,26891,0,54,ITC,ITC4,3,Lombardia,Lombardia,10060574,10714557,106.5,0.27
4439,2021-04-05,LOM,27388,11697,15691,19029,8105,254,ITC,ITC4,3,Lombardia,Lombardia,10060574,10741945,106.77,0.27
4440,2021-05-08,LOM,87774,40772,47002,63481,22071,2222,ITC,ITC4,3,Lombardia,Lombardia,10060574,10829719,107.65,0.87
4441,2021-07-16,LOM,108883,56698,52185,11121,96592,1170,ITC,ITC4,3,Lombardia,Lombardia,10060574,10938602,108.73,1.08
4442,2021-04-07,LOM,50607,20929,29678,34080,15820,707,ITC,ITC4,3,Lombardia,Lombardia,10060574,10989209,109.23,0.5
4443,2021-01-31,LOM,9764,3778,5986,29,9735,0,ITC,ITC4,3,Lombardia,Lombardia,10060574,10998973,109.33,0.1
4444,2021-05-25,LOM,91172,43626,47546,43847,46500,825,ITC,ITC4,3,Lombardia,Lombardia,10060574,11090145,110.23,0.91
4445,2021-02-14,LOM,3584,1547,2037,2934,636,14,ITC,ITC4,3,Lombardia,Lombardia,10060574,11093729,110.27,0.04
4446,2021-01-12,LOM,20299,6723,13576,20270,0,29,ITC,ITC4,3,Lombardia,Lombardia,10060574,11114028,110.47,0.2
4447,2021-07-29,LOM,74184,40247,33937,33741,38492,1951,ITC,ITC4,3,Lombardia,Lombardia,10060574,11188212,111.21,0.74
4448,2021-02-20,LOM,9349,3870,5479,8847,307,195,ITC,ITC4,3,Lombardia,Lombardia,10060574,11197561,111.3,0.09
4449,2021-04-18,LOM,36407,16230,20177,30523,5241,643,ITC,ITC4,3,Lombardia,Lombardia,10060574,11233968,111.66,0.36
4450,2021-01-08,LOM,12727,3928,8799,12716,0,11,ITC,ITC4,3,Lombardia,Lombardia,10060574,11246695,111.79,0.13
4451,2021-01-15,LOM,25271,7448,17823,25219,0,52,ITC,ITC4,3,Lombardia,Lombardia,10060574,11271966,112.04,0.25
4452,2021-04-29,LOM,115587,53611,61976,83132,29879,2576,ITC,ITC4,3,Lombardia,Lombardia,10060574,11387553,113.19,1.15
4453,2021-06-25,LOM,108071,56081,51990,78215,27557,2299,ITC,ITC4,3,Lombardia,Lombardia,10060574,11495624,114.26,1.07
4454,2021-04-20,LOM,67691,30838,36853,55908,10351,1432,ITC,ITC4,3,Lombardia,Lombardia,10060574,11563315,114.94,0.67
4455,2021-01-10,LOM,10536,3972,6564,10527,0,9,ITC,ITC4,3,Lombardia,Lombardia,10060574,11573851,115.04,0.1
4456,2021-01-17,LOM,8353,3347,5006,8146,201,6,ITC,ITC4,3,Lombardia,Lombardia,10060574,11582204,115.12,0.08
4457,2021-06-23,LOM,110954,57409,53545,76765,32057,2132,ITC,ITC4,3,Lombardia,Lombardia,10060574,11693158,116.23,1.1
4458,2021-03-15,LOM,31575,11339,20236,22431,8530,614,ITC,ITC4,3,Lombardia,Lombardia,10060574,11724733,116.54,0.31
4459,2021-04-27,LOM,86081,40000,46081,67675,16597,1809,ITC,ITC4,3,Lombardia,Lombardia,10060574,11810814,117.4,0.86
4460,2021-03-17,LOM,26264,10499,15765,15102,11002,160,ITC,ITC4,3,Lombardia,Lombardia,10060574,11837078,117.66,0.26
4461,2021-07-04,LOM,86639,43333,43306,40176,44508,1955,ITC,ITC4,3,Lombardia,Lombardia,10060574,11923717,118.52,0.86
4462,2021-07-02,LOM,103837,52051,51786,48864,52766,2207,ITC,ITC4,3,Lombardia,Lombardia,10060574,12027554,119.55,1.03
4463,2021-03-24,LOM,43260,15620,27640,30471,11899,890,ITC,ITC4,3,Lombardia,Lombardia,10060574,12070814,119.98,0.43
4464,2021-02-09,LOM,12221,3335,8886,4025,8182,14,ITC,ITC4,3,Lombardia,Lombardia,10060574,12083035,120.1,0.12
