,data,area,Vaccinazioni giornaliere,sesso_maschile,sesso_femminile,prima_dose,seconda_dose,codice_NUTS1,codice_NUTS2,codice_regione_ISTAT,nome_area,Regione,popolazione,Totale vaccinazioni,Totale vaccinazioni ogni cento ab,Vaccinazioni giornaliere ogni cento ab
0,2021-06-01,PUG,9356,4668,4688,6102,3254,ITF,ITF4,16,Puglia,Puglia,4029053,9356,0.23,0.23
1,2021-03-29,PUG,12882,6006,6876,6150,6732,ITF,ITF4,16,Puglia,Puglia,4029053,22238,0.55,0.32
2,2021-05-15,PUG,42884,18687,24197,23291,19593,ITF,ITF4,16,Puglia,Puglia,4029053,65122,1.62,1.06
3,2021-03-12,PUG,13930,6107,7823,10005,3925,ITF,ITF4,16,Puglia,Puglia,4029053,79052,1.96,0.35
4,2021-02-23,PUG,9349,4422,4927,8874,475,ITF,ITF4,16,Puglia,Puglia,4029053,88401,2.19,0.23
5,2021-04-02,PUG,12589,5764,6825,8070,4519,ITF,ITF4,16,Puglia,Puglia,4029053,100990,2.51,0.31
6,2021-04-16,PUG,35831,16835,18996,32550,3281,ITF,ITF4,16,Puglia,Puglia,4029053,136821,3.4,0.89
7,2021-02-18,PUG,4378,1846,2532,3774,604,ITF,ITF4,16,Puglia,Puglia,4029053,141199,3.5,0.11
8,2021-02-11,PUG,3701,1402,2299,2423,1278,ITF,ITF4,16,Puglia,Puglia,4029053,144900,3.6,0.09
9,2021-01-31,PUG,1812,827,985,74,1738,ITF,ITF4,16,Puglia,Puglia,4029053,146712,3.64,0.04
10,2021-05-29,PUG,28947,13645,15302,20050,8897,ITF,ITF4,16,Puglia,Puglia,4029053,175659,4.36,0.72
11,2021-05-22,PUG,33987,15572,18415,23794,10193,ITF,ITF4,16,Puglia,Puglia,4029053,209646,5.2,0.84
12,2021-04-09,PUG,21838,9390,12448,17217,4621,ITF,ITF4,16,Puglia,Puglia,4029053,231484,5.75,0.54
13,2021-02-25,PUG,11956,5052,6904,10792,1164,ITF,ITF4,16,Puglia,Puglia,4029053,243440,6.04,0.3
14,2021-02-14,PUG,787,348,439,663,124,ITF,ITF4,16,Puglia,Puglia,4029053,244227,6.06,0.02
15,2021-01-28,PUG,5472,2277,3195,471,5001,ITF,ITF4,16,Puglia,Puglia,4029053,249699,6.2,0.14
16,2021-04-24,PUG,29229,13303,15926,25286,3943,ITF,ITF4,16,Puglia,Puglia,4029053,278928,6.92,0.73
17,2021-02-19,PUG,4730,2009,2721,4338,392,ITF,ITF4,16,Puglia,Puglia,4029053,283658,7.04,0.12
18,2021-04-19,PUG,27533,12774,14759,24487,3046,ITF,ITF4,16,Puglia,Puglia,4029053,311191,7.72,0.68
19,2021-01-07,PUG,5716,2457,3259,5716,0,ITF,ITF4,16,Puglia,Puglia,4029053,316907,7.87,0.14
20,2021-01-16,PUG,2507,1033,1474,2507,0,ITF,ITF4,16,Puglia,Puglia,4029053,319414,7.93,0.06
21,2021-03-16,PUG,9866,4684,5182,3509,6357,ITF,ITF4,16,Puglia,Puglia,4029053,329280,8.17,0.24
22,2021-04-28,PUG,19686,8815,10871,14936,4750,ITF,ITF4,16,Puglia,Puglia,4029053,348966,8.66,0.49
23,2021-02-07,PUG,1579,669,910,253,1326,ITF,ITF4,16,Puglia,Puglia,4029053,350545,8.7,0.04
24,2021-05-01,PUG,27449,12575,14874,16805,10644,ITF,ITF4,16,Puglia,Puglia,4029053,377994,9.38,0.68
25,2021-04-12,PUG,29088,13700,15388,26263,2825,ITF,ITF4,16,Puglia,Puglia,4029053,407082,10.1,0.72
26,2021-01-21,PUG,2132,904,1228,1271,861,ITF,ITF4,16,Puglia,Puglia,4029053,409214,10.16,0.05
27,2021-01-02,PUG,2949,1301,1648,2949,0,ITF,ITF4,16,Puglia,Puglia,4029053,412163,10.23,0.07
28,2021-03-26,PUG,11538,5420,6118,6893,4645,ITF,ITF4,16,Puglia,Puglia,4029053,423701,10.52,0.29
29,2021-03-28,PUG,3527,1650,1877,1202,2325,ITF,ITF4,16,Puglia,Puglia,4029053,427228,10.6,0.09
30,2021-05-10,PUG,37306,16452,20854,19460,17846,ITF,ITF4,16,Puglia,Puglia,4029053,464534,11.53,0.93
31,2021-04-04,PUG,5942,2951,2991,5937,5,ITF,ITF4,16,Puglia,Puglia,4029053,470476,11.68,0.15
32,2021-03-21,PUG,2692,1226,1466,588,2104,ITF,ITF4,16,Puglia,Puglia,4029053,473168,11.74,0.07
33,2021-05-24,PUG,34758,16105,18653,24294,10464,ITF,ITF4,16,Puglia,Puglia,4029053,507926,12.61,0.86
34,2021-01-30,PUG,5528,2515,3013,411,5117,ITF,ITF4,16,Puglia,Puglia,4029053,513454,12.74,0.14
35,2021-03-10,PUG,14408,6249,8159,11290,3118,ITF,ITF4,16,Puglia,Puglia,4029053,527862,13.1,0.36
36,2021-02-21,PUG,2175,472,1703,2114,61,ITF,ITF4,16,Puglia,Puglia,4029053,530037,13.16,0.05
37,2021-02-04,PUG,5926,2366,3560,1195,4731,ITF,ITF4,16,Puglia,Puglia,4029053,535963,13.3,0.15
38,2021-05-17,PUG,32185,14744,17441,20555,11630,ITF,ITF4,16,Puglia,Puglia,4029053,568148,14.1,0.8
39,2021-05-12,PUG,36153,16067,20086,23784,12369,ITF,ITF4,16,Puglia,Puglia,4029053,604301,15.0,0.9
40,2021-05-05,PUG,38792,16951,21841,24665,14127,ITF,ITF4,16,Puglia,Puglia,4029053,643093,15.96,0.96
41,2021-03-30,PUG,11870,5494,6376,5975,5895,ITF,ITF4,16,Puglia,Puglia,4029053,654963,16.26,0.29
42,2021-04-05,PUG,12687,6164,6523,12153,534,ITF,ITF4,16,Puglia,Puglia,4029053,667650,16.57,0.31
43,2021-05-25,PUG,33419,15196,18223,20412,13007,ITF,ITF4,16,Puglia,Puglia,4029053,701069,17.4,0.83
44,2021-03-19,PUG,7953,3650,4303,3408,4545,ITF,ITF4,16,Puglia,Puglia,4029053,709022,17.6,0.2
45,2021-05-08,PUG,53897,22796,31101,24284,29613,ITF,ITF4,16,Puglia,Puglia,4029053,762919,18.94,1.34
46,2021-01-19,PUG,1221,452,769,1211,10,ITF,ITF4,16,Puglia,Puglia,4029053,764140,18.97,0.03
47,2021-04-14,PUG,31795,15013,16782,28489,3306,ITF,ITF4,16,Puglia,Puglia,4029053,795935,19.75,0.79
48,2021-01-04,PUG,4506,2015,2491,4506,0,ITF,ITF4,16,Puglia,Puglia,4029053,800441,19.87,0.11
49,2021-03-09,PUG,13291,5790,7501,11283,2008,ITF,ITF4,16,Puglia,Puglia,4029053,813732,20.2,0.33
50,2021-02-06,PUG,4546,1928,2618,1590,2956,ITF,ITF4,16,Puglia,Puglia,4029053,818278,20.31,0.11
51,2021-01-20,PUG,1545,540,1005,1537,8,ITF,ITF4,16,Puglia,Puglia,4029053,819823,20.35,0.04
52,2021-05-02,PUG,21249,9638,11611,14000,7249,ITF,ITF4,16,Puglia,Puglia,4029053,841072,20.88,0.53
53,2021-01-03,PUG,2007,943,1064,2007,0,ITF,ITF4,16,Puglia,Puglia,4029053,843079,20.92,0.05
54,2021-04-15,PUG,32372,15097,17275,28873,3499,ITF,ITF4,16,Puglia,Puglia,4029053,875451,21.73,0.8
55,2021-04-17,PUG,39823,18867,20956,36257,3566,ITF,ITF4,16,Puglia,Puglia,4029053,915274,22.72,0.99
56,2021-01-14,PUG,4069,1589,2480,4069,0,ITF,ITF4,16,Puglia,Puglia,4029053,919343,22.82,0.1
57,2021-04-26,PUG,26065,11937,14128,22834,3231,ITF,ITF4,16,Puglia,Puglia,4029053,945408,23.46,0.65
58,2021-01-09,PUG,4885,2250,2635,4885,0,ITF,ITF4,16,Puglia,Puglia,4029053,950293,23.59,0.12
59,2021-03-14,PUG,3319,1429,1890,2508,811,ITF,ITF4,16,Puglia,Puglia,4029053,953612,23.67,0.08
60,2021-05-20,PUG,32572,14492,18080,20611,11961,ITF,ITF4,16,Puglia,Puglia,4029053,986184,24.48,0.81
61,2021-05-06,PUG,39250,17134,22116,19612,19638,ITF,ITF4,16,Puglia,Puglia,4029053,1025434,25.45,0.97
62,2021-05-13,PUG,38280,17026,21254,21248,17032,ITF,ITF4,16,Puglia,Puglia,4029053,1063714,26.4,0.95
63,2021-03-17,PUG,10345,4702,5643,4171,6174,ITF,ITF4,16,Puglia,Puglia,4029053,1074059,26.66,0.26
64,2021-02-09,PUG,3840,1570,2270,2168,1672,ITF,ITF4,16,Puglia,Puglia,4029053,1077899,26.75,0.1
65,2021-03-24,PUG,12976,5983,6993,5719,7257,ITF,ITF4,16,Puglia,Puglia,4029053,1090875,27.08,0.32
66,2021-01-26,PUG,5359,2397,2962,570,4789,ITF,ITF4,16,Puglia,Puglia,4029053,1096234,27.21,0.13
67,2021-03-31,PUG,14049,6357,7692,8494,5555,ITF,ITF4,16,Puglia,Puglia,4029053,1110283,27.56,0.35
68,2021-02-02,PUG,4343,1845,2498,593,3750,ITF,ITF4,16,Puglia,Puglia,4029053,1114626,27.66,0.11
69,2021-02-26,PUG,13715,5027,8688,12681,1034,ITF,ITF4,16,Puglia,Puglia,4029053,1128341,28.01,0.34
70,2020-12-31,PUG,1634,782,852,1634,0,ITF,ITF4,16,Puglia,Puglia,4029053,1129975,28.05,0.04
71,2021-03-05,PUG,17309,6865,10444,15070,2239,ITF,ITF4,16,Puglia,Puglia,4029053,1147284,28.48,0.43
72,2021-02-28,PUG,6045,1806,4239,5859,186,ITF,ITF4,16,Puglia,Puglia,4029053,1153329,28.63,0.15
73,2021-05-03,PUG,33083,14766,18317,22468,10615,ITF,ITF4,16,Puglia,Puglia,4029053,1186412,29.45,0.82
74,2021-03-07,PUG,4921,1943,2978,4350,571,ITF,ITF4,16,Puglia,Puglia,4029053,1191333,29.57,0.12
75,2021-01-23,PUG,3040,1294,1746,886,2154,ITF,ITF4,16,Puglia,Puglia,4029053,1194373,29.64,0.08
76,2020-12-30,PUG,1,0,1,1,0,ITF,ITF4,16,Puglia,Puglia,4029053,1194374,29.64,0.0
77,2021-04-27,PUG,26525,12006,14519,20940,5585,ITF,ITF4,16,Puglia,Puglia,4029053,1220899,30.3,0.66
78,2021-03-08,PUG,14604,6086,8518,12205,2399,ITF,ITF4,16,Puglia,Puglia,4029053,1235503,30.66,0.36
79,2021-01-24,PUG,1669,749,920,153,1516,ITF,ITF4,16,Puglia,Puglia,4029053,1237172,30.71,0.04
80,2021-05-19,PUG,25607,12140,13467,19317,6290,ITF,ITF4,16,Puglia,Puglia,4029053,1262779,31.34,0.64
81,2021-03-25,PUG,10890,5292,5598,4656,6234,ITF,ITF4,16,Puglia,Puglia,4029053,1273669,31.61,0.27
82,2021-02-10,PUG,3644,1436,2208,2134,1510,ITF,ITF4,16,Puglia,Puglia,4029053,1277313,31.7,0.09
83,2021-05-23,PUG,17689,8275,9414,13891,3798,ITF,ITF4,16,Puglia,Puglia,4029053,1295002,32.14,0.44
84,2021-05-28,PUG,41400,19290,22110,26714,14686,ITF,ITF4,16,Puglia,Puglia,4029053,1336402,33.17,1.03
85,2021-01-06,PUG,3946,1669,2277,3946,0,ITF,ITF4,16,Puglia,Puglia,4029053,1340348,33.27,0.1
86,2021-05-04,PUG,34780,14670,20110,18388,16392,ITF,ITF4,16,Puglia,Puglia,4029053,1375128,34.13,0.86
87,2021-03-22,PUG,9349,4554,4795,3705,5644,ITF,ITF4,16,Puglia,Puglia,4029053,1384477,34.36,0.23
88,2021-03-15,PUG,11783,5624,6159,5282,6501,ITF,ITF4,16,Puglia,Puglia,4029053,1396260,34.65,0.29
89,2021-01-17,PUG,1308,590,718,1239,69,ITF,ITF4,16,Puglia,Puglia,4029053,1397568,34.69,0.03
90,2021-03-13,PUG,10387,4103,6284,8655,1732,ITF,ITF4,16,Puglia,Puglia,4029053,1407955,34.95,0.26
91,2021-05-16,PUG,24329,10972,13357,12567,11762,ITF,ITF4,16,Puglia,Puglia,4029053,1432284,35.55,0.6
92,2021-05-18,PUG,28193,12923,15270,15634,12559,ITF,ITF4,16,Puglia,Puglia,4029053,1460477,36.25,0.7
93,2021-04-23,PUG,29295,13610,15685,24090,5205,ITF,ITF4,16,Puglia,Puglia,4029053,1489772,36.98,0.73
94,2021-03-04,PUG,15113,5903,9210,13715,1398,ITF,ITF4,16,Puglia,Puglia,4029053,1504885,37.35,0.38
95,2021-05-07,PUG,49352,22005,27347,26112,23240,ITF,ITF4,16,Puglia,Puglia,4029053,1554237,38.58,1.22
96,2021-02-15,PUG,3252,1268,1984,2632,620,ITF,ITF4,16,Puglia,Puglia,4029053,1557489,38.66,0.08
97,2021-04-06,PUG,13579,6026,7553,6829,6750,ITF,ITF4,16,Puglia,Puglia,4029053,1571068,38.99,0.34
98,2021-04-20,PUG,21054,9771,11283,17611,3443,ITF,ITF4,16,Puglia,Puglia,4029053,1592122,39.52,0.52
99,2021-02-13,PUG,3726,1455,2271,3031,695,ITF,ITF4,16,Puglia,Puglia,4029053,1595848,39.61,0.09
100,2021-05-09,PUG,30464,12477,17987,14920,15544,ITF,ITF4,16,Puglia,Puglia,4029053,1626312,40.36,0.76
101,2021-01-29,PUG,6195,2661,3534,436,5759,ITF,ITF4,16,Puglia,Puglia,4029053,1632507,40.52,0.15
102,2021-03-20,PUG,8255,3734,4521,3666,4589,ITF,ITF4,16,Puglia,Puglia,4029053,1640762,40.72,0.2
103,2021-02-12,PUG,4164,1659,2505,3072,1092,ITF,ITF4,16,Puglia,Puglia,4029053,1644926,40.83,0.1
104,2021-05-31,PUG,33993,15992,18001,21539,12454,ITF,ITF4,16,Puglia,Puglia,4029053,1678919,41.67,0.84
105,2021-04-11,PUG,16443,7240,9203,14787,1656,ITF,ITF4,16,Puglia,Puglia,4029053,1695362,42.08,0.41
106,2021-04-18,PUG,22532,10773,11759,21467,1065,ITF,ITF4,16,Puglia,Puglia,4029053,1717894,42.64,0.56
107,2021-02-20,PUG,2969,1080,1889,2713,256,ITF,ITF4,16,Puglia,Puglia,4029053,1720863,42.71,0.07
108,2021-04-25,PUG,11193,5193,6000,10036,1157,ITF,ITF4,16,Puglia,Puglia,4029053,1732056,42.99,0.28
109,2021-02-27,PUG,14212,4812,9400,12987,1225,ITF,ITF4,16,Puglia,Puglia,4029053,1746268,43.34,0.35
110,2021-01-01,PUG,148,61,87,148,0,ITF,ITF4,16,Puglia,Puglia,4029053,1746416,43.35,0.0
111,2021-03-06,PUG,15974,5967,10007,13887,2087,ITF,ITF4,16,Puglia,Puglia,4029053,1762390,43.74,0.4
112,2021-01-08,PUG,5597,2347,3250,5597,0,ITF,ITF4,16,Puglia,Puglia,4029053,1767987,43.88,0.14
113,2021-01-15,PUG,4552,1866,2686,4552,0,ITF,ITF4,16,Puglia,Puglia,4029053,1772539,43.99,0.11
114,2021-01-22,PUG,1409,578,831,991,418,ITF,ITF4,16,Puglia,Puglia,4029053,1773948,44.03,0.03
115,2021-02-01,PUG,3965,1659,2306,375,3590,ITF,ITF4,16,Puglia,Puglia,4029053,1777913,44.13,0.1
116,2021-01-25,PUG,3823,1680,2143,423,3400,ITF,ITF4,16,Puglia,Puglia,4029053,1781736,44.22,0.09
117,2021-05-14,PUG,44558,20319,24239,28505,16053,ITF,ITF4,16,Puglia,Puglia,4029053,1826294,45.33,1.11
118,2021-04-08,PUG,17443,7569,9874,11270,6173,ITF,ITF4,16,Puglia,Puglia,4029053,1843737,45.76,0.43
119,2021-04-01,PUG,13504,6158,7346,7161,6343,ITF,ITF4,16,Puglia,Puglia,4029053,1857241,46.1,0.34
120,2021-02-03,PUG,5036,2005,3031,730,4306,ITF,ITF4,16,Puglia,Puglia,4029053,1862277,46.22,0.12
121,2021-01-18,PUG,1845,770,1075,1496,349,ITF,ITF4,16,Puglia,Puglia,4029053,1864122,46.27,0.05
122,2021-04-30,PUG,34617,15479,19138,22682,11935,ITF,ITF4,16,Puglia,Puglia,4029053,1898739,47.13,0.86
123,2021-04-13,PUG,28615,13561,15054,25218,3397,ITF,ITF4,16,Puglia,Puglia,4029053,1927354,47.84,0.71
124,2021-03-27,PUG,12138,5702,6436,6977,5161,ITF,ITF4,16,Puglia,Puglia,4029053,1939492,48.14,0.3
125,2021-01-05,PUG,5104,2249,2855,5104,0,ITF,ITF4,16,Puglia,Puglia,4029053,1944596,48.26,0.13
126,2021-03-11,PUG,14382,6195,8187,11274,3108,ITF,ITF4,16,Puglia,Puglia,4029053,1958978,48.62,0.36
127,2021-02-22,PUG,9629,4536,5093,9297,332,ITF,ITF4,16,Puglia,Puglia,4029053,1968607,48.86,0.24
128,2021-02-24,PUG,10034,4703,5331,9445,589,ITF,ITF4,16,Puglia,Puglia,4029053,1978641,49.11,0.25
129,2021-04-29,PUG,25920,11997,13923,19265,6655,ITF,ITF4,16,Puglia,Puglia,4029053,2004561,49.75,0.64
130,2021-03-23,PUG,10411,4999,5412,3941,6470,ITF,ITF4,16,Puglia,Puglia,4029053,2014972,50.01,0.26
131,2021-05-21,PUG,37745,17667,20078,28115,9630,ITF,ITF4,16,Puglia,Puglia,4029053,2052717,50.95,0.94
132,2021-02-08,PUG,3992,1610,2382,1597,2395,ITF,ITF4,16,Puglia,Puglia,4029053,2056709,51.05,0.1
133,2021-02-17,PUG,4272,1744,2528,3670,602,ITF,ITF4,16,Puglia,Puglia,4029053,2060981,51.15,0.11
134,2021-05-11,PUG,32221,14176,18045,13892,18329,ITF,ITF4,16,Puglia,Puglia,4029053,2093202,51.95,0.8
135,2021-04-03,PUG,10542,4634,5908,6988,3554,ITF,ITF4,16,Puglia,Puglia,4029053,2103744,52.21,0.26
136,2021-05-26,PUG,37086,17420,19666,26058,11028,ITF,ITF4,16,Puglia,Puglia,4029053,2140830,53.13,0.92
137,2021-01-13,PUG,4541,1731,2810,4541,0,ITF,ITF4,16,Puglia,Puglia,4029053,2145371,53.25,0.11
138,2021-03-18,PUG,9401,4254,5147,3284,6117,ITF,ITF4,16,Puglia,Puglia,4029053,2154772,53.48,0.23
139,2021-01-27,PUG,4580,1931,2649,611,3969,ITF,ITF4,16,Puglia,Puglia,4029053,2159352,53.59,0.11
140,2021-03-01,PUG,15089,5861,9228,13719,1370,ITF,ITF4,16,Puglia,Puglia,4029053,2174441,53.97,0.37
141,2021-01-10,PUG,2348,1061,1287,2348,0,ITF,ITF4,16,Puglia,Puglia,4029053,2176789,54.03,0.06
142,2020-12-27,PUG,509,252,257,509,0,ITF,ITF4,16,Puglia,Puglia,4029053,2177298,54.04,0.01
143,2021-02-05,PUG,5635,2273,3362,1333,4302,ITF,ITF4,16,Puglia,Puglia,4029053,2182933,54.18,0.14
144,2021-05-30,PUG,20156,9635,10521,15259,4897,ITF,ITF4,16,Puglia,Puglia,4029053,2203089,54.68,0.5
145,2021-04-10,PUG,30717,13027,17690,26494,4223,ITF,ITF4,16,Puglia,Puglia,4029053,2233806,55.44,0.76
146,2021-01-12,PUG,4212,1772,2440,4212,0,ITF,ITF4,16,Puglia,Puglia,4029053,2238018,55.55,0.1
147,2021-04-07,PUG,15328,6790,8538,8658,6670,ITF,ITF4,16,Puglia,Puglia,4029053,2253346,55.93,0.38
148,2021-05-27,PUG,38514,17717,20797,22397,16117,ITF,ITF4,16,Puglia,Puglia,4029053,2291860,56.88,0.96
149,2021-04-21,PUG,23053,10636,12417,19320,3733,ITF,ITF4,16,Puglia,Puglia,4029053,2314913,57.46,0.57
150,2021-02-16,PUG,3379,1452,1927,2735,644,ITF,ITF4,16,Puglia,Puglia,4029053,2318292,57.54,0.08
151,2021-03-02,PUG,16342,6068,10274,15042,1300,ITF,ITF4,16,Puglia,Puglia,4029053,2334634,57.94,0.41
152,2021-01-11,PUG,3753,1588,2165,3753,0,ITF,ITF4,16,Puglia,Puglia,4029053,2338387,58.04,0.09
153,2021-04-22,PUG,22895,10461,12434,18029,4866,ITF,ITF4,16,Puglia,Puglia,4029053,2361282,58.61,0.57
154,2021-03-03,PUG,16669,6705,9964,14757,1912,ITF,ITF4,16,Puglia,Puglia,4029053,2377951,59.02,0.41
155,2021-01-18,CAM,957,399,558,713,244,ITF,ITF3,15,Campania,Campania,5801692,957,0.02,0.02
156,2021-04-30,CAM,42231,20132,22099,25783,16448,ITF,ITF3,15,Campania,Campania,5801692,43188,0.74,0.73
157,2021-05-17,CAM,49217,21604,27613,24078,25139,ITF,ITF3,15,Campania,Campania,5801692,92405,1.59,0.85
158,2021-02-04,CAM,7943,3429,4514,1308,6635,ITF,ITF3,15,Campania,Campania,5801692,100348,1.73,0.14
159,2021-01-01,CAM,919,506,413,919,0,ITF,ITF3,15,Campania,Campania,5801692,101267,1.75,0.02
160,2021-01-30,CAM,10721,5079,5642,38,10683,ITF,ITF3,15,Campania,Campania,5801692,111988,1.93,0.18
161,2021-01-23,CAM,3838,2028,1810,273,3565,ITF,ITF3,15,Campania,Campania,5801692,115826,2.0,0.07
162,2021-04-08,CAM,28269,13639,14630,22433,5836,ITF,ITF3,15,Campania,Campania,5801692,144095,2.48,0.49
163,2021-04-01,CAM,24338,11687,12651,20205,4133,ITF,ITF3,15,Campania,Campania,5801692,168433,2.9,0.42
164,2021-05-21,CAM,63378,29336,34042,43178,20200,ITF,ITF3,15,Campania,Campania,5801692,231811,4.0,1.09
165,2021-01-16,CAM,3369,1675,1694,3369,0,ITF,ITF3,15,Campania,Campania,5801692,235180,4.05,0.06
166,2021-03-21,CAM,9983,4592,5391,7593,2390,ITF,ITF3,15,Campania,Campania,5801692,245163,4.23,0.17
167,2021-02-10,CAM,6904,3413,3491,6728,176,ITF,ITF3,15,Campania,Campania,5801692,252067,4.34,0.12
168,2021-05-28,CAM,71177,34100,37077,26741,44436,ITF,ITF3,15,Campania,Campania,5801692,323244,5.57,1.23
169,2021-05-14,CAM,60792,27461,33331,36304,24488,ITF,ITF3,15,Campania,Campania,5801692,384036,6.62,1.05
170,2021-02-13,CAM,5508,2550,2958,5291,217,ITF,ITF3,15,Campania,Campania,5801692,389544,6.71,0.09
171,2021-04-04,CAM,7958,4012,3946,6914,1044,ITF,ITF3,15,Campania,Campania,5801692,397502,6.85,0.14
172,2021-01-27,CAM,7738,3820,3918,162,7576,ITF,ITF3,15,Campania,Campania,5801692,405240,6.98,0.13
173,2021-03-18,CAM,12172,5378,6794,5984,6188,ITF,ITF3,15,Campania,Campania,5801692,417412,7.19,0.21
174,2021-02-25,CAM,12425,4478,7947,11237,1188,ITF,ITF3,15,Campania,Campania,5801692,429837,7.41,0.21
175,2021-04-09,CAM,29844,13964,15880,23717,6127,ITF,ITF3,15,Campania,Campania,5801692,459681,7.92,0.51
176,2021-01-22,CAM,1524,776,748,673,851,ITF,ITF3,15,Campania,Campania,5801692,461205,7.95,0.03
177,2021-03-06,CAM,16308,6753,9555,10639,5669,ITF,ITF3,15,Campania,Campania,5801692,477513,8.23,0.28
178,2021-05-31,CAM,40064,20081,19983,30070,9994,ITF,ITF3,15,Campania,Campania,5801692,517577,8.92,0.69
179,2021-03-28,CAM,15552,7501,8051,13927,1625,ITF,ITF3,15,Campania,Campania,5801692,533129,9.19,0.27
180,2021-05-16,CAM,51098,23191,27907,33567,17531,ITF,ITF3,15,Campania,Campania,5801692,584227,10.07,0.88
181,2021-02-03,CAM,8903,4003,4900,878,8025,ITF,ITF3,15,Campania,Campania,5801692,593130,10.22,0.15
182,2021-03-11,CAM,17584,8672,8912,10306,7278,ITF,ITF3,15,Campania,Campania,5801692,610714,10.53,0.3
183,2021-02-20,CAM,8573,3080,5493,8270,303,ITF,ITF3,15,Campania,Campania,5801692,619287,10.67,0.15
184,2021-03-20,CAM,13881,6429,7452,10142,3739,ITF,ITF3,15,Campania,Campania,5801692,633168,10.91,0.24
185,2021-05-09,CAM,43169,20272,22897,32079,11090,ITF,ITF3,15,Campania,Campania,5801692,676337,11.66,0.74
186,2021-04-11,CAM,17522,8605,8917,15440,2082,ITF,ITF3,15,Campania,Campania,5801692,693859,11.96,0.3
187,2021-02-06,CAM,5340,2665,2675,2102,3238,ITF,ITF3,15,Campania,Campania,5801692,699199,12.05,0.09
188,2021-04-28,CAM,36391,17612,18779,26641,9750,ITF,ITF3,15,Campania,Campania,5801692,735590,12.68,0.63
189,2021-01-03,CAM,3837,2009,1828,3837,0,ITF,ITF3,15,Campania,Campania,5801692,739427,12.75,0.07
190,2021-03-25,CAM,19991,9335,10656,16488,3503,ITF,ITF3,15,Campania,Campania,5801692,759418,13.09,0.34
191,2021-01-20,CAM,1257,650,607,1257,0,ITF,ITF3,15,Campania,Campania,5801692,760675,13.11,0.02
192,2021-04-27,CAM,32116,15593,16523,24197,7919,ITF,ITF3,15,Campania,Campania,5801692,792791,13.66,0.55
193,2021-03-22,CAM,12740,5921,6819,10700,2040,ITF,ITF3,15,Campania,Campania,5801692,805531,13.88,0.22
194,2021-04-23,CAM,32298,15507,16791,23162,9136,ITF,ITF3,15,Campania,Campania,5801692,837829,14.44,0.56
195,2021-03-04,CAM,14659,5352,9307,8766,5893,ITF,ITF3,15,Campania,Campania,5801692,852488,14.69,0.25
196,2021-05-24,CAM,31061,14890,16171,16173,14888,ITF,ITF3,15,Campania,Campania,5801692,883549,15.23,0.54
197,2021-05-07,CAM,59707,29179,30528,43765,15942,ITF,ITF3,15,Campania,Campania,5801692,943256,16.26,1.03
198,2021-01-04,CAM,5825,2962,2863,5825,0,ITF,ITF3,15,Campania,Campania,5801692,949081,16.36,0.1
199,2021-03-09,CAM,13880,6637,7243,10095,3785,ITF,ITF3,15,Campania,Campania,5801692,962961,16.6,0.24
200,2021-02-22,CAM,10680,3294,7386,10417,263,ITF,ITF3,15,Campania,Campania,5801692,973641,16.78,0.18
201,2021-04-13,CAM,26599,12682,13917,21069,5530,ITF,ITF3,15,Campania,Campania,5801692,1000240,17.24,0.46
202,2021-03-10,CAM,15252,7381,7871,8418,6834,ITF,ITF3,15,Campania,Campania,5801692,1015492,17.5,0.26
203,2021-03-27,CAM,21279,10032,11247,17415,3864,ITF,ITF3,15,Campania,Campania,5801692,1036771,17.87,0.37
204,2021-02-27,CAM,13950,4473,9477,12308,1642,ITF,ITF3,15,Campania,Campania,5801692,1050721,18.11,0.24
205,2021-05-02,CAM,43482,21537,21945,32132,11350,ITF,ITF3,15,Campania,Campania,5801692,1094203,18.86,0.75
206,2021-03-16,CAM,8086,3519,4567,3772,4314,ITF,ITF3,15,Campania,Campania,5801692,1102289,19.0,0.14
207,2021-01-25,CAM,5745,2927,2818,164,5581,ITF,ITF3,15,Campania,Campania,5801692,1108034,19.1,0.1
208,2021-03-23,CAM,15335,7055,8280,12822,2513,ITF,ITF3,15,Campania,Campania,5801692,1123369,19.36,0.26
209,2021-05-19,CAM,51009,22492,28517,34512,16497,ITF,ITF3,15,Campania,Campania,5801692,1174378,20.24,0.88
210,2021-05-12,CAM,40794,19912,20882,31657,9137,ITF,ITF3,15,Campania,Campania,5801692,1215172,20.95,0.7
211,2021-05-05,CAM,51124,24838,26286,44748,6376,ITF,ITF3,15,Campania,Campania,5801692,1266296,21.83,0.88
212,2021-02-08,CAM,5113,2449,2664,4310,803,ITF,ITF3,15,Campania,Campania,5801692,1271409,21.91,0.09
213,2021-02-01,CAM,3985,1813,2172,110,3875,ITF,ITF3,15,Campania,Campania,5801692,1275394,21.98,0.07
214,2021-03-30,CAM,21729,10272,11457,18771,2958,ITF,ITF3,15,Campania,Campania,5801692,1297123,22.36,0.37
215,2021-01-06,CAM,7652,3749,3903,7652,0,ITF,ITF3,15,Campania,Campania,5801692,1304775,22.49,0.13
216,2021-02-11,CAM,6278,2704,3574,6212,66,ITF,ITF3,15,Campania,Campania,5801692,1311053,22.6,0.11
217,2021-04-16,CAM,34301,16552,17749,23643,10658,ITF,ITF3,15,Campania,Campania,5801692,1345354,23.19,0.59
218,2021-02-18,CAM,9080,3812,5268,8372,708,ITF,ITF3,15,Campania,Campania,5801692,1354434,23.35,0.16
219,2021-01-15,CAM,4980,2381,2599,4980,0,ITF,ITF3,15,Campania,Campania,5801692,1359414,23.43,0.09
220,2021-03-13,CAM,14249,6795,7454,8967,5282,ITF,ITF3,15,Campania,Campania,5801692,1373663,23.68,0.25
221,2021-04-25,CAM,30725,15172,15553,25333,5392,ITF,ITF3,15,Campania,Campania,5801692,1404388,24.21,0.53
222,2021-01-13,CAM,8020,3666,4354,8020,0,ITF,ITF3,15,Campania,Campania,5801692,1412408,24.34,0.14
223,2021-04-18,CAM,27214,13281,13933,18316,8898,ITF,ITF3,15,Campania,Campania,5801692,1439622,24.81,0.47
224,2021-01-08,CAM,10455,4968,5487,10455,0,ITF,ITF3,15,Campania,Campania,5801692,1450077,24.99,0.18
225,2021-01-05,CAM,7238,3637,3601,7238,0,ITF,ITF3,15,Campania,Campania,5801692,1457315,25.12,0.12
226,2021-02-17,CAM,7388,3210,4178,6328,1060,ITF,ITF3,15,Campania,Campania,5801692,1464703,25.25,0.13
227,2021-03-14,CAM,8502,3721,4781,4363,4139,ITF,ITF3,15,Campania,Campania,5801692,1473205,25.39,0.15
228,2021-04-26,CAM,33999,16635,17364,28377,5622,ITF,ITF3,15,Campania,Campania,5801692,1507204,25.98,0.59
229,2021-05-13,CAM,55378,24808,30570,39388,15990,ITF,ITF3,15,Campania,Campania,5801692,1562582,26.93,0.95
230,2021-01-31,CAM,8067,3711,4356,23,8044,ITF,ITF3,15,Campania,Campania,5801692,1570649,27.07,0.14
231,2021-05-04,CAM,48432,23330,25102,39544,8888,ITF,ITF3,15,Campania,Campania,5801692,1619081,27.91,0.83
232,2021-03-31,CAM,22685,10906,11779,19246,3439,ITF,ITF3,15,Campania,Campania,5801692,1641766,28.3,0.39
233,2021-02-24,CAM,11786,4149,7637,11098,688,ITF,ITF3,15,Campania,Campania,5801692,1653552,28.5,0.2
234,2021-04-15,CAM,34337,16658,17679,24440,9897,ITF,ITF3,15,Campania,Campania,5801692,1687889,29.09,0.59
235,2021-05-10,CAM,35400,16370,19030,25492,9908,ITF,ITF3,15,Campania,Campania,5801692,1723289,29.7,0.61
236,2021-03-07,CAM,11911,5344,6567,8068,3843,ITF,ITF3,15,Campania,Campania,5801692,1735200,29.91,0.21
237,2021-05-03,CAM,40745,19884,20861,28899,11846,ITF,ITF3,15,Campania,Campania,5801692,1775945,30.61,0.7
238,2021-02-05,CAM,7260,3463,3797,2133,5127,ITF,ITF3,15,Campania,Campania,5801692,1783205,30.74,0.13
239,2021-01-21,CAM,2092,1115,977,676,1416,ITF,ITF3,15,Campania,Campania,5801692,1785297,30.77,0.04
240,2021-03-26,CAM,19458,8929,10529,15644,3814,ITF,ITF3,15,Campania,Campania,5801692,1804755,31.11,0.34
241,2021-05-01,CAM,46319,22654,23665,30221,16098,ITF,ITF3,15,Campania,Campania,5801692,1851074,31.91,0.8
242,2021-04-05,CAM,11638,5543,6095,9215,2423,ITF,ITF3,15,Campania,Campania,5801692,1862712,32.11,0.2
243,2021-05-25,CAM,45950,21931,24019,22885,23065,ITF,ITF3,15,Campania,Campania,5801692,1908662,32.9,0.79
244,2021-04-22,CAM,33941,16530,17411,21539,12402,ITF,ITF3,15,Campania,Campania,5801692,1942603,33.48,0.59
245,2021-01-09,CAM,10567,5024,5543,10567,0,ITF,ITF3,15,Campania,Campania,5801692,1953170,33.67,0.18
246,2021-02-12,CAM,6529,2861,3668,6343,186,ITF,ITF3,15,Campania,Campania,5801692,1959699,33.78,0.11
247,2021-04-03,CAM,21115,10315,10800,18735,2380,ITF,ITF3,15,Campania,Campania,5801692,1980814,34.14,0.36
248,2021-05-23,CAM,58717,28617,30100,37840,20877,ITF,ITF3,15,Campania,Campania,5801692,2039531,35.15,1.01
249,2021-01-29,CAM,10052,4812,5240,47,10005,ITF,ITF3,15,Campania,Campania,5801692,2049583,35.33,0.17
250,2021-03-19,CAM,11037,4870,6167,7165,3872,ITF,ITF3,15,Campania,Campania,5801692,2060620,35.52,0.19
251,2021-01-28,CAM,8832,4121,4711,134,8698,ITF,ITF3,15,Campania,Campania,5801692,2069452,35.67,0.15
252,2021-05-08,CAM,56343,27099,29244,40524,15819,ITF,ITF3,15,Campania,Campania,5801692,2125795,36.64,0.97
253,2021-04-17,CAM,36172,17506,18666,24666,11506,ITF,ITF3,15,Campania,Campania,5801692,2161967,37.26,0.62
254,2021-02-19,CAM,9570,3559,6011,8920,650,ITF,ITF3,15,Campania,Campania,5801692,2171537,37.43,0.16
255,2020-12-31,CAM,1490,811,679,1490,0,ITF,ITF3,15,Campania,Campania,5801692,2173027,37.46,0.03
256,2021-02-26,CAM,13339,4230,9109,12004,1335,ITF,ITF3,15,Campania,Campania,5801692,2186366,37.68,0.23
257,2021-04-24,CAM,36328,17519,18809,25082,11246,ITF,ITF3,15,Campania,Campania,5801692,2222694,38.31,0.63
258,2021-05-30,CAM,48868,23811,25057,38810,10058,ITF,ITF3,15,Campania,Campania,5801692,2271562,39.15,0.84
259,2021-04-10,CAM,28341,13486,14855,23428,4913,ITF,ITF3,15,Campania,Campania,5801692,2299903,39.64,0.49
260,2021-01-07,CAM,8910,4166,4744,8910,0,ITF,ITF3,15,Campania,Campania,5801692,2308813,39.8,0.15
261,2021-03-05,CAM,16483,6348,10135,9820,6663,ITF,ITF3,15,Campania,Campania,5801692,2325296,40.08,0.28
262,2021-02-07,CAM,2929,1382,1547,2158,771,ITF,ITF3,15,Campania,Campania,5801692,2328225,40.13,0.05
263,2021-01-17,CAM,1155,551,604,702,453,ITF,ITF3,15,Campania,Campania,5801692,2329380,40.15,0.02
264,2021-03-15,CAM,12932,6088,6844,8187,4745,ITF,ITF3,15,Campania,Campania,5801692,2342312,40.37,0.22
265,2021-02-16,CAM,5440,2411,3029,4669,771,ITF,ITF3,15,Campania,Campania,5801692,2347752,40.47,0.09
266,2021-02-09,CAM,4643,2202,2441,4391,252,ITF,ITF3,15,Campania,Campania,5801692,2352395,40.55,0.08
267,2021-05-27,CAM,72304,34764,37540,26221,46083,ITF,ITF3,15,Campania,Campania,5801692,2424699,41.79,1.25
268,2021-03-24,CAM,17620,8082,9538,14663,2957,ITF,ITF3,15,Campania,Campania,5801692,2442319,42.1,0.3
269,2021-05-20,CAM,60443,27824,32619,43072,17371,ITF,ITF3,15,Campania,Campania,5801692,2502762,43.14,1.04
270,2021-03-29,CAM,18947,9134,9813,17401,1546,ITF,ITF3,15,Campania,Campania,5801692,2521709,43.47,0.33
271,2021-06-01,CAM,13328,6979,6349,8696,4632,ITF,ITF3,15,Campania,Campania,5801692,2535037,43.69,0.23
272,2021-05-15,CAM,62601,29025,33576,43936,18665,ITF,ITF3,15,Campania,Campania,5801692,2597638,44.77,1.08
273,2021-02-23,CAM,11003,3388,7615,10477,526,ITF,ITF3,15,Campania,Campania,5801692,2608641,44.96,0.19
274,2021-03-12,CAM,14248,7097,7151,8166,6082,ITF,ITF3,15,Campania,Campania,5801692,2622889,45.21,0.25
275,2021-01-19,CAM,1095,474,621,1092,3,ITF,ITF3,15,Campania,Campania,5801692,2623984,45.23,0.02
276,2021-05-18,CAM,52047,23142,28905,32506,19541,ITF,ITF3,15,Campania,Campania,5801692,2676031,46.13,0.9
277,2021-04-29,CAM,41283,20007,21276,24818,16465,ITF,ITF3,15,Campania,Campania,5801692,2717314,46.84,0.71
278,2021-04-14,CAM,27639,13330,14309,19073,8566,ITF,ITF3,15,Campania,Campania,5801692,2744953,47.31,0.48
279,2021-01-02,CAM,3673,1962,1711,3673,0,ITF,ITF3,15,Campania,Campania,5801692,2748626,47.38,0.06
280,2021-04-12,CAM,23301,10916,12385,20265,3036,ITF,ITF3,15,Campania,Campania,5801692,2771927,47.78,0.4
281,2021-01-24,CAM,4128,2123,2005,383,3745,ITF,ITF3,15,Campania,Campania,5801692,2776055,47.85,0.07
282,2021-03-08,CAM,14541,6717,7824,9765,4776,ITF,ITF3,15,Campania,Campania,5801692,2790596,48.1,0.25
283,2021-05-11,CAM,39834,19230,20604,30465,9369,ITF,ITF3,15,Campania,Campania,5801692,2830430,48.79,0.69
284,2021-04-07,CAM,24753,11780,12973,20031,4722,ITF,ITF3,15,Campania,Campania,5801692,2855183,49.21,0.43
285,2021-04-02,CAM,21729,10410,11319,19408,2321,ITF,ITF3,15,Campania,Campania,5801692,2876912,49.59,0.37
286,2021-02-02,CAM,5723,2804,2919,444,5279,ITF,ITF3,15,Campania,Campania,5801692,2882635,49.69,0.1
287,2021-05-22,CAM,67835,32439,35396,46439,21396,ITF,ITF3,15,Campania,Campania,5801692,2950470,50.86,1.17
288,2021-02-21,CAM,5834,2239,3595,5609,225,ITF,ITF3,15,Campania,Campania,5801692,2956304,50.96,0.1
289,2021-03-17,CAM,11588,5099,6489,5008,6580,ITF,ITF3,15,Campania,Campania,5801692,2967892,51.16,0.2
290,2021-03-03,CAM,13921,5494,8427,7291,6630,ITF,ITF3,15,Campania,Campania,5801692,2981813,51.4,0.24
291,2021-01-12,CAM,5214,2563,2651,5214,0,ITF,ITF3,15,Campania,Campania,5801692,2987027,51.49,0.09
292,2021-05-06,CAM,57252,27890,29362,42812,14440,ITF,ITF3,15,Campania,Campania,5801692,3044279,52.47,0.99
293,2021-02-28,CAM,10412,3206,7206,8512,1900,ITF,ITF3,15,Campania,Campania,5801692,3054691,52.65,0.18
294,2021-02-14,CAM,3928,1923,2005,3894,34,ITF,ITF3,15,Campania,Campania,5801692,3058619,52.72,0.07
295,2021-04-19,CAM,30730,14818,15912,19163,11567,ITF,ITF3,15,Campania,Campania,5801692,3089349,53.25,0.53
296,2021-01-14,CAM,7073,2977,4096,7073,0,ITF,ITF3,15,Campania,Campania,5801692,3096422,53.37,0.12
297,2021-01-26,CAM,7340,3726,3614,351,6989,ITF,ITF3,15,Campania,Campania,5801692,3103762,53.5,0.13
298,2021-05-29,CAM,63983,30382,33601,43929,20054,ITF,ITF3,15,Campania,Campania,5801692,3167745,54.6,1.1
299,2021-05-26,CAM,52000,25383,26617,21130,30870,ITF,ITF3,15,Campania,Campania,5801692,3219745,55.5,0.9
300,2021-03-02,CAM,12756,4554,8202,8411,4345,ITF,ITF3,15,Campania,Campania,5801692,3232501,55.72,0.22
301,2021-01-11,CAM,4072,1871,2201,4072,0,ITF,ITF3,15,Campania,Campania,5801692,3236573,55.79,0.07
302,2020-12-27,CAM,720,422,298,720,0,ITF,ITF3,15,Campania,Campania,5801692,3237293,55.8,0.01
303,2021-04-20,CAM,32010,15490,16520,20704,11306,ITF,ITF3,15,Campania,Campania,5801692,3269303,56.35,0.55
304,2021-03-01,CAM,12130,4247,7883,8017,4113,ITF,ITF3,15,Campania,Campania,5801692,3281433,56.56,0.21
305,2021-04-06,CAM,24370,11419,12951,19848,4522,ITF,ITF3,15,Campania,Campania,5801692,3305803,56.98,0.42
306,2021-02-15,CAM,5470,2516,2954,5297,173,ITF,ITF3,15,Campania,Campania,5801692,3311273,57.07,0.09
307,2021-01-10,CAM,8165,3736,4429,8165,0,ITF,ITF3,15,Campania,Campania,5801692,3319438,57.21,0.14
308,2021-04-21,CAM,30220,14723,15497,17993,12227,ITF,ITF3,15,Campania,Campania,5801692,3349658,57.74,0.52
309,2021-02-24,BAS,1803,743,1060,1734,69,ITF,ITF5,17,Basilicata,Basilicata,559084,1803,0.32,0.32
310,2021-03-13,BAS,1796,889,907,751,1045,ITF,ITF5,17,Basilicata,Basilicata,559084,3599,0.64,0.32
311,2021-02-07,BAS,373,159,214,49,324,ITF,ITF5,17,Basilicata,Basilicata,559084,3972,0.71,0.07
312,2021-05-20,BAS,5856,2965,2891,2891,2965,ITF,ITF5,17,Basilicata,Basilicata,559084,9828,1.76,1.05
313,2021-03-25,BAS,1879,601,1278,1533,346,ITF,ITF5,17,Basilicata,Basilicata,559084,11707,2.09,0.34
314,2021-05-21,BAS,4579,2324,2255,1498,3081,ITF,ITF5,17,Basilicata,Basilicata,559084,16286,2.91,0.82
315,2021-02-03,BAS,666,300,366,32,634,ITF,ITF5,17,Basilicata,Basilicata,559084,16952,3.03,0.12
316,2021-06-01,BAS,2184,1001,1183,1009,1175,ITF,ITF5,17,Basilicata,Basilicata,559084,19136,3.42,0.39
317,2021-04-12,BAS,2184,1054,1130,1692,492,ITF,ITF5,17,Basilicata,Basilicata,559084,21320,3.81,0.39
318,2021-02-10,BAS,547,237,310,495,52,ITF,ITF5,17,Basilicata,Basilicata,559084,21867,3.91,0.1
319,2021-01-27,BAS,411,175,236,113,298,ITF,ITF5,17,Basilicata,Basilicata,559084,22278,3.98,0.07
320,2021-04-01,BAS,2808,1134,1674,2091,717,ITF,ITF5,17,Basilicata,Basilicata,559084,25086,4.49,0.5
321,2021-04-19,BAS,4163,1910,2253,2526,1637,ITF,ITF5,17,Basilicata,Basilicata,559084,29249,5.23,0.74
322,2021-04-08,BAS,764,348,416,754,10,ITF,ITF5,17,Basilicata,Basilicata,559084,30013,5.37,0.14
323,2021-05-11,BAS,2654,1353,1301,1621,1033,ITF,ITF5,17,Basilicata,Basilicata,559084,32667,5.84,0.47
324,2021-05-28,BAS,3609,1804,1805,949,2660,ITF,ITF5,17,Basilicata,Basilicata,559084,36276,6.49,0.65
325,2021-03-22,BAS,1175,531,644,628,547,ITF,ITF5,17,Basilicata,Basilicata,559084,37451,6.7,0.21
326,2021-05-25,BAS,4191,2107,2084,873,3318,ITF,ITF5,17,Basilicata,Basilicata,559084,41642,7.45,0.75
327,2021-01-17,BAS,328,133,195,327,1,ITF,ITF5,17,Basilicata,Basilicata,559084,41970,7.51,0.06
328,2021-04-20,BAS,4033,1920,2113,2202,1831,ITF,ITF5,17,Basilicata,Basilicata,559084,46003,8.23,0.72
329,2021-01-08,BAS,554,219,335,554,0,ITF,ITF5,17,Basilicata,Basilicata,559084,46557,8.33,0.1
330,2021-03-17,BAS,1452,609,843,27,1425,ITF,ITF5,17,Basilicata,Basilicata,559084,48009,8.59,0.26
331,2021-04-29,BAS,4830,2384,2446,4409,421,ITF,ITF5,17,Basilicata,Basilicata,559084,52839,9.45,0.86
332,2021-04-15,BAS,3386,1659,1727,2632,754,ITF,ITF5,17,Basilicata,Basilicata,559084,56225,10.06,0.61
333,2021-01-03,BAS,901,344,557,901,0,ITF,ITF5,17,Basilicata,Basilicata,559084,57126,10.22,0.16
334,2021-03-29,BAS,2435,881,1554,2149,286,ITF,ITF5,17,Basilicata,Basilicata,559084,59561,10.65,0.44
335,2021-01-05,BAS,946,409,537,946,0,ITF,ITF5,17,Basilicata,Basilicata,559084,60507,10.82,0.17
336,2020-12-27,BAS,106,41,65,106,0,ITF,ITF5,17,Basilicata,Basilicata,559084,60613,10.84,0.02
337,2021-02-15,BAS,622,232,390,580,42,ITF,ITF5,17,Basilicata,Basilicata,559084,61235,10.95,0.11
338,2021-05-27,BAS,3601,1855,1746,1076,2525,ITF,ITF5,17,Basilicata,Basilicata,559084,64836,11.6,0.64
339,2021-02-22,BAS,1790,773,1017,1737,53,ITF,ITF5,17,Basilicata,Basilicata,559084,66626,11.92,0.32
340,2021-05-01,BAS,4703,2135,2568,3952,751,ITF,ITF5,17,Basilicata,Basilicata,559084,71329,12.76,0.84
341,2021-02-26,BAS,2149,904,1245,2069,80,ITF,ITF5,17,Basilicata,Basilicata,559084,73478,13.14,0.38
342,2021-05-18,BAS,5897,2856,3041,3403,2494,ITF,ITF5,17,Basilicata,Basilicata,559084,79375,14.2,1.05
343,2021-05-08,BAS,4833,2398,2435,3427,1406,ITF,ITF5,17,Basilicata,Basilicata,559084,84208,15.06,0.86
344,2021-04-22,BAS,5035,2345,2690,3433,1602,ITF,ITF5,17,Basilicata,Basilicata,559084,89243,15.96,0.9
345,2021-02-17,BAS,1135,493,642,1059,76,ITF,ITF5,17,Basilicata,Basilicata,559084,90378,16.17,0.2
346,2021-04-05,BAS,723,233,490,421,302,ITF,ITF5,17,Basilicata,Basilicata,559084,91101,16.29,0.13
347,2021-02-14,BAS,151,48,103,151,0,ITF,ITF5,17,Basilicata,Basilicata,559084,91252,16.32,0.03
348,2021-03-03,BAS,1744,814,930,1186,558,ITF,ITF5,17,Basilicata,Basilicata,559084,92996,16.63,0.31
349,2021-01-31,BAS,77,24,53,0,77,ITF,ITF5,17,Basilicata,Basilicata,559084,93073,16.65,0.01
350,2021-01-22,BAS,67,24,43,67,0,ITF,ITF5,17,Basilicata,Basilicata,559084,93140,16.66,0.01
351,2021-05-02,BAS,4179,2000,2179,3551,628,ITF,ITF5,17,Basilicata,Basilicata,559084,97319,17.41,0.75
352,2021-04-17,BAS,3461,1655,1806,2199,1262,ITF,ITF5,17,Basilicata,Basilicata,559084,100780,18.03,0.62
353,2021-01-04,BAS,607,271,336,607,0,ITF,ITF5,17,Basilicata,Basilicata,559084,101387,18.13,0.11
354,2021-01-21,BAS,30,10,20,30,0,ITF,ITF5,17,Basilicata,Basilicata,559084,101417,18.14,0.01
355,2021-05-03,BAS,4513,2043,2470,3686,827,ITF,ITF5,17,Basilicata,Basilicata,559084,105930,18.95,0.81
356,2021-03-30,BAS,2739,1156,1583,2394,345,ITF,ITF5,17,Basilicata,Basilicata,559084,108669,19.44,0.49
357,2021-01-10,BAS,77,24,53,77,0,ITF,ITF5,17,Basilicata,Basilicata,559084,108746,19.45,0.01
358,2021-03-15,BAS,2352,983,1369,521,1831,ITF,ITF5,17,Basilicata,Basilicata,559084,111098,19.87,0.42
359,2021-04-27,BAS,4725,2242,2483,4400,325,ITF,ITF5,17,Basilicata,Basilicata,559084,115823,20.72,0.85
360,2021-01-19,BAS,199,84,115,199,0,ITF,ITF5,17,Basilicata,Basilicata,559084,116022,20.75,0.04
361,2021-03-24,BAS,1750,685,1065,1355,395,ITF,ITF5,17,Basilicata,Basilicata,559084,117772,21.07,0.31
362,2021-05-30,BAS,2773,1421,1352,923,1850,ITF,ITF5,17,Basilicata,Basilicata,559084,120545,21.56,0.5
363,2021-04-03,BAS,1807,749,1058,1472,335,ITF,ITF5,17,Basilicata,Basilicata,559084,122352,21.88,0.32
364,2021-02-05,BAS,984,443,541,64,920,ITF,ITF5,17,Basilicata,Basilicata,559084,123336,22.06,0.18
365,2021-05-16,BAS,4969,2466,2503,2858,2111,ITF,ITF5,17,Basilicata,Basilicata,559084,128305,22.95,0.89
366,2021-05-23,BAS,4736,2404,2332,1681,3055,ITF,ITF5,17,Basilicata,Basilicata,559084,133041,23.8,0.85
367,2021-03-27,BAS,2229,851,1378,1816,413,ITF,ITF5,17,Basilicata,Basilicata,559084,135270,24.19,0.4
368,2021-01-07,BAS,640,319,321,640,0,ITF,ITF5,17,Basilicata,Basilicata,559084,135910,24.31,0.11
369,2021-02-19,BAS,1622,737,885,1560,62,ITF,ITF5,17,Basilicata,Basilicata,559084,137532,24.6,0.29
370,2021-02-12,BAS,775,332,443,744,31,ITF,ITF5,17,Basilicata,Basilicata,559084,138307,24.74,0.14
371,2021-04-10,BAS,1032,378,654,950,82,ITF,ITF5,17,Basilicata,Basilicata,559084,139339,24.92,0.18
372,2021-05-04,BAS,4139,1992,2147,3616,523,ITF,ITF5,17,Basilicata,Basilicata,559084,143478,25.66,0.74
373,2021-03-08,BAS,1455,710,745,843,612,ITF,ITF5,17,Basilicata,Basilicata,559084,144933,25.92,0.26
374,2021-03-01,BAS,547,284,263,381,166,ITF,ITF5,17,Basilicata,Basilicata,559084,145480,26.02,0.1
375,2021-04-13,BAS,2115,1053,1062,1295,820,ITF,ITF5,17,Basilicata,Basilicata,559084,147595,26.4,0.38
376,2021-05-13,BAS,5982,2966,3016,3385,2597,ITF,ITF5,17,Basilicata,Basilicata,559084,153577,27.47,1.07
377,2021-01-26,BAS,797,352,445,101,696,ITF,ITF5,17,Basilicata,Basilicata,559084,154374,27.61,0.14
378,2021-01-24,BAS,837,300,537,58,779,ITF,ITF5,17,Basilicata,Basilicata,559084,155211,27.76,0.15
379,2021-01-16,BAS,721,304,417,721,0,ITF,ITF5,17,Basilicata,Basilicata,559084,155932,27.89,0.13
380,2021-02-28,BAS,804,343,461,775,29,ITF,ITF5,17,Basilicata,Basilicata,559084,156736,28.03,0.14
381,2021-01-09,BAS,557,160,397,557,0,ITF,ITF5,17,Basilicata,Basilicata,559084,157293,28.13,0.1
382,2021-05-07,BAS,4647,2284,2363,3292,1355,ITF,ITF5,17,Basilicata,Basilicata,559084,161940,28.97,0.83
383,2021-03-18,BAS,1349,563,786,25,1324,ITF,ITF5,17,Basilicata,Basilicata,559084,163289,29.21,0.24
384,2021-02-11,BAS,951,401,550,868,83,ITF,ITF5,17,Basilicata,Basilicata,559084,164240,29.38,0.17
385,2021-03-26,BAS,1957,703,1254,1696,261,ITF,ITF5,17,Basilicata,Basilicata,559084,166197,29.73,0.35
386,2021-02-20,BAS,1161,531,630,1043,118,ITF,ITF5,17,Basilicata,Basilicata,559084,167358,29.93,0.21
387,2021-05-24,BAS,4825,2340,2485,1103,3722,ITF,ITF5,17,Basilicata,Basilicata,559084,172183,30.8,0.86
388,2021-01-02,BAS,949,380,569,949,0,ITF,ITF5,17,Basilicata,Basilicata,559084,173132,30.97,0.17
389,2021-04-26,BAS,4464,2164,2300,4244,220,ITF,ITF5,17,Basilicata,Basilicata,559084,177596,31.77,0.8
390,2021-02-21,BAS,284,113,171,284,0,ITF,ITF5,17,Basilicata,Basilicata,559084,177880,31.82,0.05
391,2021-03-07,BAS,887,309,578,849,38,ITF,ITF5,17,Basilicata,Basilicata,559084,178767,31.97,0.16
392,2021-05-14,BAS,5906,2797,3109,3374,2532,ITF,ITF5,17,Basilicata,Basilicata,559084,184673,33.03,1.06
393,2021-02-23,BAS,1901,771,1130,1763,138,ITF,ITF5,17,Basilicata,Basilicata,559084,186574,33.37,0.34
394,2021-03-31,BAS,3095,1258,1837,2313,782,ITF,ITF5,17,Basilicata,Basilicata,559084,189669,33.92,0.55
395,2021-02-08,BAS,557,193,364,151,406,ITF,ITF5,17,Basilicata,Basilicata,559084,190226,34.02,0.1
396,2021-05-19,BAS,2870,1498,1372,1194,1676,ITF,ITF5,17,Basilicata,Basilicata,559084,193096,34.54,0.51
397,2021-01-12,BAS,217,88,129,217,0,ITF,ITF5,17,Basilicata,Basilicata,559084,193313,34.58,0.04
398,2021-03-21,BAS,1046,481,565,352,694,ITF,ITF5,17,Basilicata,Basilicata,559084,194359,34.76,0.19
399,2021-05-29,BAS,3012,1511,1501,831,2181,ITF,ITF5,17,Basilicata,Basilicata,559084,197371,35.3,0.54
400,2021-01-13,BAS,916,387,529,916,0,ITF,ITF5,17,Basilicata,Basilicata,559084,198287,35.47,0.16
401,2021-01-30,BAS,704,227,477,128,576,ITF,ITF5,17,Basilicata,Basilicata,559084,198991,35.59,0.13
402,2021-02-16,BAS,905,377,528,807,98,ITF,ITF5,17,Basilicata,Basilicata,559084,199896,35.75,0.16
403,2021-04-07,BAS,1218,549,669,1181,37,ITF,ITF5,17,Basilicata,Basilicata,559084,201114,35.97,0.22
404,2021-04-06,BAS,1266,461,805,1082,184,ITF,ITF5,17,Basilicata,Basilicata,559084,202380,36.2,0.23
405,2021-02-01,BAS,242,91,151,46,196,ITF,ITF5,17,Basilicata,Basilicata,559084,202622,36.24,0.04
406,2021-05-26,BAS,4470,2246,2224,1706,2764,ITF,ITF5,17,Basilicata,Basilicata,559084,207092,37.04,0.8
407,2021-05-12,BAS,4722,2324,2398,2839,1883,ITF,ITF5,17,Basilicata,Basilicata,559084,211814,37.89,0.84
408,2021-03-23,BAS,1584,608,976,1409,175,ITF,ITF5,17,Basilicata,Basilicata,559084,213398,38.17,0.28
409,2021-04-28,BAS,4704,2158,2546,4263,441,ITF,ITF5,17,Basilicata,Basilicata,559084,218102,39.01,0.84
410,2021-03-02,BAS,794,383,411,659,135,ITF,ITF5,17,Basilicata,Basilicata,559084,218896,39.15,0.14
411,2021-04-21,BAS,3921,1835,2086,2271,1650,ITF,ITF5,17,Basilicata,Basilicata,559084,222817,39.85,0.7
412,2021-01-25,BAS,1023,429,594,74,949,ITF,ITF5,17,Basilicata,Basilicata,559084,223840,40.04,0.18
413,2021-01-18,BAS,463,157,306,364,99,ITF,ITF5,17,Basilicata,Basilicata,559084,224303,40.12,0.08
414,2021-03-16,BAS,1903,801,1102,228,1675,ITF,ITF5,17,Basilicata,Basilicata,559084,226206,40.46,0.34
415,2021-05-05,BAS,4333,2048,2285,3443,890,ITF,ITF5,17,Basilicata,Basilicata,559084,230539,41.24,0.78
416,2021-04-02,BAS,2318,1046,1272,1714,604,ITF,ITF5,17,Basilicata,Basilicata,559084,232857,41.65,0.41
417,2021-02-04,BAS,1096,442,654,63,1033,ITF,ITF5,17,Basilicata,Basilicata,559084,233953,41.85,0.2
418,2021-04-09,BAS,1152,350,802,1089,63,ITF,ITF5,17,Basilicata,Basilicata,559084,235105,42.05,0.21
419,2021-05-15,BAS,6527,3341,3186,3955,2572,ITF,ITF5,17,Basilicata,Basilicata,559084,241632,43.22,1.17
420,2021-02-27,BAS,1992,860,1132,1828,164,ITF,ITF5,17,Basilicata,Basilicata,559084,243624,43.58,0.36
421,2021-04-11,BAS,867,339,528,805,62,ITF,ITF5,17,Basilicata,Basilicata,559084,244491,43.73,0.16
422,2021-04-04,BAS,610,225,385,197,413,ITF,ITF5,17,Basilicata,Basilicata,559084,245101,43.84,0.11
423,2021-01-23,BAS,719,303,416,33,686,ITF,ITF5,17,Basilicata,Basilicata,559084,245820,43.97,0.13
424,2021-04-14,BAS,2054,998,1056,1380,674,ITF,ITF5,17,Basilicata,Basilicata,559084,247874,44.34,0.37
425,2021-02-09,BAS,491,213,278,316,175,ITF,ITF5,17,Basilicata,Basilicata,559084,248365,44.42,0.09
426,2021-03-11,BAS,1790,924,866,831,959,ITF,ITF5,17,Basilicata,Basilicata,559084,250155,44.74,0.32
427,2021-01-06,BAS,294,129,165,294,0,ITF,ITF5,17,Basilicata,Basilicata,559084,250449,44.8,0.05
428,2021-03-28,BAS,2139,741,1398,2122,17,ITF,ITF5,17,Basilicata,Basilicata,559084,252588,45.18,0.38
429,2021-03-14,BAS,1008,477,531,539,469,ITF,ITF5,17,Basilicata,Basilicata,559084,253596,45.36,0.18
430,2021-05-17,BAS,5542,2735,2807,3409,2133,ITF,ITF5,17,Basilicata,Basilicata,559084,259138,46.35,0.99
431,2021-03-12,BAS,1901,978,923,802,1099,ITF,ITF5,17,Basilicata,Basilicata,559084,261039,46.69,0.34
432,2021-01-20,BAS,84,22,62,84,0,ITF,ITF5,17,Basilicata,Basilicata,559084,261123,46.71,0.02
433,2021-02-25,BAS,1787,736,1051,1741,46,ITF,ITF5,17,Basilicata,Basilicata,559084,262910,47.03,0.32
434,2021-02-06,BAS,902,367,535,146,756,ITF,ITF5,17,Basilicata,Basilicata,559084,263812,47.19,0.16
435,2021-05-22,BAS,5556,2761,2795,2005,3551,ITF,ITF5,17,Basilicata,Basilicata,559084,269368,48.18,0.99
436,2021-02-13,BAS,799,313,486,738,61,ITF,ITF5,17,Basilicata,Basilicata,559084,270167,48.32,0.14
437,2021-04-18,BAS,3720,1847,1873,2353,1367,ITF,ITF5,17,Basilicata,Basilicata,559084,273887,48.99,0.67
438,2021-05-31,BAS,4060,1934,2126,1696,2364,ITF,ITF5,17,Basilicata,Basilicata,559084,277947,49.71,0.73
439,2021-03-10,BAS,1676,839,837,837,839,ITF,ITF5,17,Basilicata,Basilicata,559084,279623,50.01,0.3
440,2021-05-06,BAS,5053,2435,2618,3484,1569,ITF,ITF5,17,Basilicata,Basilicata,559084,284676,50.92,0.9
441,2021-02-02,BAS,367,143,224,175,192,ITF,ITF5,17,Basilicata,Basilicata,559084,285043,50.98,0.07
442,2021-04-16,BAS,3319,1632,1687,2421,898,ITF,ITF5,17,Basilicata,Basilicata,559084,288362,51.58,0.59
443,2021-05-10,BAS,4806,2383,2423,2766,2040,ITF,ITF5,17,Basilicata,Basilicata,559084,293168,52.44,0.86
444,2021-04-23,BAS,4538,2187,2351,3538,1000,ITF,ITF5,17,Basilicata,Basilicata,559084,297706,53.25,0.81
445,2021-03-09,BAS,1393,708,685,789,604,ITF,ITF5,17,Basilicata,Basilicata,559084,299099,53.5,0.25
446,2021-01-11,BAS,183,66,117,183,0,ITF,ITF5,17,Basilicata,Basilicata,559084,299282,53.53,0.03
447,2021-03-04,BAS,1879,892,987,1084,795,ITF,ITF5,17,Basilicata,Basilicata,559084,301161,53.87,0.34
448,2021-04-30,BAS,5284,2373,2911,4121,1163,ITF,ITF5,17,Basilicata,Basilicata,559084,306445,54.81,0.95
449,2021-02-18,BAS,1070,401,669,855,215,ITF,ITF5,17,Basilicata,Basilicata,559084,307515,55.0,0.19
450,2021-03-20,BAS,1287,567,720,275,1012,ITF,ITF5,17,Basilicata,Basilicata,559084,308802,55.23,0.23
451,2021-01-29,BAS,615,230,385,63,552,ITF,ITF5,17,Basilicata,Basilicata,559084,309417,55.34,0.11
452,2021-01-15,BAS,813,350,463,813,0,ITF,ITF5,17,Basilicata,Basilicata,559084,310230,55.49,0.15
453,2021-03-06,BAS,1354,536,818,758,596,ITF,ITF5,17,Basilicata,Basilicata,559084,311584,55.73,0.24
454,2021-05-09,BAS,4687,2342,2345,2992,1695,ITF,ITF5,17,Basilicata,Basilicata,559084,316271,56.57,0.84
455,2021-03-05,BAS,1855,857,998,1109,746,ITF,ITF5,17,Basilicata,Basilicata,559084,318126,56.9,0.33
456,2021-04-24,BAS,4544,2197,2347,3532,1012,ITF,ITF5,17,Basilicata,Basilicata,559084,322670,57.71,0.81
457,2021-03-19,BAS,2290,992,1298,262,2028,ITF,ITF5,17,Basilicata,Basilicata,559084,324960,58.12,0.41
458,2021-01-28,BAS,903,401,502,119,784,ITF,ITF5,17,Basilicata,Basilicata,559084,325863,58.29,0.16
459,2021-01-14,BAS,969,413,556,969,0,ITF,ITF5,17,Basilicata,Basilicata,559084,326832,58.46,0.17
460,2021-04-25,BAS,2985,1458,1527,2932,53,ITF,ITF5,17,Basilicata,Basilicata,559084,329817,58.99,0.53
461,2021-04-26,LIG,10449,4915,5534,7823,2626,ITC,ITC3,7,Liguria,Liguria,1550640,10449,0.67,0.67
462,2021-02-21,LIG,869,491,378,865,4,ITC,ITC3,7,Liguria,Liguria,1550640,11318,0.73,0.06
463,2021-02-04,LIG,2817,986,1831,179,2638,ITC,ITC3,7,Liguria,Liguria,1550640,14135,0.91,0.18
464,2021-01-18,LIG,2138,746,1392,1981,157,ITC,ITC3,7,Liguria,Liguria,1550640,16273,1.05,0.14
465,2021-03-14,LIG,1659,752,907,1055,604,ITC,ITC3,7,Liguria,Liguria,1550640,17932,1.16,0.11
466,2021-01-23,LIG,809,295,514,153,656,ITC,ITC3,7,Liguria,Liguria,1550640,18741,1.21,0.05
467,2021-05-17,LIG,11832,5360,6472,8530,3302,ITC,ITC3,7,Liguria,Liguria,1550640,30573,1.97,0.76
468,2021-01-30,LIG,1661,567,1094,25,1636,ITC,ITC3,7,Liguria,Liguria,1550640,32234,2.08,0.11
469,2021-03-28,LIG,1142,511,631,391,751,ITC,ITC3,7,Liguria,Liguria,1550640,33376,2.15,0.07
470,2021-05-10,LIG,12507,5506,7001,6133,6374,ITC,ITC3,7,Liguria,Liguria,1550640,45883,2.96,0.81
471,2021-05-03,LIG,13269,5920,7349,6457,6812,ITC,ITC3,7,Liguria,Liguria,1550640,59152,3.81,0.86
472,2021-03-21,LIG,552,221,331,69,483,ITC,ITC3,7,Liguria,Liguria,1550640,59704,3.85,0.04
473,2021-02-06,LIG,1892,768,1124,145,1747,ITC,ITC3,7,Liguria,Liguria,1550640,61596,3.97,0.12
474,2021-01-09,LIG,1335,481,854,1335,0,ITC,ITC3,7,Liguria,Liguria,1550640,62931,4.06,0.09
475,2021-04-04,LIG,756,366,390,507,249,ITC,ITC3,7,Liguria,Liguria,1550640,63687,4.11,0.05
476,2021-02-13,LIG,1080,508,572,800,280,ITC,ITC3,7,Liguria,Liguria,1550640,64767,4.18,0.07
477,2021-03-31,LIG,11844,5207,6637,9074,2770,ITC,ITC3,7,Liguria,Liguria,1550640,76611,4.94,0.76
478,2021-04-09,LIG,12424,5556,6868,10685,1739,ITC,ITC3,7,Liguria,Liguria,1550640,89035,5.74,0.8
479,2020-12-28,LIG,80,30,50,80,0,ITC,ITC3,7,Liguria,Liguria,1550640,89115,5.75,0.01
480,2021-02-25,LIG,3455,1349,2106,3325,130,ITC,ITC3,7,Liguria,Liguria,1550640,92570,5.97,0.22
481,2021-04-30,LIG,14350,6392,7958,5780,8570,ITC,ITC3,7,Liguria,Liguria,1550640,106920,6.9,0.93
482,2021-03-26,LIG,9123,3855,5268,5969,3154,ITC,ITC3,7,Liguria,Liguria,1550640,116043,7.48,0.59
483,2021-02-18,LIG,2762,1126,1636,2431,331,ITC,ITC3,7,Liguria,Liguria,1550640,118805,7.66,0.18
484,2021-05-31,LIG,14143,7030,7113,8798,5345,ITC,ITC3,7,Liguria,Liguria,1550640,132948,8.57,0.91
485,2021-05-14,LIG,12877,5647,7230,8579,4298,ITC,ITC3,7,Liguria,Liguria,1550640,145825,9.4,0.83
486,2021-02-20,LIG,1336,637,699,1335,1,ITC,ITC3,7,Liguria,Liguria,1550640,147161,9.49,0.09
487,2021-01-21,LIG,1103,385,718,672,431,ITC,ITC3,7,Liguria,Liguria,1550640,148264,9.56,0.07
488,2021-01-14,LIG,2981,1055,1926,2981,0,ITC,ITC3,7,Liguria,Liguria,1550640,151245,9.75,0.19
489,2021-03-12,LIG,6150,2814,3336,3681,2469,ITC,ITC3,7,Liguria,Liguria,1550640,157395,10.15,0.4
490,2021-01-28,LIG,2847,971,1876,39,2808,ITC,ITC3,7,Liguria,Liguria,1550640,160242,10.33,0.18
491,2021-03-19,LIG,5296,2235,3061,2149,3147,ITC,ITC3,7,Liguria,Liguria,1550640,165538,10.68,0.34
492,2021-05-08,LIG,7529,3332,4197,2315,5214,ITC,ITC3,7,Liguria,Liguria,1550640,173067,11.16,0.49
493,2021-02-11,LIG,1979,767,1212,1103,876,ITC,ITC3,7,Liguria,Liguria,1550640,175046,11.29,0.13
494,2021-05-22,LIG,6551,3195,3356,4943,1608,ITC,ITC3,7,Liguria,Liguria,1550640,181597,11.71,0.42
495,2021-04-02,LIG,11671,5117,6554,9185,2486,ITC,ITC3,7,Liguria,Liguria,1550640,193268,12.46,0.75
496,2021-02-02,LIG,2668,1005,1663,134,2534,ITC,ITC3,7,Liguria,Liguria,1550640,195936,12.64,0.17
497,2021-05-15,LIG,7183,3195,3988,4296,2887,ITC,ITC3,7,Liguria,Liguria,1550640,203119,13.1,0.46
498,2021-01-16,LIG,1278,557,721,1278,0,ITC,ITC3,7,Liguria,Liguria,1550640,204397,13.18,0.08
499,2021-04-28,LIG,14448,6520,7928,6460,7988,ITC,ITC3,7,Liguria,Liguria,1550640,218845,14.11,0.93
500,2020-12-30,LIG,12,5,7,12,0,ITC,ITC3,7,Liguria,Liguria,1550640,218857,14.11,0.0
501,2021-04-11,LIG,4249,1931,2318,4000,249,ITC,ITC3,7,Liguria,Liguria,1550640,223106,14.39,0.27
502,2021-05-27,LIG,16299,8217,8082,12388,3911,ITC,ITC3,7,Liguria,Liguria,1550640,239405,15.44,1.05
503,2021-02-09,LIG,1936,689,1247,256,1680,ITC,ITC3,7,Liguria,Liguria,1550640,241341,15.56,0.12
504,2021-02-16,LIG,2397,954,1443,2004,393,ITC,ITC3,7,Liguria,Liguria,1550640,243738,15.72,0.15
505,2021-04-14,LIG,13029,5659,7370,10827,2202,ITC,ITC3,7,Liguria,Liguria,1550640,256767,16.56,0.84
506,2021-01-04,LIG,2617,855,1762,2617,0,ITC,ITC3,7,Liguria,Liguria,1550640,259384,16.73,0.17
507,2021-02-28,LIG,1060,581,479,1051,9,ITC,ITC3,7,Liguria,Liguria,1550640,260444,16.8,0.07
508,2021-04-19,LIG,12810,5616,7194,9001,3809,ITC,ITC3,7,Liguria,Liguria,1550640,273254,17.62,0.83
509,2021-05-24,LIG,11655,5422,6233,9175,2480,ITC,ITC3,7,Liguria,Liguria,1550640,284909,18.37,0.75
510,2021-05-07,LIG,13546,6015,7531,5781,7765,ITC,ITC3,7,Liguria,Liguria,1550640,298455,19.25,0.87
511,2021-01-02,LIG,691,245,446,691,0,ITC,ITC3,7,Liguria,Liguria,1550640,299146,19.29,0.04
512,2021-03-07,LIG,1858,1085,773,1557,301,ITC,ITC3,7,Liguria,Liguria,1550640,301004,19.41,0.12
513,2021-03-09,LIG,5932,2754,3178,4502,1430,ITC,ITC3,7,Liguria,Liguria,1550640,306936,19.79,0.38
514,2021-01-01,LIG,144,55,89,144,0,ITC,ITC3,7,Liguria,Liguria,1550640,307080,19.8,0.01
515,2021-04-13,LIG,13052,5860,7192,11031,2021,ITC,ITC3,7,Liguria,Liguria,1550640,320132,20.65,0.84
516,2021-03-27,LIG,3921,1538,2383,2525,1396,ITC,ITC3,7,Liguria,Liguria,1550640,324053,20.9,0.25
517,2021-05-30,LIG,3275,1603,1672,1364,1911,ITC,ITC3,7,Liguria,Liguria,1550640,327328,21.11,0.21
518,2021-05-13,LIG,13023,5845,7178,8808,4215,ITC,ITC3,7,Liguria,Liguria,1550640,340351,21.95,0.84
519,2021-04-07,LIG,13586,6032,7554,11297,2289,ITC,ITC3,7,Liguria,Liguria,1550640,353937,22.83,0.88
520,2021-02-23,LIG,3806,1559,2247,3697,109,ITC,ITC3,7,Liguria,Liguria,1550640,357743,23.07,0.25
521,2021-03-04,LIG,4738,2118,2620,3891,847,ITC,ITC3,7,Liguria,Liguria,1550640,362481,23.38,0.31
522,2021-05-12,LIG,11884,5327,6557,6544,5340,ITC,ITC3,7,Liguria,Liguria,1550640,374365,24.14,0.77
523,2021-05-19,LIG,13516,5944,7572,10408,3108,ITC,ITC3,7,Liguria,Liguria,1550640,387881,25.01,0.87
524,2021-03-23,LIG,9036,4082,4954,5827,3209,ITC,ITC3,7,Liguria,Liguria,1550640,396917,25.6,0.58
525,2021-02-01,LIG,2558,923,1635,90,2468,ITC,ITC3,7,Liguria,Liguria,1550640,399475,25.76,0.16
526,2021-05-26,LIG,16137,8007,8130,11984,4153,ITC,ITC3,7,Liguria,Liguria,1550640,415612,26.8,1.04
527,2021-03-30,LIG,12148,5381,6767,8759,3389,ITC,ITC3,7,Liguria,Liguria,1550640,427760,27.59,0.78
528,2021-05-29,LIG,6786,3221,3565,3947,2839,ITC,ITC3,7,Liguria,Liguria,1550640,434546,28.02,0.44
529,2021-04-23,LIG,14675,6639,8036,8555,6120,ITC,ITC3,7,Liguria,Liguria,1550640,449221,28.97,0.95
530,2021-04-16,LIG,11972,5280,6692,10161,1811,ITC,ITC3,7,Liguria,Liguria,1550640,461193,29.74,0.77
531,2021-03-11,LIG,6352,3054,3298,4346,2006,ITC,ITC3,7,Liguria,Liguria,1550640,467545,30.15,0.41
532,2021-01-13,LIG,2754,1013,1741,2754,0,ITC,ITC3,7,Liguria,Liguria,1550640,470299,30.33,0.18
533,2021-04-08,LIG,13727,6157,7570,11683,2044,ITC,ITC3,7,Liguria,Liguria,1550640,484026,31.21,0.89
534,2021-02-17,LIG,2689,1181,1508,2263,426,ITC,ITC3,7,Liguria,Liguria,1550640,486715,31.39,0.17
535,2021-01-05,LIG,2879,896,1983,2879,0,ITC,ITC3,7,Liguria,Liguria,1550640,489594,31.57,0.19
536,2021-04-22,LIG,13823,6196,7627,8749,5074,ITC,ITC3,7,Liguria,Liguria,1550640,503417,32.47,0.89
537,2021-03-06,LIG,3304,1842,1462,2599,705,ITC,ITC3,7,Liguria,Liguria,1550640,506721,32.68,0.21
538,2021-05-09,LIG,2826,1245,1581,1116,1710,ITC,ITC3,7,Liguria,Liguria,1550640,509547,32.86,0.18
539,2021-01-22,LIG,1818,604,1214,1332,486,ITC,ITC3,7,Liguria,Liguria,1550640,511365,32.98,0.12
540,2021-05-04,LIG,13604,6081,7523,5377,8227,ITC,ITC3,7,Liguria,Liguria,1550640,524969,33.85,0.88
541,2021-04-05,LIG,3976,1751,2225,2327,1649,ITC,ITC3,7,Liguria,Liguria,1550640,528945,34.11,0.26
542,2021-05-28,LIG,15897,7876,8021,11516,4381,ITC,ITC3,7,Liguria,Liguria,1550640,544842,35.14,1.03
543,2021-04-15,LIG,11820,5221,6599,9968,1852,ITC,ITC3,7,Liguria,Liguria,1550640,556662,35.9,0.76
544,2021-03-03,LIG,4581,1847,2734,3555,1026,ITC,ITC3,7,Liguria,Liguria,1550640,561243,36.19,0.3
545,2021-02-24,LIG,3763,1560,2203,3505,258,ITC,ITC3,7,Liguria,Liguria,1550640,565006,36.44,0.24
546,2020-12-29,LIG,125,33,92,125,0,ITC,ITC3,7,Liguria,Liguria,1550640,565131,36.45,0.01
547,2021-01-12,LIG,2460,886,1574,2460,0,ITC,ITC3,7,Liguria,Liguria,1550640,567591,36.6,0.16
548,2021-02-03,LIG,2315,791,1524,55,2260,ITC,ITC3,7,Liguria,Liguria,1550640,569906,36.75,0.15
549,2021-05-16,LIG,3694,1855,1839,2134,1560,ITC,ITC3,7,Liguria,Liguria,1550640,573600,36.99,0.24
550,2021-02-05,LIG,2675,986,1689,304,2371,ITC,ITC3,7,Liguria,Liguria,1550640,576275,37.16,0.17
551,2021-04-10,LIG,7887,3558,4329,6973,914,ITC,ITC3,7,Liguria,Liguria,1550640,584162,37.67,0.51
552,2020-12-31,LIG,989,354,635,989,0,ITC,ITC3,7,Liguria,Liguria,1550640,585151,37.74,0.06
553,2021-04-18,LIG,2584,1151,1433,2115,469,ITC,ITC3,7,Liguria,Liguria,1550640,587735,37.9,0.17
554,2021-01-27,LIG,1744,603,1141,141,1603,ITC,ITC3,7,Liguria,Liguria,1550640,589479,38.02,0.11
555,2021-05-21,LIG,12835,5950,6885,9710,3125,ITC,ITC3,7,Liguria,Liguria,1550640,602314,38.84,0.83
556,2021-03-18,LIG,4982,2124,2858,2009,2973,ITC,ITC3,7,Liguria,Liguria,1550640,607296,39.16,0.32
557,2021-04-01,LIG,12378,5468,6910,9608,2770,ITC,ITC3,7,Liguria,Liguria,1550640,619674,39.96,0.8
558,2021-05-23,LIG,2305,1119,1186,1182,1123,ITC,ITC3,7,Liguria,Liguria,1550640,621979,40.11,0.15
559,2021-04-03,LIG,5406,2498,2908,4463,943,ITC,ITC3,7,Liguria,Liguria,1550640,627385,40.46,0.35
560,2021-02-12,LIG,1927,689,1238,895,1032,ITC,ITC3,7,Liguria,Liguria,1550640,629312,40.58,0.12
561,2021-04-17,LIG,7383,3217,4166,6633,750,ITC,ITC3,7,Liguria,Liguria,1550640,636695,41.06,0.48
562,2021-01-07,LIG,3229,1095,2134,3229,0,ITC,ITC3,7,Liguria,Liguria,1550640,639924,41.27,0.21
563,2021-05-01,LIG,7134,3255,3879,1332,5802,ITC,ITC3,7,Liguria,Liguria,1550640,647058,41.73,0.46
564,2021-03-05,LIG,4869,2150,2719,3737,1132,ITC,ITC3,7,Liguria,Liguria,1550640,651927,42.04,0.31
565,2021-05-25,LIG,13720,6599,7121,10731,2989,ITC,ITC3,7,Liguria,Liguria,1550640,665647,42.93,0.88
566,2021-03-22,LIG,7663,3399,4264,4727,2936,ITC,ITC3,7,Liguria,Liguria,1550640,673310,43.42,0.49
567,2021-05-18,LIG,13323,6012,7311,10037,3286,ITC,ITC3,7,Liguria,Liguria,1550640,686633,44.28,0.86
568,2021-02-14,LIG,233,122,111,233,0,ITC,ITC3,7,Liguria,Liguria,1550640,686866,44.3,0.02
569,2021-02-07,LIG,407,153,254,2,405,ITC,ITC3,7,Liguria,Liguria,1550640,687273,44.32,0.03
570,2021-05-20,LIG,12814,5941,6873,8796,4018,ITC,ITC3,7,Liguria,Liguria,1550640,700087,45.15,0.83
571,2021-03-25,LIG,9595,4081,5514,6202,3393,ITC,ITC3,7,Liguria,Liguria,1550640,709682,45.77,0.62
572,2021-03-08,LIG,5630,2460,3170,3941,1689,ITC,ITC3,7,Liguria,Liguria,1550640,715312,46.13,0.36
573,2021-02-19,LIG,3213,1305,1908,3037,176,ITC,ITC3,7,Liguria,Liguria,1550640,718525,46.34,0.21
574,2021-06-01,LIG,4478,2235,2243,2903,1575,ITC,ITC3,7,Liguria,Liguria,1550640,723003,46.63,0.29
575,2021-02-22,LIG,3334,1467,1867,3192,142,ITC,ITC3,7,Liguria,Liguria,1550640,726337,46.84,0.22
576,2021-04-27,LIG,14737,6676,8061,7158,7579,ITC,ITC3,7,Liguria,Liguria,1550640,741074,47.79,0.95
577,2021-04-29,LIG,15551,6975,8576,6732,8819,ITC,ITC3,7,Liguria,Liguria,1550640,756625,48.79,1.0
578,2021-01-17,LIG,862,300,562,862,0,ITC,ITC3,7,Liguria,Liguria,1550640,757487,48.85,0.06
579,2021-04-12,LIG,12383,5475,6908,10364,2019,ITC,ITC3,7,Liguria,Liguria,1550640,769870,49.65,0.8
580,2021-01-19,LIG,1371,438,933,1281,90,ITC,ITC3,7,Liguria,Liguria,1550640,771241,49.74,0.09
581,2021-05-02,LIG,3878,1769,2109,506,3372,ITC,ITC3,7,Liguria,Liguria,1550640,775119,49.99,0.25
582,2021-01-20,LIG,1550,555,995,1538,12,ITC,ITC3,7,Liguria,Liguria,1550640,776669,50.09,0.1
583,2021-01-29,LIG,3079,1064,2015,67,3012,ITC,ITC3,7,Liguria,Liguria,1550640,779748,50.29,0.2
584,2021-05-11,LIG,13661,6172,7489,7068,6593,ITC,ITC3,7,Liguria,Liguria,1550640,793409,51.17,0.88
585,2021-03-29,LIG,10440,4511,5929,7310,3130,ITC,ITC3,7,Liguria,Liguria,1550640,803849,51.84,0.67
586,2021-01-06,LIG,1660,616,1044,1660,0,ITC,ITC3,7,Liguria,Liguria,1550640,805509,51.95,0.11
587,2021-01-15,LIG,2256,754,1502,2256,0,ITC,ITC3,7,Liguria,Liguria,1550640,807765,52.09,0.15
588,2021-04-25,LIG,1936,921,1015,1521,415,ITC,ITC3,7,Liguria,Liguria,1550640,809701,52.22,0.12
589,2021-03-13,LIG,3827,1616,2211,2972,855,ITC,ITC3,7,Liguria,Liguria,1550640,813528,52.46,0.25
590,2021-03-20,LIG,2316,995,1321,1142,1174,ITC,ITC3,7,Liguria,Liguria,1550640,815844,52.61,0.15
591,2021-04-06,LIG,13171,5857,7314,10931,2240,ITC,ITC3,7,Liguria,Liguria,1550640,829015,53.46,0.85
592,2021-02-08,LIG,1977,742,1235,306,1671,ITC,ITC3,7,Liguria,Liguria,1550640,830992,53.59,0.13
593,2020-12-27,LIG,135,56,79,135,0,ITC,ITC3,7,Liguria,Liguria,1550640,831127,53.6,0.01
594,2021-02-15,LIG,2262,839,1423,1865,397,ITC,ITC3,7,Liguria,Liguria,1550640,833389,53.74,0.15
595,2021-01-03,LIG,734,230,504,734,0,ITC,ITC3,7,Liguria,Liguria,1550640,834123,53.79,0.05
596,2021-03-10,LIG,5877,2839,3038,3971,1906,ITC,ITC3,7,Liguria,Liguria,1550640,840000,54.17,0.38
597,2021-01-08,LIG,2926,999,1927,2926,0,ITC,ITC3,7,Liguria,Liguria,1550640,842926,54.36,0.19
598,2021-02-27,LIG,1888,921,967,1759,129,ITC,ITC3,7,Liguria,Liguria,1550640,844814,54.48,0.12
599,2021-02-10,LIG,2314,837,1477,1019,1295,ITC,ITC3,7,Liguria,Liguria,1550640,847128,54.63,0.15
600,2021-05-06,LIG,14467,6406,8061,6166,8301,ITC,ITC3,7,Liguria,Liguria,1550640,861595,55.56,0.93
601,2021-03-17,LIG,5552,2368,3184,2473,3079,ITC,ITC3,7,Liguria,Liguria,1550640,867147,55.92,0.36
602,2021-04-24,LIG,8170,3785,4385,5018,3152,ITC,ITC3,7,Liguria,Liguria,1550640,875317,56.45,0.53
603,2021-02-26,LIG,3767,1524,2243,3439,328,ITC,ITC3,7,Liguria,Liguria,1550640,879084,56.69,0.24
604,2021-01-31,LIG,624,270,354,9,615,ITC,ITC3,7,Liguria,Liguria,1550640,879708,56.73,0.04
605,2021-01-26,LIG,2484,803,1681,13,2471,ITC,ITC3,7,Liguria,Liguria,1550640,882192,56.89,0.16
606,2021-03-24,LIG,8945,3834,5111,5657,3288,ITC,ITC3,7,Liguria,Liguria,1550640,891137,57.47,0.58
607,2021-03-02,LIG,4074,1689,2385,3764,310,ITC,ITC3,7,Liguria,Liguria,1550640,895211,57.73,0.26
608,2021-04-21,LIG,14246,6432,7814,8923,5323,ITC,ITC3,7,Liguria,Liguria,1550640,909457,58.65,0.92
609,2021-05-05,LIG,13669,6124,7545,5251,8418,ITC,ITC3,7,Liguria,Liguria,1550640,923126,59.53,0.88
610,2021-03-16,LIG,6073,2722,3351,2349,3724,ITC,ITC3,7,Liguria,Liguria,1550640,929199,59.92,0.39
611,2021-01-11,LIG,2654,990,1664,2654,0,ITC,ITC3,7,Liguria,Liguria,1550640,931853,60.09,0.17
612,2021-01-25,LIG,2725,889,1836,478,2247,ITC,ITC3,7,Liguria,Liguria,1550640,934578,60.27,0.18
613,2021-04-20,LIG,14213,6505,7708,9864,4349,ITC,ITC3,7,Liguria,Liguria,1550640,948791,61.19,0.92
614,2021-01-10,LIG,648,262,386,648,0,ITC,ITC3,7,Liguria,Liguria,1550640,949439,61.23,0.04
615,2021-03-01,LIG,3507,1430,2077,3385,122,ITC,ITC3,7,Liguria,Liguria,1550640,952946,61.46,0.23
616,2021-01-24,LIG,756,237,519,113,643,ITC,ITC3,7,Liguria,Liguria,1550640,953702,61.5,0.05
617,2021-03-15,LIG,7193,3056,4137,4492,2701,ITC,ITC3,7,Liguria,Liguria,1550640,960895,61.97,0.46
618,2021-05-12,LAZ,47395,21471,25924,30877,16518,ITI,ITI4,12,Lazio,Lazio,5879082,47395,0.81,0.81
619,2021-01-30,LAZ,7009,2891,4118,807,6202,ITI,ITI4,12,Lazio,Lazio,5879082,54404,0.93,0.12
620,2021-01-13,LAZ,5691,2150,3541,5691,0,ITI,ITI4,12,Lazio,Lazio,5879082,60095,1.02,0.1
621,2021-04-25,LAZ,24511,11240,13271,16701,7810,ITI,ITI4,12,Lazio,Lazio,5879082,84606,1.44,0.42
622,2020-12-27,LAZ,274,132,142,274,0,ITI,ITI4,12,Lazio,Lazio,5879082,84880,1.44,0.0
623,2021-04-30,LAZ,41232,18255,22977,27060,14172,ITI,ITI4,12,Lazio,Lazio,5879082,126112,2.15,0.7
624,2021-05-07,LAZ,48142,22568,25574,30427,17715,ITI,ITI4,12,Lazio,Lazio,5879082,174254,2.96,0.82
625,2021-03-18,LAZ,14225,6077,8148,7835,6390,ITI,ITI4,12,Lazio,Lazio,5879082,188479,3.21,0.24
626,2021-02-03,LAZ,6488,2488,4000,964,5524,ITI,ITI4,12,Lazio,Lazio,5879082,194967,3.32,0.11
627,2021-03-11,LAZ,23793,10582,13211,17564,6229,ITI,ITI4,12,Lazio,Lazio,5879082,218760,3.72,0.4
628,2021-01-20,LAZ,4806,1942,2864,3263,1543,ITI,ITI4,12,Lazio,Lazio,5879082,223566,3.8,0.08
629,2021-05-14,LAZ,50728,23153,27575,32519,18209,ITI,ITI4,12,Lazio,Lazio,5879082,274294,4.67,0.86
630,2021-03-25,LAZ,26915,11511,15404,20312,6603,ITI,ITI4,12,Lazio,Lazio,5879082,301209,5.12,0.46
631,2021-01-27,LAZ,6114,2387,3727,997,5117,ITI,ITI4,12,Lazio,Lazio,5879082,307323,5.23,0.1
632,2021-04-16,LAZ,34394,15676,18718,22335,12059,ITI,ITI4,12,Lazio,Lazio,5879082,341717,5.81,0.59
633,2021-02-25,LAZ,12654,5518,7136,11604,1050,ITI,ITI4,12,Lazio,Lazio,5879082,354371,6.03,0.22
634,2021-05-21,LAZ,50252,23624,26628,37391,12861,ITI,ITI4,12,Lazio,Lazio,5879082,404623,6.88,0.85
635,2021-04-04,LAZ,17463,8036,9427,12197,5266,ITI,ITI4,12,Lazio,Lazio,5879082,422086,7.18,0.3
636,2021-02-20,LAZ,9204,4273,4931,8437,767,ITI,ITI4,12,Lazio,Lazio,5879082,431290,7.34,0.16
637,2021-03-01,LAZ,17084,7344,9740,13199,3885,ITI,ITI4,12,Lazio,Lazio,5879082,448374,7.63,0.29
638,2021-03-21,LAZ,17858,6826,11032,12807,5051,ITI,ITI4,12,Lazio,Lazio,5879082,466232,7.93,0.3
639,2021-04-09,LAZ,27298,12267,15031,19076,8222,ITI,ITI4,12,Lazio,Lazio,5879082,493530,8.39,0.46
640,2021-03-04,LAZ,18654,8014,10640,13638,5016,ITI,ITI4,12,Lazio,Lazio,5879082,512184,8.71,0.32
641,2020-12-30,LAZ,1630,629,1001,1630,0,ITI,ITI4,12,Lazio,Lazio,5879082,513814,8.74,0.03
642,2021-03-06,LAZ,18302,7050,11252,14045,4257,ITI,ITI4,12,Lazio,Lazio,5879082,532116,9.05,0.31
643,2021-01-29,LAZ,8042,3079,4963,813,7229,ITI,ITI4,12,Lazio,Lazio,5879082,540158,9.19,0.14
644,2021-03-27,LAZ,26009,10395,15614,19539,6470,ITI,ITI4,12,Lazio,Lazio,5879082,566167,9.63,0.44
645,2021-05-23,LAZ,47009,22770,24239,39683,7326,ITI,ITI4,12,Lazio,Lazio,5879082,613176,10.43,0.8
646,2021-05-09,LAZ,37523,17248,20275,26257,11266,ITI,ITI4,12,Lazio,Lazio,5879082,650699,11.07,0.64
647,2021-04-18,LAZ,23773,10556,13217,16139,7634,ITI,ITI4,12,Lazio,Lazio,5879082,674472,11.47,0.4
648,2021-05-02,LAZ,32620,14333,18287,23259,9361,ITI,ITI4,12,Lazio,Lazio,5879082,707092,12.03,0.55
649,2021-02-27,LAZ,11427,4268,7159,10472,955,ITI,ITI4,12,Lazio,Lazio,5879082,718519,12.22,0.19
650,2021-03-13,LAZ,21445,8427,13018,15551,5894,ITI,ITI4,12,Lazio,Lazio,5879082,739964,12.59,0.36
651,2021-01-22,LAZ,4002,1633,2369,487,3515,ITI,ITI4,12,Lazio,Lazio,5879082,743966,12.65,0.07
652,2021-02-18,LAZ,10017,4976,5041,9208,809,ITI,ITI4,12,Lazio,Lazio,5879082,753983,12.82,0.17
653,2021-04-23,LAZ,37653,18080,19573,22404,15249,ITI,ITI4,12,Lazio,Lazio,5879082,791636,13.47,0.64
654,2021-02-01,LAZ,5675,2177,3498,354,5321,ITI,ITI4,12,Lazio,Lazio,5879082,797311,13.56,0.1
655,2021-04-06,LAZ,23879,10653,13226,16776,7103,ITI,ITI4,12,Lazio,Lazio,5879082,821190,13.97,0.41
656,2021-01-15,LAZ,6574,2705,3869,6574,0,ITI,ITI4,12,Lazio,Lazio,5879082,827764,14.08,0.11
657,2021-03-20,LAZ,18224,6810,11414,12340,5884,ITI,ITI4,12,Lazio,Lazio,5879082,845988,14.39,0.31
658,2021-04-13,LAZ,25661,11869,13792,17955,7706,ITI,ITI4,12,Lazio,Lazio,5879082,871649,14.83,0.44
659,2021-01-03,LAZ,5250,1972,3278,5250,0,ITI,ITI4,12,Lazio,Lazio,5879082,876899,14.92,0.09
660,2021-01-10,LAZ,4039,1700,2339,4039,0,ITI,ITI4,12,Lazio,Lazio,5879082,880938,14.98,0.07
661,2021-04-20,LAZ,30996,14226,16770,19715,11281,ITI,ITI4,12,Lazio,Lazio,5879082,911934,15.51,0.53
662,2021-03-08,LAZ,20062,8313,11749,14789,5273,ITI,ITI4,12,Lazio,Lazio,5879082,931996,15.85,0.34
663,2021-01-23,LAZ,7212,2869,4343,583,6629,ITI,ITI4,12,Lazio,Lazio,5879082,939208,15.98,0.12
664,2021-01-06,LAZ,5122,1961,3161,5122,0,ITI,ITI4,12,Lazio,Lazio,5879082,944330,16.06,0.09
665,2021-04-01,LAZ,28404,13047,15357,21264,7140,ITI,ITI4,12,Lazio,Lazio,5879082,972734,16.55,0.48
666,2021-04-15,LAZ,31907,14300,17607,21103,10804,ITI,ITI4,12,Lazio,Lazio,5879082,1004641,17.09,0.54
667,2021-02-10,LAZ,8187,3398,4789,4850,3337,ITI,ITI4,12,Lazio,Lazio,5879082,1012828,17.23,0.14
668,2021-05-26,LAZ,46056,20585,25471,34916,11140,ITI,ITI4,12,Lazio,Lazio,5879082,1058884,18.01,0.78
669,2021-03-23,LAZ,23496,10225,13271,16919,6577,ITI,ITI4,12,Lazio,Lazio,5879082,1082380,18.41,0.4
670,2021-02-15,LAZ,8025,3540,4485,7394,631,ITI,ITI4,12,Lazio,Lazio,5879082,1090405,18.55,0.14
671,2021-05-28,LAZ,55734,25496,30238,43284,12450,ITI,ITI4,12,Lazio,Lazio,5879082,1146139,19.5,0.95
672,2021-02-17,LAZ,9181,4603,4578,8307,874,ITI,ITI4,12,Lazio,Lazio,5879082,1155320,19.65,0.16
673,2021-04-08,LAZ,26648,12173,14475,18966,7682,ITI,ITI4,12,Lazio,Lazio,5879082,1181968,20.1,0.45
674,2021-03-22,LAZ,21697,9064,12633,15036,6661,ITI,ITI4,12,Lazio,Lazio,5879082,1203665,20.47,0.37
675,2021-03-05,LAZ,18792,7961,10831,14059,4733,ITI,ITI4,12,Lazio,Lazio,5879082,1222457,20.79,0.32
676,2021-05-29,LAZ,51048,22762,28286,40726,10322,ITI,ITI4,12,Lazio,Lazio,5879082,1273505,21.66,0.87
677,2021-05-31,LAZ,49045,20975,28070,31038,18007,ITI,ITI4,12,Lazio,Lazio,5879082,1322550,22.5,0.83
678,2021-03-28,LAZ,18838,7541,11297,13528,5310,ITI,ITI4,12,Lazio,Lazio,5879082,1341388,22.82,0.32
679,2021-04-27,LAZ,30626,13820,16806,19783,10843,ITI,ITI4,12,Lazio,Lazio,5879082,1372014,23.34,0.52
680,2021-02-22,LAZ,11456,4990,6466,10954,502,ITI,ITI4,12,Lazio,Lazio,5879082,1383470,23.53,0.19
681,2021-03-16,LAZ,13538,5732,7806,7094,6444,ITI,ITI4,12,Lazio,Lazio,5879082,1397008,23.76,0.23
682,2021-03-09,LAZ,20868,8937,11931,15671,5197,ITI,ITI4,12,Lazio,Lazio,5879082,1417876,24.12,0.35
683,2021-01-11,LAZ,5531,2105,3426,5531,0,ITI,ITI4,12,Lazio,Lazio,5879082,1423407,24.21,0.09
684,2021-05-05,LAZ,46705,21424,25281,30901,15804,ITI,ITI4,12,Lazio,Lazio,5879082,1470112,25.01,0.79
685,2021-03-02,LAZ,16987,7429,9558,13053,3934,ITI,ITI4,12,Lazio,Lazio,5879082,1487099,25.29,0.29
686,2021-04-28,LAZ,32844,14995,17849,21298,11546,ITI,ITI4,12,Lazio,Lazio,5879082,1519943,25.85,0.56
687,2021-01-25,LAZ,8111,3246,4865,770,7341,ITI,ITI4,12,Lazio,Lazio,5879082,1528054,25.99,0.14
688,2021-01-18,LAZ,6267,2557,3710,5289,978,ITI,ITI4,12,Lazio,Lazio,5879082,1534321,26.1,0.11
689,2021-05-17,LAZ,43777,19993,23784,35334,8443,ITI,ITI4,12,Lazio,Lazio,5879082,1578098,26.84,0.74
690,2021-02-11,LAZ,6998,3012,3986,6467,531,ITI,ITI4,12,Lazio,Lazio,5879082,1585096,26.96,0.12
691,2021-05-24,LAZ,42786,19158,23628,34001,8785,ITI,ITI4,12,Lazio,Lazio,5879082,1627882,27.69,0.73
692,2021-02-06,LAZ,6136,2474,3662,817,5319,ITI,ITI4,12,Lazio,Lazio,5879082,1634018,27.79,0.1
693,2021-04-11,LAZ,19115,8431,10684,13234,5881,ITI,ITI4,12,Lazio,Lazio,5879082,1653133,28.12,0.33
694,2021-02-13,LAZ,6608,2626,3982,6194,414,ITI,ITI4,12,Lazio,Lazio,5879082,1659741,28.23,0.11
695,2021-01-08,LAZ,7728,2894,4834,7728,0,ITI,ITI4,12,Lazio,Lazio,5879082,1667469,28.36,0.13
696,2021-01-01,LAZ,3554,1382,2172,3554,0,ITI,ITI4,12,Lazio,Lazio,5879082,1671023,28.42,0.06
697,2021-05-25,LAZ,46175,21180,24995,35418,10757,ITI,ITI4,12,Lazio,Lazio,5879082,1717198,29.21,0.79
698,2021-04-12,LAZ,23758,10677,13081,16861,6897,ITI,ITI4,12,Lazio,Lazio,5879082,1740956,29.61,0.4
699,2021-02-21,LAZ,6987,3179,3808,6525,462,ITI,ITI4,12,Lazio,Lazio,5879082,1747943,29.73,0.12
700,2021-02-28,LAZ,10248,4007,6241,9734,514,ITI,ITI4,12,Lazio,Lazio,5879082,1758191,29.91,0.17
701,2021-01-09,LAZ,6296,2561,3735,6296,0,ITI,ITI4,12,Lazio,Lazio,5879082,1764487,30.01,0.11
702,2021-01-17,LAZ,4894,2028,2866,4682,212,ITI,ITI4,12,Lazio,Lazio,5879082,1769381,30.1,0.08
703,2021-04-29,LAZ,38558,17207,21351,25338,13220,ITI,ITI4,12,Lazio,Lazio,5879082,1807939,30.75,0.66
704,2021-01-26,LAZ,7958,3125,4833,724,7234,ITI,ITI4,12,Lazio,Lazio,5879082,1815897,30.89,0.14
705,2021-05-08,LAZ,45171,20611,24560,29813,15358,ITI,ITI4,12,Lazio,Lazio,5879082,1861068,31.66,0.77
706,2021-03-26,LAZ,28226,12252,15974,21383,6843,ITI,ITI4,12,Lazio,Lazio,5879082,1889294,32.14,0.48
707,2021-06-01,LAZ,22377,10537,11840,13965,8412,ITI,ITI4,12,Lazio,Lazio,5879082,1911671,32.52,0.38
708,2021-04-05,LAZ,19769,8992,10777,13591,6178,ITI,ITI4,12,Lazio,Lazio,5879082,1931440,32.85,0.34
709,2021-04-19,LAZ,30060,13661,16399,19383,10677,ITI,ITI4,12,Lazio,Lazio,5879082,1961500,33.36,0.51
710,2021-02-14,LAZ,5773,2370,3403,5303,470,ITI,ITI4,12,Lazio,Lazio,5879082,1967273,33.46,0.1
711,2021-01-02,LAZ,6707,2631,4076,6707,0,ITI,ITI4,12,Lazio,Lazio,5879082,1973980,33.58,0.11
712,2021-05-30,LAZ,41002,17499,23503,33781,7221,ITI,ITI4,12,Lazio,Lazio,5879082,2014982,34.27,0.7
713,2021-04-24,LAZ,33319,15013,18306,20572,12747,ITI,ITI4,12,Lazio,Lazio,5879082,2048301,34.84,0.57
714,2021-01-14,LAZ,5473,2142,3331,5473,0,ITI,ITI4,12,Lazio,Lazio,5879082,2053774,34.93,0.09
715,2021-04-26,LAZ,29175,13429,15746,19973,9202,ITI,ITI4,12,Lazio,Lazio,5879082,2082949,35.43,0.5
716,2021-01-16,LAZ,5645,2280,3365,5645,0,ITI,ITI4,12,Lazio,Lazio,5879082,2088594,35.53,0.1
717,2021-05-04,LAZ,39752,18280,21472,26276,13476,ITI,ITI4,12,Lazio,Lazio,5879082,2128346,36.2,0.68
718,2021-02-24,LAZ,12047,5204,6843,11053,994,ITI,ITI4,12,Lazio,Lazio,5879082,2140393,36.41,0.2
719,2021-01-05,LAZ,7374,2802,4572,7374,0,ITI,ITI4,12,Lazio,Lazio,5879082,2147767,36.53,0.13
720,2021-02-07,LAZ,4942,2023,2919,387,4555,ITI,ITI4,12,Lazio,Lazio,5879082,2152709,36.62,0.08
721,2021-05-03,LAZ,39102,17638,21464,26532,12570,ITI,ITI4,12,Lazio,Lazio,5879082,2191811,37.28,0.67
722,2021-02-26,LAZ,13075,5700,7375,11713,1362,ITI,ITI4,12,Lazio,Lazio,5879082,2204886,37.5,0.22
723,2021-05-01,LAZ,37914,17065,20849,25968,11946,ITI,ITI4,12,Lazio,Lazio,5879082,2242800,38.15,0.64
724,2021-04-17,LAZ,32304,14175,18129,20357,11947,ITI,ITI4,12,Lazio,Lazio,5879082,2275104,38.7,0.55
725,2021-03-12,LAZ,22903,10130,12773,16589,6314,ITI,ITI4,12,Lazio,Lazio,5879082,2298007,39.09,0.39
726,2021-01-21,LAZ,5600,2348,3252,548,5052,ITI,ITI4,12,Lazio,Lazio,5879082,2303607,39.18,0.1
727,2021-01-07,LAZ,7747,2902,4845,7747,0,ITI,ITI4,12,Lazio,Lazio,5879082,2311354,39.31,0.13
728,2021-05-16,LAZ,50893,24505,26388,37419,13474,ITI,ITI4,12,Lazio,Lazio,5879082,2362247,40.18,0.87
729,2021-02-12,LAZ,6844,2845,3999,6432,412,ITI,ITI4,12,Lazio,Lazio,5879082,2369091,40.3,0.12
730,2021-04-10,LAZ,23808,10314,13494,16626,7182,ITI,ITI4,12,Lazio,Lazio,5879082,2392899,40.7,0.4
731,2021-02-05,LAZ,7278,2960,4318,1183,6095,ITI,ITI4,12,Lazio,Lazio,5879082,2400177,40.83,0.12
732,2021-04-03,LAZ,24687,11094,13593,17988,6699,ITI,ITI4,12,Lazio,Lazio,5879082,2424864,41.25,0.42
733,2020-12-31,LAZ,5293,2121,3172,5293,0,ITI,ITI4,12,Lazio,Lazio,5879082,2430157,41.34,0.09
734,2021-02-19,LAZ,10047,5081,4966,9216,831,ITI,ITI4,12,Lazio,Lazio,5879082,2440204,41.51,0.17
735,2021-04-22,LAZ,38527,18929,19598,23951,14576,ITI,ITI4,12,Lazio,Lazio,5879082,2478731,42.16,0.66
736,2021-03-10,LAZ,22022,9489,12533,16376,5646,ITI,ITI4,12,Lazio,Lazio,5879082,2500753,42.54,0.37
737,2021-01-12,LAZ,5412,1981,3431,5412,0,ITI,ITI4,12,Lazio,Lazio,5879082,2506165,42.63,0.09
738,2021-03-17,LAZ,13786,5896,7890,7531,6255,ITI,ITI4,12,Lazio,Lazio,5879082,2519951,42.86,0.23
739,2020-12-29,LAZ,488,176,312,488,0,ITI,ITI4,12,Lazio,Lazio,5879082,2520439,42.87,0.01
740,2021-03-24,LAZ,25876,11297,14579,19639,6237,ITI,ITI4,12,Lazio,Lazio,5879082,2546315,43.31,0.44
741,2021-05-27,LAZ,56167,25368,30799,43805,12362,ITI,ITI4,12,Lazio,Lazio,5879082,2602482,44.27,0.96
742,2021-03-07,LAZ,14110,5442,8668,10517,3593,ITI,ITI4,12,Lazio,Lazio,5879082,2616592,44.51,0.24
743,2021-05-10,LAZ,44169,20139,24030,30798,13371,ITI,ITI4,12,Lazio,Lazio,5879082,2660761,45.26,0.75
744,2021-05-11,LAZ,47901,21959,25942,31512,16389,ITI,ITI4,12,Lazio,Lazio,5879082,2708662,46.07,0.81
745,2021-01-31,LAZ,4459,1854,2605,476,3983,ITI,ITI4,12,Lazio,Lazio,5879082,2713121,46.15,0.08
746,2021-05-13,LAZ,49499,22177,27322,31858,17641,ITI,ITI4,12,Lazio,Lazio,5879082,2762620,46.99,0.84
747,2021-04-07,LAZ,24958,11320,13638,17654,7304,ITI,ITI4,12,Lazio,Lazio,5879082,2787578,47.42,0.42
748,2021-02-02,LAZ,5909,2213,3696,637,5272,ITI,ITI4,12,Lazio,Lazio,5879082,2793487,47.52,0.1
749,2020-12-28,LAZ,959,412,547,959,0,ITI,ITI4,12,Lazio,Lazio,5879082,2794446,47.53,0.02
750,2021-03-03,LAZ,17395,7438,9957,13101,4294,ITI,ITI4,12,Lazio,Lazio,5879082,2811841,47.83,0.3
751,2021-05-06,LAZ,48624,22614,26010,31101,17523,ITI,ITI4,12,Lazio,Lazio,5879082,2860465,48.65,0.83
752,2021-01-19,LAZ,4768,1954,2814,4314,454,ITI,ITI4,12,Lazio,Lazio,5879082,2865233,48.74,0.08
753,2021-04-02,LAZ,28547,13376,15171,21219,7328,ITI,ITI4,12,Lazio,Lazio,5879082,2893780,49.22,0.49
754,2021-01-28,LAZ,8279,3165,5114,782,7497,ITI,ITI4,12,Lazio,Lazio,5879082,2902059,49.36,0.14
755,2021-05-15,LAZ,57040,27245,29795,40615,16425,ITI,ITI4,12,Lazio,Lazio,5879082,2959099,50.33,0.97
756,2021-03-19,LAZ,17215,7364,9851,10887,6328,ITI,ITI4,12,Lazio,Lazio,5879082,2976314,50.63,0.29
757,2021-04-21,LAZ,32975,14973,18002,20613,12362,ITI,ITI4,12,Lazio,Lazio,5879082,3009289,51.19,0.56
758,2021-02-16,LAZ,8354,4033,4321,7749,605,ITI,ITI4,12,Lazio,Lazio,5879082,3017643,51.33,0.14
759,2021-03-15,LAZ,19275,8333,10942,12536,6739,ITI,ITI4,12,Lazio,Lazio,5879082,3036918,51.66,0.33
760,2021-01-24,LAZ,5694,2229,3465,612,5082,ITI,ITI4,12,Lazio,Lazio,5879082,3042612,51.75,0.1
761,2021-05-18,LAZ,44134,20123,24011,34810,9324,ITI,ITI4,12,Lazio,Lazio,5879082,3086746,52.5,0.75
762,2021-03-29,LAZ,23956,10756,13200,16923,7033,ITI,ITI4,12,Lazio,Lazio,5879082,3110702,52.91,0.41
763,2021-03-14,LAZ,17102,6613,10489,11948,5154,ITI,ITI4,12,Lazio,Lazio,5879082,3127804,53.2,0.29
764,2021-04-14,LAZ,29270,13261,16009,19149,10121,ITI,ITI4,12,Lazio,Lazio,5879082,3157074,53.7,0.5
765,2021-02-04,LAZ,6302,2481,3821,987,5315,ITI,ITI4,12,Lazio,Lazio,5879082,3163376,53.81,0.11
766,2021-05-22,LAZ,54625,26609,28016,44249,10376,ITI,ITI4,12,Lazio,Lazio,5879082,3218001,54.74,0.93
767,2021-01-04,LAZ,7481,2908,4573,7481,0,ITI,ITI4,12,Lazio,Lazio,5879082,3225482,54.86,0.13
768,2021-03-30,LAZ,25256,11584,13672,18108,7148,ITI,ITI4,12,Lazio,Lazio,5879082,3250738,55.29,0.43
769,2021-05-19,LAZ,46443,21207,25236,36635,9808,ITI,ITI4,12,Lazio,Lazio,5879082,3297181,56.08,0.79
770,2021-02-08,LAZ,9739,4153,5586,4508,5231,ITI,ITI4,12,Lazio,Lazio,5879082,3306920,56.25,0.17
771,2021-05-20,LAZ,50663,24174,26489,37407,13256,ITI,ITI4,12,Lazio,Lazio,5879082,3357583,57.11,0.86
772,2021-02-09,LAZ,8797,3768,5029,4580,4217,ITI,ITI4,12,Lazio,Lazio,5879082,3366380,57.26,0.15
773,2021-03-31,LAZ,26107,12046,14061,19014,7093,ITI,ITI4,12,Lazio,Lazio,5879082,3392487,57.7,0.44
774,2021-02-23,LAZ,11087,4780,6307,10326,761,ITI,ITI4,12,Lazio,Lazio,5879082,3403574,57.89,0.19
775,2021-04-05,MAR,5688,2355,3333,4419,1269,ITI,ITI3,11,Marche,Marche,1525271,5688,0.37,0.37
776,2021-03-19,MAR,3835,1597,2238,339,3496,ITI,ITI3,11,Marche,Marche,1525271,9523,0.62,0.25
777,2021-03-02,MAR,4953,1941,3012,4387,566,ITI,ITI3,11,Marche,Marche,1525271,14476,0.95,0.32
778,2021-05-22,MAR,11933,5718,6215,7485,4448,ITI,ITI3,11,Marche,Marche,1525271,26409,1.73,0.78
779,2021-04-26,MAR,8980,3983,4997,5958,3022,ITI,ITI3,11,Marche,Marche,1525271,35389,2.32,0.59
780,2021-05-10,MAR,9447,4336,5111,4895,4552,ITI,ITI3,11,Marche,Marche,1525271,44836,2.94,0.62
781,2021-03-14,MAR,2500,1032,1468,1907,593,ITI,ITI3,11,Marche,Marche,1525271,47336,3.1,0.16
782,2021-01-23,MAR,557,190,367,123,434,ITI,ITI3,11,Marche,Marche,1525271,47893,3.14,0.04
783,2021-03-28,MAR,4126,1739,2387,2435,1691,ITI,ITI3,11,Marche,Marche,1525271,52019,3.41,0.27
784,2021-01-12,MAR,1227,413,814,1227,0,ITI,ITI3,11,Marche,Marche,1525271,53246,3.49,0.08
785,2021-05-03,MAR,10196,4605,5591,4789,5407,ITI,ITI3,11,Marche,Marche,1525271,63442,4.16,0.67
786,2021-03-21,MAR,4505,1873,2632,1629,2876,ITI,ITI3,11,Marche,Marche,1525271,67947,4.45,0.3
787,2021-01-30,MAR,1905,668,1237,29,1876,ITI,ITI3,11,Marche,Marche,1525271,69852,4.58,0.12
788,2021-03-24,MAR,7032,2983,4049,3364,3668,ITI,ITI3,11,Marche,Marche,1525271,76884,5.04,0.46
789,2021-03-10,MAR,5668,2401,3267,4531,1137,ITI,ITI3,11,Marche,Marche,1525271,82552,5.41,0.37
790,2021-01-19,MAR,228,83,145,142,86,ITI,ITI3,11,Marche,Marche,1525271,82780,5.43,0.01
791,2021-05-13,MAR,12601,5694,6907,7102,5499,ITI,ITI3,11,Marche,Marche,1525271,95381,6.25,0.83
792,2021-02-21,MAR,376,141,235,375,1,ITI,ITI3,11,Marche,Marche,1525271,95757,6.28,0.02
793,2021-01-02,MAR,453,139,314,453,0,ITI,ITI3,11,Marche,Marche,1525271,96210,6.31,0.03
794,2021-03-07,MAR,5182,2108,3074,4428,754,ITI,ITI3,11,Marche,Marche,1525271,101392,6.65,0.34
795,2021-05-17,MAR,11853,5568,6285,7690,4163,ITI,ITI3,11,Marche,Marche,1525271,113245,7.42,0.78
796,2021-01-31,MAR,1920,770,1150,105,1815,ITI,ITI3,11,Marche,Marche,1525271,115165,7.55,0.13
797,2021-02-09,MAR,124,42,82,46,78,ITI,ITI3,11,Marche,Marche,1525271,115289,7.56,0.01
798,2021-04-14,MAR,10215,4564,5651,9843,372,ITI,ITI3,11,Marche,Marche,1525271,125504,8.23,0.67
799,2021-04-09,MAR,9560,4189,5371,9360,200,ITI,ITI3,11,Marche,Marche,1525271,135064,8.86,0.63
800,2021-01-06,MAR,2181,792,1389,2181,0,ITI,ITI3,11,Marche,Marche,1525271,137245,9.0,0.14
801,2021-05-08,MAR,12270,5477,6793,5022,7248,ITI,ITI3,11,Marche,Marche,1525271,149515,9.8,0.8
802,2021-04-02,MAR,6875,2973,3902,6135,740,ITI,ITI3,11,Marche,Marche,1525271,156390,10.25,0.45
803,2021-01-28,MAR,2086,725,1361,165,1921,ITI,ITI3,11,Marche,Marche,1525271,158476,10.39,0.14
804,2021-04-04,MAR,3824,1792,2032,2655,1169,ITI,ITI3,11,Marche,Marche,1525271,162300,10.64,0.25
805,2021-05-01,MAR,9318,3924,5394,3576,5742,ITI,ITI3,11,Marche,Marche,1525271,171618,11.25,0.61
806,2021-03-05,MAR,6171,2856,3315,4703,1468,ITI,ITI3,11,Marche,Marche,1525271,177789,11.66,0.4
807,2021-01-07,MAR,1807,636,1171,1807,0,ITI,ITI3,11,Marche,Marche,1525271,179596,11.77,0.12
808,2021-04-24,MAR,12026,5304,6722,7560,4466,ITI,ITI3,11,Marche,Marche,1525271,191622,12.56,0.79
809,2021-02-26,MAR,3630,1499,2131,3154,476,ITI,ITI3,11,Marche,Marche,1525271,195252,12.8,0.24
810,2021-01-21,MAR,899,255,644,585,314,ITI,ITI3,11,Marche,Marche,1525271,196151,12.86,0.06
811,2021-03-12,MAR,4640,1972,2668,3402,1238,ITI,ITI3,11,Marche,Marche,1525271,200791,13.16,0.3
812,2021-01-14,MAR,2010,692,1318,2010,0,ITI,ITI3,11,Marche,Marche,1525271,202801,13.3,0.13
813,2021-02-19,MAR,1962,712,1250,1827,135,ITI,ITI3,11,Marche,Marche,1525271,204763,13.42,0.13
814,2020-12-31,MAR,385,180,205,385,0,ITI,ITI3,11,Marche,Marche,1525271,205148,13.45,0.03
815,2021-05-15,MAR,13966,6376,7590,8076,5890,ITI,ITI3,11,Marche,Marche,1525271,219114,14.37,0.92
816,2021-02-04,MAR,2341,809,1532,112,2229,ITI,ITI3,11,Marche,Marche,1525271,221455,14.52,0.15
817,2021-03-26,MAR,6331,2606,3725,3523,2808,ITI,ITI3,11,Marche,Marche,1525271,227786,14.93,0.42
818,2021-03-17,MAR,3428,1494,1934,107,3321,ITI,ITI3,11,Marche,Marche,1525271,231214,15.16,0.22
819,2021-02-28,MAR,2836,1251,1585,2830,6,ITI,ITI3,11,Marche,Marche,1525271,234050,15.34,0.19
820,2021-05-24,MAR,10797,5112,5685,8123,2674,ITI,ITI3,11,Marche,Marche,1525271,244847,16.05,0.71
821,2021-02-11,MAR,1987,657,1330,1598,389,ITI,ITI3,11,Marche,Marche,1525271,246834,16.18,0.13
822,2021-03-29,MAR,5860,2567,3293,3435,2425,ITI,ITI3,11,Marche,Marche,1525271,252694,16.57,0.38
823,2021-05-27,MAR,13731,6818,6913,9430,4301,ITI,ITI3,11,Marche,Marche,1525271,266425,17.47,0.9
824,2021-03-31,MAR,7374,3086,4288,4350,3024,ITI,ITI3,11,Marche,Marche,1525271,273799,17.95,0.48
825,2021-02-16,MAR,1287,475,812,1257,30,ITI,ITI3,11,Marche,Marche,1525271,275086,18.04,0.08
826,2021-02-23,MAR,3267,1397,1870,3211,56,ITI,ITI3,11,Marche,Marche,1525271,278353,18.25,0.21
827,2021-06-01,MAR,4529,2396,2133,3526,1003,ITI,ITI3,11,Marche,Marche,1525271,282882,18.55,0.3
828,2021-04-12,MAR,8567,3772,4795,8083,484,ITI,ITI3,11,Marche,Marche,1525271,291449,19.11,0.56
829,2021-02-02,MAR,1191,397,794,72,1119,ITI,ITI3,11,Marche,Marche,1525271,292640,19.19,0.08
830,2021-01-16,MAR,2005,723,1282,2005,0,ITI,ITI3,11,Marche,Marche,1525271,294645,19.32,0.13
831,2021-01-26,MAR,2016,746,1270,92,1924,ITI,ITI3,11,Marche,Marche,1525271,296661,19.45,0.13
832,2021-02-14,MAR,738,301,437,738,0,ITI,ITI3,11,Marche,Marche,1525271,297399,19.5,0.05
833,2021-04-19,MAR,9603,4498,5105,8022,1581,ITI,ITI3,11,Marche,Marche,1525271,307002,20.13,0.63
834,2021-01-09,MAR,1709,605,1104,1709,0,ITI,ITI3,11,Marche,Marche,1525271,308711,20.24,0.11
835,2021-04-21,MAR,10781,4967,5814,9587,1194,ITI,ITI3,11,Marche,Marche,1525271,319492,20.95,0.71
836,2021-03-16,MAR,3471,1485,1986,290,3181,ITI,ITI3,11,Marche,Marche,1525271,322963,21.17,0.23
837,2021-01-11,MAR,1176,411,765,1176,0,ITI,ITI3,11,Marche,Marche,1525271,324139,21.25,0.08
838,2021-05-05,MAR,11646,5299,6347,5217,6429,ITI,ITI3,11,Marche,Marche,1525271,335785,22.01,0.76
839,2021-02-13,MAR,1063,453,610,1011,52,ITI,ITI3,11,Marche,Marche,1525271,336848,22.08,0.07
840,2021-04-18,MAR,8820,4131,4689,7899,921,ITI,ITI3,11,Marche,Marche,1525271,345668,22.66,0.58
841,2021-01-27,MAR,2118,780,1338,122,1996,ITI,ITI3,11,Marche,Marche,1525271,347786,22.8,0.14
842,2021-01-10,MAR,1737,699,1038,1737,0,ITI,ITI3,11,Marche,Marche,1525271,349523,22.92,0.11
843,2021-05-20,MAR,12365,5814,6551,7666,4699,ITI,ITI3,11,Marche,Marche,1525271,361888,23.73,0.81
844,2021-02-07,MAR,1868,734,1134,344,1524,ITI,ITI3,11,Marche,Marche,1525271,363756,23.85,0.12
845,2021-04-07,MAR,7810,3435,4375,7475,335,ITI,ITI3,11,Marche,Marche,1525271,371566,24.36,0.51
846,2021-04-16,MAR,10082,4702,5380,9557,525,ITI,ITI3,11,Marche,Marche,1525271,381648,25.02,0.66
847,2021-01-04,MAR,1504,566,938,1504,0,ITI,ITI3,11,Marche,Marche,1525271,383152,25.12,0.1
848,2020-12-30,MAR,17,5,12,17,0,ITI,ITI3,11,Marche,Marche,1525271,383169,25.12,0.0
849,2021-05-12,MAR,10423,4685,5738,4922,5501,ITI,ITI3,11,Marche,Marche,1525271,393592,25.8,0.68
850,2021-05-29,MAR,12750,6157,6593,8261,4489,ITI,ITI3,11,Marche,Marche,1525271,406342,26.64,0.84
851,2021-02-18,MAR,2101,745,1356,1815,286,ITI,ITI3,11,Marche,Marche,1525271,408443,26.78,0.14
852,2021-02-25,MAR,3510,1434,2076,3331,179,ITI,ITI3,11,Marche,Marche,1525271,411953,27.01,0.23
853,2021-05-21,MAR,12951,6113,6838,6695,6256,ITI,ITI3,11,Marche,Marche,1525271,424904,27.86,0.85
854,2021-04-01,MAR,7577,3182,4395,4161,3416,ITI,ITI3,11,Marche,Marche,1525271,432481,28.35,0.5
855,2021-02-17,MAR,1785,662,1123,1668,117,ITI,ITI3,11,Marche,Marche,1525271,434266,28.47,0.12
856,2021-04-22,MAR,10795,4930,5865,9217,1578,ITI,ITI3,11,Marche,Marche,1525271,445061,29.18,0.71
857,2021-03-03,MAR,6643,3046,3597,5761,882,ITI,ITI3,11,Marche,Marche,1525271,451704,29.61,0.44
858,2021-01-05,MAR,1562,586,976,1562,0,ITI,ITI3,11,Marche,Marche,1525271,453266,29.72,0.1
859,2021-05-09,MAR,8770,3986,4784,3639,5131,ITI,ITI3,11,Marche,Marche,1525271,462036,30.29,0.57
860,2021-03-06,MAR,5702,2625,3077,4435,1267,ITI,ITI3,11,Marche,Marche,1525271,467738,30.67,0.37
861,2021-05-18,MAR,11061,5257,5804,7657,3404,ITI,ITI3,11,Marche,Marche,1525271,478799,31.39,0.73
862,2021-02-06,MAR,2460,900,1560,522,1938,ITI,ITI3,11,Marche,Marche,1525271,481259,31.55,0.16
863,2021-05-28,MAR,13960,6736,7224,9098,4862,ITI,ITI3,11,Marche,Marche,1525271,495219,32.47,0.92
864,2021-04-08,MAR,7522,3285,4237,7195,327,ITI,ITI3,11,Marche,Marche,1525271,502741,32.96,0.49
865,2021-04-15,MAR,10376,4674,5702,9811,565,ITI,ITI3,11,Marche,Marche,1525271,513117,33.64,0.68
866,2021-02-24,MAR,3486,1515,1971,3408,78,ITI,ITI3,11,Marche,Marche,1525271,516603,33.87,0.23
867,2021-02-27,MAR,3356,1435,1921,3147,209,ITI,ITI3,11,Marche,Marche,1525271,519959,34.09,0.22
868,2021-03-18,MAR,3389,1475,1914,162,3227,ITI,ITI3,11,Marche,Marche,1525271,523348,34.31,0.22
869,2021-05-23,MAR,9208,4282,4926,7537,1671,ITI,ITI3,11,Marche,Marche,1525271,532556,34.92,0.6
870,2021-02-10,MAR,1439,452,987,1080,359,ITI,ITI3,11,Marche,Marche,1525271,533995,35.01,0.09
871,2021-02-12,MAR,1582,618,964,1430,152,ITI,ITI3,11,Marche,Marche,1525271,535577,35.11,0.1
872,2021-05-31,MAR,11783,5945,5838,8854,2929,ITI,ITI3,11,Marche,Marche,1525271,547360,35.89,0.77
873,2021-04-30,MAR,13940,6100,7840,5398,8542,ITI,ITI3,11,Marche,Marche,1525271,561300,36.8,0.91
874,2021-03-11,MAR,6593,2785,3808,5223,1370,ITI,ITI3,11,Marche,Marche,1525271,567893,37.23,0.43
875,2021-05-14,MAR,13492,6217,7275,6720,6772,ITI,ITI3,11,Marche,Marche,1525271,581385,38.12,0.88
876,2021-03-27,MAR,7379,3073,4306,5021,2358,ITI,ITI3,11,Marche,Marche,1525271,588764,38.6,0.48
877,2021-05-16,MAR,10898,4957,5941,6670,4228,ITI,ITI3,11,Marche,Marche,1525271,599662,39.32,0.71
878,2021-04-10,MAR,10917,4620,6297,10603,314,ITI,ITI3,11,Marche,Marche,1525271,610579,40.03,0.72
879,2021-02-05,MAR,2155,653,1502,440,1715,ITI,ITI3,11,Marche,Marche,1525271,612734,40.17,0.14
880,2021-05-30,MAR,9744,4695,5049,6752,2992,ITI,ITI3,11,Marche,Marche,1525271,622478,40.81,0.64
881,2021-04-17,MAR,11701,5316,6385,10628,1073,ITI,ITI3,11,Marche,Marche,1525271,634179,41.58,0.77
882,2021-05-04,MAR,10844,4789,6055,4949,5895,ITI,ITI3,11,Marche,Marche,1525271,645023,42.29,0.71
883,2021-03-22,MAR,5655,2376,3279,2527,3128,ITI,ITI3,11,Marche,Marche,1525271,650678,42.66,0.37
884,2021-01-24,MAR,880,339,541,5,875,ITI,ITI3,11,Marche,Marche,1525271,651558,42.72,0.06
885,2021-05-07,MAR,12838,5805,7033,3660,9178,ITI,ITI3,11,Marche,Marche,1525271,664396,43.56,0.84
886,2021-01-25,MAR,1597,560,1037,97,1500,ITI,ITI3,11,Marche,Marche,1525271,665993,43.66,0.1
887,2021-04-20,MAR,10698,4996,5702,9281,1417,ITI,ITI3,11,Marche,Marche,1525271,676691,44.37,0.7
888,2021-01-08,MAR,1576,588,988,1576,0,ITI,ITI3,11,Marche,Marche,1525271,678267,44.47,0.1
889,2021-03-01,MAR,3724,1487,2237,3476,248,ITI,ITI3,11,Marche,Marche,1525271,681991,44.71,0.24
890,2021-05-06,MAR,12655,5820,6835,5582,7073,ITI,ITI3,11,Marche,Marche,1525271,694646,45.54,0.83
891,2021-03-04,MAR,6487,2869,3618,5094,1393,ITI,ITI3,11,Marche,Marche,1525271,701133,45.97,0.43
892,2021-03-13,MAR,5765,2653,3112,1808,3957,ITI,ITI3,11,Marche,Marche,1525271,706898,46.35,0.38
893,2021-01-29,MAR,1991,730,1261,167,1824,ITI,ITI3,11,Marche,Marche,1525271,708889,46.48,0.13
894,2021-04-23,MAR,11159,5140,6019,8104,3055,ITI,ITI3,11,Marche,Marche,1525271,720048,47.21,0.73
895,2021-01-13,MAR,2105,746,1359,2105,0,ITI,ITI3,11,Marche,Marche,1525271,722153,47.35,0.14
896,2021-01-15,MAR,1771,500,1271,1771,0,ITI,ITI3,11,Marche,Marche,1525271,723924,47.46,0.12
897,2021-04-25,MAR,8600,3994,4606,7025,1575,ITI,ITI3,11,Marche,Marche,1525271,732524,48.03,0.56
898,2021-05-02,MAR,8898,3936,4962,3160,5738,ITI,ITI3,11,Marche,Marche,1525271,741422,48.61,0.58
899,2021-03-20,MAR,4135,1740,2395,1049,3086,ITI,ITI3,11,Marche,Marche,1525271,745557,48.88,0.27
900,2021-01-22,MAR,487,167,320,194,293,ITI,ITI3,11,Marche,Marche,1525271,746044,48.91,0.03
901,2021-05-26,MAR,11805,5916,5889,8620,3185,ITI,ITI3,11,Marche,Marche,1525271,757849,49.69,0.77
902,2021-03-30,MAR,7418,3044,4374,4603,2815,ITI,ITI3,11,Marche,Marche,1525271,765267,50.17,0.49
903,2021-02-01,MAR,1362,479,883,98,1264,ITI,ITI3,11,Marche,Marche,1525271,766629,50.26,0.09
904,2021-03-23,MAR,5789,2529,3260,2262,3527,ITI,ITI3,11,Marche,Marche,1525271,772418,50.64,0.38
905,2021-05-19,MAR,11471,5272,6199,8562,2909,ITI,ITI3,11,Marche,Marche,1525271,783889,51.39,0.75
906,2021-02-15,MAR,967,412,555,954,13,ITI,ITI3,11,Marche,Marche,1525271,784856,51.46,0.06
907,2021-04-06,MAR,8879,3693,5186,8066,813,ITI,ITI3,11,Marche,Marche,1525271,793735,52.04,0.58
908,2021-02-08,MAR,833,258,575,371,462,ITI,ITI3,11,Marche,Marche,1525271,794568,52.09,0.05
909,2020-12-27,MAR,200,97,103,200,0,ITI,ITI3,11,Marche,Marche,1525271,794768,52.11,0.01
910,2021-04-11,MAR,7116,3115,4001,6830,286,ITI,ITI3,11,Marche,Marche,1525271,801884,52.57,0.47
911,2021-02-20,MAR,4121,1705,2416,4010,111,ITI,ITI3,11,Marche,Marche,1525271,806005,52.84,0.27
912,2021-03-25,MAR,6656,2772,3884,3247,3409,ITI,ITI3,11,Marche,Marche,1525271,812661,53.28,0.44
913,2021-01-20,MAR,401,100,301,384,17,ITI,ITI3,11,Marche,Marche,1525271,813062,53.31,0.03
914,2021-02-03,MAR,2124,741,1383,119,2005,ITI,ITI3,11,Marche,Marche,1525271,815186,53.45,0.14
915,2021-04-29,MAR,13246,6061,7185,7149,6097,ITI,ITI3,11,Marche,Marche,1525271,828432,54.31,0.87
916,2021-03-15,MAR,4402,2027,2375,1312,3090,ITI,ITI3,11,Marche,Marche,1525271,832834,54.6,0.29
917,2021-04-03,MAR,7573,3204,4369,6903,670,ITI,ITI3,11,Marche,Marche,1525271,840407,55.1,0.5
918,2021-05-25,MAR,11646,5744,5902,8717,2929,ITI,ITI3,11,Marche,Marche,1525271,852053,55.86,0.76
919,2021-05-11,MAR,10622,4832,5790,5678,4944,ITI,ITI3,11,Marche,Marche,1525271,862675,56.56,0.7
920,2021-04-28,MAR,10734,4890,5844,6003,4731,ITI,ITI3,11,Marche,Marche,1525271,873409,57.26,0.7
921,2021-01-18,MAR,673,230,443,547,126,ITI,ITI3,11,Marche,Marche,1525271,874082,57.31,0.04
922,2021-03-09,MAR,5428,2290,3138,4548,880,ITI,ITI3,11,Marche,Marche,1525271,879510,57.66,0.36
923,2021-04-13,MAR,9838,4259,5579,9605,233,ITI,ITI3,11,Marche,Marche,1525271,889348,58.31,0.65
924,2021-02-22,MAR,3413,1499,1914,3338,75,ITI,ITI3,11,Marche,Marche,1525271,892761,58.53,0.22
925,2021-01-03,MAR,897,349,548,897,0,ITI,ITI3,11,Marche,Marche,1525271,893658,58.59,0.06
926,2021-03-08,MAR,6264,2744,3520,5262,1002,ITI,ITI3,11,Marche,Marche,1525271,899922,59.0,0.41
927,2021-04-27,MAR,9400,4309,5091,5413,3987,ITI,ITI3,11,Marche,Marche,1525271,909322,59.62,0.62
928,2021-01-17,MAR,1607,687,920,1550,57,ITI,ITI3,11,Marche,Marche,1525271,910929,59.72,0.11
929,2021-03-04,EMR,16434,5345,11089,13422,3012,ITH,ITH5,8,Emilia-Romagna,Emilia-Romagna,4459477,16434,0.37,0.37
930,2021-05-24,EMR,29578,13492,16086,18369,11209,ITH,ITH5,8,Emilia-Romagna,Emilia-Romagna,4459477,46012,1.03,0.66
931,2021-01-29,EMR,10414,3497,6917,290,10124,ITH,ITH5,8,Emilia-Romagna,Emilia-Romagna,4459477,56426,1.27,0.23
932,2021-02-15,EMR,2903,850,2053,2778,125,ITH,ITH5,8,Emilia-Romagna,Emilia-Romagna,4459477,59329,1.33,0.07
933,2021-01-25,EMR,6456,2145,4311,207,6249,ITH,ITH5,8,Emilia-Romagna,Emilia-Romagna,4459477,65785,1.48,0.14
934,2021-05-12,EMR,38160,17946,20214,28556,9604,ITH,ITH5,8,Emilia-Romagna,Emilia-Romagna,4459477,103945,2.33,0.86
935,2021-03-16,EMR,12241,5026,7215,4933,7308,ITH,ITH5,8,Emilia-Romagna,Emilia-Romagna,4459477,116186,2.61,0.27
936,2021-03-09,EMR,14704,5984,8720,10748,3956,ITH,ITH5,8,Emilia-Romagna,Emilia-Romagna,4459477,130890,2.94,0.33
937,2021-05-23,EMR,25397,11820,13577,13851,11546,ITH,ITH5,8,Emilia-Romagna,Emilia-Romagna,4459477,156287,3.5,0.57
938,2021-02-01,EMR,10320,3610,6710,362,9958,ITH,ITH5,8,Emilia-Romagna,Emilia-Romagna,4459477,166607,3.74,0.23
939,2021-03-23,EMR,18698,8069,10629,12011,6687,ITH,ITH5,8,Emilia-Romagna,Emilia-Romagna,4459477,185305,4.16,0.42
940,2021-01-18,EMR,3127,879,2248,2449,678,ITH,ITH5,8,Emilia-Romagna,Emilia-Romagna,4459477,188432,4.23,0.07
941,2021-05-05,EMR,29367,13656,15711,18130,11237,ITH,ITH5,8,Emilia-Romagna,Emilia-Romagna,4459477,217799,4.88,0.66
942,2021-03-30,EMR,23286,10292,12994,18249,5037,ITH,ITH5,8,Emilia-Romagna,Emilia-Romagna,4459477,241085,5.41,0.52
943,2021-05-19,EMR,33502,14886,18616,18476,15026,ITH,ITH5,8,Emilia-Romagna,Emilia-Romagna,4459477,274587,6.16,0.75
944,2021-01-04,EMR,7310,2526,4784,7310,0,ITH,ITH5,8,Emilia-Romagna,Emilia-Romagna,4459477,281897,6.32,0.16
945,2021-01-03,EMR,2762,943,1819,2762,0,ITH,ITH5,8,Emilia-Romagna,Emilia-Romagna,4459477,284659,6.38,0.06
946,2021-05-16,EMR,25807,12152,13655,18703,7104,ITH,ITH5,8,Emilia-Romagna,Emilia-Romagna,4459477,310466,6.96,0.58
947,2021-03-13,EMR,16077,6308,9769,10763,5314,ITH,ITH5,8,Emilia-Romagna,Emilia-Romagna,4459477,326543,7.32,0.36
948,2021-05-02,EMR,25452,11593,13859,13465,11987,ITH,ITH5,8,Emilia-Romagna,Emilia-Romagna,4459477,351995,7.89,0.57
949,2021-04-11,EMR,15259,6926,8333,12214,3045,ITH,ITH5,8,Emilia-Romagna,Emilia-Romagna,4459477,367254,8.24,0.34
950,2021-02-11,EMR,4250,1416,2834,3410,840,ITH,ITH5,8,Emilia-Romagna,Emilia-Romagna,4459477,371504,8.33,0.1
951,2021-03-08,EMR,12177,5063,7114,9502,2675,ITH,ITH5,8,Emilia-Romagna,Emilia-Romagna,4459477,383681,8.6,0.27
952,2021-04-20,EMR,22593,10392,12201,14242,8351,ITH,ITH5,8,Emilia-Romagna,Emilia-Romagna,4459477,406274,9.11,0.51
953,2021-01-08,EMR,10865,3580,7285,10865,0,ITH,ITH5,8,Emilia-Romagna,Emilia-Romagna,4459477,417139,9.35,0.24
954,2021-01-13,EMR,9074,2940,6134,9074,0,ITH,ITH5,8,Emilia-Romagna,Emilia-Romagna,4459477,426213,9.56,0.2
955,2021-04-23,EMR,29551,13807,15744,14672,14879,ITH,ITH5,8,Emilia-Romagna,Emilia-Romagna,4459477,455764,10.22,0.66
956,2021-01-11,EMR,9349,3273,6076,9349,0,ITH,ITH5,8,Emilia-Romagna,Emilia-Romagna,4459477,465113,10.43,0.21
957,2021-05-07,EMR,35106,16862,18244,23303,11803,ITH,ITH5,8,Emilia-Romagna,Emilia-Romagna,4459477,500219,11.22,0.79
958,2021-02-10,EMR,4019,1383,2636,2764,1255,ITH,ITH5,8,Emilia-Romagna,Emilia-Romagna,4459477,504238,11.31,0.09
959,2021-04-08,EMR,30824,14130,16694,25524,5300,ITH,ITH5,8,Emilia-Romagna,Emilia-Romagna,4459477,535062,12.0,0.69
960,2021-02-17,EMR,6538,2764,3774,5766,772,ITH,ITH5,8,Emilia-Romagna,Emilia-Romagna,4459477,541600,12.14,0.15
961,2021-03-25,EMR,21390,9347,12043,14402,6988,ITH,ITH5,8,Emilia-Romagna,Emilia-Romagna,4459477,562990,12.62,0.48
962,2021-01-06,EMR,8285,2954,5331,8285,0,ITH,ITH5,8,Emilia-Romagna,Emilia-Romagna,4459477,571275,12.81,0.19
963,2021-04-30,EMR,36527,16743,19784,21742,14785,ITH,ITH5,8,Emilia-Romagna,Emilia-Romagna,4459477,607802,13.63,0.82
964,2021-03-11,EMR,17257,7136,10121,11407,5850,ITH,ITH5,8,Emilia-Romagna,Emilia-Romagna,4459477,625059,14.02,0.39
965,2021-04-16,EMR,28857,13565,15292,20023,8834,ITH,ITH5,8,Emilia-Romagna,Emilia-Romagna,4459477,653916,14.66,0.65
966,2021-02-25,EMR,9228,3497,5731,8274,954,ITH,ITH5,8,Emilia-Romagna,Emilia-Romagna,4459477,663144,14.87,0.21
967,2021-04-15,EMR,29017,13807,15210,19347,9670,ITH,ITH5,8,Emilia-Romagna,Emilia-Romagna,4459477,692161,15.52,0.65
968,2021-01-20,EMR,1325,270,1055,1324,1,ITH,ITH5,8,Emilia-Romagna,Emilia-Romagna,4459477,693486,15.55,0.03
969,2021-03-10,EMR,18727,7683,11044,13084,5643,ITH,ITH5,8,Emilia-Romagna,Emilia-Romagna,4459477,712213,15.97,0.42
970,2021-05-26,EMR,32802,14521,18281,10157,22645,ITH,ITH5,8,Emilia-Romagna,Emilia-Romagna,4459477,745015,16.71,0.74
971,2021-02-13,EMR,3627,1085,2542,3029,598,ITH,ITH5,8,Emilia-Romagna,Emilia-Romagna,4459477,748642,16.79,0.08
972,2021-05-09,EMR,25488,12190,13298,18525,6963,ITH,ITH5,8,Emilia-Romagna,Emilia-Romagna,4459477,774130,17.36,0.57
973,2021-01-27,EMR,8362,2947,5415,463,7899,ITH,ITH5,8,Emilia-Romagna,Emilia-Romagna,4459477,782492,17.55,0.19
974,2021-02-20,EMR,5317,2094,3223,5054,263,ITH,ITH5,8,Emilia-Romagna,Emilia-Romagna,4459477,787809,17.67,0.12
975,2021-05-31,EMR,28930,13268,15662,17920,11010,ITH,ITH5,8,Emilia-Romagna,Emilia-Romagna,4459477,816739,18.31,0.65
976,2021-03-01,EMR,10092,3578,6514,7836,2256,ITH,ITH5,8,Emilia-Romagna,Emilia-Romagna,4459477,826831,18.54,0.23
977,2021-05-04,EMR,28568,13380,15188,14915,13653,ITH,ITH5,8,Emilia-Romagna,Emilia-Romagna,4459477,855399,19.18,0.64
978,2021-04-27,EMR,32043,14829,17214,19582,12461,ITH,ITH5,8,Emilia-Romagna,Emilia-Romagna,4459477,887442,19.9,0.72
979,2021-01-15,EMR,7746,2403,5343,7746,0,ITH,ITH5,8,Emilia-Romagna,Emilia-Romagna,4459477,895188,20.07,0.17
980,2021-02-27,EMR,10967,3999,6968,9229,1738,ITH,ITH5,8,Emilia-Romagna,Emilia-Romagna,4459477,906155,20.32,0.25
981,2021-04-25,EMR,22324,10222,12102,14816,7508,ITH,ITH5,8,Emilia-Romagna,Emilia-Romagna,4459477,928479,20.82,0.5
982,2021-03-27,EMR,21600,9045,12555,14695,6905,ITH,ITH5,8,Emilia-Romagna,Emilia-Romagna,4459477,950079,21.3,0.48
983,2021-01-22,EMR,1829,477,1352,1088,741,ITH,ITH5,8,Emilia-Romagna,Emilia-Romagna,4459477,951908,21.35,0.04
984,2021-04-13,EMR,23644,11086,12558,19343,4301,ITH,ITH5,8,Emilia-Romagna,Emilia-Romagna,4459477,975552,21.88,0.53
985,2021-02-08,EMR,5227,1532,3695,2315,2912,ITH,ITH5,8,Emilia-Romagna,Emilia-Romagna,4459477,980779,21.99,0.12
986,2021-02-22,EMR,7481,3091,4390,7209,272,ITH,ITH5,8,Emilia-Romagna,Emilia-Romagna,4459477,988260,22.16,0.17
987,2021-01-30,EMR,10077,3519,6558,141,9936,ITH,ITH5,8,Emilia-Romagna,Emilia-Romagna,4459477,998337,22.39,0.23
988,2021-04-04,EMR,9885,4718,5167,7616,2269,ITH,ITH5,8,Emilia-Romagna,Emilia-Romagna,4459477,1008222,22.61,0.22
989,2021-03-20,EMR,16086,6831,9255,9122,6964,ITH,ITH5,8,Emilia-Romagna,Emilia-Romagna,4459477,1024308,22.97,0.36
990,2020-12-27,EMR,970,372,598,970,0,ITH,ITH5,8,Emilia-Romagna,Emilia-Romagna,4459477,1025278,22.99,0.02
991,2021-04-06,EMR,24620,11113,13507,19883,4737,ITH,ITH5,8,Emilia-Romagna,Emilia-Romagna,4459477,1049898,23.54,0.55
992,2021-05-28,EMR,40528,18614,21914,17764,22764,ITH,ITH5,8,Emilia-Romagna,Emilia-Romagna,4459477,1090426,24.45,0.91
993,2021-01-12,EMR,9475,3124,6351,9475,0,ITH,ITH5,8,Emilia-Romagna,Emilia-Romagna,4459477,1099901,24.66,0.21
994,2021-04-24,EMR,28573,13213,15360,14360,14213,ITH,ITH5,8,Emilia-Romagna,Emilia-Romagna,4459477,1128474,25.31,0.64
995,2021-05-11,EMR,35223,16516,18707,27968,7255,ITH,ITH5,8,Emilia-Romagna,Emilia-Romagna,4459477,1163697,26.09,0.79
996,2021-03-21,EMR,11920,5273,6647,7316,4604,ITH,ITH5,8,Emilia-Romagna,Emilia-Romagna,4459477,1175617,26.36,0.27
997,2021-04-18,EMR,17494,8392,9102,12568,4926,ITH,ITH5,8,Emilia-Romagna,Emilia-Romagna,4459477,1193111,26.75,0.39
998,2021-01-10,EMR,7168,2683,4485,7168,0,ITH,ITH5,8,Emilia-Romagna,Emilia-Romagna,4459477,1200279,26.92,0.16
999,2021-03-06,EMR,20636,5884,14752,17906,2730,ITH,ITH5,8,Emilia-Romagna,Emilia-Romagna,4459477,1220915,27.38,0.46
1000,2021-01-23,EMR,2447,870,1577,443,2004,ITH,ITH5,8,Emilia-Romagna,Emilia-Romagna,4459477,1223362,27.43,0.05
1001,2021-02-18,EMR,7039,2892,4147,6456,583,ITH,ITH5,8,Emilia-Romagna,Emilia-Romagna,4459477,1230401,27.59,0.16
1002,2021-01-07,EMR,10271,3406,6865,10271,0,ITH,ITH5,8,Emilia-Romagna,Emilia-Romagna,4459477,1240672,27.82,0.23
1003,2021-02-19,EMR,7327,3010,4317,6813,514,ITH,ITH5,8,Emilia-Romagna,Emilia-Romagna,4459477,1247999,27.99,0.16
1004,2020-12-31,EMR,2213,779,1434,2213,0,ITH,ITH5,8,Emilia-Romagna,Emilia-Romagna,4459477,1250212,28.03,0.05
1005,2021-04-03,EMR,19936,8766,11170,16196,3740,ITH,ITH5,8,Emilia-Romagna,Emilia-Romagna,4459477,1270148,28.48,0.45
1006,2021-04-28,EMR,33659,15550,18109,20773,12886,ITH,ITH5,8,Emilia-Romagna,Emilia-Romagna,4459477,1303807,29.24,0.75
1007,2021-05-20,EMR,39816,18124,21692,18742,21074,ITH,ITH5,8,Emilia-Romagna,Emilia-Romagna,4459477,1343623,30.13,0.89
1008,2021-03-17,EMR,13720,5693,8027,5875,7845,ITH,ITH5,8,Emilia-Romagna,Emilia-Romagna,4459477,1357343,30.44,0.31
1009,2021-05-15,EMR,33134,14949,18185,22781,10353,ITH,ITH5,8,Emilia-Romagna,Emilia-Romagna,4459477,1390477,31.18,0.74
1010,2021-02-02,EMR,9484,3053,6431,527,8957,ITH,ITH5,8,Emilia-Romagna,Emilia-Romagna,4459477,1399961,31.39,0.21
1011,2021-02-26,EMR,7866,2996,4870,6821,1045,ITH,ITH5,8,Emilia-Romagna,Emilia-Romagna,4459477,1407827,31.57,0.18
1012,2021-02-12,EMR,5321,1679,3642,3918,1403,ITH,ITH5,8,Emilia-Romagna,Emilia-Romagna,4459477,1413148,31.69,0.12
1013,2021-04-10,EMR,20906,9291,11615,16763,4143,ITH,ITH5,8,Emilia-Romagna,Emilia-Romagna,4459477,1434054,32.16,0.47
1014,2021-04-17,EMR,27027,12931,14096,17731,9296,ITH,ITH5,8,Emilia-Romagna,Emilia-Romagna,4459477,1461081,32.76,0.61
1015,2021-05-30,EMR,26783,12643,14140,13227,13556,ITH,ITH5,8,Emilia-Romagna,Emilia-Romagna,4459477,1487864,33.36,0.6
1016,2021-03-05,EMR,17684,5752,11932,14234,3450,ITH,ITH5,8,Emilia-Romagna,Emilia-Romagna,4459477,1505548,33.76,0.4
1017,2021-03-03,EMR,15829,5250,10579,13353,2476,ITH,ITH5,8,Emilia-Romagna,Emilia-Romagna,4459477,1521377,34.12,0.35
1018,2021-02-16,EMR,5768,2444,3324,5237,531,ITH,ITH5,8,Emilia-Romagna,Emilia-Romagna,4459477,1527145,34.24,0.13
1019,2021-04-21,EMR,23919,10952,12967,14184,9735,ITH,ITH5,8,Emilia-Romagna,Emilia-Romagna,4459477,1551064,34.78,0.54
1020,2021-01-28,EMR,10250,3339,6911,349,9901,ITH,ITH5,8,Emilia-Romagna,Emilia-Romagna,4459477,1561314,35.01,0.23
1021,2021-05-27,EMR,36414,15969,20445,8713,27701,ITH,ITH5,8,Emilia-Romagna,Emilia-Romagna,4459477,1597728,35.83,0.82
1022,2021-05-08,EMR,31664,14822,16842,20253,11411,ITH,ITH5,8,Emilia-Romagna,Emilia-Romagna,4459477,1629392,36.54,0.71
1023,2021-02-23,EMR,8215,3219,4996,7829,386,ITH,ITH5,8,Emilia-Romagna,Emilia-Romagna,4459477,1637607,36.72,0.18
1024,2021-01-21,EMR,2164,729,1435,819,1345,ITH,ITH5,8,Emilia-Romagna,Emilia-Romagna,4459477,1639771,36.77,0.05
1025,2021-01-19,EMR,2045,505,1540,2028,17,ITH,ITH5,8,Emilia-Romagna,Emilia-Romagna,4459477,1641816,36.82,0.05
1026,2021-02-24,EMR,9327,3558,5769,8443,884,ITH,ITH5,8,Emilia-Romagna,Emilia-Romagna,4459477,1651143,37.03,0.21
1027,2021-01-05,EMR,9362,3170,6192,9362,0,ITH,ITH5,8,Emilia-Romagna,Emilia-Romagna,4459477,1660505,37.24,0.21
1028,2021-04-29,EMR,44897,21106,23791,27355,17542,ITH,ITH5,8,Emilia-Romagna,Emilia-Romagna,4459477,1705402,38.24,1.01
1029,2021-05-21,EMR,37696,16816,20880,20944,16752,ITH,ITH5,8,Emilia-Romagna,Emilia-Romagna,4459477,1743098,39.09,0.85
1030,2021-03-18,EMR,13673,5806,7867,5673,8000,ITH,ITH5,8,Emilia-Romagna,Emilia-Romagna,4459477,1756771,39.39,0.31
1031,2021-05-14,EMR,36987,17038,19949,27425,9562,ITH,ITH5,8,Emilia-Romagna,Emilia-Romagna,4459477,1793758,40.22,0.83
1032,2021-02-03,EMR,9355,2995,6360,984,8371,ITH,ITH5,8,Emilia-Romagna,Emilia-Romagna,4459477,1803113,40.43,0.21
1033,2021-04-01,EMR,23880,10732,13148,19339,4541,ITH,ITH5,8,Emilia-Romagna,Emilia-Romagna,4459477,1826993,40.97,0.54
1034,2021-01-24,EMR,2443,885,1558,298,2145,ITH,ITH5,8,Emilia-Romagna,Emilia-Romagna,4459477,1829436,41.02,0.05
1035,2021-01-17,EMR,2890,887,2003,2644,246,ITH,ITH5,8,Emilia-Romagna,Emilia-Romagna,4459477,1832326,41.09,0.06
1036,2021-04-05,EMR,14860,6809,8051,11969,2891,ITH,ITH5,8,Emilia-Romagna,Emilia-Romagna,4459477,1847186,41.42,0.33
1037,2021-01-31,EMR,7696,2762,4934,241,7455,ITH,ITH5,8,Emilia-Romagna,Emilia-Romagna,4459477,1854882,41.59,0.17
1038,2021-04-22,EMR,29026,13433,15593,14952,14074,ITH,ITH5,8,Emilia-Romagna,Emilia-Romagna,4459477,1883908,42.25,0.65
1039,2021-03-02,EMR,11859,3906,7953,9830,2029,ITH,ITH5,8,Emilia-Romagna,Emilia-Romagna,4459477,1895767,42.51,0.27
1040,2021-03-19,EMR,15843,6915,8928,7876,7967,ITH,ITH5,8,Emilia-Romagna,Emilia-Romagna,4459477,1911610,42.87,0.36
1041,2021-02-14,EMR,1401,378,1023,1281,120,ITH,ITH5,8,Emilia-Romagna,Emilia-Romagna,4459477,1913011,42.9,0.03
1042,2021-03-22,EMR,17464,7652,9812,10599,6865,ITH,ITH5,8,Emilia-Romagna,Emilia-Romagna,4459477,1930475,43.29,0.39
1043,2021-05-25,EMR,24763,11042,13721,11580,13183,ITH,ITH5,8,Emilia-Romagna,Emilia-Romagna,4459477,1955238,43.84,0.56
1044,2021-05-10,EMR,33586,15993,17593,26358,7228,ITH,ITH5,8,Emilia-Romagna,Emilia-Romagna,4459477,1988824,44.6,0.75
1045,2021-05-13,EMR,35505,16347,19158,27740,7765,ITH,ITH5,8,Emilia-Romagna,Emilia-Romagna,4459477,2024329,45.39,0.8
1046,2021-03-15,EMR,13268,6091,7177,6769,6499,ITH,ITH5,8,Emilia-Romagna,Emilia-Romagna,4459477,2037597,45.69,0.3
1047,2021-02-04,EMR,9938,3207,6731,1250,8688,ITH,ITH5,8,Emilia-Romagna,Emilia-Romagna,4459477,2047535,45.91,0.22
1048,2021-05-22,EMR,32818,14070,18748,16852,15966,ITH,ITH5,8,Emilia-Romagna,Emilia-Romagna,4459477,2080353,46.65,0.74
1049,2021-04-09,EMR,25505,11567,13938,19814,5691,ITH,ITH5,8,Emilia-Romagna,Emilia-Romagna,4459477,2105858,47.22,0.57
1050,2021-02-09,EMR,4153,1248,2905,2307,1846,ITH,ITH5,8,Emilia-Romagna,Emilia-Romagna,4459477,2110011,47.32,0.09
1051,2021-01-26,EMR,8334,3000,5334,215,8119,ITH,ITH5,8,Emilia-Romagna,Emilia-Romagna,4459477,2118345,47.5,0.19
1052,2021-03-24,EMR,21076,9301,11775,13694,7382,ITH,ITH5,8,Emilia-Romagna,Emilia-Romagna,4459477,2139421,47.97,0.47
1053,2021-05-06,EMR,35455,16384,19071,22414,13041,ITH,ITH5,8,Emilia-Romagna,Emilia-Romagna,4459477,2174876,48.77,0.8
1054,2021-04-02,EMR,23304,10493,12811,18842,4462,ITH,ITH5,8,Emilia-Romagna,Emilia-Romagna,4459477,2198180,49.29,0.52
1055,2021-05-29,EMR,37035,16177,20858,16723,20312,ITH,ITH5,8,Emilia-Romagna,Emilia-Romagna,4459477,2235215,50.12,0.83
1056,2021-06-01,EMR,7197,3469,3728,4350,2847,ITH,ITH5,8,Emilia-Romagna,Emilia-Romagna,4459477,2242412,50.28,0.16
1057,2021-04-12,EMR,19217,8993,10224,14775,4442,ITH,ITH5,8,Emilia-Romagna,Emilia-Romagna,4459477,2261629,50.72,0.43
1058,2021-01-09,EMR,9984,3450,6534,9984,0,ITH,ITH5,8,Emilia-Romagna,Emilia-Romagna,4459477,2271613,50.94,0.22
1059,2021-03-07,EMR,6861,2640,4221,5344,1517,ITH,ITH5,8,Emilia-Romagna,Emilia-Romagna,4459477,2278474,51.09,0.15
1060,2021-05-03,EMR,28450,13444,15006,17574,10876,ITH,ITH5,8,Emilia-Romagna,Emilia-Romagna,4459477,2306924,51.73,0.64
1061,2021-01-16,EMR,5626,1718,3908,5626,0,ITH,ITH5,8,Emilia-Romagna,Emilia-Romagna,4459477,2312550,51.86,0.13
1062,2021-03-14,EMR,8696,3744,4952,4899,3797,ITH,ITH5,8,Emilia-Romagna,Emilia-Romagna,4459477,2321246,52.05,0.2
1063,2021-04-19,EMR,20882,9788,11094,14610,6272,ITH,ITH5,8,Emilia-Romagna,Emilia-Romagna,4459477,2342128,52.52,0.47
1064,2021-04-07,EMR,25804,11735,14069,19793,6011,ITH,ITH5,8,Emilia-Romagna,Emilia-Romagna,4459477,2367932,53.1,0.58
1065,2021-05-01,EMR,28380,12764,15616,15611,12769,ITH,ITH5,8,Emilia-Romagna,Emilia-Romagna,4459477,2396312,53.74,0.64
1066,2021-02-05,EMR,9316,2966,6350,1637,7679,ITH,ITH5,8,Emilia-Romagna,Emilia-Romagna,4459477,2405628,53.94,0.21
1067,2021-04-14,EMR,27006,12825,14181,20902,6104,ITH,ITH5,8,Emilia-Romagna,Emilia-Romagna,4459477,2432634,54.55,0.61
1068,2021-01-14,EMR,8128,2593,5535,8128,0,ITH,ITH5,8,Emilia-Romagna,Emilia-Romagna,4459477,2440762,54.73,0.18
1069,2021-03-12,EMR,18116,7552,10564,11399,6717,ITH,ITH5,8,Emilia-Romagna,Emilia-Romagna,4459477,2458878,55.14,0.41
1070,2021-02-28,EMR,6823,2527,4296,4977,1846,ITH,ITH5,8,Emilia-Romagna,Emilia-Romagna,4459477,2465701,55.29,0.15
1071,2021-04-26,EMR,27856,12912,14944,18550,9306,ITH,ITH5,8,Emilia-Romagna,Emilia-Romagna,4459477,2493557,55.92,0.62
1072,2021-03-26,EMR,23414,9899,13515,16980,6434,ITH,ITH5,8,Emilia-Romagna,Emilia-Romagna,4459477,2516971,56.44,0.53
1073,2021-03-31,EMR,25131,10949,14182,19675,5456,ITH,ITH5,8,Emilia-Romagna,Emilia-Romagna,4459477,2542102,57.0,0.56
1074,2021-03-28,EMR,13456,6001,7455,9592,3864,ITH,ITH5,8,Emilia-Romagna,Emilia-Romagna,4459477,2555558,57.31,0.3
1075,2021-02-06,EMR,7600,2406,5194,2131,5469,ITH,ITH5,8,Emilia-Romagna,Emilia-Romagna,4459477,2563158,57.48,0.17
1076,2021-02-07,EMR,4793,1537,3256,1732,3061,ITH,ITH5,8,Emilia-Romagna,Emilia-Romagna,4459477,2567951,57.58,0.11
1077,2021-03-29,EMR,21200,9442,11758,16549,4651,ITH,ITH5,8,Emilia-Romagna,Emilia-Romagna,4459477,2589151,58.06,0.48
1078,2021-05-18,EMR,28974,13205,15769,18516,10458,ITH,ITH5,8,Emilia-Romagna,Emilia-Romagna,4459477,2618125,58.71,0.65
1079,2021-05-17,EMR,32297,15367,16930,22860,9437,ITH,ITH5,8,Emilia-Romagna,Emilia-Romagna,4459477,2650422,59.43,0.72
1080,2021-02-21,EMR,4450,1708,2742,4010,440,ITH,ITH5,8,Emilia-Romagna,Emilia-Romagna,4459477,2654872,59.53,0.1
1081,2021-01-02,EMR,2372,913,1459,2372,0,ITH,ITH5,8,Emilia-Romagna,Emilia-Romagna,4459477,2657244,59.59,0.05
1082,2021-02-24,ABR,3305,1441,1864,3129,176,ITF,ITF1,13,Abruzzo,Abruzzo,1304970,3305,0.25,0.25
1083,2021-05-16,ABR,9581,4140,5441,5765,3816,ITF,ITF1,13,Abruzzo,Abruzzo,1304970,12886,0.99,0.73
1084,2021-01-21,ABR,157,47,110,157,0,ITF,ITF1,13,Abruzzo,Abruzzo,1304970,13043,1.0,0.01
1085,2021-02-07,ABR,777,307,470,201,576,ITF,ITF1,13,Abruzzo,Abruzzo,1304970,13820,1.06,0.06
1086,2021-05-20,ABR,12548,5786,6762,7330,5218,ITF,ITF1,13,Abruzzo,Abruzzo,1304970,26368,2.02,0.96
1087,2021-02-03,ABR,2061,717,1344,419,1642,ITF,ITF1,13,Abruzzo,Abruzzo,1304970,28429,2.18,0.16
1088,2021-02-28,ABR,1704,510,1194,1702,2,ITF,ITF1,13,Abruzzo,Abruzzo,1304970,30133,2.31,0.13
1089,2021-06-01,ABR,3442,1590,1852,2383,1059,ITF,ITF1,13,Abruzzo,Abruzzo,1304970,33575,2.57,0.26
1090,2021-04-12,ABR,6223,2949,3274,5049,1174,ITF,ITF1,13,Abruzzo,Abruzzo,1304970,39798,3.05,0.48
1091,2021-02-10,ABR,947,312,635,503,444,ITF,ITF1,13,Abruzzo,Abruzzo,1304970,40745,3.12,0.07
1092,2021-01-02,ABR,548,218,330,548,0,ITF,ITF1,13,Abruzzo,Abruzzo,1304970,41293,3.16,0.04
1093,2021-04-26,ABR,8563,4066,4497,7349,1214,ITF,ITF1,13,Abruzzo,Abruzzo,1304970,49856,3.82,0.66
1094,2021-04-19,ABR,6225,2856,3369,3854,2371,ITF,ITF1,13,Abruzzo,Abruzzo,1304970,56081,4.3,0.48
1095,2021-02-21,ABR,1218,550,668,1217,1,ITF,ITF1,13,Abruzzo,Abruzzo,1304970,57299,4.39,0.09
1096,2021-03-22,ABR,4281,1852,2429,2311,1970,ITF,ITF1,13,Abruzzo,Abruzzo,1304970,61580,4.72,0.33
1097,2021-05-11,ABR,10737,5097,5640,5909,4828,ITF,ITF1,13,Abruzzo,Abruzzo,1304970,72317,5.54,0.82
1098,2021-04-08,ABR,7367,3329,4038,5065,2302,ITF,ITF1,13,Abruzzo,Abruzzo,1304970,79684,6.11,0.56
1099,2021-01-12,ABR,1804,666,1138,1804,0,ITF,ITF1,13,Abruzzo,Abruzzo,1304970,81488,6.24,0.14
1100,2021-04-29,ABR,12669,5850,6819,9574,3095,ITF,ITF1,13,Abruzzo,Abruzzo,1304970,94157,7.22,0.97
1101,2021-01-17,ABR,187,59,128,180,7,ITF,ITF1,13,Abruzzo,Abruzzo,1304970,94344,7.23,0.01
1102,2021-03-17,ABR,4539,1873,2666,2799,1740,ITF,ITF1,13,Abruzzo,Abruzzo,1304970,98883,7.58,0.35
1103,2021-01-22,ABR,118,57,61,118,0,ITF,ITF1,13,Abruzzo,Abruzzo,1304970,99001,7.59,0.01
1104,2021-03-27,ABR,6121,2620,3501,3636,2485,ITF,ITF1,13,Abruzzo,Abruzzo,1304970,105122,8.06,0.47
1105,2021-03-12,ABR,6016,1986,4030,4434,1582,ITF,ITF1,13,Abruzzo,Abruzzo,1304970,111138,8.52,0.46
1106,2021-05-30,ABR,8563,4067,4496,5349,3214,ITF,ITF1,13,Abruzzo,Abruzzo,1304970,119701,9.17,0.66
1107,2021-04-03,ABR,5085,2221,2864,3489,1596,ITF,ITF1,13,Abruzzo,Abruzzo,1304970,124786,9.56,0.39
1108,2021-02-12,ABR,1228,567,661,1039,189,ITF,ITF1,13,Abruzzo,Abruzzo,1304970,126014,9.66,0.09
1109,2021-04-10,ABR,8772,4057,4715,6264,2508,ITF,ITF1,13,Abruzzo,Abruzzo,1304970,134786,10.33,0.67
1110,2021-05-23,ABR,9886,4701,5185,7191,2695,ITF,ITF1,13,Abruzzo,Abruzzo,1304970,144672,11.09,0.76
1111,2021-01-07,ABR,1603,552,1051,1603,0,ITF,ITF1,13,Abruzzo,Abruzzo,1304970,146275,11.21,0.12
1112,2021-04-17,ABR,7346,3398,3948,4293,3053,ITF,ITF1,13,Abruzzo,Abruzzo,1304970,153621,11.77,0.56
1113,2021-02-19,ABR,3300,1551,1749,3200,100,ITF,ITF1,13,Abruzzo,Abruzzo,1304970,156921,12.02,0.25
1114,2021-03-20,ABR,4787,2197,2590,2618,2169,ITF,ITF1,13,Abruzzo,Abruzzo,1304970,161708,12.39,0.37
1115,2021-01-29,ABR,1387,449,938,74,1313,ITF,ITF1,13,Abruzzo,Abruzzo,1304970,163095,12.5,0.11
1116,2021-03-19,ABR,5794,2584,3210,2774,3020,ITF,ITF1,13,Abruzzo,Abruzzo,1304970,168889,12.94,0.44
1117,2021-05-08,ABR,10303,4877,5426,6468,3835,ITF,ITF1,13,Abruzzo,Abruzzo,1304970,179192,13.73,0.79
1118,2021-01-14,ABR,530,189,341,530,0,ITF,ITF1,13,Abruzzo,Abruzzo,1304970,179722,13.77,0.04
1119,2021-03-05,ABR,5345,1956,3389,4648,697,ITF,ITF1,13,Abruzzo,Abruzzo,1304970,185067,14.18,0.41
1120,2021-04-24,ABR,8710,3970,4740,7179,1531,ITF,ITF1,13,Abruzzo,Abruzzo,1304970,193777,14.85,0.67
1121,2021-02-05,ABR,1534,521,1013,788,746,ITF,ITF1,13,Abruzzo,Abruzzo,1304970,195311,14.97,0.12
1122,2021-05-18,ABR,12120,5663,6457,7737,4383,ITF,ITF1,13,Abruzzo,Abruzzo,1304970,207431,15.9,0.93
1123,2021-02-22,ABR,2643,1173,1470,2613,30,ITF,ITF1,13,Abruzzo,Abruzzo,1304970,210074,16.1,0.2
1124,2021-01-19,ABR,111,55,56,91,20,ITF,ITF1,13,Abruzzo,Abruzzo,1304970,210185,16.11,0.01
1125,2021-05-01,ABR,10746,5053,5693,5772,4974,ITF,ITF1,13,Abruzzo,Abruzzo,1304970,220931,16.93,0.82
1126,2021-01-24,ABR,50,22,28,6,44,ITF,ITF1,13,Abruzzo,Abruzzo,1304970,220981,16.93,0.0
1127,2021-05-04,ABR,10698,5033,5665,7081,3617,ITF,ITF1,13,Abruzzo,Abruzzo,1304970,231679,17.75,0.82
1128,2021-03-08,ABR,5122,1666,3456,4150,972,ITF,ITF1,13,Abruzzo,Abruzzo,1304970,236801,18.15,0.39
1129,2021-03-01,ABR,3477,1384,2093,2725,752,ITF,ITF1,13,Abruzzo,Abruzzo,1304970,240278,18.41,0.27
1130,2021-02-02,ABR,1778,672,1106,222,1556,ITF,ITF1,13,Abruzzo,Abruzzo,1304970,242056,18.55,0.14
1131,2021-03-31,ABR,6649,2880,3769,4581,2068,ITF,ITF1,13,Abruzzo,Abruzzo,1304970,248705,19.06,0.51
1132,2021-05-13,ABR,11149,5042,6107,7188,3961,ITF,ITF1,13,Abruzzo,Abruzzo,1304970,259854,19.91,0.85
1133,2021-03-10,ABR,4951,1642,3309,3996,955,ITF,ITF1,13,Abruzzo,Abruzzo,1304970,264805,20.29,0.38
1134,2021-01-26,ABR,1542,567,975,30,1512,ITF,ITF1,13,Abruzzo,Abruzzo,1304970,266347,20.41,0.12
1135,2021-05-06,ABR,13046,6106,6940,7999,5047,ITF,ITF1,13,Abruzzo,Abruzzo,1304970,279393,21.41,1.0
1136,2021-03-03,ABR,4621,1879,2742,3715,906,ITF,ITF1,13,Abruzzo,Abruzzo,1304970,284014,21.76,0.35
1137,2021-04-22,ABR,6662,3193,3469,4981,1681,ITF,ITF1,13,Abruzzo,Abruzzo,1304970,290676,22.27,0.51
1138,2021-02-17,ABR,2071,948,1123,1789,282,ITF,ITF1,13,Abruzzo,Abruzzo,1304970,292747,22.43,0.16
1139,2021-04-05,ABR,2693,1147,1546,1813,880,ITF,ITF1,13,Abruzzo,Abruzzo,1304970,295440,22.64,0.21
1140,2021-01-31,ABR,1501,487,1014,286,1215,ITF,ITF1,13,Abruzzo,Abruzzo,1304970,296941,22.75,0.12
1141,2021-01-05,ABR,1614,604,1010,1614,0,ITF,ITF1,13,Abruzzo,Abruzzo,1304970,298555,22.88,0.12
1142,2021-01-03,ABR,471,185,286,471,0,ITF,ITF1,13,Abruzzo,Abruzzo,1304970,299026,22.91,0.04
1143,2021-04-15,ABR,7807,3669,4138,5967,1840,ITF,ITF1,13,Abruzzo,Abruzzo,1304970,306833,23.51,0.6
1144,2021-03-29,ABR,5624,2524,3100,2985,2639,ITF,ITF1,13,Abruzzo,Abruzzo,1304970,312457,23.94,0.43
1145,2021-01-04,ABR,1401,575,826,1401,0,ITF,ITF1,13,Abruzzo,Abruzzo,1304970,313858,24.05,0.11
1146,2021-04-16,ABR,7535,3488,4047,5618,1917,ITF,ITF1,13,Abruzzo,Abruzzo,1304970,321393,24.63,0.58
1147,2021-05-03,ABR,11110,5241,5869,7260,3850,ITF,ITF1,13,Abruzzo,Abruzzo,1304970,332503,25.48,0.85
1148,2021-03-13,ABR,4126,1420,2706,3083,1043,ITF,ITF1,13,Abruzzo,Abruzzo,1304970,336629,25.8,0.32
1149,2021-03-15,ABR,3627,1392,2235,1819,1808,ITF,ITF1,13,Abruzzo,Abruzzo,1304970,340256,26.07,0.28
1150,2021-01-10,ABR,1139,409,730,1139,0,ITF,ITF1,13,Abruzzo,Abruzzo,1304970,341395,26.16,0.09
1151,2021-01-15,ABR,379,149,230,379,0,ITF,ITF1,13,Abruzzo,Abruzzo,1304970,341774,26.19,0.03
1152,2021-04-27,ABR,9086,4371,4715,6618,2468,ITF,ITF1,13,Abruzzo,Abruzzo,1304970,350860,26.89,0.7
1153,2021-02-09,ABR,908,311,597,499,409,ITF,ITF1,13,Abruzzo,Abruzzo,1304970,351768,26.96,0.07
1154,2021-03-24,ABR,6386,2785,3601,4134,2252,ITF,ITF1,13,Abruzzo,Abruzzo,1304970,358154,27.45,0.49
1155,2021-05-15,ABR,11421,5174,6247,6126,5295,ITF,ITF1,13,Abruzzo,Abruzzo,1304970,369575,28.32,0.88
1156,2021-01-16,ABR,928,428,500,928,0,ITF,ITF1,13,Abruzzo,Abruzzo,1304970,370503,28.39,0.07
1157,2021-01-09,ABR,1483,565,918,1483,0,ITF,ITF1,13,Abruzzo,Abruzzo,1304970,371986,28.51,0.11
1158,2021-03-25,ABR,5686,2561,3125,3070,2616,ITF,ITF1,13,Abruzzo,Abruzzo,1304970,377672,28.94,0.44
1159,2021-05-21,ABR,13004,6328,6676,8028,4976,ITF,ITF1,13,Abruzzo,Abruzzo,1304970,390676,29.94,1.0
1160,2021-03-18,ABR,3896,1651,2245,2065,1831,ITF,ITF1,13,Abruzzo,Abruzzo,1304970,394572,30.24,0.3
1161,2021-05-07,ABR,12191,5700,6491,7762,4429,ITF,ITF1,13,Abruzzo,Abruzzo,1304970,406763,31.17,0.93
1162,2021-02-11,ABR,816,262,554,773,43,ITF,ITF1,13,Abruzzo,Abruzzo,1304970,407579,31.23,0.06
1163,2021-05-24,ABR,12184,5787,6397,8878,3306,ITF,ITF1,13,Abruzzo,Abruzzo,1304970,419763,32.17,0.93
1164,2021-05-29,ABR,10180,4412,5768,4544,5636,ITF,ITF1,13,Abruzzo,Abruzzo,1304970,429943,32.95,0.78
1165,2021-03-26,ABR,5305,2263,3042,3231,2074,ITF,ITF1,13,Abruzzo,Abruzzo,1304970,435248,33.35,0.41
1166,2021-04-20,ABR,5589,2689,2900,4179,1410,ITF,ITF1,13,Abruzzo,Abruzzo,1304970,440837,33.78,0.43
1167,2021-04-25,ABR,9067,4621,4446,8257,810,ITF,ITF1,13,Abruzzo,Abruzzo,1304970,449904,34.48,0.69
1168,2021-01-08,ABR,1525,507,1018,1525,0,ITF,ITF1,13,Abruzzo,Abruzzo,1304970,451429,34.59,0.12
1169,2021-03-07,ABR,2520,629,1891,2520,0,ITF,ITF1,13,Abruzzo,Abruzzo,1304970,453949,34.79,0.19
1170,2021-01-27,ABR,1364,515,849,39,1325,ITF,ITF1,13,Abruzzo,Abruzzo,1304970,455313,34.89,0.1
1171,2021-05-14,ABR,10601,5076,5525,5443,5158,ITF,ITF1,13,Abruzzo,Abruzzo,1304970,465914,35.7,0.81
1172,2021-04-01,ABR,5521,2442,3079,3434,2087,ITF,ITF1,13,Abruzzo,Abruzzo,1304970,471435,36.13,0.42
1173,2021-02-25,ABR,3042,1330,1712,2514,528,ITF,ITF1,13,Abruzzo,Abruzzo,1304970,474477,36.36,0.23
1174,2021-02-06,ABR,1610,742,868,602,1008,ITF,ITF1,13,Abruzzo,Abruzzo,1304970,476087,36.48,0.12
1175,2021-03-14,ABR,1883,731,1152,1216,667,ITF,ITF1,13,Abruzzo,Abruzzo,1304970,477970,36.63,0.14
1176,2021-05-17,ABR,11025,5039,5986,6166,4859,ITF,ITF1,13,Abruzzo,Abruzzo,1304970,488995,37.47,0.84
1177,2021-01-20,ABR,447,156,291,445,2,ITF,ITF1,13,Abruzzo,Abruzzo,1304970,489442,37.51,0.03
1178,2021-05-02,ABR,10423,5087,5336,5213,5210,ITF,ITF1,13,Abruzzo,Abruzzo,1304970,499865,38.3,0.8
1179,2021-04-30,ABR,12392,5803,6589,6702,5690,ITF,ITF1,13,Abruzzo,Abruzzo,1304970,512257,39.25,0.95
1180,2021-05-25,ABR,11213,5195,6018,8091,3122,ITF,ITF1,13,Abruzzo,Abruzzo,1304970,523470,40.11,0.86
1181,2021-01-30,ABR,1510,567,943,69,1441,ITF,ITF1,13,Abruzzo,Abruzzo,1304970,524980,40.23,0.12
1182,2021-03-21,ABR,2134,913,1221,843,1291,ITF,ITF1,13,Abruzzo,Abruzzo,1304970,527114,40.39,0.16
1183,2021-05-28,ABR,13970,6279,7691,7617,6353,ITF,ITF1,13,Abruzzo,Abruzzo,1304970,541084,41.46,1.07
1184,2021-01-13,ABR,1253,440,813,1253,0,ITF,ITF1,13,Abruzzo,Abruzzo,1304970,542337,41.56,0.1
1185,2021-01-28,ABR,1433,495,938,12,1421,ITF,ITF1,13,Abruzzo,Abruzzo,1304970,543770,41.67,0.11
1186,2021-05-09,ABR,9152,4089,5063,4282,4870,ITF,ITF1,13,Abruzzo,Abruzzo,1304970,552922,42.37,0.7
1187,2021-02-26,ABR,3914,1670,2244,2946,968,ITF,ITF1,13,Abruzzo,Abruzzo,1304970,556836,42.67,0.3
1188,2021-03-28,ABR,2415,1017,1398,2044,371,ITF,ITF1,13,Abruzzo,Abruzzo,1304970,559251,42.86,0.19
1189,2021-01-23,ABR,263,114,149,57,206,ITF,ITF1,13,Abruzzo,Abruzzo,1304970,559514,42.88,0.02
1190,2021-04-14,ABR,6502,2896,3606,4423,2079,ITF,ITF1,13,Abruzzo,Abruzzo,1304970,566016,43.37,0.5
1191,2021-03-11,ABR,5453,2193,3260,4314,1139,ITF,ITF1,13,Abruzzo,Abruzzo,1304970,571469,43.79,0.42
1192,2021-02-23,ABR,2782,1275,1507,2771,11,ITF,ITF1,13,Abruzzo,Abruzzo,1304970,574251,44.0,0.21
1193,2021-02-08,ABR,1197,396,801,487,710,ITF,ITF1,13,Abruzzo,Abruzzo,1304970,575448,44.1,0.09
1194,2021-04-13,ABR,5879,2752,3127,4679,1200,ITF,ITF1,13,Abruzzo,Abruzzo,1304970,581327,44.55,0.45
1195,2021-05-19,ABR,10693,5109,5584,7654,3039,ITF,ITF1,13,Abruzzo,Abruzzo,1304970,592020,45.37,0.82
1196,2021-02-18,ABR,2288,933,1355,2158,130,ITF,ITF1,13,Abruzzo,Abruzzo,1304970,594308,45.54,0.18
1197,2021-05-31,ABR,11221,5045,6176,6910,4311,ITF,ITF1,13,Abruzzo,Abruzzo,1304970,605529,46.4,0.86
1198,2021-05-22,ABR,13069,6351,6718,8168,4901,ITF,ITF1,13,Abruzzo,Abruzzo,1304970,618598,47.4,1.0
1199,2021-04-09,ABR,8791,4139,4652,6252,2539,ITF,ITF1,13,Abruzzo,Abruzzo,1304970,627389,48.08,0.67
1200,2021-04-04,ABR,1630,767,863,1501,129,ITF,ITF1,13,Abruzzo,Abruzzo,1304970,629019,48.2,0.12
1201,2021-04-02,ABR,6684,3093,3591,5197,1487,ITF,ITF1,13,Abruzzo,Abruzzo,1304970,635703,48.71,0.51
1202,2021-02-04,ABR,1679,615,1064,609,1070,ITF,ITF1,13,Abruzzo,Abruzzo,1304970,637382,48.84,0.13
1203,2021-02-27,ABR,2811,1338,1473,2546,265,ITF,ITF1,13,Abruzzo,Abruzzo,1304970,640193,49.06,0.22
1204,2021-03-06,ABR,4176,1357,2819,3606,570,ITF,ITF1,13,Abruzzo,Abruzzo,1304970,644369,49.38,0.32
1205,2021-01-18,ABR,122,48,74,46,76,ITF,ITF1,13,Abruzzo,Abruzzo,1304970,644491,49.39,0.01
1206,2021-05-12,ABR,9616,4586,5030,6046,3570,ITF,ITF1,13,Abruzzo,Abruzzo,1304970,654107,50.12,0.74
1207,2021-03-16,ABR,3484,1452,2032,1830,1654,ITF,ITF1,13,Abruzzo,Abruzzo,1304970,657591,50.39,0.27
1208,2021-05-05,ABR,11581,5546,6035,6451,5130,ITF,ITF1,13,Abruzzo,Abruzzo,1304970,669172,51.28,0.89
1209,2021-03-09,ABR,5168,1795,3373,4229,939,ITF,ITF1,13,Abruzzo,Abruzzo,1304970,674340,51.67,0.4
1210,2021-04-28,ABR,9510,4585,4925,7486,2024,ITF,ITF1,13,Abruzzo,Abruzzo,1304970,683850,52.4,0.73
1211,2021-03-30,ABR,5056,2197,2859,3232,1824,ITF,ITF1,13,Abruzzo,Abruzzo,1304970,688906,52.79,0.39
1212,2021-04-23,ABR,7369,3382,3987,5067,2302,ITF,ITF1,13,Abruzzo,Abruzzo,1304970,696275,53.36,0.56
1213,2021-05-10,ABR,10107,4784,5323,5456,4651,ITF,ITF1,13,Abruzzo,Abruzzo,1304970,706382,54.13,0.77
1214,2021-02-13,ABR,849,383,466,437,412,ITF,ITF1,13,Abruzzo,Abruzzo,1304970,707231,54.2,0.07
1215,2021-02-20,ABR,4777,1842,2935,4701,76,ITF,ITF1,13,Abruzzo,Abruzzo,1304970,712008,54.56,0.37
1216,2021-01-06,ABR,1830,664,1166,1830,0,ITF,ITF1,13,Abruzzo,Abruzzo,1304970,713838,54.7,0.14
1217,2021-03-04,ABR,5935,2359,3576,5013,922,ITF,ITF1,13,Abruzzo,Abruzzo,1304970,719773,55.16,0.45
1218,2021-04-18,ABR,5811,2726,3085,4869,942,ITF,ITF1,13,Abruzzo,Abruzzo,1304970,725584,55.6,0.45
1219,2021-02-01,ABR,1632,573,1059,271,1361,ITF,ITF1,13,Abruzzo,Abruzzo,1304970,727216,55.73,0.13
1220,2021-03-23,ABR,4782,2143,2639,2216,2566,ITF,ITF1,13,Abruzzo,Abruzzo,1304970,731998,56.09,0.37
1221,2021-01-25,ABR,1603,632,971,19,1584,ITF,ITF1,13,Abruzzo,Abruzzo,1304970,733601,56.22,0.12
1222,2021-04-11,ABR,5330,2606,2724,4847,483,ITF,ITF1,13,Abruzzo,Abruzzo,1304970,738931,56.62,0.41
1223,2020-12-27,ABR,37,19,18,37,0,ITF,ITF1,13,Abruzzo,Abruzzo,1304970,738968,56.63,0.0
1224,2021-05-27,ABR,12930,5877,7053,8241,4689,ITF,ITF1,13,Abruzzo,Abruzzo,1304970,751898,57.62,0.99
1225,2021-04-07,ABR,7129,3282,3847,4404,2725,ITF,ITF1,13,Abruzzo,Abruzzo,1304970,759027,58.16,0.55
1226,2021-03-02,ABR,3963,1676,2287,3279,684,ITF,ITF1,13,Abruzzo,Abruzzo,1304970,762990,58.47,0.3
1227,2021-01-11,ABR,1551,557,994,1551,0,ITF,ITF1,13,Abruzzo,Abruzzo,1304970,764541,58.59,0.12
1228,2021-02-16,ABR,1918,842,1076,1906,12,ITF,ITF1,13,Abruzzo,Abruzzo,1304970,766459,58.73,0.15
1229,2021-04-21,ABR,6384,3100,3284,4710,1674,ITF,ITF1,13,Abruzzo,Abruzzo,1304970,772843,59.22,0.49
1230,2021-04-06,ABR,7681,3581,4100,5362,2319,ITF,ITF1,13,Abruzzo,Abruzzo,1304970,780524,59.81,0.59
1231,2021-02-15,ABR,1794,831,963,1752,42,ITF,ITF1,13,Abruzzo,Abruzzo,1304970,782318,59.95,0.14
1232,2021-05-26,ABR,13308,5905,7403,8381,4927,ITF,ITF1,13,Abruzzo,Abruzzo,1304970,795626,60.97,1.02
1233,2021-04-30,CAL,14905,7315,7590,10597,4308,ITF,ITF6,18,Calabria,Calabria,1947131,14905,0.77,0.77
1234,2021-01-18,CAL,1262,568,694,1043,219,ITF,ITF6,18,Calabria,Calabria,1947131,16167,0.83,0.06
1235,2021-03-27,CAL,8583,3895,4688,4588,3995,ITF,ITF6,18,Calabria,Calabria,1947131,24750,1.27,0.44
1236,2021-04-13,CAL,6778,3268,3510,5469,1309,ITF,ITF6,18,Calabria,Calabria,1947131,31528,1.62,0.35
1237,2021-01-23,CAL,400,186,214,358,42,ITF,ITF6,18,Calabria,Calabria,1947131,31928,1.64,0.02
1238,2021-03-28,CAL,2567,1184,1383,1434,1133,ITF,ITF6,18,Calabria,Calabria,1947131,34495,1.77,0.13
1239,2021-01-30,CAL,2178,1149,1029,358,1820,ITF,ITF6,18,Calabria,Calabria,1947131,36673,1.88,0.11
1240,2021-02-17,CAL,1832,797,1035,1621,211,ITF,ITF6,18,Calabria,Calabria,1947131,38505,1.98,0.09
1241,2021-04-08,CAL,9403,4430,4973,5808,3595,ITF,ITF6,18,Calabria,Calabria,1947131,47908,2.46,0.48
1242,2021-04-01,CAL,8516,3856,4660,3979,4537,ITF,ITF6,18,Calabria,Calabria,1947131,56424,2.9,0.44
1243,2021-05-21,CAL,21311,10847,10464,13951,7360,ITF,ITF6,18,Calabria,Calabria,1947131,77735,3.99,1.09
1244,2021-02-06,CAL,2906,1337,1569,442,2464,ITF,ITF6,18,Calabria,Calabria,1947131,80641,4.14,0.15
1245,2021-04-15,CAL,7604,3725,3879,5980,1624,ITF,ITF6,18,Calabria,Calabria,1947131,88245,4.53,0.39
1246,2021-02-10,CAL,2509,1078,1431,884,1625,ITF,ITF6,18,Calabria,Calabria,1947131,90754,4.66,0.13
1247,2021-05-28,CAL,20958,10162,10796,11477,9481,ITF,ITF6,18,Calabria,Calabria,1947131,111712,5.74,1.08
1248,2021-04-18,CAL,5840,2790,3050,4931,909,ITF,ITF6,18,Calabria,Calabria,1947131,117552,6.04,0.3
1249,2021-02-13,CAL,1395,603,792,1031,364,ITF,ITF6,18,Calabria,Calabria,1947131,118947,6.11,0.07
1250,2021-04-04,CAL,1763,887,876,1262,501,ITF,ITF6,18,Calabria,Calabria,1947131,120710,6.2,0.09
1251,2021-03-18,CAL,4368,2037,2331,2342,2026,ITF,ITF6,18,Calabria,Calabria,1947131,125078,6.42,0.22
1252,2021-01-27,CAL,1457,733,724,396,1061,ITF,ITF6,18,Calabria,Calabria,1947131,126535,6.5,0.07
1253,2021-02-25,CAL,2866,1545,1321,2280,586,ITF,ITF6,18,Calabria,Calabria,1947131,129401,6.65,0.15
1254,2021-05-04,CAL,16318,7517,8801,11691,4627,ITF,ITF6,18,Calabria,Calabria,1947131,145719,7.48,0.84
1255,2021-01-22,CAL,658,274,384,656,2,ITF,ITF6,18,Calabria,Calabria,1947131,146377,7.52,0.03
1256,2021-03-06,CAL,8415,4334,4081,7623,792,ITF,ITF6,18,Calabria,Calabria,1947131,154792,7.95,0.43
1257,2021-05-09,CAL,9668,4499,5169,6139,3529,ITF,ITF6,18,Calabria,Calabria,1947131,164460,8.45,0.5
1258,2021-02-20,CAL,1415,758,657,1097,318,ITF,ITF6,18,Calabria,Calabria,1947131,165875,8.52,0.07
1259,2021-03-11,CAL,7248,3418,3830,5986,1262,ITF,ITF6,18,Calabria,Calabria,1947131,173123,8.89,0.37
1260,2021-05-31,CAL,15184,7266,7918,7344,7840,ITF,ITF6,18,Calabria,Calabria,1947131,188307,9.67,0.78
1261,2021-05-16,CAL,13774,6725,7049,9960,3814,ITF,ITF6,18,Calabria,Calabria,1947131,202081,10.38,0.71
1262,2021-05-14,CAL,19943,9588,10355,13073,6870,ITF,ITF6,18,Calabria,Calabria,1947131,222024,11.4,1.02
1263,2021-02-03,CAL,2764,1429,1335,581,2183,ITF,ITF6,18,Calabria,Calabria,1947131,224788,11.54,0.14
1264,2021-02-11,CAL,2329,1040,1289,1082,1247,ITF,ITF6,18,Calabria,Calabria,1947131,227117,11.66,0.12
1265,2021-05-23,CAL,11367,5550,5817,7036,4331,ITF,ITF6,18,Calabria,Calabria,1947131,238484,12.25,0.58
1266,2021-04-11,CAL,4166,1895,2271,2223,1943,ITF,ITF6,18,Calabria,Calabria,1947131,242650,12.46,0.21
1267,2021-01-03,CAL,6,3,3,6,0,ITF,ITF6,18,Calabria,Calabria,1947131,242656,12.46,0.0
1268,2021-03-08,CAL,5404,2896,2508,4343,1061,ITF,ITF6,18,Calabria,Calabria,1947131,248060,12.74,0.28
1269,2021-01-20,CAL,1399,626,773,1398,1,ITF,ITF6,18,Calabria,Calabria,1947131,249459,12.81,0.07
1270,2021-03-25,CAL,7386,3463,3923,4547,2839,ITF,ITF6,18,Calabria,Calabria,1947131,256845,13.19,0.38
1271,2021-01-04,CAL,1051,517,534,1051,0,ITF,ITF6,18,Calabria,Calabria,1947131,257896,13.24,0.05
1272,2021-05-07,CAL,16065,7573,8492,9702,6363,ITF,ITF6,18,Calabria,Calabria,1947131,273961,14.07,0.83
1273,2021-05-24,CAL,17624,8777,8847,9958,7666,ITF,ITF6,18,Calabria,Calabria,1947131,291585,14.98,0.91
1274,2021-01-08,CAL,2134,1022,1112,2134,0,ITF,ITF6,18,Calabria,Calabria,1947131,293719,15.08,0.11
1275,2021-02-27,CAL,3987,2051,1936,3608,379,ITF,ITF6,18,Calabria,Calabria,1947131,297706,15.29,0.2
1276,2021-03-09,CAL,6255,3227,3028,5276,979,ITF,ITF6,18,Calabria,Calabria,1947131,303961,15.61,0.32
1277,2021-04-27,CAL,9946,4889,5057,8004,1942,ITF,ITF6,18,Calabria,Calabria,1947131,313907,16.12,0.51
1278,2021-02-22,CAL,2031,1028,1003,1475,556,ITF,ITF6,18,Calabria,Calabria,1947131,315938,16.23,0.1
1279,2021-03-10,CAL,6552,3314,3238,5273,1279,ITF,ITF6,18,Calabria,Calabria,1947131,322490,16.56,0.34
1280,2021-05-13,CAL,15871,7612,8259,11212,4659,ITF,ITF6,18,Calabria,Calabria,1947131,338361,17.38,0.82
1281,2021-05-30,CAL,11132,5360,5772,6976,4156,ITF,ITF6,18,Calabria,Calabria,1947131,349493,17.95,0.57
1282,2021-05-17,CAL,15070,7530,7540,10357,4713,ITF,ITF6,18,Calabria,Calabria,1947131,364563,18.72,0.77
1283,2021-02-04,CAL,3475,1659,1816,652,2823,ITF,ITF6,18,Calabria,Calabria,1947131,368038,18.9,0.18
1284,2021-02-21,CAL,609,286,323,532,77,ITF,ITF6,18,Calabria,Calabria,1947131,368647,18.93,0.03
1285,2021-03-04,CAL,5457,3180,2277,4660,797,ITF,ITF6,18,Calabria,Calabria,1947131,374104,19.21,0.28
1286,2021-01-29,CAL,2047,985,1062,230,1817,ITF,ITF6,18,Calabria,Calabria,1947131,376151,19.32,0.11
1287,2021-05-02,CAL,12501,5834,6667,10663,1838,ITF,ITF6,18,Calabria,Calabria,1947131,388652,19.96,0.64
1288,2021-02-01,CAL,2494,1191,1303,243,2251,ITF,ITF6,18,Calabria,Calabria,1947131,391146,20.09,0.13
1289,2021-05-26,CAL,18490,9139,9351,10284,8206,ITF,ITF6,18,Calabria,Calabria,1947131,409636,21.04,0.95
1290,2021-03-30,CAL,6189,2657,3532,3485,2704,ITF,ITF6,18,Calabria,Calabria,1947131,415825,21.36,0.32
1291,2021-05-19,CAL,18447,9138,9309,11430,7017,ITF,ITF6,18,Calabria,Calabria,1947131,434272,22.3,0.95
1292,2021-03-23,CAL,5252,2459,2793,3443,1809,ITF,ITF6,18,Calabria,Calabria,1947131,439524,22.57,0.27
1293,2021-05-12,CAL,16379,7955,8424,10953,5426,ITF,ITF6,18,Calabria,Calabria,1947131,455903,23.41,0.84
1294,2020-12-27,CAL,281,156,125,281,0,ITF,ITF6,18,Calabria,Calabria,1947131,456184,23.43,0.01
1295,2021-02-15,CAL,1140,539,601,991,149,ITF,ITF6,18,Calabria,Calabria,1947131,457324,23.49,0.06
1296,2021-04-06,CAL,7529,3392,4137,4195,3334,ITF,ITF6,18,Calabria,Calabria,1947131,464853,23.87,0.39
1297,2021-01-06,CAL,928,501,427,928,0,ITF,ITF6,18,Calabria,Calabria,1947131,465781,23.92,0.05
1298,2021-01-13,CAL,2031,1023,1008,2031,0,ITF,ITF6,18,Calabria,Calabria,1947131,467812,24.03,0.1
1299,2021-04-16,CAL,10298,5009,5289,8645,1653,ITF,ITF6,18,Calabria,Calabria,1947131,478110,24.55,0.53
1300,2021-02-18,CAL,1822,825,997,1596,226,ITF,ITF6,18,Calabria,Calabria,1947131,479932,24.65,0.09
1301,2021-04-23,CAL,12851,6318,6533,9442,3409,ITF,ITF6,18,Calabria,Calabria,1947131,492783,25.31,0.66
1302,2021-01-15,CAL,2795,1258,1537,2795,0,ITF,ITF6,18,Calabria,Calabria,1947131,495578,25.45,0.14
1303,2021-03-20,CAL,6693,3068,3625,4196,2497,ITF,ITF6,18,Calabria,Calabria,1947131,502271,25.8,0.34
1304,2021-03-13,CAL,6836,2983,3853,5868,968,ITF,ITF6,18,Calabria,Calabria,1947131,509107,26.15,0.35
1305,2021-01-05,CAL,1464,684,780,1464,0,ITF,ITF6,18,Calabria,Calabria,1947131,510571,26.22,0.08
1306,2021-03-14,CAL,2691,1063,1628,2276,415,ITF,ITF6,18,Calabria,Calabria,1947131,513262,26.36,0.14
1307,2021-01-31,CAL,1108,555,553,154,954,ITF,ITF6,18,Calabria,Calabria,1947131,514370,26.42,0.06
1308,2020-12-28,CAL,6,2,4,6,0,ITF,ITF6,18,Calabria,Calabria,1947131,514376,26.42,0.0
1309,2021-04-09,CAL,7933,3714,4219,5009,2924,ITF,ITF6,18,Calabria,Calabria,1947131,522309,26.82,0.41
1310,2021-01-12,CAL,2063,1020,1043,2063,0,ITF,ITF6,18,Calabria,Calabria,1947131,524372,26.93,0.11
1311,2021-02-24,CAL,1847,942,905,1372,475,ITF,ITF6,18,Calabria,Calabria,1947131,526219,27.03,0.09
1312,2021-03-03,CAL,5000,2730,2270,3928,1072,ITF,ITF6,18,Calabria,Calabria,1947131,531219,27.28,0.26
1313,2021-05-03,CAL,14740,6755,7985,10536,4204,ITF,ITF6,18,Calabria,Calabria,1947131,545959,28.04,0.76
1314,2021-03-21,CAL,4455,1925,2530,2730,1725,ITF,ITF6,18,Calabria,Calabria,1947131,550414,28.27,0.23
1315,2021-03-07,CAL,3330,1701,1629,3241,89,ITF,ITF6,18,Calabria,Calabria,1947131,553744,28.44,0.17
1316,2021-05-10,CAL,13137,6093,7044,7735,5402,ITF,ITF6,18,Calabria,Calabria,1947131,566881,29.11,0.67
1317,2021-04-10,CAL,11370,5126,6244,6559,4811,ITF,ITF6,18,Calabria,Calabria,1947131,578251,29.7,0.58
1318,2021-02-05,CAL,3800,1710,2090,490,3310,ITF,ITF6,18,Calabria,Calabria,1947131,582051,29.89,0.2
1319,2021-03-26,CAL,7822,3708,4114,4704,3118,ITF,ITF6,18,Calabria,Calabria,1947131,589873,30.29,0.4
1320,2021-01-26,CAL,1808,861,947,278,1530,ITF,ITF6,18,Calabria,Calabria,1947131,591681,30.39,0.09
1321,2021-04-05,CAL,3501,1648,1853,2602,899,ITF,ITF6,18,Calabria,Calabria,1947131,595182,30.57,0.18
1322,2021-05-25,CAL,16396,7989,8407,10296,6100,ITF,ITF6,18,Calabria,Calabria,1947131,611578,31.41,0.84
1323,2021-04-22,CAL,9619,4796,4823,6778,2841,ITF,ITF6,18,Calabria,Calabria,1947131,621197,31.9,0.49
1324,2021-01-09,CAL,1924,1040,884,1924,0,ITF,ITF6,18,Calabria,Calabria,1947131,623121,32.0,0.1
1325,2021-02-12,CAL,1710,667,1043,945,765,ITF,ITF6,18,Calabria,Calabria,1947131,624831,32.09,0.09
1326,2021-04-03,CAL,8912,3822,5090,4282,4630,ITF,ITF6,18,Calabria,Calabria,1947131,633743,32.55,0.46
1327,2021-01-28,CAL,2235,1109,1126,83,2152,ITF,ITF6,18,Calabria,Calabria,1947131,635978,32.66,0.11
1328,2021-05-22,CAL,22044,10503,11541,14220,7824,ITF,ITF6,18,Calabria,Calabria,1947131,658022,33.79,1.13
1329,2021-04-02,CAL,8128,3701,4427,4331,3797,ITF,ITF6,18,Calabria,Calabria,1947131,666150,34.21,0.42
1330,2021-05-08,CAL,18275,8327,9948,10469,7806,ITF,ITF6,18,Calabria,Calabria,1947131,684425,35.15,0.94
1331,2021-03-19,CAL,4186,1947,2239,1900,2286,ITF,ITF6,18,Calabria,Calabria,1947131,688611,35.37,0.21
1332,2021-04-24,CAL,18997,9476,9521,15587,3410,ITF,ITF6,18,Calabria,Calabria,1947131,707608,36.34,0.98
1333,2021-02-26,CAL,3062,1631,1431,2609,453,ITF,ITF6,18,Calabria,Calabria,1947131,710670,36.5,0.16
1334,2021-01-07,CAL,2185,1065,1120,2185,0,ITF,ITF6,18,Calabria,Calabria,1947131,712855,36.61,0.11
1335,2021-04-17,CAL,10919,5116,5803,9047,1872,ITF,ITF6,18,Calabria,Calabria,1947131,723774,37.17,0.56
1336,2021-05-01,CAL,16620,7926,8694,12423,4197,ITF,ITF6,18,Calabria,Calabria,1947131,740394,38.02,0.85
1337,2021-03-05,CAL,6219,3610,2609,5646,573,ITF,ITF6,18,Calabria,Calabria,1947131,746613,38.34,0.32
1338,2021-03-12,CAL,5110,2451,2659,4040,1070,ITF,ITF6,18,Calabria,Calabria,1947131,751723,38.61,0.26
1339,2021-01-14,CAL,2634,1248,1386,2634,0,ITF,ITF6,18,Calabria,Calabria,1947131,754357,38.74,0.14
1340,2021-05-20,CAL,16896,8437,8459,11291,5605,ITF,ITF6,18,Calabria,Calabria,1947131,771253,39.61,0.87
1341,2021-02-07,CAL,859,427,432,147,712,ITF,ITF6,18,Calabria,Calabria,1947131,772112,39.65,0.04
1342,2021-03-15,CAL,3542,1682,1860,2107,1435,ITF,ITF6,18,Calabria,Calabria,1947131,775654,39.84,0.18
1343,2021-05-18,CAL,15546,7785,7761,12083,3463,ITF,ITF6,18,Calabria,Calabria,1947131,791200,40.63,0.8
1344,2021-03-22,CAL,4880,2289,2591,3129,1751,ITF,ITF6,18,Calabria,Calabria,1947131,796080,40.88,0.25
1345,2021-04-14,CAL,8129,3906,4223,6676,1453,ITF,ITF6,18,Calabria,Calabria,1947131,804209,41.3,0.42
1346,2021-02-16,CAL,1735,732,1003,1456,279,ITF,ITF6,18,Calabria,Calabria,1947131,805944,41.39,0.09
1347,2021-02-09,CAL,2147,905,1242,947,1200,ITF,ITF6,18,Calabria,Calabria,1947131,808091,41.5,0.11
1348,2021-05-27,CAL,17423,8574,8849,9732,7691,ITF,ITF6,18,Calabria,Calabria,1947131,825514,42.4,0.89
1349,2021-06-01,CAL,4047,1871,2176,2339,1708,ITF,ITF6,18,Calabria,Calabria,1947131,829561,42.6,0.21
1350,2021-02-19,CAL,1508,681,827,1247,261,ITF,ITF6,18,Calabria,Calabria,1947131,831069,42.68,0.08
1351,2021-04-28,CAL,12533,6062,6471,9675,2858,ITF,ITF6,18,Calabria,Calabria,1947131,843602,43.33,0.64
1352,2021-01-16,CAL,2394,1120,1274,2394,0,ITF,ITF6,18,Calabria,Calabria,1947131,845996,43.45,0.12
1353,2021-05-15,CAL,26698,12767,13931,19925,6773,ITF,ITF6,18,Calabria,Calabria,1947131,872694,44.82,1.37
1354,2021-03-24,CAL,7605,3462,4143,4367,3238,ITF,ITF6,18,Calabria,Calabria,1947131,880299,45.21,0.39
1355,2021-04-12,CAL,6901,3349,3552,5248,1653,ITF,ITF6,18,Calabria,Calabria,1947131,887200,45.56,0.35
1356,2021-01-19,CAL,1111,490,621,1101,10,ITF,ITF6,18,Calabria,Calabria,1947131,888311,45.62,0.06
1357,2021-01-17,CAL,867,418,449,801,66,ITF,ITF6,18,Calabria,Calabria,1947131,889178,45.67,0.04
1358,2021-04-29,CAL,11825,5744,6081,8308,3517,ITF,ITF6,18,Calabria,Calabria,1947131,901003,46.27,0.61
1359,2021-03-29,CAL,5687,2405,3282,3931,1756,ITF,ITF6,18,Calabria,Calabria,1947131,906690,46.57,0.29
1360,2021-05-11,CAL,15128,7315,7813,10351,4777,ITF,ITF6,18,Calabria,Calabria,1947131,921818,47.34,0.78
1361,2021-01-24,CAL,44,18,26,39,5,ITF,ITF6,18,Calabria,Calabria,1947131,921862,47.34,0.0
1362,2021-02-23,CAL,1590,753,837,1475,115,ITF,ITF6,18,Calabria,Calabria,1947131,923452,47.43,0.08
1363,2021-04-07,CAL,6514,2942,3572,3716,2798,ITF,ITF6,18,Calabria,Calabria,1947131,929966,47.76,0.33
1364,2021-04-25,CAL,15833,8033,7800,14696,1137,ITF,ITF6,18,Calabria,Calabria,1947131,945799,48.57,0.81
1365,2021-05-29,CAL,19020,8830,10190,9194,9826,ITF,ITF6,18,Calabria,Calabria,1947131,964819,49.55,0.98
1366,2021-04-26,CAL,10199,5067,5132,7778,2421,ITF,ITF6,18,Calabria,Calabria,1947131,975018,50.07,0.52
1367,2021-02-08,CAL,1850,735,1115,662,1188,ITF,ITF6,18,Calabria,Calabria,1947131,976868,50.17,0.1
1368,2021-02-14,CAL,462,210,252,432,30,ITF,ITF6,18,Calabria,Calabria,1947131,977330,50.19,0.02
1369,2021-03-17,CAL,3977,1768,2209,2138,1839,ITF,ITF6,18,Calabria,Calabria,1947131,981307,50.4,0.2
1370,2021-05-06,CAL,13264,6274,6990,8993,4271,ITF,ITF6,18,Calabria,Calabria,1947131,994571,51.08,0.68
1371,2021-04-19,CAL,7822,3773,4049,6174,1648,ITF,ITF6,18,Calabria,Calabria,1947131,1002393,51.48,0.4
1372,2021-02-28,CAL,2272,1034,1238,2120,152,ITF,ITF6,18,Calabria,Calabria,1947131,1004665,51.6,0.12
1373,2021-01-21,CAL,960,445,515,930,30,ITF,ITF6,18,Calabria,Calabria,1947131,1005625,51.65,0.05
1374,2021-03-31,CAL,8862,4025,4837,4905,3957,ITF,ITF6,18,Calabria,Calabria,1947131,1014487,52.1,0.46
1375,2021-02-02,CAL,2287,1114,1173,177,2110,ITF,ITF6,18,Calabria,Calabria,1947131,1016774,52.22,0.12
1376,2021-01-02,CAL,166,94,72,166,0,ITF,ITF6,18,Calabria,Calabria,1947131,1016940,52.23,0.01
1377,2021-01-25,CAL,1068,514,554,148,920,ITF,ITF6,18,Calabria,Calabria,1947131,1018008,52.28,0.05
1378,2021-01-11,CAL,2155,1041,1114,2155,0,ITF,ITF6,18,Calabria,Calabria,1947131,1020163,52.39,0.11
1379,2021-05-05,CAL,13598,6508,7090,8489,5109,ITF,ITF6,18,Calabria,Calabria,1947131,1033761,53.09,0.7
1380,2021-03-02,CAL,4367,2489,1878,3611,756,ITF,ITF6,18,Calabria,Calabria,1947131,1038128,53.32,0.22
1381,2021-03-16,CAL,3835,1883,1952,2175,1660,ITF,ITF6,18,Calabria,Calabria,1947131,1041963,53.51,0.2
1382,2021-03-01,CAL,2723,1545,1178,2269,454,ITF,ITF6,18,Calabria,Calabria,1947131,1044686,53.65,0.14
1383,2021-01-10,CAL,929,524,405,929,0,ITF,ITF6,18,Calabria,Calabria,1947131,1045615,53.7,0.05
1384,2021-04-20,CAL,7834,3946,3888,6108,1726,ITF,ITF6,18,Calabria,Calabria,1947131,1053449,54.1,0.4
1385,2021-04-21,CAL,11573,5815,5758,8639,2934,ITF,ITF6,18,Calabria,Calabria,1947131,1065022,54.7,0.59
1386,2021-03-10,MOL,1737,720,1017,1687,50,ITF,ITF2,14,Molise,Molise,305617,1737,0.57,0.57
1387,2021-05-13,MOL,3037,1409,1628,2580,457,ITF,ITF2,14,Molise,Molise,305617,4774,1.56,0.99
1388,2021-02-21,MOL,573,227,346,571,2,ITF,ITF2,14,Molise,Molise,305617,5347,1.75,0.19
1389,2021-04-26,MOL,1157,521,636,826,331,ITF,ITF2,14,Molise,Molise,305617,6504,2.13,0.38
1390,2021-02-04,MOL,758,295,463,77,681,ITF,ITF2,14,Molise,Molise,305617,7262,2.38,0.25
1391,2021-04-17,MOL,3051,1500,1551,1565,1486,ITF,ITF2,14,Molise,Molise,305617,10313,3.37,1.0
1392,2021-05-01,MOL,2641,1266,1375,420,2221,ITF,ITF2,14,Molise,Molise,305617,12954,4.24,0.86
1393,2021-03-05,MOL,1219,649,570,1015,204,ITF,ITF2,14,Molise,Molise,305617,14173,4.64,0.4
1394,2021-02-26,MOL,563,260,303,490,73,ITF,ITF2,14,Molise,Molise,305617,14736,4.82,0.18
1395,2021-03-19,MOL,1184,482,702,757,427,ITF,ITF2,14,Molise,Molise,305617,15920,5.21,0.39
1396,2021-01-14,MOL,646,239,407,646,0,ITF,ITF2,14,Molise,Molise,305617,16566,5.42,0.21
1397,2021-04-24,MOL,2540,1197,1343,699,1841,ITF,ITF2,14,Molise,Molise,305617,19106,6.25,0.83
1398,2021-01-21,MOL,6,2,4,6,0,ITF,ITF2,14,Molise,Molise,305617,19112,6.25,0.0
1399,2021-03-12,MOL,1459,637,822,1423,36,ITF,ITF2,14,Molise,Molise,305617,20571,6.73,0.48
1400,2021-01-28,MOL,613,217,396,17,596,ITF,ITF2,14,Molise,Molise,305617,21184,6.93,0.2
1401,2021-02-12,MOL,330,149,181,208,122,ITF,ITF2,14,Molise,Molise,305617,21514,7.04,0.11
1402,2021-03-15,MOL,832,338,494,587,245,ITF,ITF2,14,Molise,Molise,305617,22346,7.31,0.27
1403,2021-05-08,MOL,2972,1453,1519,1728,1244,ITF,ITF2,14,Molise,Molise,305617,25318,8.28,0.97
1404,2021-05-22,MOL,1307,706,601,1225,82,ITF,ITF2,14,Molise,Molise,305617,26625,8.71,0.43
1405,2021-03-02,MOL,667,383,284,509,158,ITF,ITF2,14,Molise,Molise,305617,27292,8.93,0.22
1406,2021-04-21,MOL,1862,788,1074,967,895,ITF,ITF2,14,Molise,Molise,305617,29154,9.54,0.61
1407,2021-01-31,MOL,268,70,198,6,262,ITF,ITF2,14,Molise,Molise,305617,29422,9.63,0.09
1408,2021-04-05,MOL,391,189,202,292,99,ITF,ITF2,14,Molise,Molise,305617,29813,9.76,0.13
1409,2021-03-31,MOL,2193,919,1274,1374,819,ITF,ITF2,14,Molise,Molise,305617,32006,10.47,0.72
1410,2021-01-17,MOL,78,38,40,48,30,ITF,ITF2,14,Molise,Molise,305617,32084,10.5,0.03
1411,2021-04-10,MOL,2635,1259,1376,2483,152,ITF,ITF2,14,Molise,Molise,305617,34719,11.36,0.86
1412,2021-02-05,MOL,593,269,324,55,538,ITF,ITF2,14,Molise,Molise,305617,35312,11.55,0.19
1413,2021-04-12,MOL,1299,557,742,1048,251,ITF,ITF2,14,Molise,Molise,305617,36611,11.98,0.43
1414,2021-03-07,MOL,1132,501,631,1130,2,ITF,ITF2,14,Molise,Molise,305617,37743,12.35,0.37
1415,2021-05-03,MOL,2484,1164,1320,2321,163,ITF,ITF2,14,Molise,Molise,305617,40227,13.16,0.81
1416,2021-05-10,MOL,2889,1285,1604,2516,373,ITF,ITF2,14,Molise,Molise,305617,43116,14.11,0.95
1417,2021-04-19,MOL,1827,842,985,1049,778,ITF,ITF2,14,Molise,Molise,305617,44943,14.71,0.6
1418,2021-02-28,MOL,829,331,498,787,42,ITF,ITF2,14,Molise,Molise,305617,45772,14.98,0.27
1419,2021-01-09,MOL,450,152,298,450,0,ITF,ITF2,14,Molise,Molise,305617,46222,15.12,0.15
1420,2021-05-24,MOL,1951,847,1104,1285,666,ITF,ITF2,14,Molise,Molise,305617,48173,15.76,0.64
1421,2021-02-19,MOL,169,93,76,167,2,ITF,ITF2,14,Molise,Molise,305617,48342,15.82,0.06
1422,2021-06-01,MOL,1232,633,599,1198,34,ITF,ITF2,14,Molise,Molise,305617,49574,16.22,0.4
1423,2021-05-15,MOL,2979,1398,1581,2595,384,ITF,ITF2,14,Molise,Molise,305617,52553,17.2,0.97
1424,2021-02-02,MOL,539,176,363,216,323,ITF,ITF2,14,Molise,Molise,305617,53092,17.37,0.18
1425,2021-04-28,MOL,1683,913,770,466,1217,ITF,ITF2,14,Molise,Molise,305617,54775,17.92,0.55
1426,2021-05-20,MOL,2572,1325,1247,2397,175,ITF,ITF2,14,Molise,Molise,305617,57347,18.76,0.84
1427,2021-04-14,MOL,1806,767,1039,1145,661,ITF,ITF2,14,Molise,Molise,305617,59153,19.36,0.59
1428,2021-02-16,MOL,156,70,86,150,6,ITF,ITF2,14,Molise,Molise,305617,59309,19.41,0.05
1429,2021-05-27,MOL,2825,1342,1483,1991,834,ITF,ITF2,14,Molise,Molise,305617,62134,20.33,0.92
1430,2021-02-09,MOL,359,170,189,197,162,ITF,ITF2,14,Molise,Molise,305617,62493,20.45,0.12
1431,2021-01-04,MOL,314,131,183,314,0,ITF,ITF2,14,Molise,Molise,305617,62807,20.55,0.1
1432,2021-05-29,MOL,2289,1194,1095,1935,354,ITF,ITF2,14,Molise,Molise,305617,65096,21.3,0.75
1433,2021-01-07,MOL,598,209,389,598,0,ITF,ITF2,14,Molise,Molise,305617,65694,21.5,0.2
1434,2021-04-02,MOL,1453,708,745,676,777,ITF,ITF2,14,Molise,Molise,305617,67147,21.97,0.48
1435,2021-02-11,MOL,293,133,160,257,36,ITF,ITF2,14,Molise,Molise,305617,67440,22.07,0.1
1436,2021-04-29,MOL,2237,1144,1093,890,1347,ITF,ITF2,14,Molise,Molise,305617,69677,22.8,0.73
1437,2021-03-24,MOL,1631,658,973,1229,402,ITF,ITF2,14,Molise,Molise,305617,71308,23.33,0.53
1438,2021-01-19,MOL,173,63,110,162,11,ITF,ITF2,14,Molise,Molise,305617,71481,23.39,0.06
1439,2021-03-26,MOL,2575,1045,1530,1933,642,ITF,ITF2,14,Molise,Molise,305617,74056,24.23,0.84
1440,2021-04-09,MOL,2318,1248,1070,2127,191,ITF,ITF2,14,Molise,Molise,305617,76374,24.99,0.76
1441,2021-01-18,MOL,114,48,66,114,0,ITF,ITF2,14,Molise,Molise,305617,76488,25.03,0.04
1442,2021-04-13,MOL,1630,718,912,1043,587,ITF,ITF2,14,Molise,Molise,305617,78118,25.56,0.53
1443,2021-03-27,MOL,2743,1273,1470,1310,1433,ITF,ITF2,14,Molise,Molise,305617,80861,26.46,0.9
1444,2021-03-29,MOL,2033,835,1198,1547,486,ITF,ITF2,14,Molise,Molise,305617,82894,27.12,0.67
1445,2021-04-07,MOL,1688,847,841,1413,275,ITF,ITF2,14,Molise,Molise,305617,84582,27.68,0.55
1446,2021-02-23,MOL,582,223,359,363,219,ITF,ITF2,14,Molise,Molise,305617,85164,27.87,0.19
1447,2021-01-12,MOL,336,114,222,336,0,ITF,ITF2,14,Molise,Molise,305617,85500,27.98,0.11
1448,2021-02-24,MOL,666,278,388,333,333,ITF,ITF2,14,Molise,Molise,305617,86166,28.19,0.22
1449,2021-03-03,MOL,672,316,356,590,82,ITF,ITF2,14,Molise,Molise,305617,86838,28.41,0.22
1450,2021-01-05,MOL,449,180,269,449,0,ITF,ITF2,14,Molise,Molise,305617,87287,28.56,0.15
1451,2021-05-18,MOL,1645,877,768,990,655,ITF,ITF2,14,Molise,Molise,305617,88932,29.1,0.54
1452,2021-03-22,MOL,1146,439,707,903,243,ITF,ITF2,14,Molise,Molise,305617,90078,29.47,0.37
1453,2021-05-25,MOL,1960,885,1075,1330,630,ITF,ITF2,14,Molise,Molise,305617,92038,30.12,0.64
1454,2021-02-07,MOL,66,32,34,19,47,ITF,ITF2,14,Molise,Molise,305617,92104,30.14,0.02
1455,2021-05-12,MOL,2847,1291,1556,2751,96,ITF,ITF2,14,Molise,Molise,305617,94951,31.07,0.93
1456,2021-05-26,MOL,1528,684,844,783,745,ITF,ITF2,14,Molise,Molise,305617,96479,31.57,0.5
1457,2021-02-08,MOL,334,141,193,216,118,ITF,ITF2,14,Molise,Molise,305617,96813,31.68,0.11
1458,2021-03-23,MOL,1642,694,948,1435,207,ITF,ITF2,14,Molise,Molise,305617,98455,32.22,0.54
1459,2021-02-22,MOL,265,129,136,250,15,ITF,ITF2,14,Molise,Molise,305617,98720,32.3,0.09
1460,2020-12-27,MOL,50,20,30,50,0,ITF,ITF2,14,Molise,Molise,305617,98770,32.32,0.02
1461,2021-02-25,MOL,541,239,302,473,68,ITF,ITF2,14,Molise,Molise,305617,99311,32.5,0.18
1462,2021-04-30,MOL,2935,1554,1381,829,2106,ITF,ITF2,14,Molise,Molise,305617,102246,33.46,0.96
1463,2021-05-09,MOL,2051,932,1119,1955,96,ITF,ITF2,14,Molise,Molise,305617,104297,34.13,0.67
1464,2021-03-06,MOL,1728,807,921,1569,159,ITF,ITF2,14,Molise,Molise,305617,106025,34.69,0.57
1465,2021-05-19,MOL,2335,1205,1130,1912,423,ITF,ITF2,14,Molise,Molise,305617,108360,35.46,0.76
1466,2021-03-30,MOL,2003,857,1146,1491,512,ITF,ITF2,14,Molise,Molise,305617,110363,36.11,0.66
1467,2021-02-01,MOL,562,201,361,14,548,ITF,ITF2,14,Molise,Molise,305617,110925,36.3,0.18
1468,2021-04-06,MOL,1494,701,793,1151,343,ITF,ITF2,14,Molise,Molise,305617,112419,36.78,0.49
1469,2021-02-15,MOL,144,70,74,141,3,ITF,ITF2,14,Molise,Molise,305617,112563,36.83,0.05
1470,2021-05-31,MOL,2228,1066,1162,1910,318,ITF,ITF2,14,Molise,Molise,305617,114791,37.56,0.73
1471,2021-02-20,MOL,1018,441,577,998,20,ITF,ITF2,14,Molise,Molise,305617,115809,37.89,0.33
1472,2021-04-27,MOL,1593,767,826,465,1128,ITF,ITF2,14,Molise,Molise,305617,117402,38.41,0.52
1473,2021-05-16,MOL,1246,570,676,1064,182,ITF,ITF2,14,Molise,Molise,305617,118648,38.82,0.41
1474,2021-05-05,MOL,2413,1042,1371,2272,141,ITF,ITF2,14,Molise,Molise,305617,121061,39.61,0.79
1475,2021-05-04,MOL,2704,1181,1523,2576,128,ITF,ITF2,14,Molise,Molise,305617,123765,40.5,0.88
1476,2021-01-10,MOL,270,72,198,270,0,ITF,ITF2,14,Molise,Molise,305617,124035,40.59,0.09
1477,2021-04-04,MOL,253,141,112,238,15,ITF,ITF2,14,Molise,Molise,305617,124288,40.67,0.08
1478,2021-02-27,MOL,1366,568,798,1347,19,ITF,ITF2,14,Molise,Molise,305617,125654,41.11,0.45
1479,2021-02-13,MOL,132,80,52,132,0,ITF,ITF2,14,Molise,Molise,305617,125786,41.16,0.04
1480,2021-04-18,MOL,1083,483,600,149,934,ITF,ITF2,14,Molise,Molise,305617,126869,41.51,0.35
1481,2021-01-08,MOL,429,141,288,429,0,ITF,ITF2,14,Molise,Molise,305617,127298,41.65,0.14
1482,2021-05-17,MOL,2228,1092,1136,1732,496,ITF,ITF2,14,Molise,Molise,305617,129526,42.38,0.73
1483,2021-03-21,MOL,1246,542,704,479,767,ITF,ITF2,14,Molise,Molise,305617,130772,42.79,0.41
1484,2021-03-14,MOL,595,239,356,17,578,ITF,ITF2,14,Molise,Molise,305617,131367,42.98,0.19
1485,2021-03-28,MOL,1626,747,879,524,1102,ITF,ITF2,14,Molise,Molise,305617,132993,43.52,0.53
1486,2021-01-30,MOL,461,158,303,12,449,ITF,ITF2,14,Molise,Molise,305617,133454,43.67,0.15
1487,2021-02-06,MOL,429,179,250,29,400,ITF,ITF2,14,Molise,Molise,305617,133883,43.81,0.14
1488,2021-04-16,MOL,2430,1033,1397,1198,1232,ITF,ITF2,14,Molise,Molise,305617,136313,44.6,0.8
1489,2021-04-23,MOL,2049,882,1167,1390,659,ITF,ITF2,14,Molise,Molise,305617,138362,45.27,0.67
1490,2021-03-11,MOL,1463,636,827,1457,6,ITF,ITF2,14,Molise,Molise,305617,139825,45.75,0.48
1491,2021-01-06,MOL,689,260,429,689,0,ITF,ITF2,14,Molise,Molise,305617,140514,45.98,0.23
1492,2021-01-13,MOL,474,160,314,474,0,ITF,ITF2,14,Molise,Molise,305617,140988,46.13,0.16
1493,2021-01-16,MOL,420,166,254,420,0,ITF,ITF2,14,Molise,Molise,305617,141408,46.27,0.14
1494,2021-04-11,MOL,1196,591,605,1182,14,ITF,ITF2,14,Molise,Molise,305617,142604,46.66,0.39
1495,2021-03-25,MOL,1806,730,1076,1309,497,ITF,ITF2,14,Molise,Molise,305617,144410,47.25,0.59
1496,2021-03-08,MOL,1379,522,857,1239,140,ITF,ITF2,14,Molise,Molise,305617,145789,47.7,0.45
1497,2021-02-18,MOL,319,74,245,306,13,ITF,ITF2,14,Molise,Molise,305617,146108,47.81,0.1
1498,2021-03-09,MOL,1329,579,750,1177,152,ITF,ITF2,14,Molise,Molise,305617,147437,48.24,0.43
1499,2021-05-14,MOL,2644,1215,1429,1926,718,ITF,ITF2,14,Molise,Molise,305617,150081,49.11,0.87
1500,2021-02-03,MOL,731,249,482,338,393,ITF,ITF2,14,Molise,Molise,305617,150812,49.35,0.24
1501,2021-03-04,MOL,850,417,433,526,324,ITF,ITF2,14,Molise,Molise,305617,151662,49.62,0.28
1502,2021-01-20,MOL,18,8,10,18,0,ITF,ITF2,14,Molise,Molise,305617,151680,49.63,0.01
1503,2021-05-02,MOL,1890,930,960,587,1303,ITF,ITF2,14,Molise,Molise,305617,153570,50.25,0.62
1504,2021-01-29,MOL,421,136,285,6,415,ITF,ITF2,14,Molise,Molise,305617,153991,50.39,0.14
1505,2021-05-11,MOL,3205,1413,1792,2955,250,ITF,ITF2,14,Molise,Molise,305617,157196,51.44,1.05
1506,2021-04-25,MOL,792,395,397,559,233,ITF,ITF2,14,Molise,Molise,305617,157988,51.69,0.26
1507,2021-03-13,MOL,1189,594,595,200,989,ITF,ITF2,14,Molise,Molise,305617,159177,52.08,0.39
1508,2021-01-15,MOL,538,242,296,538,0,ITF,ITF2,14,Molise,Molise,305617,159715,52.26,0.18
1509,2021-05-28,MOL,2465,1288,1177,1956,509,ITF,ITF2,14,Molise,Molise,305617,162180,53.07,0.81
1510,2021-04-08,MOL,1766,903,863,1564,202,ITF,ITF2,14,Molise,Molise,305617,163946,53.64,0.58
1511,2021-04-22,MOL,1844,863,981,1065,779,ITF,ITF2,14,Molise,Molise,305617,165790,54.25,0.6
1512,2021-02-17,MOL,72,32,40,57,15,ITF,ITF2,14,Molise,Molise,305617,165862,54.27,0.02
1513,2021-05-30,MOL,1822,903,919,1538,284,ITF,ITF2,14,Molise,Molise,305617,167684,54.87,0.6
1514,2021-03-16,MOL,614,230,384,267,347,ITF,ITF2,14,Molise,Molise,305617,168298,55.07,0.2
1515,2021-01-11,MOL,557,194,363,557,0,ITF,ITF2,14,Molise,Molise,305617,168855,55.25,0.18
1516,2021-01-25,MOL,319,130,189,3,316,ITF,ITF2,14,Molise,Molise,305617,169174,55.35,0.1
1517,2021-04-20,MOL,2318,1025,1293,1220,1098,ITF,ITF2,14,Molise,Molise,305617,171492,56.11,0.76
1518,2021-05-23,MOL,1698,863,835,1693,5,ITF,ITF2,14,Molise,Molise,305617,173190,56.67,0.56
1519,2021-04-03,MOL,1770,850,920,1735,35,ITF,ITF2,14,Molise,Molise,305617,174960,57.25,0.58
1520,2021-01-22,MOL,126,35,91,126,0,ITF,ITF2,14,Molise,Molise,305617,175086,57.29,0.04
1521,2021-03-01,MOL,661,274,387,447,214,ITF,ITF2,14,Molise,Molise,305617,175747,57.51,0.22
1522,2021-04-15,MOL,1923,793,1130,1079,844,ITF,ITF2,14,Molise,Molise,305617,177670,58.13,0.63
1523,2021-03-20,MOL,2321,968,1353,1000,1321,ITF,ITF2,14,Molise,Molise,305617,179991,58.89,0.76
1524,2021-05-06,MOL,2679,1214,1465,2081,598,ITF,ITF2,14,Molise,Molise,305617,182670,59.77,0.88
1525,2021-01-26,MOL,450,184,266,8,442,ITF,ITF2,14,Molise,Molise,305617,183120,59.92,0.15
1526,2021-03-17,MOL,908,385,523,576,332,ITF,ITF2,14,Molise,Molise,305617,184028,60.22,0.3
1527,2021-05-07,MOL,2641,1226,1415,2044,597,ITF,ITF2,14,Molise,Molise,305617,186669,61.08,0.86
1528,2021-03-18,MOL,1156,476,680,692,464,ITF,ITF2,14,Molise,Molise,305617,187825,61.46,0.38
1529,2021-05-21,MOL,2018,1011,1007,1707,311,ITF,ITF2,14,Molise,Molise,305617,189843,62.12,0.66
1530,2021-01-27,MOL,674,251,423,8,666,ITF,ITF2,14,Molise,Molise,305617,190517,62.34,0.22
1531,2021-04-01,MOL,1469,667,802,743,726,ITF,ITF2,14,Molise,Molise,305617,191986,62.82,0.48
1532,2021-02-10,MOL,150,78,72,130,20,ITF,ITF2,14,Molise,Molise,305617,192136,62.87,0.05
1533,2021-03-04,FVG,3445,1595,1850,2787,658,ITH,ITH4,6,Friuli-Venezia Giulia,Friuli Venezia Giulia,1215220,3445,0.28,0.28
1534,2021-05-24,FVG,10957,5252,5705,7496,3461,ITH,ITH4,6,Friuli-Venezia Giulia,Friuli Venezia Giulia,1215220,14402,1.19,0.9
1535,2021-03-21,FVG,2602,937,1665,2193,409,ITH,ITH4,6,Friuli-Venezia Giulia,Friuli Venezia Giulia,1215220,17004,1.4,0.21
1536,2021-02-15,FVG,2453,911,1542,2201,252,ITH,ITH4,6,Friuli-Venezia Giulia,Friuli Venezia Giulia,1215220,19457,1.6,0.2
1537,2021-04-20,FVG,7106,3059,4047,3203,3903,ITH,ITH4,6,Friuli-Venezia Giulia,Friuli Venezia Giulia,1215220,26563,2.19,0.58
1538,2021-05-07,FVG,10537,4815,5722,7070,3467,ITH,ITH4,6,Friuli-Venezia Giulia,Friuli Venezia Giulia,1215220,37100,3.05,0.87
1539,2021-04-11,FVG,3433,1520,1913,2527,906,ITH,ITH4,6,Friuli-Venezia Giulia,Friuli Venezia Giulia,1215220,40533,3.34,0.28
1540,2021-01-08,FVG,2322,747,1575,2322,0,ITH,ITH4,6,Friuli-Venezia Giulia,Friuli Venezia Giulia,1215220,42855,3.53,0.19
1541,2021-02-27,FVG,3528,1200,2328,3527,1,ITH,ITH4,6,Friuli-Venezia Giulia,Friuli Venezia Giulia,1215220,46383,3.82,0.29
1542,2021-04-25,FVG,2363,990,1373,2352,11,ITH,ITH4,6,Friuli-Venezia Giulia,Friuli Venezia Giulia,1215220,48746,4.01,0.19
1543,2021-02-20,FVG,2068,933,1135,1924,144,ITH,ITH4,6,Friuli-Venezia Giulia,Friuli Venezia Giulia,1215220,50814,4.18,0.17
1544,2021-05-31,FVG,7938,3855,4083,6156,1782,ITH,ITH4,6,Friuli-Venezia Giulia,Friuli Venezia Giulia,1215220,58752,4.83,0.65
1545,2021-01-15,FVG,2021,605,1416,2021,0,ITH,ITH4,6,Friuli-Venezia Giulia,Friuli Venezia Giulia,1215220,60773,5.0,0.17
1546,2021-01-22,FVG,90,30,60,0,90,ITH,ITH4,6,Friuli-Venezia Giulia,Friuli Venezia Giulia,1215220,60863,5.01,0.01
1547,2021-03-06,FVG,3499,1196,2303,3174,325,ITH,ITH4,6,Friuli-Venezia Giulia,Friuli Venezia Giulia,1215220,64362,5.3,0.29
1548,2021-04-18,FVG,6037,2799,3238,5630,407,ITH,ITH4,6,Friuli-Venezia Giulia,Friuli Venezia Giulia,1215220,70399,5.79,0.5
1549,2021-02-06,FVG,1154,338,816,22,1132,ITH,ITH4,6,Friuli-Venezia Giulia,Friuli Venezia Giulia,1215220,71553,5.89,0.09
1550,2021-01-04,FVG,1507,558,949,1507,0,ITH,ITH4,6,Friuli-Venezia Giulia,Friuli Venezia Giulia,1215220,73060,6.01,0.12
1551,2021-02-23,FVG,2617,1252,1365,2437,180,ITH,ITH4,6,Friuli-Venezia Giulia,Friuli Venezia Giulia,1215220,75677,6.23,0.22
1552,2021-03-09,FVG,3855,1589,2266,1108,2747,ITH,ITH4,6,Friuli-Venezia Giulia,Friuli Venezia Giulia,1215220,79532,6.54,0.32
1553,2021-03-13,FVG,2935,1120,1815,1664,1271,ITH,ITH4,6,Friuli-Venezia Giulia,Friuli Venezia Giulia,1215220,82467,6.79,0.24
1554,2021-05-16,FVG,9939,4759,5180,8545,1394,ITH,ITH4,6,Friuli-Venezia Giulia,Friuli Venezia Giulia,1215220,92406,7.6,0.82
1555,2021-01-25,FVG,1582,567,1015,194,1388,ITH,ITH4,6,Friuli-Venezia Giulia,Friuli Venezia Giulia,1215220,93988,7.73,0.13
1556,2021-04-28,FVG,7246,3194,4052,3782,3464,ITH,ITH4,6,Friuli-Venezia Giulia,Friuli Venezia Giulia,1215220,101234,8.33,0.6
1557,2021-01-16,FVG,1230,360,870,1230,0,ITH,ITH4,6,Friuli-Venezia Giulia,Friuli Venezia Giulia,1215220,102464,8.43,0.1
1558,2021-05-28,FVG,9651,4453,5198,5813,3838,ITH,ITH4,6,Friuli-Venezia Giulia,Friuli Venezia Giulia,1215220,112115,9.23,0.79
1559,2021-03-25,FVG,5309,2261,3048,3176,2133,ITH,ITH4,6,Friuli-Venezia Giulia,Friuli Venezia Giulia,1215220,117424,9.66,0.44
1560,2021-03-30,FVG,7094,3142,3952,6172,922,ITH,ITH4,6,Friuli-Venezia Giulia,Friuli Venezia Giulia,1215220,124518,10.25,0.58
1561,2021-04-23,FVG,7455,3375,4080,3599,3856,ITH,ITH4,6,Friuli-Venezia Giulia,Friuli Venezia Giulia,1215220,131973,10.86,0.61
1562,2021-03-20,FVG,3340,1351,1989,1249,2091,ITH,ITH4,6,Friuli-Venezia Giulia,Friuli Venezia Giulia,1215220,135313,11.13,0.27
1563,2021-03-18,FVG,3371,1421,1950,1690,1681,ITH,ITH4,6,Friuli-Venezia Giulia,Friuli Venezia Giulia,1215220,138684,11.41,0.28
1564,2021-01-13,FVG,2650,834,1816,2650,0,ITH,ITH4,6,Friuli-Venezia Giulia,Friuli Venezia Giulia,1215220,141334,11.63,0.22
1565,2021-01-06,FVG,710,264,446,710,0,ITH,ITH4,6,Friuli-Venezia Giulia,Friuli Venezia Giulia,1215220,142044,11.69,0.06
1566,2020-12-30,FVG,626,244,382,626,0,ITH,ITH4,6,Friuli-Venezia Giulia,Friuli Venezia Giulia,1215220,142670,11.74,0.05
1567,2021-02-25,FVG,3160,1651,1509,3135,25,ITH,ITH4,6,Friuli-Venezia Giulia,Friuli Venezia Giulia,1215220,145830,12.0,0.26
1568,2021-02-18,FVG,3218,1492,1726,2811,407,ITH,ITH4,6,Friuli-Venezia Giulia,Friuli Venezia Giulia,1215220,149048,12.27,0.26
1569,2021-04-02,FVG,6566,2915,3651,4733,1833,ITH,ITH4,6,Friuli-Venezia Giulia,Friuli Venezia Giulia,1215220,155614,12.81,0.54
1570,2021-04-16,FVG,6910,2995,3915,4987,1923,ITH,ITH4,6,Friuli-Venezia Giulia,Friuli Venezia Giulia,1215220,162524,13.37,0.57
1571,2021-02-11,FVG,1930,664,1266,1738,192,ITH,ITH4,6,Friuli-Venezia Giulia,Friuli Venezia Giulia,1215220,164454,13.53,0.16
1572,2021-04-09,FVG,7762,3528,4234,6518,1244,ITH,ITH4,6,Friuli-Venezia Giulia,Friuli Venezia Giulia,1215220,172216,14.17,0.64
1573,2021-04-30,FVG,7304,3217,4087,3691,3613,ITH,ITH4,6,Friuli-Venezia Giulia,Friuli Venezia Giulia,1215220,179520,14.77,0.6
1574,2021-02-04,FVG,2725,808,1917,35,2690,ITH,ITH4,6,Friuli-Venezia Giulia,Friuli Venezia Giulia,1215220,182245,15.0,0.22
1575,2021-03-11,FVG,3355,1413,1942,1605,1750,ITH,ITH4,6,Friuli-Venezia Giulia,Friuli Venezia Giulia,1215220,185600,15.27,0.28
1576,2021-01-20,FVG,748,320,428,13,735,ITH,ITH4,6,Friuli-Venezia Giulia,Friuli Venezia Giulia,1215220,186348,15.33,0.06
1577,2021-02-13,FVG,566,179,387,560,6,ITH,ITH4,6,Friuli-Venezia Giulia,Friuli Venezia Giulia,1215220,186914,15.38,0.05
1578,2021-03-02,FVG,4219,1519,2700,2720,1499,ITH,ITH4,6,Friuli-Venezia Giulia,Friuli Venezia Giulia,1215220,191133,15.73,0.35
1579,2021-01-27,FVG,1272,425,847,450,822,ITH,ITH4,6,Friuli-Venezia Giulia,Friuli Venezia Giulia,1215220,192405,15.83,0.1
1580,2021-05-09,FVG,7338,3295,4043,3484,3854,ITH,ITH4,6,Friuli-Venezia Giulia,Friuli Venezia Giulia,1215220,199743,16.44,0.6
1581,2021-05-26,FVG,12656,6283,6373,9413,3243,ITH,ITH4,6,Friuli-Venezia Giulia,Friuli Venezia Giulia,1215220,212399,17.48,1.04
1582,2021-03-16,FVG,3153,1287,1866,1073,2080,ITH,ITH4,6,Friuli-Venezia Giulia,Friuli Venezia Giulia,1215220,215552,17.74,0.26
1583,2021-05-12,FVG,10669,4937,5732,9314,1355,ITH,ITH4,6,Friuli-Venezia Giulia,Friuli Venezia Giulia,1215220,226221,18.62,0.88
1584,2021-05-19,FVG,11693,5737,5956,9467,2226,ITH,ITH4,6,Friuli-Venezia Giulia,Friuli Venezia Giulia,1215220,237914,19.58,0.96
1585,2021-03-14,FVG,1395,547,848,1143,252,ITH,ITH4,6,Friuli-Venezia Giulia,Friuli Venezia Giulia,1215220,239309,19.69,0.11
1586,2021-02-01,FVG,2097,688,1409,16,2081,ITH,ITH4,6,Friuli-Venezia Giulia,Friuli Venezia Giulia,1215220,241406,19.87,0.17
1587,2021-02-08,FVG,2357,694,1663,92,2265,ITH,ITH4,6,Friuli-Venezia Giulia,Friuli Venezia Giulia,1215220,243763,20.06,0.19
1588,2021-01-18,FVG,1961,606,1355,1867,94,ITH,ITH4,6,Friuli-Venezia Giulia,Friuli Venezia Giulia,1215220,245724,20.22,0.16
1589,2021-03-28,FVG,4810,2274,2536,4670,140,ITH,ITH4,6,Friuli-Venezia Giulia,Friuli Venezia Giulia,1215220,250534,20.62,0.4
1590,2021-05-17,FVG,8767,4073,4694,6290,2477,ITH,ITH4,6,Friuli-Venezia Giulia,Friuli Venezia Giulia,1215220,259301,21.34,0.72
1591,2021-01-30,FVG,2275,745,1530,270,2005,ITH,ITH4,6,Friuli-Venezia Giulia,Friuli Venezia Giulia,1215220,261576,21.52,0.19
1592,2021-04-21,FVG,7702,3439,4263,4022,3680,ITH,ITH4,6,Friuli-Venezia Giulia,Friuli Venezia Giulia,1215220,269278,22.16,0.63
1593,2021-01-11,FVG,1882,608,1274,1882,0,ITH,ITH4,6,Friuli-Venezia Giulia,Friuli Venezia Giulia,1215220,271160,22.31,0.15
1594,2021-03-01,FVG,2957,1041,1916,2905,52,ITH,ITH4,6,Friuli-Venezia Giulia,Friuli Venezia Giulia,1215220,274117,22.56,0.24
1595,2020-12-27,FVG,262,149,113,262,0,ITH,ITH4,6,Friuli-Venezia Giulia,Friuli Venezia Giulia,1215220,274379,22.58,0.02
1596,2021-01-12,FVG,2260,713,1547,2260,0,ITH,ITH4,6,Friuli-Venezia Giulia,Friuli Venezia Giulia,1215220,276639,22.76,0.19
1597,2021-01-29,FVG,2414,814,1600,264,2150,ITH,ITH4,6,Friuli-Venezia Giulia,Friuli Venezia Giulia,1215220,279053,22.96,0.2
1598,2021-04-03,FVG,3982,1968,2014,2654,1328,ITH,ITH4,6,Friuli-Venezia Giulia,Friuli Venezia Giulia,1215220,283035,23.29,0.33
1599,2021-04-07,FVG,7494,3321,4173,6713,781,ITH,ITH4,6,Friuli-Venezia Giulia,Friuli Venezia Giulia,1215220,290529,23.91,0.62
1600,2021-03-23,FVG,3753,1558,2195,1613,2140,ITH,ITH4,6,Friuli-Venezia Giulia,Friuli Venezia Giulia,1215220,294282,24.22,0.31
1601,2021-01-23,FVG,816,324,492,4,812,ITH,ITH4,6,Friuli-Venezia Giulia,Friuli Venezia Giulia,1215220,295098,24.28,0.07
1602,2021-05-05,FVG,9707,4230,5477,6266,3441,ITH,ITH4,6,Friuli-Venezia Giulia,Friuli Venezia Giulia,1215220,304805,25.08,0.8
1603,2021-04-01,FVG,6315,2993,3322,5300,1015,ITH,ITH4,6,Friuli-Venezia Giulia,Friuli Venezia Giulia,1215220,311120,25.6,0.52
1604,2021-04-27,FVG,8077,3703,4374,3619,4458,ITH,ITH4,6,Friuli-Venezia Giulia,Friuli Venezia Giulia,1215220,319197,26.27,0.66
1605,2021-04-08,FVG,7207,3014,4193,5287,1920,ITH,ITH4,6,Friuli-Venezia Giulia,Friuli Venezia Giulia,1215220,326404,26.86,0.59
1606,2021-02-10,FVG,1352,496,856,1266,86,ITH,ITH4,6,Friuli-Venezia Giulia,Friuli Venezia Giulia,1215220,327756,26.97,0.11
1607,2021-02-03,FVG,2647,791,1856,23,2624,ITH,ITH4,6,Friuli-Venezia Giulia,Friuli Venezia Giulia,1215220,330403,27.19,0.22
1608,2021-05-21,FVG,11011,4898,6113,8136,2875,ITH,ITH4,6,Friuli-Venezia Giulia,Friuli Venezia Giulia,1215220,341414,28.09,0.91
1609,2021-05-14,FVG,10555,5228,5327,8083,2472,ITH,ITH4,6,Friuli-Venezia Giulia,Friuli Venezia Giulia,1215220,351969,28.96,0.87
1610,2021-05-06,FVG,11863,5512,6351,7910,3953,ITH,ITH4,6,Friuli-Venezia Giulia,Friuli Venezia Giulia,1215220,363832,29.94,0.98
1611,2021-03-17,FVG,3231,1265,1966,743,2488,ITH,ITH4,6,Friuli-Venezia Giulia,Friuli Venezia Giulia,1215220,367063,30.21,0.27
1612,2021-02-16,FVG,2516,1135,1381,2400,116,ITH,ITH4,6,Friuli-Venezia Giulia,Friuli Venezia Giulia,1215220,369579,30.41,0.21
1613,2021-05-20,FVG,12364,6069,6295,9949,2415,ITH,ITH4,6,Friuli-Venezia Giulia,Friuli Venezia Giulia,1215220,381943,31.43,1.02
1614,2021-02-19,FVG,3251,1289,1962,2824,427,ITH,ITH4,6,Friuli-Venezia Giulia,Friuli Venezia Giulia,1215220,385194,31.7,0.27
1615,2021-04-24,FVG,6674,2945,3729,5432,1242,ITH,ITH4,6,Friuli-Venezia Giulia,Friuli Venezia Giulia,1215220,391868,32.25,0.55
1616,2021-05-03,FVG,7178,3270,3908,3404,3774,ITH,ITH4,6,Friuli-Venezia Giulia,Friuli Venezia Giulia,1215220,399046,32.84,0.59
1617,2021-02-28,FVG,2685,1002,1683,2292,393,ITH,ITH4,6,Friuli-Venezia Giulia,Friuli Venezia Giulia,1215220,401731,33.06,0.22
1618,2021-05-13,FVG,10994,5282,5712,8995,1999,ITH,ITH4,6,Friuli-Venezia Giulia,Friuli Venezia Giulia,1215220,412725,33.96,0.9
1619,2021-02-09,FVG,1842,555,1287,1556,286,ITH,ITH4,6,Friuli-Venezia Giulia,Friuli Venezia Giulia,1215220,414567,34.11,0.15
1620,2021-03-24,FVG,3766,1530,2236,2286,1480,ITH,ITH4,6,Friuli-Venezia Giulia,Friuli Venezia Giulia,1215220,418333,34.42,0.31
1621,2021-01-26,FVG,1977,647,1330,217,1760,ITH,ITH4,6,Friuli-Venezia Giulia,Friuli Venezia Giulia,1215220,420310,34.59,0.16
1622,2021-02-12,FVG,1193,428,765,1146,47,ITH,ITH4,6,Friuli-Venezia Giulia,Friuli Venezia Giulia,1215220,421503,34.69,0.1
1623,2021-03-03,FVG,3639,1627,2012,2365,1274,ITH,ITH4,6,Friuli-Venezia Giulia,Friuli Venezia Giulia,1215220,425142,34.98,0.3
1624,2021-01-28,FVG,2239,794,1445,354,1885,ITH,ITH4,6,Friuli-Venezia Giulia,Friuli Venezia Giulia,1215220,427381,35.17,0.18
1625,2021-05-08,FVG,10248,4631,5617,5470,4778,ITH,ITH4,6,Friuli-Venezia Giulia,Friuli Venezia Giulia,1215220,437629,36.01,0.84
1626,2021-05-02,FVG,6838,3210,3628,3939,2899,ITH,ITH4,6,Friuli-Venezia Giulia,Friuli Venezia Giulia,1215220,444467,36.58,0.56
1627,2021-04-29,FVG,6683,2932,3751,4162,2521,ITH,ITH4,6,Friuli-Venezia Giulia,Friuli Venezia Giulia,1215220,451150,37.12,0.55
1628,2021-02-24,FVG,2520,1084,1436,2502,18,ITH,ITH4,6,Friuli-Venezia Giulia,Friuli Venezia Giulia,1215220,453670,37.33,0.21
1629,2021-04-15,FVG,6487,2859,3628,5216,1271,ITH,ITH4,6,Friuli-Venezia Giulia,Friuli Venezia Giulia,1215220,460157,37.87,0.53
1630,2021-05-15,FVG,12590,6069,6521,7913,4677,ITH,ITH4,6,Friuli-Venezia Giulia,Friuli Venezia Giulia,1215220,472747,38.9,1.04
1631,2021-01-21,FVG,896,345,551,1,895,ITH,ITH4,6,Friuli-Venezia Giulia,Friuli Venezia Giulia,1215220,473643,38.98,0.07
1632,2021-03-26,FVG,5801,2425,3376,3789,2012,ITH,ITH4,6,Friuli-Venezia Giulia,Friuli Venezia Giulia,1215220,479444,39.45,0.48
1633,2021-05-01,FVG,7185,3244,3941,6142,1043,ITH,ITH4,6,Friuli-Venezia Giulia,Friuli Venezia Giulia,1215220,486629,40.04,0.59
1634,2021-03-12,FVG,3938,1544,2394,2557,1381,ITH,ITH4,6,Friuli-Venezia Giulia,Friuli Venezia Giulia,1215220,490567,40.37,0.32
1635,2021-05-29,FVG,11856,5765,6091,6956,4900,ITH,ITH4,6,Friuli-Venezia Giulia,Friuli Venezia Giulia,1215220,502423,41.34,0.98
1636,2021-05-22,FVG,11470,5150,6320,7263,4207,ITH,ITH4,6,Friuli-Venezia Giulia,Friuli Venezia Giulia,1215220,513893,42.29,0.94
1637,2021-01-09,FVG,2513,841,1672,2513,0,ITH,ITH4,6,Friuli-Venezia Giulia,Friuli Venezia Giulia,1215220,516406,42.49,0.21
1638,2021-03-07,FVG,2547,932,1615,2546,1,ITH,ITH4,6,Friuli-Venezia Giulia,Friuli Venezia Giulia,1215220,518953,42.7,0.21
1639,2021-04-19,FVG,6705,3131,3574,3293,3412,ITH,ITH4,6,Friuli-Venezia Giulia,Friuli Venezia Giulia,1215220,525658,43.26,0.55
1640,2021-04-05,FVG,2868,1425,1443,2853,15,ITH,ITH4,6,Friuli-Venezia Giulia,Friuli Venezia Giulia,1215220,528526,43.49,0.24
1641,2021-01-10,FVG,2939,918,2021,2939,0,ITH,ITH4,6,Friuli-Venezia Giulia,Friuli Venezia Giulia,1215220,531465,43.73,0.24
1642,2021-04-22,FVG,6755,3073,3682,3079,3676,ITH,ITH4,6,Friuli-Venezia Giulia,Friuli Venezia Giulia,1215220,538220,44.29,0.56
1643,2021-03-19,FVG,3234,1339,1895,1301,1933,ITH,ITH4,6,Friuli-Venezia Giulia,Friuli Venezia Giulia,1215220,541454,44.56,0.27
1644,2021-04-06,FVG,6276,2771,3505,5126,1150,ITH,ITH4,6,Friuli-Venezia Giulia,Friuli Venezia Giulia,1215220,547730,45.07,0.52
1645,2021-05-25,FVG,12372,6037,6335,9204,3168,ITH,ITH4,6,Friuli-Venezia Giulia,Friuli Venezia Giulia,1215220,560102,46.09,1.02
1646,2021-05-10,FVG,7911,3514,4397,6372,1539,ITH,ITH4,6,Friuli-Venezia Giulia,Friuli Venezia Giulia,1215220,568013,46.74,0.65
1647,2021-05-27,FVG,12158,5746,6412,7152,5006,ITH,ITH4,6,Friuli-Venezia Giulia,Friuli Venezia Giulia,1215220,580171,47.74,1.0
1648,2021-02-26,FVG,3734,2092,1642,3586,148,ITH,ITH4,6,Friuli-Venezia Giulia,Friuli Venezia Giulia,1215220,583905,48.05,0.31
1649,2021-02-17,FVG,2353,999,1354,1873,480,ITH,ITH4,6,Friuli-Venezia Giulia,Friuli Venezia Giulia,1215220,586258,48.24,0.19
1650,2021-05-30,FVG,11034,4977,6057,7457,3577,ITH,ITH4,6,Friuli-Venezia Giulia,Friuli Venezia Giulia,1215220,597292,49.15,0.91
1651,2021-04-26,FVG,5444,2445,2999,3796,1648,ITH,ITH4,6,Friuli-Venezia Giulia,Friuli Venezia Giulia,1215220,602736,49.6,0.45
1652,2021-01-14,FVG,2584,789,1795,2584,0,ITH,ITH4,6,Friuli-Venezia Giulia,Friuli Venezia Giulia,1215220,605320,49.81,0.21
1653,2021-04-17,FVG,7447,3232,4215,5965,1482,ITH,ITH4,6,Friuli-Venezia Giulia,Friuli Venezia Giulia,1215220,612767,50.42,0.61
1654,2021-04-10,FVG,4985,2164,2821,3760,1225,ITH,ITH4,6,Friuli-Venezia Giulia,Friuli Venezia Giulia,1215220,617752,50.83,0.41
1655,2021-05-23,FVG,10249,4843,5406,6110,4139,ITH,ITH4,6,Friuli-Venezia Giulia,Friuli Venezia Giulia,1215220,628001,51.68,0.84
1656,2021-02-02,FVG,2467,806,1661,217,2250,ITH,ITH4,6,Friuli-Venezia Giulia,Friuli Venezia Giulia,1215220,630468,51.88,0.2
1657,2021-01-24,FVG,305,119,186,1,304,ITH,ITH4,6,Friuli-Venezia Giulia,Friuli Venezia Giulia,1215220,630773,51.91,0.03
1658,2021-03-22,FVG,3541,1343,2198,1586,1955,ITH,ITH4,6,Friuli-Venezia Giulia,Friuli Venezia Giulia,1215220,634314,52.2,0.29
1659,2021-01-31,FVG,2715,836,1879,385,2330,ITH,ITH4,6,Friuli-Venezia Giulia,Friuli Venezia Giulia,1215220,637029,52.42,0.22
1660,2021-05-04,FVG,9502,4284,5218,6150,3352,ITH,ITH4,6,Friuli-Venezia Giulia,Friuli Venezia Giulia,1215220,646531,53.2,0.78
1661,2021-03-08,FVG,4063,1593,2470,1978,2085,ITH,ITH4,6,Friuli-Venezia Giulia,Friuli Venezia Giulia,1215220,650594,53.54,0.33
1662,2021-01-17,FVG,1716,523,1193,1716,0,ITH,ITH4,6,Friuli-Venezia Giulia,Friuli Venezia Giulia,1215220,652310,53.68,0.14
1663,2021-03-15,FVG,3765,1636,2129,1446,2319,ITH,ITH4,6,Friuli-Venezia Giulia,Friuli Venezia Giulia,1215220,656075,53.99,0.31
1664,2021-05-11,FVG,8910,4267,4643,7122,1788,ITH,ITH4,6,Friuli-Venezia Giulia,Friuli Venezia Giulia,1215220,664985,54.72,0.73
1665,2021-03-10,FVG,3358,1493,1865,1566,1792,ITH,ITH4,6,Friuli-Venezia Giulia,Friuli Venezia Giulia,1215220,668343,55.0,0.28
1666,2021-01-05,FVG,1678,551,1127,1678,0,ITH,ITH4,6,Friuli-Venezia Giulia,Friuli Venezia Giulia,1215220,670021,55.14,0.14
1667,2021-03-27,FVG,4985,2560,2425,3574,1411,ITH,ITH4,6,Friuli-Venezia Giulia,Friuli Venezia Giulia,1215220,675006,55.55,0.41
1668,2021-02-05,FVG,2614,785,1829,90,2524,ITH,ITH4,6,Friuli-Venezia Giulia,Friuli Venezia Giulia,1215220,677620,55.76,0.22
1669,2021-04-14,FVG,7216,3119,4097,5504,1712,ITH,ITH4,6,Friuli-Venezia Giulia,Friuli Venezia Giulia,1215220,684836,56.35,0.59
1670,2021-01-19,FVG,6,2,4,6,0,ITH,ITH4,6,Friuli-Venezia Giulia,Friuli Venezia Giulia,1215220,684842,56.36,0.0
1671,2021-03-31,FVG,8030,3500,4530,7185,845,ITH,ITH4,6,Friuli-Venezia Giulia,Friuli Venezia Giulia,1215220,692872,57.02,0.66
1672,2021-01-07,FVG,2090,717,1373,2090,0,ITH,ITH4,6,Friuli-Venezia Giulia,Friuli Venezia Giulia,1215220,694962,57.19,0.17
1673,2021-03-05,FVG,3736,1478,2258,2663,1073,ITH,ITH4,6,Friuli-Venezia Giulia,Friuli Venezia Giulia,1215220,698698,57.5,0.31
1674,2020-12-31,FVG,1053,384,669,1053,0,ITH,ITH4,6,Friuli-Venezia Giulia,Friuli Venezia Giulia,1215220,699751,57.58,0.09
1675,2021-01-03,FVG,312,122,190,312,0,ITH,ITH4,6,Friuli-Venezia Giulia,Friuli Venezia Giulia,1215220,700063,57.61,0.03
1676,2021-02-22,FVG,2485,1193,1292,2067,418,ITH,ITH4,6,Friuli-Venezia Giulia,Friuli Venezia Giulia,1215220,702548,57.81,0.2
1677,2021-04-13,FVG,7362,3289,4073,5758,1604,ITH,ITH4,6,Friuli-Venezia Giulia,Friuli Venezia Giulia,1215220,709910,58.42,0.61
1678,2021-02-07,FVG,1561,483,1078,386,1175,ITH,ITH4,6,Friuli-Venezia Giulia,Friuli Venezia Giulia,1215220,711471,58.55,0.13
1679,2021-05-18,FVG,10555,5266,5289,8539,2016,ITH,ITH4,6,Friuli-Venezia Giulia,Friuli Venezia Giulia,1215220,722026,59.42,0.87
1680,2021-03-29,FVG,6873,3000,3873,5294,1579,ITH,ITH4,6,Friuli-Venezia Giulia,Friuli Venezia Giulia,1215220,728899,59.98,0.57
1681,2021-01-02,FVG,1216,470,746,1216,0,ITH,ITH4,6,Friuli-Venezia Giulia,Friuli Venezia Giulia,1215220,730115,60.08,0.1
1682,2021-02-21,FVG,801,281,520,423,378,ITH,ITH4,6,Friuli-Venezia Giulia,Friuli Venezia Giulia,1215220,730916,60.15,0.07
1683,2021-04-12,FVG,7253,3181,4072,6122,1131,ITH,ITH4,6,Friuli-Venezia Giulia,Friuli Venezia Giulia,1215220,738169,60.74,0.6
1684,2021-03-02,PIE,11202,4506,6696,10386,816,ITC,ITC1,1,Piemonte,Piemonte,4356406,11202,0.26,0.26
1685,2021-02-13,PIE,4153,1334,2819,2931,1222,ITC,ITC1,1,Piemonte,Piemonte,4356406,15355,0.35,0.1
1686,2021-05-26,PIE,32081,14621,17460,15558,16523,ITC,ITC1,1,Piemonte,Piemonte,4356406,47436,1.09,0.74
1687,2021-01-27,PIE,4196,1453,2743,999,3197,ITC,ITC1,1,Piemonte,Piemonte,4356406,51632,1.19,0.1
1688,2021-05-09,PIE,27049,12897,14152,13442,13607,ITC,ITC1,1,Piemonte,Piemonte,4356406,78681,1.81,0.62
1689,2020-12-28,PIE,1,1,0,1,0,ITC,ITC1,1,Piemonte,Piemonte,4356406,78682,1.81,0.0
1690,2021-04-18,PIE,22951,10817,12134,20197,2754,ITC,ITC1,1,Piemonte,Piemonte,4356406,101633,2.33,0.53
1691,2021-01-15,PIE,9113,3011,6102,9113,0,ITC,ITC1,1,Piemonte,Piemonte,4356406,110746,2.54,0.21
1692,2021-02-27,PIE,12691,4851,7840,12346,345,ITC,ITC1,1,Piemonte,Piemonte,4356406,123437,2.83,0.29
1693,2021-04-25,PIE,20223,9303,10920,17722,2501,ITC,ITC1,1,Piemonte,Piemonte,4356406,143660,3.3,0.46
1694,2021-05-02,PIE,25043,11261,13782,14298,10745,ITC,ITC1,1,Piemonte,Piemonte,4356406,168703,3.87,0.57
1695,2021-03-13,PIE,13044,4720,8324,11600,1444,ITC,ITC1,1,Piemonte,Piemonte,4356406,181747,4.17,0.3
1696,2021-01-08,PIE,5531,1761,3770,5531,0,ITC,ITC1,1,Piemonte,Piemonte,4356406,187278,4.3,0.13
1697,2021-05-17,PIE,30612,14371,16241,17674,12938,ITC,ITC1,1,Piemonte,Piemonte,4356406,217890,5.0,0.7
1698,2021-03-28,PIE,16054,6899,9155,8433,7621,ITC,ITC1,1,Piemonte,Piemonte,4356406,233944,5.37,0.37
1699,2021-01-18,PIE,6166,2048,4118,5917,249,ITC,ITC1,1,Piemonte,Piemonte,4356406,240110,5.51,0.14
1700,2021-05-31,PIE,28682,13789,14893,20396,8286,ITC,ITC1,1,Piemonte,Piemonte,4356406,268792,6.17,0.66
1701,2021-01-01,PIE,1038,395,643,1038,0,ITC,ITC1,1,Piemonte,Piemonte,4356406,269830,6.19,0.02
1702,2021-01-23,PIE,4257,1325,2932,879,3378,ITC,ITC1,1,Piemonte,Piemonte,4356406,274087,6.29,0.1
1703,2021-03-23,PIE,13070,5447,7623,6826,6244,ITC,ITC1,1,Piemonte,Piemonte,4356406,287157,6.59,0.3
1704,2021-05-05,PIE,32102,15024,17078,19093,13009,ITC,ITC1,1,Piemonte,Piemonte,4356406,319259,7.33,0.74
1705,2021-04-01,PIE,19329,8073,11256,11209,8120,ITC,ITC1,1,Piemonte,Piemonte,4356406,338588,7.77,0.44
1706,2021-04-23,PIE,27434,12597,14837,20672,6762,ITC,ITC1,1,Piemonte,Piemonte,4356406,366022,8.4,0.63
1707,2021-03-18,PIE,11756,4803,6953,4029,7727,ITC,ITC1,1,Piemonte,Piemonte,4356406,377778,8.67,0.27
1708,2021-03-20,PIE,11921,4898,7023,6023,5898,ITC,ITC1,1,Piemonte,Piemonte,4356406,389699,8.95,0.27
1709,2021-02-11,PIE,6764,2107,4657,3006,3758,ITC,ITC1,1,Piemonte,Piemonte,4356406,396463,9.1,0.16
1710,2021-04-09,PIE,25847,11387,14460,21338,4509,ITC,ITC1,1,Piemonte,Piemonte,4356406,422310,9.69,0.59
1711,2021-04-02,PIE,20130,8298,11832,11703,8427,ITC,ITC1,1,Piemonte,Piemonte,4356406,442440,10.16,0.46
1712,2021-05-29,PIE,32584,15134,17450,20463,12121,ITC,ITC1,1,Piemonte,Piemonte,4356406,475024,10.9,0.75
1713,2020-12-30,PIE,730,322,408,730,0,ITC,ITC1,1,Piemonte,Piemonte,4356406,475754,10.92,0.02
1714,2021-02-25,PIE,12218,5252,6966,11671,547,ITC,ITC1,1,Piemonte,Piemonte,4356406,487972,11.2,0.28
1715,2021-02-18,PIE,4789,2093,2696,4359,430,ITC,ITC1,1,Piemonte,Piemonte,4356406,492761,11.31,0.11
1716,2021-04-16,PIE,28385,13204,15181,23403,4982,ITC,ITC1,1,Piemonte,Piemonte,4356406,521146,11.96,0.65
1717,2021-01-13,PIE,10080,3223,6857,10080,0,ITC,ITC1,1,Piemonte,Piemonte,4356406,531226,12.19,0.23
1718,2021-01-06,PIE,3116,1111,2005,3116,0,ITC,ITC1,1,Piemonte,Piemonte,4356406,534342,12.27,0.07
1719,2021-02-04,PIE,10203,3339,6864,588,9615,ITC,ITC1,1,Piemonte,Piemonte,4356406,544545,12.5,0.23
1720,2021-04-30,PIE,31754,14261,17493,18428,13326,ITC,ITC1,1,Piemonte,Piemonte,4356406,576299,13.23,0.73
1721,2021-03-11,PIE,13771,5075,8696,10675,3096,ITC,ITC1,1,Piemonte,Piemonte,4356406,590070,13.54,0.32
1722,2021-01-20,PIE,6616,2089,4527,5899,717,ITC,ITC1,1,Piemonte,Piemonte,4356406,596686,13.7,0.15
1723,2021-03-25,PIE,17062,7203,9859,8423,8639,ITC,ITC1,1,Piemonte,Piemonte,4356406,613748,14.09,0.39
1724,2021-02-03,PIE,10199,3303,6896,611,9588,ITC,ITC1,1,Piemonte,Piemonte,4356406,623947,14.32,0.23
1725,2021-05-24,PIE,28526,13064,15462,16964,11562,ITC,ITC1,1,Piemonte,Piemonte,4356406,652473,14.98,0.65
1726,2021-05-07,PIE,32943,15548,17395,18900,14043,ITC,ITC1,1,Piemonte,Piemonte,4356406,685416,15.73,0.76
1727,2021-03-04,PIE,14495,5734,8761,11547,2948,ITC,ITC1,1,Piemonte,Piemonte,4356406,699911,16.07,0.33
1728,2021-04-20,PIE,25453,11655,13798,19109,6344,ITC,ITC1,1,Piemonte,Piemonte,4356406,725364,16.65,0.58
1729,2021-02-15,PIE,4432,1597,2835,3227,1205,ITC,ITC1,1,Piemonte,Piemonte,4356406,729796,16.75,0.1
1730,2021-03-14,PIE,8204,3335,4869,5308,2896,ITC,ITC1,1,Piemonte,Piemonte,4356406,738000,16.94,0.19
1731,2021-05-10,PIE,28664,13736,14928,15650,13014,ITC,ITC1,1,Piemonte,Piemonte,4356406,766664,17.6,0.66
1732,2021-05-19,PIE,32864,15115,17749,21948,10916,ITC,ITC1,1,Piemonte,Piemonte,4356406,799528,18.35,0.75
1733,2021-01-30,PIE,5980,2136,3844,218,5762,ITC,ITC1,1,Piemonte,Piemonte,4356406,805508,18.49,0.14
1734,2021-03-16,PIE,10520,4268,6252,4463,6057,ITC,ITC1,1,Piemonte,Piemonte,4356406,816028,18.73,0.24
1735,2021-05-12,PIE,31638,15042,16596,18932,12706,ITC,ITC1,1,Piemonte,Piemonte,4356406,847666,19.46,0.73
1736,2021-02-08,PIE,6916,2355,4561,666,6250,ITC,ITC1,1,Piemonte,Piemonte,4356406,854582,19.62,0.16
1737,2021-02-01,PIE,8645,3055,5590,579,8066,ITC,ITC1,1,Piemonte,Piemonte,4356406,863227,19.82,0.2
1738,2021-01-04,PIE,5564,1679,3885,5564,0,ITC,ITC1,1,Piemonte,Piemonte,4356406,868791,19.94,0.13
1739,2021-04-28,PIE,25958,11691,14267,15954,10004,ITC,ITC1,1,Piemonte,Piemonte,4356406,894749,20.54,0.6
1740,2021-02-23,PIE,9233,3713,5520,8653,580,ITC,ITC1,1,Piemonte,Piemonte,4356406,903982,20.75,0.21
1741,2021-04-11,PIE,20824,9317,11507,18663,2161,ITC,ITC1,1,Piemonte,Piemonte,4356406,924806,21.23,0.48
1742,2021-02-06,PIE,7995,2666,5329,400,7595,ITC,ITC1,1,Piemonte,Piemonte,4356406,932801,21.41,0.18
1743,2021-03-09,PIE,13964,5429,8535,11622,2342,ITC,ITC1,1,Piemonte,Piemonte,4356406,946765,21.73,0.32
1744,2021-02-20,PIE,3833,1253,2580,3659,174,ITC,ITC1,1,Piemonte,Piemonte,4356406,950598,21.82,0.09
1745,2021-04-21,PIE,25704,11816,13888,20371,5333,ITC,ITC1,1,Piemonte,Piemonte,4356406,976302,22.41,0.59
1746,2021-04-04,PIE,9254,4059,5195,6541,2713,ITC,ITC1,1,Piemonte,Piemonte,4356406,985556,22.62,0.21
1747,2021-01-11,PIE,8744,2980,5764,8744,0,ITC,ITC1,1,Piemonte,Piemonte,4356406,994300,22.82,0.2
1748,2021-04-06,PIE,20239,8809,11430,15043,5196,ITC,ITC1,1,Piemonte,Piemonte,4356406,1014539,23.29,0.46
1749,2020-12-27,PIE,913,369,544,913,0,ITC,ITC1,1,Piemonte,Piemonte,4356406,1015452,23.31,0.02
1750,2021-01-10,PIE,5214,2275,2939,5214,0,ITC,ITC1,1,Piemonte,Piemonte,4356406,1020666,23.43,0.12
1751,2021-04-22,PIE,27627,12711,14916,20931,6696,ITC,ITC1,1,Piemonte,Piemonte,4356406,1048293,24.06,0.63
1752,2021-04-05,PIE,14746,6233,8513,12189,2557,ITC,ITC1,1,Piemonte,Piemonte,4356406,1063039,24.4,0.34
1753,2021-03-19,PIE,11019,4511,6508,4414,6605,ITC,ITC1,1,Piemonte,Piemonte,4356406,1074058,24.65,0.25
1754,2021-01-16,PIE,7771,2630,5141,7771,0,ITC,ITC1,1,Piemonte,Piemonte,4356406,1081829,24.83,0.18
1755,2021-03-21,PIE,10723,4738,5985,4189,6534,ITC,ITC1,1,Piemonte,Piemonte,4356406,1092552,25.08,0.25
1756,2021-03-30,PIE,16891,7033,9858,9020,7871,ITC,ITC1,1,Piemonte,Piemonte,4356406,1109443,25.47,0.39
1757,2021-01-25,PIE,6215,1938,4277,983,5232,ITC,ITC1,1,Piemonte,Piemonte,4356406,1115658,25.61,0.14
1758,2021-05-28,PIE,34464,16200,18264,18837,15627,ITC,ITC1,1,Piemonte,Piemonte,4356406,1150122,26.4,0.79
1759,2021-05-14,PIE,33267,16190,17077,17913,15354,ITC,ITC1,1,Piemonte,Piemonte,4356406,1183389,27.16,0.76
1760,2021-05-21,PIE,35810,16592,19218,20340,15470,ITC,ITC1,1,Piemonte,Piemonte,4356406,1219199,27.99,0.82
1761,2021-03-06,PIE,13994,5211,8783,11205,2789,ITC,ITC1,1,Piemonte,Piemonte,4356406,1233193,28.31,0.32
1762,2021-01-22,PIE,3867,1249,2618,2526,1341,ITC,ITC1,1,Piemonte,Piemonte,4356406,1237060,28.4,0.09
1763,2021-05-13,PIE,35376,17285,18091,20518,14858,ITC,ITC1,1,Piemonte,Piemonte,4356406,1272436,29.21,0.81
1764,2021-05-27,PIE,36873,17070,19803,19038,17835,ITC,ITC1,1,Piemonte,Piemonte,4356406,1309309,30.05,0.85
1765,2021-03-24,PIE,15505,6341,9164,6378,9127,ITC,ITC1,1,Piemonte,Piemonte,4356406,1324814,30.41,0.36
1766,2021-03-31,PIE,19106,8102,11004,10413,8693,ITC,ITC1,1,Piemonte,Piemonte,4356406,1343920,30.85,0.44
1767,2021-05-30,PIE,27667,13167,14500,18362,9305,ITC,ITC1,1,Piemonte,Piemonte,4356406,1371587,31.48,0.64
1768,2021-02-17,PIE,4793,2156,2637,3803,990,ITC,ITC1,1,Piemonte,Piemonte,4356406,1376380,31.59,0.11
1769,2021-02-26,PIE,12293,4933,7360,11556,737,ITC,ITC1,1,Piemonte,Piemonte,4356406,1388673,31.88,0.28
1770,2021-04-26,PIE,19750,8731,11019,15351,4399,ITC,ITC1,1,Piemonte,Piemonte,4356406,1408423,32.33,0.45
1771,2021-05-20,PIE,38256,17695,20561,13544,24712,ITC,ITC1,1,Piemonte,Piemonte,4356406,1446679,33.21,0.88
1772,2021-02-02,PIE,10241,3509,6732,816,9425,ITC,ITC1,1,Piemonte,Piemonte,4356406,1456920,33.44,0.24
1773,2021-02-16,PIE,3967,1756,2211,3209,758,ITC,ITC1,1,Piemonte,Piemonte,4356406,1460887,33.53,0.09
1774,2021-05-23,PIE,28666,13122,15544,15745,12921,ITC,ITC1,1,Piemonte,Piemonte,4356406,1489553,34.19,0.66
1775,2021-03-03,PIE,12120,4644,7476,11301,819,ITC,ITC1,1,Piemonte,Piemonte,4356406,1501673,34.47,0.28
1776,2021-05-06,PIE,33210,15629,17581,19759,13451,ITC,ITC1,1,Piemonte,Piemonte,4356406,1534883,35.23,0.76
1777,2021-02-12,PIE,6891,2215,4676,3930,2961,ITC,ITC1,1,Piemonte,Piemonte,4356406,1541774,35.39,0.16
1778,2021-01-26,PIE,6331,1879,4452,735,5596,ITC,ITC1,1,Piemonte,Piemonte,4356406,1548105,35.54,0.15
1779,2021-05-08,PIE,34113,16182,17931,18487,15626,ITC,ITC1,1,Piemonte,Piemonte,4356406,1582218,36.32,0.78
1780,2021-01-28,PIE,5591,1809,3782,384,5207,ITC,ITC1,1,Piemonte,Piemonte,4356406,1587809,36.45,0.13
1781,2021-02-05,PIE,9601,3138,6463,659,8942,ITC,ITC1,1,Piemonte,Piemonte,4356406,1597410,36.67,0.22
1782,2021-03-27,PIE,18384,7827,10557,9553,8831,ITC,ITC1,1,Piemonte,Piemonte,4356406,1615794,37.09,0.42
1783,2021-03-10,PIE,13634,5169,8465,11340,2294,ITC,ITC1,1,Piemonte,Piemonte,4356406,1629428,37.4,0.31
1784,2021-01-19,PIE,6466,2105,4361,6454,12,ITC,ITC1,1,Piemonte,Piemonte,4356406,1635894,37.55,0.15
1785,2021-04-14,PIE,27702,12558,15144,23181,4521,ITC,ITC1,1,Piemonte,Piemonte,4356406,1663596,38.19,0.64
1786,2021-05-01,PIE,28526,12993,15533,16728,11798,ITC,ITC1,1,Piemonte,Piemonte,4356406,1692122,38.84,0.65
1787,2021-01-21,PIE,6923,2318,4605,3427,3496,ITC,ITC1,1,Piemonte,Piemonte,4356406,1699045,39.0,0.16
1788,2021-05-15,PIE,33574,15661,17913,19960,13614,ITC,ITC1,1,Piemonte,Piemonte,4356406,1732619,39.77,0.77
1789,2021-03-07,PIE,11976,4658,7318,11099,877,ITC,ITC1,1,Piemonte,Piemonte,4356406,1744595,40.05,0.27
1790,2021-04-03,PIE,19430,8156,11274,10883,8547,ITC,ITC1,1,Piemonte,Piemonte,4356406,1764025,40.49,0.45
1791,2021-01-29,PIE,5943,1886,4057,455,5488,ITC,ITC1,1,Piemonte,Piemonte,4356406,1769968,40.63,0.14
1792,2021-01-12,PIE,10089,3415,6674,10089,0,ITC,ITC1,1,Piemonte,Piemonte,4356406,1780057,40.86,0.23
1793,2021-03-17,PIE,12518,5055,7463,5224,7294,ITC,ITC1,1,Piemonte,Piemonte,4356406,1792575,41.15,0.29
1794,2021-02-28,PIE,10816,4060,6756,10576,240,ITC,ITC1,1,Piemonte,Piemonte,4356406,1803391,41.4,0.25
1795,2021-03-01,PIE,12041,4845,7196,11232,809,ITC,ITC1,1,Piemonte,Piemonte,4356406,1815432,41.67,0.28
1796,2021-05-25,PIE,30937,14338,16599,15905,15032,ITC,ITC1,1,Piemonte,Piemonte,4356406,1846369,42.38,0.71
1797,2021-02-14,PIE,1476,498,978,876,600,ITC,ITC1,1,Piemonte,Piemonte,4356406,1847845,42.42,0.03
1798,2021-04-19,PIE,22532,10762,11770,18168,4364,ITC,ITC1,1,Piemonte,Piemonte,4356406,1870377,42.93,0.52
1799,2021-01-09,PIE,6184,2185,3999,6184,0,ITC,ITC1,1,Piemonte,Piemonte,4356406,1876561,43.08,0.14
1800,2021-02-24,PIE,11409,4629,6780,10904,505,ITC,ITC1,1,Piemonte,Piemonte,4356406,1887970,43.34,0.26
1801,2021-02-19,PIE,5535,2175,3360,5034,501,ITC,ITC1,1,Piemonte,Piemonte,4356406,1893505,43.46,0.13
1802,2021-04-24,PIE,27441,12418,15023,21802,5639,ITC,ITC1,1,Piemonte,Piemonte,4356406,1920946,44.09,0.63
1803,2021-05-03,PIE,26636,12156,14480,12504,14132,ITC,ITC1,1,Piemonte,Piemonte,4356406,1947582,44.71,0.61
1804,2021-02-10,PIE,7535,2371,5164,1316,6219,ITC,ITC1,1,Piemonte,Piemonte,4356406,1955117,44.88,0.17
1805,2021-04-08,PIE,25142,10929,14213,20412,4730,ITC,ITC1,1,Piemonte,Piemonte,4356406,1980259,45.46,0.58
1806,2021-04-15,PIE,29626,13569,16057,24150,5476,ITC,ITC1,1,Piemonte,Piemonte,4356406,2009885,46.14,0.68
1807,2021-04-17,PIE,30422,14130,16292,27109,3313,ITC,ITC1,1,Piemonte,Piemonte,4356406,2040307,46.83,0.7
1808,2021-04-10,PIE,30163,13416,16747,25884,4279,ITC,ITC1,1,Piemonte,Piemonte,4356406,2070470,47.53,0.69
1809,2021-01-05,PIE,5381,1603,3778,5381,0,ITC,ITC1,1,Piemonte,Piemonte,4356406,2075851,47.65,0.12
1810,2021-01-07,PIE,5387,1739,3648,5387,0,ITC,ITC1,1,Piemonte,Piemonte,4356406,2081238,47.77,0.12
1811,2021-03-05,PIE,15268,5961,9307,11451,3817,ITC,ITC1,1,Piemonte,Piemonte,4356406,2096506,48.12,0.35
1812,2020-12-31,PIE,3909,1334,2575,3909,0,ITC,ITC1,1,Piemonte,Piemonte,4356406,2100415,48.21,0.09
1813,2021-02-09,PIE,7392,2316,5076,722,6670,ITC,ITC1,1,Piemonte,Piemonte,4356406,2107807,48.38,0.17
1814,2021-03-08,PIE,13946,5293,8653,11232,2714,ITC,ITC1,1,Piemonte,Piemonte,4356406,2121753,48.7,0.32
1815,2021-05-04,PIE,28474,13072,15402,16391,12083,ITC,ITC1,1,Piemonte,Piemonte,4356406,2150227,49.36,0.65
1816,2021-04-27,PIE,22571,10203,12368,17436,5135,ITC,ITC1,1,Piemonte,Piemonte,4356406,2172798,49.88,0.52
1817,2021-01-17,PIE,3518,1168,2350,2870,648,ITC,ITC1,1,Piemonte,Piemonte,4356406,2176316,49.96,0.08
1818,2021-03-15,PIE,10658,4162,6496,5037,5621,ITC,ITC1,1,Piemonte,Piemonte,4356406,2186974,50.2,0.24
1819,2021-05-11,PIE,31970,15399,16571,18831,13139,ITC,ITC1,1,Piemonte,Piemonte,4356406,2218944,50.94,0.73
1820,2021-01-24,PIE,3153,959,2194,434,2719,ITC,ITC1,1,Piemonte,Piemonte,4356406,2222097,51.01,0.07
1821,2021-03-22,PIE,11510,4880,6630,3904,7606,ITC,ITC1,1,Piemonte,Piemonte,4356406,2233607,51.27,0.26
1822,2021-01-31,PIE,4113,1753,2360,112,4001,ITC,ITC1,1,Piemonte,Piemonte,4356406,2237720,51.37,0.09
1823,2021-02-07,PIE,3088,974,2114,445,2643,ITC,ITC1,1,Piemonte,Piemonte,4356406,2240808,51.44,0.07
1824,2021-03-12,PIE,13949,5184,8765,11014,2935,ITC,ITC1,1,Piemonte,Piemonte,4356406,2254757,51.76,0.32
1825,2021-03-26,PIE,17748,6982,10766,8840,8908,ITC,ITC1,1,Piemonte,Piemonte,4356406,2272505,52.16,0.41
1826,2021-05-16,PIE,28110,12762,15348,15054,13056,ITC,ITC1,1,Piemonte,Piemonte,4356406,2300615,52.81,0.65
1827,2021-04-29,PIE,48269,21837,26432,35668,12601,ITC,ITC1,1,Piemonte,Piemonte,4356406,2348884,53.92,1.11
1828,2021-05-22,PIE,33270,15027,18243,17168,16102,ITC,ITC1,1,Piemonte,Piemonte,4356406,2382154,54.68,0.76
1829,2021-01-14,PIE,9766,3152,6614,9766,0,ITC,ITC1,1,Piemonte,Piemonte,4356406,2391920,54.91,0.22
1830,2021-04-07,PIE,23605,9994,13611,18141,5464,ITC,ITC1,1,Piemonte,Piemonte,4356406,2415525,55.45,0.54
1831,2021-02-22,PIE,8482,3472,5010,7892,590,ITC,ITC1,1,Piemonte,Piemonte,4356406,2424007,55.64,0.19
1832,2021-04-13,PIE,25929,11608,14321,22469,3460,ITC,ITC1,1,Piemonte,Piemonte,4356406,2449936,56.24,0.6
1833,2021-01-03,PIE,3063,967,2096,3063,0,ITC,ITC1,1,Piemonte,Piemonte,4356406,2452999,56.31,0.07
1834,2021-05-18,PIE,31762,14574,17188,19312,12450,ITC,ITC1,1,Piemonte,Piemonte,4356406,2484761,57.04,0.73
1835,2021-03-29,PIE,15161,6385,8776,8549,6612,ITC,ITC1,1,Piemonte,Piemonte,4356406,2499922,57.38,0.35
1836,2021-04-12,PIE,22923,10352,12571,19933,2990,ITC,ITC1,1,Piemonte,Piemonte,4356406,2522845,57.91,0.53
1837,2021-06-01,PIE,11914,5957,5957,9803,2111,ITC,ITC1,1,Piemonte,Piemonte,4356406,2534759,58.18,0.27
1838,2021-01-02,PIE,3545,1134,2411,3545,0,ITC,ITC1,1,Piemonte,Piemonte,4356406,2538304,58.27,0.08
1839,2021-02-21,PIE,5090,2083,3007,4988,102,ITC,ITC1,1,Piemonte,Piemonte,4356406,2543394,58.38,0.12
1840,2021-03-14,LOM,14876,5349,9527,11590,3286,ITC,ITC4,3,Lombardia,Lombardia,10060574,14876,0.15,0.15
1841,2021-05-17,LOM,94499,45265,49234,30197,64302,ITC,ITC4,3,Lombardia,Lombardia,10060574,109375,1.09,0.94
1842,2021-02-25,LOM,15223,6307,8916,13645,1578,ITC,ITC4,3,Lombardia,Lombardia,10060574,124598,1.24,0.15
1843,2021-04-30,LOM,116894,54639,62255,89700,27194,ITC,ITC4,3,Lombardia,Lombardia,10060574,241492,2.4,1.16
1844,2021-02-08,LOM,10081,2918,7163,2139,7942,ITC,ITC4,3,Lombardia,Lombardia,10060574,251573,2.5,0.1
1845,2021-01-09,LOM,12410,4573,7837,12410,0,ITC,ITC4,3,Lombardia,Lombardia,10060574,263983,2.62,0.12
1846,2021-01-27,LOM,8045,2677,5368,821,7224,ITC,ITC4,3,Lombardia,Lombardia,10060574,272028,2.7,0.08
1847,2021-05-21,LOM,93472,45094,48378,29047,64425,ITC,ITC4,3,Lombardia,Lombardia,10060574,365500,3.63,0.93
1848,2021-03-18,LOM,27428,10960,16468,16196,11232,ITC,ITC4,3,Lombardia,Lombardia,10060574,392928,3.91,0.27
1849,2021-01-16,LOM,15417,5725,9692,15417,0,ITC,ITC4,3,Lombardia,Lombardia,10060574,408345,4.06,0.15
1850,2021-03-07,LOM,12082,5355,6727,9523,2559,ITC,ITC4,3,Lombardia,Lombardia,10060574,420427,4.18,0.12
1851,2021-05-07,LOM,92043,43579,48464,69870,22173,ITC,ITC4,3,Lombardia,Lombardia,10060574,512470,5.09,0.91
1852,2021-03-25,LOM,42654,15932,26722,30074,12580,ITC,ITC4,3,Lombardia,Lombardia,10060574,555124,5.52,0.42
1853,2021-05-14,LOM,85548,41209,44339,55508,30040,ITC,ITC4,3,Lombardia,Lombardia,10060574,640672,6.37,0.85
1854,2021-01-30,LOM,12323,4570,7753,173,12150,ITC,ITC4,3,Lombardia,Lombardia,10060574,652995,6.49,0.12
1855,2021-02-13,LOM,6416,2443,3973,4939,1477,ITC,ITC4,3,Lombardia,Lombardia,10060574,659411,6.55,0.06
1856,2021-01-13,LOM,26378,8053,18325,26378,0,ITC,ITC4,3,Lombardia,Lombardia,10060574,685789,6.82,0.26
1857,2021-02-04,LOM,27681,8076,19605,1998,25683,ITC,ITC4,3,Lombardia,Lombardia,10060574,713470,7.09,0.28
1858,2021-04-09,LOM,52222,22289,29933,36225,15997,ITC,ITC4,3,Lombardia,Lombardia,10060574,765692,7.61,0.52
1859,2021-04-04,LOM,7617,3232,4385,3718,3899,ITC,ITC4,3,Lombardia,Lombardia,10060574,773309,7.69,0.08
1860,2021-01-01,LOM,24,7,17,24,0,ITC,ITC4,3,Lombardia,Lombardia,10060574,773333,7.69,0.0
1861,2021-03-06,LOM,21317,9087,12230,16801,4516,ITC,ITC4,3,Lombardia,Lombardia,10060574,794650,7.9,0.21
1862,2021-05-03,LOM,83639,39731,43908,71523,12116,ITC,ITC4,3,Lombardia,Lombardia,10060574,878289,8.73,0.83
1863,2021-03-28,LOM,20474,7807,12667,14310,6164,ITC,ITC4,3,Lombardia,Lombardia,10060574,898763,8.93,0.2
1864,2021-04-16,LOM,53615,23899,29716,39276,14339,ITC,ITC4,3,Lombardia,Lombardia,10060574,952378,9.47,0.53
1865,2021-01-23,LOM,1114,357,757,916,198,ITC,ITC4,3,Lombardia,Lombardia,10060574,953492,9.48,0.01
1866,2021-03-11,LOM,36239,13479,22760,26324,9915,ITC,ITC4,3,Lombardia,Lombardia,10060574,989731,9.84,0.36
1867,2021-01-06,LOM,7061,2492,4569,7061,0,ITC,ITC4,3,Lombardia,Lombardia,10060574,996792,9.91,0.07
1868,2021-01-28,LOM,12196,3693,8503,777,11419,ITC,ITC4,3,Lombardia,Lombardia,10060574,1008988,10.03,0.12
1869,2021-04-25,LOM,51451,23600,27851,46735,4716,ITC,ITC4,3,Lombardia,Lombardia,10060574,1060439,10.54,0.51
1870,2021-02-23,LOM,11773,4792,6981,11465,308,ITC,ITC4,3,Lombardia,Lombardia,10060574,1072212,10.66,0.12
1871,2021-05-19,LOM,82612,39492,43120,33780,48832,ITC,ITC4,3,Lombardia,Lombardia,10060574,1154824,11.48,0.82
1872,2021-02-06,LOM,15260,5534,9726,1038,14222,ITC,ITC4,3,Lombardia,Lombardia,10060574,1170084,11.63,0.15
1873,2021-05-02,LOM,83497,38330,45167,61037,22460,ITC,ITC4,3,Lombardia,Lombardia,10060574,1253581,12.46,0.83
1874,2021-05-10,LOM,85184,40858,44326,63680,21504,ITC,ITC4,3,Lombardia,Lombardia,10060574,1338765,13.31,0.85
1875,2021-04-23,LOM,73367,33271,40096,56857,16510,ITC,ITC4,3,Lombardia,Lombardia,10060574,1412132,14.04,0.73
1876,2021-03-21,LOM,23577,8549,15028,18316,5261,ITC,ITC4,3,Lombardia,Lombardia,10060574,1435709,14.27,0.23
1877,2021-03-04,LOM,29418,12149,17269,20287,9131,ITC,ITC4,3,Lombardia,Lombardia,10060574,1465127,14.56,0.29
1878,2021-04-14,LOM,47139,21018,26121,34172,12967,ITC,ITC4,3,Lombardia,Lombardia,10060574,1512266,15.03,0.47
1879,2021-01-04,LOM,6080,2098,3982,6080,0,ITC,ITC4,3,Lombardia,Lombardia,10060574,1518346,15.09,0.06
1880,2021-03-30,LOM,39491,15488,24003,24704,14787,ITC,ITC4,3,Lombardia,Lombardia,10060574,1557837,15.48,0.39
1881,2021-04-13,LOM,47579,21239,26340,33511,14068,ITC,ITC4,3,Lombardia,Lombardia,10060574,1605416,15.96,0.47
1882,2021-01-22,LOM,3105,866,2239,3035,70,ITC,ITC4,3,Lombardia,Lombardia,10060574,1608521,15.99,0.03
1883,2021-03-27,LOM,32425,12368,20057,23717,8708,ITC,ITC4,3,Lombardia,Lombardia,10060574,1640946,16.31,0.32
1884,2021-01-05,LOM,7821,2566,5255,7821,0,ITC,ITC4,3,Lombardia,Lombardia,10060574,1648767,16.39,0.08
1885,2021-04-02,LOM,41138,16828,24310,26692,14446,ITC,ITC4,3,Lombardia,Lombardia,10060574,1689905,16.8,0.41
1886,2021-04-11,LOM,32187,13937,18250,24795,7392,ITC,ITC4,3,Lombardia,Lombardia,10060574,1722092,17.12,0.32
1887,2020-12-30,LOM,114,42,72,114,0,ITC,ITC4,3,Lombardia,Lombardia,10060574,1722206,17.12,0.0
1888,2021-02-27,LOM,13950,5872,8078,13308,642,ITC,ITC4,3,Lombardia,Lombardia,10060574,1736156,17.26,0.14
1889,2021-04-28,LOM,95585,43603,51982,68730,26855,ITC,ITC4,3,Lombardia,Lombardia,10060574,1831741,18.21,0.95
1890,2021-03-16,LOM,25476,10112,15364,16418,9058,ITC,ITC4,3,Lombardia,Lombardia,10060574,1857217,18.46,0.25
1891,2021-05-12,LOM,87201,41613,45588,59779,27422,ITC,ITC4,3,Lombardia,Lombardia,10060574,1944418,19.33,0.87
1892,2021-03-09,LOM,33243,12854,20389,25817,7426,ITC,ITC4,3,Lombardia,Lombardia,10060574,1977661,19.66,0.33
1893,2021-05-05,LOM,87781,41867,45914,72543,15238,ITC,ITC4,3,Lombardia,Lombardia,10060574,2065442,20.53,0.87
1894,2021-01-18,LOM,9156,2968,6188,8175,981,ITC,ITC4,3,Lombardia,Lombardia,10060574,2074598,20.62,0.09
1895,2021-03-23,LOM,42516,15403,27113,29639,12877,ITC,ITC4,3,Lombardia,Lombardia,10060574,2117114,21.04,0.42
1896,2021-01-25,LOM,7025,2372,4653,487,6538,ITC,ITC4,3,Lombardia,Lombardia,10060574,2124139,21.11,0.07
1897,2021-02-01,LOM,16056,5317,10739,304,15752,ITC,ITC4,3,Lombardia,Lombardia,10060574,2140195,21.27,0.16
1898,2021-03-26,LOM,41177,15617,25560,28108,13069,ITC,ITC4,3,Lombardia,Lombardia,10060574,2181372,21.68,0.41
1899,2021-05-22,LOM,70272,33706,36566,32348,37924,ITC,ITC4,3,Lombardia,Lombardia,10060574,2251644,22.38,0.7
1900,2021-05-29,LOM,87632,42095,45537,41985,45647,ITC,ITC4,3,Lombardia,Lombardia,10060574,2339276,23.25,0.87
1901,2021-05-24,LOM,89126,43243,45883,49427,39699,ITC,ITC4,3,Lombardia,Lombardia,10060574,2428402,24.14,0.89
1902,2021-02-11,LOM,17045,5004,12041,9700,7345,ITC,ITC4,3,Lombardia,Lombardia,10060574,2445447,24.31,0.17
1903,2021-05-31,LOM,94864,47064,47800,79228,15636,ITC,ITC4,3,Lombardia,Lombardia,10060574,2540311,25.25,0.94
1904,2021-02-18,LOM,14043,4928,9115,13015,1028,ITC,ITC4,3,Lombardia,Lombardia,10060574,2554354,25.39,0.14
1905,2021-02-20,LOM,9474,3905,5569,9175,299,ITC,ITC4,3,Lombardia,Lombardia,10060574,2563828,25.48,0.09
1906,2021-04-18,LOM,36344,16204,20140,31116,5228,ITC,ITC4,3,Lombardia,Lombardia,10060574,2600172,25.85,0.36
1907,2021-02-03,LOM,25577,7908,17669,1151,24426,ITC,ITC4,3,Lombardia,Lombardia,10060574,2625749,26.1,0.25
1908,2021-04-01,LOM,42935,17218,25717,26741,16194,ITC,ITC4,3,Lombardia,Lombardia,10060574,2668684,26.53,0.43
1909,2021-04-26,LOM,87925,40915,47010,68766,19159,ITC,ITC4,3,Lombardia,Lombardia,10060574,2756609,27.4,0.87
1910,2021-05-04,LOM,86764,41049,45715,72401,14363,ITC,ITC4,3,Lombardia,Lombardia,10060574,2843373,28.26,0.86
1911,2021-03-01,LOM,18797,8232,10565,17092,1705,ITC,ITC4,3,Lombardia,Lombardia,10060574,2862170,28.45,0.19
1912,2021-05-13,LOM,86871,41659,45212,58228,28643,ITC,ITC4,3,Lombardia,Lombardia,10060574,2949041,29.31,0.86
1913,2021-03-10,LOM,33244,12731,20513,25386,7858,ITC,ITC4,3,Lombardia,Lombardia,10060574,2982285,29.64,0.33
1914,2021-03-31,LOM,41974,16988,24986,26739,15235,ITC,ITC4,3,Lombardia,Lombardia,10060574,3024259,30.06,0.42
1915,2021-02-10,LOM,14392,4504,9888,7572,6820,ITC,ITC4,3,Lombardia,Lombardia,10060574,3038651,30.2,0.14
1916,2021-06-01,LOM,32402,15975,16427,25391,7011,ITC,ITC4,3,Lombardia,Lombardia,10060574,3071053,30.53,0.32
1917,2021-01-02,LOM,199,72,127,199,0,ITC,ITC4,3,Lombardia,Lombardia,10060574,3071252,30.53,0.0
1918,2021-02-28,LOM,7890,3257,4633,7674,216,ITC,ITC4,3,Lombardia,Lombardia,10060574,3079142,30.61,0.08
1919,2021-05-16,LOM,68484,32408,36076,36483,32001,ITC,ITC4,3,Lombardia,Lombardia,10060574,3147626,31.29,0.68
1920,2021-03-13,LOM,27176,9767,17409,21080,6096,ITC,ITC4,3,Lombardia,Lombardia,10060574,3174802,31.56,0.27
1921,2021-02-05,LOM,25616,7442,18174,2397,23219,ITC,ITC4,3,Lombardia,Lombardia,10060574,3200418,31.81,0.25
1922,2021-05-01,LOM,95877,43645,52232,66745,29132,ITC,ITC4,3,Lombardia,Lombardia,10060574,3296295,32.76,0.95
1923,2021-01-21,LOM,5342,1569,3773,4653,689,ITC,ITC4,3,Lombardia,Lombardia,10060574,3301637,32.82,0.05
1924,2021-04-08,LOM,52328,21754,30574,35873,16455,ITC,ITC4,3,Lombardia,Lombardia,10060574,3353965,33.34,0.52
1925,2021-02-17,LOM,11969,3746,8223,10579,1390,ITC,ITC4,3,Lombardia,Lombardia,10060574,3365934,33.46,0.12
1926,2021-03-22,LOM,40305,14291,26014,29761,10544,ITC,ITC4,3,Lombardia,Lombardia,10060574,3406239,33.86,0.4
1927,2021-04-22,LOM,73780,33333,40447,57486,16294,ITC,ITC4,3,Lombardia,Lombardia,10060574,3480019,34.59,0.73
1928,2021-04-05,LOM,27387,11697,15690,19277,8110,ITC,ITC4,3,Lombardia,Lombardia,10060574,3507406,34.86,0.27
1929,2021-01-31,LOM,9747,3763,5984,34,9713,ITC,ITC4,3,Lombardia,Lombardia,10060574,3517153,34.96,0.1
1930,2021-05-25,LOM,90715,43403,47312,44576,46139,ITC,ITC4,3,Lombardia,Lombardia,10060574,3607868,35.86,0.9
1931,2021-03-20,LOM,32513,12152,20361,22661,9852,ITC,ITC4,3,Lombardia,Lombardia,10060574,3640381,36.18,0.32
1932,2021-05-09,LOM,69514,32811,36703,56427,13087,ITC,ITC4,3,Lombardia,Lombardia,10060574,3709895,36.88,0.69
1933,2021-01-29,LOM,13439,4115,9324,654,12785,ITC,ITC4,3,Lombardia,Lombardia,10060574,3723334,37.01,0.13
1934,2021-04-24,LOM,75677,33539,42138,54614,21063,ITC,ITC4,3,Lombardia,Lombardia,10060574,3799011,37.76,0.75
1935,2021-03-05,LOM,28993,11949,17044,20586,8407,ITC,ITC4,3,Lombardia,Lombardia,10060574,3828004,38.05,0.29
1936,2021-03-19,LOM,32421,12908,19513,19216,13205,ITC,ITC4,3,Lombardia,Lombardia,10060574,3860425,38.37,0.32
1937,2021-01-14,LOM,26801,7782,19019,26801,0,ITC,ITC4,3,Lombardia,Lombardia,10060574,3887226,38.64,0.27
1938,2021-05-08,LOM,87347,40589,46758,65654,21693,ITC,ITC4,3,Lombardia,Lombardia,10060574,3974573,39.51,0.87
1939,2021-05-23,LOM,60726,28915,31811,26788,33938,ITC,ITC4,3,Lombardia,Lombardia,10060574,4035299,40.11,0.6
1940,2021-04-03,LOM,36240,14861,21379,26160,10080,ITC,ITC4,3,Lombardia,Lombardia,10060574,4071539,40.47,0.36
1941,2021-05-30,LOM,74181,35514,38667,34306,39875,ITC,ITC4,3,Lombardia,Lombardia,10060574,4145720,41.21,0.74
1942,2021-02-12,LOM,13946,4355,9591,9027,4919,ITC,ITC4,3,Lombardia,Lombardia,10060574,4159666,41.35,0.14
1943,2021-04-10,LOM,52374,21699,30675,40581,11793,ITC,ITC4,3,Lombardia,Lombardia,10060574,4212040,41.87,0.52
1944,2021-02-19,LOM,14115,5369,8746,13435,680,ITC,ITC4,3,Lombardia,Lombardia,10060574,4226155,42.01,0.14
1945,2021-04-17,LOM,48394,21259,27135,37625,10769,ITC,ITC4,3,Lombardia,Lombardia,10060574,4274549,42.49,0.48
1946,2021-02-26,LOM,18382,7557,10825,16516,1866,ITC,ITC4,3,Lombardia,Lombardia,10060574,4292931,42.67,0.18
1947,2020-12-31,LOM,714,301,413,714,0,ITC,ITC4,3,Lombardia,Lombardia,10060574,4293645,42.68,0.01
1948,2021-01-07,LOM,11761,3636,8125,11761,0,ITC,ITC4,3,Lombardia,Lombardia,10060574,4305406,42.79,0.12
1949,2021-04-20,LOM,67619,30815,36804,57290,10329,ITC,ITC4,3,Lombardia,Lombardia,10060574,4373025,43.47,0.67
1950,2021-01-10,LOM,10519,3957,6562,10519,0,ITC,ITC4,3,Lombardia,Lombardia,10060574,4383544,43.57,0.1
1951,2021-04-27,LOM,85905,39949,45956,69369,16536,ITC,ITC4,3,Lombardia,Lombardia,10060574,4469449,44.43,0.85
1952,2021-04-29,LOM,115375,53539,61836,85583,29792,ITC,ITC4,3,Lombardia,Lombardia,10060574,4584824,45.57,1.15
1953,2021-01-17,LOM,8348,3347,5001,8147,201,ITC,ITC4,3,Lombardia,Lombardia,10060574,4593172,45.66,0.08
1954,2021-03-15,LOM,31571,11334,20237,23053,8518,ITC,ITC4,3,Lombardia,Lombardia,10060574,4624743,45.97,0.31
1955,2021-03-17,LOM,26256,10492,15764,15245,11011,ITC,ITC4,3,Lombardia,Lombardia,10060574,4650999,46.23,0.26
1956,2021-03-24,LOM,43326,15629,27697,31439,11887,ITC,ITC4,3,Lombardia,Lombardia,10060574,4694325,46.66,0.43
1957,2021-02-09,LOM,12285,3344,8941,4113,8172,ITC,ITC4,3,Lombardia,Lombardia,10060574,4706610,46.78,0.12
1958,2021-01-20,LOM,5608,1373,4235,5493,115,ITC,ITC4,3,Lombardia,Lombardia,10060574,4712218,46.84,0.06
1959,2021-04-15,LOM,49396,21840,27556,35584,13812,ITC,ITC4,3,Lombardia,Lombardia,10060574,4761614,47.33,0.49
1960,2021-01-03,LOM,854,316,538,854,0,ITC,ITC4,3,Lombardia,Lombardia,10060574,4762468,47.34,0.01
1961,2021-03-29,LOM,40016,15514,24502,25181,14835,ITC,ITC4,3,Lombardia,Lombardia,10060574,4802484,47.74,0.4
1962,2021-03-12,LOM,35249,12955,22294,25044,10205,ITC,ITC4,3,Lombardia,Lombardia,10060574,4837733,48.09,0.35
1963,2021-02-22,LOM,11894,4808,7086,11586,308,ITC,ITC4,3,Lombardia,Lombardia,10060574,4849627,48.2,0.12
1964,2021-05-18,LOM,88009,42053,45956,32580,55429,ITC,ITC4,3,Lombardia,Lombardia,10060574,4937636,49.08,0.87
1965,2021-02-24,LOM,14677,5928,8749,13749,928,ITC,ITC4,3,Lombardia,Lombardia,10060574,4952313,49.22,0.15
1966,2021-02-07,LOM,7308,2821,4487,340,6968,ITC,ITC4,3,Lombardia,Lombardia,10060574,4959621,49.3,0.07
1967,2021-01-19,LOM,8125,2348,5777,7651,474,ITC,ITC4,3,Lombardia,Lombardia,10060574,4967746,49.38,0.08
1968,2021-05-20,LOM,94135,45489,48646,31771,62364,ITC,ITC4,3,Lombardia,Lombardia,10060574,5061881,50.31,0.94
1969,2021-03-08,LOM,29767,11186,18581,22696,7071,ITC,ITC4,3,Lombardia,Lombardia,10060574,5091648,50.61,0.3
1970,2021-01-24,LOM,1201,459,742,537,664,ITC,ITC4,3,Lombardia,Lombardia,10060574,5092849,50.62,0.01
1971,2021-05-06,LOM,89714,42155,47559,73291,16423,ITC,ITC4,3,Lombardia,Lombardia,10060574,5182563,51.51,0.89
1972,2021-05-15,LOM,80437,38610,41827,47322,33115,ITC,ITC4,3,Lombardia,Lombardia,10060574,5263000,52.31,0.8
1973,2021-02-02,LOM,19850,6584,13266,491,19359,ITC,ITC4,3,Lombardia,Lombardia,10060574,5282850,52.51,0.2
1974,2021-01-08,LOM,12698,3916,8782,12698,0,ITC,ITC4,3,Lombardia,Lombardia,10060574,5295548,52.64,0.13
1975,2021-01-15,LOM,25207,7431,17776,25207,0,ITC,ITC4,3,Lombardia,Lombardia,10060574,5320755,52.89,0.25
1976,2021-04-12,LOM,47226,20573,26653,32893,14333,ITC,ITC4,3,Lombardia,Lombardia,10060574,5367981,53.36,0.47
1977,2021-02-21,LOM,5052,1862,3190,5034,18,ITC,ITC4,3,Lombardia,Lombardia,10060574,5373033,53.41,0.05
1978,2021-05-28,LOM,92675,44455,48220,42725,49950,ITC,ITC4,3,Lombardia,Lombardia,10060574,5465708,54.33,0.92
1979,2020-12-29,LOM,104,44,60,104,0,ITC,ITC4,3,Lombardia,Lombardia,10060574,5465812,54.33,0.0
1980,2021-03-03,LOM,26944,11505,15439,19671,7273,ITC,ITC4,3,Lombardia,Lombardia,10060574,5492756,54.6,0.27
1981,2021-05-11,LOM,86707,41367,45340,60604,26103,ITC,ITC4,3,Lombardia,Lombardia,10060574,5579463,55.46,0.86
1982,2021-01-12,LOM,20220,6698,13522,20220,0,ITC,ITC4,3,Lombardia,Lombardia,10060574,5599683,55.66,0.2
1983,2021-02-14,LOM,3578,1546,2032,2944,634,ITC,ITC4,3,Lombardia,Lombardia,10060574,5603261,55.7,0.04
1984,2021-01-26,LOM,8376,2721,5655,371,8005,ITC,ITC4,3,Lombardia,Lombardia,10060574,5611637,55.78,0.08
1985,2021-04-19,LOM,60097,27341,32756,50691,9406,ITC,ITC4,3,Lombardia,Lombardia,10060574,5671734,56.38,0.6
1986,2021-02-16,LOM,9544,3086,6458,9088,456,ITC,ITC4,3,Lombardia,Lombardia,10060574,5681278,56.47,0.09
1987,2020-12-28,LOM,107,47,60,107,0,ITC,ITC4,3,Lombardia,Lombardia,10060574,5681385,56.47,0.0
1988,2021-04-21,LOM,71658,32506,39152,57068,14590,ITC,ITC4,3,Lombardia,Lombardia,10060574,5753043,57.18,0.71
1989,2021-03-02,LOM,22850,9713,13137,19815,3035,ITC,ITC4,3,Lombardia,Lombardia,10060574,5775893,57.41,0.23
1990,2021-01-11,LOM,16174,5362,10812,16174,0,ITC,ITC4,3,Lombardia,Lombardia,10060574,5792067,57.57,0.16
1991,2021-05-26,LOM,92980,44320,48660,43472,49508,ITC,ITC4,3,Lombardia,Lombardia,10060574,5885047,58.5,0.92
1992,2021-04-06,LOM,43045,17563,25482,25092,17953,ITC,ITC4,3,Lombardia,Lombardia,10060574,5928092,58.92,0.43
1993,2021-02-15,LOM,8916,3120,5796,8495,421,ITC,ITC4,3,Lombardia,Lombardia,10060574,5937008,59.01,0.09
1994,2020-12-27,LOM,717,413,304,717,0,ITC,ITC4,3,Lombardia,Lombardia,10060574,5937725,59.02,0.01
1995,2021-05-27,LOM,94039,45122,48917,41180,52859,ITC,ITC4,3,Lombardia,Lombardia,10060574,6031764,59.95,0.93
1996,2021-04-07,LOM,50525,20877,29648,34712,15813,ITC,ITC4,3,Lombardia,Lombardia,10060574,6082289,60.46,0.5
1997,2021-01-09,TOS,4485,1596,2889,4485,0,ITI,ITI1,9,Toscana,Toscana,3729641,4485,0.12,0.12
1998,2021-04-04,TOS,13910,6601,7309,13657,253,ITI,ITI1,9,Toscana,Toscana,3729641,18395,0.49,0.37
1999,2021-03-18,TOS,9970,3981,5989,6005,3965,ITI,ITI1,9,Toscana,Toscana,3729641,28365,0.76,0.27
2000,2021-03-19,TOS,10136,4457,5679,7271,2865,ITI,ITI1,9,Toscana,Toscana,3729641,38501,1.03,0.27
2001,2021-01-21,TOS,1589,686,903,867,722,ITI,ITI1,9,Toscana,Toscana,3729641,40090,1.07,0.04
2002,2021-02-08,TOS,4097,1360,2737,3638,459,ITI,ITI1,9,Toscana,Toscana,3729641,44187,1.18,0.11
2003,2021-04-13,TOS,8490,3508,4982,6032,2458,ITI,ITI1,9,Toscana,Toscana,3729641,52677,1.41,0.23
2004,2021-05-26,TOS,35177,16775,18402,20168,15009,ITI,ITI1,9,Toscana,Toscana,3729641,87854,2.36,0.94
2005,2021-03-30,TOS,16861,7498,9363,13297,3564,ITI,ITI1,9,Toscana,Toscana,3729641,104715,2.81,0.45
2006,2021-01-28,TOS,6282,1882,4400,354,5928,ITI,ITI1,9,Toscana,Toscana,3729641,110997,2.98,0.17
2007,2021-05-19,TOS,27755,13434,14321,18865,8890,ITI,ITI1,9,Toscana,Toscana,3729641,138752,3.72,0.74
2008,2021-04-06,TOS,22169,9773,12396,18455,3714,ITI,ITI1,9,Toscana,Toscana,3729641,160921,4.31,0.59
2009,2021-03-26,TOS,20404,9160,11244,14644,5760,ITI,ITI1,9,Toscana,Toscana,3729641,181325,4.86,0.55
2010,2021-05-29,TOS,31222,15092,16130,23276,7946,ITI,ITI1,9,Toscana,Toscana,3729641,212547,5.7,0.84
2011,2021-03-09,TOS,10674,4152,6522,5122,5552,ITI,ITI1,9,Toscana,Toscana,3729641,223221,5.99,0.29
2012,2021-04-09,TOS,24531,10545,13986,21122,3409,ITI,ITI1,9,Toscana,Toscana,3729641,247752,6.64,0.66
2013,2021-02-04,TOS,4253,1594,2659,961,3292,ITI,ITI1,9,Toscana,Toscana,3729641,252005,6.76,0.11
2014,2021-03-23,TOS,9093,4102,4991,6819,2274,ITI,ITI1,9,Toscana,Toscana,3729641,261098,7.0,0.24
2015,2021-05-12,TOS,34123,15545,18578,14160,19963,ITI,ITI1,9,Toscana,Toscana,3729641,295221,7.92,0.91
2016,2021-01-18,TOS,1119,636,483,1021,98,ITI,ITI1,9,Toscana,Toscana,3729641,296340,7.95,0.03
2017,2021-02-16,TOS,9279,3339,5940,8558,721,ITI,ITI1,9,Toscana,Toscana,3729641,305619,8.19,0.25
2018,2021-04-21,TOS,29599,12663,16936,17515,12084,ITI,ITI1,9,Toscana,Toscana,3729641,335218,8.99,0.79
2019,2021-02-25,TOS,10635,4306,6329,9636,999,ITI,ITI1,9,Toscana,Toscana,3729641,345853,9.27,0.29
2020,2021-04-30,TOS,40014,17694,22320,20159,19855,ITI,ITI1,9,Toscana,Toscana,3729641,385867,10.35,1.07
2021,2021-04-25,TOS,11054,5248,5806,8917,2137,ITI,ITI1,9,Toscana,Toscana,3729641,396921,10.64,0.3
2022,2021-01-13,TOS,4062,1398,2664,4062,0,ITI,ITI1,9,Toscana,Toscana,3729641,400983,10.75,0.11
2023,2021-05-22,TOS,25954,12623,13331,21699,4255,ITI,ITI1,9,Toscana,Toscana,3729641,426937,11.45,0.7
2024,2021-02-09,TOS,4488,1468,3020,3877,611,ITI,ITI1,9,Toscana,Toscana,3729641,431425,11.57,0.12
2025,2021-05-05,TOS,30016,13368,16648,15644,14372,ITI,ITI1,9,Toscana,Toscana,3729641,461441,12.37,0.8
2026,2021-02-11,TOS,5383,2021,3362,5141,242,ITI,ITI1,9,Toscana,Toscana,3729641,466824,12.52,0.14
2027,2021-01-25,TOS,5127,1896,3231,248,4879,ITI,ITI1,9,Toscana,Toscana,3729641,471951,12.65,0.14
2028,2021-05-07,TOS,32057,14668,17389,11986,20071,ITI,ITI1,9,Toscana,Toscana,3729641,504008,13.51,0.86
2029,2021-05-14,TOS,33253,15382,17871,20634,12619,ITI,ITI1,9,Toscana,Toscana,3729641,537261,14.41,0.89
2030,2021-04-02,TOS,31944,13534,18410,23921,8023,ITI,ITI1,9,Toscana,Toscana,3729641,569205,15.26,0.86
2031,2021-03-16,TOS,4903,1884,3019,2653,2250,ITI,ITI1,9,Toscana,Toscana,3729641,574108,15.39,0.13
2032,2021-02-27,TOS,1982,755,1227,1080,902,ITI,ITI1,9,Toscana,Toscana,3729641,576090,15.45,0.05
2033,2021-05-15,TOS,29295,13829,15466,23559,5736,ITI,ITI1,9,Toscana,Toscana,3729641,605385,16.23,0.79
2034,2021-04-28,TOS,19120,8188,10932,3831,15289,ITI,ITI1,9,Toscana,Toscana,3729641,624505,16.74,0.51
2035,2021-02-18,TOS,8819,3284,5535,7924,895,ITI,ITI1,9,Toscana,Toscana,3729641,633324,16.98,0.24
2036,2020-12-30,TOS,327,104,223,327,0,ITI,ITI1,9,Toscana,Toscana,3729641,633651,16.99,0.01
2037,2021-02-01,TOS,5509,1958,3551,521,4988,ITI,ITI1,9,Toscana,Toscana,3729641,639160,17.14,0.15
2038,2021-02-28,TOS,1649,667,982,922,727,ITI,ITI1,9,Toscana,Toscana,3729641,640809,17.18,0.04
2039,2021-05-24,TOS,33367,16400,16967,24090,9277,ITI,ITI1,9,Toscana,Toscana,3729641,674176,18.08,0.89
2040,2021-02-13,TOS,7785,2360,5425,7558,227,ITI,ITI1,9,Toscana,Toscana,3729641,681961,18.28,0.21
2041,2021-04-18,TOS,8338,4083,4255,7342,996,ITI,ITI1,9,Toscana,Toscana,3729641,690299,18.51,0.22
2042,2021-05-21,TOS,28598,13225,15373,17445,11153,ITI,ITI1,9,Toscana,Toscana,3729641,718897,19.28,0.77
2043,2021-03-01,TOS,4472,1733,2739,832,3640,ITI,ITI1,9,Toscana,Toscana,3729641,723369,19.4,0.12
2044,2021-05-04,TOS,18300,8207,10093,12853,5447,ITI,ITI1,9,Toscana,Toscana,3729641,741669,19.89,0.49
2045,2021-02-12,TOS,7606,2683,4923,7393,213,ITI,ITI1,9,Toscana,Toscana,3729641,749275,20.09,0.2
2046,2021-04-17,TOS,20533,9206,11327,18411,2122,ITI,ITI1,9,Toscana,Toscana,3729641,769808,20.64,0.55
2047,2021-01-26,TOS,5393,1792,3601,220,5173,ITI,ITI1,9,Toscana,Toscana,3729641,775201,20.78,0.14
2048,2021-01-11,TOS,5094,1691,3403,5094,0,ITI,ITI1,9,Toscana,Toscana,3729641,780295,20.92,0.14
2049,2021-02-23,TOS,7721,3324,4397,7560,161,ITI,ITI1,9,Toscana,Toscana,3729641,788016,21.13,0.21
2050,2021-04-23,TOS,25676,11429,14247,9361,16315,ITI,ITI1,9,Toscana,Toscana,3729641,813692,21.82,0.69
2051,2021-05-02,TOS,11167,4931,6236,9204,1963,ITI,ITI1,9,Toscana,Toscana,3729641,824859,22.12,0.3
2052,2021-01-20,TOS,1331,637,694,1083,248,ITI,ITI1,9,Toscana,Toscana,3729641,826190,22.15,0.04
2053,2021-05-03,TOS,11933,5510,6423,10614,1319,ITI,ITI1,9,Toscana,Toscana,3729641,838123,22.47,0.32
2054,2021-05-17,TOS,29477,14631,14846,20806,8671,ITI,ITI1,9,Toscana,Toscana,3729641,867600,23.26,0.79
2055,2021-03-21,TOS,3231,1573,1658,1798,1433,ITI,ITI1,9,Toscana,Toscana,3729641,870831,23.35,0.09
2056,2021-01-23,TOS,3949,1354,2595,640,3309,ITI,ITI1,9,Toscana,Toscana,3729641,874780,23.45,0.11
2057,2021-03-28,TOS,6212,2808,3404,5958,254,ITI,ITI1,9,Toscana,Toscana,3729641,880992,23.62,0.17
2058,2021-01-30,TOS,4622,1622,3000,198,4424,ITI,ITI1,9,Toscana,Toscana,3729641,885614,23.75,0.12
2059,2021-05-10,TOS,26137,12350,13787,15521,10616,ITI,ITI1,9,Toscana,Toscana,3729641,911751,24.45,0.7
2060,2021-03-14,TOS,7207,2574,4633,3272,3935,ITI,ITI1,9,Toscana,Toscana,3729641,918958,24.64,0.19
2061,2021-02-06,TOS,4527,1550,2977,1294,3233,ITI,ITI1,9,Toscana,Toscana,3729641,923485,24.76,0.12
2062,2021-04-07,TOS,35635,15293,20342,28387,7248,ITI,ITI1,9,Toscana,Toscana,3729641,959120,25.72,0.96
2063,2021-04-14,TOS,20156,8334,11822,15048,5108,ITI,ITI1,9,Toscana,Toscana,3729641,979276,26.26,0.54
2064,2021-04-16,TOS,28955,12889,16066,22045,6910,ITI,ITI1,9,Toscana,Toscana,3729641,1008231,27.03,0.78
2065,2021-03-02,TOS,10598,3798,6800,7154,3444,ITI,ITI1,9,Toscana,Toscana,3729641,1018829,27.32,0.28
2066,2021-01-04,TOS,5065,1894,3171,5065,0,ITI,ITI1,9,Toscana,Toscana,3729641,1023894,27.45,0.14
2067,2021-03-04,TOS,17625,6759,10866,14543,3082,ITI,ITI1,9,Toscana,Toscana,3729641,1041519,27.93,0.47
2068,2021-01-06,TOS,4520,1460,3060,4520,0,ITI,ITI1,9,Toscana,Toscana,3729641,1046039,28.05,0.12
2069,2020-12-27,TOS,620,267,353,620,0,ITI,ITI1,9,Toscana,Toscana,3729641,1046659,28.06,0.02
2070,2021-05-08,TOS,29123,13104,16019,13693,15430,ITI,ITI1,9,Toscana,Toscana,3729641,1075782,28.84,0.78
2071,2021-01-14,TOS,3255,1179,2076,3255,0,ITI,ITI1,9,Toscana,Toscana,3729641,1079037,28.93,0.09
2072,2021-01-22,TOS,2866,1064,1802,528,2338,ITI,ITI1,9,Toscana,Toscana,3729641,1081903,29.01,0.08
2073,2021-03-27,TOS,8860,4150,4710,8645,215,ITI,ITI1,9,Toscana,Toscana,3729641,1090763,29.25,0.24
2074,2021-05-25,TOS,33814,16216,17598,19336,14478,ITI,ITI1,9,Toscana,Toscana,3729641,1124577,30.15,0.91
2075,2021-03-22,TOS,4890,2451,2439,4446,444,ITI,ITI1,9,Toscana,Toscana,3729641,1129467,30.28,0.13
2076,2021-01-03,TOS,3335,1051,2284,3335,0,ITI,ITI1,9,Toscana,Toscana,3729641,1132802,30.37,0.09
2077,2021-02-15,TOS,8771,3375,5396,7946,825,ITI,ITI1,9,Toscana,Toscana,3729641,1141573,30.61,0.24
2078,2021-02-22,TOS,9818,4254,5564,9541,277,ITI,ITI1,9,Toscana,Toscana,3729641,1151391,30.87,0.26
2079,2021-04-24,TOS,13433,6163,7270,5989,7444,ITI,ITI1,9,Toscana,Toscana,3729641,1164824,31.23,0.36
2080,2021-03-12,TOS,16521,6220,10301,12993,3528,ITI,ITI1,9,Toscana,Toscana,3729641,1181345,31.67,0.44
2081,2021-04-01,TOS,26904,11107,15797,16301,10603,ITI,ITI1,9,Toscana,Toscana,3729641,1208249,32.4,0.72
2082,2021-01-27,TOS,4835,1573,3262,206,4629,ITI,ITI1,9,Toscana,Toscana,3729641,1213084,32.53,0.13
2083,2021-03-17,TOS,11421,4586,6835,6893,4528,ITI,ITI1,9,Toscana,Toscana,3729641,1224505,32.83,0.31
2084,2021-01-17,TOS,2536,871,1665,2023,513,ITI,ITI1,9,Toscana,Toscana,3729641,1227041,32.9,0.07
2085,2021-05-30,TOS,28509,13874,14635,21685,6824,ITI,ITI1,9,Toscana,Toscana,3729641,1255550,33.66,0.76
2086,2020-12-31,TOS,804,202,602,804,0,ITI,ITI1,9,Toscana,Toscana,3729641,1256354,33.69,0.02
2087,2021-02-03,TOS,4221,1452,2769,241,3980,ITI,ITI1,9,Toscana,Toscana,3729641,1260575,33.8,0.11
2088,2021-03-25,TOS,23613,10124,13489,15275,8338,ITI,ITI1,9,Toscana,Toscana,3729641,1284188,34.43,0.63
2089,2021-05-13,TOS,34804,15294,19510,13720,21084,ITI,ITI1,9,Toscana,Toscana,3729641,1318992,35.37,0.93
2090,2021-04-29,TOS,39341,17711,21630,19237,20104,ITI,ITI1,9,Toscana,Toscana,3729641,1358333,36.42,1.05
2091,2021-03-10,TOS,18013,7073,10940,13996,4017,ITI,ITI1,9,Toscana,Toscana,3729641,1376346,36.9,0.48
2092,2021-03-24,TOS,19684,8001,11683,10227,9457,ITI,ITI1,9,Toscana,Toscana,3729641,1396030,37.43,0.53
2093,2021-05-28,TOS,29734,13664,16070,17461,12273,ITI,ITI1,9,Toscana,Toscana,3729641,1425764,38.23,0.8
2094,2021-04-08,TOS,29655,12538,17117,23275,6380,ITI,ITI1,9,Toscana,Toscana,3729641,1455419,39.02,0.8
2095,2021-04-15,TOS,24385,10190,14195,15864,8521,ITI,ITI1,9,Toscana,Toscana,3729641,1479804,39.68,0.65
2096,2021-02-17,TOS,8175,3169,5006,7423,752,ITI,ITI1,9,Toscana,Toscana,3729641,1487979,39.9,0.22
2097,2021-04-22,TOS,35721,15303,20418,18281,17440,ITI,ITI1,9,Toscana,Toscana,3729641,1523700,40.85,0.96
2098,2021-02-24,TOS,10372,4467,5905,10171,201,ITI,ITI1,9,Toscana,Toscana,3729641,1534072,41.13,0.28
2099,2021-03-03,TOS,18193,6509,11684,14587,3606,ITI,ITI1,9,Toscana,Toscana,3729641,1552265,41.62,0.49
2100,2021-01-05,TOS,5249,1755,3494,5249,0,ITI,ITI1,9,Toscana,Toscana,3729641,1557514,41.76,0.14
2101,2021-01-12,TOS,3581,1398,2183,3581,0,ITI,ITI1,9,Toscana,Toscana,3729641,1561095,41.86,0.1
2102,2021-01-19,TOS,1104,531,573,1104,0,ITI,ITI1,9,Toscana,Toscana,3729641,1562199,41.89,0.03
2103,2021-05-16,TOS,26659,12879,13780,24200,2459,ITI,ITI1,9,Toscana,Toscana,3729641,1588858,42.6,0.71
2104,2021-03-13,TOS,9275,3301,5974,5312,3963,ITI,ITI1,9,Toscana,Toscana,3729641,1598133,42.85,0.25
2105,2021-05-09,TOS,22515,9760,12755,9656,12859,ITI,ITI1,9,Toscana,Toscana,3729641,1620648,43.45,0.6
2106,2021-02-05,TOS,5749,2245,3504,1924,3825,ITI,ITI1,9,Toscana,Toscana,3729641,1626397,43.61,0.15
2107,2021-05-11,TOS,27935,12978,14957,12478,15457,ITI,ITI1,9,Toscana,Toscana,3729641,1654332,44.36,0.75
2108,2021-01-29,TOS,6144,1700,4444,304,5840,ITI,ITI1,9,Toscana,Toscana,3729641,1660476,44.52,0.16
2109,2021-01-31,TOS,3050,1129,1921,106,2944,ITI,ITI1,9,Toscana,Toscana,3729641,1663526,44.6,0.08
2110,2021-04-05,TOS,15279,6823,8456,14542,737,ITI,ITI1,9,Toscana,Toscana,3729641,1678805,45.01,0.41
2111,2021-05-18,TOS,28689,14133,14556,19976,8713,ITI,ITI1,9,Toscana,Toscana,3729641,1707494,45.78,0.77
2112,2021-02-07,TOS,2805,952,1853,885,1920,ITI,ITI1,9,Toscana,Toscana,3729641,1710299,45.86,0.08
2113,2021-02-10,TOS,4263,1281,2982,3740,523,ITI,ITI1,9,Toscana,Toscana,3729641,1714562,45.97,0.11
2114,2021-05-23,TOS,28368,13642,14726,25804,2564,ITI,ITI1,9,Toscana,Toscana,3729641,1742930,46.73,0.76
2115,2021-05-06,TOS,31291,13599,17692,14171,17120,ITI,ITI1,9,Toscana,Toscana,3729641,1774221,47.57,0.84
2116,2021-01-24,TOS,3349,1073,2276,201,3148,ITI,ITI1,9,Toscana,Toscana,3729641,1777570,47.66,0.09
2117,2021-01-08,TOS,5946,1642,4304,5946,0,ITI,ITI1,9,Toscana,Toscana,3729641,1783516,47.82,0.16
2118,2021-04-20,TOS,18157,8111,10046,12599,5558,ITI,ITI1,9,Toscana,Toscana,3729641,1801673,48.31,0.49
2119,2021-03-15,TOS,8356,3332,5024,3914,4442,ITI,ITI1,9,Toscana,Toscana,3729641,1810029,48.53,0.22
2120,2021-01-10,TOS,3001,1104,1897,3001,0,ITI,ITI1,9,Toscana,Toscana,3729641,1813030,48.61,0.08
2121,2021-04-03,TOS,15013,6646,8367,13887,1126,ITI,ITI1,9,Toscana,Toscana,3729641,1828043,49.01,0.4
2122,2021-02-26,TOS,10076,3833,6243,8870,1206,ITI,ITI1,9,Toscana,Toscana,3729641,1838119,49.28,0.27
2123,2021-03-20,TOS,6489,2883,3606,5353,1136,ITI,ITI1,9,Toscana,Toscana,3729641,1844608,49.46,0.17
2124,2021-03-29,TOS,9391,4588,4803,9067,324,ITI,ITI1,9,Toscana,Toscana,3729641,1853999,49.71,0.25
2125,2021-02-14,TOS,9000,2569,6431,8890,110,ITI,ITI1,9,Toscana,Toscana,3729641,1862999,49.95,0.24
2126,2021-05-27,TOS,27866,12808,15058,13249,14617,ITI,ITI1,9,Toscana,Toscana,3729641,1890865,50.7,0.75
2127,2021-03-11,TOS,15495,5993,9502,12169,3326,ITI,ITI1,9,Toscana,Toscana,3729641,1906360,51.11,0.42
2128,2021-03-05,TOS,16494,6336,10158,11752,4742,ITI,ITI1,9,Toscana,Toscana,3729641,1922854,51.56,0.44
2129,2021-02-02,TOS,3742,1475,2267,195,3547,ITI,ITI1,9,Toscana,Toscana,3729641,1926596,51.66,0.1
2130,2021-04-27,TOS,10346,4909,5437,3866,6480,ITI,ITI1,9,Toscana,Toscana,3729641,1936942,51.93,0.28
2131,2021-03-08,TOS,6371,2630,3741,1551,4820,ITI,ITI1,9,Toscana,Toscana,3729641,1943313,52.1,0.17
2132,2021-04-10,TOS,11723,5349,6374,10978,745,ITI,ITI1,9,Toscana,Toscana,3729641,1955036,52.42,0.31
2133,2021-02-19,TOS,8291,2952,5339,7781,510,ITI,ITI1,9,Toscana,Toscana,3729641,1963327,52.64,0.22
2134,2021-03-31,TOS,32574,13135,19439,20418,12156,ITI,ITI1,9,Toscana,Toscana,3729641,1995901,53.51,0.87
2135,2021-05-01,TOS,23305,10059,13246,14132,9173,ITI,ITI1,9,Toscana,Toscana,3729641,2019206,54.14,0.62
2136,2021-04-19,TOS,9097,4506,4591,8069,1028,ITI,ITI1,9,Toscana,Toscana,3729641,2028303,54.38,0.24
2137,2021-01-07,TOS,6018,1751,4267,6018,0,ITI,ITI1,9,Toscana,Toscana,3729641,2034321,54.54,0.16
2138,2021-05-20,TOS,29445,13649,15796,18896,10549,ITI,ITI1,9,Toscana,Toscana,3729641,2063766,55.33,0.79
2139,2021-04-26,TOS,10153,4943,5210,7598,2555,ITI,ITI1,9,Toscana,Toscana,3729641,2073919,55.61,0.27
2140,2021-01-02,TOS,3497,1096,2401,3497,0,ITI,ITI1,9,Toscana,Toscana,3729641,2077416,55.7,0.09
2141,2021-03-07,TOS,5647,2357,3290,2105,3542,ITI,ITI1,9,Toscana,Toscana,3729641,2083063,55.85,0.15
2142,2021-01-16,TOS,3271,1046,2225,3271,0,ITI,ITI1,9,Toscana,Toscana,3729641,2086334,55.94,0.09
2143,2021-05-31,TOS,29861,14315,15546,19230,10631,ITI,ITI1,9,Toscana,Toscana,3729641,2116195,56.74,0.8
2144,2021-04-11,TOS,3642,1679,1963,3487,155,ITI,ITI1,9,Toscana,Toscana,3729641,2119837,56.84,0.1
2145,2021-02-20,TOS,4640,1789,2851,4127,513,ITI,ITI1,9,Toscana,Toscana,3729641,2124477,56.96,0.12
2146,2021-01-01,TOS,2369,787,1582,2369,0,ITI,ITI1,9,Toscana,Toscana,3729641,2126846,57.03,0.06
2147,2021-03-06,TOS,7094,2838,4256,2901,4193,ITI,ITI1,9,Toscana,Toscana,3729641,2133940,57.22,0.19
2148,2021-01-15,TOS,3878,1347,2531,3878,0,ITI,ITI1,9,Toscana,Toscana,3729641,2137818,57.32,0.1
2149,2021-06-01,TOS,7099,3455,3644,5868,1231,ITI,ITI1,9,Toscana,Toscana,3729641,2144917,57.51,0.19
2150,2021-04-12,TOS,2612,1183,1429,1958,654,ITI,ITI1,9,Toscana,Toscana,3729641,2147529,57.58,0.07
2151,2021-02-21,TOS,5105,2089,3016,4935,170,ITI,ITI1,9,Toscana,Toscana,3729641,2152634,57.72,0.14
2152,2021-04-14,VEN,15869,6879,8990,9243,6626,ITH,ITH3,5,Veneto,Veneto,4905854,15869,0.32,0.32
2153,2021-05-31,VEN,30952,15852,15100,21565,9387,ITH,ITH3,5,Veneto,Veneto,4905854,46821,0.95,0.63
2154,2021-03-28,VEN,31250,13586,17664,27614,3636,ITH,ITH3,5,Veneto,Veneto,4905854,78071,1.59,0.64
2155,2021-03-11,VEN,19708,8775,10933,14128,5580,ITH,ITH3,5,Veneto,Veneto,4905854,97779,1.99,0.4
2156,2021-05-14,VEN,46266,22014,24252,25641,20625,ITH,ITH3,5,Veneto,Veneto,4905854,144045,2.94,0.94
2157,2021-05-05,VEN,43905,21061,22844,37395,6510,ITH,ITH3,5,Veneto,Veneto,4905854,187950,3.83,0.89
2158,2021-03-16,VEN,12516,5347,7169,6902,5614,ITH,ITH3,5,Veneto,Veneto,4905854,200466,4.09,0.26
2159,2021-03-23,VEN,22148,10186,11962,17429,4719,ITH,ITH3,5,Veneto,Veneto,4905854,222614,4.54,0.45
2160,2021-05-19,VEN,32338,14835,17503,16630,15708,ITH,ITH3,5,Veneto,Veneto,4905854,254952,5.2,0.66
2161,2021-02-01,VEN,8557,2500,6057,161,8396,ITH,ITH3,5,Veneto,Veneto,4905854,263509,5.37,0.17
2162,2021-04-06,VEN,28876,13275,15601,23802,5074,ITH,ITH3,5,Veneto,Veneto,4905854,292385,5.96,0.59
2163,2021-05-12,VEN,36205,17518,18687,31152,5053,ITH,ITH3,5,Veneto,Veneto,4905854,328590,6.7,0.74
2164,2021-03-30,VEN,35886,15238,20648,30637,5249,ITH,ITH3,5,Veneto,Veneto,4905854,364476,7.43,0.73
2165,2021-02-08,VEN,4976,1541,3435,1929,3047,ITH,ITH3,5,Veneto,Veneto,4905854,369452,7.53,0.1
2166,2021-02-15,VEN,4386,1821,2565,4146,240,ITH,ITH3,5,Veneto,Veneto,4905854,373838,7.62,0.09
2167,2021-05-22,VEN,34638,16624,18014,13281,21357,ITH,ITH3,5,Veneto,Veneto,4905854,408476,8.33,0.71
2168,2021-01-28,VEN,9209,2662,6547,173,9036,ITH,ITH3,5,Veneto,Veneto,4905854,417685,8.51,0.19
2169,2021-04-02,VEN,23974,10549,13425,17643,6331,ITH,ITH3,5,Veneto,Veneto,4905854,441659,9.0,0.49
2170,2021-01-11,VEN,7238,2101,5137,7238,0,ITH,ITH3,5,Veneto,Veneto,4905854,448897,9.15,0.15
2171,2021-03-02,VEN,11483,4622,6861,8175,3308,ITH,ITH3,5,Veneto,Veneto,4905854,460380,9.38,0.23
2172,2021-05-26,VEN,29447,14360,15087,13532,15915,ITH,ITH3,5,Veneto,Veneto,4905854,489827,9.98,0.6
2173,2021-04-23,VEN,31148,13799,17349,22447,8701,ITH,ITH3,5,Veneto,Veneto,4905854,520975,10.62,0.63
2174,2021-02-18,VEN,5828,2455,3373,5764,64,ITH,ITH3,5,Veneto,Veneto,4905854,526803,10.74,0.12
2175,2021-04-18,VEN,17518,7255,10263,9945,7573,ITH,ITH3,5,Veneto,Veneto,4905854,544321,11.1,0.36
2176,2021-01-06,VEN,8132,2385,5747,8132,0,ITH,ITH3,5,Veneto,Veneto,4905854,552453,11.26,0.17
2177,2021-05-17,VEN,26352,12928,13424,16426,9926,ITH,ITH3,5,Veneto,Veneto,4905854,578805,11.8,0.54
2178,2021-02-06,VEN,4095,1354,2741,709,3386,ITH,ITH3,5,Veneto,Veneto,4905854,582900,11.88,0.08
2179,2021-04-11,VEN,21002,8873,12129,14695,6307,ITH,ITH3,5,Veneto,Veneto,4905854,603902,12.31,0.43
2180,2021-01-01,VEN,1528,471,1057,1528,0,ITH,ITH3,5,Veneto,Veneto,4905854,605430,12.34,0.03
2181,2021-04-13,VEN,14020,6319,7701,8534,5486,ITH,ITH3,5,Veneto,Veneto,4905854,619450,12.63,0.29
2182,2021-01-03,VEN,5157,1562,3595,5157,0,ITH,ITH3,5,Veneto,Veneto,4905854,624607,12.73,0.11
2183,2021-01-16,VEN,4611,1542,3069,4611,0,ITH,ITH3,5,Veneto,Veneto,4905854,629218,12.83,0.09
2184,2021-03-14,VEN,15166,5935,9231,14272,894,ITH,ITH3,5,Veneto,Veneto,4905854,644384,13.14,0.31
2185,2021-05-10,VEN,36337,16994,19343,26507,9830,ITH,ITH3,5,Veneto,Veneto,4905854,680721,13.88,0.74
2186,2021-03-07,VEN,4475,1756,2719,3914,561,ITH,ITH3,5,Veneto,Veneto,4905854,685196,13.97,0.09
2187,2021-05-03,VEN,40582,19763,20819,34157,6425,ITH,ITH3,5,Veneto,Veneto,4905854,725778,14.79,0.83
2188,2021-01-23,VEN,4050,1246,2804,31,4019,ITH,ITH3,5,Veneto,Veneto,4905854,729828,14.88,0.08
2189,2021-03-21,VEN,11984,4754,7230,8522,3462,ITH,ITH3,5,Veneto,Veneto,4905854,741812,15.12,0.24
2190,2021-01-30,VEN,8747,2672,6075,693,8054,ITH,ITH3,5,Veneto,Veneto,4905854,750559,15.3,0.18
2191,2021-01-09,VEN,7927,2539,5388,7927,0,ITH,ITH3,5,Veneto,Veneto,4905854,758486,15.46,0.16
2192,2021-04-04,VEN,7775,3531,4244,6624,1151,ITH,ITH3,5,Veneto,Veneto,4905854,766261,15.62,0.16
2193,2021-05-24,VEN,32551,16088,16463,7711,24840,ITH,ITH3,5,Veneto,Veneto,4905854,798812,16.28,0.66
2194,2021-02-13,VEN,3267,1474,1793,3247,20,ITH,ITH3,5,Veneto,Veneto,4905854,802079,16.35,0.07
2195,2021-03-26,VEN,29541,13118,16423,24074,5467,ITH,ITH3,5,Veneto,Veneto,4905854,831620,16.95,0.6
2196,2021-03-09,VEN,16464,7382,9082,10145,6319,ITH,ITH3,5,Veneto,Veneto,4905854,848084,17.29,0.34
2197,2021-01-04,VEN,6736,2033,4703,6736,0,ITH,ITH3,5,Veneto,Veneto,4905854,854820,17.42,0.14
2198,2021-02-20,VEN,6424,2014,4410,6353,71,ITH,ITH3,5,Veneto,Veneto,4905854,861244,17.56,0.13
2199,2021-02-25,VEN,7899,3339,4560,7294,605,ITH,ITH3,5,Veneto,Veneto,4905854,869143,17.72,0.16
2200,2021-04-09,VEN,31096,13692,17404,22759,8337,ITH,ITH3,5,Veneto,Veneto,4905854,900239,18.35,0.63
2201,2020-12-30,VEN,699,245,454,699,0,ITH,ITH3,5,Veneto,Veneto,4905854,900938,18.36,0.01
2202,2021-03-04,VEN,12919,4828,8091,9448,3471,ITH,ITH3,5,Veneto,Veneto,4905854,913857,18.63,0.26
2203,2021-04-21,VEN,32315,13176,19139,16249,16066,ITH,ITH3,5,Veneto,Veneto,4905854,946172,19.29,0.66
2204,2021-02-11,VEN,4013,1238,2775,3385,628,ITH,ITH3,5,Veneto,Veneto,4905854,950185,19.37,0.08
2205,2021-01-25,VEN,6468,2075,4393,159,6309,ITH,ITH3,5,Veneto,Veneto,4905854,956653,19.5,0.13
2206,2021-04-20,VEN,22403,9486,12917,8404,13999,ITH,ITH3,5,Veneto,Veneto,4905854,979056,19.96,0.46
2207,2021-02-23,VEN,7375,3250,4125,7105,270,ITH,ITH3,5,Veneto,Veneto,4905854,986431,20.11,0.15
2208,2021-02-04,VEN,7388,2024,5364,553,6835,ITH,ITH3,5,Veneto,Veneto,4905854,993819,20.26,0.15
2209,2021-04-28,VEN,32373,15158,17215,23353,9020,ITH,ITH3,5,Veneto,Veneto,4905854,1026192,20.92,0.66
2210,2021-01-18,VEN,2762,776,1986,2563,199,ITH,ITH3,5,Veneto,Veneto,4905854,1028954,20.97,0.06
2211,2021-04-30,VEN,49917,23440,26477,34267,15650,ITH,ITH3,5,Veneto,Veneto,4905854,1078871,21.99,1.02
2212,2021-01-20,VEN,1038,368,670,386,652,ITH,ITH3,5,Veneto,Veneto,4905854,1079909,22.01,0.02
2213,2021-03-25,VEN,25836,10950,14886,19716,6120,ITH,ITH3,5,Veneto,Veneto,4905854,1105745,22.54,0.53
2214,2021-04-27,VEN,28105,12747,15358,21188,6917,ITH,ITH3,5,Veneto,Veneto,4905854,1133850,23.11,0.57
2215,2021-02-22,VEN,7013,3040,3973,6626,387,ITH,ITH3,5,Veneto,Veneto,4905854,1140863,23.26,0.14
2216,2021-02-05,VEN,8371,2534,5837,1413,6958,ITH,ITH3,5,Veneto,Veneto,4905854,1149234,23.43,0.17
2217,2021-01-19,VEN,1309,472,837,1159,150,ITH,ITH3,5,Veneto,Veneto,4905854,1150543,23.45,0.03
2218,2021-05-01,VEN,38761,18197,20564,29847,8914,ITH,ITH3,5,Veneto,Veneto,4905854,1189304,24.24,0.79
2219,2021-01-02,VEN,5743,1766,3977,5743,0,ITH,ITH3,5,Veneto,Veneto,4905854,1195047,24.36,0.12
2220,2021-02-16,VEN,6639,2870,3769,6462,177,ITH,ITH3,5,Veneto,Veneto,4905854,1201686,24.49,0.14
2221,2021-05-29,VEN,31949,16189,15760,25190,6759,ITH,ITH3,5,Veneto,Veneto,4905854,1233635,25.15,0.65
2222,2021-04-16,VEN,24420,10480,13940,12537,11883,ITH,ITH3,5,Veneto,Veneto,4905854,1258055,25.64,0.5
2223,2021-01-13,VEN,5985,1606,4379,5985,0,ITH,ITH3,5,Veneto,Veneto,4905854,1264040,25.77,0.12
2224,2021-01-08,VEN,9404,2835,6569,9404,0,ITH,ITH3,5,Veneto,Veneto,4905854,1273444,25.96,0.19
2225,2021-04-25,VEN,18310,8146,10164,13477,4833,ITH,ITH3,5,Veneto,Veneto,4905854,1291754,26.33,0.37
2226,2021-05-28,VEN,44446,21851,22595,24531,19915,ITH,ITH3,5,Veneto,Veneto,4905854,1336200,27.24,0.91
2227,2021-05-21,VEN,44474,21881,22593,20822,23652,ITH,ITH3,5,Veneto,Veneto,4905854,1380674,28.14,0.91
2228,2021-05-02,VEN,37221,17254,19967,26886,10335,ITH,ITH3,5,Veneto,Veneto,4905854,1417895,28.9,0.76
2229,2021-03-06,VEN,10627,4316,6311,7365,3262,ITH,ITH3,5,Veneto,Veneto,4905854,1428522,29.12,0.22
2230,2021-04-10,VEN,27444,11971,15473,18963,8481,ITH,ITH3,5,Veneto,Veneto,4905854,1455966,29.68,0.56
2231,2021-05-30,VEN,22446,11226,11220,15814,6632,ITH,ITH3,5,Veneto,Veneto,4905854,1478412,30.14,0.46
2232,2021-02-26,VEN,8292,3270,5022,7036,1256,ITH,ITH3,5,Veneto,Veneto,4905854,1486704,30.3,0.17
2233,2021-01-14,VEN,7062,1924,5138,7062,0,ITH,ITH3,5,Veneto,Veneto,4905854,1493766,30.45,0.14
2234,2021-03-12,VEN,18572,8125,10447,11826,6746,ITH,ITH3,5,Veneto,Veneto,4905854,1512338,30.83,0.38
2235,2021-01-07,VEN,8358,2318,6040,8358,0,ITH,ITH3,5,Veneto,Veneto,4905854,1520696,31.0,0.17
2236,2021-01-15,VEN,5874,1819,4055,5874,0,ITH,ITH3,5,Veneto,Veneto,4905854,1526570,31.12,0.12
2237,2021-03-15,VEN,16601,7266,9335,11384,5217,ITH,ITH3,5,Veneto,Veneto,4905854,1543171,31.46,0.34
2238,2021-05-18,VEN,26623,12408,14215,13215,13408,ITH,ITH3,5,Veneto,Veneto,4905854,1569794,32.0,0.54
2239,2021-03-24,VEN,22020,9504,12516,15212,6808,ITH,ITH3,5,Veneto,Veneto,4905854,1591814,32.45,0.45
2240,2021-02-09,VEN,5246,1889,3357,3446,1800,ITH,ITH3,5,Veneto,Veneto,4905854,1597060,32.55,0.11
2241,2021-05-27,VEN,45248,22224,23024,22832,22416,ITH,ITH3,5,Veneto,Veneto,4905854,1642308,33.48,0.92
2242,2020-12-27,VEN,880,395,485,880,0,ITH,ITH3,5,Veneto,Veneto,4905854,1643188,33.49,0.02
2243,2021-04-24,VEN,24730,10819,13911,15652,9078,ITH,ITH3,5,Veneto,Veneto,4905854,1667918,34.0,0.5
2244,2021-04-17,VEN,22403,9078,13325,15121,7282,ITH,ITH3,5,Veneto,Veneto,4905854,1690321,34.46,0.46
2245,2021-03-05,VEN,13286,4978,8308,9625,3661,ITH,ITH3,5,Veneto,Veneto,4905854,1703607,34.73,0.27
2246,2021-01-21,VEN,2292,719,1573,21,2271,ITH,ITH3,5,Veneto,Veneto,4905854,1705899,34.77,0.05
2247,2021-03-08,VEN,13549,6195,7354,9480,4069,ITH,ITH3,5,Veneto,Veneto,4905854,1719448,35.05,0.28
2248,2021-03-27,VEN,32049,13988,18061,26243,5806,ITH,ITH3,5,Veneto,Veneto,4905854,1751497,35.7,0.65
2249,2021-02-19,VEN,7322,3140,4182,7118,204,ITH,ITH3,5,Veneto,Veneto,4905854,1758819,35.85,0.15
2250,2021-06-01,VEN,10288,5328,4960,6616,3672,ITH,ITH3,5,Veneto,Veneto,4905854,1769107,36.06,0.21
2251,2021-02-21,VEN,4633,1209,3424,4628,5,ITH,ITH3,5,Veneto,Veneto,4905854,1773740,36.16,0.09
2252,2021-05-09,VEN,34925,16056,18869,24868,10057,ITH,ITH3,5,Veneto,Veneto,4905854,1808665,36.87,0.71
2253,2021-03-20,VEN,12943,5340,7603,10848,2095,ITH,ITH3,5,Veneto,Veneto,4905854,1821608,37.13,0.26
2254,2021-01-10,VEN,5032,1671,3361,5032,0,ITH,ITH3,5,Veneto,Veneto,4905854,1826640,37.23,0.1
2255,2021-05-23,VEN,34438,16442,17996,11067,23371,ITH,ITH3,5,Veneto,Veneto,4905854,1861078,37.94,0.7
2256,2021-05-25,VEN,27120,13019,14101,11473,15647,ITH,ITH3,5,Veneto,Veneto,4905854,1888198,38.49,0.55
2257,2021-04-05,VEN,19137,8367,10770,13697,5440,ITH,ITH3,5,Veneto,Veneto,4905854,1907335,38.88,0.39
2258,2021-02-14,VEN,125,56,69,112,13,ITH,ITH3,5,Veneto,Veneto,4905854,1907460,38.88,0.0
2259,2021-02-28,VEN,4136,1389,2747,3299,837,ITH,ITH3,5,Veneto,Veneto,4905854,1911596,38.97,0.08
2260,2021-04-26,VEN,20710,9451,11259,15567,5143,ITH,ITH3,5,Veneto,Veneto,4905854,1932306,39.39,0.42
2261,2021-05-13,VEN,43770,21617,22153,33917,9853,ITH,ITH3,5,Veneto,Veneto,4905854,1976076,40.28,0.89
2262,2021-04-07,VEN,35890,16110,19780,28560,7330,ITH,ITH3,5,Veneto,Veneto,4905854,2011966,41.01,0.73
2263,2021-02-02,VEN,6508,1878,4630,396,6112,ITH,ITH3,5,Veneto,Veneto,4905854,2018474,41.14,0.13
2264,2021-03-31,VEN,38604,16235,22369,31110,7494,ITH,ITH3,5,Veneto,Veneto,4905854,2057078,41.93,0.79
2265,2021-02-03,VEN,5938,1664,4274,480,5458,ITH,ITH3,5,Veneto,Veneto,4905854,2063016,42.05,0.12
2266,2021-05-16,VEN,28397,14002,14395,21319,7078,ITH,ITH3,5,Veneto,Veneto,4905854,2091413,42.63,0.58
2267,2021-01-17,VEN,1933,781,1152,1584,349,ITH,ITH3,5,Veneto,Veneto,4905854,2093346,42.67,0.04
2268,2021-04-29,VEN,50211,23356,26855,37026,13185,ITH,ITH3,5,Veneto,Veneto,4905854,2143557,43.69,1.02
2269,2020-12-31,VEN,3219,1042,2177,3219,0,ITH,ITH3,5,Veneto,Veneto,4905854,2146776,43.76,0.07
2270,2021-04-12,VEN,14903,6335,8568,6684,8219,ITH,ITH3,5,Veneto,Veneto,4905854,2161679,44.06,0.3
2271,2021-03-10,VEN,18938,8638,10300,13255,5683,ITH,ITH3,5,Veneto,Veneto,4905854,2180617,44.45,0.39
2272,2021-03-13,VEN,17178,7259,9919,14045,3133,ITH,ITH3,5,Veneto,Veneto,4905854,2197795,44.8,0.35
2273,2021-03-22,VEN,18093,8134,9959,13050,5043,ITH,ITH3,5,Veneto,Veneto,4905854,2215888,45.17,0.37
2274,2021-05-20,VEN,44209,21004,23205,20098,24111,ITH,ITH3,5,Veneto,Veneto,4905854,2260097,46.07,0.9
2275,2021-02-07,VEN,2315,862,1453,714,1601,ITH,ITH3,5,Veneto,Veneto,4905854,2262412,46.12,0.05
2276,2021-02-27,VEN,8987,2691,6296,8140,847,ITH,ITH3,5,Veneto,Veneto,4905854,2271399,46.3,0.18
2277,2021-01-22,VEN,1080,332,748,25,1055,ITH,ITH3,5,Veneto,Veneto,4905854,2272479,46.32,0.02
2278,2021-05-04,VEN,42778,20260,22518,34770,8008,ITH,ITH3,5,Veneto,Veneto,4905854,2315257,47.19,0.87
2279,2021-05-11,VEN,32893,16404,16489,28217,4676,ITH,ITH3,5,Veneto,Veneto,4905854,2348150,47.86,0.67
2280,2021-01-24,VEN,4117,1219,2898,28,4089,ITH,ITH3,5,Veneto,Veneto,4905854,2352267,47.95,0.08
2281,2021-01-31,VEN,4769,1562,3207,392,4377,ITH,ITH3,5,Veneto,Veneto,4905854,2357036,48.05,0.1
2282,2021-03-29,VEN,31393,13631,17762,27559,3834,ITH,ITH3,5,Veneto,Veneto,4905854,2388429,48.69,0.64
2283,2021-02-17,VEN,6022,2772,3250,5928,94,ITH,ITH3,5,Veneto,Veneto,4905854,2394451,48.81,0.12
2284,2021-04-01,VEN,25197,11052,14145,18786,6411,ITH,ITH3,5,Veneto,Veneto,4905854,2419648,49.32,0.51
2285,2021-04-15,VEN,20824,8596,12228,10018,10806,ITH,ITH3,5,Veneto,Veneto,4905854,2440472,49.75,0.42
2286,2021-02-10,VEN,4751,1588,3163,3697,1054,ITH,ITH3,5,Veneto,Veneto,4905854,2445223,49.84,0.1
2287,2021-04-08,VEN,32313,14345,17968,24440,7873,ITH,ITH3,5,Veneto,Veneto,4905854,2477536,50.5,0.66
2288,2021-01-05,VEN,7329,2182,5147,7329,0,ITH,ITH3,5,Veneto,Veneto,4905854,2484865,50.65,0.15
2289,2021-02-24,VEN,8614,3678,4936,8128,486,ITH,ITH3,5,Veneto,Veneto,4905854,2493479,50.83,0.18
2290,2021-04-19,VEN,21527,8916,12611,5117,16410,ITH,ITH3,5,Veneto,Veneto,4905854,2515006,51.27,0.44
2291,2021-03-01,VEN,9394,3716,5678,7572,1822,ITH,ITH3,5,Veneto,Veneto,4905854,2524400,51.46,0.19
2292,2021-01-29,VEN,9019,2788,6231,367,8652,ITH,ITH3,5,Veneto,Veneto,4905854,2533419,51.64,0.18
2293,2021-04-03,VEN,21941,9626,12315,14225,7716,ITH,ITH3,5,Veneto,Veneto,4905854,2555360,52.09,0.45
2294,2021-02-12,VEN,4314,1447,2867,3742,572,ITH,ITH3,5,Veneto,Veneto,4905854,2559674,52.18,0.09
2295,2021-05-08,VEN,41164,18625,22539,29380,11784,ITH,ITH3,5,Veneto,Veneto,4905854,2600838,53.01,0.84
2296,2021-03-19,VEN,13790,5668,8122,7697,6093,ITH,ITH3,5,Veneto,Veneto,4905854,2614628,53.3,0.28
2297,2021-05-15,VEN,36038,17426,18612,26122,9916,ITH,ITH3,5,Veneto,Veneto,4905854,2650666,54.03,0.73
2298,2021-05-07,VEN,48011,23024,24987,39403,8608,ITH,ITH3,5,Veneto,Veneto,4905854,2698677,55.01,0.98
2299,2021-03-18,VEN,12608,5136,7472,7382,5226,ITH,ITH3,5,Veneto,Veneto,4905854,2711285,55.27,0.26
2300,2021-01-27,VEN,7138,2062,5076,241,6897,ITH,ITH3,5,Veneto,Veneto,4905854,2718423,55.41,0.15
2301,2021-03-03,VEN,12044,4597,7447,8546,3498,ITH,ITH3,5,Veneto,Veneto,4905854,2730467,55.66,0.25
2302,2021-04-22,VEN,31902,13888,18014,16156,15746,ITH,ITH3,5,Veneto,Veneto,4905854,2762369,56.31,0.65
2303,2021-03-17,VEN,14643,5991,8652,7849,6794,ITH,ITH3,5,Veneto,Veneto,4905854,2777012,56.61,0.3
2304,2021-01-12,VEN,5230,1516,3714,5230,0,ITH,ITH3,5,Veneto,Veneto,4905854,2782242,56.71,0.11
2305,2021-05-06,VEN,46471,21800,24671,38055,8416,ITH,ITH3,5,Veneto,Veneto,4905854,2828713,57.66,0.95
2306,2021-01-26,VEN,6917,2091,4826,152,6765,ITH,ITH3,5,Veneto,Veneto,4905854,2835630,57.8,0.14
2307,2021-05-31,UMB,5730,2796,2934,4882,848,ITI,ITI2,10,Umbria,Umbria,882015,5730,0.65,0.65
2308,2021-02-18,UMB,1496,582,914,1030,466,ITI,ITI2,10,Umbria,Umbria,882015,7226,0.82,0.17
2309,2021-05-14,UMB,5238,2435,2803,3433,1805,ITI,ITI2,10,Umbria,Umbria,882015,12464,1.41,0.59
2310,2021-02-01,UMB,1285,342,943,48,1237,ITI,ITI2,10,Umbria,Umbria,882015,13749,1.56,0.15
2311,2021-04-27,UMB,5664,2403,3261,3088,2576,ITI,ITI2,10,Umbria,Umbria,882015,19413,2.2,0.64
2312,2021-04-23,UMB,6607,2786,3821,3488,3119,ITI,ITI2,10,Umbria,Umbria,882015,26020,2.95,0.75
2313,2021-03-11,UMB,3565,1697,1868,2559,1006,ITI,ITI2,10,Umbria,Umbria,882015,29585,3.35,0.4
2314,2021-01-06,UMB,846,325,521,846,0,ITI,ITI2,10,Umbria,Umbria,882015,30431,3.45,0.1
2315,2021-01-20,UMB,613,222,391,613,0,ITI,ITI2,10,Umbria,Umbria,882015,31044,3.52,0.07
2316,2021-02-25,UMB,1336,497,839,1284,52,ITI,ITI2,10,Umbria,Umbria,882015,32380,3.67,0.15
2317,2021-04-16,UMB,8100,3742,4358,6263,1837,ITI,ITI2,10,Umbria,Umbria,882015,40480,4.59,0.92
2318,2021-04-30,UMB,6232,2962,3270,2843,3389,ITI,ITI2,10,Umbria,Umbria,882015,46712,5.3,0.71
2319,2021-01-13,UMB,450,139,311,450,0,ITI,ITI2,10,Umbria,Umbria,882015,47162,5.35,0.05
2320,2021-03-04,UMB,4485,1853,2632,3657,828,ITI,ITI2,10,Umbria,Umbria,882015,51647,5.86,0.51
2321,2021-05-11,UMB,6223,2826,3397,4024,2199,ITI,ITI2,10,Umbria,Umbria,882015,57870,6.56,0.71
2322,2021-01-27,UMB,840,330,510,13,827,ITI,ITI2,10,Umbria,Umbria,882015,58710,6.66,0.1
2323,2021-04-01,UMB,4374,1836,2538,2366,2008,ITI,ITI2,10,Umbria,Umbria,882015,63084,7.15,0.5
2324,2021-01-10,UMB,1070,277,793,1070,0,ITI,ITI2,10,Umbria,Umbria,882015,64154,7.27,0.12
2325,2021-03-15,UMB,4596,1930,2666,2828,1768,ITI,ITI2,10,Umbria,Umbria,882015,68750,7.79,0.52
2326,2021-03-28,UMB,1096,442,654,1072,24,ITI,ITI2,10,Umbria,Umbria,882015,69846,7.92,0.12
2327,2021-04-06,UMB,5290,2169,3121,2901,2389,ITI,ITI2,10,Umbria,Umbria,882015,75136,8.52,0.6
2328,2021-02-22,UMB,1859,778,1081,1773,86,ITI,ITI2,10,Umbria,Umbria,882015,76995,8.73,0.21
2329,2021-01-18,UMB,614,219,395,529,85,ITI,ITI2,10,Umbria,Umbria,882015,77609,8.8,0.07
2330,2021-03-25,UMB,3904,1699,2205,2840,1064,ITI,ITI2,10,Umbria,Umbria,882015,81513,9.24,0.44
2331,2021-03-08,UMB,3672,1801,1871,2309,1363,ITI,ITI2,10,Umbria,Umbria,882015,85185,9.66,0.42
2332,2021-01-11,UMB,1315,346,969,1315,0,ITI,ITI2,10,Umbria,Umbria,882015,86500,9.81,0.15
2333,2021-05-05,UMB,7173,3284,3889,3877,3296,ITI,ITI2,10,Umbria,Umbria,882015,93673,10.62,0.81
2334,2021-03-16,UMB,3538,1454,2084,1911,1627,ITI,ITI2,10,Umbria,Umbria,882015,97211,11.02,0.4
2335,2021-01-25,UMB,648,323,325,5,643,ITI,ITI2,10,Umbria,Umbria,882015,97859,11.09,0.07
2336,2021-03-09,UMB,4051,1971,2080,2760,1291,ITI,ITI2,10,Umbria,Umbria,882015,101910,11.55,0.46
2337,2021-02-20,UMB,282,100,182,258,24,ITI,ITI2,10,Umbria,Umbria,882015,102192,11.59,0.03
2338,2021-02-03,UMB,725,174,551,67,658,ITI,ITI2,10,Umbria,Umbria,882015,102917,11.67,0.08
2339,2021-05-16,UMB,5317,2534,2783,5265,52,ITI,ITI2,10,Umbria,Umbria,882015,108234,12.27,0.6
2340,2021-02-06,UMB,396,138,258,34,362,ITI,ITI2,10,Umbria,Umbria,882015,108630,12.32,0.04
2341,2021-05-07,UMB,10097,4692,5405,6898,3199,ITI,ITI2,10,Umbria,Umbria,882015,118727,13.46,1.14
2342,2021-03-18,UMB,2942,1164,1778,1704,1238,ITI,ITI2,10,Umbria,Umbria,882015,121669,13.79,0.33
2343,2021-04-20,UMB,5439,2356,3083,3492,1947,ITI,ITI2,10,Umbria,Umbria,882015,127108,14.41,0.62
2344,2021-05-21,UMB,8919,3635,5284,4116,4803,ITI,ITI2,10,Umbria,Umbria,882015,136027,15.42,1.01
2345,2021-05-04,UMB,5531,2543,2988,2410,3121,ITI,ITI2,10,Umbria,Umbria,882015,141558,16.05,0.63
2346,2021-03-01,UMB,1503,774,729,1389,114,ITI,ITI2,10,Umbria,Umbria,882015,143061,16.22,0.17
2347,2021-01-01,UMB,274,105,169,274,0,ITI,ITI2,10,Umbria,Umbria,882015,143335,16.25,0.03
2348,2021-04-11,UMB,3102,1503,1599,3053,49,ITI,ITI2,10,Umbria,Umbria,882015,146437,16.6,0.35
2349,2021-05-30,UMB,5971,2992,2979,5780,191,ITI,ITI2,10,Umbria,Umbria,882015,152408,17.28,0.68
2350,2021-03-27,UMB,4253,1512,2741,3913,340,ITI,ITI2,10,Umbria,Umbria,882015,156661,17.76,0.48
2351,2021-02-05,UMB,780,234,546,18,762,ITI,ITI2,10,Umbria,Umbria,882015,157441,17.85,0.09
2352,2021-04-10,UMB,7467,3512,3955,7332,135,ITI,ITI2,10,Umbria,Umbria,882015,164908,18.7,0.85
2353,2021-01-19,UMB,103,23,80,103,0,ITI,ITI2,10,Umbria,Umbria,882015,165011,18.71,0.01
2354,2021-03-24,UMB,4073,1760,2313,2750,1323,ITI,ITI2,10,Umbria,Umbria,882015,169084,19.17,0.46
2355,2021-01-02,UMB,304,111,193,304,0,ITI,ITI2,10,Umbria,Umbria,882015,169388,19.2,0.03
2356,2021-03-07,UMB,845,180,665,838,7,ITI,ITI2,10,Umbria,Umbria,882015,170233,19.3,0.1
2357,2021-01-30,UMB,1590,490,1100,44,1546,ITI,ITI2,10,Umbria,Umbria,882015,171823,19.48,0.18
2358,2021-05-12,UMB,6441,3004,3437,4301,2140,ITI,ITI2,10,Umbria,Umbria,882015,178264,20.21,0.73
2359,2021-03-30,UMB,3948,1705,2243,2416,1532,ITI,ITI2,10,Umbria,Umbria,882015,182212,20.66,0.45
2360,2020-12-27,UMB,86,45,41,86,0,ITI,ITI2,10,Umbria,Umbria,882015,182298,20.67,0.01
2361,2021-04-08,UMB,5832,2465,3367,4037,1795,ITI,ITI2,10,Umbria,Umbria,882015,188130,21.33,0.66
2362,2021-04-25,UMB,4364,1685,2679,4282,82,ITI,ITI2,10,Umbria,Umbria,882015,192494,21.82,0.49
2363,2021-03-06,UMB,4267,1110,3157,4124,143,ITI,ITI2,10,Umbria,Umbria,882015,196761,22.31,0.48
2364,2021-05-02,UMB,3787,1868,1919,1333,2454,ITI,ITI2,10,Umbria,Umbria,882015,200548,22.74,0.43
2365,2021-03-13,UMB,1731,524,1207,1486,245,ITI,ITI2,10,Umbria,Umbria,882015,202279,22.93,0.2
2366,2021-01-15,UMB,701,215,486,701,0,ITI,ITI2,10,Umbria,Umbria,882015,202980,23.01,0.08
2367,2021-05-09,UMB,5765,2757,3008,5374,391,ITI,ITI2,10,Umbria,Umbria,882015,208745,23.67,0.65
2368,2021-01-22,UMB,276,105,171,32,244,ITI,ITI2,10,Umbria,Umbria,882015,209021,23.7,0.03
2369,2021-03-20,UMB,2298,833,1465,2273,25,ITI,ITI2,10,Umbria,Umbria,882015,211319,23.96,0.26
2370,2021-05-19,UMB,9390,4197,5193,5651,3739,ITI,ITI2,10,Umbria,Umbria,882015,220709,25.02,1.06
2371,2021-03-23,UMB,3797,1685,2112,2168,1629,ITI,ITI2,10,Umbria,Umbria,882015,224506,25.45,0.43
2372,2021-02-08,UMB,637,203,434,88,549,ITI,ITI2,10,Umbria,Umbria,882015,225143,25.53,0.07
2373,2021-05-26,UMB,9608,4545,5063,8378,1230,ITI,ITI2,10,Umbria,Umbria,882015,234751,26.62,1.09
2374,2021-05-28,UMB,9457,4350,5107,7243,2214,ITI,ITI2,10,Umbria,Umbria,882015,244208,27.69,1.07
2375,2021-04-13,UMB,7676,3398,4278,6007,1669,ITI,ITI2,10,Umbria,Umbria,882015,251884,28.56,0.87
2376,2021-02-15,UMB,1368,692,676,1367,1,ITI,ITI2,10,Umbria,Umbria,882015,253252,28.71,0.16
2377,2021-04-15,UMB,7628,3483,4145,5742,1886,ITI,ITI2,10,Umbria,Umbria,882015,260880,29.58,0.86
2378,2021-02-17,UMB,1618,748,870,1267,351,ITI,ITI2,10,Umbria,Umbria,882015,262498,29.76,0.18
2379,2021-03-29,UMB,3844,1692,2152,2365,1479,ITI,ITI2,10,Umbria,Umbria,882015,266342,30.2,0.44
2380,2021-01-31,UMB,1058,276,782,25,1033,ITI,ITI2,10,Umbria,Umbria,882015,267400,30.32,0.12
2381,2021-05-18,UMB,7721,3341,4380,3883,3838,ITI,ITI2,10,Umbria,Umbria,882015,275121,31.19,0.88
2382,2021-04-05,UMB,4250,1728,2522,2195,2055,ITI,ITI2,10,Umbria,Umbria,882015,279371,31.67,0.48
2383,2021-03-03,UMB,4438,1773,2665,3727,711,ITI,ITI2,10,Umbria,Umbria,882015,283809,32.18,0.5
2384,2021-05-01,UMB,5373,2640,2733,2146,3227,ITI,ITI2,10,Umbria,Umbria,882015,289182,32.79,0.61
2385,2021-01-28,UMB,1247,394,853,19,1228,ITI,ITI2,10,Umbria,Umbria,882015,290429,32.93,0.14
2386,2021-05-10,UMB,5982,2799,3183,3830,2152,ITI,ITI2,10,Umbria,Umbria,882015,296411,33.61,0.68
2387,2021-01-23,UMB,280,100,180,2,278,ITI,ITI2,10,Umbria,Umbria,882015,296691,33.64,0.03
2388,2021-05-25,UMB,8753,4258,4495,7735,1018,ITI,ITI2,10,Umbria,Umbria,882015,305444,34.63,0.99
2389,2021-03-22,UMB,3559,1654,1905,2313,1246,ITI,ITI2,10,Umbria,Umbria,882015,309003,35.03,0.4
2390,2021-02-07,UMB,54,17,37,1,53,ITI,ITI2,10,Umbria,Umbria,882015,309057,35.04,0.01
2391,2021-03-10,UMB,4013,1927,2086,2757,1256,ITI,ITI2,10,Umbria,Umbria,882015,313070,35.49,0.45
2392,2021-05-13,UMB,5896,2655,3241,3823,2073,ITI,ITI2,10,Umbria,Umbria,882015,318966,36.16,0.67
2393,2021-02-02,UMB,944,274,670,32,912,ITI,ITI2,10,Umbria,Umbria,882015,319910,36.27,0.11
2394,2021-04-28,UMB,5346,2317,3029,2964,2382,ITI,ITI2,10,Umbria,Umbria,882015,325256,36.88,0.61
2395,2021-02-10,UMB,715,349,366,700,15,ITI,ITI2,10,Umbria,Umbria,882015,325971,36.96,0.08
2396,2021-01-24,UMB,258,106,152,1,257,ITI,ITI2,10,Umbria,Umbria,882015,326229,36.99,0.03
2397,2021-05-22,UMB,6909,2712,4197,2640,4269,ITI,ITI2,10,Umbria,Umbria,882015,333138,37.77,0.78
2398,2021-04-19,UMB,5015,2216,2799,2966,2049,ITI,ITI2,10,Umbria,Umbria,882015,338153,38.34,0.57
2399,2021-05-06,UMB,9453,4310,5143,6146,3307,ITI,ITI2,10,Umbria,Umbria,882015,347606,39.41,1.07
2400,2021-03-17,UMB,3331,1313,2018,1859,1472,ITI,ITI2,10,Umbria,Umbria,882015,350937,39.79,0.38
2401,2021-01-26,UMB,816,390,426,18,798,ITI,ITI2,10,Umbria,Umbria,882015,351753,39.88,0.09
2402,2021-04-21,UMB,5310,2308,3002,3084,2226,ITI,ITI2,10,Umbria,Umbria,882015,357063,40.48,0.6
2403,2021-03-02,UMB,3642,1346,2296,3638,4,ITI,ITI2,10,Umbria,Umbria,882015,360705,40.9,0.41
2404,2021-05-20,UMB,9825,4582,5243,6188,3637,ITI,ITI2,10,Umbria,Umbria,882015,370530,42.01,1.11
2405,2021-03-31,UMB,3903,1733,2170,2216,1687,ITI,ITI2,10,Umbria,Umbria,882015,374433,42.45,0.44
2406,2021-02-16,UMB,1308,655,653,1299,9,ITI,ITI2,10,Umbria,Umbria,882015,375741,42.6,0.15
2407,2021-05-27,UMB,9930,4828,5102,8647,1283,ITI,ITI2,10,Umbria,Umbria,882015,385671,43.73,1.13
2408,2021-04-14,UMB,8147,3673,4474,6168,1979,ITI,ITI2,10,Umbria,Umbria,882015,393818,44.65,0.92
2409,2021-04-07,UMB,5568,2289,3279,3562,2006,ITI,ITI2,10,Umbria,Umbria,882015,399386,45.28,0.63
2410,2021-01-04,UMB,810,398,412,810,0,ITI,ITI2,10,Umbria,Umbria,882015,400196,45.37,0.09
2411,2021-04-17,UMB,6665,3059,3606,5325,1340,ITI,ITI2,10,Umbria,Umbria,882015,406861,46.13,0.76
2412,2021-04-24,UMB,4562,1963,2599,3384,1178,ITI,ITI2,10,Umbria,Umbria,882015,411423,46.65,0.52
2413,2021-03-12,UMB,2653,1040,1613,2157,496,ITI,ITI2,10,Umbria,Umbria,882015,414076,46.95,0.3
2414,2021-01-14,UMB,752,201,551,752,0,ITI,ITI2,10,Umbria,Umbria,882015,414828,47.03,0.09
2415,2021-03-19,UMB,1743,565,1178,1087,656,ITI,ITI2,10,Umbria,Umbria,882015,416571,47.23,0.2
2416,2021-03-14,UMB,66,48,18,66,0,ITI,ITI2,10,Umbria,Umbria,882015,416637,47.24,0.01
2417,2021-03-21,UMB,665,330,335,665,0,ITI,ITI2,10,Umbria,Umbria,882015,417302,47.31,0.08
2418,2021-05-17,UMB,6360,3058,3302,4187,2173,ITI,ITI2,10,Umbria,Umbria,882015,423662,48.03,0.72
2419,2021-04-29,UMB,5209,2245,2964,2883,2326,ITI,ITI2,10,Umbria,Umbria,882015,428871,48.62,0.59
2420,2021-01-17,UMB,54,17,37,54,0,ITI,ITI2,10,Umbria,Umbria,882015,428925,48.63,0.01
2421,2021-04-12,UMB,7086,3076,4010,5369,1717,ITI,ITI2,10,Umbria,Umbria,882015,436011,49.43,0.8
2422,2020-12-31,UMB,322,127,195,322,0,ITI,ITI2,10,Umbria,Umbria,882015,436333,49.47,0.04
2423,2021-03-26,UMB,4570,1682,2888,4398,172,ITI,ITI2,10,Umbria,Umbria,882015,440903,49.99,0.52
2424,2021-02-19,UMB,743,293,450,526,217,ITI,ITI2,10,Umbria,Umbria,882015,441646,50.07,0.08
2425,2021-06-01,UMB,2011,948,1063,1917,94,ITI,ITI2,10,Umbria,Umbria,882015,443657,50.3,0.23
2426,2021-04-26,UMB,5374,2328,3046,3122,2252,ITI,ITI2,10,Umbria,Umbria,882015,449031,50.91,0.61
2427,2021-05-15,UMB,4977,1872,3105,1812,3165,ITI,ITI2,10,Umbria,Umbria,882015,454008,51.47,0.56
2428,2021-01-16,UMB,221,73,148,221,0,ITI,ITI2,10,Umbria,Umbria,882015,454229,51.5,0.03
2429,2021-04-09,UMB,6791,3162,3629,6572,219,ITI,ITI2,10,Umbria,Umbria,882015,461020,52.27,0.77
2430,2021-02-24,UMB,1520,565,955,1505,15,ITI,ITI2,10,Umbria,Umbria,882015,462540,52.44,0.17
2431,2021-03-05,UMB,4592,1379,3213,3936,656,ITI,ITI2,10,Umbria,Umbria,882015,467132,52.96,0.52
2432,2021-05-08,UMB,8100,3730,4370,4904,3196,ITI,ITI2,10,Umbria,Umbria,882015,475232,53.88,0.92
2433,2021-05-03,UMB,5091,2271,2820,2204,2887,ITI,ITI2,10,Umbria,Umbria,882015,480323,54.46,0.58
2434,2021-01-21,UMB,610,202,408,341,269,ITI,ITI2,10,Umbria,Umbria,882015,480933,54.53,0.07
2435,2021-01-03,UMB,270,112,158,270,0,ITI,ITI2,10,Umbria,Umbria,882015,481203,54.56,0.03
2436,2021-04-22,UMB,5427,2230,3197,2766,2661,ITI,ITI2,10,Umbria,Umbria,882015,486630,55.17,0.62
2437,2021-01-05,UMB,854,429,425,854,0,ITI,ITI2,10,Umbria,Umbria,882015,487484,55.27,0.1
2438,2021-01-12,UMB,838,248,590,838,0,ITI,ITI2,10,Umbria,Umbria,882015,488322,55.36,0.1
2439,2021-01-29,UMB,1232,348,884,79,1153,ITI,ITI2,10,Umbria,Umbria,882015,489554,55.5,0.14
2440,2021-02-11,UMB,842,349,493,837,5,ITI,ITI2,10,Umbria,Umbria,882015,490396,55.6,0.1
2441,2021-01-09,UMB,1745,499,1246,1745,0,ITI,ITI2,10,Umbria,Umbria,882015,492141,55.8,0.2
2442,2021-02-23,UMB,1693,658,1035,1651,42,ITI,ITI2,10,Umbria,Umbria,882015,493834,55.99,0.19
2443,2021-05-29,UMB,7823,3593,4230,6268,1555,ITI,ITI2,10,Umbria,Umbria,882015,501657,56.88,0.89
2444,2021-04-02,UMB,4308,1746,2562,3551,757,ITI,ITI2,10,Umbria,Umbria,882015,505965,57.36,0.49
2445,2021-02-04,UMB,733,226,507,25,708,ITI,ITI2,10,Umbria,Umbria,882015,506698,57.45,0.08
2446,2021-05-24,UMB,9015,4480,4535,8169,846,ITI,ITI2,10,Umbria,Umbria,882015,515713,58.47,1.02
2447,2021-04-04,UMB,59,20,39,23,36,ITI,ITI2,10,Umbria,Umbria,882015,515772,58.48,0.01
2448,2021-02-13,UMB,115,28,87,112,3,ITI,ITI2,10,Umbria,Umbria,882015,515887,58.49,0.01
2449,2021-04-18,UMB,1530,680,850,600,930,ITI,ITI2,10,Umbria,Umbria,882015,517417,58.66,0.17
2450,2021-02-27,UMB,1658,354,1304,1642,16,ITI,ITI2,10,Umbria,Umbria,882015,519075,58.85,0.19
2451,2021-01-08,UMB,1190,345,845,1190,0,ITI,ITI2,10,Umbria,Umbria,882015,520265,58.99,0.13
2452,2021-04-03,UMB,2111,716,1395,1058,1053,ITI,ITI2,10,Umbria,Umbria,882015,522376,59.23,0.24
2453,2021-05-23,UMB,5068,1855,3213,652,4416,ITI,ITI2,10,Umbria,Umbria,882015,527444,59.8,0.57
2454,2021-02-12,UMB,671,224,447,665,6,ITI,ITI2,10,Umbria,Umbria,882015,528115,59.88,0.08
2455,2021-01-07,UMB,1300,387,913,1300,0,ITI,ITI2,10,Umbria,Umbria,882015,529415,60.02,0.15
2456,2021-02-26,UMB,660,253,407,652,8,ITI,ITI2,10,Umbria,Umbria,882015,530075,60.1,0.07
2457,2021-01-23,SAR,60,22,38,0,60,ITG,ITG2,20,Sardegna,Sardegna,1639591,60,0.0,0.0
2458,2021-03-28,SAR,4619,1814,2805,4540,79,ITG,ITG2,20,Sardegna,Sardegna,1639591,4679,0.29,0.28
2459,2021-03-11,SAR,6036,2726,3310,4835,1201,ITG,ITG2,20,Sardegna,Sardegna,1639591,10715,0.65,0.37
2460,2021-01-06,SAR,1615,549,1066,1615,0,ITG,ITG2,20,Sardegna,Sardegna,1639591,12330,0.75,0.1
2461,2021-02-22,SAR,1639,949,690,1411,228,ITG,ITG2,20,Sardegna,Sardegna,1639591,13969,0.85,0.1
2462,2021-05-14,SAR,13881,6368,7513,10697,3184,ITG,ITG2,20,Sardegna,Sardegna,1639591,27850,1.7,0.85
2463,2021-01-27,SAR,1410,495,915,79,1331,ITG,ITG2,20,Sardegna,Sardegna,1639591,29260,1.78,0.09
2464,2021-04-01,SAR,10101,4026,6075,7088,3013,ITG,ITG2,20,Sardegna,Sardegna,1639591,39361,2.4,0.62
2465,2021-01-16,SAR,1492,525,967,1492,0,ITG,ITG2,20,Sardegna,Sardegna,1639591,40853,2.49,0.09
2466,2021-05-07,SAR,14124,6456,7668,9624,4500,ITG,ITG2,20,Sardegna,Sardegna,1639591,54977,3.35,0.86
2467,2021-03-18,SAR,7255,3070,4185,5652,1603,ITG,ITG2,20,Sardegna,Sardegna,1639591,62232,3.8,0.44
2468,2021-03-25,SAR,8795,3704,5091,7490,1305,ITG,ITG2,20,Sardegna,Sardegna,1639591,71027,4.33,0.54
2469,2021-05-21,SAR,20557,10034,10523,15062,5495,ITG,ITG2,20,Sardegna,Sardegna,1639591,91584,5.59,1.25
2470,2021-02-03,SAR,1119,419,700,426,693,ITG,ITG2,20,Sardegna,Sardegna,1639591,92703,5.65,0.07
2471,2021-05-10,SAR,9732,4336,5396,7195,2537,ITG,ITG2,20,Sardegna,Sardegna,1639591,102435,6.25,0.59
2472,2021-04-23,SAR,12844,5734,7110,7383,5461,ITG,ITG2,20,Sardegna,Sardegna,1639591,115279,7.03,0.78
2473,2021-02-13,SAR,1456,565,891,1454,2,ITG,ITG2,20,Sardegna,Sardegna,1639591,116735,7.12,0.09
2474,2021-02-18,SAR,1878,732,1146,1814,64,ITG,ITG2,20,Sardegna,Sardegna,1639591,118613,7.23,0.11
2475,2021-05-31,SAR,11069,5190,5879,8234,2835,ITG,ITG2,20,Sardegna,Sardegna,1639591,129682,7.91,0.68
2476,2021-04-18,SAR,5127,2225,2902,2258,2869,ITG,ITG2,20,Sardegna,Sardegna,1639591,134809,8.22,0.31
2477,2021-02-23,SAR,1519,1010,509,1285,234,ITG,ITG2,20,Sardegna,Sardegna,1639591,136328,8.31,0.09
2478,2021-05-19,SAR,14853,7285,7568,11389,3464,ITG,ITG2,20,Sardegna,Sardegna,1639591,151181,9.22,0.91
2479,2021-02-08,SAR,1470,533,937,856,614,ITG,ITG2,20,Sardegna,Sardegna,1639591,152651,9.31,0.09
2480,2021-04-15,SAR,11821,5525,6296,6865,4956,ITG,ITG2,20,Sardegna,Sardegna,1639591,164472,10.03,0.72
2481,2021-03-02,SAR,2865,1459,1406,1712,1153,ITG,ITG2,20,Sardegna,Sardegna,1639591,167337,10.21,0.17
2482,2021-04-28,SAR,9012,4271,4741,5315,3697,ITG,ITG2,20,Sardegna,Sardegna,1639591,176349,10.76,0.55
2483,2021-04-21,SAR,12072,5557,6515,6540,5532,ITG,ITG2,20,Sardegna,Sardegna,1639591,188421,11.49,0.74
2484,2021-03-09,SAR,5152,2373,2779,4423,729,ITG,ITG2,20,Sardegna,Sardegna,1639591,193573,11.81,0.31
2485,2021-05-05,SAR,10144,4640,5504,8134,2010,ITG,ITG2,20,Sardegna,Sardegna,1639591,203717,12.42,0.62
2486,2021-01-18,SAR,904,326,578,780,124,ITG,ITG2,20,Sardegna,Sardegna,1639591,204621,12.48,0.06
2487,2021-03-16,SAR,4374,1949,2425,3452,922,ITG,ITG2,20,Sardegna,Sardegna,1639591,208995,12.75,0.27
2488,2021-01-11,SAR,1183,505,678,1183,0,ITG,ITG2,20,Sardegna,Sardegna,1639591,210178,12.82,0.07
2489,2021-01-25,SAR,588,212,376,22,566,ITG,ITG2,20,Sardegna,Sardegna,1639591,210766,12.85,0.04
2490,2020-12-28,SAR,65,25,40,65,0,ITG,ITG2,20,Sardegna,Sardegna,1639591,210831,12.86,0.0
2491,2021-03-23,SAR,6157,2640,3517,5079,1078,ITG,ITG2,20,Sardegna,Sardegna,1639591,216988,13.23,0.38
2492,2021-05-12,SAR,10754,5026,5728,7675,3079,ITG,ITG2,20,Sardegna,Sardegna,1639591,227742,13.89,0.66
2493,2021-04-06,SAR,7446,3113,4333,5018,2428,ITG,ITG2,20,Sardegna,Sardegna,1639591,235188,14.34,0.45
2494,2021-02-01,SAR,1524,605,919,225,1299,ITG,ITG2,20,Sardegna,Sardegna,1639591,236712,14.44,0.09
2495,2021-05-26,SAR,14258,7082,7176,9781,4477,ITG,ITG2,20,Sardegna,Sardegna,1639591,250970,15.31,0.87
2496,2020-12-27,SAR,65,34,31,65,0,ITG,ITG2,20,Sardegna,Sardegna,1639591,251035,15.31,0.0
2497,2021-02-15,SAR,958,349,609,927,31,ITG,ITG2,20,Sardegna,Sardegna,1639591,251993,15.37,0.06
2498,2021-01-04,SAR,592,217,375,592,0,ITG,ITG2,20,Sardegna,Sardegna,1639591,252585,15.41,0.04
2499,2021-04-16,SAR,14441,6488,7953,9098,5343,ITG,ITG2,20,Sardegna,Sardegna,1639591,267026,16.29,0.88
2500,2021-03-30,SAR,8641,3462,5179,6367,2274,ITG,ITG2,20,Sardegna,Sardegna,1639591,275667,16.81,0.53
2501,2021-03-13,SAR,2754,1075,1679,2473,281,ITG,ITG2,20,Sardegna,Sardegna,1639591,278421,16.98,0.17
2502,2021-04-09,SAR,12261,5436,6825,7909,4352,ITG,ITG2,20,Sardegna,Sardegna,1639591,290682,17.73,0.75
2503,2021-02-04,SAR,2271,816,1455,916,1355,ITG,ITG2,20,Sardegna,Sardegna,1639591,292953,17.87,0.14
2504,2021-04-02,SAR,8987,3547,5440,5745,3242,ITG,ITG2,20,Sardegna,Sardegna,1639591,301940,18.42,0.55
2505,2021-04-11,SAR,5393,2442,2951,4273,1120,ITG,ITG2,20,Sardegna,Sardegna,1639591,307333,18.74,0.33
2506,2021-04-04,SAR,1,0,1,0,1,ITG,ITG2,20,Sardegna,Sardegna,1639591,307334,18.74,0.0
2507,2021-01-01,SAR,32,17,15,32,0,ITG,ITG2,20,Sardegna,Sardegna,1639591,307366,18.75,0.0
2508,2021-02-27,SAR,1921,647,1274,1366,555,ITG,ITG2,20,Sardegna,Sardegna,1639591,309287,18.86,0.12
2509,2021-03-21,SAR,4030,1809,2221,2590,1440,ITG,ITG2,20,Sardegna,Sardegna,1639591,313317,19.11,0.25
2510,2021-01-30,SAR,3863,1392,2471,362,3501,ITG,ITG2,20,Sardegna,Sardegna,1639591,317180,19.35,0.24
2511,2021-03-04,SAR,4002,1953,2049,2747,1255,ITG,ITG2,20,Sardegna,Sardegna,1639591,321182,19.59,0.24
2512,2021-01-13,SAR,573,178,395,573,0,ITG,ITG2,20,Sardegna,Sardegna,1639591,321755,19.62,0.03
2513,2021-05-28,SAR,17303,8259,9044,13438,3865,ITG,ITG2,20,Sardegna,Sardegna,1639591,339058,20.68,1.06
2514,2021-03-14,SAR,607,376,231,607,0,ITG,ITG2,20,Sardegna,Sardegna,1639591,339665,20.72,0.04
2515,2021-05-17,SAR,12114,5688,6426,9224,2890,ITG,ITG2,20,Sardegna,Sardegna,1639591,351779,21.46,0.74
2516,2021-02-25,SAR,2899,1255,1644,2294,605,ITG,ITG2,20,Sardegna,Sardegna,1639591,354678,21.63,0.18
2517,2021-04-30,SAR,11128,5297,5831,6919,4209,ITG,ITG2,20,Sardegna,Sardegna,1639591,365806,22.31,0.68
2518,2021-02-06,SAR,1970,697,1273,569,1401,ITG,ITG2,20,Sardegna,Sardegna,1639591,367776,22.43,0.12
2519,2021-01-20,SAR,210,77,133,208,2,ITG,ITG2,20,Sardegna,Sardegna,1639591,367986,22.44,0.01
2520,2021-05-02,SAR,5883,2669,3214,5302,581,ITG,ITG2,20,Sardegna,Sardegna,1639591,373869,22.8,0.36
2521,2021-05-18,SAR,13750,6639,7111,9290,4460,ITG,ITG2,20,Sardegna,Sardegna,1639591,387619,23.64,0.84
2522,2021-05-01,SAR,9902,4759,5143,5445,4457,ITG,ITG2,20,Sardegna,Sardegna,1639591,397521,24.25,0.6
2523,2021-02-26,SAR,2800,1108,1692,2494,306,ITG,ITG2,20,Sardegna,Sardegna,1639591,400321,24.42,0.17
2524,2021-04-14,SAR,8250,3902,4348,7013,1237,ITG,ITG2,20,Sardegna,Sardegna,1639591,408571,24.92,0.5
2525,2021-02-11,SAR,1315,490,825,1204,111,ITG,ITG2,20,Sardegna,Sardegna,1639591,409886,25.0,0.08
2526,2021-05-29,SAR,17688,8495,9193,13291,4397,ITG,ITG2,20,Sardegna,Sardegna,1639591,427574,26.08,1.08
2527,2021-05-24,SAR,13582,6503,7079,8420,5162,ITG,ITG2,20,Sardegna,Sardegna,1639591,441156,26.91,0.83
2528,2021-02-20,SAR,2041,855,1186,1707,334,ITG,ITG2,20,Sardegna,Sardegna,1639591,443197,27.03,0.12
2529,2021-01-08,SAR,3258,1184,2074,3258,0,ITG,ITG2,20,Sardegna,Sardegna,1639591,446455,27.23,0.2
2530,2021-04-20,SAR,10992,4992,6000,7778,3214,ITG,ITG2,20,Sardegna,Sardegna,1639591,457447,27.9,0.67
2531,2021-05-16,SAR,8177,3812,4365,6017,2160,ITG,ITG2,20,Sardegna,Sardegna,1639591,465624,28.4,0.5
2532,2021-02-10,SAR,1959,765,1194,1441,518,ITG,ITG2,20,Sardegna,Sardegna,1639591,467583,28.52,0.12
2533,2021-04-19,SAR,10181,4617,5564,8762,1419,ITG,ITG2,20,Sardegna,Sardegna,1639591,477764,29.14,0.62
2534,2021-01-02,SAR,60,21,39,60,0,ITG,ITG2,20,Sardegna,Sardegna,1639591,477824,29.14,0.0
2535,2021-04-26,SAR,6820,3263,3557,5945,875,ITG,ITG2,20,Sardegna,Sardegna,1639591,484644,29.56,0.42
2536,2021-02-21,SAR,1589,710,879,1559,30,ITG,ITG2,20,Sardegna,Sardegna,1639591,486233,29.66,0.1
2537,2021-03-07,SAR,1657,750,907,1117,540,ITG,ITG2,20,Sardegna,Sardegna,1639591,487890,29.76,0.1
2538,2021-01-10,SAR,2183,750,1433,2183,0,ITG,ITG2,20,Sardegna,Sardegna,1639591,490073,29.89,0.13
2539,2021-04-27,SAR,7606,3547,4059,5565,2041,ITG,ITG2,20,Sardegna,Sardegna,1639591,497679,30.35,0.46
2540,2021-03-15,SAR,2688,1219,1469,2315,373,ITG,ITG2,20,Sardegna,Sardegna,1639591,500367,30.52,0.16
2541,2021-01-19,SAR,747,270,477,692,55,ITG,ITG2,20,Sardegna,Sardegna,1639591,501114,30.56,0.05
2542,2021-03-24,SAR,7287,2998,4289,5928,1359,ITG,ITG2,20,Sardegna,Sardegna,1639591,508401,31.01,0.44
2543,2021-05-22,SAR,24294,11624,12670,19364,4930,ITG,ITG2,20,Sardegna,Sardegna,1639591,532695,32.49,1.48
2544,2021-04-12,SAR,6990,3179,3811,5276,1714,ITG,ITG2,20,Sardegna,Sardegna,1639591,539685,32.92,0.43
2545,2021-06-01,SAR,4867,2302,2565,3085,1782,ITG,ITG2,20,Sardegna,Sardegna,1639591,544552,33.21,0.3
2546,2021-02-28,SAR,368,169,199,142,226,ITG,ITG2,20,Sardegna,Sardegna,1639591,544920,33.24,0.02
2547,2021-01-03,SAR,90,36,54,90,0,ITG,ITG2,20,Sardegna,Sardegna,1639591,545010,33.24,0.01
2548,2021-03-29,SAR,4425,1559,2866,3837,588,ITG,ITG2,20,Sardegna,Sardegna,1639591,549435,33.51,0.27
2549,2021-01-05,SAR,1327,446,881,1327,0,ITG,ITG2,20,Sardegna,Sardegna,1639591,550762,33.59,0.08
2550,2021-03-31,SAR,10154,4050,6104,7707,2447,ITG,ITG2,20,Sardegna,Sardegna,1639591,560916,34.21,0.62
2551,2021-02-17,SAR,1407,577,830,1333,74,ITG,ITG2,20,Sardegna,Sardegna,1639591,562323,34.3,0.09
2552,2020-12-29,SAR,57,32,25,57,0,ITG,ITG2,20,Sardegna,Sardegna,1639591,562380,34.3,0.0
2553,2021-04-22,SAR,10480,4641,5839,5561,4919,ITG,ITG2,20,Sardegna,Sardegna,1639591,572860,34.94,0.64
2554,2021-03-03,SAR,3859,2073,1786,2611,1248,ITG,ITG2,20,Sardegna,Sardegna,1639591,576719,35.17,0.24
2555,2021-01-31,SAR,2121,750,1371,48,2073,ITG,ITG2,20,Sardegna,Sardegna,1639591,578840,35.3,0.13
2556,2021-02-14,SAR,539,263,276,537,2,ITG,ITG2,20,Sardegna,Sardegna,1639591,579379,35.34,0.03
2557,2021-04-05,SAR,2036,784,1252,2035,1,ITG,ITG2,20,Sardegna,Sardegna,1639591,581415,35.46,0.12
2558,2021-05-27,SAR,16240,8175,8065,11532,4708,ITG,ITG2,20,Sardegna,Sardegna,1639591,597655,36.45,0.99
2559,2021-02-16,SAR,700,289,411,673,27,ITG,ITG2,20,Sardegna,Sardegna,1639591,598355,36.49,0.04
2560,2021-05-08,SAR,13074,5959,7115,10788,2286,ITG,ITG2,20,Sardegna,Sardegna,1639591,611429,37.29,0.8
2561,2021-05-15,SAR,13754,6416,7338,10325,3429,ITG,ITG2,20,Sardegna,Sardegna,1639591,625183,38.13,0.84
2562,2021-02-24,SAR,2412,1293,1119,2223,189,ITG,ITG2,20,Sardegna,Sardegna,1639591,627595,38.28,0.15
2563,2021-02-07,SAR,1117,395,722,228,889,ITG,ITG2,20,Sardegna,Sardegna,1639591,628712,38.35,0.07
2564,2021-05-20,SAR,15849,7497,8352,11301,4548,ITG,ITG2,20,Sardegna,Sardegna,1639591,644561,39.31,0.97
2565,2021-01-21,SAR,126,60,66,94,32,ITG,ITG2,20,Sardegna,Sardegna,1639591,644687,39.32,0.01
2566,2021-01-22,SAR,83,47,36,55,28,ITG,ITG2,20,Sardegna,Sardegna,1639591,644770,39.33,0.01
2567,2021-04-17,SAR,10078,4500,5578,5481,4597,ITG,ITG2,20,Sardegna,Sardegna,1639591,654848,39.94,0.61
2568,2021-01-17,SAR,860,277,583,859,1,ITG,ITG2,20,Sardegna,Sardegna,1639591,655708,39.99,0.05
2569,2021-04-29,SAR,11108,5106,6002,6755,4353,ITG,ITG2,20,Sardegna,Sardegna,1639591,666816,40.67,0.68
2570,2021-03-17,SAR,6556,2849,3707,4949,1607,ITG,ITG2,20,Sardegna,Sardegna,1639591,673372,41.07,0.4
2571,2021-03-26,SAR,8091,3180,4911,6566,1525,ITG,ITG2,20,Sardegna,Sardegna,1639591,681463,41.56,0.49
2572,2021-04-13,SAR,7606,3593,4013,5781,1825,ITG,ITG2,20,Sardegna,Sardegna,1639591,689069,42.03,0.46
2573,2021-03-08,SAR,4008,1790,2218,2788,1220,ITG,ITG2,20,Sardegna,Sardegna,1639591,693077,42.27,0.24
2574,2021-05-04,SAR,9536,4385,5151,7684,1852,ITG,ITG2,20,Sardegna,Sardegna,1639591,702613,42.85,0.58
2575,2021-03-01,SAR,2162,1055,1107,1503,659,ITG,ITG2,20,Sardegna,Sardegna,1639591,704775,42.98,0.13
2576,2021-01-24,SAR,90,34,56,5,85,ITG,ITG2,20,Sardegna,Sardegna,1639591,704865,42.99,0.01
2577,2021-03-10,SAR,6011,2918,3093,5161,850,ITG,ITG2,20,Sardegna,Sardegna,1639591,710876,43.36,0.37
2578,2021-05-06,SAR,12942,6007,6935,9797,3145,ITG,ITG2,20,Sardegna,Sardegna,1639591,723818,44.15,0.79
2579,2021-05-13,SAR,11399,5281,6118,8425,2974,ITG,ITG2,20,Sardegna,Sardegna,1639591,735217,44.84,0.7
2580,2021-01-26,SAR,1336,453,883,27,1309,ITG,ITG2,20,Sardegna,Sardegna,1639591,736553,44.92,0.08
2581,2021-02-05,SAR,1897,749,1148,433,1464,ITG,ITG2,20,Sardegna,Sardegna,1639591,738450,45.04,0.12
2582,2021-04-03,SAR,4663,1802,2861,2696,1967,ITG,ITG2,20,Sardegna,Sardegna,1639591,743113,45.32,0.28
2583,2021-05-30,SAR,9726,4836,4890,7369,2357,ITG,ITG2,20,Sardegna,Sardegna,1639591,752839,45.92,0.59
2584,2021-03-27,SAR,5717,2177,3540,5295,422,ITG,ITG2,20,Sardegna,Sardegna,1639591,758556,46.26,0.35
2585,2021-05-23,SAR,9964,4805,5159,7720,2244,ITG,ITG2,20,Sardegna,Sardegna,1639591,768520,46.87,0.61
2586,2021-02-19,SAR,1499,473,1026,1443,56,ITG,ITG2,20,Sardegna,Sardegna,1639591,770019,46.96,0.09
2587,2021-02-12,SAR,2237,933,1304,2178,59,ITG,ITG2,20,Sardegna,Sardegna,1639591,772256,47.1,0.14
2588,2021-04-10,SAR,10489,4748,5741,8554,1935,ITG,ITG2,20,Sardegna,Sardegna,1639591,782745,47.74,0.64
2589,2021-01-07,SAR,3112,1077,2035,3112,0,ITG,ITG2,20,Sardegna,Sardegna,1639591,785857,47.93,0.19
2590,2020-12-31,SAR,32,16,16,32,0,ITG,ITG2,20,Sardegna,Sardegna,1639591,785889,47.93,0.0
2591,2021-02-09,SAR,2287,837,1450,1290,997,ITG,ITG2,20,Sardegna,Sardegna,1639591,788176,48.07,0.14
2592,2021-04-07,SAR,13477,5985,7492,7829,5648,ITG,ITG2,20,Sardegna,Sardegna,1639591,801653,48.89,0.82
2593,2021-04-08,SAR,13426,5924,7502,8307,5119,ITG,ITG2,20,Sardegna,Sardegna,1639591,815079,49.71,0.82
2594,2021-05-11,SAR,8648,3989,4659,6317,2331,ITG,ITG2,20,Sardegna,Sardegna,1639591,823727,50.24,0.53
2595,2021-05-25,SAR,13627,6659,6968,8296,5331,ITG,ITG2,20,Sardegna,Sardegna,1639591,837354,51.07,0.83
2596,2021-03-22,SAR,3551,1363,2188,3038,513,ITG,ITG2,20,Sardegna,Sardegna,1639591,840905,51.29,0.22
2597,2021-01-12,SAR,865,408,457,865,0,ITG,ITG2,20,Sardegna,Sardegna,1639591,841770,51.34,0.05
2598,2021-01-09,SAR,4026,1417,2609,4026,0,ITG,ITG2,20,Sardegna,Sardegna,1639591,845796,51.59,0.25
2599,2021-05-03,SAR,8180,3817,4363,6584,1596,ITG,ITG2,20,Sardegna,Sardegna,1639591,853976,52.08,0.5
2600,2021-03-12,SAR,6699,2796,3903,5342,1357,ITG,ITG2,20,Sardegna,Sardegna,1639591,860675,52.49,0.41
2601,2021-02-02,SAR,1482,655,827,241,1241,ITG,ITG2,20,Sardegna,Sardegna,1639591,862157,52.58,0.09
2602,2021-04-25,SAR,4497,2269,2228,3718,779,ITG,ITG2,20,Sardegna,Sardegna,1639591,866654,52.86,0.27
2603,2021-03-06,SAR,2639,1079,1560,858,1781,ITG,ITG2,20,Sardegna,Sardegna,1639591,869293,53.02,0.16
2604,2021-01-15,SAR,1563,573,990,1563,0,ITG,ITG2,20,Sardegna,Sardegna,1639591,870856,53.11,0.1
2605,2021-05-09,SAR,6128,2874,3254,5202,926,ITG,ITG2,20,Sardegna,Sardegna,1639591,876984,53.49,0.37
2606,2021-03-20,SAR,5193,2073,3120,2916,2277,ITG,ITG2,20,Sardegna,Sardegna,1639591,882177,53.8,0.32
2607,2021-01-29,SAR,2954,1068,1886,48,2906,ITG,ITG2,20,Sardegna,Sardegna,1639591,885131,53.98,0.18
2608,2021-03-05,SAR,5036,2445,2591,2682,2354,ITG,ITG2,20,Sardegna,Sardegna,1639591,890167,54.29,0.31
2609,2021-04-24,SAR,10367,4851,5516,8028,2339,ITG,ITG2,20,Sardegna,Sardegna,1639591,900534,54.92,0.63
2610,2021-01-28,SAR,2970,1045,1925,69,2901,ITG,ITG2,20,Sardegna,Sardegna,1639591,903504,55.11,0.18
2611,2021-03-19,SAR,7269,3049,4220,5054,2215,ITG,ITG2,20,Sardegna,Sardegna,1639591,910773,55.55,0.44
2612,2021-01-14,SAR,1105,426,679,1105,0,ITG,ITG2,20,Sardegna,Sardegna,1639591,911878,55.62,0.07
2613,2021-03-03,PAB,1179,393,786,1166,13,ITH,ITH1,4,Provincia Autonoma Bolzano / Bozen,P.A. Bolzano,533050,1179,0.22,0.22
2614,2021-05-27,PAB,6039,3172,2867,4035,2004,ITH,ITH1,4,Provincia Autonoma Bolzano / Bozen,P.A. Bolzano,533050,7218,1.35,1.13
2615,2021-02-14,PAB,297,130,167,297,0,ITH,ITH1,4,Provincia Autonoma Bolzano / Bozen,P.A. Bolzano,533050,7515,1.41,0.06
2616,2021-01-28,PAB,871,308,563,10,861,ITH,ITH1,4,Provincia Autonoma Bolzano / Bozen,P.A. Bolzano,533050,8386,1.57,0.16
2617,2021-05-10,PAB,3018,1300,1718,1413,1605,ITH,ITH1,4,Provincia Autonoma Bolzano / Bozen,P.A. Bolzano,533050,11404,2.14,0.57
2618,2021-01-24,PAB,12,10,2,0,12,ITH,ITH1,4,Provincia Autonoma Bolzano / Bozen,P.A. Bolzano,533050,11416,2.14,0.0
2619,2021-05-15,PAB,6995,3683,3312,6700,295,ITH,ITH1,4,Provincia Autonoma Bolzano / Bozen,P.A. Bolzano,533050,18411,3.45,1.31
2620,2021-05-22,PAB,6821,3552,3269,4654,2167,ITH,ITH1,4,Provincia Autonoma Bolzano / Bozen,P.A. Bolzano,533050,25232,4.73,1.28
2621,2021-04-02,PAB,2077,837,1240,720,1357,ITH,ITH1,4,Provincia Autonoma Bolzano / Bozen,P.A. Bolzano,533050,27309,5.12,0.39
2622,2021-03-26,PAB,1644,721,923,511,1133,ITH,ITH1,4,Provincia Autonoma Bolzano / Bozen,P.A. Bolzano,533050,28953,5.43,0.31
2623,2021-02-04,PAB,1958,593,1365,8,1950,ITH,ITH1,4,Provincia Autonoma Bolzano / Bozen,P.A. Bolzano,533050,30911,5.8,0.37
2624,2021-05-29,PAB,7124,3763,3361,3991,3133,ITH,ITH1,4,Provincia Autonoma Bolzano / Bozen,P.A. Bolzano,533050,38035,7.14,1.34
2625,2021-04-09,PAB,2926,1292,1634,2196,730,ITH,ITH1,4,Provincia Autonoma Bolzano / Bozen,P.A. Bolzano,533050,40961,7.68,0.55
2626,2021-02-11,PAB,1093,431,662,239,854,ITH,ITH1,4,Provincia Autonoma Bolzano / Bozen,P.A. Bolzano,533050,42054,7.89,0.21
2627,2021-05-18,PAB,3304,1728,1576,2140,1164,ITH,ITH1,4,Provincia Autonoma Bolzano / Bozen,P.A. Bolzano,533050,45358,8.51,0.62
2628,2021-03-29,PAB,1171,499,672,412,759,ITH,ITH1,4,Provincia Autonoma Bolzano / Bozen,P.A. Bolzano,533050,46529,8.73,0.22
2629,2021-05-01,PAB,2104,1067,1037,1944,160,ITH,ITH1,4,Provincia Autonoma Bolzano / Bozen,P.A. Bolzano,533050,48633,9.12,0.39
2630,2021-03-12,PAB,1664,734,930,1251,413,ITH,ITH1,4,Provincia Autonoma Bolzano / Bozen,P.A. Bolzano,533050,50297,9.44,0.31
2631,2021-04-10,PAB,5390,2664,2726,4802,588,ITH,ITH1,4,Provincia Autonoma Bolzano / Bozen,P.A. Bolzano,533050,55687,10.45,1.01
2632,2021-04-19,PAB,1871,858,1013,1689,182,ITH,ITH1,4,Provincia Autonoma Bolzano / Bozen,P.A. Bolzano,533050,57558,10.8,0.35
2633,2021-01-07,PAB,917,327,590,917,0,ITH,ITH1,4,Provincia Autonoma Bolzano / Bozen,P.A. Bolzano,533050,58475,10.97,0.17
2634,2021-03-07,PAB,114,13,101,9,105,ITH,ITH1,4,Provincia Autonoma Bolzano / Bozen,P.A. Bolzano,533050,58589,10.99,0.02
2635,2021-01-02,PAB,91,48,43,91,0,ITH,ITH1,4,Provincia Autonoma Bolzano / Bozen,P.A. Bolzano,533050,58680,11.01,0.02
2636,2021-01-12,PAB,1709,459,1250,1709,0,ITH,ITH1,4,Provincia Autonoma Bolzano / Bozen,P.A. Bolzano,533050,60389,11.33,0.32
2637,2021-04-07,PAB,1777,802,975,1238,539,ITH,ITH1,4,Provincia Autonoma Bolzano / Bozen,P.A. Bolzano,533050,62166,11.66,0.33
2638,2021-03-02,PAB,695,200,495,693,2,ITH,ITH1,4,Provincia Autonoma Bolzano / Bozen,P.A. Bolzano,533050,62861,11.79,0.13
2639,2021-03-04,PAB,1711,1001,710,1482,229,ITH,ITH1,4,Provincia Autonoma Bolzano / Bozen,P.A. Bolzano,533050,64572,12.11,0.32
2640,2021-03-10,PAB,1261,524,737,1118,143,ITH,ITH1,4,Provincia Autonoma Bolzano / Bozen,P.A. Bolzano,533050,65833,12.35,0.24
2641,2021-05-06,PAB,5181,2747,2434,2612,2569,ITH,ITH1,4,Provincia Autonoma Bolzano / Bozen,P.A. Bolzano,533050,71014,13.32,0.97
2642,2021-04-29,PAB,2630,1351,1279,1936,694,ITH,ITH1,4,Provincia Autonoma Bolzano / Bozen,P.A. Bolzano,533050,73644,13.82,0.49
2643,2021-01-26,PAB,810,291,519,1,809,ITH,ITH1,4,Provincia Autonoma Bolzano / Bozen,P.A. Bolzano,533050,74454,13.97,0.15
2644,2021-03-24,PAB,2041,978,1063,2028,13,ITH,ITH1,4,Provincia Autonoma Bolzano / Bozen,P.A. Bolzano,533050,76495,14.35,0.38
2645,2021-03-17,PAB,581,213,368,580,1,ITH,ITH1,4,Provincia Autonoma Bolzano / Bozen,P.A. Bolzano,533050,77076,14.46,0.11
2646,2021-05-13,PAB,2980,1347,1633,1050,1930,ITH,ITH1,4,Provincia Autonoma Bolzano / Bozen,P.A. Bolzano,533050,80056,15.02,0.56
2647,2021-01-19,PAB,853,371,482,723,130,ITH,ITH1,4,Provincia Autonoma Bolzano / Bozen,P.A. Bolzano,533050,80909,15.18,0.16
2648,2021-02-09,PAB,317,126,191,1,316,ITH,ITH1,4,Provincia Autonoma Bolzano / Bozen,P.A. Bolzano,533050,81226,15.24,0.06
2649,2021-02-02,PAB,1745,506,1239,8,1737,ITH,ITH1,4,Provincia Autonoma Bolzano / Bozen,P.A. Bolzano,533050,82971,15.57,0.33
2650,2021-01-05,PAB,830,286,544,830,0,ITH,ITH1,4,Provincia Autonoma Bolzano / Bozen,P.A. Bolzano,533050,83801,15.72,0.16
2651,2021-05-20,PAB,4678,2303,2375,3222,1456,ITH,ITH1,4,Provincia Autonoma Bolzano / Bozen,P.A. Bolzano,533050,88479,16.6,0.88
2652,2021-03-31,PAB,1832,694,1138,821,1011,ITH,ITH1,4,Provincia Autonoma Bolzano / Bozen,P.A. Bolzano,533050,90311,16.94,0.34
2653,2021-04-14,PAB,3593,1645,1948,3502,91,ITH,ITH1,4,Provincia Autonoma Bolzano / Bozen,P.A. Bolzano,533050,93904,17.62,0.67
2654,2021-02-23,PAB,769,324,445,763,6,ITH,ITH1,4,Provincia Autonoma Bolzano / Bozen,P.A. Bolzano,533050,94673,17.76,0.14
2655,2021-01-04,PAB,508,201,307,508,0,ITH,ITH1,4,Provincia Autonoma Bolzano / Bozen,P.A. Bolzano,533050,95181,17.86,0.1
2656,2021-03-22,PAB,1133,514,619,1129,4,ITH,ITH1,4,Provincia Autonoma Bolzano / Bozen,P.A. Bolzano,533050,96314,18.07,0.21
2657,2021-05-25,PAB,3809,1968,1841,2935,874,ITH,ITH1,4,Provincia Autonoma Bolzano / Bozen,P.A. Bolzano,533050,100123,18.78,0.71
2658,2021-03-05,PAB,1839,625,1214,1397,442,ITH,ITH1,4,Provincia Autonoma Bolzano / Bozen,P.A. Bolzano,533050,101962,19.13,0.34
2659,2021-05-08,PAB,4426,2381,2045,3762,664,ITH,ITH1,4,Provincia Autonoma Bolzano / Bozen,P.A. Bolzano,533050,106388,19.96,0.83
2660,2021-02-16,PAB,530,205,325,530,0,ITH,ITH1,4,Provincia Autonoma Bolzano / Bozen,P.A. Bolzano,533050,106918,20.06,0.1
2661,2021-02-19,PAB,2252,512,1740,2241,11,ITH,ITH1,4,Provincia Autonoma Bolzano / Bozen,P.A. Bolzano,533050,109170,20.48,0.42
2662,2021-02-26,PAB,1526,551,975,1496,30,ITH,ITH1,4,Provincia Autonoma Bolzano / Bozen,P.A. Bolzano,533050,110696,20.77,0.29
2663,2021-06-01,PAB,1255,918,337,649,606,ITH,ITH1,4,Provincia Autonoma Bolzano / Bozen,P.A. Bolzano,533050,111951,21.0,0.24
2664,2021-04-26,PAB,1543,771,772,1538,5,ITH,ITH1,4,Provincia Autonoma Bolzano / Bozen,P.A. Bolzano,533050,113494,21.29,0.29
2665,2021-01-16,PAB,2840,1265,1575,2840,0,ITH,ITH1,4,Provincia Autonoma Bolzano / Bozen,P.A. Bolzano,533050,116334,21.82,0.53
2666,2021-02-07,PAB,2361,1057,1304,14,2347,ITH,ITH1,4,Provincia Autonoma Bolzano / Bozen,P.A. Bolzano,533050,118695,22.27,0.44
2667,2021-01-21,PAB,953,442,511,139,814,ITH,ITH1,4,Provincia Autonoma Bolzano / Bozen,P.A. Bolzano,533050,119648,22.45,0.18
2668,2021-04-24,PAB,5104,2449,2655,4619,485,ITH,ITH1,4,Provincia Autonoma Bolzano / Bozen,P.A. Bolzano,533050,124752,23.4,0.96
2669,2021-04-05,PAB,301,144,157,23,278,ITH,ITH1,4,Provincia Autonoma Bolzano / Bozen,P.A. Bolzano,533050,125053,23.46,0.06
2670,2021-01-14,PAB,1946,575,1371,1946,0,ITH,ITH1,4,Provincia Autonoma Bolzano / Bozen,P.A. Bolzano,533050,126999,23.82,0.37
2671,2021-03-19,PAB,1906,773,1133,799,1107,ITH,ITH1,4,Provincia Autonoma Bolzano / Bozen,P.A. Bolzano,533050,128905,24.18,0.36
2672,2021-03-21,PAB,768,285,483,14,754,ITH,ITH1,4,Provincia Autonoma Bolzano / Bozen,P.A. Bolzano,533050,129673,24.33,0.14
2673,2021-04-23,PAB,4542,2151,2391,3251,1291,ITH,ITH1,4,Provincia Autonoma Bolzano / Bozen,P.A. Bolzano,533050,134215,25.18,0.85
2674,2021-01-11,PAB,1570,513,1057,1570,0,ITH,ITH1,4,Provincia Autonoma Bolzano / Bozen,P.A. Bolzano,533050,135785,25.47,0.29
2675,2021-04-06,PAB,2249,1117,1132,2146,103,ITH,ITH1,4,Provincia Autonoma Bolzano / Bozen,P.A. Bolzano,533050,138034,25.9,0.42
2676,2021-02-12,PAB,730,217,513,482,248,ITH,ITH1,4,Provincia Autonoma Bolzano / Bozen,P.A. Bolzano,533050,138764,26.03,0.14
2677,2021-04-17,PAB,5232,2598,2634,5188,44,ITH,ITH1,4,Provincia Autonoma Bolzano / Bozen,P.A. Bolzano,533050,143996,27.01,0.98
2678,2020-12-31,PAB,912,518,394,912,0,ITH,ITH1,4,Provincia Autonoma Bolzano / Bozen,P.A. Bolzano,533050,144908,27.18,0.17
2679,2021-04-12,PAB,2105,946,1159,2098,7,ITH,ITH1,4,Provincia Autonoma Bolzano / Bozen,P.A. Bolzano,533050,147013,27.58,0.39
2680,2021-01-09,PAB,612,326,286,612,0,ITH,ITH1,4,Provincia Autonoma Bolzano / Bozen,P.A. Bolzano,533050,147625,27.69,0.11
2681,2021-04-21,PAB,3012,1468,1544,2164,848,ITH,ITH1,4,Provincia Autonoma Bolzano / Bozen,P.A. Bolzano,533050,150637,28.26,0.57
2682,2021-04-28,PAB,2460,1301,1159,2455,5,ITH,ITH1,4,Provincia Autonoma Bolzano / Bozen,P.A. Bolzano,533050,153097,28.72,0.46
2683,2021-02-18,PAB,1839,457,1382,1832,7,ITH,ITH1,4,Provincia Autonoma Bolzano / Bozen,P.A. Bolzano,533050,154936,29.07,0.34
2684,2020-12-30,PAB,388,182,206,388,0,ITH,ITH1,4,Provincia Autonoma Bolzano / Bozen,P.A. Bolzano,533050,155324,29.14,0.07
2685,2021-04-27,PAB,2226,1013,1213,1150,1076,ITH,ITH1,4,Provincia Autonoma Bolzano / Bozen,P.A. Bolzano,533050,157550,29.56,0.42
2686,2021-03-15,PAB,1192,451,741,710,482,ITH,ITH1,4,Provincia Autonoma Bolzano / Bozen,P.A. Bolzano,533050,158742,29.78,0.22
2687,2021-01-10,PAB,2,2,0,2,0,ITH,ITH1,4,Provincia Autonoma Bolzano / Bozen,P.A. Bolzano,533050,158744,29.78,0.0
2688,2021-03-16,PAB,1290,532,758,124,1166,ITH,ITH1,4,Provincia Autonoma Bolzano / Bozen,P.A. Bolzano,533050,160034,30.02,0.24
2689,2021-05-14,PAB,5087,2290,2797,3071,2016,ITH,ITH1,4,Provincia Autonoma Bolzano / Bozen,P.A. Bolzano,533050,165121,30.98,0.95
2690,2021-02-01,PAB,1452,440,1012,12,1440,ITH,ITH1,4,Provincia Autonoma Bolzano / Bozen,P.A. Bolzano,533050,166573,31.25,0.27
2691,2021-05-23,PAB,4332,2302,2030,4324,8,ITH,ITH1,4,Provincia Autonoma Bolzano / Bozen,P.A. Bolzano,533050,170905,32.06,0.81
2692,2021-02-10,PAB,1635,604,1031,26,1609,ITH,ITH1,4,Provincia Autonoma Bolzano / Bozen,P.A. Bolzano,533050,172540,32.37,0.31
2693,2021-04-20,PAB,1560,783,777,1559,1,ITH,ITH1,4,Provincia Autonoma Bolzano / Bozen,P.A. Bolzano,533050,174100,32.66,0.29
2694,2021-03-01,PAB,922,221,701,921,1,ITH,ITH1,4,Provincia Autonoma Bolzano / Bozen,P.A. Bolzano,533050,175022,32.83,0.17
2695,2021-01-17,PAB,2328,1044,1284,2317,11,ITH,ITH1,4,Provincia Autonoma Bolzano / Bozen,P.A. Bolzano,533050,177350,33.27,0.44
2696,2021-05-26,PAB,4798,2422,2376,2846,1952,ITH,ITH1,4,Provincia Autonoma Bolzano / Bozen,P.A. Bolzano,533050,182148,34.17,0.9
2697,2021-02-15,PAB,72,42,30,26,46,ITH,ITH1,4,Provincia Autonoma Bolzano / Bozen,P.A. Bolzano,533050,182220,34.18,0.01
2698,2021-05-28,PAB,5610,2848,2762,3762,1848,ITH,ITH1,4,Provincia Autonoma Bolzano / Bozen,P.A. Bolzano,533050,187830,35.24,1.05
2699,2021-04-22,PAB,2923,1500,1423,1981,942,ITH,ITH1,4,Provincia Autonoma Bolzano / Bozen,P.A. Bolzano,533050,190753,35.79,0.55
2700,2021-02-17,PAB,156,51,105,139,17,ITH,ITH1,4,Provincia Autonoma Bolzano / Bozen,P.A. Bolzano,533050,190909,35.81,0.03
2701,2021-01-06,PAB,59,18,41,59,0,ITH,ITH1,4,Provincia Autonoma Bolzano / Bozen,P.A. Bolzano,533050,190968,35.83,0.01
2702,2021-05-19,PAB,3570,1816,1754,1807,1763,ITH,ITH1,4,Provincia Autonoma Bolzano / Bozen,P.A. Bolzano,533050,194538,36.5,0.67
2703,2021-01-20,PAB,617,252,365,409,208,ITH,ITH1,4,Provincia Autonoma Bolzano / Bozen,P.A. Bolzano,533050,195155,36.61,0.12
2704,2021-03-11,PAB,1681,823,858,1143,538,ITH,ITH1,4,Provincia Autonoma Bolzano / Bozen,P.A. Bolzano,533050,196836,36.93,0.32
2705,2021-02-22,PAB,526,143,383,514,12,ITH,ITH1,4,Provincia Autonoma Bolzano / Bozen,P.A. Bolzano,533050,197362,37.03,0.1
2706,2021-01-03,PAB,41,16,25,41,0,ITH,ITH1,4,Provincia Autonoma Bolzano / Bozen,P.A. Bolzano,533050,197403,37.03,0.01
2707,2021-02-24,PAB,1367,406,961,1355,12,ITH,ITH1,4,Provincia Autonoma Bolzano / Bozen,P.A. Bolzano,533050,198770,37.29,0.26
2708,2021-04-15,PAB,4399,2307,2092,4136,263,ITH,ITH1,4,Provincia Autonoma Bolzano / Bozen,P.A. Bolzano,533050,203169,38.11,0.83
2709,2021-05-30,PAB,4758,2514,2244,752,4006,ITH,ITH1,4,Provincia Autonoma Bolzano / Bozen,P.A. Bolzano,533050,207927,39.01,0.89
2710,2021-04-03,PAB,831,364,467,22,809,ITH,ITH1,4,Provincia Autonoma Bolzano / Bozen,P.A. Bolzano,533050,208758,39.16,0.16
2711,2021-01-30,PAB,498,245,253,4,494,ITH,ITH1,4,Provincia Autonoma Bolzano / Bozen,P.A. Bolzano,533050,209256,39.26,0.09
2712,2021-04-25,PAB,3071,1496,1575,2400,671,ITH,ITH1,4,Provincia Autonoma Bolzano / Bozen,P.A. Bolzano,533050,212327,39.83,0.58
2713,2021-01-13,PAB,1691,557,1134,1691,0,ITH,ITH1,4,Provincia Autonoma Bolzano / Bozen,P.A. Bolzano,533050,214018,40.15,0.32
2714,2021-04-08,PAB,2754,1336,1418,2551,203,ITH,ITH1,4,Provincia Autonoma Bolzano / Bozen,P.A. Bolzano,533050,216772,40.67,0.52
2715,2020-12-27,PAB,144,65,79,144,0,ITH,ITH1,4,Provincia Autonoma Bolzano / Bozen,P.A. Bolzano,533050,216916,40.69,0.03
2716,2021-05-09,PAB,4234,2405,1829,3081,1153,ITH,ITH1,4,Provincia Autonoma Bolzano / Bozen,P.A. Bolzano,533050,221150,41.49,0.79
2717,2021-03-06,PAB,3969,2079,1890,3758,211,ITH,ITH1,4,Provincia Autonoma Bolzano / Bozen,P.A. Bolzano,533050,225119,42.23,0.74
2718,2021-05-11,PAB,2842,1334,1508,1320,1522,ITH,ITH1,4,Provincia Autonoma Bolzano / Bozen,P.A. Bolzano,533050,227961,42.77,0.53
2719,2021-01-29,PAB,1497,510,987,24,1473,ITH,ITH1,4,Provincia Autonoma Bolzano / Bozen,P.A. Bolzano,533050,229458,43.05,0.28
2720,2021-05-12,PAB,3776,2048,1728,3623,153,ITH,ITH1,4,Provincia Autonoma Bolzano / Bozen,P.A. Bolzano,533050,233234,43.75,0.71
2721,2021-03-09,PAB,1194,543,651,1192,2,ITH,ITH1,4,Provincia Autonoma Bolzano / Bozen,P.A. Bolzano,533050,234428,43.98,0.22
2722,2021-03-18,PAB,1302,531,771,226,1076,ITH,ITH1,4,Provincia Autonoma Bolzano / Bozen,P.A. Bolzano,533050,235730,44.22,0.24
2723,2021-02-03,PAB,1503,478,1025,5,1498,ITH,ITH1,4,Provincia Autonoma Bolzano / Bozen,P.A. Bolzano,533050,237233,44.5,0.28
2724,2021-05-21,PAB,6834,3730,3104,5057,1777,ITH,ITH1,4,Provincia Autonoma Bolzano / Bozen,P.A. Bolzano,533050,244067,45.79,1.28
2725,2021-05-16,PAB,2024,931,1093,1330,694,ITH,ITH1,4,Provincia Autonoma Bolzano / Bozen,P.A. Bolzano,533050,246091,46.17,0.38
2726,2021-01-18,PAB,1772,687,1085,1767,5,ITH,ITH1,4,Provincia Autonoma Bolzano / Bozen,P.A. Bolzano,533050,247863,46.5,0.33
2727,2021-05-05,PAB,4154,1945,2209,2038,2116,ITH,ITH1,4,Provincia Autonoma Bolzano / Bozen,P.A. Bolzano,533050,252017,47.28,0.78
2728,2021-01-25,PAB,487,183,304,3,484,ITH,ITH1,4,Provincia Autonoma Bolzano / Bozen,P.A. Bolzano,533050,252504,47.37,0.09
2729,2021-03-23,PAB,1552,759,793,1551,1,ITH,ITH1,4,Provincia Autonoma Bolzano / Bozen,P.A. Bolzano,533050,254056,47.66,0.29
2730,2021-05-07,PAB,4181,2055,2126,3663,518,ITH,ITH1,4,Provincia Autonoma Bolzano / Bozen,P.A. Bolzano,533050,258237,48.45,0.78
2731,2021-04-01,PAB,2786,1407,1379,2642,144,ITH,ITH1,4,Provincia Autonoma Bolzano / Bozen,P.A. Bolzano,533050,261023,48.97,0.52
2732,2021-03-25,PAB,2141,1059,1082,1698,443,ITH,ITH1,4,Provincia Autonoma Bolzano / Bozen,P.A. Bolzano,533050,263164,49.37,0.4
2733,2021-01-27,PAB,84,28,56,1,83,ITH,ITH1,4,Provincia Autonoma Bolzano / Bozen,P.A. Bolzano,533050,263248,49.39,0.02
2734,2021-03-08,PAB,1200,526,674,1173,27,ITH,ITH1,4,Provincia Autonoma Bolzano / Bozen,P.A. Bolzano,533050,264448,49.61,0.23
2735,2021-05-31,PAB,2983,1461,1522,2116,867,ITH,ITH1,4,Provincia Autonoma Bolzano / Bozen,P.A. Bolzano,533050,267431,50.17,0.56
2736,2021-02-13,PAB,318,79,239,312,6,ITH,ITH1,4,Provincia Autonoma Bolzano / Bozen,P.A. Bolzano,533050,267749,50.23,0.06
2737,2021-04-11,PAB,2720,1291,1429,2543,177,ITH,ITH1,4,Provincia Autonoma Bolzano / Bozen,P.A. Bolzano,533050,270469,50.74,0.51
2738,2021-05-24,PAB,1442,761,681,1109,333,ITH,ITH1,4,Provincia Autonoma Bolzano / Bozen,P.A. Bolzano,533050,271911,51.01,0.27
2739,2021-01-01,PAB,6,5,1,6,0,ITH,ITH1,4,Provincia Autonoma Bolzano / Bozen,P.A. Bolzano,533050,271917,51.01,0.0
2740,2021-02-27,PAB,2458,759,1699,2448,10,ITH,ITH1,4,Provincia Autonoma Bolzano / Bozen,P.A. Bolzano,533050,274375,51.47,0.46
2741,2021-02-20,PAB,1802,540,1262,1784,18,ITH,ITH1,4,Provincia Autonoma Bolzano / Bozen,P.A. Bolzano,533050,276177,51.81,0.34
2742,2021-04-18,PAB,3110,1607,1503,2100,1010,ITH,ITH1,4,Provincia Autonoma Bolzano / Bozen,P.A. Bolzano,533050,279287,52.39,0.58
2743,2021-01-15,PAB,3282,1228,2054,3282,0,ITH,ITH1,4,Provincia Autonoma Bolzano / Bozen,P.A. Bolzano,533050,282569,53.01,0.62
2744,2021-01-08,PAB,1521,479,1042,1521,0,ITH,ITH1,4,Provincia Autonoma Bolzano / Bozen,P.A. Bolzano,533050,284090,53.3,0.29
2745,2021-03-20,PAB,1757,848,909,1132,625,ITH,ITH1,4,Provincia Autonoma Bolzano / Bozen,P.A. Bolzano,533050,285847,53.62,0.33
2746,2021-04-30,PAB,3337,1592,1745,1562,1775,ITH,ITH1,4,Provincia Autonoma Bolzano / Bozen,P.A. Bolzano,533050,289184,54.25,0.63
2747,2021-04-16,PAB,2949,1418,1531,2438,511,ITH,ITH1,4,Provincia Autonoma Bolzano / Bozen,P.A. Bolzano,533050,292133,54.8,0.55
2748,2021-02-25,PAB,1498,549,949,1497,1,ITH,ITH1,4,Provincia Autonoma Bolzano / Bozen,P.A. Bolzano,533050,293631,55.09,0.28
2749,2021-03-30,PAB,1298,532,766,218,1080,ITH,ITH1,4,Provincia Autonoma Bolzano / Bozen,P.A. Bolzano,533050,294929,55.33,0.24
2750,2021-02-08,PAB,2,1,1,1,1,ITH,ITH1,4,Provincia Autonoma Bolzano / Bozen,P.A. Bolzano,533050,294931,55.33,0.0
2751,2021-04-13,PAB,2391,1130,1261,2384,7,ITH,ITH1,4,Provincia Autonoma Bolzano / Bozen,P.A. Bolzano,533050,297322,55.78,0.45
2752,2021-05-04,PAB,3447,1843,1604,2410,1037,ITH,ITH1,4,Provincia Autonoma Bolzano / Bozen,P.A. Bolzano,533050,300769,56.42,0.65
2753,2021-05-03,PAB,1829,846,983,417,1412,ITH,ITH1,4,Provincia Autonoma Bolzano / Bozen,P.A. Bolzano,533050,302598,56.77,0.34
2754,2021-01-23,PAB,197,117,80,0,197,ITH,ITH1,4,Provincia Autonoma Bolzano / Bozen,P.A. Bolzano,533050,302795,56.8,0.04
2755,2021-05-17,PAB,3109,1499,1610,2425,684,ITH,ITH1,4,Provincia Autonoma Bolzano / Bozen,P.A. Bolzano,533050,305904,57.39,0.58
2756,2021-03-14,PAB,758,336,422,25,733,ITH,ITH1,4,Provincia Autonoma Bolzano / Bozen,P.A. Bolzano,533050,306662,57.53,0.14
2757,2021-02-06,PAB,2626,1171,1455,19,2607,ITH,ITH1,4,Provincia Autonoma Bolzano / Bozen,P.A. Bolzano,533050,309288,58.02,0.49
2758,2021-03-28,PAB,569,212,357,11,558,ITH,ITH1,4,Provincia Autonoma Bolzano / Bozen,P.A. Bolzano,533050,309857,58.13,0.11
2759,2021-03-13,PAB,2885,1459,1426,2784,101,ITH,ITH1,4,Provincia Autonoma Bolzano / Bozen,P.A. Bolzano,533050,312742,58.67,0.54
2760,2021-05-02,PAB,2457,1288,1169,1536,921,ITH,ITH1,4,Provincia Autonoma Bolzano / Bozen,P.A. Bolzano,533050,315199,59.13,0.46
2761,2021-03-27,PAB,3049,1553,1496,1543,1506,ITH,ITH1,4,Provincia Autonoma Bolzano / Bozen,P.A. Bolzano,533050,318248,59.7,0.57
2762,2021-02-05,PAB,3195,1181,2014,8,3187,ITH,ITH1,4,Provincia Autonoma Bolzano / Bozen,P.A. Bolzano,533050,321443,60.3,0.6
2763,2021-01-22,PAB,248,143,105,124,124,ITH,ITH1,4,Provincia Autonoma Bolzano / Bozen,P.A. Bolzano,533050,321691,60.35,0.05
2764,2021-04-15,VDA,810,377,433,671,139,ITC,ITC2,2,Valle d'Aosta / Vallée d'Aoste,Valle d'Aosta,125666,810,0.64,0.64
2765,2021-03-29,VDA,493,233,260,453,40,ITC,ITC2,2,Valle d'Aosta / Vallée d'Aoste,Valle d'Aosta,125666,1303,1.04,0.39
2766,2021-06-01,VDA,334,167,167,35,299,ITC,ITC2,2,Valle d'Aosta / Vallée d'Aoste,Valle d'Aosta,125666,1637,1.3,0.27
2767,2021-03-12,VDA,531,175,356,305,226,ITC,ITC2,2,Valle d'Aosta / Vallée d'Aoste,Valle d'Aosta,125666,2168,1.73,0.42
2768,2021-04-27,VDA,978,423,555,686,292,ITC,ITC2,2,Valle d'Aosta / Vallée d'Aoste,Valle d'Aosta,125666,3146,2.5,0.78
2769,2021-03-08,VDA,482,231,251,237,245,ITC,ITC2,2,Valle d'Aosta / Vallée d'Aoste,Valle d'Aosta,125666,3628,2.89,0.38
2770,2021-05-11,VDA,645,325,320,494,151,ITC,ITC2,2,Valle d'Aosta / Vallée d'Aoste,Valle d'Aosta,125666,4273,3.4,0.51
2771,2021-05-04,VDA,1135,510,625,462,673,ITC,ITC2,2,Valle d'Aosta / Vallée d'Aoste,Valle d'Aosta,125666,5408,4.3,0.9
2772,2021-03-15,VDA,362,123,239,159,203,ITC,ITC2,2,Valle d'Aosta / Vallée d'Aoste,Valle d'Aosta,125666,5770,4.59,0.29
2773,2021-01-17,VDA,131,56,75,131,0,ITC,ITC2,2,Valle d'Aosta / Vallée d'Aoste,Valle d'Aosta,125666,5901,4.7,0.1
2774,2021-01-31,VDA,291,91,200,58,233,ITC,ITC2,2,Valle d'Aosta / Vallée d'Aoste,Valle d'Aosta,125666,6192,4.93,0.23
2775,2021-03-22,VDA,560,205,355,333,227,ITC,ITC2,2,Valle d'Aosta / Vallée d'Aoste,Valle d'Aosta,125666,6752,5.37,0.45
2776,2021-04-20,VDA,932,430,502,738,194,ITC,ITC2,2,Valle d'Aosta / Vallée d'Aoste,Valle d'Aosta,125666,7684,6.11,0.74
2777,2021-02-15,VDA,264,136,128,229,35,ITC,ITC2,2,Valle d'Aosta / Vallée d'Aoste,Valle d'Aosta,125666,7948,6.32,0.21
2778,2021-02-14,VDA,48,16,32,1,47,ITC,ITC2,2,Valle d'Aosta / Vallée d'Aoste,Valle d'Aosta,125666,7996,6.36,0.04
2779,2021-05-28,VDA,975,414,561,563,412,ITC,ITC2,2,Valle d'Aosta / Vallée d'Aoste,Valle d'Aosta,125666,8971,7.14,0.78
2780,2021-03-25,VDA,389,154,235,379,10,ITC,ITC2,2,Valle d'Aosta / Vallée d'Aoste,Valle d'Aosta,125666,9360,7.45,0.31
2781,2021-02-10,VDA,248,77,171,141,107,ITC,ITC2,2,Valle d'Aosta / Vallée d'Aoste,Valle d'Aosta,125666,9608,7.65,0.2
2782,2021-02-19,VDA,292,102,190,268,24,ITC,ITC2,2,Valle d'Aosta / Vallée d'Aoste,Valle d'Aosta,125666,9900,7.88,0.23
2783,2021-01-07,VDA,275,111,164,275,0,ITC,ITC2,2,Valle d'Aosta / Vallée d'Aoste,Valle d'Aosta,125666,10175,8.1,0.22
2784,2021-04-24,VDA,722,400,322,555,167,ITC,ITC2,2,Valle d'Aosta / Vallée d'Aoste,Valle d'Aosta,125666,10897,8.67,0.57
2785,2021-04-19,VDA,751,325,426,542,209,ITC,ITC2,2,Valle d'Aosta / Vallée d'Aoste,Valle d'Aosta,125666,11648,9.27,0.6
2786,2021-02-22,VDA,316,94,222,213,103,ITC,ITC2,2,Valle d'Aosta / Vallée d'Aoste,Valle d'Aosta,125666,11964,9.52,0.25
2787,2021-04-29,VDA,1291,634,657,757,534,ITC,ITC2,2,Valle d'Aosta / Vallée d'Aoste,Valle d'Aosta,125666,13255,10.55,1.03
2788,2021-01-19,VDA,256,77,179,256,0,ITC,ITC2,2,Valle d'Aosta / Vallée d'Aoste,Valle d'Aosta,125666,13511,10.75,0.2
2789,2021-04-14,VDA,941,430,511,717,224,ITC,ITC2,2,Valle d'Aosta / Vallée d'Aoste,Valle d'Aosta,125666,14452,11.5,0.75
2790,2021-05-06,VDA,1063,509,554,679,384,ITC,ITC2,2,Valle d'Aosta / Vallée d'Aoste,Valle d'Aosta,125666,15515,12.35,0.85
2791,2021-03-31,VDA,555,302,253,529,26,ITC,ITC2,2,Valle d'Aosta / Vallée d'Aoste,Valle d'Aosta,125666,16070,12.79,0.44
2792,2021-05-27,VDA,1089,497,592,586,503,ITC,ITC2,2,Valle d'Aosta / Vallée d'Aoste,Valle d'Aosta,125666,17159,13.65,0.87
2793,2021-05-13,VDA,1139,556,583,540,599,ITC,ITC2,2,Valle d'Aosta / Vallée d'Aoste,Valle d'Aosta,125666,18298,14.56,0.91
2794,2021-02-02,VDA,272,70,202,2,270,ITC,ITC2,2,Valle d'Aosta / Vallée d'Aoste,Valle d'Aosta,125666,18570,14.78,0.22
2795,2021-04-22,VDA,1067,449,618,684,383,ITC,ITC2,2,Valle d'Aosta / Vallée d'Aoste,Valle d'Aosta,125666,19637,15.63,0.85
2796,2021-03-03,VDA,255,118,137,187,68,ITC,ITC2,2,Valle d'Aosta / Vallée d'Aoste,Valle d'Aosta,125666,19892,15.83,0.2
2797,2021-01-12,VDA,302,72,230,302,0,ITC,ITC2,2,Valle d'Aosta / Vallée d'Aoste,Valle d'Aosta,125666,20194,16.07,0.24
2798,2021-03-17,VDA,433,185,248,273,160,ITC,ITC2,2,Valle d'Aosta / Vallée d'Aoste,Valle d'Aosta,125666,20627,16.41,0.34
2799,2021-01-26,VDA,139,48,91,0,139,ITC,ITC2,2,Valle d'Aosta / Vallée d'Aoste,Valle d'Aosta,125666,20766,16.52,0.11
2800,2021-04-13,VDA,373,171,202,329,44,ITC,ITC2,2,Valle d'Aosta / Vallée d'Aoste,Valle d'Aosta,125666,21139,16.82,0.3
2801,2021-03-27,VDA,333,164,169,302,31,ITC,ITC2,2,Valle d'Aosta / Vallée d'Aoste,Valle d'Aosta,125666,21472,17.09,0.26
2802,2021-03-10,VDA,438,183,255,225,213,ITC,ITC2,2,Valle d'Aosta / Vallée d'Aoste,Valle d'Aosta,125666,21910,17.44,0.35
2803,2021-02-21,VDA,18,3,15,0,18,ITC,ITC2,2,Valle d'Aosta / Vallée d'Aoste,Valle d'Aosta,125666,21928,17.45,0.01
2804,2021-04-10,VDA,404,190,214,399,5,ITC,ITC2,2,Valle d'Aosta / Vallée d'Aoste,Valle d'Aosta,125666,22332,17.77,0.32
2805,2021-02-26,VDA,207,58,149,122,85,ITC,ITC2,2,Valle d'Aosta / Vallée d'Aoste,Valle d'Aosta,125666,22539,17.94,0.16
2806,2020-12-31,VDA,18,4,14,18,0,ITC,ITC2,2,Valle d'Aosta / Vallée d'Aoste,Valle d'Aosta,125666,22557,17.95,0.01
2807,2021-03-05,VDA,275,124,151,53,222,ITC,ITC2,2,Valle d'Aosta / Vallée d'Aoste,Valle d'Aosta,125666,22832,18.17,0.22
2808,2021-01-27,VDA,151,71,80,79,72,ITC,ITC2,2,Valle d'Aosta / Vallée d'Aoste,Valle d'Aosta,125666,22983,18.29,0.12
2809,2020-12-27,VDA,20,9,11,20,0,ITC,ITC2,2,Valle d'Aosta / Vallée d'Aoste,Valle d'Aosta,125666,23003,18.3,0.02
2810,2021-03-01,VDA,181,66,115,147,34,ITC,ITC2,2,Valle d'Aosta / Vallée d'Aoste,Valle d'Aosta,125666,23184,18.45,0.14
2811,2021-01-10,VDA,220,71,149,220,0,ITC,ITC2,2,Valle d'Aosta / Vallée d'Aoste,Valle d'Aosta,125666,23404,18.62,0.18
2812,2021-05-25,VDA,1115,530,585,541,574,ITC,ITC2,2,Valle d'Aosta / Vallée d'Aoste,Valle d'Aosta,125666,24519,19.51,0.89
2813,2021-05-08,VDA,904,540,364,526,378,ITC,ITC2,2,Valle d'Aosta / Vallée d'Aoste,Valle d'Aosta,125666,25423,20.23,0.72
2814,2021-04-05,VDA,461,222,239,457,4,ITC,ITC2,2,Valle d'Aosta / Vallée d'Aoste,Valle d'Aosta,125666,25884,20.6,0.37
2815,2021-05-16,VDA,688,341,347,347,341,ITC,ITC2,2,Valle d'Aosta / Vallée d'Aoste,Valle d'Aosta,125666,26572,21.14,0.55
2816,2021-02-05,VDA,294,102,192,101,193,ITC,ITC2,2,Valle d'Aosta / Vallée d'Aoste,Valle d'Aosta,125666,26866,21.38,0.23
2817,2021-05-18,VDA,969,484,485,353,616,ITC,ITC2,2,Valle d'Aosta / Vallée d'Aoste,Valle d'Aosta,125666,27835,22.15,0.77
2818,2021-04-12,VDA,486,186,300,323,163,ITC,ITC2,2,Valle d'Aosta / Vallée d'Aoste,Valle d'Aosta,125666,28321,22.54,0.39
2819,2021-02-07,VDA,292,120,172,190,102,ITC,ITC2,2,Valle d'Aosta / Vallée d'Aoste,Valle d'Aosta,125666,28613,22.77,0.23
2820,2021-05-15,VDA,1065,614,451,380,685,ITC,ITC2,2,Valle d'Aosta / Vallée d'Aoste,Valle d'Aosta,125666,29678,23.62,0.85
2821,2021-02-23,VDA,216,123,93,216,0,ITC,ITC2,2,Valle d'Aosta / Vallée d'Aoste,Valle d'Aosta,125666,29894,23.79,0.17
2822,2021-04-28,VDA,1218,632,586,715,503,ITC,ITC2,2,Valle d'Aosta / Vallée d'Aoste,Valle d'Aosta,125666,31112,24.76,0.97
2823,2021-02-06,VDA,289,104,185,92,197,ITC,ITC2,2,Valle d'Aosta / Vallée d'Aoste,Valle d'Aosta,125666,31401,24.99,0.23
2824,2021-04-11,VDA,479,208,271,479,0,ITC,ITC2,2,Valle d'Aosta / Vallée d'Aoste,Valle d'Aosta,125666,31880,25.37,0.38
2825,2021-01-20,VDA,23,8,15,23,0,ITC,ITC2,2,Valle d'Aosta / Vallée d'Aoste,Valle d'Aosta,125666,31903,25.39,0.02
2826,2021-05-21,VDA,917,433,484,531,386,ITC,ITC2,2,Valle d'Aosta / Vallée d'Aoste,Valle d'Aosta,125666,32820,26.12,0.73
2827,2021-05-30,VDA,865,429,436,694,171,ITC,ITC2,2,Valle d'Aosta / Vallée d'Aoste,Valle d'Aosta,125666,33685,26.81,0.69
2828,2021-02-17,VDA,327,144,183,227,100,ITC,ITC2,2,Valle d'Aosta / Vallée d'Aoste,Valle d'Aosta,125666,34012,27.07,0.26
2829,2021-04-17,VDA,638,407,231,636,2,ITC,ITC2,2,Valle d'Aosta / Vallée d'Aoste,Valle d'Aosta,125666,34650,27.57,0.51
2830,2021-01-05,VDA,150,54,96,150,0,ITC,ITC2,2,Valle d'Aosta / Vallée d'Aoste,Valle d'Aosta,125666,34800,27.69,0.12
2831,2021-01-14,VDA,237,69,168,237,0,ITC,ITC2,2,Valle d'Aosta / Vallée d'Aoste,Valle d'Aosta,125666,35037,27.88,0.19
2832,2021-05-02,VDA,765,345,420,605,160,ITC,ITC2,2,Valle d'Aosta / Vallée d'Aoste,Valle d'Aosta,125666,35802,28.49,0.61
2833,2021-01-08,VDA,299,130,169,299,0,ITC,ITC2,2,Valle d'Aosta / Vallée d'Aoste,Valle d'Aosta,125666,36101,28.73,0.24
2834,2021-03-06,VDA,22,4,18,22,0,ITC,ITC2,2,Valle d'Aosta / Vallée d'Aoste,Valle d'Aosta,125666,36123,28.75,0.02
2835,2021-03-13,VDA,145,86,59,145,0,ITC,ITC2,2,Valle d'Aosta / Vallée d'Aoste,Valle d'Aosta,125666,36268,28.86,0.12
2836,2021-01-15,VDA,218,82,136,218,0,ITC,ITC2,2,Valle d'Aosta / Vallée d'Aoste,Valle d'Aosta,125666,36486,29.03,0.17
2837,2021-01-22,VDA,56,21,35,20,36,ITC,ITC2,2,Valle d'Aosta / Vallée d'Aoste,Valle d'Aosta,125666,36542,29.08,0.04
2838,2021-02-03,VDA,351,114,237,14,337,ITC,ITC2,2,Valle d'Aosta / Vallée d'Aoste,Valle d'Aosta,125666,36893,29.36,0.28
2839,2021-04-01,VDA,776,394,382,764,12,ITC,ITC2,2,Valle d'Aosta / Vallée d'Aoste,Valle d'Aosta,125666,37669,29.98,0.62
2840,2021-04-08,VDA,584,282,302,441,143,ITC,ITC2,2,Valle d'Aosta / Vallée d'Aoste,Valle d'Aosta,125666,38253,30.44,0.46
2841,2021-02-24,VDA,183,82,101,164,19,ITC,ITC2,2,Valle d'Aosta / Vallée d'Aoste,Valle d'Aosta,125666,38436,30.59,0.15
2842,2021-02-11,VDA,231,107,124,222,9,ITC,ITC2,2,Valle d'Aosta / Vallée d'Aoste,Valle d'Aosta,125666,38667,30.77,0.18
2843,2021-04-16,VDA,599,261,338,597,2,ITC,ITC2,2,Valle d'Aosta / Vallée d'Aoste,Valle d'Aosta,125666,39266,31.25,0.48
2844,2021-04-02,VDA,873,344,529,648,225,ITC,ITC2,2,Valle d'Aosta / Vallée d'Aoste,Valle d'Aosta,125666,40139,31.94,0.69
2845,2021-02-18,VDA,349,153,196,261,88,ITC,ITC2,2,Valle d'Aosta / Vallée d'Aoste,Valle d'Aosta,125666,40488,32.22,0.28
2846,2021-01-16,VDA,236,80,156,236,0,ITC,ITC2,2,Valle d'Aosta / Vallée d'Aoste,Valle d'Aosta,125666,40724,32.41,0.19
2847,2021-05-19,VDA,993,498,495,418,575,ITC,ITC2,2,Valle d'Aosta / Vallée d'Aoste,Valle d'Aosta,125666,41717,33.2,0.79
2848,2021-03-16,VDA,180,37,143,118,62,ITC,ITC2,2,Valle d'Aosta / Vallée d'Aoste,Valle d'Aosta,125666,41897,33.34,0.14
2849,2021-05-22,VDA,940,494,446,540,400,ITC,ITC2,2,Valle d'Aosta / Vallée d'Aoste,Valle d'Aosta,125666,42837,34.09,0.75
2850,2021-04-09,VDA,237,111,126,204,33,ITC,ITC2,2,Valle d'Aosta / Vallée d'Aoste,Valle d'Aosta,125666,43074,34.28,0.19
2851,2021-05-29,VDA,798,434,364,561,237,ITC,ITC2,2,Valle d'Aosta / Vallée d'Aoste,Valle d'Aosta,125666,43872,34.91,0.64
2852,2021-02-25,VDA,201,101,100,194,7,ITC,ITC2,2,Valle d'Aosta / Vallée d'Aoste,Valle d'Aosta,125666,44073,35.07,0.16
2853,2021-01-06,VDA,65,33,32,65,0,ITC,ITC2,2,Valle d'Aosta / Vallée d'Aoste,Valle d'Aosta,125666,44138,35.12,0.05
2854,2021-01-04,VDA,142,59,83,142,0,ITC,ITC2,2,Valle d'Aosta / Vallée d'Aoste,Valle d'Aosta,125666,44280,35.24,0.11
2855,2021-03-09,VDA,206,96,110,174,32,ITC,ITC2,2,Valle d'Aosta / Vallée d'Aoste,Valle d'Aosta,125666,44486,35.4,0.16
2856,2021-03-11,VDA,197,76,121,66,131,ITC,ITC2,2,Valle d'Aosta / Vallée d'Aoste,Valle d'Aosta,125666,44683,35.56,0.16
2857,2021-01-28,VDA,290,123,167,56,234,ITC,ITC2,2,Valle d'Aosta / Vallée d'Aoste,Valle d'Aosta,125666,44973,35.79,0.23
2858,2021-04-23,VDA,921,443,478,538,383,ITC,ITC2,2,Valle d'Aosta / Vallée d'Aoste,Valle d'Aosta,125666,45894,36.52,0.73
2859,2021-03-04,VDA,291,139,152,42,249,ITC,ITC2,2,Valle d'Aosta / Vallée d'Aoste,Valle d'Aosta,125666,46185,36.75,0.23
2860,2021-05-07,VDA,564,245,319,533,31,ITC,ITC2,2,Valle d'Aosta / Vallée d'Aoste,Valle d'Aosta,125666,46749,37.2,0.45
2861,2021-04-06,VDA,741,381,360,629,112,ITC,ITC2,2,Valle d'Aosta / Vallée d'Aoste,Valle d'Aosta,125666,47490,37.79,0.59
2862,2021-04-21,VDA,868,410,458,620,248,ITC,ITC2,2,Valle d'Aosta / Vallée d'Aoste,Valle d'Aosta,125666,48358,38.48,0.69
2863,2021-03-02,VDA,339,166,173,336,3,ITC,ITC2,2,Valle d'Aosta / Vallée d'Aoste,Valle d'Aosta,125666,48697,38.75,0.27
2864,2021-01-11,VDA,325,112,213,325,0,ITC,ITC2,2,Valle d'Aosta / Vallée d'Aoste,Valle d'Aosta,125666,49022,39.01,0.26
2865,2021-05-20,VDA,807,363,444,367,440,ITC,ITC2,2,Valle d'Aosta / Vallée d'Aoste,Valle d'Aosta,125666,49829,39.65,0.64
2866,2021-03-24,VDA,515,230,285,258,257,ITC,ITC2,2,Valle d'Aosta / Vallée d'Aoste,Valle d'Aosta,125666,50344,40.06,0.41
2867,2021-02-16,VDA,325,53,272,320,5,ITC,ITC2,2,Valle d'Aosta / Vallée d'Aoste,Valle d'Aosta,125666,50669,40.32,0.26
2868,2021-04-07,VDA,910,474,436,681,229,ITC,ITC2,2,Valle d'Aosta / Vallée d'Aoste,Valle d'Aosta,125666,51579,41.04,0.72
2869,2021-02-09,VDA,251,84,167,68,183,ITC,ITC2,2,Valle d'Aosta / Vallée d'Aoste,Valle d'Aosta,125666,51830,41.24,0.2
2870,2021-02-28,VDA,260,86,174,77,183,ITC,ITC2,2,Valle d'Aosta / Vallée d'Aoste,Valle d'Aosta,125666,52090,41.45,0.21
2871,2021-05-03,VDA,839,400,439,488,351,ITC,ITC2,2,Valle d'Aosta / Vallée d'Aoste,Valle d'Aosta,125666,52929,42.12,0.67
2872,2021-03-07,VDA,64,30,34,11,53,ITC,ITC2,2,Valle d'Aosta / Vallée d'Aoste,Valle d'Aosta,125666,52993,42.17,0.05
2873,2021-01-30,VDA,439,202,237,14,425,ITC,ITC2,2,Valle d'Aosta / Vallée d'Aoste,Valle d'Aosta,125666,53432,42.52,0.35
2874,2021-05-17,VDA,809,417,392,375,434,ITC,ITC2,2,Valle d'Aosta / Vallée d'Aoste,Valle d'Aosta,125666,54241,43.16,0.64
2875,2021-02-04,VDA,294,86,208,8,286,ITC,ITC2,2,Valle d'Aosta / Vallée d'Aoste,Valle d'Aosta,125666,54535,43.4,0.23
2876,2021-04-30,VDA,831,355,476,485,346,ITC,ITC2,2,Valle d'Aosta / Vallée d'Aoste,Valle d'Aosta,125666,55366,44.06,0.66
2877,2021-01-18,VDA,213,74,139,213,0,ITC,ITC2,2,Valle d'Aosta / Vallée d'Aoste,Valle d'Aosta,125666,55579,44.23,0.17
2878,2021-05-01,VDA,940,563,377,456,484,ITC,ITC2,2,Valle d'Aosta / Vallée d'Aoste,Valle d'Aosta,125666,56519,44.98,0.75
2879,2021-01-02,VDA,6,5,1,6,0,ITC,ITC2,2,Valle d'Aosta / Vallée d'Aoste,Valle d'Aosta,125666,56525,44.98,0.0
2880,2021-03-26,VDA,498,204,294,491,7,ITC,ITC2,2,Valle d'Aosta / Vallée d'Aoste,Valle d'Aosta,125666,57023,45.38,0.4
2881,2021-01-21,VDA,33,12,21,33,0,ITC,ITC2,2,Valle d'Aosta / Vallée d'Aoste,Valle d'Aosta,125666,57056,45.4,0.03
2882,2021-03-28,VDA,522,212,310,521,1,ITC,ITC2,2,Valle d'Aosta / Vallée d'Aoste,Valle d'Aosta,125666,57578,45.82,0.42
2883,2021-02-20,VDA,251,210,41,241,10,ITC,ITC2,2,Valle d'Aosta / Vallée d'Aoste,Valle d'Aosta,125666,57829,46.02,0.2
2884,2021-04-26,VDA,715,327,388,545,170,ITC,ITC2,2,Valle d'Aosta / Vallée d'Aoste,Valle d'Aosta,125666,58544,46.59,0.57
2885,2021-01-09,VDA,443,199,244,443,0,ITC,ITC2,2,Valle d'Aosta / Vallée d'Aoste,Valle d'Aosta,125666,58987,46.94,0.35
2886,2021-03-14,VDA,392,200,192,392,0,ITC,ITC2,2,Valle d'Aosta / Vallée d'Aoste,Valle d'Aosta,125666,59379,47.25,0.31
2887,2021-03-23,VDA,379,150,229,245,134,ITC,ITC2,2,Valle d'Aosta / Vallée d'Aoste,Valle d'Aosta,125666,59758,47.55,0.3
2888,2021-02-08,VDA,223,83,140,25,198,ITC,ITC2,2,Valle d'Aosta / Vallée d'Aoste,Valle d'Aosta,125666,59981,47.73,0.18
2889,2021-05-05,VDA,1038,566,472,456,582,ITC,ITC2,2,Valle d'Aosta / Vallée d'Aoste,Valle d'Aosta,125666,61019,48.56,0.83
2890,2021-01-25,VDA,147,65,82,0,147,ITC,ITC2,2,Valle d'Aosta / Vallée d'Aoste,Valle d'Aosta,125666,61166,48.67,0.12
2891,2021-05-12,VDA,1138,549,589,468,670,ITC,ITC2,2,Valle d'Aosta / Vallée d'Aoste,Valle d'Aosta,125666,62304,49.58,0.91
2892,2021-05-31,VDA,879,395,484,500,379,ITC,ITC2,2,Valle d'Aosta / Vallée d'Aoste,Valle d'Aosta,125666,63183,50.28,0.7
2893,2021-04-18,VDA,522,254,268,518,4,ITC,ITC2,2,Valle d'Aosta / Vallée d'Aoste,Valle d'Aosta,125666,63705,50.69,0.42
2894,2021-03-19,VDA,322,85,237,286,36,ITC,ITC2,2,Valle d'Aosta / Vallée d'Aoste,Valle d'Aosta,125666,64027,50.95,0.26
2895,2021-01-13,VDA,337,110,227,337,0,ITC,ITC2,2,Valle d'Aosta / Vallée d'Aoste,Valle d'Aosta,125666,64364,51.22,0.27
2896,2021-03-18,VDA,136,43,93,99,37,ITC,ITC2,2,Valle d'Aosta / Vallée d'Aoste,Valle d'Aosta,125666,64500,51.33,0.11
2897,2021-05-26,VDA,1209,587,622,576,633,ITC,ITC2,2,Valle d'Aosta / Vallée d'Aoste,Valle d'Aosta,125666,65709,52.29,0.96
2898,2021-04-25,VDA,849,408,441,710,139,ITC,ITC2,2,Valle d'Aosta / Vallée d'Aoste,Valle d'Aosta,125666,66558,52.96,0.68
2899,2021-02-27,VDA,231,85,146,124,107,ITC,ITC2,2,Valle d'Aosta / Vallée d'Aoste,Valle d'Aosta,125666,66789,53.15,0.18
2900,2021-05-14,VDA,960,442,518,291,669,ITC,ITC2,2,Valle d'Aosta / Vallée d'Aoste,Valle d'Aosta,125666,67749,53.91,0.76
2901,2021-02-01,VDA,404,127,277,87,317,ITC,ITC2,2,Valle d'Aosta / Vallée d'Aoste,Valle d'Aosta,125666,68153,54.23,0.32
2902,2021-03-30,VDA,402,223,179,382,20,ITC,ITC2,2,Valle d'Aosta / Vallée d'Aoste,Valle d'Aosta,125666,68555,54.55,0.32
2903,2021-03-20,VDA,208,86,122,172,36,ITC,ITC2,2,Valle d'Aosta / Vallée d'Aoste,Valle d'Aosta,125666,68763,54.72,0.17
2904,2021-05-09,VDA,574,287,287,444,130,ITC,ITC2,2,Valle d'Aosta / Vallée d'Aoste,Valle d'Aosta,125666,69337,55.18,0.46
2905,2021-04-03,VDA,676,341,335,661,15,ITC,ITC2,2,Valle d'Aosta / Vallée d'Aoste,Valle d'Aosta,125666,70013,55.71,0.54
2906,2021-05-23,VDA,999,465,534,658,341,ITC,ITC2,2,Valle d'Aosta / Vallée d'Aoste,Valle d'Aosta,125666,71012,56.51,0.79
2907,2021-01-29,VDA,318,138,180,2,316,ITC,ITC2,2,Valle d'Aosta / Vallée d'Aoste,Valle d'Aosta,125666,71330,56.76,0.25
2908,2021-02-12,VDA,263,96,167,217,46,ITC,ITC2,2,Valle d'Aosta / Vallée d'Aoste,Valle d'Aosta,125666,71593,56.97,0.21
2909,2021-05-24,VDA,1135,516,619,688,447,ITC,ITC2,2,Valle d'Aosta / Vallée d'Aoste,Valle d'Aosta,125666,72728,57.87,0.9
2910,2021-05-10,VDA,782,381,401,547,235,ITC,ITC2,2,Valle d'Aosta / Vallée d'Aoste,Valle d'Aosta,125666,73510,58.5,0.62
2911,2021-03-21,VDA,355,165,190,355,0,ITC,ITC2,2,Valle d'Aosta / Vallée d'Aoste,Valle d'Aosta,125666,73865,58.78,0.28
2912,2021-04-04,VDA,572,253,319,571,1,ITC,ITC2,2,Valle d'Aosta / Vallée d'Aoste,Valle d'Aosta,125666,74437,59.23,0.46
2913,2021-02-13,VDA,216,196,20,215,1,ITC,ITC2,2,Valle d'Aosta / Vallée d'Aoste,Valle d'Aosta,125666,74653,59.41,0.17
2914,2021-03-02,PAT,1304,440,864,928,376,ITH,ITH2,4,Provincia Autonoma Trento,P.A. Trento,541380,1304,0.24,0.24
2915,2021-02-13,PAT,537,333,204,172,365,ITH,ITH2,4,Provincia Autonoma Trento,P.A. Trento,541380,1841,0.34,0.1
2916,2021-05-26,PAT,3899,1837,2062,1219,2680,ITH,ITH2,4,Provincia Autonoma Trento,P.A. Trento,541380,5740,1.06,0.72
2917,2021-01-27,PAT,802,277,525,91,711,ITH,ITH2,4,Provincia Autonoma Trento,P.A. Trento,541380,6542,1.21,0.15
2918,2021-05-31,PAT,4189,1953,2236,1449,2740,ITH,ITH2,4,Provincia Autonoma Trento,P.A. Trento,541380,10731,1.98,0.77
2919,2021-04-18,PAT,1855,845,1010,1846,9,ITH,ITH2,4,Provincia Autonoma Trento,P.A. Trento,541380,12586,2.32,0.34
2920,2021-03-06,PAT,783,277,506,632,151,ITH,ITH2,4,Provincia Autonoma Trento,P.A. Trento,541380,13369,2.47,0.14
2921,2021-01-01,PAT,213,50,163,213,0,ITH,ITH2,4,Provincia Autonoma Trento,P.A. Trento,541380,13582,2.51,0.04
2922,2021-02-20,PAT,407,245,162,123,284,ITH,ITH2,4,Provincia Autonoma Trento,P.A. Trento,541380,13989,2.58,0.08
2923,2021-04-11,PAT,2340,1135,1205,2249,91,ITH,ITH2,4,Provincia Autonoma Trento,P.A. Trento,541380,16329,3.02,0.43
2924,2021-01-08,PAT,1449,313,1136,1449,0,ITH,ITH2,4,Provincia Autonoma Trento,P.A. Trento,541380,17778,3.28,0.27
2925,2021-02-27,PAT,1027,456,571,606,421,ITH,ITH2,4,Provincia Autonoma Trento,P.A. Trento,541380,18805,3.47,0.19
2926,2021-04-25,PAT,1970,939,1031,1963,7,ITH,ITH2,4,Provincia Autonoma Trento,P.A. Trento,541380,20775,3.84,0.36
2927,2021-05-17,PAT,4292,2121,2171,3942,350,ITH,ITH2,4,Provincia Autonoma Trento,P.A. Trento,541380,25067,4.63,0.79
2928,2021-04-14,PAT,3115,1464,1651,2379,736,ITH,ITH2,4,Provincia Autonoma Trento,P.A. Trento,541380,28182,5.21,0.58
2929,2021-03-28,PAT,748,292,456,746,2,ITH,ITH2,4,Provincia Autonoma Trento,P.A. Trento,541380,28930,5.34,0.14
2930,2021-01-18,PAT,643,154,489,588,55,ITH,ITH2,4,Provincia Autonoma Trento,P.A. Trento,541380,29573,5.46,0.12
2931,2021-01-23,PAT,577,334,243,388,189,ITH,ITH2,4,Provincia Autonoma Trento,P.A. Trento,541380,30150,5.57,0.11
2932,2021-05-05,PAT,4972,2575,2397,4689,283,ITH,ITH2,4,Provincia Autonoma Trento,P.A. Trento,541380,35122,6.49,0.92
2933,2021-03-23,PAT,2444,943,1501,1704,740,ITH,ITH2,4,Provincia Autonoma Trento,P.A. Trento,541380,37566,6.94,0.45
2934,2021-04-01,PAT,2893,1227,1666,1800,1093,ITH,ITH2,4,Provincia Autonoma Trento,P.A. Trento,541380,40459,7.47,0.53
2935,2021-01-28,PAT,530,147,383,48,482,ITH,ITH2,4,Provincia Autonoma Trento,P.A. Trento,541380,40989,7.57,0.1
2936,2021-04-23,PAT,3600,1749,1851,3546,54,ITH,ITH2,4,Provincia Autonoma Trento,P.A. Trento,541380,44589,8.24,0.66
2937,2021-01-13,PAT,421,123,298,421,0,ITH,ITH2,4,Provincia Autonoma Trento,P.A. Trento,541380,45010,8.31,0.08
2938,2021-03-18,PAT,2318,957,1361,1238,1080,ITH,ITH2,4,Provincia Autonoma Trento,P.A. Trento,541380,47328,8.74,0.43
2939,2021-05-22,PAT,3239,1589,1650,919,2320,ITH,ITH2,4,Provincia Autonoma Trento,P.A. Trento,541380,50567,9.34,0.6
2940,2021-05-29,PAT,2219,1156,1063,815,1404,ITH,ITH2,4,Provincia Autonoma Trento,P.A. Trento,541380,52786,9.75,0.41
2941,2021-04-02,PAT,2801,1146,1655,2126,675,ITH,ITH2,4,Provincia Autonoma Trento,P.A. Trento,541380,55587,10.27,0.52
2942,2021-04-09,PAT,2706,1144,1562,1507,1199,ITH,ITH2,4,Provincia Autonoma Trento,P.A. Trento,541380,58293,10.77,0.5
2943,2021-02-11,PAT,1132,365,767,796,336,ITH,ITH2,4,Provincia Autonoma Trento,P.A. Trento,541380,59425,10.98,0.21
2944,2021-02-25,PAT,1641,643,998,1200,441,ITH,ITH2,4,Provincia Autonoma Trento,P.A. Trento,541380,61066,11.28,0.3
2945,2020-12-30,PAT,7,3,4,7,0,ITH,ITH2,4,Provincia Autonoma Trento,P.A. Trento,541380,61073,11.28,0.0
2946,2021-04-16,PAT,2837,1344,1493,2692,145,ITH,ITH2,4,Provincia Autonoma Trento,P.A. Trento,541380,63910,11.81,0.52
2947,2021-02-18,PAT,1205,426,779,1143,62,ITH,ITH2,4,Provincia Autonoma Trento,P.A. Trento,541380,65115,12.03,0.22
2948,2021-01-06,PAT,42,13,29,42,0,ITH,ITH2,4,Provincia Autonoma Trento,P.A. Trento,541380,65157,12.04,0.01
2949,2021-03-26,PAT,3155,1226,1929,2556,599,ITH,ITH2,4,Provincia Autonoma Trento,P.A. Trento,541380,68312,12.62,0.58
2950,2021-02-04,PAT,974,304,670,421,553,ITH,ITH2,4,Provincia Autonoma Trento,P.A. Trento,541380,69286,12.8,0.18
2951,2021-04-30,PAT,4910,2396,2514,4765,145,ITH,ITH2,4,Provincia Autonoma Trento,P.A. Trento,541380,74196,13.7,0.91
2952,2021-03-11,PAT,2295,851,1444,1473,822,ITH,ITH2,4,Provincia Autonoma Trento,P.A. Trento,541380,76491,14.13,0.42
2953,2021-01-20,PAT,291,73,218,279,12,ITH,ITH2,4,Provincia Autonoma Trento,P.A. Trento,541380,76782,14.18,0.05
2954,2021-03-21,PAT,129,69,60,129,0,ITH,ITH2,4,Provincia Autonoma Trento,P.A. Trento,541380,76911,14.21,0.02
2955,2021-05-24,PAT,4372,2007,2365,1340,3032,ITH,ITH2,4,Provincia Autonoma Trento,P.A. Trento,541380,81283,15.01,0.81
2956,2021-03-04,PAT,2358,793,1565,1580,778,ITH,ITH2,4,Provincia Autonoma Trento,P.A. Trento,541380,83641,15.45,0.44
2957,2021-05-07,PAT,5985,3078,2907,5148,837,ITH,ITH2,4,Provincia Autonoma Trento,P.A. Trento,541380,89626,16.56,1.11
2958,2021-04-20,PAT,2875,1374,1501,2838,37,ITH,ITH2,4,Provincia Autonoma Trento,P.A. Trento,541380,92501,17.09,0.53
2959,2021-03-14,PAT,107,65,42,20,87,ITH,ITH2,4,Provincia Autonoma Trento,P.A. Trento,541380,92608,17.11,0.02
2960,2021-03-07,PAT,22,6,16,22,0,ITH,ITH2,4,Provincia Autonoma Trento,P.A. Trento,541380,92630,17.11,0.0
2961,2021-01-09,PAT,190,40,150,190,0,ITH,ITH2,4,Provincia Autonoma Trento,P.A. Trento,541380,92820,17.15,0.04
2962,2021-03-09,PAT,1581,589,992,938,643,ITH,ITH2,4,Provincia Autonoma Trento,P.A. Trento,541380,94401,17.44,0.29
2963,2021-05-12,PAT,3297,1491,1806,2114,1183,ITH,ITH2,4,Provincia Autonoma Trento,P.A. Trento,541380,97698,18.05,0.61
2964,2021-03-16,PAT,1391,506,885,608,783,ITH,ITH2,4,Provincia Autonoma Trento,P.A. Trento,541380,99089,18.3,0.26
2965,2021-02-01,PAT,1220,335,885,92,1128,ITH,ITH2,4,Provincia Autonoma Trento,P.A. Trento,541380,100309,18.53,0.23
2966,2021-02-08,PAT,1151,318,833,342,809,ITH,ITH2,4,Provincia Autonoma Trento,P.A. Trento,541380,101460,18.74,0.21
2967,2021-02-23,PAT,1108,395,713,897,211,ITH,ITH2,4,Provincia Autonoma Trento,P.A. Trento,541380,102568,18.95,0.2
2968,2021-02-06,PAT,574,298,276,433,141,ITH,ITH2,4,Provincia Autonoma Trento,P.A. Trento,541380,103142,19.05,0.11
2969,2021-01-04,PAT,870,227,643,870,0,ITH,ITH2,4,Provincia Autonoma Trento,P.A. Trento,541380,104012,19.21,0.16
2970,2021-05-02,PAT,3512,1955,1557,3475,37,ITH,ITH2,4,Provincia Autonoma Trento,P.A. Trento,541380,107524,19.86,0.65
2971,2021-03-13,PAT,830,380,450,782,48,ITH,ITH2,4,Provincia Autonoma Trento,P.A. Trento,541380,108354,20.01,0.15
2972,2021-04-21,PAT,2893,1349,1544,2843,50,ITH,ITH2,4,Provincia Autonoma Trento,P.A. Trento,541380,111247,20.55,0.53
2973,2021-02-16,PAT,663,244,419,658,5,ITH,ITH2,4,Provincia Autonoma Trento,P.A. Trento,541380,111910,20.67,0.12
2974,2021-05-10,PAT,3205,1644,1561,2701,504,ITH,ITH2,4,Provincia Autonoma Trento,P.A. Trento,541380,115115,21.26,0.59
2975,2021-01-11,PAT,730,221,509,730,0,ITH,ITH2,4,Provincia Autonoma Trento,P.A. Trento,541380,115845,21.4,0.13
2976,2021-01-30,PAT,386,132,254,152,234,ITH,ITH2,4,Provincia Autonoma Trento,P.A. Trento,541380,116231,21.47,0.07
2977,2021-04-06,PAT,2258,949,1309,1493,765,ITH,ITH2,4,Provincia Autonoma Trento,P.A. Trento,541380,118489,21.89,0.42
2978,2021-05-09,PAT,2322,1210,1112,1978,344,ITH,ITH2,4,Provincia Autonoma Trento,P.A. Trento,541380,120811,22.32,0.43
2979,2021-01-10,PAT,84,19,65,84,0,ITH,ITH2,4,Provincia Autonoma Trento,P.A. Trento,541380,120895,22.33,0.02
2980,2021-04-22,PAT,3146,1468,1678,3102,44,ITH,ITH2,4,Provincia Autonoma Trento,P.A. Trento,541380,124041,22.91,0.58
2981,2021-04-05,PAT,35,17,18,33,2,ITH,ITH2,4,Provincia Autonoma Trento,P.A. Trento,541380,124076,22.92,0.01
2982,2021-05-03,PAT,4235,2179,2056,4082,153,ITH,ITH2,4,Provincia Autonoma Trento,P.A. Trento,541380,128311,23.7,0.78
2983,2021-01-16,PAT,319,148,171,319,0,ITH,ITH2,4,Provincia Autonoma Trento,P.A. Trento,541380,128630,23.76,0.06
2984,2021-04-28,PAT,4241,1972,2269,4103,138,ITH,ITH2,4,Provincia Autonoma Trento,P.A. Trento,541380,132871,24.54,0.78
2985,2021-01-25,PAT,817,215,602,23,794,ITH,ITH2,4,Provincia Autonoma Trento,P.A. Trento,541380,133688,24.69,0.15
2986,2021-03-30,PAT,2387,973,1414,1750,637,ITH,ITH2,4,Provincia Autonoma Trento,P.A. Trento,541380,136075,25.13,0.44
2987,2021-05-28,PAT,3348,1569,1779,1331,2017,ITH,ITH2,4,Provincia Autonoma Trento,P.A. Trento,541380,139423,25.75,0.62
2988,2021-03-25,PAT,2874,1103,1771,1824,1050,ITH,ITH2,4,Provincia Autonoma Trento,P.A. Trento,541380,142297,26.28,0.53
2989,2021-05-14,PAT,5300,2535,2765,3931,1369,ITH,ITH2,4,Provincia Autonoma Trento,P.A. Trento,541380,147597,27.26,0.98
2990,2021-01-15,PAT,595,132,463,595,0,ITH,ITH2,4,Provincia Autonoma Trento,P.A. Trento,541380,148192,27.37,0.11
2991,2021-03-24,PAT,2376,940,1436,1556,820,ITH,ITH2,4,Provincia Autonoma Trento,P.A. Trento,541380,150568,27.81,0.44
2992,2021-05-13,PAT,3405,1579,1826,2304,1101,ITH,ITH2,4,Provincia Autonoma Trento,P.A. Trento,541380,153973,28.44,0.63
2993,2021-01-26,PAT,542,154,388,27,515,ITH,ITH2,4,Provincia Autonoma Trento,P.A. Trento,541380,154515,28.54,0.1
2994,2021-02-09,PAT,915,287,628,442,473,ITH,ITH2,4,Provincia Autonoma Trento,P.A. Trento,541380,155430,28.71,0.17
2995,2021-02-17,PAT,1110,425,685,1020,90,ITH,ITH2,4,Provincia Autonoma Trento,P.A. Trento,541380,156540,28.91,0.21
2996,2021-05-30,PAT,1769,871,898,927,842,ITH,ITH2,4,Provincia Autonoma Trento,P.A. Trento,541380,158309,29.24,0.33
2997,2021-02-26,PAT,1218,435,783,923,295,ITH,ITH2,4,Provincia Autonoma Trento,P.A. Trento,541380,159527,29.47,0.22
2998,2021-01-14,PAT,700,203,497,700,0,ITH,ITH2,4,Provincia Autonoma Trento,P.A. Trento,541380,160227,29.6,0.13
2999,2021-04-26,PAT,2648,1246,1402,2554,94,ITH,ITH2,4,Provincia Autonoma Trento,P.A. Trento,541380,162875,30.09,0.49
3000,2021-05-20,PAT,4997,2353,2644,3373,1624,ITH,ITH2,4,Provincia Autonoma Trento,P.A. Trento,541380,167872,31.01,0.92
3001,2021-03-17,PAT,2067,790,1277,1199,868,ITH,ITH2,4,Provincia Autonoma Trento,P.A. Trento,541380,169939,31.39,0.38
3002,2021-05-06,PAT,5505,2726,2779,4726,779,ITH,ITH2,4,Provincia Autonoma Trento,P.A. Trento,541380,175444,32.41,1.02
3003,2021-02-02,PAT,907,240,667,190,717,ITH,ITH2,4,Provincia Autonoma Trento,P.A. Trento,541380,176351,32.57,0.17
3004,2021-03-20,PAT,873,402,471,670,203,ITH,ITH2,4,Provincia Autonoma Trento,P.A. Trento,541380,177224,32.74,0.16
3005,2021-02-12,PAT,1010,340,670,589,421,ITH,ITH2,4,Provincia Autonoma Trento,P.A. Trento,541380,178234,32.92,0.19
3006,2021-03-03,PAT,1656,622,1034,1139,517,ITH,ITH2,4,Provincia Autonoma Trento,P.A. Trento,541380,179890,33.23,0.31
3007,2021-05-08,PAT,3151,1721,1430,2734,417,ITH,ITH2,4,Provincia Autonoma Trento,P.A. Trento,541380,183041,33.81,0.58
3008,2021-01-22,PAT,1668,433,1235,329,1339,ITH,ITH2,4,Provincia Autonoma Trento,P.A. Trento,541380,184709,34.12,0.31
3009,2021-03-27,PAT,1615,709,906,1362,253,ITH,ITH2,4,Provincia Autonoma Trento,P.A. Trento,541380,186324,34.42,0.3
3010,2021-02-05,PAT,802,272,530,283,519,ITH,ITH2,4,Provincia Autonoma Trento,P.A. Trento,541380,187126,34.56,0.15
3011,2021-01-05,PAT,709,232,477,709,0,ITH,ITH2,4,Provincia Autonoma Trento,P.A. Trento,541380,187835,34.7,0.13
3012,2021-01-19,PAT,405,77,328,405,0,ITH,ITH2,4,Provincia Autonoma Trento,P.A. Trento,541380,188240,34.77,0.07
3013,2021-03-10,PAT,2411,928,1483,1490,921,ITH,ITH2,4,Provincia Autonoma Trento,P.A. Trento,541380,190651,35.22,0.45
3014,2021-05-01,PAT,4837,2463,2374,4802,35,ITH,ITH2,4,Provincia Autonoma Trento,P.A. Trento,541380,195488,36.11,0.89
3015,2021-03-12,PAT,2506,936,1570,1701,805,ITH,ITH2,4,Provincia Autonoma Trento,P.A. Trento,541380,197994,36.57,0.46
3016,2021-01-21,PAT,352,95,257,228,124,ITH,ITH2,4,Provincia Autonoma Trento,P.A. Trento,541380,198346,36.64,0.07
3017,2021-04-19,PAT,2622,1235,1387,2600,22,ITH,ITH2,4,Provincia Autonoma Trento,P.A. Trento,541380,200968,37.12,0.48
3018,2021-02-15,PAT,533,187,346,419,114,ITH,ITH2,4,Provincia Autonoma Trento,P.A. Trento,541380,201501,37.22,0.1
3019,2021-01-29,PAT,1353,331,1022,55,1298,ITH,ITH2,4,Provincia Autonoma Trento,P.A. Trento,541380,202854,37.47,0.25
3020,2021-01-12,PAT,505,158,347,505,0,ITH,ITH2,4,Provincia Autonoma Trento,P.A. Trento,541380,203359,37.56,0.09
3021,2021-04-07,PAT,2599,1012,1587,1658,941,ITH,ITH2,4,Provincia Autonoma Trento,P.A. Trento,541380,205958,38.04,0.48
3022,2021-03-01,PAT,1237,454,783,942,295,ITH,ITH2,4,Provincia Autonoma Trento,P.A. Trento,541380,207195,38.27,0.23
3023,2020-12-27,PAT,103,40,63,103,0,ITH,ITH2,4,Provincia Autonoma Trento,P.A. Trento,541380,207298,38.29,0.02
3024,2021-05-25,PAT,4741,2258,2483,1851,2890,ITH,ITH2,4,Provincia Autonoma Trento,P.A. Trento,541380,212039,39.17,0.88
3025,2021-02-14,PAT,246,186,60,11,235,ITH,ITH2,4,Provincia Autonoma Trento,P.A. Trento,541380,212285,39.21,0.05
3026,2021-05-27,PAT,3850,1794,2056,1106,2744,ITH,ITH2,4,Provincia Autonoma Trento,P.A. Trento,541380,216135,39.92,0.71
3027,2021-04-03,PAT,1138,471,667,971,167,ITH,ITH2,4,Provincia Autonoma Trento,P.A. Trento,541380,217273,40.13,0.21
3028,2021-04-24,PAT,3507,1682,1825,3494,13,ITH,ITH2,4,Provincia Autonoma Trento,P.A. Trento,541380,220780,40.78,0.65
3029,2021-02-19,PAT,928,358,570,869,59,ITH,ITH2,4,Provincia Autonoma Trento,P.A. Trento,541380,221708,40.95,0.17
3030,2021-02-28,PAT,242,121,121,242,0,ITH,ITH2,4,Provincia Autonoma Trento,P.A. Trento,541380,221950,41.0,0.04
3031,2021-05-21,PAT,5023,2410,2613,3325,1698,ITH,ITH2,4,Provincia Autonoma Trento,P.A. Trento,541380,226973,41.92,0.93
3032,2021-02-03,PAT,846,314,532,414,432,ITH,ITH2,4,Provincia Autonoma Trento,P.A. Trento,541380,227819,42.08,0.16
3033,2021-05-23,PAT,1953,993,960,447,1506,ITH,ITH2,4,Provincia Autonoma Trento,P.A. Trento,541380,229772,42.44,0.36
3034,2021-02-10,PAT,851,291,560,509,342,ITH,ITH2,4,Provincia Autonoma Trento,P.A. Trento,541380,230623,42.6,0.16
3035,2021-04-08,PAT,3114,1294,1820,1996,1118,ITH,ITH2,4,Provincia Autonoma Trento,P.A. Trento,541380,233737,43.17,0.58
3036,2021-04-10,PAT,2796,1307,1489,2003,793,ITH,ITH2,4,Provincia Autonoma Trento,P.A. Trento,541380,236533,43.69,0.52
3037,2020-12-31,PAT,1624,449,1175,1624,0,ITH,ITH2,4,Provincia Autonoma Trento,P.A. Trento,541380,238157,43.99,0.3
3038,2021-03-05,PAT,2244,703,1541,1678,566,ITH,ITH2,4,Provincia Autonoma Trento,P.A. Trento,541380,240401,44.41,0.41
3039,2021-04-17,PAT,2203,1120,1083,2146,57,ITH,ITH2,4,Provincia Autonoma Trento,P.A. Trento,541380,242604,44.81,0.41
3040,2021-03-31,PAT,2567,983,1584,1710,857,ITH,ITH2,4,Provincia Autonoma Trento,P.A. Trento,541380,245171,45.29,0.47
3041,2021-04-27,PAT,3879,1865,2014,3812,67,ITH,ITH2,4,Provincia Autonoma Trento,P.A. Trento,541380,249050,46.0,0.72
3042,2021-05-04,PAT,4475,2422,2053,4385,90,ITH,ITH2,4,Provincia Autonoma Trento,P.A. Trento,541380,253525,46.83,0.83
3043,2021-03-08,PAT,1398,433,965,1045,353,ITH,ITH2,4,Provincia Autonoma Trento,P.A. Trento,541380,254923,47.09,0.26
3044,2021-03-15,PAT,1410,545,865,946,464,ITH,ITH2,4,Provincia Autonoma Trento,P.A. Trento,541380,256333,47.35,0.26
3045,2021-01-17,PAT,251,195,56,251,0,ITH,ITH2,4,Provincia Autonoma Trento,P.A. Trento,541380,256584,47.39,0.05
3046,2021-05-11,PAT,3688,1744,1944,2845,843,ITH,ITH2,4,Provincia Autonoma Trento,P.A. Trento,541380,260272,48.08,0.68
3047,2021-03-22,PAT,2306,973,1333,1431,875,ITH,ITH2,4,Provincia Autonoma Trento,P.A. Trento,541380,262578,48.5,0.43
3048,2021-01-24,PAT,547,276,271,224,323,ITH,ITH2,4,Provincia Autonoma Trento,P.A. Trento,541380,263125,48.6,0.1
3049,2021-01-31,PAT,75,15,60,1,74,ITH,ITH2,4,Provincia Autonoma Trento,P.A. Trento,541380,263200,48.62,0.01
3050,2021-03-19,PAT,2423,915,1508,1571,852,ITH,ITH2,4,Provincia Autonoma Trento,P.A. Trento,541380,265623,49.06,0.45
3051,2021-05-15,PAT,1567,815,752,679,888,ITH,ITH2,4,Provincia Autonoma Trento,P.A. Trento,541380,267190,49.35,0.29
3052,2021-05-16,PAT,1321,729,592,1083,238,ITH,ITH2,4,Provincia Autonoma Trento,P.A. Trento,541380,268511,49.6,0.24
3053,2021-04-15,PAT,3182,1437,1745,3028,154,ITH,ITH2,4,Provincia Autonoma Trento,P.A. Trento,541380,271693,50.19,0.59
3054,2021-04-29,PAT,4621,2232,2389,4412,209,ITH,ITH2,4,Provincia Autonoma Trento,P.A. Trento,541380,276314,51.04,0.85
3055,2021-02-24,PAT,1318,523,795,922,396,ITH,ITH2,4,Provincia Autonoma Trento,P.A. Trento,541380,277632,51.28,0.24
3056,2021-01-07,PAT,1270,310,960,1270,0,ITH,ITH2,4,Provincia Autonoma Trento,P.A. Trento,541380,278902,51.52,0.23
3057,2021-05-19,PAT,5088,2451,2637,3839,1249,ITH,ITH2,4,Provincia Autonoma Trento,P.A. Trento,541380,283990,52.46,0.94
3058,2021-04-13,PAT,2553,1058,1495,2046,507,ITH,ITH2,4,Provincia Autonoma Trento,P.A. Trento,541380,286543,52.93,0.47
3059,2021-01-03,PAT,492,160,332,492,0,ITH,ITH2,4,Provincia Autonoma Trento,P.A. Trento,541380,287035,53.02,0.09
3060,2021-02-22,PAT,745,259,486,661,84,ITH,ITH2,4,Provincia Autonoma Trento,P.A. Trento,541380,287780,53.16,0.14
3061,2021-05-18,PAT,4245,2008,2237,3403,842,ITH,ITH2,4,Provincia Autonoma Trento,P.A. Trento,541380,292025,53.94,0.78
3062,2021-03-29,PAT,2461,958,1503,1726,735,ITH,ITH2,4,Provincia Autonoma Trento,P.A. Trento,541380,294486,54.4,0.45
3063,2021-04-12,PAT,3087,1408,1679,2591,496,ITH,ITH2,4,Provincia Autonoma Trento,P.A. Trento,541380,297573,54.97,0.57
3064,2021-06-01,PAT,1152,533,619,282,870,ITH,ITH2,4,Provincia Autonoma Trento,P.A. Trento,541380,298725,55.18,0.21
3065,2021-01-02,PAT,502,143,359,502,0,ITH,ITH2,4,Provincia Autonoma Trento,P.A. Trento,541380,299227,55.27,0.09
3066,2021-02-21,PAT,155,92,63,43,112,ITH,ITH2,4,Provincia Autonoma Trento,P.A. Trento,541380,299382,55.3,0.03
3067,2021-05-12,SIC,36856,17349,19507,21913,14943,ITG,ITG1,19,Sicilia,Sicilia,4999891,36856,0.74,0.74
3068,2021-02-20,SIC,7242,3726,3516,7000,242,ITG,ITG1,19,Sicilia,Sicilia,4999891,44098,0.88,0.14
3069,2021-04-25,SIC,21350,10183,11167,16373,4977,ITG,ITG1,19,Sicilia,Sicilia,4999891,65448,1.31,0.43
3070,2021-04-08,SIC,16796,8287,8509,8312,8484,ITG,ITG1,19,Sicilia,Sicilia,4999891,82244,1.64,0.34
3071,2021-02-03,SIC,6095,2854,3241,752,5343,ITG,ITG1,19,Sicilia,Sicilia,4999891,88339,1.77,0.12
3072,2021-04-30,SIC,35213,16456,18757,24009,11204,ITG,ITG1,19,Sicilia,Sicilia,4999891,123552,2.47,0.7
3073,2021-03-04,SIC,15184,6544,8640,10986,4198,ITG,ITG1,19,Sicilia,Sicilia,4999891,138736,2.77,0.3
3074,2021-05-07,SIC,36657,17315,19342,25028,11629,ITG,ITG1,19,Sicilia,Sicilia,4999891,175393,3.51,0.73
3075,2021-01-13,SIC,5269,2494,2775,5269,0,ITG,ITG1,19,Sicilia,Sicilia,4999891,180662,3.61,0.11
3076,2021-03-18,SIC,15603,7783,7820,9865,5738,ITG,ITG1,19,Sicilia,Sicilia,4999891,196265,3.93,0.31
3077,2021-04-23,SIC,28884,13844,15040,22937,5947,ITG,ITG1,19,Sicilia,Sicilia,4999891,225149,4.5,0.58
3078,2021-03-11,SIC,15448,6516,8932,12883,2565,ITG,ITG1,19,Sicilia,Sicilia,4999891,240597,4.81,0.31
3079,2021-01-20,SIC,836,427,409,574,262,ITG,ITG1,19,Sicilia,Sicilia,4999891,241433,4.83,0.02
3080,2021-01-27,SIC,7528,3838,3690,183,7345,ITG,ITG1,19,Sicilia,Sicilia,4999891,248961,4.98,0.15
3081,2021-03-14,SIC,8779,3928,4851,4944,3835,ITG,ITG1,19,Sicilia,Sicilia,4999891,257740,5.15,0.18
3082,2021-02-11,SIC,5321,2097,3224,4859,462,ITG,ITG1,19,Sicilia,Sicilia,4999891,263061,5.26,0.11
3083,2021-04-16,SIC,28740,14421,14319,20364,8376,ITG,ITG1,19,Sicilia,Sicilia,4999891,291801,5.84,0.57
3084,2021-02-25,SIC,10121,5247,4874,8955,1166,ITG,ITG1,19,Sicilia,Sicilia,4999891,301922,6.04,0.2
3085,2021-05-21,SIC,45831,21567,24264,24368,21463,ITG,ITG1,19,Sicilia,Sicilia,4999891,347753,6.96,0.92
3086,2021-01-30,SIC,7837,3569,4268,172,7665,ITG,ITG1,19,Sicilia,Sicilia,4999891,355590,7.11,0.16
3087,2021-04-04,SIC,6825,3325,3500,5533,1292,ITG,ITG1,19,Sicilia,Sicilia,4999891,362415,7.25,0.14
3088,2020-12-27,SIC,92,55,37,92,0,ITG,ITG1,19,Sicilia,Sicilia,4999891,362507,7.25,0.0
3089,2021-03-01,SIC,12959,6119,6840,11304,1655,ITG,ITG1,19,Sicilia,Sicilia,4999891,375466,7.51,0.26
3090,2020-12-28,SIC,211,126,85,211,0,ITG,ITG1,19,Sicilia,Sicilia,4999891,375677,7.51,0.0
3091,2021-03-23,SIC,21065,10076,10989,15411,5654,ITG,ITG1,19,Sicilia,Sicilia,4999891,396742,7.94,0.42
3092,2021-03-25,SIC,20635,9556,11079,15096,5539,ITG,ITG1,19,Sicilia,Sicilia,4999891,417377,8.35,0.41
3093,2021-05-28,SIC,51061,22793,28268,24793,26268,ITG,ITG1,19,Sicilia,Sicilia,4999891,468438,9.37,1.02
3094,2021-03-02,SIC,14869,6360,8509,12060,2809,ITG,ITG1,19,Sicilia,Sicilia,4999891,483307,9.67,0.3
3095,2021-01-04,SIC,8405,4192,4213,8405,0,ITG,ITG1,19,Sicilia,Sicilia,4999891,491712,9.83,0.17
3096,2021-04-28,SIC,29350,13767,15583,20268,9082,ITG,ITG1,19,Sicilia,Sicilia,4999891,521062,10.42,0.59
3097,2021-02-23,SIC,8909,4670,4239,8446,463,ITG,ITG1,19,Sicilia,Sicilia,4999891,529971,10.6,0.18
3098,2021-03-09,SIC,13147,5587,7560,10774,2373,ITG,ITG1,19,Sicilia,Sicilia,4999891,543118,10.86,0.26
3099,2021-01-11,SIC,5917,2597,3320,5917,0,ITG,ITG1,19,Sicilia,Sicilia,4999891,549035,10.98,0.12
3100,2021-01-18,SIC,1650,670,980,1495,155,ITG,ITG1,19,Sicilia,Sicilia,4999891,550685,11.01,0.03
3101,2021-05-05,SIC,26301,12175,14126,16706,9595,ITG,ITG1,19,Sicilia,Sicilia,4999891,576986,11.54,0.53
3102,2021-01-25,SIC,7514,3697,3817,308,7206,ITG,ITG1,19,Sicilia,Sicilia,4999891,584500,11.69,0.15
3103,2021-05-19,SIC,42691,20583,22108,28390,14301,ITG,ITG1,19,Sicilia,Sicilia,4999891,627191,12.54,0.85
3104,2021-03-16,SIC,9780,4363,5417,3662,6118,ITG,ITG1,19,Sicilia,Sicilia,4999891,636971,12.74,0.2
3105,2021-02-08,SIC,4086,1760,2326,2129,1957,ITG,ITG1,19,Sicilia,Sicilia,4999891,641057,12.82,0.08
3106,2021-03-30,SIC,14595,6759,7836,9770,4825,ITG,ITG1,19,Sicilia,Sicilia,4999891,655652,13.11,0.29
3107,2021-02-18,SIC,5473,3152,2321,5044,429,ITG,ITG1,19,Sicilia,Sicilia,4999891,661125,13.22,0.11
3108,2021-05-31,SIC,37665,16794,20871,21429,16236,ITG,ITG1,19,Sicilia,Sicilia,4999891,698790,13.98,0.75
3109,2021-05-14,SIC,52242,24468,27774,36395,15847,ITG,ITG1,19,Sicilia,Sicilia,4999891,751032,15.02,1.04
3110,2021-02-01,SIC,6071,2681,3390,298,5773,ITG,ITG1,19,Sicilia,Sicilia,4999891,757103,15.14,0.12
3111,2021-04-27,SIC,26382,12713,13669,15589,10793,ITG,ITG1,19,Sicilia,Sicilia,4999891,783485,15.67,0.53
3112,2021-05-24,SIC,35520,17107,18413,15710,19810,ITG,ITG1,19,Sicilia,Sicilia,4999891,819005,16.38,0.71
3113,2021-05-17,SIC,32096,15458,16638,19345,12751,ITG,ITG1,19,Sicilia,Sicilia,4999891,851101,17.02,0.64
3114,2021-03-21,SIC,15207,7330,7877,11236,3971,ITG,ITG1,19,Sicilia,Sicilia,4999891,866308,17.33,0.3
3115,2021-02-04,SIC,6932,3187,3745,1455,5477,ITG,ITG1,19,Sicilia,Sicilia,4999891,873240,17.47,0.14
3116,2021-02-13,SIC,3097,1164,1933,2841,256,ITG,ITG1,19,Sicilia,Sicilia,4999891,876337,17.53,0.06
3117,2021-02-06,SIC,5015,2189,2826,1462,3553,ITG,ITG1,19,Sicilia,Sicilia,4999891,881352,17.63,0.1
3118,2021-01-01,SIC,815,437,378,815,0,ITG,ITG1,19,Sicilia,Sicilia,4999891,882167,17.64,0.02
3119,2021-01-23,SIC,4331,2234,2097,216,4115,ITG,ITG1,19,Sicilia,Sicilia,4999891,886498,17.73,0.09
3120,2021-04-02,SIC,14011,6596,7415,9224,4787,ITG,ITG1,19,Sicilia,Sicilia,4999891,900509,18.01,0.28
3121,2021-01-06,SIC,6486,3412,3074,6486,0,ITG,ITG1,19,Sicilia,Sicilia,4999891,906995,18.14,0.13
3122,2021-02-10,SIC,4420,1813,2607,3999,421,ITG,ITG1,19,Sicilia,Sicilia,4999891,911415,18.23,0.09
3123,2021-04-01,SIC,14398,6674,7724,9684,4714,ITG,ITG1,19,Sicilia,Sicilia,4999891,925813,18.52,0.29
3124,2021-01-16,SIC,2781,1198,1583,2781,0,ITG,ITG1,19,Sicilia,Sicilia,4999891,928594,18.57,0.06
3125,2021-04-09,SIC,20538,10003,10535,11389,9149,ITG,ITG1,19,Sicilia,Sicilia,4999891,949132,18.98,0.41
3126,2021-04-11,SIC,15336,7575,7761,8307,7029,ITG,ITG1,19,Sicilia,Sicilia,4999891,964468,19.29,0.31
3127,2020-12-30,SIC,175,102,73,175,0,ITG,ITG1,19,Sicilia,Sicilia,4999891,964643,19.29,0.0
3128,2021-03-06,SIC,12918,5167,7751,10015,2903,ITG,ITG1,19,Sicilia,Sicilia,4999891,977561,19.55,0.26
3129,2021-01-17,SIC,1302,589,713,1245,57,ITG,ITG1,19,Sicilia,Sicilia,4999891,978863,19.58,0.03
3130,2021-03-22,SIC,16818,7916,8902,11275,5543,ITG,ITG1,19,Sicilia,Sicilia,4999891,995681,19.91,0.34
3131,2021-03-05,SIC,15877,6838,9039,11560,4317,ITG,ITG1,19,Sicilia,Sicilia,4999891,1011558,20.23,0.32
3132,2020-12-31,SIC,879,470,409,879,0,ITG,ITG1,19,Sicilia,Sicilia,4999891,1012437,20.25,0.02
3133,2021-02-16,SIC,4371,2283,2088,3906,465,ITG,ITG1,19,Sicilia,Sicilia,4999891,1016808,20.34,0.09
3134,2021-03-28,SIC,10892,5126,5766,6881,4011,ITG,ITG1,19,Sicilia,Sicilia,4999891,1027700,20.55,0.22
3135,2021-04-06,SIC,17823,8534,9289,13497,4326,ITG,ITG1,19,Sicilia,Sicilia,4999891,1045523,20.91,0.36
3136,2021-02-22,SIC,8013,4146,3867,7522,491,ITG,ITG1,19,Sicilia,Sicilia,4999891,1053536,21.07,0.16
3137,2021-05-02,SIC,24655,11445,13210,18054,6601,ITG,ITG1,19,Sicilia,Sicilia,4999891,1078191,21.56,0.49
3138,2021-05-16,SIC,33110,16124,16986,21784,11326,ITG,ITG1,19,Sicilia,Sicilia,4999891,1111301,22.23,0.66
3139,2021-03-20,SIC,18813,9030,9783,13488,5325,ITG,ITG1,19,Sicilia,Sicilia,4999891,1130114,22.6,0.38
3140,2021-05-09,SIC,28135,13161,14974,19864,8271,ITG,ITG1,19,Sicilia,Sicilia,4999891,1158249,23.17,0.56
3141,2021-05-26,SIC,44225,20624,23601,23785,20440,ITG,ITG1,19,Sicilia,Sicilia,4999891,1202474,24.05,0.88
3142,2021-04-13,SIC,19914,9688,10226,11079,8835,ITG,ITG1,19,Sicilia,Sicilia,4999891,1222388,24.45,0.4
3143,2021-04-20,SIC,19269,9079,10190,13930,5339,ITG,ITG1,19,Sicilia,Sicilia,4999891,1241657,24.83,0.39
3144,2021-02-07,SIC,2338,991,1347,674,1664,ITG,ITG1,19,Sicilia,Sicilia,4999891,1243995,24.88,0.05
3145,2021-05-25,SIC,33133,15006,18127,13967,19166,ITG,ITG1,19,Sicilia,Sicilia,4999891,1277128,25.54,0.66
3146,2021-04-12,SIC,18959,9204,9755,11619,7340,ITG,ITG1,19,Sicilia,Sicilia,4999891,1296087,25.92,0.38
3147,2021-02-21,SIC,5169,2501,2668,5063,106,ITG,ITG1,19,Sicilia,Sicilia,4999891,1301256,26.03,0.1
3148,2021-02-24,SIC,9562,4851,4711,8972,590,ITG,ITG1,19,Sicilia,Sicilia,4999891,1310818,26.22,0.19
3149,2021-04-29,SIC,31683,14764,16919,22328,9355,ITG,ITG1,19,Sicilia,Sicilia,4999891,1342501,26.85,0.63
3150,2021-05-08,SIC,35760,17079,18681,25433,10327,ITG,ITG1,19,Sicilia,Sicilia,4999891,1378261,27.57,0.72
3151,2021-01-26,SIC,9481,4667,4814,260,9221,ITG,ITG1,19,Sicilia,Sicilia,4999891,1387742,27.76,0.19
3152,2021-01-21,SIC,1386,679,707,500,886,ITG,ITG1,19,Sicilia,Sicilia,4999891,1389128,27.78,0.03
3153,2021-03-26,SIC,18032,8376,9656,12501,5531,ITG,ITG1,19,Sicilia,Sicilia,4999891,1407160,28.14,0.36
3154,2021-05-18,SIC,36139,17312,18827,23558,12581,ITG,ITG1,19,Sicilia,Sicilia,4999891,1443299,28.87,0.72
3155,2021-03-29,SIC,15004,7036,7968,10488,4516,ITG,ITG1,19,Sicilia,Sicilia,4999891,1458303,29.17,0.3
3156,2021-06-01,SIC,12660,5783,6877,7269,5391,ITG,ITG1,19,Sicilia,Sicilia,4999891,1470963,29.42,0.25
3157,2021-04-05,SIC,8024,3959,4065,6584,1440,ITG,ITG1,19,Sicilia,Sicilia,4999891,1478987,29.58,0.16
3158,2021-02-14,SIC,1058,403,655,918,140,ITG,ITG1,19,Sicilia,Sicilia,4999891,1480045,29.6,0.02
3159,2021-01-02,SIC,4885,2541,2344,4885,0,ITG,ITG1,19,Sicilia,Sicilia,4999891,1484930,29.7,0.1
3160,2021-03-08,SIC,13535,5825,7710,10728,2807,ITG,ITG1,19,Sicilia,Sicilia,4999891,1498465,29.97,0.27
3161,2021-05-11,SIC,32429,15424,17005,19887,12542,ITG,ITG1,19,Sicilia,Sicilia,4999891,1530894,30.62,0.65
3162,2021-02-17,SIC,5414,3278,2136,4746,668,ITG,ITG1,19,Sicilia,Sicilia,4999891,1536308,30.73,0.11
3163,2021-05-13,SIC,47388,22236,25152,30787,16601,ITG,ITG1,19,Sicilia,Sicilia,4999891,1583696,31.67,0.95
3164,2021-01-31,SIC,4110,1959,2151,113,3997,ITG,ITG1,19,Sicilia,Sicilia,4999891,1587806,31.76,0.08
3165,2021-02-02,SIC,5534,2620,2914,629,4905,ITG,ITG1,19,Sicilia,Sicilia,4999891,1593340,31.87,0.11
3166,2021-05-04,SIC,26824,12463,14361,17638,9186,ITG,ITG1,19,Sicilia,Sicilia,4999891,1620164,32.4,0.54
3167,2021-02-28,SIC,7165,3063,4102,6535,630,ITG,ITG1,19,Sicilia,Sicilia,4999891,1627329,32.55,0.14
3168,2021-03-17,SIC,15172,7463,7709,9260,5912,ITG,ITG1,19,Sicilia,Sicilia,4999891,1642501,32.85,0.3
3169,2021-05-06,SIC,29065,13771,15294,18436,10629,ITG,ITG1,19,Sicilia,Sicilia,4999891,1671566,33.43,0.58
3170,2021-03-31,SIC,14606,6750,7856,9578,5028,ITG,ITG1,19,Sicilia,Sicilia,4999891,1686172,33.72,0.29
3171,2021-05-20,SIC,43508,20775,22733,27625,15883,ITG,ITG1,19,Sicilia,Sicilia,4999891,1729680,34.59,0.87
3172,2021-02-09,SIC,4411,1823,2588,3356,1055,ITG,ITG1,19,Sicilia,Sicilia,4999891,1734091,34.68,0.09
3173,2021-05-27,SIC,47181,21542,25639,24908,22273,ITG,ITG1,19,Sicilia,Sicilia,4999891,1781272,35.63,0.94
3174,2021-04-14,SIC,20291,9798,10493,11507,8784,ITG,ITG1,19,Sicilia,Sicilia,4999891,1801563,36.03,0.41
3175,2021-04-21,SIC,22687,10885,11802,16459,6228,ITG,ITG1,19,Sicilia,Sicilia,4999891,1824250,36.49,0.45
3176,2021-03-12,SIC,13118,5615,7503,10902,2216,ITG,ITG1,19,Sicilia,Sicilia,4999891,1837368,36.75,0.26
3177,2021-05-15,SIC,57074,26664,30410,41704,15370,ITG,ITG1,19,Sicilia,Sicilia,4999891,1894442,37.89,1.14
3178,2021-03-19,SIC,16519,8114,8405,10788,5731,ITG,ITG1,19,Sicilia,Sicilia,4999891,1910961,38.22,0.33
3179,2021-01-15,SIC,5088,2236,2852,5088,0,ITG,ITG1,19,Sicilia,Sicilia,4999891,1916049,38.32,0.1
3180,2020-12-29,SIC,239,148,91,239,0,ITG,ITG1,19,Sicilia,Sicilia,4999891,1916288,38.33,0.0
3181,2021-04-10,SIC,20662,10083,10579,11620,9042,ITG,ITG1,19,Sicilia,Sicilia,4999891,1936950,38.74,0.41
3182,2021-03-24,SIC,21145,9908,11237,15308,5837,ITG,ITG1,19,Sicilia,Sicilia,4999891,1958095,39.16,0.42
3183,2021-05-30,SIC,35541,16084,19457,17477,18064,ITG,ITG1,19,Sicilia,Sicilia,4999891,1993636,39.87,0.71
3184,2021-02-19,SIC,5130,2732,2398,4563,567,ITG,ITG1,19,Sicilia,Sicilia,4999891,1998766,39.98,0.1
3185,2021-04-24,SIC,31354,14804,16550,23614,7740,ITG,ITG1,19,Sicilia,Sicilia,4999891,2030120,40.6,0.63
3186,2021-01-14,SIC,5263,2521,2742,5263,0,ITG,ITG1,19,Sicilia,Sicilia,4999891,2035383,40.71,0.11
3187,2021-04-26,SIC,21936,10377,11559,13798,8138,ITG,ITG1,19,Sicilia,Sicilia,4999891,2057319,41.15,0.44
3188,2021-01-19,SIC,1301,539,762,1096,205,ITG,ITG1,19,Sicilia,Sicilia,4999891,2058620,41.17,0.03
3189,2021-03-03,SIC,14666,6522,8144,11578,3088,ITG,ITG1,19,Sicilia,Sicilia,4999891,2073286,41.47,0.29
3190,2021-05-01,SIC,24475,11326,13149,19317,5158,ITG,ITG1,19,Sicilia,Sicilia,4999891,2097761,41.96,0.49
3191,2021-05-10,SIC,28304,13595,14709,16187,12117,ITG,ITG1,19,Sicilia,Sicilia,4999891,2126065,42.52,0.57
3192,2021-01-28,SIC,9313,4394,4919,398,8915,ITG,ITG1,19,Sicilia,Sicilia,4999891,2135378,42.71,0.19
3193,2021-02-15,SIC,3927,1818,2109,3362,565,ITG,ITG1,19,Sicilia,Sicilia,4999891,2139305,42.79,0.08
3194,2021-01-03,SIC,4705,2461,2244,4705,0,ITG,ITG1,19,Sicilia,Sicilia,4999891,2144010,42.88,0.09
3195,2021-01-10,SIC,3622,1616,2006,3622,0,ITG,ITG1,19,Sicilia,Sicilia,4999891,2147632,42.95,0.07
3196,2021-04-15,SIC,21356,10387,10969,11799,9557,ITG,ITG1,19,Sicilia,Sicilia,4999891,2168988,43.38,0.43
3197,2021-04-22,SIC,27165,12821,14344,20575,6590,ITG,ITG1,19,Sicilia,Sicilia,4999891,2196153,43.92,0.54
3198,2021-01-05,SIC,10538,5163,5375,10538,0,ITG,ITG1,19,Sicilia,Sicilia,4999891,2206691,44.13,0.21
3199,2021-03-10,SIC,13935,5955,7980,11550,2385,ITG,ITG1,19,Sicilia,Sicilia,4999891,2220626,44.41,0.28
3200,2021-01-12,SIC,4547,2236,2311,4547,0,ITG,ITG1,19,Sicilia,Sicilia,4999891,2225173,44.5,0.09
3201,2021-02-05,SIC,7103,3158,3945,2128,4975,ITG,ITG1,19,Sicilia,Sicilia,4999891,2232276,44.65,0.14
3202,2021-04-03,SIC,16363,7781,8582,13527,2836,ITG,ITG1,19,Sicilia,Sicilia,4999891,2248639,44.97,0.33
3203,2021-03-27,SIC,15751,7437,8314,10838,4913,ITG,ITG1,19,Sicilia,Sicilia,4999891,2264390,45.29,0.32
3204,2021-01-29,SIC,9354,4317,5037,425,8929,ITG,ITG1,19,Sicilia,Sicilia,4999891,2273744,45.48,0.19
3205,2021-05-23,SIC,34135,16613,17522,20109,14026,ITG,ITG1,19,Sicilia,Sicilia,4999891,2307879,46.16,0.68
3206,2021-02-12,SIC,4674,1847,2827,4406,268,ITG,ITG1,19,Sicilia,Sicilia,4999891,2312553,46.25,0.09
3207,2021-05-29,SIC,47144,21433,25711,23925,23219,ITG,ITG1,19,Sicilia,Sicilia,4999891,2359697,47.19,0.94
3208,2021-03-15,SIC,10817,4716,6101,5752,5065,ITG,ITG1,19,Sicilia,Sicilia,4999891,2370514,47.41,0.22
3209,2021-01-24,SIC,4310,2254,2056,141,4169,ITG,ITG1,19,Sicilia,Sicilia,4999891,2374824,47.5,0.09
3210,2021-04-19,SIC,18471,8735,9736,12764,5707,ITG,ITG1,19,Sicilia,Sicilia,4999891,2393295,47.87,0.37
3211,2021-05-22,SIC,48204,22880,25324,28715,19489,ITG,ITG1,19,Sicilia,Sicilia,4999891,2441499,48.83,0.96
3212,2021-04-07,SIC,15528,7632,7896,8364,7164,ITG,ITG1,19,Sicilia,Sicilia,4999891,2457027,49.14,0.31
3213,2021-03-07,SIC,9265,3455,5810,8182,1083,ITG,ITG1,19,Sicilia,Sicilia,4999891,2466292,49.33,0.19
3214,2021-01-09,SIC,7328,3425,3903,7328,0,ITG,ITG1,19,Sicilia,Sicilia,4999891,2473620,49.47,0.15
3215,2021-05-03,SIC,23471,10825,12646,13587,9884,ITG,ITG1,19,Sicilia,Sicilia,4999891,2497091,49.94,0.47
3216,2021-02-27,SIC,12425,5556,6869,11221,1204,ITG,ITG1,19,Sicilia,Sicilia,4999891,2509516,50.19,0.25
3217,2021-04-18,SIC,19723,9862,9861,15357,4366,ITG,ITG1,19,Sicilia,Sicilia,4999891,2529239,50.59,0.39
3218,2021-01-22,SIC,1254,634,620,243,1011,ITG,ITG1,19,Sicilia,Sicilia,4999891,2530493,50.61,0.03
3219,2021-01-08,SIC,8335,3868,4467,8335,0,ITG,ITG1,19,Sicilia,Sicilia,4999891,2538828,50.78,0.17
3220,2021-03-13,SIC,12422,5480,6942,7839,4583,ITG,ITG1,19,Sicilia,Sicilia,4999891,2551250,51.03,0.25
3221,2021-04-17,SIC,26189,13226,12963,19037,7152,ITG,ITG1,19,Sicilia,Sicilia,4999891,2577439,51.55,0.52
3222,2021-02-26,SIC,12208,5967,6241,10524,1684,ITG,ITG1,19,Sicilia,Sicilia,4999891,2589647,51.79,0.24
3223,2021-01-07,SIC,9190,4250,4940,9190,0,ITG,ITG1,19,Sicilia,Sicilia,4999891,2598837,51.98,0.18
