,data,area,Vaccinazioni giornaliere,sesso_maschile,sesso_femminile,Operatori sanitari - sociosanitari,Personale non sanitario,Ospiti RSA,categoria_personale_scolastico,categoria_60_69,categoria_70_79,categoria_over80,categoria_soggetti_fragili,categoria_forze_armate,categoria_altro,prima_dose,seconda_dose,codice_NUTS1,codice_NUTS2,codice_regione_ISTAT,nome_area,Regione,popolazione,Totale vaccinazioni,Totale vaccinazioni ogni cento ab,Vaccinazioni giornaliere ogni cento ab
0,2021-02-01,PIE,8642,3053,5589,6177,1397,1068,0,0,0,0,0,0,0,578,8064,ITC,ITC1,1,Piemonte,Piemonte,4356406,8642,0.2,0.2
1,2021-02-05,PIE,9452,3079,6373,5766,2041,1643,0,0,0,1,0,0,1,657,8795,ITC,ITC1,1,Piemonte,Piemonte,4356406,18094,0.42,0.22
2,2021-02-20,PIE,3829,1252,2577,1100,1064,219,1416,0,0,30,0,0,0,3656,173,ITC,ITC1,1,Piemonte,Piemonte,4356406,21923,0.5,0.09
3,2021-04-28,PIE,25701,11578,14123,564,274,106,54,3481,3984,7840,9353,25,20,15751,9950,ITC,ITC1,1,Piemonte,Piemonte,4356406,47624,1.09,0.59
4,2021-03-26,PIE,17738,6979,10759,1165,744,529,2429,3,14,11529,608,710,7,8834,8904,ITC,ITC1,1,Piemonte,Piemonte,4356406,65362,1.5,0.41
5,2021-04-19,PIE,22284,10642,11642,304,159,213,28,786,5403,4765,10605,1,20,17947,4337,ITC,ITC1,1,Piemonte,Piemonte,4356406,87646,2.01,0.51
6,2021-02-19,PIE,5532,2174,3358,1989,1752,666,1078,0,1,34,0,1,11,5030,502,ITC,ITC1,1,Piemonte,Piemonte,4356406,93178,2.14,0.13
7,2021-04-25,PIE,19946,9183,10763,213,108,9,18,1246,6277,2504,9548,8,15,17435,2511,ITC,ITC1,1,Piemonte,Piemonte,4356406,113124,2.6,0.46
8,2021-04-05,PIE,14735,6232,8503,148,115,0,703,1,3904,7986,1844,33,1,12179,2556,ITC,ITC1,1,Piemonte,Piemonte,4356406,127859,2.93,0.34
9,2021-04-15,PIE,29409,13471,15938,898,399,387,53,1202,9645,6837,9954,7,27,23936,5473,ITC,ITC1,1,Piemonte,Piemonte,4356406,157268,3.61,0.68
10,2021-01-16,PIE,7771,2630,5141,4803,1596,1372,0,0,0,0,0,0,0,7771,0,ITC,ITC1,1,Piemonte,Piemonte,4356406,165039,3.79,0.18
11,2021-02-03,PIE,10197,3303,6894,6643,2299,1246,0,2,0,5,0,0,2,611,9586,ITC,ITC1,1,Piemonte,Piemonte,4356406,175236,4.02,0.23
12,2021-04-01,PIE,19278,8033,11245,672,371,289,914,6,1954,13846,961,261,4,11171,8107,ITC,ITC1,1,Piemonte,Piemonte,4356406,194514,4.47,0.44
13,2021-01-19,PIE,6423,2099,4324,3574,1301,1548,0,0,0,0,0,0,0,6414,9,ITC,ITC1,1,Piemonte,Piemonte,4356406,200937,4.61,0.15
14,2021-02-13,PIE,4152,1334,2818,2310,722,1114,5,0,0,1,0,0,0,2931,1221,ITC,ITC1,1,Piemonte,Piemonte,4356406,205089,4.71,0.1
15,2021-01-18,PIE,6164,2047,4117,3238,1403,1523,0,0,0,0,0,0,0,5916,248,ITC,ITC1,1,Piemonte,Piemonte,4356406,211253,4.85,0.14
16,2021-01-03,PIE,3063,967,2096,2715,295,52,0,0,0,0,0,0,1,3063,0,ITC,ITC1,1,Piemonte,Piemonte,4356406,214316,4.92,0.07
17,2021-01-04,PIE,5563,1679,3884,4590,736,235,0,0,0,0,0,0,2,5563,0,ITC,ITC1,1,Piemonte,Piemonte,4356406,219879,5.05,0.13
18,2021-02-12,PIE,6887,2213,4674,3527,1645,1707,2,1,0,4,0,0,1,3928,2959,ITC,ITC1,1,Piemonte,Piemonte,4356406,226766,5.21,0.16
19,2021-03-09,PIE,13939,5417,8522,1688,1543,356,2330,2,6,8007,1,6,0,11597,2342,ITC,ITC1,1,Piemonte,Piemonte,4356406,240705,5.53,0.32
20,2021-02-27,PIE,12678,4846,7832,885,963,232,3038,0,0,7558,1,0,1,12331,347,ITC,ITC1,1,Piemonte,Piemonte,4356406,253383,5.82,0.29
21,2021-03-20,PIE,11912,4896,7016,882,1039,163,1937,20,17,7683,21,21,129,6016,5896,ITC,ITC1,1,Piemonte,Piemonte,4356406,265295,6.09,0.27
22,2021-02-17,PIE,4788,2154,2634,2245,2030,497,1,0,1,1,0,0,13,3799,989,ITC,ITC1,1,Piemonte,Piemonte,4356406,270083,6.2,0.11
23,2021-03-08,PIE,13921,5284,8637,2035,1425,413,2628,1,1,7403,0,12,3,11208,2713,ITC,ITC1,1,Piemonte,Piemonte,4356406,284004,6.52,0.32
24,2021-03-27,PIE,18346,7814,10532,1215,1621,110,2109,13,939,11696,446,191,6,9533,8813,ITC,ITC1,1,Piemonte,Piemonte,4356406,302350,6.94,0.42
25,2021-03-01,PIE,12035,4839,7196,1157,1277,281,2435,0,4,6873,0,7,1,11226,809,ITC,ITC1,1,Piemonte,Piemonte,4356406,314385,7.22,0.28
26,2021-01-29,PIE,5942,1886,4056,4199,1067,673,0,0,0,2,0,0,1,455,5487,ITC,ITC1,1,Piemonte,Piemonte,4356406,320327,7.35,0.14
27,2021-05-04,PIE,22364,10244,12120,399,153,96,150,5328,4076,5604,6335,210,13,11514,10850,ITC,ITC1,1,Piemonte,Piemonte,4356406,342691,7.87,0.51
28,2021-02-16,PIE,3966,1755,2211,1815,1587,548,1,0,4,1,0,4,6,3208,758,ITC,ITC1,1,Piemonte,Piemonte,4356406,346657,7.96,0.09
29,2021-02-14,PIE,1476,498,978,796,381,285,14,0,0,0,0,0,0,876,600,ITC,ITC1,1,Piemonte,Piemonte,4356406,348133,7.99,0.03
30,2021-02-24,PIE,11406,4629,6777,1855,1290,408,2155,0,3,5684,0,6,5,10900,506,ITC,ITC1,1,Piemonte,Piemonte,4356406,359539,8.25,0.26
31,2021-03-31,PIE,19099,8100,10999,962,687,311,687,8,2527,13177,524,209,7,10409,8690,ITC,ITC1,1,Piemonte,Piemonte,4356406,378638,8.69,0.44
32,2021-01-09,PIE,6183,2185,3998,4499,1113,568,0,1,0,0,0,0,2,6183,0,ITC,ITC1,1,Piemonte,Piemonte,4356406,384821,8.83,0.14
33,2021-01-07,PIE,5387,1739,3648,4159,885,341,0,1,0,0,0,0,1,5387,0,ITC,ITC1,1,Piemonte,Piemonte,4356406,390208,8.96,0.12
34,2021-04-30,PIE,30787,13810,16977,720,429,316,122,4338,5283,8511,10920,119,29,17652,13135,ITC,ITC1,1,Piemonte,Piemonte,4356406,420995,9.66,0.71
35,2021-02-09,PIE,7351,2309,5042,4154,1367,1830,0,0,0,0,0,0,0,722,6629,ITC,ITC1,1,Piemonte,Piemonte,4356406,428346,9.83,0.17
36,2021-02-15,PIE,4431,1596,2835,2319,1144,962,1,0,2,2,0,1,0,3226,1205,ITC,ITC1,1,Piemonte,Piemonte,4356406,432777,9.93,0.1
37,2021-01-27,PIE,4196,1453,2743,2982,657,557,0,0,0,0,0,0,0,999,3197,ITC,ITC1,1,Piemonte,Piemonte,4356406,436973,10.03,0.1
38,2021-01-06,PIE,3116,1111,2005,2370,429,313,0,0,1,1,0,0,2,3116,0,ITC,ITC1,1,Piemonte,Piemonte,4356406,440089,10.1,0.07
39,2021-04-20,PIE,25303,11588,13715,706,271,241,35,1204,6120,6633,10078,2,13,19037,6266,ITC,ITC1,1,Piemonte,Piemonte,4356406,465392,10.68,0.58
40,2021-03-11,PIE,13745,5064,8681,2312,1416,381,2184,0,5,7371,0,69,7,10654,3091,ITC,ITC1,1,Piemonte,Piemonte,4356406,479137,11.0,0.32
41,2021-01-20,PIE,6615,2089,4526,3618,1182,1813,0,0,0,0,0,0,2,5898,717,ITC,ITC1,1,Piemonte,Piemonte,4356406,485752,11.15,0.15
42,2021-01-05,PIE,5381,1603,3778,4368,721,285,0,0,2,1,0,0,4,5381,0,ITC,ITC1,1,Piemonte,Piemonte,4356406,491133,11.27,0.12
43,2021-04-02,PIE,20071,8260,11811,885,438,390,879,8,2690,13338,1259,153,31,11664,8407,ITC,ITC1,1,Piemonte,Piemonte,4356406,511204,11.73,0.46
44,2021-04-09,PIE,25799,11360,14439,1218,523,254,46,44,7391,11140,5133,35,15,21291,4508,ITC,ITC1,1,Piemonte,Piemonte,4356406,537003,12.33,0.59
45,2021-01-28,PIE,5589,1809,3780,4119,878,590,0,1,0,1,0,0,0,384,5205,ITC,ITC1,1,Piemonte,Piemonte,4356406,542592,12.46,0.13
46,2021-02-25,PIE,12211,5249,6962,1447,2064,405,1959,0,2,6329,0,1,4,11665,546,ITC,ITC1,1,Piemonte,Piemonte,4356406,554803,12.74,0.28
47,2021-05-02,PIE,24529,10980,13549,578,230,33,68,2747,7094,5629,8044,86,20,13794,10735,ITC,ITC1,1,Piemonte,Piemonte,4356406,579332,13.3,0.56
48,2021-01-15,PIE,8968,2955,6013,5499,1922,1546,0,0,0,0,0,0,1,8968,0,ITC,ITC1,1,Piemonte,Piemonte,4356406,588300,13.5,0.21
49,2021-04-07,PIE,23528,9956,13572,952,441,272,533,7,5777,12362,3052,66,66,18070,5458,ITC,ITC1,1,Piemonte,Piemonte,4356406,611828,14.04,0.54
50,2021-01-11,PIE,8741,2980,5761,6060,1553,1126,0,1,0,0,0,0,1,8741,0,ITC,ITC1,1,Piemonte,Piemonte,4356406,620569,14.24,0.2
51,2021-02-02,PIE,10237,3507,6730,6871,2048,1317,0,0,0,0,0,0,1,815,9422,ITC,ITC1,1,Piemonte,Piemonte,4356406,630806,14.48,0.23
52,2021-02-11,PIE,6764,2107,4657,3422,1328,2010,3,0,0,0,0,0,1,3006,3758,ITC,ITC1,1,Piemonte,Piemonte,4356406,637570,14.64,0.16
53,2021-03-02,PIE,11192,4502,6690,907,1122,215,2517,0,4,6416,0,9,2,10376,816,ITC,ITC1,1,Piemonte,Piemonte,4356406,648762,14.89,0.26
54,2021-03-07,PIE,11968,4656,7312,1322,1134,111,2050,0,5,7344,0,0,2,11088,880,ITC,ITC1,1,Piemonte,Piemonte,4356406,660730,15.17,0.27
55,2021-01-14,PIE,9763,3151,6612,6180,2097,1484,0,0,0,0,0,0,2,9763,0,ITC,ITC1,1,Piemonte,Piemonte,4356406,670493,15.39,0.22
56,2021-03-25,PIE,17079,7201,9878,1035,963,626,1375,4,25,12004,568,472,7,8444,8635,ITC,ITC1,1,Piemonte,Piemonte,4356406,687572,15.78,0.39
57,2021-01-23,PIE,4257,1325,2932,3210,526,520,0,0,0,1,0,0,0,879,3378,ITC,ITC1,1,Piemonte,Piemonte,4356406,691829,15.88,0.1
58,2021-03-13,PIE,13033,4717,8316,1169,996,158,2138,1,3,8559,0,4,5,11590,1443,ITC,ITC1,1,Piemonte,Piemonte,4356406,704862,16.18,0.3
59,2021-01-17,PIE,3517,1168,2349,2081,596,840,0,0,0,0,0,0,0,2870,647,ITC,ITC1,1,Piemonte,Piemonte,4356406,708379,16.26,0.08
60,2021-04-08,PIE,25065,10892,14173,1057,521,274,412,25,7376,11243,4034,117,6,20346,4719,ITC,ITC1,1,Piemonte,Piemonte,4356406,733444,16.84,0.58
61,2021-01-26,PIE,6330,1879,4451,4726,874,728,0,0,0,0,0,0,2,735,5595,ITC,ITC1,1,Piemonte,Piemonte,4356406,739774,16.98,0.15
62,2021-04-24,PIE,27069,12270,14799,461,168,21,23,2646,8134,5189,10349,48,30,21449,5620,ITC,ITC1,1,Piemonte,Piemonte,4356406,766843,17.6,0.62
63,2021-03-17,PIE,12509,5050,7459,2083,806,236,9,1,9,9100,9,250,6,5221,7288,ITC,ITC1,1,Piemonte,Piemonte,4356406,779352,17.89,0.29
64,2021-03-14,PIE,8200,3331,4869,794,588,2,990,0,5,5815,0,1,5,5307,2893,ITC,ITC1,1,Piemonte,Piemonte,4356406,787552,18.08,0.19
65,2021-02-04,PIE,10198,3337,6861,6234,2199,1763,0,0,0,0,0,0,2,588,9610,ITC,ITC1,1,Piemonte,Piemonte,4356406,797750,18.31,0.23
66,2021-04-26,PIE,19506,8628,10878,306,99,83,44,1509,3329,4814,9297,11,14,15129,4377,ITC,ITC1,1,Piemonte,Piemonte,4356406,817256,18.76,0.45
67,2021-02-10,PIE,7533,2370,5163,3905,1530,2097,0,0,0,0,0,0,1,1316,6217,ITC,ITC1,1,Piemonte,Piemonte,4356406,824789,18.93,0.17
68,2021-01-31,PIE,4106,1748,2358,3076,655,375,0,0,0,0,0,0,0,112,3994,ITC,ITC1,1,Piemonte,Piemonte,4356406,828895,19.03,0.09
69,2021-02-18,PIE,4785,2090,2695,2254,1897,624,2,0,0,0,0,2,6,4355,430,ITC,ITC1,1,Piemonte,Piemonte,4356406,833680,19.14,0.11
70,2020-12-30,PIE,730,322,408,685,45,0,0,0,0,0,0,0,0,730,0,ITC,ITC1,1,Piemonte,Piemonte,4356406,834410,19.15,0.02
71,2021-03-19,PIE,11012,4508,6504,1126,650,432,271,3,19,8179,25,301,6,4413,6599,ITC,ITC1,1,Piemonte,Piemonte,4356406,845422,19.41,0.25
72,2021-03-28,PIE,16035,6892,9143,926,1914,34,2480,3,461,8926,1076,208,7,8427,7608,ITC,ITC1,1,Piemonte,Piemonte,4356406,861457,19.77,0.37
73,2020-12-31,PIE,3909,1334,2575,3415,356,134,0,0,0,0,0,0,4,3909,0,ITC,ITC1,1,Piemonte,Piemonte,4356406,865366,19.86,0.09
74,2021-04-06,PIE,20191,8786,11405,648,592,260,1319,16,5170,9643,2405,113,25,15014,5177,ITC,ITC1,1,Piemonte,Piemonte,4356406,885557,20.33,0.46
75,2021-02-07,PIE,3087,974,2113,1648,662,777,0,0,0,0,0,0,0,445,2642,ITC,ITC1,1,Piemonte,Piemonte,4356406,888644,20.4,0.07
76,2021-04-12,PIE,22885,10331,12554,612,296,243,60,240,7766,7329,6282,10,47,19904,2981,ITC,ITC1,1,Piemonte,Piemonte,4356406,911529,20.92,0.53
77,2021-01-08,PIE,5530,1761,3769,4078,1027,422,0,0,0,0,0,0,3,5530,0,ITC,ITC1,1,Piemonte,Piemonte,4356406,917059,21.05,0.13
78,2021-04-11,PIE,20806,9309,11497,401,231,68,254,217,7630,6876,5114,5,10,18645,2161,ITC,ITC1,1,Piemonte,Piemonte,4356406,937865,21.53,0.48
79,2021-03-18,PIE,11739,4798,6941,1464,770,343,18,3,14,8871,7,235,14,4028,7711,ITC,ITC1,1,Piemonte,Piemonte,4356406,949604,21.8,0.27
80,2021-01-21,PIE,6880,2314,4566,4707,840,1318,0,3,0,0,0,0,12,3385,3495,ITC,ITC1,1,Piemonte,Piemonte,4356406,956484,21.96,0.16
81,2021-02-26,PIE,12285,4927,7358,843,1436,490,2900,0,1,6613,0,1,1,11548,737,ITC,ITC1,1,Piemonte,Piemonte,4356406,968769,22.24,0.28
82,2021-03-03,PIE,12114,4640,7474,1103,1025,257,2665,0,2,7059,0,3,0,11295,819,ITC,ITC1,1,Piemonte,Piemonte,4356406,980883,22.52,0.28
83,2021-03-05,PIE,15261,5957,9304,2540,2011,655,2370,1,5,7673,1,5,0,11444,3817,ITC,ITC1,1,Piemonte,Piemonte,4356406,996144,22.87,0.35
84,2021-02-23,PIE,9231,3712,5519,2298,1346,389,1052,0,2,4106,0,33,5,8651,580,ITC,ITC1,1,Piemonte,Piemonte,4356406,1005375,23.08,0.21
85,2021-01-25,PIE,6213,1938,4275,4786,862,562,0,0,1,1,0,0,1,983,5230,ITC,ITC1,1,Piemonte,Piemonte,4356406,1011588,23.22,0.14
86,2021-01-01,PIE,1038,395,643,922,116,0,0,0,0,0,0,0,0,1038,0,ITC,ITC1,1,Piemonte,Piemonte,4356406,1012626,23.24,0.02
87,2021-03-06,PIE,13988,5209,8779,2262,1126,462,2697,1,2,7437,1,0,0,11199,2789,ITC,ITC1,1,Piemonte,Piemonte,4356406,1026614,23.57,0.32
88,2021-04-04,PIE,9242,4054,5188,197,302,0,294,0,2035,4226,2173,9,6,6530,2712,ITC,ITC1,1,Piemonte,Piemonte,4356406,1035856,23.78,0.21
89,2021-03-16,PIE,10517,4267,6250,2229,872,322,13,7,10,6798,65,162,39,4462,6055,ITC,ITC1,1,Piemonte,Piemonte,4356406,1046373,24.02,0.24
90,2021-04-22,PIE,27419,12607,14812,589,330,420,60,1654,5403,6515,12383,20,45,20828,6591,ITC,ITC1,1,Piemonte,Piemonte,4356406,1073792,24.65,0.63
91,2020-12-27,PIE,913,369,544,761,73,76,0,1,0,0,0,0,2,913,0,ITC,ITC1,1,Piemonte,Piemonte,4356406,1074705,24.67,0.02
92,2021-01-22,PIE,3866,1249,2617,2279,650,934,0,1,0,1,0,0,1,2525,1341,ITC,ITC1,1,Piemonte,Piemonte,4356406,1078571,24.76,0.09
93,2021-04-21,PIE,25485,11713,13772,798,357,264,45,1393,7065,6107,9425,11,20,20179,5306,ITC,ITC1,1,Piemonte,Piemonte,4356406,1104056,25.34,0.59
94,2021-03-12,PIE,13929,5173,8756,2142,1295,472,2274,0,4,7627,6,108,1,10995,2934,ITC,ITC1,1,Piemonte,Piemonte,4356406,1117985,25.66,0.32
95,2021-04-18,PIE,22902,10809,12093,341,240,24,46,912,5673,4371,11268,10,17,20151,2751,ITC,ITC1,1,Piemonte,Piemonte,4356406,1140887,26.19,0.53
96,2021-04-17,PIE,30253,14063,16190,746,317,116,56,2804,9976,4886,11328,9,15,26977,3276,ITC,ITC1,1,Piemonte,Piemonte,4356406,1171140,26.88,0.69
97,2021-03-10,PIE,13624,5164,8460,1666,1339,280,2240,1,6,8017,1,73,1,11330,2294,ITC,ITC1,1,Piemonte,Piemonte,4356406,1184764,27.2,0.31
98,2021-04-03,PIE,19383,8113,11270,309,237,76,540,13,2974,13411,1663,114,46,10838,8545,ITC,ITC1,1,Piemonte,Piemonte,4356406,1204147,27.64,0.44
99,2021-02-22,PIE,8467,3464,5003,1705,1398,512,920,2,4,3914,0,9,3,7877,590,ITC,ITC1,1,Piemonte,Piemonte,4356406,1212614,27.84,0.19
100,2021-02-28,PIE,10812,4058,6754,642,501,53,2790,1,1,6822,0,0,2,10572,240,ITC,ITC1,1,Piemonte,Piemonte,4356406,1223426,28.08,0.25
101,2021-02-08,PIE,6916,2355,4561,3786,1557,1572,0,0,0,0,0,0,1,666,6250,ITC,ITC1,1,Piemonte,Piemonte,4356406,1230342,28.24,0.16
102,2021-04-29,PIE,47311,21420,25891,1224,560,301,61,9131,11013,9118,15643,164,96,34789,12522,ITC,ITC1,1,Piemonte,Piemonte,4356406,1277653,29.33,1.09
103,2021-02-21,PIE,5086,2080,3006,685,263,47,737,0,0,3353,0,0,1,4984,102,ITC,ITC1,1,Piemonte,Piemonte,4356406,1282739,29.44,0.12
104,2021-01-10,PIE,5214,2275,2939,3910,783,519,0,0,0,0,0,0,2,5214,0,ITC,ITC1,1,Piemonte,Piemonte,4356406,1287953,29.56,0.12
105,2021-04-27,PIE,22451,10154,12297,356,212,156,80,3086,3888,4970,9654,31,18,17386,5065,ITC,ITC1,1,Piemonte,Piemonte,4356406,1310404,30.08,0.52
106,2021-04-14,PIE,27601,12520,15081,860,434,445,60,783,10248,7057,7686,9,19,23088,4513,ITC,ITC1,1,Piemonte,Piemonte,4356406,1338005,30.71,0.63
107,2021-01-12,PIE,10047,3404,6643,6863,2009,1170,0,2,0,0,0,0,3,10047,0,ITC,ITC1,1,Piemonte,Piemonte,4356406,1348052,30.94,0.23
108,2021-03-21,PIE,10706,4734,5972,585,1475,9,1318,2,165,7017,1,133,1,4183,6523,ITC,ITC1,1,Piemonte,Piemonte,4356406,1358758,31.19,0.25
109,2021-03-29,PIE,15133,6372,8761,415,543,137,1330,1,1259,10371,733,342,2,8522,6611,ITC,ITC1,1,Piemonte,Piemonte,4356406,1373891,31.54,0.35
110,2021-04-23,PIE,27239,12527,14712,696,273,273,30,1804,5255,6440,12406,41,21,20533,6706,ITC,ITC1,1,Piemonte,Piemonte,4356406,1401130,32.16,0.63
111,2021-03-15,PIE,10644,4155,6489,1716,1460,231,1469,2,5,5731,0,28,2,5028,5616,ITC,ITC1,1,Piemonte,Piemonte,4356406,1411774,32.41,0.24
112,2021-03-30,PIE,16883,7030,9853,783,436,287,994,7,1375,12119,580,297,5,9013,7870,ITC,ITC1,1,Piemonte,Piemonte,4356406,1428657,32.79,0.39
113,2021-01-30,PIE,5978,2135,3843,4375,1108,495,0,0,0,0,0,0,0,218,5760,ITC,ITC1,1,Piemonte,Piemonte,4356406,1434635,32.93,0.14
114,2021-04-16,PIE,27992,13040,14952,1040,465,414,76,1624,7580,5805,10952,5,31,23108,4884,ITC,ITC1,1,Piemonte,Piemonte,4356406,1462627,33.57,0.64
115,2021-05-01,PIE,27538,12518,15020,410,275,42,88,3160,8554,6901,8034,51,23,15848,11690,ITC,ITC1,1,Piemonte,Piemonte,4356406,1490165,34.21,0.63
116,2020-12-28,PIE,1,1,0,1,0,0,0,0,0,0,0,0,0,1,0,ITC,ITC1,1,Piemonte,Piemonte,4356406,1490166,34.21,0.0
117,2021-01-13,PIE,10080,3223,6857,6488,2259,1329,0,0,0,0,0,0,4,10080,0,ITC,ITC1,1,Piemonte,Piemonte,4356406,1500246,34.44,0.23
118,2021-04-13,PIE,25844,11565,14279,666,266,261,121,899,10387,7018,6196,7,23,22405,3439,ITC,ITC1,1,Piemonte,Piemonte,4356406,1526090,35.03,0.59
119,2021-05-03,PIE,26047,11895,14152,677,290,56,96,3715,4532,7503,9036,104,38,12042,14005,ITC,ITC1,1,Piemonte,Piemonte,4356406,1552137,35.63,0.6
120,2021-02-06,PIE,7983,2664,5319,5101,1629,1251,0,0,0,1,0,0,1,400,7583,ITC,ITC1,1,Piemonte,Piemonte,4356406,1560120,35.81,0.18
121,2021-04-10,PIE,30103,13385,16718,900,456,138,134,359,11958,10217,5917,15,9,25825,4278,ITC,ITC1,1,Piemonte,Piemonte,4356406,1590223,36.5,0.69
122,2021-03-22,PIE,11448,4851,6597,880,909,191,1221,1,9,7914,72,249,2,3865,7583,ITC,ITC1,1,Piemonte,Piemonte,4356406,1601671,36.77,0.26
123,2021-03-04,PIE,14479,5727,8752,2185,1951,609,2190,0,2,7535,0,3,4,11530,2949,ITC,ITC1,1,Piemonte,Piemonte,4356406,1616150,37.1,0.33
124,2021-03-24,PIE,15473,6334,9139,1072,766,479,840,5,21,11510,394,376,10,6347,9126,ITC,ITC1,1,Piemonte,Piemonte,4356406,1631623,37.45,0.36
125,2021-03-23,PIE,12999,5411,7588,689,1020,222,1334,5,15,9239,277,187,11,6762,6237,ITC,ITC1,1,Piemonte,Piemonte,4356406,1644622,37.75,0.3
126,2021-01-02,PIE,3545,1134,2411,3081,407,53,0,1,0,1,0,0,2,3545,0,ITC,ITC1,1,Piemonte,Piemonte,4356406,1648167,37.83,0.08
127,2021-01-24,PIE,3153,959,2194,2636,370,146,0,0,0,0,0,0,1,434,2719,ITC,ITC1,1,Piemonte,Piemonte,4356406,1651320,37.91,0.07
128,2021-02-01,UMB,1285,342,943,877,35,373,0,0,0,0,0,0,0,48,1237,ITI,ITI2,10,Umbria,Umbria,882015,1285,0.15,0.15
129,2021-04-12,UMB,7074,3072,4002,204,17,0,17,30,2418,2910,1462,4,12,5357,1717,ITI,ITI2,10,Umbria,Umbria,882015,8359,0.95,0.8
130,2021-02-20,UMB,282,100,182,83,7,39,0,0,0,152,0,0,1,258,24,ITI,ITI2,10,Umbria,Umbria,882015,8641,0.98,0.03
131,2021-05-03,UMB,5063,2257,2806,189,22,12,12,16,99,1449,3228,35,1,2179,2884,ITI,ITI2,10,Umbria,Umbria,882015,13704,1.55,0.57
132,2021-01-02,UMB,304,111,193,304,0,0,0,0,0,0,0,0,0,304,0,ITI,ITI2,10,Umbria,Umbria,882015,14008,1.59,0.03
133,2021-01-11,UMB,1315,346,969,880,14,415,0,1,0,0,0,0,5,1315,0,ITI,ITI2,10,Umbria,Umbria,882015,15323,1.74,0.15
134,2021-03-09,UMB,4051,1971,2080,143,568,122,23,0,1,2915,7,217,55,2759,1292,ITI,ITI2,10,Umbria,Umbria,882015,19374,2.2,0.46
135,2021-01-25,UMB,648,323,325,646,2,0,0,0,0,0,0,0,0,5,643,ITI,ITI2,10,Umbria,Umbria,882015,20022,2.27,0.07
136,2021-01-19,UMB,103,23,80,21,2,80,0,0,0,0,0,0,0,103,0,ITI,ITI2,10,Umbria,Umbria,882015,20125,2.28,0.01
137,2021-02-06,UMB,396,138,258,333,47,16,0,0,0,0,0,0,0,34,362,ITI,ITI2,10,Umbria,Umbria,882015,20521,2.33,0.04
138,2021-01-04,UMB,810,398,412,810,0,0,0,0,0,0,0,0,0,810,0,ITI,ITI2,10,Umbria,Umbria,882015,21331,2.42,0.09
139,2021-04-10,UMB,7438,3496,3942,81,62,30,50,49,2471,691,3972,18,14,7325,113,ITI,ITI2,10,Umbria,Umbria,882015,28769,3.26,0.84
140,2021-02-05,UMB,780,234,546,645,51,84,0,0,0,0,0,0,0,18,762,ITI,ITI2,10,Umbria,Umbria,882015,29549,3.35,0.09
141,2021-02-03,UMB,725,174,551,560,34,131,0,0,0,0,0,0,0,67,658,ITI,ITI2,10,Umbria,Umbria,882015,30274,3.43,0.08
142,2021-02-26,UMB,660,253,407,386,73,40,3,0,0,154,0,4,0,652,8,ITI,ITI2,10,Umbria,Umbria,882015,30934,3.51,0.07
143,2021-01-07,UMB,1299,387,912,892,1,404,0,0,0,1,0,0,1,1299,0,ITI,ITI2,10,Umbria,Umbria,882015,32233,3.65,0.15
144,2021-03-11,UMB,3563,1695,1868,144,652,263,158,0,0,2018,1,291,36,2557,1006,ITI,ITI2,10,Umbria,Umbria,882015,35796,4.06,0.4
145,2021-03-14,UMB,66,48,18,0,6,1,4,6,2,0,0,0,47,66,0,ITI,ITI2,10,Umbria,Umbria,882015,35862,4.07,0.01
146,2021-04-27,UMB,5623,2389,3234,200,11,1,8,28,1142,2470,1731,8,24,3061,2562,ITI,ITI2,10,Umbria,Umbria,882015,41485,4.7,0.64
147,2021-04-24,UMB,4541,1957,2584,42,15,0,81,35,1121,1064,2178,3,2,3375,1166,ITI,ITI2,10,Umbria,Umbria,882015,46026,5.22,0.51
148,2021-04-30,UMB,6176,2946,3230,74,28,47,77,23,371,280,5260,8,8,2792,3384,ITI,ITI2,10,Umbria,Umbria,882015,52202,5.92,0.7
149,2021-04-22,UMB,5393,2219,3174,258,21,76,5,37,775,3007,1199,7,8,2743,2650,ITI,ITI2,10,Umbria,Umbria,882015,57595,6.53,0.61
150,2021-01-06,UMB,846,325,521,843,0,0,0,1,0,0,0,0,2,846,0,ITI,ITI2,10,Umbria,Umbria,882015,58441,6.63,0.1
151,2021-03-10,UMB,4012,1927,2085,123,785,180,75,3,3,2566,6,263,8,2756,1256,ITI,ITI2,10,Umbria,Umbria,882015,62453,7.08,0.45
152,2021-03-06,UMB,4267,1110,3157,422,186,26,2322,6,5,1128,0,125,47,4124,143,ITI,ITI2,10,Umbria,Umbria,882015,66720,7.56,0.48
153,2021-02-16,UMB,1308,655,653,34,4,0,0,2,1,1263,4,0,0,1299,9,ITI,ITI2,10,Umbria,Umbria,882015,68028,7.71,0.15
154,2021-04-21,UMB,5283,2300,2983,237,9,1,9,73,1048,2692,1201,5,8,3063,2220,ITI,ITI2,10,Umbria,Umbria,882015,73311,8.31,0.6
155,2021-02-17,UMB,1618,748,870,363,4,0,1,0,6,1240,1,0,3,1267,351,ITI,ITI2,10,Umbria,Umbria,882015,74929,8.5,0.18
156,2021-03-01,UMB,1503,774,729,110,10,0,1,0,0,1249,0,133,0,1389,114,ITI,ITI2,10,Umbria,Umbria,882015,76432,8.67,0.17
157,2021-01-05,UMB,854,429,425,851,0,0,0,1,0,0,0,0,2,854,0,ITI,ITI2,10,Umbria,Umbria,882015,77286,8.76,0.1
158,2021-04-03,UMB,2092,710,1382,143,208,30,216,5,32,1265,169,21,3,1056,1036,ITI,ITI2,10,Umbria,Umbria,882015,79378,9.0,0.24
159,2021-02-24,UMB,1520,565,955,1083,45,90,0,1,0,292,0,9,0,1505,15,ITI,ITI2,10,Umbria,Umbria,882015,80898,9.17,0.17
160,2021-01-16,UMB,221,73,148,146,32,43,0,0,0,0,0,0,0,221,0,ITI,ITI2,10,Umbria,Umbria,882015,81119,9.2,0.03
161,2021-04-01,UMB,4319,1788,2531,204,14,309,19,5,7,3257,452,5,47,2323,1996,ITI,ITI2,10,Umbria,Umbria,882015,85438,9.69,0.49
162,2021-03-20,UMB,2297,832,1465,317,682,21,1200,0,0,0,0,72,5,2272,25,ITI,ITI2,10,Umbria,Umbria,882015,87735,9.95,0.26
163,2021-02-08,UMB,637,203,434,368,111,154,0,0,0,0,0,4,0,88,549,ITI,ITI2,10,Umbria,Umbria,882015,88372,10.02,0.07
164,2021-01-15,UMB,701,215,486,590,44,67,0,0,0,0,0,0,0,701,0,ITI,ITI2,10,Umbria,Umbria,882015,89073,10.1,0.08
165,2021-01-09,UMB,1745,499,1246,894,7,844,0,0,0,0,0,0,0,1745,0,ITI,ITI2,10,Umbria,Umbria,882015,90818,10.3,0.2
166,2021-01-14,UMB,752,201,551,697,35,19,1,0,0,0,0,0,0,752,0,ITI,ITI2,10,Umbria,Umbria,882015,91570,10.38,0.09
167,2021-03-29,UMB,3799,1648,2151,247,42,58,26,9,11,2832,534,21,19,2320,1479,ITI,ITI2,10,Umbria,Umbria,882015,95369,10.81,0.43
168,2021-03-05,UMB,4591,1379,3212,604,320,7,2554,2,1,712,0,383,8,3935,656,ITI,ITI2,10,Umbria,Umbria,882015,99960,11.33,0.52
169,2021-02-02,UMB,944,274,670,714,17,212,0,0,0,0,0,0,1,32,912,ITI,ITI2,10,Umbria,Umbria,882015,100904,11.44,0.11
170,2021-04-18,UMB,1529,680,849,67,11,0,41,2,171,840,376,21,0,598,931,ITI,ITI2,10,Umbria,Umbria,882015,102433,11.61,0.17
171,2021-03-15,UMB,4596,1930,2666,1426,264,79,263,2,1,2343,7,206,5,2828,1768,ITI,ITI2,10,Umbria,Umbria,882015,107029,12.13,0.52
172,2021-02-10,UMB,715,349,366,606,106,3,0,0,0,0,0,0,0,700,15,ITI,ITI2,10,Umbria,Umbria,882015,107744,12.22,0.08
173,2021-04-14,UMB,8134,3668,4466,226,35,15,19,58,2920,3148,1694,12,7,6155,1979,ITI,ITI2,10,Umbria,Umbria,882015,115878,13.14,0.92
174,2021-03-07,UMB,845,180,665,17,82,25,676,0,0,45,0,0,0,838,7,ITI,ITI2,10,Umbria,Umbria,882015,116723,13.23,0.1
175,2021-01-13,UMB,450,139,311,379,29,42,0,0,0,0,0,0,0,450,0,ITI,ITI2,10,Umbria,Umbria,882015,117173,13.28,0.05
176,2021-04-07,UMB,5525,2277,3248,482,42,92,19,8,920,3183,759,18,2,3520,2005,ITI,ITI2,10,Umbria,Umbria,882015,122698,13.91,0.63
177,2021-03-13,UMB,1731,524,1207,120,154,49,1152,3,0,152,0,91,10,1486,245,ITI,ITI2,10,Umbria,Umbria,882015,124429,14.11,0.2
178,2021-01-18,UMB,614,219,395,348,114,144,0,2,1,0,0,0,5,529,85,ITI,ITI2,10,Umbria,Umbria,882015,125043,14.18,0.07
179,2021-02-15,UMB,1368,692,676,10,4,0,0,0,1,1351,2,0,0,1367,1,ITI,ITI2,10,Umbria,Umbria,882015,126411,14.33,0.16
180,2021-03-27,UMB,4252,1512,2740,752,595,1,576,4,7,2238,1,24,54,3912,340,ITI,ITI2,10,Umbria,Umbria,882015,130663,14.81,0.48
181,2021-03-04,UMB,4485,1853,2632,849,184,4,1466,2,0,1563,0,410,7,3657,828,ITI,ITI2,10,Umbria,Umbria,882015,135148,15.32,0.51
182,2021-04-02,UMB,4263,1708,2555,376,318,68,331,3,23,886,2155,35,68,3516,747,ITI,ITI2,10,Umbria,Umbria,882015,139411,15.81,0.48
183,2021-01-27,UMB,840,330,510,839,1,0,0,0,0,0,0,0,0,13,827,ITI,ITI2,10,Umbria,Umbria,882015,140251,15.9,0.1
184,2021-02-13,UMB,115,28,87,68,46,0,0,0,0,1,0,0,0,112,3,ITI,ITI2,10,Umbria,Umbria,882015,140366,15.91,0.01
185,2021-01-26,UMB,816,390,426,815,1,0,0,0,0,0,0,0,0,18,798,ITI,ITI2,10,Umbria,Umbria,882015,141182,16.01,0.09
186,2021-01-31,UMB,1058,276,782,767,10,281,0,0,0,0,0,0,0,25,1033,ITI,ITI2,10,Umbria,Umbria,882015,142240,16.13,0.12
187,2021-04-13,UMB,7669,3396,4273,218,23,21,19,61,2861,2875,1573,8,10,6000,1669,ITI,ITI2,10,Umbria,Umbria,882015,149909,17.0,0.87
188,2021-03-30,UMB,3947,1705,2242,179,31,108,20,0,0,3074,432,15,88,2415,1532,ITI,ITI2,10,Umbria,Umbria,882015,153856,17.44,0.45
189,2021-01-20,UMB,613,222,391,583,15,14,1,0,0,0,0,0,0,613,0,ITI,ITI2,10,Umbria,Umbria,882015,154469,17.51,0.07
190,2021-01-03,UMB,270,112,158,270,0,0,0,0,0,0,0,0,0,270,0,ITI,ITI2,10,Umbria,Umbria,882015,154739,17.54,0.03
191,2021-02-12,UMB,671,224,447,459,208,1,2,0,0,1,0,0,0,665,6,ITI,ITI2,10,Umbria,Umbria,882015,155410,17.62,0.08
192,2021-01-22,UMB,276,105,171,273,1,2,0,0,0,0,0,0,0,32,244,ITI,ITI2,10,Umbria,Umbria,882015,155686,17.65,0.03
193,2021-03-08,UMB,3668,1799,1869,141,289,46,42,0,1,2855,2,292,0,2305,1363,ITI,ITI2,10,Umbria,Umbria,882015,159354,18.07,0.42
194,2021-04-17,UMB,6659,3056,3603,164,31,23,127,39,1753,1443,3061,11,7,5317,1342,ITI,ITI2,10,Umbria,Umbria,882015,166013,18.82,0.75
195,2021-01-23,UMB,280,100,180,279,1,0,0,0,0,0,0,0,0,2,278,ITI,ITI2,10,Umbria,Umbria,882015,166293,18.85,0.03
196,2021-02-04,UMB,733,226,507,693,20,20,0,0,0,0,0,0,0,25,708,ITI,ITI2,10,Umbria,Umbria,882015,167026,18.94,0.08
197,2021-03-02,UMB,3640,1345,2295,318,234,55,1446,0,1,1303,0,283,0,3636,4,ITI,ITI2,10,Umbria,Umbria,882015,170666,19.35,0.41
198,2021-03-17,UMB,3331,1313,2018,1430,55,131,16,2,0,1684,1,8,4,1859,1472,ITI,ITI2,10,Umbria,Umbria,882015,173997,19.73,0.38
199,2021-04-08,UMB,5827,2463,3364,343,28,287,12,23,1399,2904,810,13,8,4032,1795,ITI,ITI2,10,Umbria,Umbria,882015,179824,20.39,0.66
200,2021-03-22,UMB,3559,1654,1905,163,235,0,147,3,2,2830,0,174,5,2313,1246,ITI,ITI2,10,Umbria,Umbria,882015,183383,20.79,0.4
201,2021-01-28,UMB,1246,394,852,897,4,345,0,0,0,0,0,0,0,19,1227,ITI,ITI2,10,Umbria,Umbria,882015,184629,20.93,0.14
202,2021-03-31,UMB,3901,1732,2169,178,39,183,23,1,5,2962,425,6,79,2214,1687,ITI,ITI2,10,Umbria,Umbria,882015,188530,21.37,0.44
203,2021-01-10,UMB,1070,277,793,745,3,318,0,1,1,1,0,0,1,1070,0,ITI,ITI2,10,Umbria,Umbria,882015,189600,21.5,0.12
204,2021-02-27,UMB,1658,354,1304,14,11,13,1560,0,0,0,0,60,0,1642,16,ITI,ITI2,10,Umbria,Umbria,882015,191258,21.68,0.19
205,2021-04-06,UMB,5288,2169,3119,599,56,113,29,16,378,3353,713,5,26,2901,2387,ITI,ITI2,10,Umbria,Umbria,882015,196546,22.28,0.6
206,2020-12-31,UMB,322,127,195,310,0,0,0,2,0,0,0,0,10,322,0,ITI,ITI2,10,Umbria,Umbria,882015,196868,22.32,0.04
207,2021-02-23,UMB,1693,658,1035,1187,95,17,0,0,0,394,0,0,0,1651,42,ITI,ITI2,10,Umbria,Umbria,882015,198561,22.51,0.19
208,2021-03-21,UMB,665,330,335,31,285,0,64,34,6,0,0,34,211,665,0,ITI,ITI2,10,Umbria,Umbria,882015,199226,22.59,0.08
209,2021-03-03,UMB,4437,1772,2665,720,247,86,1534,0,0,1519,0,329,2,3725,712,ITI,ITI2,10,Umbria,Umbria,882015,203663,23.09,0.5
210,2021-02-18,UMB,1496,582,914,325,14,170,0,0,0,985,1,0,1,1030,466,ITI,ITI2,10,Umbria,Umbria,882015,205159,23.26,0.17
211,2021-04-11,UMB,3101,1502,1599,30,1,2,4,23,924,136,1942,39,0,3052,49,ITI,ITI2,10,Umbria,Umbria,882015,208260,23.61,0.35
212,2021-01-08,UMB,1190,345,845,942,8,239,0,0,1,0,0,0,0,1190,0,ITI,ITI2,10,Umbria,Umbria,882015,209450,23.75,0.13
213,2021-04-05,UMB,4249,1728,2521,764,22,69,26,3,88,2653,615,6,3,2194,2055,ITI,ITI2,10,Umbria,Umbria,882015,213699,24.23,0.48
214,2021-04-25,UMB,4361,1685,2676,12,13,8,1,20,187,3995,124,1,0,4280,81,ITI,ITI2,10,Umbria,Umbria,882015,218060,24.72,0.49
215,2021-04-28,UMB,5308,2297,3011,183,37,15,4,27,1096,2165,1773,6,2,2926,2382,ITI,ITI2,10,Umbria,Umbria,882015,223368,25.32,0.6
216,2021-04-04,UMB,59,20,39,0,0,0,0,0,22,37,0,0,0,23,36,ITI,ITI2,10,Umbria,Umbria,882015,223427,25.33,0.01
217,2021-04-20,UMB,5428,2348,3080,203,18,27,16,37,1318,2525,1278,0,6,3481,1947,ITI,ITI2,10,Umbria,Umbria,882015,228855,25.95,0.62
218,2021-02-25,UMB,1336,497,839,827,96,99,6,1,0,305,0,0,2,1284,52,ITI,ITI2,10,Umbria,Umbria,882015,230191,26.1,0.15
219,2021-02-19,UMB,743,293,450,282,12,14,0,0,0,433,2,0,0,526,217,ITI,ITI2,10,Umbria,Umbria,882015,230934,26.18,0.08
220,2021-03-26,UMB,4570,1682,2888,570,496,91,738,2,4,2488,0,155,26,4397,173,ITI,ITI2,10,Umbria,Umbria,882015,235504,26.7,0.52
221,2021-04-23,UMB,6581,2777,3804,66,36,83,92,50,1131,1004,4097,8,14,3469,3112,ITI,ITI2,10,Umbria,Umbria,882015,242085,27.45,0.75
222,2021-01-29,UMB,1232,348,884,944,16,272,0,0,0,0,0,0,0,79,1153,ITI,ITI2,10,Umbria,Umbria,882015,243317,27.59,0.14
223,2021-03-16,UMB,3538,1454,2084,1634,79,98,11,0,2,1708,1,0,5,1911,1627,ITI,ITI2,10,Umbria,Umbria,882015,246855,27.99,0.4
224,2021-03-12,UMB,2652,1039,1613,113,454,59,1194,2,0,465,2,309,54,2154,498,ITI,ITI2,10,Umbria,Umbria,882015,249507,28.29,0.3
225,2021-04-09,UMB,6773,3152,3621,105,62,53,86,35,1800,709,3890,10,23,6557,216,ITI,ITI2,10,Umbria,Umbria,882015,256280,29.06,0.77
226,2021-02-07,UMB,54,17,37,46,8,0,0,0,0,0,0,0,0,1,53,ITI,ITI2,10,Umbria,Umbria,882015,256334,29.06,0.01
227,2021-01-30,UMB,1590,490,1100,852,18,719,0,0,0,1,0,0,0,44,1546,ITI,ITI2,10,Umbria,Umbria,882015,257924,29.24,0.18
228,2021-03-25,UMB,3903,1699,2204,260,72,80,32,5,9,3271,1,123,50,2839,1064,ITI,ITI2,10,Umbria,Umbria,882015,261827,29.69,0.44
229,2021-01-24,UMB,258,106,152,258,0,0,0,0,0,0,0,0,0,1,257,ITI,ITI2,10,Umbria,Umbria,882015,262085,29.71,0.03
230,2020-12-27,UMB,86,45,41,68,2,16,0,0,0,0,0,0,0,86,0,ITI,ITI2,10,Umbria,Umbria,882015,262171,29.72,0.01
231,2021-03-24,UMB,4072,1760,2312,215,165,1,42,3,2,3531,0,111,2,2749,1323,ITI,ITI2,10,Umbria,Umbria,882015,266243,30.19,0.46
232,2021-03-23,UMB,3796,1685,2111,396,237,12,60,4,3,2854,0,175,55,2167,1629,ITI,ITI2,10,Umbria,Umbria,882015,270039,30.62,0.43
233,2021-05-04,UMB,5423,2507,2916,202,22,13,7,15,149,1473,3490,40,12,2354,3069,ITI,ITI2,10,Umbria,Umbria,882015,275462,31.23,0.61
234,2021-05-01,UMB,5361,2635,2726,50,19,0,62,10,97,226,4873,23,1,2135,3226,ITI,ITI2,10,Umbria,Umbria,882015,280823,31.84,0.61
235,2021-01-21,UMB,610,202,408,428,13,169,0,0,0,0,0,0,0,341,269,ITI,ITI2,10,Umbria,Umbria,882015,281433,31.91,0.07
236,2021-04-26,UMB,5313,2295,3018,202,20,0,8,13,1241,2327,1494,2,6,3073,2240,ITI,ITI2,10,Umbria,Umbria,882015,286746,32.51,0.6
237,2021-04-16,UMB,8082,3732,4350,166,34,96,180,90,2589,1903,2978,18,28,6245,1837,ITI,ITI2,10,Umbria,Umbria,882015,294828,33.43,0.92
238,2021-04-19,UMB,4987,2201,2786,205,44,34,23,46,781,2514,1322,5,13,2938,2049,ITI,ITI2,10,Umbria,Umbria,882015,299815,33.99,0.57
239,2021-02-22,UMB,1859,778,1081,736,89,1,0,1,2,1007,5,0,18,1773,86,ITI,ITI2,10,Umbria,Umbria,882015,301674,34.2,0.21
240,2021-05-02,UMB,3786,1868,1918,36,31,0,19,9,40,67,3574,9,1,1332,2454,ITI,ITI2,10,Umbria,Umbria,882015,305460,34.63,0.43
241,2021-01-17,UMB,54,17,37,47,7,0,0,0,0,0,0,0,0,54,0,ITI,ITI2,10,Umbria,Umbria,882015,305514,34.64,0.01
242,2021-03-19,UMB,1743,565,1178,462,237,74,724,4,0,192,0,27,23,1087,656,ITI,ITI2,10,Umbria,Umbria,882015,307257,34.84,0.2
243,2021-03-28,UMB,1096,442,654,65,15,5,37,5,7,938,0,24,0,1072,24,ITI,ITI2,10,Umbria,Umbria,882015,308353,34.96,0.12
244,2021-02-11,UMB,842,349,493,735,98,5,3,1,0,0,0,0,0,837,5,ITI,ITI2,10,Umbria,Umbria,882015,309195,35.06,0.1
245,2021-01-12,UMB,838,248,590,677,15,146,0,0,0,0,0,0,0,838,0,ITI,ITI2,10,Umbria,Umbria,882015,310033,35.15,0.1
246,2021-04-29,UMB,5120,2212,2908,204,26,32,8,32,972,2044,1790,6,6,2817,2303,ITI,ITI2,10,Umbria,Umbria,882015,315153,35.73,0.58
247,2021-03-18,UMB,2942,1164,1778,975,124,350,12,3,5,1463,0,3,7,1704,1238,ITI,ITI2,10,Umbria,Umbria,882015,318095,36.06,0.33
248,2021-04-15,UMB,7605,3474,4131,256,34,49,25,76,2571,2865,1668,44,17,5730,1875,ITI,ITI2,10,Umbria,Umbria,882015,325700,36.93,0.86
249,2021-01-01,UMB,274,105,169,273,0,0,0,0,0,0,0,0,1,274,0,ITI,ITI2,10,Umbria,Umbria,882015,325974,36.96,0.03
250,2021-03-21,MOL,1246,542,704,14,1,0,0,0,2,1090,133,0,6,479,767,ITF,ITF2,14,Molise,Molise,305617,1246,0.41,0.41
251,2021-03-07,MOL,1131,501,630,2,16,0,0,0,0,1113,0,0,0,1129,2,ITF,ITF2,14,Molise,Molise,305617,2377,0.78,0.37
252,2021-02-23,MOL,581,223,358,136,39,61,1,0,0,340,0,0,4,362,219,ITF,ITF2,14,Molise,Molise,305617,2958,0.97,0.19
253,2021-01-13,MOL,474,160,314,256,69,144,1,1,1,0,0,0,2,474,0,ITF,ITF2,14,Molise,Molise,305617,3432,1.12,0.16
254,2021-02-02,MOL,539,176,363,295,64,180,0,0,0,0,0,0,0,216,323,ITF,ITF2,14,Molise,Molise,305617,3971,1.3,0.18
255,2021-05-01,MOL,2596,1255,1341,9,3,2,7,28,186,127,2138,4,92,408,2188,ITF,ITF2,14,Molise,Molise,305617,6567,2.15,0.85
256,2021-03-12,MOL,1459,637,822,42,33,0,505,0,1,719,35,116,8,1423,36,ITF,ITF2,14,Molise,Molise,305617,8026,2.63,0.48
257,2021-04-21,MOL,1858,785,1073,19,5,1,26,19,712,420,633,6,17,965,893,ITF,ITF2,14,Molise,Molise,305617,9884,3.23,0.61
258,2021-03-24,MOL,1630,658,972,77,57,0,450,2,3,707,275,48,11,1228,402,ITF,ITF2,14,Molise,Molise,305617,11514,3.77,0.53
259,2021-03-23,MOL,1642,694,948,76,8,6,454,2,4,606,367,97,22,1435,207,ITF,ITF2,14,Molise,Molise,305617,13156,4.3,0.54
260,2021-04-18,MOL,610,264,346,0,0,0,1,1,87,325,191,0,5,104,506,ITF,ITF2,14,Molise,Molise,305617,13766,4.5,0.2
261,2020-12-27,MOL,50,20,30,29,4,17,0,0,0,0,0,0,0,50,0,ITF,ITF2,14,Molise,Molise,305617,13816,4.52,0.02
262,2021-04-06,MOL,1493,700,793,33,9,9,1,2,5,254,1160,18,2,1150,343,ITF,ITF2,14,Molise,Molise,305617,15309,5.01,0.49
263,2021-01-08,MOL,429,141,288,244,7,120,0,13,0,0,0,0,45,429,0,ITF,ITF2,14,Molise,Molise,305617,15738,5.15,0.14
264,2021-02-21,MOL,573,227,346,1,1,0,0,0,1,570,0,0,0,571,2,ITF,ITF2,14,Molise,Molise,305617,16311,5.34,0.19
265,2021-03-14,MOL,595,239,356,2,0,0,0,1,1,582,7,0,2,17,578,ITF,ITF2,14,Molise,Molise,305617,16906,5.53,0.19
266,2021-04-24,MOL,2066,968,1098,11,3,0,17,4,217,345,1462,3,4,593,1473,ITF,ITF2,14,Molise,Molise,305617,18972,6.21,0.68
267,2021-02-28,MOL,829,331,498,38,3,27,0,0,0,761,0,0,0,787,42,ITF,ITF2,14,Molise,Molise,305617,19801,6.48,0.27
268,2021-02-18,MOL,319,74,245,296,8,0,0,0,0,0,0,0,15,306,13,ITF,ITF2,14,Molise,Molise,305617,20120,6.58,0.1
269,2021-01-10,MOL,270,72,198,82,19,169,0,0,0,0,0,0,0,270,0,ITF,ITF2,14,Molise,Molise,305617,20390,6.67,0.09
270,2021-01-31,MOL,268,70,198,85,18,164,1,0,0,0,0,0,0,6,262,ITF,ITF2,14,Molise,Molise,305617,20658,6.76,0.09
271,2021-02-09,MOL,359,170,189,161,83,110,0,0,0,0,0,0,5,197,162,ITF,ITF2,14,Molise,Molise,305617,21017,6.88,0.12
272,2021-04-27,MOL,1584,763,821,29,8,17,1,3,115,247,1128,1,35,456,1128,ITF,ITF2,14,Molise,Molise,305617,22601,7.4,0.52
273,2021-01-26,MOL,450,184,266,444,0,0,1,2,0,0,0,0,3,8,442,ITF,ITF2,14,Molise,Molise,305617,23051,7.54,0.15
274,2021-02-19,MOL,169,93,76,95,70,1,3,0,0,0,0,0,0,167,2,ITF,ITF2,14,Molise,Molise,305617,23220,7.6,0.06
275,2021-04-20,MOL,2311,1020,1291,23,7,1,23,11,740,420,1052,18,16,1219,1092,ITF,ITF2,14,Molise,Molise,305617,25531,8.35,0.76
276,2021-04-28,MOL,1637,887,750,10,4,5,34,127,170,103,1107,4,73,451,1186,ITF,ITF2,14,Molise,Molise,305617,27168,8.89,0.54
277,2021-01-28,MOL,613,217,396,430,9,154,1,4,1,0,0,0,14,17,596,ITF,ITF2,14,Molise,Molise,305617,27781,9.09,0.2
278,2021-03-15,MOL,832,338,494,137,43,67,297,24,4,118,31,61,50,587,245,ITF,ITF2,14,Molise,Molise,305617,28613,9.36,0.27
279,2021-03-10,MOL,1737,720,1017,188,7,1,509,2,5,757,54,187,27,1687,50,ITF,ITF2,14,Molise,Molise,305617,30350,9.93,0.57
280,2021-04-17,MOL,1688,823,865,5,3,0,3,1,169,553,915,34,5,960,728,ITF,ITF2,14,Molise,Molise,305617,32038,10.48,0.55
281,2021-02-27,MOL,1366,568,798,25,29,14,1,1,0,1290,0,0,6,1347,19,ITF,ITF2,14,Molise,Molise,305617,33404,10.93,0.45
282,2021-03-30,MOL,1964,845,1119,46,1,1,424,2,4,573,810,82,21,1452,512,ITF,ITF2,14,Molise,Molise,305617,35368,11.57,0.64
283,2021-05-03,MOL,1645,773,872,1,1,0,0,142,761,67,652,20,1,1605,40,ITF,ITF2,14,Molise,Molise,305617,37013,12.11,0.54
284,2021-01-22,MOL,126,35,91,21,32,73,0,0,0,0,0,0,0,126,0,ITF,ITF2,14,Molise,Molise,305617,37139,12.15,0.04
285,2021-04-13,MOL,1615,710,905,7,4,1,1,12,910,322,350,1,7,1028,587,ITF,ITF2,14,Molise,Molise,305617,38754,12.68,0.53
286,2021-03-22,MOL,1146,439,707,106,5,2,458,7,3,255,216,59,35,903,243,ITF,ITF2,14,Molise,Molise,305617,39900,13.06,0.37
287,2021-04-10,MOL,2556,1233,1323,10,4,0,19,1,12,237,2262,9,2,2405,151,ITF,ITF2,14,Molise,Molise,305617,42456,13.89,0.84
288,2021-03-16,MOL,614,230,384,13,4,11,0,3,7,395,173,4,4,267,347,ITF,ITF2,14,Molise,Molise,305617,43070,14.09,0.2
289,2021-02-05,MOL,593,269,324,460,22,63,0,13,0,0,0,0,35,55,538,ITF,ITF2,14,Molise,Molise,305617,43663,14.29,0.19
290,2021-03-17,MOL,908,385,523,48,25,42,1,8,4,573,176,13,18,576,332,ITF,ITF2,14,Molise,Molise,305617,44571,14.58,0.3
291,2021-04-26,MOL,1134,509,625,7,0,0,1,3,108,215,788,10,2,805,329,ITF,ITF2,14,Molise,Molise,305617,45705,14.95,0.37
292,2021-02-08,MOL,334,141,193,206,39,85,0,3,0,0,0,0,1,216,118,ITF,ITF2,14,Molise,Molise,305617,46039,15.06,0.11
293,2021-02-01,MOL,562,201,361,301,144,111,1,1,0,0,0,0,4,14,548,ITF,ITF2,14,Molise,Molise,305617,46601,15.25,0.18
294,2021-03-28,MOL,1591,741,850,155,15,0,1,0,1,1184,233,1,1,489,1102,ITF,ITF2,14,Molise,Molise,305617,48192,15.77,0.52
295,2021-02-22,MOL,265,129,136,56,65,62,0,27,0,8,0,0,47,250,15,ITF,ITF2,14,Molise,Molise,305617,48457,15.86,0.09
296,2021-04-19,MOL,1803,831,972,18,5,51,7,13,652,251,763,24,19,1037,766,ITF,ITF2,14,Molise,Molise,305617,50260,16.45,0.59
297,2021-01-17,MOL,78,38,40,78,0,0,0,0,0,0,0,0,0,48,30,ITF,ITF2,14,Molise,Molise,305617,50338,16.47,0.03
298,2021-03-19,MOL,1184,482,702,32,1,9,248,2,4,727,155,2,4,757,427,ITF,ITF2,14,Molise,Molise,305617,51522,16.86,0.39
299,2021-01-29,MOL,421,136,285,227,23,109,3,12,0,0,0,0,47,6,415,ITF,ITF2,14,Molise,Molise,305617,51943,17.0,0.14
300,2021-03-29,MOL,2032,835,1197,108,8,5,525,4,55,514,774,22,17,1546,486,ITF,ITF2,14,Molise,Molise,305617,53975,17.66,0.66
301,2021-04-15,MOL,1895,777,1118,3,3,0,27,7,692,649,496,4,14,1057,838,ITF,ITF2,14,Molise,Molise,305617,55870,18.28,0.62
302,2021-03-18,MOL,1156,476,680,73,10,45,0,2,3,855,157,0,11,692,464,ITF,ITF2,14,Molise,Molise,305617,57026,18.66,0.38
303,2021-01-12,MOL,336,114,222,132,74,129,0,0,0,0,0,0,1,336,0,ITF,ITF2,14,Molise,Molise,305617,57362,18.77,0.11
304,2021-03-05,MOL,1219,649,570,322,5,0,73,9,2,618,0,151,39,1015,204,ITF,ITF2,14,Molise,Molise,305617,58581,19.17,0.4
305,2021-01-09,MOL,450,152,298,221,27,178,0,5,0,0,0,0,19,450,0,ITF,ITF2,14,Molise,Molise,305617,59031,19.32,0.15
306,2021-02-16,MOL,156,70,86,148,5,0,0,2,0,0,0,0,1,150,6,ITF,ITF2,14,Molise,Molise,305617,59187,19.37,0.05
307,2021-03-20,MOL,2320,968,1352,28,23,0,222,1,6,1857,147,21,15,999,1321,ITF,ITF2,14,Molise,Molise,305617,61507,20.13,0.76
308,2021-02-17,MOL,72,32,40,47,10,6,0,0,0,1,0,0,8,57,15,ITF,ITF2,14,Molise,Molise,305617,61579,20.15,0.02
309,2021-02-07,MOL,66,32,34,49,1,16,0,0,0,0,0,0,0,19,47,ITF,ITF2,14,Molise,Molise,305617,61645,20.17,0.02
310,2021-02-24,MOL,666,278,388,242,66,44,1,6,7,274,0,0,26,333,333,ITF,ITF2,14,Molise,Molise,305617,62311,20.39,0.22
311,2021-04-29,MOL,2217,1138,1079,108,2,2,7,7,146,154,1714,31,46,880,1337,ITF,ITF2,14,Molise,Molise,305617,64528,21.11,0.73
312,2021-03-25,MOL,1806,730,1076,53,4,18,493,3,10,832,269,107,17,1309,497,ITF,ITF2,14,Molise,Molise,305617,66334,21.7,0.59
313,2021-01-30,MOL,461,158,303,189,52,180,0,6,0,0,0,0,34,12,449,ITF,ITF2,14,Molise,Molise,305617,66795,21.86,0.15
314,2021-03-04,MOL,850,417,433,252,20,69,0,0,1,469,0,36,3,526,324,ITF,ITF2,14,Molise,Molise,305617,67645,22.13,0.28
315,2021-01-14,MOL,646,239,407,418,102,115,0,2,0,0,0,0,9,646,0,ITF,ITF2,14,Molise,Molise,305617,68291,22.35,0.21
316,2021-04-01,MOL,1437,654,783,27,18,21,20,0,2,715,566,62,6,712,725,ITF,ITF2,14,Molise,Molise,305617,69728,22.82,0.47
317,2021-04-25,MOL,785,392,393,2,0,0,0,0,217,62,504,0,0,557,228,ITF,ITF2,14,Molise,Molise,305617,70513,23.07,0.26
318,2021-01-16,MOL,420,166,254,270,16,127,0,1,0,0,0,0,6,420,0,ITF,ITF2,14,Molise,Molise,305617,70933,23.21,0.14
319,2021-04-03,MOL,1766,848,918,28,74,0,26,13,16,267,1323,7,12,1732,34,ITF,ITF2,14,Molise,Molise,305617,72699,23.79,0.58
320,2021-04-05,MOL,389,188,201,1,0,0,0,1,1,113,273,0,0,290,99,ITF,ITF2,14,Molise,Molise,305617,73088,23.91,0.13
321,2021-03-06,MOL,1728,807,921,156,18,0,0,2,4,1395,0,152,1,1569,159,ITF,ITF2,14,Molise,Molise,305617,74816,24.48,0.57
322,2021-03-03,MOL,672,316,356,63,4,48,127,0,0,385,0,45,0,590,82,ITF,ITF2,14,Molise,Molise,305617,75488,24.7,0.22
323,2021-01-06,MOL,689,260,429,456,26,171,0,1,2,21,0,0,12,689,0,ITF,ITF2,14,Molise,Molise,305617,76177,24.93,0.23
324,2021-04-30,MOL,2897,1536,1361,28,0,2,2,8,267,119,2457,0,14,827,2070,ITF,ITF2,14,Molise,Molise,305617,79074,25.87,0.95
325,2021-04-23,MOL,2037,877,1160,50,18,0,20,7,605,226,1096,11,4,1378,659,ITF,ITF2,14,Molise,Molise,305617,81111,26.54,0.67
326,2021-01-05,MOL,449,180,269,441,0,0,0,1,0,0,0,0,7,449,0,ITF,ITF2,14,Molise,Molise,305617,81560,26.69,0.15
327,2021-02-03,MOL,731,249,482,391,112,180,1,4,3,0,0,0,40,338,393,ITF,ITF2,14,Molise,Molise,305617,82291,26.93,0.24
328,2021-01-19,MOL,173,63,110,90,57,22,2,0,0,0,0,0,2,162,11,ITF,ITF2,14,Molise,Molise,305617,82464,26.98,0.06
329,2021-01-15,MOL,538,242,296,398,17,81,0,8,0,0,0,0,34,538,0,ITF,ITF2,14,Molise,Molise,305617,83002,27.16,0.18
330,2021-01-04,MOL,314,131,183,301,0,0,0,2,0,0,0,0,11,314,0,ITF,ITF2,14,Molise,Molise,305617,83316,27.26,0.1
331,2021-02-06,MOL,429,179,250,276,14,130,1,2,0,0,0,0,6,29,400,ITF,ITF2,14,Molise,Molise,305617,83745,27.4,0.14
332,2021-04-16,MOL,2411,1027,1384,56,5,11,8,7,693,738,880,7,6,1184,1227,ITF,ITF2,14,Molise,Molise,305617,86156,28.19,0.79
333,2021-04-09,MOL,2295,1240,1055,33,10,1,1,93,9,136,2004,2,6,2104,191,ITF,ITF2,14,Molise,Molise,305617,88451,28.94,0.75
334,2021-02-25,MOL,541,239,302,68,3,28,0,6,0,434,0,0,2,473,68,ITF,ITF2,14,Molise,Molise,305617,88992,29.12,0.18
335,2021-03-08,MOL,1378,522,856,359,51,23,404,2,1,411,36,76,15,1238,140,ITF,ITF2,14,Molise,Molise,305617,90370,29.57,0.45
336,2021-01-07,MOL,598,209,389,414,2,145,0,5,1,4,0,0,27,598,0,ITF,ITF2,14,Molise,Molise,305617,90968,29.77,0.2
337,2021-05-02,MOL,1750,885,865,1,3,0,0,113,23,13,1556,1,40,561,1189,ITF,ITF2,14,Molise,Molise,305617,92718,30.34,0.57
338,2021-04-22,MOL,1833,857,976,12,2,6,5,19,752,338,681,8,10,1062,771,ITF,ITF2,14,Molise,Molise,305617,94551,30.94,0.6
339,2021-01-20,MOL,18,8,10,14,4,0,0,0,0,0,0,0,0,18,0,ITF,ITF2,14,Molise,Molise,305617,94569,30.94,0.01
340,2021-03-11,MOL,1463,636,827,42,2,14,499,4,2,699,12,185,4,1457,6,ITF,ITF2,14,Molise,Molise,305617,96032,31.42,0.48
341,2021-01-25,MOL,319,130,189,317,0,0,2,0,0,0,0,0,0,3,316,ITF,ITF2,14,Molise,Molise,305617,96351,31.53,0.1
342,2021-02-12,MOL,330,149,181,224,13,72,2,7,1,0,0,0,11,208,122,ITF,ITF2,14,Molise,Molise,305617,96681,31.63,0.11
343,2021-04-11,MOL,1148,581,567,0,5,0,0,1,1,48,1089,0,4,1135,13,ITF,ITF2,14,Molise,Molise,305617,97829,32.01,0.38
344,2021-01-11,MOL,557,194,363,196,243,111,0,1,0,0,0,0,6,557,0,ITF,ITF2,14,Molise,Molise,305617,98386,32.19,0.18
345,2021-02-04,MOL,758,295,463,502,95,141,1,3,0,0,0,0,16,77,681,ITF,ITF2,14,Molise,Molise,305617,99144,32.44,0.25
346,2021-04-07,MOL,1686,846,840,36,12,62,80,10,3,133,1315,29,6,1411,275,ITF,ITF2,14,Molise,Molise,305617,100830,32.99,0.55
347,2021-03-02,MOL,667,383,284,98,106,51,151,0,0,139,0,113,9,509,158,ITF,ITF2,14,Molise,Molise,305617,101497,33.21,0.22
348,2021-04-08,MOL,1751,899,852,105,15,6,35,5,3,195,1368,8,11,1550,201,ITF,ITF2,14,Molise,Molise,305617,103248,33.78,0.57
349,2021-03-31,MOL,2192,918,1274,202,13,32,263,10,18,826,707,96,25,1373,819,ITF,ITF2,14,Molise,Molise,305617,105440,34.5,0.72
350,2021-04-04,MOL,253,141,112,1,0,0,0,0,0,3,248,0,1,238,15,ITF,ITF2,14,Molise,Molise,305617,105693,34.58,0.08
351,2021-02-11,MOL,293,133,160,225,19,45,1,0,0,0,0,3,0,257,36,ITF,ITF2,14,Molise,Molise,305617,105986,34.68,0.1
352,2021-03-01,MOL,661,274,387,200,36,108,147,8,1,135,0,2,24,447,214,ITF,ITF2,14,Molise,Molise,305617,106647,34.9,0.22
353,2021-03-13,MOL,1189,594,595,29,5,6,0,5,4,981,6,151,2,200,989,ITF,ITF2,14,Molise,Molise,305617,107836,35.28,0.39
354,2021-03-26,MOL,2573,1044,1529,72,63,23,548,7,16,1014,747,70,13,1931,642,ITF,ITF2,14,Molise,Molise,305617,110409,36.13,0.84
355,2021-02-10,MOL,150,78,72,91,6,53,0,0,0,0,0,0,0,130,20,ITF,ITF2,14,Molise,Molise,305617,110559,36.18,0.05
356,2021-04-14,MOL,1785,760,1025,44,1,11,3,5,974,431,307,5,4,1133,652,ITF,ITF2,14,Molise,Molise,305617,112344,36.76,0.58
357,2021-02-15,MOL,144,70,74,117,10,15,0,0,0,0,0,0,2,141,3,ITF,ITF2,14,Molise,Molise,305617,112488,36.81,0.05
358,2021-02-20,MOL,1018,441,577,20,5,8,0,0,1,983,0,0,1,998,20,ITF,ITF2,14,Molise,Molise,305617,113506,37.14,0.33
359,2021-01-18,MOL,114,48,66,97,14,0,0,1,0,0,0,0,2,114,0,ITF,ITF2,14,Molise,Molise,305617,113620,37.18,0.04
360,2021-04-12,MOL,1256,547,709,17,2,1,0,11,944,87,188,1,5,1014,242,ITF,ITF2,14,Molise,Molise,305617,114876,37.59,0.41
361,2021-05-04,MOL,2528,1124,1404,17,4,1,2,859,479,12,1153,0,1,2440,88,ITF,ITF2,14,Molise,Molise,305617,117404,38.42,0.83
362,2021-02-13,MOL,132,80,52,129,3,0,0,0,0,0,0,0,0,132,0,ITF,ITF2,14,Molise,Molise,305617,117536,38.46,0.04
363,2021-01-27,MOL,674,251,423,436,12,209,1,10,0,0,0,1,5,8,666,ITF,ITF2,14,Molise,Molise,305617,118210,38.68,0.22
364,2021-02-26,MOL,563,260,303,42,7,3,55,9,1,406,1,0,39,490,73,ITF,ITF2,14,Molise,Molise,305617,118773,38.86,0.18
365,2021-03-09,MOL,1329,579,750,199,6,0,393,4,1,409,76,218,23,1177,152,ITF,ITF2,14,Molise,Molise,305617,120102,39.3,0.43
366,2021-03-27,MOL,2737,1272,1465,18,58,0,1,6,4,1907,717,23,3,1304,1433,ITF,ITF2,14,Molise,Molise,305617,122839,40.19,0.9
367,2021-04-02,MOL,1404,691,713,47,77,0,2,8,8,663,476,105,18,643,761,ITF,ITF2,14,Molise,Molise,305617,124243,40.65,0.46
368,2021-01-21,MOL,6,2,4,0,6,0,0,0,0,0,0,0,0,6,0,ITF,ITF2,14,Molise,Molise,305617,124249,40.66,0.0
369,2021-03-21,PUG,2689,1224,1465,462,32,13,285,0,5,1792,15,38,47,585,2104,ITF,ITF4,16,Puglia,Puglia,4029053,2689,0.07,0.07
370,2021-01-30,PUG,5526,2514,3012,4750,325,419,6,0,2,3,5,4,12,411,5115,ITF,ITF4,16,Puglia,Puglia,4029053,8215,0.2,0.14
371,2021-01-14,PUG,4067,1588,2479,3185,377,499,2,1,0,0,0,0,3,4067,0,ITF,ITF4,16,Puglia,Puglia,4029053,12282,0.3,0.1
372,2021-04-20,PUG,20691,9586,11105,493,209,121,91,1384,8951,3370,5783,76,213,17239,3452,ITF,ITF4,16,Puglia,Puglia,4029053,32973,0.82,0.51
373,2021-01-24,PUG,1669,749,920,1286,231,150,0,0,0,1,1,0,0,153,1516,ITF,ITF4,16,Puglia,Puglia,4029053,34642,0.86,0.04
374,2021-03-05,PUG,17032,6784,10248,2311,827,274,7000,34,23,5336,18,1173,36,14868,2164,ITF,ITF4,16,Puglia,Puglia,4029053,51674,1.28,0.42
375,2021-03-15,PUG,11759,5615,6144,2092,646,116,682,24,30,7672,23,461,13,5264,6495,ITF,ITF4,16,Puglia,Puglia,4029053,63433,1.57,0.29
376,2021-03-03,PUG,16602,6675,9927,2046,636,269,6709,5,6,5987,2,939,3,14711,1891,ITF,ITF4,16,Puglia,Puglia,4029053,80035,1.99,0.41
377,2021-03-07,PUG,4914,1940,2974,930,101,3,1852,5,4,1681,7,325,6,4343,571,ITF,ITF4,16,Puglia,Puglia,4029053,84949,2.11,0.12
378,2021-04-14,PUG,31598,14898,16700,628,219,39,83,4650,15193,4904,5449,123,310,28285,3313,ITF,ITF4,16,Puglia,Puglia,4029053,116547,2.89,0.78
379,2021-04-25,PUG,10901,5040,5861,183,87,43,145,910,3181,1127,5027,11,187,9743,1158,ITF,ITF4,16,Puglia,Puglia,4029053,127448,3.16,0.27
380,2021-01-13,PUG,4537,1729,2808,3973,329,230,2,1,0,0,0,0,2,4537,0,ITF,ITF4,16,Puglia,Puglia,4029053,131985,3.28,0.11
381,2021-04-19,PUG,27288,12659,14629,547,143,76,57,1993,14637,3259,6347,49,180,24237,3051,ITF,ITF4,16,Puglia,Puglia,4029053,159273,3.95,0.68
382,2021-02-23,PUG,9339,4416,4923,1789,362,169,1019,11,15,5554,1,400,19,8864,475,ITF,ITF4,16,Puglia,Puglia,4029053,168612,4.18,0.23
383,2021-04-26,PUG,25726,11783,13943,422,232,102,126,6452,8040,2747,7405,34,166,22468,3258,ITF,ITF4,16,Puglia,Puglia,4029053,194338,4.82,0.64
384,2021-02-12,PUG,4099,1629,2470,2938,443,690,5,0,0,5,5,10,3,3008,1091,ITF,ITF4,16,Puglia,Puglia,4029053,198437,4.93,0.1
385,2021-03-20,PUG,8234,3721,4513,1427,87,54,811,23,51,5648,43,69,21,3653,4581,ITF,ITF4,16,Puglia,Puglia,4029053,206671,5.13,0.2
386,2021-01-27,PUG,4576,1928,2648,3932,239,396,2,1,3,0,0,0,3,610,3966,ITF,ITF4,16,Puglia,Puglia,4029053,211247,5.24,0.11
387,2021-03-18,PUG,9394,4248,5146,1754,488,225,90,17,27,6690,43,40,20,3281,6113,ITF,ITF4,16,Puglia,Puglia,4029053,220641,5.48,0.23
388,2021-01-29,PUG,6192,2659,3533,5516,376,288,3,3,0,1,0,0,5,436,5756,ITF,ITF4,16,Puglia,Puglia,4029053,226833,5.63,0.15
389,2021-02-24,PUG,10027,4699,5328,1925,602,117,560,9,12,6410,0,375,17,9438,589,ITF,ITF4,16,Puglia,Puglia,4029053,236860,5.88,0.25
390,2021-02-13,PUG,3723,1454,2269,2884,517,290,7,0,2,5,0,18,0,3029,694,ITF,ITF4,16,Puglia,Puglia,4029053,240583,5.97,0.09
391,2021-01-22,PUG,1409,578,831,878,154,373,1,0,0,1,1,0,1,991,418,ITF,ITF4,16,Puglia,Puglia,4029053,241992,6.01,0.03
392,2021-02-10,PUG,3635,1429,2206,2511,254,869,1,0,0,0,0,0,0,2125,1510,ITF,ITF4,16,Puglia,Puglia,4029053,245627,6.1,0.09
393,2021-03-08,PUG,14656,6075,8581,2140,840,224,3938,13,9,6829,6,635,22,12262,2394,ITF,ITF4,16,Puglia,Puglia,4029053,260283,6.46,0.36
394,2021-01-09,PUG,4877,2248,2629,4323,255,247,1,5,1,4,5,0,36,4877,0,ITF,ITF4,16,Puglia,Puglia,4029053,265160,6.58,0.12
395,2021-01-21,PUG,2129,903,1226,1429,167,527,0,0,1,3,0,0,2,1270,859,ITF,ITF4,16,Puglia,Puglia,4029053,267289,6.63,0.05
396,2021-02-15,PUG,3254,1268,1986,2249,527,454,3,0,1,1,1,7,11,2634,620,ITF,ITF4,16,Puglia,Puglia,4029053,270543,6.71,0.08
397,2021-03-19,PUG,7947,3646,4301,1761,279,70,260,13,20,5382,74,66,22,3406,4541,ITF,ITF4,16,Puglia,Puglia,4029053,278490,6.91,0.2
398,2021-03-29,PUG,12827,5983,6844,1594,586,241,1129,35,140,7960,664,409,69,6109,6718,ITF,ITF4,16,Puglia,Puglia,4029053,291317,7.23,0.32
399,2021-03-13,PUG,10369,4092,6277,2160,277,131,3322,7,12,4129,45,254,32,8640,1729,ITF,ITF4,16,Puglia,Puglia,4029053,301686,7.49,0.26
400,2021-03-17,PUG,10276,4683,5593,1792,464,63,70,30,39,7682,38,51,47,4174,6102,ITF,ITF4,16,Puglia,Puglia,4029053,311962,7.74,0.26
401,2021-01-28,PUG,5465,2271,3194,4782,339,327,3,3,0,0,0,6,5,473,4992,ITF,ITF4,16,Puglia,Puglia,4029053,317427,7.88,0.14
402,2021-04-11,PUG,16342,7202,9140,331,86,15,119,388,1036,5491,8749,18,109,14675,1667,ITF,ITF4,16,Puglia,Puglia,4029053,333769,8.28,0.41
403,2021-02-26,PUG,13668,5013,8655,2126,681,298,4661,12,10,5228,18,612,22,12640,1028,ITF,ITF4,16,Puglia,Puglia,4029053,347437,8.62,0.34
404,2021-01-04,PUG,4503,2012,2491,4397,88,11,1,0,0,0,0,0,6,4503,0,ITF,ITF4,16,Puglia,Puglia,4029053,351940,8.74,0.11
405,2021-03-02,PUG,16285,6043,10242,1399,665,113,8168,17,17,4351,5,1537,13,14979,1306,ITF,ITF4,16,Puglia,Puglia,4029053,368225,9.14,0.4
406,2021-01-19,PUG,1221,452,769,531,113,577,0,0,0,0,0,0,0,1211,10,ITF,ITF4,16,Puglia,Puglia,4029053,369446,9.17,0.03
407,2021-04-07,PUG,14886,6565,8321,1035,418,87,363,182,575,8675,3161,145,245,8275,6611,ITF,ITF4,16,Puglia,Puglia,4029053,384332,9.54,0.37
408,2021-01-23,PUG,3037,1292,1745,2523,176,309,1,3,6,14,0,0,5,886,2151,ITF,ITF4,16,Puglia,Puglia,4029053,387369,9.61,0.08
409,2021-02-03,PUG,5031,2002,3029,4366,476,184,3,2,0,0,0,0,0,730,4301,ITF,ITF4,16,Puglia,Puglia,4029053,392400,9.74,0.12
410,2021-04-08,PUG,17175,7472,9703,1029,330,181,506,219,808,9636,4205,89,172,11106,6069,ITF,ITF4,16,Puglia,Puglia,4029053,409575,10.17,0.43
411,2021-01-18,PUG,1846,770,1076,1183,215,445,0,0,0,1,0,1,1,1497,349,ITF,ITF4,16,Puglia,Puglia,4029053,411421,10.21,0.05
412,2021-01-06,PUG,3942,1664,2278,3313,224,372,0,11,1,0,0,0,21,3942,0,ITF,ITF4,16,Puglia,Puglia,4029053,415363,10.31,0.1
413,2021-03-06,PUG,15897,5939,9958,2175,472,99,7046,16,14,5469,25,566,15,13830,2067,ITF,ITF4,16,Puglia,Puglia,4029053,431260,10.7,0.39
414,2021-01-08,PUG,5579,2336,3243,4868,373,328,3,0,0,0,2,4,1,5579,0,ITF,ITF4,16,Puglia,Puglia,4029053,436839,10.84,0.14
415,2021-03-01,PUG,15045,5842,9203,1973,724,83,5144,7,15,6182,4,891,22,13676,1369,ITF,ITF4,16,Puglia,Puglia,4029053,451884,11.22,0.37
416,2021-04-30,PUG,33397,14903,18494,799,410,195,161,4004,8070,6951,12235,119,453,21814,11583,ITF,ITF4,16,Puglia,Puglia,4029053,485281,12.04,0.83
417,2020-12-31,PUG,1635,782,853,1549,38,44,3,0,1,0,0,0,0,1635,0,ITF,ITF4,16,Puglia,Puglia,4029053,486916,12.09,0.04
418,2021-04-22,PUG,22558,10295,12263,778,280,215,115,1824,9116,4154,5744,56,276,17740,4818,ITF,ITF4,16,Puglia,Puglia,4029053,509474,12.65,0.56
419,2021-02-09,PUG,3839,1569,2270,2533,661,622,6,2,3,9,1,0,2,2167,1672,ITF,ITF4,16,Puglia,Puglia,4029053,513313,12.74,0.1
420,2021-03-27,PUG,12094,5675,6419,970,592,71,1372,35,90,7563,1109,216,76,6950,5144,ITF,ITF4,16,Puglia,Puglia,4029053,525407,13.04,0.3
421,2021-02-28,PUG,5888,1785,4103,559,136,26,3417,6,3,1543,1,194,3,5702,186,ITF,ITF4,16,Puglia,Puglia,4029053,531295,13.19,0.15
422,2021-03-26,PUG,11436,5336,6100,1611,919,287,1340,38,119,6465,98,442,117,6793,4643,ITF,ITF4,16,Puglia,Puglia,4029053,542731,13.47,0.28
423,2021-01-31,PUG,1808,825,983,1502,103,198,2,1,0,2,0,0,0,73,1735,ITF,ITF4,16,Puglia,Puglia,4029053,544539,13.52,0.04
424,2021-04-04,PUG,5929,2949,2980,98,25,7,47,29,44,285,5320,26,48,5923,6,ITF,ITF4,16,Puglia,Puglia,4029053,550468,13.66,0.15
425,2021-04-05,PUG,12676,6162,6514,57,59,4,30,59,238,942,11207,12,68,12143,533,ITF,ITF4,16,Puglia,Puglia,4029053,563144,13.98,0.31
426,2021-01-11,PUG,3749,1587,2162,3221,336,175,2,4,0,0,0,6,5,3749,0,ITF,ITF4,16,Puglia,Puglia,4029053,566893,14.07,0.09
427,2021-01-20,PUG,1546,541,1005,781,125,627,0,0,3,9,0,0,1,1538,8,ITF,ITF4,16,Puglia,Puglia,4029053,568439,14.11,0.04
428,2021-01-02,PUG,2948,1300,1648,2829,91,23,4,0,0,0,0,0,1,2948,0,ITF,ITF4,16,Puglia,Puglia,4029053,571387,14.18,0.07
429,2021-02-21,PUG,2174,472,1702,537,73,49,1458,1,5,32,0,12,7,2113,61,ITF,ITF4,16,Puglia,Puglia,4029053,573561,14.24,0.05
430,2021-01-16,PUG,2507,1033,1474,1682,300,518,1,1,1,0,0,0,4,2507,0,ITF,ITF4,16,Puglia,Puglia,4029053,576068,14.3,0.06
431,2021-02-02,PUG,4339,1843,2496,3629,389,317,3,1,0,0,0,0,0,593,3746,ITF,ITF4,16,Puglia,Puglia,4029053,580407,14.41,0.11
432,2021-03-11,PUG,14344,6179,8165,2913,932,515,3676,5,7,5277,8,991,20,11239,3105,ITF,ITF4,16,Puglia,Puglia,4029053,594751,14.76,0.36
433,2021-01-15,PUG,4551,1866,2685,3598,369,558,4,2,0,1,1,13,5,4551,0,ITF,ITF4,16,Puglia,Puglia,4029053,599302,14.87,0.11
434,2021-04-01,PUG,13382,6103,7279,1245,453,220,1038,57,300,8055,1572,319,123,7045,6337,ITF,ITF4,16,Puglia,Puglia,4029053,612684,15.21,0.33
435,2021-04-18,PUG,22338,10673,11665,80,39,4,9,4067,9430,1437,7046,12,214,21252,1086,ITF,ITF4,16,Puglia,Puglia,4029053,635022,15.76,0.55
436,2020-12-27,PUG,507,250,257,438,6,63,0,0,0,0,0,0,0,507,0,ITF,ITF4,16,Puglia,Puglia,4029053,635529,15.77,0.01
437,2021-02-17,PUG,4268,1744,2524,2488,1171,598,1,0,1,2,1,1,5,3669,599,ITF,ITF4,16,Puglia,Puglia,4029053,639797,15.88,0.11
438,2021-03-23,PUG,10396,4990,5406,1851,414,51,991,29,44,6095,52,744,125,3934,6462,ITF,ITF4,16,Puglia,Puglia,4029053,650193,16.14,0.26
439,2021-03-24,PUG,12964,5974,6990,1907,628,193,1543,29,58,7921,83,497,105,5712,7252,ITF,ITF4,16,Puglia,Puglia,4029053,663157,16.46,0.32
440,2021-04-21,PUG,22834,10539,12295,681,240,61,377,1964,12267,2773,4205,115,151,19124,3710,ITF,ITF4,16,Puglia,Puglia,4029053,685991,17.03,0.57
441,2021-05-04,PUG,30138,12645,17493,567,198,54,3946,4738,8389,2583,9093,309,261,15393,14745,ITF,ITF4,16,Puglia,Puglia,4029053,716129,17.77,0.75
442,2021-04-27,PUG,26048,11791,14257,653,259,232,237,5205,7439,4182,7506,64,271,20563,5485,ITF,ITF4,16,Puglia,Puglia,4029053,742177,18.42,0.65
443,2021-04-24,PUG,28774,13110,15664,551,291,91,74,2479,11239,3601,9969,33,446,24770,4004,ITF,ITF4,16,Puglia,Puglia,4029053,770951,19.13,0.71
444,2021-02-16,PUG,3378,1451,1927,2154,740,412,2,7,0,5,0,16,42,2734,644,ITF,ITF4,16,Puglia,Puglia,4029053,774329,19.22,0.08
445,2021-03-14,PUG,3313,1428,1885,957,89,107,1001,28,10,976,9,43,93,2503,810,ITF,ITF4,16,Puglia,Puglia,4029053,777642,19.3,0.08
446,2021-04-02,PUG,12503,5729,6774,894,398,298,695,117,631,7473,1493,193,311,7984,4519,ITF,ITF4,16,Puglia,Puglia,4029053,790145,19.61,0.31
447,2021-01-12,PUG,4208,1768,2440,3635,343,218,5,2,3,1,0,0,1,4208,0,ITF,ITF4,16,Puglia,Puglia,4029053,794353,19.72,0.1
448,2021-01-25,PUG,3821,1678,2143,3471,170,169,1,1,0,2,1,0,6,423,3398,ITF,ITF4,16,Puglia,Puglia,4029053,798174,19.81,0.09
449,2021-04-12,PUG,28811,13570,15241,504,236,26,158,2192,14771,4835,5730,150,209,25985,2826,ITF,ITF4,16,Puglia,Puglia,4029053,826985,20.53,0.72
450,2021-01-01,PUG,146,60,86,145,1,0,0,0,0,0,0,0,0,146,0,ITF,ITF4,16,Puglia,Puglia,4029053,827131,20.53,0.0
451,2021-03-04,PUG,15031,5863,9168,1532,589,325,6288,20,15,4778,5,1451,28,13649,1382,ITF,ITF4,16,Puglia,Puglia,4029053,842162,20.9,0.37
452,2021-02-11,PUG,3698,1402,2296,2576,391,725,2,0,0,0,0,0,4,2422,1276,ITF,ITF4,16,Puglia,Puglia,4029053,845860,20.99,0.09
453,2021-04-29,PUG,25126,11609,13517,547,346,124,70,2997,9030,4076,7594,33,309,18625,6501,ITF,ITF4,16,Puglia,Puglia,4029053,870986,21.62,0.62
454,2021-03-09,PUG,13156,5743,7413,1872,711,225,3543,16,10,5627,7,1090,55,11159,1997,ITF,ITF4,16,Puglia,Puglia,4029053,884142,21.94,0.33
455,2021-03-12,PUG,13911,6099,7812,3282,1136,432,3022,9,16,5006,9,987,12,9987,3924,ITF,ITF4,16,Puglia,Puglia,4029053,898053,22.29,0.35
456,2021-01-07,PUG,5714,2455,3259,5218,263,217,3,4,0,0,2,7,0,5714,0,ITF,ITF4,16,Puglia,Puglia,4029053,903767,22.43,0.14
457,2021-02-22,PUG,9622,4528,5094,1440,650,140,319,14,19,6809,5,215,11,9290,332,ITF,ITF4,16,Puglia,Puglia,4029053,913389,22.67,0.24
458,2021-02-08,PUG,3993,1611,2382,2966,605,389,1,1,0,1,1,26,3,1598,2395,ITF,ITF4,16,Puglia,Puglia,4029053,917382,22.77,0.1
459,2021-02-01,PUG,3961,1657,2304,3443,287,208,5,4,0,0,0,6,8,375,3586,ITF,ITF4,16,Puglia,Puglia,4029053,921343,22.87,0.1
460,2021-02-20,PUG,2967,1079,1888,2116,233,168,425,0,1,9,1,4,10,2711,256,ITF,ITF4,16,Puglia,Puglia,4029053,924310,22.94,0.07
461,2021-04-10,PUG,30321,12886,17435,632,235,121,278,662,1658,11828,14496,149,262,26146,4175,ITF,ITF4,16,Puglia,Puglia,4029053,954631,23.69,0.75
462,2021-02-05,PUG,5631,2272,3359,4569,512,526,6,0,0,0,0,14,4,1331,4300,ITF,ITF4,16,Puglia,Puglia,4029053,960262,23.83,0.14
463,2021-03-22,PUG,9344,4550,4794,608,368,12,1070,17,39,6753,49,362,66,3700,5644,ITF,ITF4,16,Puglia,Puglia,4029053,969606,24.07,0.23
464,2021-02-27,PUG,14122,4782,9340,1586,653,181,6181,14,8,5119,17,350,13,12943,1179,ITF,ITF4,16,Puglia,Puglia,4029053,983728,24.42,0.35
465,2021-04-16,PUG,35248,16563,18685,689,281,135,210,4883,14875,4557,9179,100,339,31954,3294,ITF,ITF4,16,Puglia,Puglia,4029053,1018976,25.29,0.87
466,2021-01-17,PUG,1308,590,718,818,154,336,0,0,0,0,0,0,0,1239,69,ITF,ITF4,16,Puglia,Puglia,4029053,1020284,25.32,0.03
467,2021-03-31,PUG,14028,6346,7682,1789,564,177,811,30,189,8646,1342,371,109,8475,5553,ITF,ITF4,16,Puglia,Puglia,4029053,1034312,25.67,0.35
468,2021-02-04,PUG,5898,2357,3541,4444,793,653,6,0,0,0,1,0,1,1168,4730,ITF,ITF4,16,Puglia,Puglia,4029053,1040210,25.82,0.15
469,2021-02-06,PUG,4510,1916,2594,3493,484,527,3,0,1,0,0,0,2,1589,2921,ITF,ITF4,16,Puglia,Puglia,4029053,1044720,25.93,0.11
470,2021-02-18,PUG,4375,1845,2530,2713,960,680,2,1,1,5,1,11,1,3772,603,ITF,ITF4,16,Puglia,Puglia,4029053,1049095,26.04,0.11
471,2021-05-02,PUG,20812,9453,11359,93,93,17,39,3911,4799,3469,8076,20,295,13669,7143,ITF,ITF4,16,Puglia,Puglia,4029053,1069907,26.55,0.52
472,2021-04-03,PUG,10405,4554,5851,919,218,135,541,122,363,5417,2385,18,287,6861,3544,ITF,ITF4,16,Puglia,Puglia,4029053,1080312,26.81,0.26
473,2021-03-28,PUG,3523,1650,1873,638,151,47,119,6,11,2016,520,3,12,1198,2325,ITF,ITF4,16,Puglia,Puglia,4029053,1083835,26.9,0.09
474,2021-04-06,PUG,13331,5893,7438,749,378,159,221,88,506,8455,2554,131,90,6711,6620,ITF,ITF4,16,Puglia,Puglia,4029053,1097166,27.23,0.33
475,2021-04-15,PUG,31928,14895,17033,560,222,77,121,4274,13214,5123,7892,96,349,28437,3491,ITF,ITF4,16,Puglia,Puglia,4029053,1129094,28.02,0.79
476,2021-03-10,PUG,14372,6231,8141,2602,1070,355,3078,6,33,6545,7,655,21,11257,3115,ITF,ITF4,16,Puglia,Puglia,4029053,1143466,28.38,0.36
477,2021-04-17,PUG,38938,18449,20489,523,166,83,181,4755,12993,4910,14771,82,474,35450,3488,ITF,ITF4,16,Puglia,Puglia,4029053,1182404,29.35,0.97
478,2021-04-28,PUG,19346,8668,10678,332,163,93,85,2228,7597,3215,5474,55,104,14667,4679,ITF,ITF4,16,Puglia,Puglia,4029053,1201750,29.83,0.48
479,2021-02-19,PUG,4729,2010,2719,3065,1189,389,7,2,1,2,0,49,25,4338,391,ITF,ITF4,16,Puglia,Puglia,4029053,1206479,29.94,0.12
480,2021-02-14,PUG,785,348,437,682,32,70,1,0,0,0,0,0,0,662,123,ITF,ITF4,16,Puglia,Puglia,4029053,1207264,29.96,0.02
481,2021-04-09,PUG,21595,9267,12328,1111,544,170,417,468,1171,9790,7461,146,317,16966,4629,ITF,ITF4,16,Puglia,Puglia,4029053,1228859,30.5,0.54
482,2021-03-16,PUG,9854,4680,5174,2201,553,91,40,21,23,6630,129,143,23,3498,6356,ITF,ITF4,16,Puglia,Puglia,4029053,1238713,30.74,0.24
483,2021-01-03,PUG,2007,943,1064,1818,38,145,1,1,1,0,3,0,0,2007,0,ITF,ITF4,16,Puglia,Puglia,4029053,1240720,30.79,0.05
484,2021-02-25,PUG,11890,5037,6853,1746,763,420,2381,19,15,5784,1,727,34,10733,1157,ITF,ITF4,16,Puglia,Puglia,4029053,1252610,31.09,0.3
485,2021-05-03,PUG,31595,14133,17462,457,306,162,1448,10923,5801,3386,8798,78,236,21215,10380,ITF,ITF4,16,Puglia,Puglia,4029053,1284205,31.87,0.78
486,2021-04-13,PUG,28363,13465,14898,658,252,58,118,4553,10806,5302,6144,122,350,24974,3389,ITF,ITF4,16,Puglia,Puglia,4029053,1312568,32.58,0.7
487,2021-01-26,PUG,5358,2396,2962,4850,269,232,0,2,1,1,0,0,3,571,4787,ITF,ITF4,16,Puglia,Puglia,4029053,1317926,32.71,0.13
488,2021-01-05,PUG,5099,2247,2852,4783,178,98,4,9,9,5,0,0,13,5099,0,ITF,ITF4,16,Puglia,Puglia,4029053,1323025,32.84,0.13
489,2021-01-10,PUG,2349,1061,1288,2038,106,202,0,2,0,0,1,0,0,2349,0,ITF,ITF4,16,Puglia,Puglia,4029053,1325374,32.9,0.06
490,2021-03-30,PUG,11832,5486,6346,1334,493,266,960,47,167,7140,998,372,55,5966,5866,ITF,ITF4,16,Puglia,Puglia,4029053,1337206,33.19,0.29
491,2020-12-30,PUG,1,0,1,1,0,0,0,0,0,0,0,0,0,1,0,ITF,ITF4,16,Puglia,Puglia,4029053,1337207,33.19,0.0
492,2021-03-25,PUG,10840,5260,5580,1270,671,154,658,22,50,7195,59,675,86,4637,6203,ITF,ITF4,16,Puglia,Puglia,4029053,1348047,33.46,0.27
493,2021-04-23,PUG,28632,13301,15331,643,241,190,103,2442,12925,4503,6990,195,400,23633,4999,ITF,ITF4,16,Puglia,Puglia,4029053,1376679,34.17,0.71
494,2021-02-07,PUG,1578,669,909,1039,227,309,1,0,2,0,0,0,0,253,1325,ITF,ITF4,16,Puglia,Puglia,4029053,1378257,34.21,0.04
495,2021-05-01,PUG,26505,12182,14323,172,154,50,25,3346,5455,3930,12995,15,363,16161,10344,ITF,ITF4,16,Puglia,Puglia,4029053,1404762,34.87,0.66
496,2021-02-28,LOM,7884,3255,4629,1106,761,76,31,594,199,4343,0,88,686,7668,216,ITC,ITC4,3,Lombardia,Lombardia,10060574,7884,0.08,0.08
497,2021-03-19,LOM,32365,12887,19478,2748,1933,1418,3009,69,115,22423,350,158,142,19183,13182,ITC,ITC4,3,Lombardia,Lombardia,10060574,40249,0.4,0.32
498,2021-02-15,LOM,8913,3119,5794,6034,1677,1071,9,12,9,29,4,31,37,8491,422,ITC,ITC4,3,Lombardia,Lombardia,10060574,49162,0.49,0.09
499,2021-02-18,LOM,14037,4926,9111,6163,1880,1593,28,13,18,3438,3,859,42,13010,1027,ITC,ITC4,3,Lombardia,Lombardia,10060574,63199,0.63,0.14
500,2021-01-08,LOM,12664,3910,8754,9964,2236,376,0,17,9,6,1,0,55,12664,0,ITC,ITC4,3,Lombardia,Lombardia,10060574,75863,0.75,0.13
501,2021-04-06,LOM,42991,17541,25450,2178,1931,685,4532,281,557,27994,4393,128,312,25038,17953,ITC,ITC4,3,Lombardia,Lombardia,10060574,118854,1.18,0.43
502,2020-12-30,LOM,114,42,72,106,7,0,0,0,0,0,0,0,1,114,0,ITC,ITC4,3,Lombardia,Lombardia,10060574,118968,1.18,0.0
503,2021-03-28,LOM,20387,7769,12618,2016,1291,115,3875,197,427,11319,1008,34,105,14240,6147,ITC,ITC4,3,Lombardia,Lombardia,10060574,139355,1.39,0.2
504,2020-12-31,LOM,713,300,413,657,56,0,0,0,0,0,0,0,0,713,0,ITC,ITC4,3,Lombardia,Lombardia,10060574,140068,1.39,0.01
505,2021-02-09,LOM,12247,3328,8919,5738,2236,4128,4,16,5,78,4,2,36,4109,8138,ITC,ITC4,3,Lombardia,Lombardia,10060574,152315,1.51,0.12
506,2021-02-21,LOM,5052,1862,3190,1766,910,57,3,2,14,2234,2,42,22,5032,20,ITC,ITC4,3,Lombardia,Lombardia,10060574,157367,1.56,0.05
507,2021-04-02,LOM,41014,16779,24235,2553,1825,1166,4639,539,2171,24628,3017,130,346,26617,14397,ITC,ITC4,3,Lombardia,Lombardia,10060574,198381,1.97,0.41
508,2021-01-12,LOM,19859,6616,13243,13439,4542,1631,0,20,13,102,2,1,109,19859,0,ITC,ITC4,3,Lombardia,Lombardia,10060574,218240,2.17,0.2
509,2021-01-01,LOM,24,7,17,24,0,0,0,0,0,0,0,0,0,24,0,ITC,ITC4,3,Lombardia,Lombardia,10060574,218264,2.17,0.0
510,2021-03-16,LOM,25473,10111,15362,3316,1463,1459,76,311,249,18138,28,17,416,16416,9057,ITC,ITC4,3,Lombardia,Lombardia,10060574,243737,2.42,0.25
511,2021-04-20,LOM,67372,30687,36685,1158,586,750,567,8883,34190,10960,9536,228,514,57078,10294,ITC,ITC4,3,Lombardia,Lombardia,10060574,311109,3.09,0.67
512,2021-01-21,LOM,5341,1569,3772,3024,1211,1025,0,8,4,7,1,0,61,4652,689,ITC,ITC4,3,Lombardia,Lombardia,10060574,316450,3.15,0.05
513,2021-03-15,LOM,31538,11315,20223,4691,2871,882,8320,273,376,13072,8,637,408,23013,8525,ITC,ITC4,3,Lombardia,Lombardia,10060574,347988,3.46,0.31
514,2021-02-19,LOM,14110,5368,8742,5570,1752,1153,16,22,42,4543,2,929,81,13425,685,ITC,ITC4,3,Lombardia,Lombardia,10060574,362098,3.6,0.14
515,2021-04-28,LOM,95045,43437,51608,1404,654,766,315,23413,28617,23061,15806,310,699,68418,26627,ITC,ITC4,3,Lombardia,Lombardia,10060574,457143,4.54,0.94
516,2021-01-22,LOM,3098,864,2234,1582,619,874,0,2,3,13,0,0,5,3028,70,ITC,ITC4,3,Lombardia,Lombardia,10060574,460241,4.57,0.03
517,2021-03-12,LOM,35239,12947,22292,5134,3225,1507,7388,184,278,16071,10,1114,328,25020,10219,ITC,ITC4,3,Lombardia,Lombardia,10060574,495480,4.92,0.35
518,2021-02-08,LOM,10076,2915,7161,5323,2251,2404,4,5,2,53,4,0,30,2138,7938,ITC,ITC4,3,Lombardia,Lombardia,10060574,505556,5.03,0.1
519,2021-04-22,LOM,73210,33097,40113,1189,704,1015,438,11020,31864,15429,10829,185,537,56968,16242,ITC,ITC4,3,Lombardia,Lombardia,10060574,578766,5.75,0.73
520,2021-03-10,LOM,33218,12723,20495,6906,3853,2102,5479,429,302,12092,9,1608,438,25366,7852,ITC,ITC4,3,Lombardia,Lombardia,10060574,611984,6.08,0.33
521,2021-03-08,LOM,29730,11167,18563,6595,2985,1160,4622,423,211,11766,10,1613,345,22658,7072,ITC,ITC4,3,Lombardia,Lombardia,10060574,641714,6.38,0.3
522,2021-04-17,LOM,47825,21007,26818,520,203,287,382,424,28575,11556,5614,124,140,37061,10764,ITC,ITC4,3,Lombardia,Lombardia,10060574,689539,6.85,0.48
523,2021-04-18,LOM,36237,16160,20077,262,115,72,142,235,25851,5663,3684,99,114,31003,5234,ITC,ITC4,3,Lombardia,Lombardia,10060574,725776,7.21,0.36
524,2021-03-17,LOM,26150,10452,15698,2533,1418,1969,44,73,108,19534,175,45,251,15233,10917,ITC,ITC4,3,Lombardia,Lombardia,10060574,751926,7.47,0.26
525,2021-02-04,LOM,27644,8069,19575,15831,5866,5659,0,11,1,199,4,7,66,1962,25682,ITC,ITC4,3,Lombardia,Lombardia,10060574,779570,7.75,0.27
526,2021-03-31,LOM,41843,16928,24915,2598,1888,1472,6196,403,1820,24078,2811,150,427,26687,15156,ITC,ITC4,3,Lombardia,Lombardia,10060574,821413,8.16,0.42
527,2021-04-21,LOM,71452,32437,39015,1051,482,722,346,10503,32405,14545,10798,178,422,56877,14575,ITC,ITC4,3,Lombardia,Lombardia,10060574,892865,8.87,0.71
528,2021-02-17,LOM,11966,3744,8222,7641,2229,1950,10,7,9,40,6,38,36,10576,1390,ITC,ITC4,3,Lombardia,Lombardia,10060574,904831,8.99,0.12
529,2020-12-27,LOM,717,413,304,615,46,14,0,13,7,1,1,0,20,717,0,ITC,ITC4,3,Lombardia,Lombardia,10060574,905548,9.0,0.01
530,2021-04-19,LOM,60072,27337,32735,1168,445,447,480,3372,34720,9984,8797,177,482,50650,9422,ITC,ITC4,3,Lombardia,Lombardia,10060574,965620,9.6,0.6
531,2021-04-24,LOM,75000,33269,41731,668,366,88,166,12519,29498,21111,9897,278,409,54176,20824,ITC,ITC4,3,Lombardia,Lombardia,10060574,1040620,10.34,0.75
532,2021-04-05,LOM,27348,11676,15672,545,572,70,703,196,325,23714,1105,28,90,19266,8082,ITC,ITC4,3,Lombardia,Lombardia,10060574,1067968,10.62,0.27
533,2021-02-01,LOM,16054,5316,10738,11676,3377,903,1,3,3,45,3,1,42,303,15751,ITC,ITC4,3,Lombardia,Lombardia,10060574,1084022,10.77,0.16
534,2021-01-31,LOM,9746,3763,5983,7577,2043,87,0,2,2,7,3,2,23,33,9713,ITC,ITC4,3,Lombardia,Lombardia,10060574,1093768,10.87,0.1
535,2021-01-28,LOM,12180,3691,8489,9192,1858,971,1,11,5,29,2,1,110,776,11404,ITC,ITC4,3,Lombardia,Lombardia,10060574,1105948,10.99,0.12
536,2021-01-03,LOM,853,316,537,744,89,4,0,0,0,1,1,0,14,853,0,ITC,ITC4,3,Lombardia,Lombardia,10060574,1106801,11.0,0.01
537,2021-01-04,LOM,6075,2097,3978,4993,736,173,0,22,4,11,0,0,136,6075,0,ITC,ITC4,3,Lombardia,Lombardia,10060574,1112876,11.06,0.06
538,2021-01-19,LOM,8101,2348,5753,4045,1772,2169,0,9,5,67,4,1,29,7626,475,ITC,ITC4,3,Lombardia,Lombardia,10060574,1120977,11.14,0.08
539,2021-02-25,LOM,15187,6296,8891,2981,1339,1294,10,39,86,8100,4,1251,83,13640,1547,ITC,ITC4,3,Lombardia,Lombardia,10060574,1136164,11.29,0.15
540,2021-02-03,LOM,25546,7897,17649,15596,5629,4081,1,17,9,144,6,8,55,1128,24418,ITC,ITC4,3,Lombardia,Lombardia,10060574,1161710,11.55,0.25
541,2021-02-14,LOM,3578,1546,2032,2750,623,42,10,5,1,3,2,0,142,2944,634,ITC,ITC4,3,Lombardia,Lombardia,10060574,1165288,11.58,0.04
542,2021-02-27,LOM,13943,5867,8076,2090,1235,568,48,208,309,8311,7,1124,43,13298,645,ITC,ITC4,3,Lombardia,Lombardia,10060574,1179231,11.72,0.14
543,2021-03-18,LOM,27416,10954,16462,2205,1209,1547,100,65,161,21448,503,50,128,16187,11229,ITC,ITC4,3,Lombardia,Lombardia,10060574,1206647,11.99,0.27
544,2021-05-03,LOM,82961,39471,43490,1731,469,282,742,31538,23705,4004,18975,284,1231,71269,11692,ITC,ITC4,3,Lombardia,Lombardia,10060574,1289608,12.82,0.82
545,2021-05-01,LOM,94713,43167,51546,683,512,72,307,28089,23941,24547,14318,336,1908,66520,28193,ITC,ITC4,3,Lombardia,Lombardia,10060574,1384321,13.76,0.94
546,2021-02-07,LOM,7208,2797,4411,5546,1315,293,5,5,2,18,0,3,21,339,6869,ITC,ITC4,3,Lombardia,Lombardia,10060574,1391529,13.83,0.07
547,2021-04-13,LOM,47803,21361,26442,947,646,701,956,537,25211,13437,4941,129,298,33728,14075,ITC,ITC4,3,Lombardia,Lombardia,10060574,1439332,14.31,0.48
548,2020-12-28,LOM,107,47,60,105,2,0,0,0,0,0,0,0,0,107,0,ITC,ITC4,3,Lombardia,Lombardia,10060574,1439439,14.31,0.0
549,2021-03-07,LOM,12001,5341,6660,3012,2099,82,707,261,333,4624,2,672,209,9441,2560,ITC,ITC4,3,Lombardia,Lombardia,10060574,1451440,14.43,0.12
550,2021-03-25,LOM,42511,15870,26641,3457,2237,1428,10845,228,768,21230,1664,318,336,29997,12514,ITC,ITC4,3,Lombardia,Lombardia,10060574,1493951,14.85,0.42
551,2021-03-30,LOM,39421,15457,23964,2777,1927,1167,6910,262,414,22335,2863,223,543,24659,14762,ITC,ITC4,3,Lombardia,Lombardia,10060574,1533372,15.24,0.39
552,2021-01-26,LOM,8338,2711,5627,6651,1337,223,0,22,4,27,0,0,74,334,8004,ITC,ITC4,3,Lombardia,Lombardia,10060574,1541710,15.32,0.08
553,2021-03-04,LOM,29384,12135,17249,7056,2496,2142,376,1623,1848,11147,6,2054,636,20251,9133,ITC,ITC4,3,Lombardia,Lombardia,10060574,1571094,15.62,0.29
554,2021-01-17,LOM,8290,3327,4963,5555,748,244,0,169,55,72,6,5,1436,8089,201,ITC,ITC4,3,Lombardia,Lombardia,10060574,1579384,15.7,0.08
555,2021-02-05,LOM,25586,7429,18157,14465,6215,4524,7,19,11,260,2,2,81,2379,23207,ITC,ITC4,3,Lombardia,Lombardia,10060574,1604970,15.95,0.25
556,2021-03-24,LOM,43258,15602,27656,2985,2447,1502,12497,413,749,20413,1264,563,425,31416,11842,ITC,ITC4,3,Lombardia,Lombardia,10060574,1648228,16.38,0.43
557,2021-04-10,LOM,51770,21467,30303,874,856,314,1465,508,2939,38614,5888,61,251,39972,11798,ITC,ITC4,3,Lombardia,Lombardia,10060574,1699998,16.9,0.51
558,2021-03-22,LOM,40259,14273,25986,2520,2361,895,12170,255,193,20475,542,533,315,29728,10531,ITC,ITC4,3,Lombardia,Lombardia,10060574,1740257,17.3,0.4
559,2021-03-23,LOM,42417,15371,27046,2254,2329,1310,12511,430,584,21315,770,405,509,29628,12789,ITC,ITC4,3,Lombardia,Lombardia,10060574,1782674,17.72,0.42
560,2021-01-24,LOM,1201,459,742,832,136,36,0,8,2,1,1,0,185,537,664,ITC,ITC4,3,Lombardia,Lombardia,10060574,1783875,17.73,0.01
561,2021-01-30,LOM,12323,4570,7753,9911,2119,161,1,18,2,8,1,1,101,170,12153,ITC,ITC4,3,Lombardia,Lombardia,10060574,1796198,17.85,0.12
562,2021-04-26,LOM,87691,40840,46851,623,363,319,383,22158,30867,18483,13671,205,619,68594,19097,ITC,ITC4,3,Lombardia,Lombardia,10060574,1883889,18.73,0.87
563,2021-04-01,LOM,42676,17117,25559,2719,2084,1277,5748,823,1629,25092,2761,135,408,26664,16012,ITC,ITC4,3,Lombardia,Lombardia,10060574,1926565,19.15,0.42
564,2021-01-05,LOM,7817,2565,5252,6271,1207,173,0,29,4,8,0,0,125,7817,0,ITC,ITC4,3,Lombardia,Lombardia,10060574,1934382,19.23,0.08
565,2021-02-22,LOM,11891,4807,7084,4235,1468,1026,28,13,22,4066,4,966,63,11581,310,ITC,ITC4,3,Lombardia,Lombardia,10060574,1946273,19.35,0.12
566,2021-01-18,LOM,9155,2968,6187,5196,1962,1852,0,16,13,54,5,2,55,8173,982,ITC,ITC4,3,Lombardia,Lombardia,10060574,1955428,19.44,0.09
567,2021-04-03,LOM,36146,14830,21316,961,963,86,2241,1004,1546,27469,1652,80,144,26080,10066,ITC,ITC4,3,Lombardia,Lombardia,10060574,1991574,19.8,0.36
568,2021-04-15,LOM,49153,21753,27400,1108,640,1067,653,278,25695,12747,6657,97,211,35352,13801,ITC,ITC4,3,Lombardia,Lombardia,10060574,2040727,20.28,0.49
569,2021-01-16,LOM,15359,5706,9653,8617,1384,1505,0,556,211,227,5,3,2851,15359,0,ITC,ITC4,3,Lombardia,Lombardia,10060574,2056086,20.44,0.15
570,2021-03-06,LOM,21313,9085,12228,4764,2181,451,1357,1898,1306,7524,7,1147,678,16799,4514,ITC,ITC4,3,Lombardia,Lombardia,10060574,2077399,20.65,0.21
571,2021-03-27,LOM,32214,12276,19938,1973,2424,323,6664,405,609,18205,1185,71,355,23607,8607,ITC,ITC4,3,Lombardia,Lombardia,10060574,2109613,20.97,0.32
572,2021-01-06,LOM,7058,2489,4569,5847,1106,38,2,24,1,0,0,0,40,7058,0,ITC,ITC4,3,Lombardia,Lombardia,10060574,2116671,21.04,0.07
573,2021-04-30,LOM,115677,54164,61513,1721,731,753,1093,32494,27448,20317,28291,449,2380,89091,26586,ITC,ITC4,3,Lombardia,Lombardia,10060574,2232348,22.19,1.15
574,2021-03-01,LOM,18775,8224,10551,2718,1182,930,29,554,321,10845,3,1656,537,17068,1707,ITC,ITC4,3,Lombardia,Lombardia,10060574,2251123,22.38,0.19
575,2021-03-20,LOM,32509,12150,20359,1991,2349,524,7861,155,140,18459,544,322,164,22656,9853,ITC,ITC4,3,Lombardia,Lombardia,10060574,2283632,22.7,0.32
576,2021-04-09,LOM,52014,22225,29789,2237,1905,1253,3038,261,2334,34004,6438,97,447,36036,15978,ITC,ITC4,3,Lombardia,Lombardia,10060574,2335646,23.22,0.52
577,2021-01-29,LOM,13438,4114,9324,10487,2325,573,0,5,3,9,1,0,35,654,12784,ITC,ITC4,3,Lombardia,Lombardia,10060574,2349084,23.35,0.13
578,2021-05-04,LOM,85028,40403,44625,1868,530,249,355,34119,21466,3879,20682,245,1635,71620,13408,ITC,ITC4,3,Lombardia,Lombardia,10060574,2434112,24.19,0.85
579,2021-02-24,LOM,14667,5923,8744,3594,1500,1787,24,36,44,6321,0,1203,158,13742,925,ITC,ITC4,3,Lombardia,Lombardia,10060574,2448779,24.34,0.15
580,2021-02-16,LOM,9539,3085,6454,5848,2209,1395,19,13,4,10,7,8,26,9084,455,ITC,ITC4,3,Lombardia,Lombardia,10060574,2458318,24.44,0.09
581,2021-01-09,LOM,12409,4572,7837,9526,2122,196,0,60,12,6,0,1,486,12409,0,ITC,ITC4,3,Lombardia,Lombardia,10060574,2470727,24.56,0.12
582,2021-01-07,LOM,11713,3622,8091,8963,1794,786,1,14,8,34,2,1,110,11713,0,ITC,ITC4,3,Lombardia,Lombardia,10060574,2482440,24.67,0.12
583,2021-03-29,LOM,39973,15499,24474,2996,2154,455,8608,221,471,21720,2708,209,431,25171,14802,ITC,ITC4,3,Lombardia,Lombardia,10060574,2522413,25.07,0.4
584,2021-02-20,LOM,9431,3895,5536,4299,1020,225,4,24,37,2919,2,864,37,9131,300,ITC,ITC4,3,Lombardia,Lombardia,10060574,2531844,25.17,0.09
585,2021-04-11,LOM,32115,13914,18201,967,543,437,1215,227,712,23130,4011,795,78,24719,7396,ITC,ITC4,3,Lombardia,Lombardia,10060574,2563959,25.49,0.32
586,2021-03-21,LOM,23577,8551,15026,1086,1632,441,9133,114,207,9738,198,756,272,18304,5273,ITC,ITC4,3,Lombardia,Lombardia,10060574,2587536,25.72,0.23
587,2021-04-04,LOM,7616,3231,4385,204,263,68,206,199,347,5879,361,9,80,3718,3898,ITC,ITC4,3,Lombardia,Lombardia,10060574,2595152,25.8,0.08
588,2020-12-29,LOM,104,44,60,103,1,0,0,0,0,0,0,0,0,104,0,ITC,ITC4,3,Lombardia,Lombardia,10060574,2595256,25.8,0.0
589,2021-03-05,LOM,28979,11943,17036,7241,3081,1556,424,1294,2142,11074,15,1980,172,20573,8406,ITC,ITC4,3,Lombardia,Lombardia,10060574,2624235,26.08,0.29
590,2021-02-26,LOM,18354,7549,10805,3331,1716,1183,24,66,40,10579,7,1339,69,16506,1848,ITC,ITC4,3,Lombardia,Lombardia,10060574,2642589,26.27,0.18
591,2021-03-26,LOM,41097,15589,25508,2730,2218,834,8659,250,552,22708,2458,256,432,28083,13014,ITC,ITC4,3,Lombardia,Lombardia,10060574,2683686,26.68,0.41
592,2021-02-23,LOM,11772,4791,6981,3960,1411,877,3,20,31,4312,1,991,166,11462,310,ITC,ITC4,3,Lombardia,Lombardia,10060574,2695458,26.79,0.12
593,2021-01-13,LOM,26215,8008,18207,15797,5796,4193,1,28,14,197,4,3,182,26215,0,ITC,ITC4,3,Lombardia,Lombardia,10060574,2721673,27.05,0.26
594,2021-04-25,LOM,51186,23502,27684,422,143,12,287,10015,26864,4688,8311,154,290,46694,4492,ITC,ITC4,3,Lombardia,Lombardia,10060574,2772859,27.56,0.51
595,2021-03-14,LOM,14875,5348,9527,1520,1746,80,5450,99,117,5274,2,413,174,11587,3288,ITC,ITC4,3,Lombardia,Lombardia,10060574,2787734,27.71,0.15
596,2021-02-10,LOM,14390,4503,9887,8534,2364,3336,6,25,17,79,1,3,25,7569,6821,ITC,ITC4,3,Lombardia,Lombardia,10060574,2802124,27.85,0.14
597,2021-04-23,LOM,73235,33227,40008,1402,607,710,348,12267,30456,15310,11431,237,467,56769,16466,ITC,ITC4,3,Lombardia,Lombardia,10060574,2875359,28.58,0.73
598,2021-04-14,LOM,46947,20955,25992,924,742,670,786,293,24949,12371,5916,86,210,34022,12925,ITC,ITC4,3,Lombardia,Lombardia,10060574,2922306,29.05,0.47
599,2021-04-27,LOM,85447,39800,45647,1092,457,288,356,22991,29379,14508,15465,308,603,69022,16425,ITC,ITC4,3,Lombardia,Lombardia,10060574,3007753,29.9,0.85
600,2021-01-10,LOM,10518,3957,6561,8175,2197,85,1,4,1,12,5,2,36,10518,0,ITC,ITC4,3,Lombardia,Lombardia,10060574,3018271,30.0,0.1
601,2021-03-03,LOM,26900,11488,15412,6403,1783,1799,471,1269,1900,10199,11,2030,1035,19627,7273,ITC,ITC4,3,Lombardia,Lombardia,10060574,3045171,30.27,0.27
602,2021-01-25,LOM,7024,2372,4652,5632,941,218,0,26,3,15,0,0,189,488,6536,ITC,ITC4,3,Lombardia,Lombardia,10060574,3052195,30.34,0.07
603,2021-02-12,LOM,13946,4355,9591,8116,2724,2957,3,7,8,102,3,5,21,9028,4918,ITC,ITC4,3,Lombardia,Lombardia,10060574,3066141,30.48,0.14
604,2021-01-27,LOM,8044,2677,5367,6204,1338,434,2,22,3,1,0,0,40,820,7224,ITC,ITC4,3,Lombardia,Lombardia,10060574,3074185,30.56,0.08
605,2021-03-09,LOM,33232,12845,20387,6078,4095,2389,5482,434,352,12532,10,1464,396,25797,7435,ITC,ITC4,3,Lombardia,Lombardia,10060574,3107417,30.89,0.33
606,2021-02-06,LOM,15250,5527,9723,9855,3034,1896,3,42,13,75,2,1,329,1063,14187,ITC,ITC4,3,Lombardia,Lombardia,10060574,3122667,31.04,0.15
607,2021-02-13,LOM,6414,2441,3973,4178,1466,709,4,7,6,17,3,4,20,4937,1477,ITC,ITC4,3,Lombardia,Lombardia,10060574,3129081,31.1,0.06
608,2021-04-16,LOM,53479,23855,29624,1739,723,1019,458,385,28432,13427,6976,113,207,39174,14305,ITC,ITC4,3,Lombardia,Lombardia,10060574,3182560,31.63,0.53
609,2021-04-12,LOM,47156,20546,26610,1147,902,504,1677,312,24481,13780,4079,76,198,32840,14316,ITC,ITC4,3,Lombardia,Lombardia,10060574,3229716,32.1,0.47
610,2021-01-02,LOM,199,72,127,178,16,0,0,1,0,0,0,0,4,199,0,ITC,ITC4,3,Lombardia,Lombardia,10060574,3229915,32.1,0.0
611,2021-02-02,LOM,19845,6582,13263,13499,4508,1684,1,6,4,76,0,7,60,489,19356,ITC,ITC4,3,Lombardia,Lombardia,10060574,3249760,32.3,0.2
612,2021-01-20,LOM,5579,1364,4215,2743,1176,1558,0,14,6,61,0,0,21,5464,115,ITC,ITC4,3,Lombardia,Lombardia,10060574,3255339,32.36,0.06
613,2021-05-02,LOM,83263,38245,45018,775,367,33,466,23642,19755,18449,17762,288,1726,61001,22262,ITC,ITC4,3,Lombardia,Lombardia,10060574,3338602,33.19,0.83
614,2021-01-15,LOM,25134,7419,17715,13799,5912,4737,9,54,24,316,3,2,278,25134,0,ITC,ITC4,3,Lombardia,Lombardia,10060574,3363736,33.43,0.25
615,2021-03-11,LOM,36190,13459,22731,5875,3535,2192,6670,225,298,15633,9,1295,458,26278,9912,ITC,ITC4,3,Lombardia,Lombardia,10060574,3399926,33.79,0.36
616,2021-01-11,LOM,16035,5329,10706,11823,3366,701,2,9,5,44,1,1,83,16035,0,ITC,ITC4,3,Lombardia,Lombardia,10060574,3415961,33.95,0.16
617,2021-03-02,LOM,22812,9691,13121,3193,1452,2200,130,1113,378,11264,8,1843,1231,19778,3034,ITC,ITC4,3,Lombardia,Lombardia,10060574,3438773,34.18,0.23
618,2021-04-07,LOM,50450,20851,29599,1740,1437,1187,2473,280,1911,36781,4198,69,374,34664,15786,ITC,ITC4,3,Lombardia,Lombardia,10060574,3489223,34.68,0.5
619,2021-01-23,LOM,1114,357,757,644,259,138,0,8,6,1,0,0,58,916,198,ITC,ITC4,3,Lombardia,Lombardia,10060574,3490337,34.69,0.01
620,2021-04-08,LOM,52086,21667,30419,2248,1365,918,1565,286,2251,37452,5439,69,493,35605,16481,ITC,ITC4,3,Lombardia,Lombardia,10060574,3542423,35.21,0.52
621,2021-02-11,LOM,17042,5002,12040,9764,3335,3872,6,3,2,33,1,4,22,9696,7346,ITC,ITC4,3,Lombardia,Lombardia,10060574,3559465,35.38,0.17
622,2021-04-29,LOM,114285,53185,61100,2078,742,618,407,30905,28497,24138,24556,305,2039,85016,29269,ITC,ITC4,3,Lombardia,Lombardia,10060574,3673750,36.52,1.14
623,2021-01-14,LOM,26727,7770,18957,15204,5577,5458,2,34,14,249,3,1,185,26727,0,ITC,ITC4,3,Lombardia,Lombardia,10060574,3700477,36.78,0.27
624,2021-03-13,LOM,27117,9753,17364,3751,2789,264,8141,222,681,10340,15,639,275,21053,6064,ITC,ITC4,3,Lombardia,Lombardia,10060574,3727594,37.05,0.27
625,2021-01-04,TOS,5065,1894,3171,4100,29,933,0,0,0,0,0,0,3,5065,0,ITI,ITI1,9,Toscana,Toscana,3729641,5065,0.14,0.14
626,2021-03-11,TOS,15486,5989,9497,2440,907,270,12,0,7,10323,1293,217,17,12167,3319,ITI,ITI1,9,Toscana,Toscana,3729641,20551,0.55,0.42
627,2021-03-03,TOS,18139,6469,11670,3324,1083,135,3446,3,0,9183,1,954,10,14533,3606,ITI,ITI1,9,Toscana,Toscana,3729641,38690,1.04,0.49
628,2021-02-20,TOS,4641,1790,2851,3350,1038,203,18,0,0,17,0,15,0,4128,513,ITI,ITI1,9,Toscana,Toscana,3729641,43331,1.16,0.12
629,2021-01-19,TOS,1104,531,573,392,220,491,0,0,0,0,0,0,1,1104,0,ITI,ITI1,9,Toscana,Toscana,3729641,44435,1.19,0.03
630,2021-03-18,TOS,9966,3979,5987,438,562,280,3,2,3,7794,871,7,6,6004,3962,ITI,ITI1,9,Toscana,Toscana,3729641,54401,1.46,0.27
631,2021-04-25,TOS,11041,5244,5797,242,101,61,15,32,6267,389,3923,5,6,8904,2137,ITI,ITI1,9,Toscana,Toscana,3729641,65442,1.75,0.3
632,2021-02-13,TOS,7785,2360,5425,3667,574,163,2,0,2,0,0,186,3191,7558,227,ITI,ITI1,9,Toscana,Toscana,3729641,73227,1.96,0.21
633,2021-04-05,TOS,15278,6823,8455,27,52,0,35,12,13541,256,1328,4,23,14541,737,ITI,ITI1,9,Toscana,Toscana,3729641,88505,2.37,0.41
634,2021-04-23,TOS,25535,11375,14160,345,245,112,6,167,486,16473,7540,13,148,9244,16291,ITI,ITI1,9,Toscana,Toscana,3729641,114040,3.06,0.68
635,2021-02-01,TOS,5508,1958,3550,4485,403,616,0,0,0,0,0,0,4,520,4988,ITI,ITI1,9,Toscana,Toscana,3729641,119548,3.21,0.15
636,2021-02-25,TOS,10632,4304,6328,1078,1634,259,3199,0,1,3232,5,1220,4,9634,998,ITI,ITI1,9,Toscana,Toscana,3729641,130180,3.49,0.29
637,2021-01-03,TOS,3335,1051,2284,2564,9,762,0,0,0,0,0,0,0,3335,0,ITI,ITI1,9,Toscana,Toscana,3729641,133515,3.58,0.09
638,2021-02-06,TOS,4527,1550,2977,3725,574,227,0,0,0,0,0,0,1,1294,3233,ITI,ITI1,9,Toscana,Toscana,3729641,138042,3.7,0.12
639,2021-01-22,TOS,2866,1064,1802,2026,81,758,0,0,0,0,1,0,0,528,2338,ITI,ITI1,9,Toscana,Toscana,3729641,140908,3.78,0.08
640,2021-02-12,TOS,7606,2683,4923,3742,380,188,0,0,1,3,0,402,2890,7393,213,ITI,ITI1,9,Toscana,Toscana,3729641,148514,3.98,0.2
641,2021-04-17,TOS,20482,9183,11299,598,388,83,1,22,7391,5918,6051,8,22,18362,2120,ITI,ITI1,9,Toscana,Toscana,3729641,168996,4.53,0.55
642,2021-03-08,TOS,6346,2610,3736,4063,747,191,8,0,0,66,965,304,2,1527,4819,ITI,ITI1,9,Toscana,Toscana,3729641,175342,4.7,0.17
643,2021-04-13,TOS,8493,3505,4988,251,462,266,5,35,54,5557,1821,30,12,6034,2459,ITI,ITI1,9,Toscana,Toscana,3729641,183835,4.93,0.23
644,2021-02-26,TOS,10074,3831,6243,1556,1653,298,3562,0,0,1816,2,1187,0,8868,1206,ITI,ITI1,9,Toscana,Toscana,3729641,193909,5.2,0.27
645,2021-04-22,TOS,35614,15242,20372,317,499,139,6,123,7342,20430,6620,15,123,18215,17399,ITI,ITI1,9,Toscana,Toscana,3729641,229523,6.15,0.95
646,2021-05-02,TOS,11048,4875,6173,38,21,2,2,56,6820,1636,2435,12,26,9183,1865,ITI,ITI1,9,Toscana,Toscana,3729641,240571,6.45,0.3
647,2021-02-03,TOS,4221,1452,2769,3475,239,505,0,0,0,1,0,0,1,241,3980,ITI,ITI1,9,Toscana,Toscana,3729641,244792,6.56,0.11
648,2021-04-16,TOS,28874,12850,16024,521,522,92,2,65,6606,15175,5819,22,50,21981,6893,ITI,ITI1,9,Toscana,Toscana,3729641,273666,7.34,0.77
649,2021-01-23,TOS,3949,1354,2595,2936,170,841,0,0,0,0,0,0,2,640,3309,ITI,ITI1,9,Toscana,Toscana,3729641,277615,7.44,0.11
650,2021-03-22,TOS,4881,2443,2438,221,367,380,314,27,2418,474,466,139,75,4438,443,ITI,ITI1,9,Toscana,Toscana,3729641,282496,7.57,0.13
651,2021-04-08,TOS,29646,12525,17121,264,319,206,5,63,1784,23694,3234,17,60,23272,6374,ITI,ITI1,9,Toscana,Toscana,3729641,312142,8.37,0.79
652,2021-03-30,TOS,16811,7464,9347,212,151,250,113,13,4545,8532,2736,212,47,13248,3563,ITI,ITI1,9,Toscana,Toscana,3729641,328953,8.82,0.45
653,2021-01-24,TOS,3349,1073,2276,2602,35,709,0,0,0,1,0,0,2,201,3148,ITI,ITI1,9,Toscana,Toscana,3729641,332302,8.91,0.09
654,2021-03-25,TOS,23575,10108,13467,225,313,406,711,46,2777,16113,2662,247,75,15252,8323,ITI,ITI1,9,Toscana,Toscana,3729641,355877,9.54,0.63
655,2021-03-02,TOS,10588,3789,6799,3171,986,154,3512,0,0,1851,0,910,4,7144,3444,ITI,ITI1,9,Toscana,Toscana,3729641,366465,9.83,0.28
656,2021-01-14,TOS,3254,1179,2075,2459,475,320,0,0,0,0,0,0,0,3254,0,ITI,ITI1,9,Toscana,Toscana,3729641,369719,9.91,0.09
657,2021-04-19,TOS,9084,4500,4584,636,245,74,7,24,378,509,7206,2,3,8057,1027,ITI,ITI1,9,Toscana,Toscana,3729641,378803,10.16,0.24
658,2021-02-15,TOS,8768,3374,5394,4536,922,216,1138,0,0,56,0,801,1099,7943,825,ITI,ITI1,9,Toscana,Toscana,3729641,387571,10.39,0.24
659,2021-03-19,TOS,10137,4457,5680,641,442,303,35,22,2644,5284,712,13,41,7275,2862,ITI,ITI1,9,Toscana,Toscana,3729641,397708,10.66,0.27
660,2021-03-04,TOS,17529,6679,10850,2816,953,274,3694,2,8,8236,597,945,4,14447,3082,ITI,ITI1,9,Toscana,Toscana,3729641,415237,11.13,0.47
661,2021-01-17,TOS,2535,871,1664,2002,293,240,0,0,0,0,0,0,0,2022,513,ITI,ITI1,9,Toscana,Toscana,3729641,417772,11.2,0.07
662,2021-04-26,TOS,10098,4919,5179,117,272,72,4,47,4250,198,5090,7,41,7567,2531,ITI,ITI1,9,Toscana,Toscana,3729641,427870,11.47,0.27
663,2021-04-14,TOS,20078,8293,11785,398,406,122,1,34,146,16631,2289,10,41,14988,5090,ITI,ITI1,9,Toscana,Toscana,3729641,447948,12.01,0.54
664,2021-04-29,TOS,39233,17650,21583,303,327,150,14,97,13129,19426,5705,16,66,19209,20024,ITI,ITI1,9,Toscana,Toscana,3729641,487181,13.06,1.05
665,2021-03-28,TOS,6198,2800,3398,37,26,145,89,22,2401,893,2545,22,18,5944,254,ITI,ITI1,9,Toscana,Toscana,3729641,493379,13.23,0.17
666,2021-04-02,TOS,31910,13514,18396,297,65,370,6,15,8606,19829,2555,117,50,23893,8017,ITI,ITI1,9,Toscana,Toscana,3729641,525289,14.08,0.86
667,2021-04-03,TOS,15010,6643,8367,101,64,99,13,16,6586,4914,3181,10,26,13883,1127,ITI,ITI1,9,Toscana,Toscana,3729641,540299,14.49,0.4
668,2021-02-18,TOS,8817,3285,5532,2924,1447,230,3142,0,0,214,0,860,0,7923,894,ITI,ITI1,9,Toscana,Toscana,3729641,549116,14.72,0.24
669,2021-03-15,TOS,8312,3309,5003,3214,1609,404,2281,0,2,36,325,438,3,3870,4442,ITI,ITI1,9,Toscana,Toscana,3729641,557428,14.95,0.22
670,2021-01-15,TOS,3878,1347,2531,2758,674,444,0,0,0,0,0,0,2,3878,0,ITI,ITI1,9,Toscana,Toscana,3729641,561306,15.05,0.1
671,2021-05-04,TOS,16994,7686,9308,355,417,58,10,112,3709,2922,9247,75,89,12569,4425,ITI,ITI1,9,Toscana,Toscana,3729641,578300,15.51,0.46
672,2021-01-21,TOS,1589,686,903,579,220,790,0,0,0,0,0,0,0,867,722,ITI,ITI1,9,Toscana,Toscana,3729641,579889,15.55,0.04
673,2021-03-27,TOS,8824,4122,4702,113,71,243,198,17,3197,2074,2840,51,20,8609,215,ITI,ITI1,9,Toscana,Toscana,3729641,588713,15.78,0.24
674,2021-03-20,TOS,6489,2882,3607,914,563,165,34,4,3576,773,423,27,10,5354,1135,ITI,ITI1,9,Toscana,Toscana,3729641,595202,15.96,0.17
675,2021-02-17,TOS,8173,3168,5005,3464,1122,249,2485,0,0,218,0,635,0,7422,751,ITI,ITI1,9,Toscana,Toscana,3729641,603375,16.18,0.22
676,2021-04-09,TOS,24501,10533,13968,241,121,220,3,42,94,20290,3435,17,38,21103,3398,ITI,ITI1,9,Toscana,Toscana,3729641,627876,16.83,0.66
677,2021-02-23,TOS,7720,3324,4396,1490,1512,204,2831,0,0,510,1,1170,2,7559,161,ITI,ITI1,9,Toscana,Toscana,3729641,635596,17.04,0.21
678,2021-02-24,TOS,10371,4466,5905,81,1513,301,2947,0,0,4142,0,1382,5,10170,201,ITI,ITI1,9,Toscana,Toscana,3729641,645967,17.32,0.28
679,2021-03-07,TOS,5647,2356,3291,3103,642,123,774,0,0,15,417,573,0,2105,3542,ITI,ITI1,9,Toscana,Toscana,3729641,651614,17.47,0.15
680,2021-01-13,TOS,4062,1398,2664,3308,348,404,0,0,0,0,0,0,2,4062,0,ITI,ITI1,9,Toscana,Toscana,3729641,655676,17.58,0.11
681,2021-02-16,TOS,9278,3339,5939,5084,952,188,2323,0,0,10,0,720,1,8557,721,ITI,ITI1,9,Toscana,Toscana,3729641,664954,17.83,0.25
682,2021-04-04,TOS,13908,6600,7308,17,20,1,52,14,12885,171,723,5,20,13655,253,ITI,ITI1,9,Toscana,Toscana,3729641,678862,18.2,0.37
683,2021-03-01,TOS,4422,1699,2723,3192,597,137,25,0,0,9,1,459,2,782,3640,ITI,ITI1,9,Toscana,Toscana,3729641,683284,18.32,0.12
684,2021-04-18,TOS,8321,4077,4244,426,217,68,2,25,678,1412,5462,4,27,7325,996,ITI,ITI1,9,Toscana,Toscana,3729641,691605,18.54,0.22
685,2021-01-07,TOS,6018,1751,4267,5308,29,680,0,0,0,0,0,0,1,6018,0,ITI,ITI1,9,Toscana,Toscana,3729641,697623,18.7,0.16
686,2021-03-31,TOS,32542,13120,19422,278,111,269,3699,64,2643,23389,1484,451,154,20404,12138,ITI,ITI1,9,Toscana,Toscana,3729641,730165,19.58,0.87
687,2021-01-09,TOS,4485,1596,2889,3780,143,560,0,0,0,1,0,0,1,4485,0,ITI,ITI1,9,Toscana,Toscana,3729641,734650,19.7,0.12
688,2021-02-28,TOS,1649,667,982,1111,202,78,9,0,0,0,0,249,0,922,727,ITI,ITI1,9,Toscana,Toscana,3729641,736299,19.74,0.04
689,2021-04-24,TOS,13176,6037,7139,123,129,84,4,77,308,6584,5793,2,72,5779,7397,ITI,ITI1,9,Toscana,Toscana,3729641,749475,20.1,0.35
690,2021-01-31,TOS,3049,1129,1920,2465,133,448,0,0,0,1,0,0,2,106,2943,ITI,ITI1,9,Toscana,Toscana,3729641,752524,20.18,0.08
691,2021-04-01,TOS,26871,11088,15783,248,111,303,6,5,30,24561,1401,157,49,16272,10599,ITI,ITI1,9,Toscana,Toscana,3729641,779395,20.9,0.72
692,2021-02-21,TOS,5105,2089,3016,3666,1220,195,9,0,0,2,0,13,0,4935,170,ITI,ITI1,9,Toscana,Toscana,3729641,784500,21.03,0.14
693,2021-01-16,TOS,3271,1046,2225,2493,538,240,0,0,0,0,0,0,0,3271,0,ITI,ITI1,9,Toscana,Toscana,3729641,787771,21.12,0.09
694,2021-02-04,TOS,4253,1594,2659,3168,623,456,0,0,0,5,0,0,1,961,3292,ITI,ITI1,9,Toscana,Toscana,3729641,792024,21.24,0.11
695,2021-03-26,TOS,20377,9146,11231,250,326,213,333,27,3492,11882,3664,145,45,14635,5742,ITI,ITI1,9,Toscana,Toscana,3729641,812401,21.78,0.55
696,2021-04-06,TOS,22144,9760,12384,805,400,136,1626,125,10038,5662,2912,165,275,18432,3712,ITI,ITI1,9,Toscana,Toscana,3729641,834545,22.38,0.59
697,2021-01-10,TOS,3001,1104,1897,2432,134,431,0,1,0,0,0,0,3,3001,0,ITI,ITI1,9,Toscana,Toscana,3729641,837546,22.46,0.08
698,2021-01-20,TOS,1331,637,694,435,255,640,0,0,0,0,0,0,1,1083,248,ITI,ITI1,9,Toscana,Toscana,3729641,838877,22.49,0.04
699,2021-01-28,TOS,6282,1883,4399,5427,64,788,0,0,0,1,0,0,2,354,5928,ITI,ITI1,9,Toscana,Toscana,3729641,845159,22.66,0.17
700,2021-04-07,TOS,35586,15276,20310,310,594,98,20,57,11343,19883,3095,64,122,28352,7234,ITI,ITI1,9,Toscana,Toscana,3729641,880745,23.61,0.95
701,2021-01-11,TOS,5094,1691,3403,4362,209,522,0,0,0,0,0,0,1,5094,0,ITI,ITI1,9,Toscana,Toscana,3729641,885839,23.75,0.14
702,2021-04-12,TOS,2608,1181,1427,168,440,225,6,4,13,382,1364,4,2,1955,653,ITI,ITI1,9,Toscana,Toscana,3729641,888447,23.82,0.07
703,2021-01-25,TOS,5126,1896,3230,4160,54,909,0,0,0,1,0,0,2,249,4877,ITI,ITI1,9,Toscana,Toscana,3729641,893573,23.96,0.14
704,2021-04-11,TOS,3634,1675,1959,62,87,98,4,7,67,1666,1639,0,4,3479,155,ITI,ITI1,9,Toscana,Toscana,3729641,897207,24.06,0.1
705,2021-03-09,TOS,10590,4091,6499,4806,907,180,11,2,3,3301,1163,214,3,5038,5552,ITI,ITI1,9,Toscana,Toscana,3729641,907797,24.34,0.28
706,2021-02-27,TOS,1944,723,1221,1352,311,132,19,0,0,1,0,128,1,1042,902,ITI,ITI1,9,Toscana,Toscana,3729641,909741,24.39,0.05
707,2021-01-02,TOS,3497,1096,2401,2681,15,801,0,0,0,0,0,0,0,3497,0,ITI,ITI1,9,Toscana,Toscana,3729641,913238,24.49,0.09
708,2021-05-03,TOS,11818,5468,6350,158,96,41,3,142,3856,621,6843,7,51,10587,1231,ITI,ITI1,9,Toscana,Toscana,3729641,925056,24.8,0.32
709,2021-05-01,TOS,23095,9972,13123,75,169,82,2,109,10224,7379,5007,8,40,14050,9045,ITI,ITI1,9,Toscana,Toscana,3729641,948151,25.42,0.62
710,2021-03-24,TOS,19619,7952,11667,222,385,195,773,51,2845,13974,872,224,78,10167,9452,ITI,ITI1,9,Toscana,Toscana,3729641,967770,25.95,0.53
711,2021-03-23,TOS,9064,4088,4976,310,312,328,338,52,2819,4030,659,148,68,6816,2248,ITI,ITI1,9,Toscana,Toscana,3729641,976834,26.19,0.24
712,2021-02-05,TOS,5749,2245,3504,4122,1180,442,0,0,0,1,0,0,4,1924,3825,ITI,ITI1,9,Toscana,Toscana,3729641,982583,26.35,0.15
713,2021-02-02,TOS,3742,1475,2267,3021,283,422,0,0,0,6,0,6,4,195,3547,ITI,ITI1,9,Toscana,Toscana,3729641,986325,26.45,0.1
714,2021-02-11,TOS,5383,2021,3362,2809,284,323,11,0,0,12,0,10,1934,5141,242,ITI,ITI1,9,Toscana,Toscana,3729641,991708,26.59,0.14
715,2021-04-10,TOS,11719,5349,6370,290,195,117,3,26,79,8131,2850,10,18,10973,746,ITI,ITI1,9,Toscana,Toscana,3729641,1003427,26.9,0.31
716,2021-03-13,TOS,9274,3300,5974,2835,1697,68,3740,0,2,178,384,369,1,5312,3962,ITI,ITI1,9,Toscana,Toscana,3729641,1012701,27.15,0.25
717,2021-01-18,TOS,1119,636,483,430,313,375,0,0,0,0,0,0,1,1021,98,ITI,ITI1,9,Toscana,Toscana,3729641,1013820,27.18,0.03
718,2021-02-10,TOS,4263,1281,2982,3535,239,485,0,1,1,1,0,1,0,3740,523,ITI,ITI1,9,Toscana,Toscana,3729641,1018083,27.3,0.11
719,2021-01-27,TOS,4834,1572,3262,4018,73,742,0,0,0,0,0,0,1,207,4627,ITI,ITI1,9,Toscana,Toscana,3729641,1022917,27.43,0.13
720,2021-02-22,TOS,9818,4254,5564,3483,2235,316,2703,0,0,22,0,1058,1,9541,277,ITI,ITI1,9,Toscana,Toscana,3729641,1032735,27.69,0.26
721,2021-04-15,TOS,24317,10163,14154,358,300,174,6,37,148,20254,2980,11,49,15800,8517,ITI,ITI1,9,Toscana,Toscana,3729641,1057052,28.34,0.65
722,2021-01-06,TOS,4519,1459,3060,3984,9,525,0,0,0,0,0,0,1,4519,0,ITI,ITI1,9,Toscana,Toscana,3729641,1061571,28.46,0.12
723,2021-03-29,TOS,9377,4579,4798,227,140,244,200,15,4855,774,2709,197,16,9053,324,ITI,ITI1,9,Toscana,Toscana,3729641,1070948,28.71,0.25
724,2021-02-07,TOS,2806,953,1853,2349,299,157,0,0,0,0,0,0,1,885,1921,ITI,ITI1,9,Toscana,Toscana,3729641,1073754,28.79,0.08
725,2021-01-01,TOS,2369,787,1582,1715,2,650,0,0,0,2,0,0,0,2369,0,ITI,ITI1,9,Toscana,Toscana,3729641,1076123,28.85,0.06
726,2021-01-08,TOS,5945,1642,4303,5361,36,545,0,0,0,0,0,0,3,5945,0,ITI,ITI1,9,Toscana,Toscana,3729641,1082068,29.01,0.16
727,2021-03-05,TOS,16467,6319,10148,3922,1684,170,3871,0,2,5297,656,861,4,11726,4741,ITI,ITI1,9,Toscana,Toscana,3729641,1098535,29.45,0.44
728,2021-01-05,TOS,5249,1755,3494,4354,15,878,0,0,0,0,0,0,2,5249,0,ITI,ITI1,9,Toscana,Toscana,3729641,1103784,29.59,0.14
729,2021-01-12,TOS,3581,1398,2183,2944,282,354,0,0,0,0,0,0,1,3581,0,ITI,ITI1,9,Toscana,Toscana,3729641,1107365,29.69,0.1
730,2021-02-08,TOS,4097,1360,2737,3373,343,377,0,0,0,2,0,0,2,3638,459,ITI,ITI1,9,Toscana,Toscana,3729641,1111462,29.8,0.11
731,2021-01-30,TOS,4622,1622,3000,3765,218,638,0,0,0,0,0,0,1,198,4424,ITI,ITI1,9,Toscana,Toscana,3729641,1116084,29.92,0.12
732,2021-04-20,TOS,18134,8098,10036,225,295,70,3,36,7071,6513,3896,3,22,12572,5562,ITI,ITI1,9,Toscana,Toscana,3729641,1134218,30.41,0.49
733,2021-01-29,TOS,6136,1698,4438,5375,138,622,0,0,0,0,0,0,1,302,5834,ITI,ITI1,9,Toscana,Toscana,3729641,1140354,30.58,0.16
734,2021-03-12,TOS,16509,6217,10292,2612,1587,303,3922,3,4,7033,303,728,14,12981,3528,ITI,ITI1,9,Toscana,Toscana,3729641,1156863,31.02,0.44
735,2021-03-21,TOS,3232,1574,1658,660,796,77,12,0,1245,274,160,6,2,1799,1433,ITI,ITI1,9,Toscana,Toscana,3729641,1160095,31.1,0.09
736,2021-04-28,TOS,19066,8169,10897,413,362,19,6,56,159,14013,3922,30,86,3815,15251,ITI,ITI1,9,Toscana,Toscana,3729641,1179161,31.62,0.51
737,2021-03-10,TOS,17977,7046,10931,3006,851,271,14,3,3,12284,1317,217,11,13960,4017,ITI,ITI1,9,Toscana,Toscana,3729641,1197138,32.1,0.48
738,2021-02-19,TOS,8286,2947,5339,2967,1207,245,3105,0,0,154,1,605,2,7779,507,ITI,ITI1,9,Toscana,Toscana,3729641,1205424,32.32,0.22
739,2020-12-27,TOS,620,267,353,460,10,13,0,23,4,5,0,0,105,620,0,ITI,ITI1,9,Toscana,Toscana,3729641,1206044,32.34,0.02
740,2020-12-30,TOS,327,104,223,34,10,283,0,0,0,0,0,0,0,327,0,ITI,ITI1,9,Toscana,Toscana,3729641,1206371,32.35,0.01
741,2021-03-16,TOS,4899,1881,3018,1551,427,124,16,1,5,2116,643,13,3,2656,2243,ITI,ITI1,9,Toscana,Toscana,3729641,1211270,32.48,0.13
742,2021-03-06,TOS,7095,2838,4257,3803,657,145,1146,0,2,30,918,394,0,2904,4191,ITI,ITI1,9,Toscana,Toscana,3729641,1218365,32.67,0.19
743,2021-04-30,TOS,39577,17494,22083,280,98,162,2,114,13546,17911,7319,36,109,19958,19619,ITI,ITI1,9,Toscana,Toscana,3729641,1257942,33.73,1.06
744,2021-04-21,TOS,29539,12636,16903,297,283,76,2,131,7378,16771,4467,16,118,17454,12085,ITI,ITI1,9,Toscana,Toscana,3729641,1287481,34.52,0.79
745,2021-03-14,TOS,7207,2574,4633,3104,1195,122,2476,0,1,44,26,239,0,3272,3935,ITI,ITI1,9,Toscana,Toscana,3729641,1294688,34.71,0.19
746,2021-02-09,TOS,4488,1468,3020,3582,386,514,0,0,0,4,0,0,2,3877,611,ITI,ITI1,9,Toscana,Toscana,3729641,1299176,34.83,0.12
747,2021-03-17,TOS,11415,4584,6831,364,327,189,2,5,8,9766,740,2,12,6887,4528,ITI,ITI1,9,Toscana,Toscana,3729641,1310591,35.14,0.31
748,2021-02-14,TOS,8996,2567,6429,3033,549,81,8,2,1,0,0,261,5061,8886,110,ITI,ITI1,9,Toscana,Toscana,3729641,1319587,35.38,0.24
749,2021-04-27,TOS,10306,4893,5413,332,346,39,1,47,347,3952,5199,2,41,3852,6454,ITI,ITI1,9,Toscana,Toscana,3729641,1329893,35.66,0.28
750,2021-01-26,TOS,5393,1792,3601,4358,81,951,0,0,0,0,0,0,3,220,5173,ITI,ITI1,9,Toscana,Toscana,3729641,1335286,35.8,0.14
751,2020-12-31,TOS,805,202,603,97,10,698,0,0,0,0,0,0,0,805,0,ITI,ITI1,9,Toscana,Toscana,3729641,1336091,35.82,0.02
752,2021-05-03,PAB,1828,846,982,21,8,0,1,313,1166,72,230,4,13,417,1411,ITH,ITH1,4,Provincia Autonoma Bolzano / Bozen,P.A. Bolzano,533050,1828,0.34,0.34
753,2021-01-07,PAB,917,327,590,617,107,0,0,25,16,61,0,0,91,917,0,ITH,ITH1,4,Provincia Autonoma Bolzano / Bozen,P.A. Bolzano,533050,2745,0.51,0.17
754,2021-04-23,PAB,4539,2148,2391,230,109,22,15,1791,718,489,1114,27,24,3248,1291,ITH,ITH1,4,Provincia Autonoma Bolzano / Bozen,P.A. Bolzano,533050,7284,1.37,0.85
755,2021-01-04,PAB,508,201,307,420,49,4,0,6,6,0,0,0,23,508,0,ITH,ITH1,4,Provincia Autonoma Bolzano / Bozen,P.A. Bolzano,533050,7792,1.46,0.1
756,2021-02-20,PAB,1502,471,1031,196,53,24,729,5,6,477,0,1,11,1484,18,ITH,ITH1,4,Provincia Autonoma Bolzano / Bozen,P.A. Bolzano,533050,9294,1.74,0.28
757,2021-03-11,PAB,1681,823,858,89,309,79,335,3,14,371,87,379,15,1143,538,ITH,ITH1,4,Provincia Autonoma Bolzano / Bozen,P.A. Bolzano,533050,10975,2.06,0.32
758,2021-02-01,PAB,1449,439,1010,772,314,295,1,6,0,2,1,1,57,12,1437,ITH,ITH1,4,Provincia Autonoma Bolzano / Bozen,P.A. Bolzano,533050,12424,2.33,0.27
759,2021-04-05,PAB,301,144,157,4,3,0,1,6,16,62,201,7,1,23,278,ITH,ITH1,4,Provincia Autonoma Bolzano / Bozen,P.A. Bolzano,533050,12725,2.39,0.06
760,2021-05-02,PAB,2455,1286,1169,81,22,3,60,212,227,49,1500,278,23,1535,920,ITH,ITH1,4,Provincia Autonoma Bolzano / Bozen,P.A. Bolzano,533050,15180,2.85,0.46
761,2021-02-05,PAB,3195,1181,2014,762,505,440,0,21,12,1381,0,0,74,8,3187,ITH,ITH1,4,Provincia Autonoma Bolzano / Bozen,P.A. Bolzano,533050,18375,3.45,0.6
762,2021-04-10,PAB,5389,2664,2725,146,54,3,22,183,3270,552,941,197,21,4801,588,ITH,ITH1,4,Provincia Autonoma Bolzano / Bozen,P.A. Bolzano,533050,23764,4.46,1.01
763,2021-02-06,PAB,2626,1171,1455,452,43,6,1,28,76,1932,0,0,88,19,2607,ITH,ITH1,4,Provincia Autonoma Bolzano / Bozen,P.A. Bolzano,533050,26390,4.95,0.49
764,2021-04-30,PAB,3327,1585,1742,182,97,43,16,648,615,143,1365,39,179,1552,1775,ITH,ITH1,4,Provincia Autonoma Bolzano / Bozen,P.A. Bolzano,533050,29717,5.57,0.62
765,2021-02-26,PAB,1525,550,975,62,32,2,333,4,1,1051,2,0,38,1495,30,ITH,ITH1,4,Provincia Autonoma Bolzano / Bozen,P.A. Bolzano,533050,31242,5.86,0.29
766,2021-03-06,PAB,3969,2079,1890,479,164,7,381,10,19,1981,48,859,21,3758,211,ITH,ITH1,4,Provincia Autonoma Bolzano / Bozen,P.A. Bolzano,533050,35211,6.61,0.74
767,2021-01-22,PAB,248,143,105,136,8,84,1,4,0,3,1,0,11,124,124,ITH,ITH1,4,Provincia Autonoma Bolzano / Bozen,P.A. Bolzano,533050,35459,6.65,0.05
768,2021-04-17,PAB,5230,2598,2632,69,12,36,76,2791,1237,99,734,161,15,5186,44,ITH,ITH1,4,Provincia Autonoma Bolzano / Bozen,P.A. Bolzano,533050,40689,7.63,0.98
769,2021-02-03,PAB,1503,478,1025,666,341,321,0,12,5,72,1,0,85,5,1498,ITH,ITH1,4,Provincia Autonoma Bolzano / Bozen,P.A. Bolzano,533050,42192,7.92,0.28
770,2021-04-16,PAB,2949,1418,1531,194,36,5,38,1422,616,115,419,98,6,2438,511,ITH,ITH1,4,Provincia Autonoma Bolzano / Bozen,P.A. Bolzano,533050,45141,8.47,0.55
771,2021-03-13,PAB,2885,1459,1426,168,59,1,20,11,879,1295,58,381,13,2784,101,ITH,ITH1,4,Provincia Autonoma Bolzano / Bozen,P.A. Bolzano,533050,48026,9.01,0.54
772,2021-01-19,PAB,853,371,482,174,55,0,0,7,6,578,3,0,30,723,130,ITH,ITH1,4,Provincia Autonoma Bolzano / Bozen,P.A. Bolzano,533050,48879,9.17,0.16
773,2021-04-03,PAB,831,364,467,9,6,0,0,1,12,799,0,4,0,22,809,ITH,ITH1,4,Provincia Autonoma Bolzano / Bozen,P.A. Bolzano,533050,49710,9.33,0.16
774,2021-04-22,PAB,2921,1499,1422,66,29,16,88,728,614,165,844,350,21,1979,942,ITH,ITH1,4,Provincia Autonoma Bolzano / Bozen,P.A. Bolzano,533050,52631,9.87,0.55
775,2021-03-01,PAB,917,220,697,18,2,5,735,18,0,0,0,0,139,917,0,ITH,ITH1,4,Provincia Autonoma Bolzano / Bozen,P.A. Bolzano,533050,53548,10.05,0.17
776,2021-02-16,PAB,529,205,324,10,1,0,0,0,0,517,1,0,0,529,0,ITH,ITH1,4,Provincia Autonoma Bolzano / Bozen,P.A. Bolzano,533050,54077,10.14,0.1
777,2021-01-06,PAB,59,18,41,58,1,0,0,0,0,0,0,0,0,59,0,ITH,ITH1,4,Provincia Autonoma Bolzano / Bozen,P.A. Bolzano,533050,54136,10.16,0.01
778,2021-03-10,PAB,1261,524,737,660,102,0,118,4,9,134,10,133,91,1118,143,ITH,ITH1,4,Provincia Autonoma Bolzano / Bozen,P.A. Bolzano,533050,55397,10.39,0.24
779,2021-01-02,PAB,91,48,43,69,1,0,0,5,1,0,0,0,15,91,0,ITH,ITH1,4,Provincia Autonoma Bolzano / Bozen,P.A. Bolzano,533050,55488,10.41,0.02
780,2020-12-30,PAB,388,182,206,343,41,0,0,0,0,0,0,0,4,388,0,ITH,ITH1,4,Provincia Autonoma Bolzano / Bozen,P.A. Bolzano,533050,55876,10.48,0.07
781,2021-01-11,PAB,1569,513,1056,586,284,175,0,54,41,161,1,0,267,1569,0,ITH,ITH1,4,Provincia Autonoma Bolzano / Bozen,P.A. Bolzano,533050,57445,10.78,0.29
782,2021-04-09,PAB,2927,1292,1635,336,113,102,14,47,635,280,1362,13,25,2196,731,ITH,ITH1,4,Provincia Autonoma Bolzano / Bozen,P.A. Bolzano,533050,60372,11.33,0.55
783,2021-02-08,PAB,2,1,1,0,0,0,0,0,0,1,0,0,1,1,1,ITH,ITH1,4,Provincia Autonoma Bolzano / Bozen,P.A. Bolzano,533050,60374,11.33,0.0
784,2021-02-02,PAB,1745,506,1239,630,370,605,0,9,10,11,0,0,110,8,1737,ITH,ITH1,4,Provincia Autonoma Bolzano / Bozen,P.A. Bolzano,533050,62119,11.65,0.33
785,2021-01-14,PAB,1946,575,1371,521,441,313,0,63,43,329,0,0,236,1946,0,ITH,ITH1,4,Provincia Autonoma Bolzano / Bozen,P.A. Bolzano,533050,64065,12.02,0.37
786,2021-01-15,PAB,3282,1228,2054,608,307,342,0,81,29,1447,0,0,468,3282,0,ITH,ITH1,4,Provincia Autonoma Bolzano / Bozen,P.A. Bolzano,533050,67347,12.63,0.62
787,2021-01-09,PAB,612,326,286,76,28,75,0,66,19,13,0,0,335,612,0,ITH,ITH1,4,Provincia Autonoma Bolzano / Bozen,P.A. Bolzano,533050,67959,12.75,0.11
788,2021-03-29,PAB,990,423,567,11,2,0,13,0,157,711,67,26,3,231,759,ITH,ITH1,4,Provincia Autonoma Bolzano / Bozen,P.A. Bolzano,533050,68949,12.93,0.19
789,2021-03-15,PAB,848,295,553,294,97,13,4,15,216,66,66,4,73,366,482,ITH,ITH1,4,Provincia Autonoma Bolzano / Bozen,P.A. Bolzano,533050,69797,13.09,0.16
790,2021-03-19,PAB,1905,773,1132,158,59,15,14,10,138,1182,310,1,18,798,1107,ITH,ITH1,4,Provincia Autonoma Bolzano / Bozen,P.A. Bolzano,533050,71702,13.45,0.36
791,2021-04-24,PAB,5100,2448,2652,294,197,2,7,2726,762,184,856,54,18,4616,484,ITH,ITH1,4,Provincia Autonoma Bolzano / Bozen,P.A. Bolzano,533050,76802,14.41,0.96
792,2021-03-05,PAB,1838,624,1214,337,98,59,240,8,2,896,125,9,64,1396,442,ITH,ITH1,4,Provincia Autonoma Bolzano / Bozen,P.A. Bolzano,533050,78640,14.75,0.34
793,2021-04-18,PAB,3110,1607,1503,28,14,2,27,1916,524,134,188,273,4,2100,1010,ITH,ITH1,4,Provincia Autonoma Bolzano / Bozen,P.A. Bolzano,533050,81750,15.34,0.58
794,2021-03-21,PAB,768,285,483,165,17,1,3,3,9,568,0,0,2,14,754,ITH,ITH1,4,Provincia Autonoma Bolzano / Bozen,P.A. Bolzano,533050,82518,15.48,0.14
795,2021-01-13,PAB,1691,557,1134,446,310,270,0,66,30,175,0,0,394,1691,0,ITH,ITH1,4,Provincia Autonoma Bolzano / Bozen,P.A. Bolzano,533050,84209,15.8,0.32
796,2021-03-30,PAB,1298,532,766,51,7,153,27,0,121,924,1,11,3,218,1080,ITH,ITH1,4,Provincia Autonoma Bolzano / Bozen,P.A. Bolzano,533050,85507,16.04,0.24
797,2021-01-18,PAB,1772,687,1085,391,102,8,0,32,56,1019,0,0,164,1767,5,ITH,ITH1,4,Provincia Autonoma Bolzano / Bozen,P.A. Bolzano,533050,87279,16.37,0.33
798,2021-03-27,PAB,3047,1552,1495,320,36,0,46,31,484,1441,358,305,26,1541,1506,ITH,ITH1,4,Provincia Autonoma Bolzano / Bozen,P.A. Bolzano,533050,90326,16.95,0.57
799,2021-03-07,PAB,114,13,101,59,50,0,1,0,0,3,0,0,1,9,105,ITH,ITH1,4,Provincia Autonoma Bolzano / Bozen,P.A. Bolzano,533050,90440,16.97,0.02
800,2021-04-14,PAB,3589,1643,1946,418,139,20,30,1094,829,124,845,80,10,3497,92,ITH,ITH1,4,Provincia Autonoma Bolzano / Bozen,P.A. Bolzano,533050,94029,17.64,0.67
801,2021-04-02,PAB,2077,837,1240,189,66,60,17,5,253,935,532,11,9,720,1357,ITH,ITH1,4,Provincia Autonoma Bolzano / Bozen,P.A. Bolzano,533050,96106,18.03,0.39
802,2021-04-12,PAB,2104,946,1158,33,11,1,2,159,1653,93,143,3,6,2098,6,ITH,ITH1,4,Provincia Autonoma Bolzano / Bozen,P.A. Bolzano,533050,98210,18.42,0.39
803,2021-03-20,PAB,1757,848,909,115,48,9,1,7,265,967,238,99,8,1132,625,ITH,ITH1,4,Provincia Autonoma Bolzano / Bozen,P.A. Bolzano,533050,99967,18.75,0.33
804,2021-04-26,PAB,1540,770,770,24,36,0,56,918,285,31,101,85,4,1535,5,ITH,ITH1,4,Provincia Autonoma Bolzano / Bozen,P.A. Bolzano,533050,101507,19.04,0.29
805,2021-02-12,PAB,730,217,513,322,71,106,0,10,6,141,0,2,72,482,248,ITH,ITH1,4,Provincia Autonoma Bolzano / Bozen,P.A. Bolzano,533050,102237,19.18,0.14
806,2021-02-22,PAB,526,143,383,342,68,0,10,15,4,5,0,1,81,514,12,ITH,ITH1,4,Provincia Autonoma Bolzano / Bozen,P.A. Bolzano,533050,102763,19.28,0.1
807,2021-03-04,PAB,1709,1000,709,307,80,39,262,12,5,171,74,710,49,1480,229,ITH,ITH1,4,Provincia Autonoma Bolzano / Bozen,P.A. Bolzano,533050,104472,19.6,0.32
808,2021-02-13,PAB,318,79,239,126,57,7,0,0,0,126,0,0,2,312,6,ITH,ITH1,4,Provincia Autonoma Bolzano / Bozen,P.A. Bolzano,533050,104790,19.66,0.06
809,2021-02-24,PAB,1366,405,961,10,3,0,1345,0,0,0,0,8,0,1354,12,ITH,ITH1,4,Provincia Autonoma Bolzano / Bozen,P.A. Bolzano,533050,106156,19.91,0.26
810,2021-03-09,PAB,1194,543,651,29,81,22,47,0,1,930,0,80,4,1192,2,ITH,ITH1,4,Provincia Autonoma Bolzano / Bozen,P.A. Bolzano,533050,107350,20.14,0.22
811,2021-01-27,PAB,84,28,56,54,26,0,0,1,0,0,0,0,3,1,83,ITH,ITH1,4,Provincia Autonoma Bolzano / Bozen,P.A. Bolzano,533050,107434,20.15,0.02
812,2021-03-31,PAB,1831,693,1138,419,304,22,16,15,160,430,425,20,20,819,1012,ITH,ITH1,4,Provincia Autonoma Bolzano / Bozen,P.A. Bolzano,533050,109265,20.5,0.34
813,2021-03-08,PAB,1200,526,674,23,10,166,3,30,47,755,147,0,19,1173,27,ITH,ITH1,4,Provincia Autonoma Bolzano / Bozen,P.A. Bolzano,533050,110465,20.72,0.23
814,2021-01-10,PAB,2,2,0,1,0,0,0,0,0,0,0,0,1,2,0,ITH,ITH1,4,Provincia Autonoma Bolzano / Bozen,P.A. Bolzano,533050,110467,20.72,0.0
815,2021-04-08,PAB,2753,1336,1417,47,34,121,2,17,2011,83,310,91,37,2550,203,ITH,ITH1,4,Provincia Autonoma Bolzano / Bozen,P.A. Bolzano,533050,113220,21.24,0.52
816,2021-03-02,PAB,695,200,495,11,1,0,676,0,0,0,0,7,0,693,2,ITH,ITH1,4,Provincia Autonoma Bolzano / Bozen,P.A. Bolzano,533050,113915,21.37,0.13
817,2021-01-20,PAB,617,252,365,287,51,0,0,6,3,257,0,0,13,409,208,ITH,ITH1,4,Provincia Autonoma Bolzano / Bozen,P.A. Bolzano,533050,114532,21.49,0.12
818,2021-01-23,PAB,197,117,80,191,0,0,0,2,0,0,0,0,4,0,197,ITH,ITH1,4,Provincia Autonoma Bolzano / Bozen,P.A. Bolzano,533050,114729,21.52,0.04
819,2021-04-06,PAB,2044,1025,1019,107,46,130,3,10,825,83,808,16,16,1941,103,ITH,ITH1,4,Provincia Autonoma Bolzano / Bozen,P.A. Bolzano,533050,116773,21.91,0.38
820,2021-01-17,PAB,2328,1044,1284,56,38,37,0,57,46,1989,0,0,105,2317,11,ITH,ITH1,4,Provincia Autonoma Bolzano / Bozen,P.A. Bolzano,533050,119101,22.34,0.44
821,2021-02-04,PAB,1958,593,1365,650,507,458,0,23,26,233,0,0,61,8,1950,ITH,ITH1,4,Provincia Autonoma Bolzano / Bozen,P.A. Bolzano,533050,121059,22.71,0.37
822,2021-04-11,PAB,2720,1291,1429,46,17,3,63,350,1672,84,222,258,5,2542,178,ITH,ITH1,4,Provincia Autonoma Bolzano / Bozen,P.A. Bolzano,533050,123779,23.22,0.51
823,2021-01-28,PAB,869,307,562,584,187,69,0,8,0,0,0,2,19,10,859,ITH,ITH1,4,Provincia Autonoma Bolzano / Bozen,P.A. Bolzano,533050,124648,23.38,0.16
824,2021-03-22,PAB,1133,514,619,2,0,0,0,6,900,192,13,15,5,1129,4,ITH,ITH1,4,Provincia Autonoma Bolzano / Bozen,P.A. Bolzano,533050,125781,23.6,0.21
825,2021-02-27,PAB,2457,759,1698,202,87,8,1233,8,13,885,0,3,18,2447,10,ITH,ITH1,4,Provincia Autonoma Bolzano / Bozen,P.A. Bolzano,533050,128238,24.06,0.46
826,2021-01-25,PAB,487,183,304,401,68,0,1,4,0,1,0,2,10,3,484,ITH,ITH1,4,Provincia Autonoma Bolzano / Bozen,P.A. Bolzano,533050,128725,24.15,0.09
827,2021-04-07,PAB,1777,802,975,128,81,57,2,6,908,459,26,100,10,1238,539,ITH,ITH1,4,Provincia Autonoma Bolzano / Bozen,P.A. Bolzano,533050,130502,24.48,0.33
828,2021-02-09,PAB,317,126,191,64,17,2,2,1,0,228,0,0,3,1,316,ITH,ITH1,4,Provincia Autonoma Bolzano / Bozen,P.A. Bolzano,533050,130819,24.54,0.06
829,2021-03-17,PAB,580,213,367,11,6,46,0,0,16,491,0,0,10,579,1,ITH,ITH1,4,Provincia Autonoma Bolzano / Bozen,P.A. Bolzano,533050,131399,24.65,0.11
830,2021-04-25,PAB,3068,1496,1572,53,24,0,24,1445,735,156,442,180,9,2397,671,ITH,ITH1,4,Provincia Autonoma Bolzano / Bozen,P.A. Bolzano,533050,134467,25.23,0.58
831,2021-03-03,PAB,1178,393,785,24,5,6,738,3,0,349,0,51,2,1165,13,ITH,ITH1,4,Provincia Autonoma Bolzano / Bozen,P.A. Bolzano,533050,135645,25.45,0.22
832,2021-01-08,PAB,1521,479,1042,790,170,168,0,51,29,104,0,0,209,1521,0,ITH,ITH1,4,Provincia Autonoma Bolzano / Bozen,P.A. Bolzano,533050,137166,25.73,0.29
833,2021-02-19,PAB,1975,450,1525,122,143,84,1511,3,3,86,6,0,17,1964,11,ITH,ITH1,4,Provincia Autonoma Bolzano / Bozen,P.A. Bolzano,533050,139141,26.1,0.37
834,2021-02-18,PAB,1646,401,1245,23,44,21,1285,1,1,261,0,0,10,1642,4,ITH,ITH1,4,Provincia Autonoma Bolzano / Bozen,P.A. Bolzano,533050,140787,26.41,0.31
835,2021-02-25,PAB,1498,549,949,22,5,0,405,2,1,1041,0,0,22,1497,1,ITH,ITH1,4,Provincia Autonoma Bolzano / Bozen,P.A. Bolzano,533050,142285,26.69,0.28
836,2020-12-31,PAB,911,518,393,478,61,0,0,47,9,1,0,0,315,911,0,ITH,ITH1,4,Provincia Autonoma Bolzano / Bozen,P.A. Bolzano,533050,143196,26.86,0.17
837,2021-01-03,PAB,41,16,25,33,5,0,0,0,0,1,0,0,2,41,0,ITH,ITH1,4,Provincia Autonoma Bolzano / Bozen,P.A. Bolzano,533050,143237,26.87,0.01
838,2021-01-26,PAB,810,291,519,673,129,0,0,3,1,0,0,0,4,1,809,ITH,ITH1,4,Provincia Autonoma Bolzano / Bozen,P.A. Bolzano,533050,144047,27.02,0.15
839,2021-03-26,PAB,1644,721,923,30,16,68,1,8,132,917,424,0,48,511,1133,ITH,ITH1,4,Provincia Autonoma Bolzano / Bozen,P.A. Bolzano,533050,145691,27.33,0.31
840,2021-03-16,PAB,776,308,468,26,31,48,0,4,14,646,4,2,1,123,653,ITH,ITH1,4,Provincia Autonoma Bolzano / Bozen,P.A. Bolzano,533050,146467,27.48,0.15
841,2021-04-01,PAB,2786,1407,1379,238,104,44,65,22,512,607,731,446,17,2642,144,ITH,ITH1,4,Provincia Autonoma Bolzano / Bozen,P.A. Bolzano,533050,149253,28.0,0.52
842,2021-04-13,PAB,2391,1130,1261,23,4,1,6,1246,932,30,93,55,1,2383,8,ITH,ITH1,4,Provincia Autonoma Bolzano / Bozen,P.A. Bolzano,533050,151644,28.45,0.45
843,2021-01-16,PAB,2840,1265,1575,435,93,77,1,54,98,1976,0,0,106,2840,0,ITH,ITH1,4,Provincia Autonoma Bolzano / Bozen,P.A. Bolzano,533050,154484,28.98,0.53
844,2021-04-28,PAB,2456,1300,1156,77,56,10,59,1156,464,76,471,74,13,2453,3,ITH,ITH1,4,Provincia Autonoma Bolzano / Bozen,P.A. Bolzano,533050,156940,29.44,0.46
845,2021-02-07,PAB,2361,1057,1304,102,75,68,0,51,44,1951,0,0,70,14,2347,ITH,ITH1,4,Provincia Autonoma Bolzano / Bozen,P.A. Bolzano,533050,159301,29.88,0.44
846,2021-05-04,PAB,3438,1837,1601,48,38,9,78,497,386,77,2057,176,72,2403,1035,ITH,ITH1,4,Provincia Autonoma Bolzano / Bozen,P.A. Bolzano,533050,162739,30.53,0.64
847,2021-05-01,PAB,2103,1066,1037,119,29,0,90,772,308,62,479,217,27,1943,160,ITH,ITH1,4,Provincia Autonoma Bolzano / Bozen,P.A. Bolzano,533050,164842,30.92,0.39
848,2021-01-21,PAB,952,442,510,750,88,68,0,1,0,28,0,5,12,139,813,ITH,ITH1,4,Provincia Autonoma Bolzano / Bozen,P.A. Bolzano,533050,165794,31.1,0.18
849,2021-03-25,PAB,2139,1058,1081,230,72,27,46,24,843,305,297,268,27,1697,442,ITH,ITH1,4,Provincia Autonoma Bolzano / Bozen,P.A. Bolzano,533050,167933,31.5,0.4
850,2021-03-23,PAB,1552,759,793,0,1,0,34,5,1156,215,58,68,15,1551,1,ITH,ITH1,4,Provincia Autonoma Bolzano / Bozen,P.A. Bolzano,533050,169485,31.8,0.29
851,2021-03-24,PAB,2040,977,1063,13,16,7,29,6,1361,248,278,61,21,2027,13,ITH,ITH1,4,Provincia Autonoma Bolzano / Bozen,P.A. Bolzano,533050,171525,32.18,0.38
852,2021-01-05,PAB,830,286,544,734,62,0,0,8,2,0,0,0,24,830,0,ITH,ITH1,4,Provincia Autonoma Bolzano / Bozen,P.A. Bolzano,533050,172355,32.33,0.16
853,2020-12-27,PAB,144,65,79,139,2,0,0,0,0,1,0,0,2,144,0,ITH,ITH1,4,Provincia Autonoma Bolzano / Bozen,P.A. Bolzano,533050,172499,32.36,0.03
854,2021-03-14,PAB,758,336,422,130,11,33,0,3,7,562,1,2,9,25,733,ITH,ITH1,4,Provincia Autonoma Bolzano / Bozen,P.A. Bolzano,533050,173257,32.5,0.14
855,2021-01-30,PAB,498,245,253,217,46,101,0,29,2,0,0,0,103,4,494,ITH,ITH1,4,Provincia Autonoma Bolzano / Bozen,P.A. Bolzano,533050,173755,32.6,0.09
856,2021-04-20,PAB,1558,781,777,10,13,12,8,619,364,46,474,9,3,1557,1,ITH,ITH1,4,Provincia Autonoma Bolzano / Bozen,P.A. Bolzano,533050,175313,32.89,0.29
857,2021-01-24,PAB,12,10,2,1,0,0,0,2,1,0,0,0,8,0,12,ITH,ITH1,4,Provincia Autonoma Bolzano / Bozen,P.A. Bolzano,533050,175325,32.89,0.0
858,2021-04-21,PAB,3008,1467,1541,112,12,2,11,1727,490,88,540,17,9,2161,847,ITH,ITH1,4,Provincia Autonoma Bolzano / Bozen,P.A. Bolzano,533050,178333,33.46,0.56
859,2021-02-17,PAB,4,1,3,1,0,0,0,0,0,2,1,0,0,2,2,ITH,ITH1,4,Provincia Autonoma Bolzano / Bozen,P.A. Bolzano,533050,178337,33.46,0.0
860,2021-02-23,PAB,768,323,445,0,0,0,85,2,1,672,0,0,8,762,6,ITH,ITH1,4,Provincia Autonoma Bolzano / Bozen,P.A. Bolzano,533050,179105,33.6,0.14
861,2021-04-19,PAB,1869,857,1012,44,22,1,11,1039,300,166,269,8,9,1687,182,ITH,ITH1,4,Provincia Autonoma Bolzano / Bozen,P.A. Bolzano,533050,180974,33.95,0.35
862,2021-04-27,PAB,2224,1011,1213,109,58,21,53,589,1115,78,118,76,7,1148,1076,ITH,ITH1,4,Provincia Autonoma Bolzano / Bozen,P.A. Bolzano,533050,183198,34.37,0.42
863,2021-04-15,PAB,4394,2305,2089,119,48,38,118,1385,735,174,1260,493,24,4131,263,ITH,ITH1,4,Provincia Autonoma Bolzano / Bozen,P.A. Bolzano,533050,187592,35.19,0.82
864,2021-03-28,PAB,569,212,357,45,38,0,2,6,5,470,2,0,1,11,558,ITH,ITH1,4,Provincia Autonoma Bolzano / Bozen,P.A. Bolzano,533050,188161,35.3,0.11
865,2021-01-12,PAB,1709,459,1250,369,228,479,0,54,43,134,0,0,402,1709,0,ITH,ITH1,4,Provincia Autonoma Bolzano / Bozen,P.A. Bolzano,533050,189870,35.62,0.32
866,2021-02-11,PAB,1092,431,661,214,92,104,0,4,2,589,57,0,30,239,853,ITH,ITH1,4,Provincia Autonoma Bolzano / Bozen,P.A. Bolzano,533050,190962,35.82,0.2
867,2021-04-29,PAB,2630,1351,1279,127,117,71,74,600,541,124,509,245,222,1936,694,ITH,ITH1,4,Provincia Autonoma Bolzano / Bozen,P.A. Bolzano,533050,193592,36.32,0.49
868,2021-02-10,PAB,1635,604,1031,489,166,1,0,18,5,872,0,1,83,26,1609,ITH,ITH1,4,Provincia Autonoma Bolzano / Bozen,P.A. Bolzano,533050,195227,36.62,0.31
869,2021-01-01,PAB,6,5,1,6,0,0,0,0,0,0,0,0,0,6,0,ITH,ITH1,4,Provincia Autonoma Bolzano / Bozen,P.A. Bolzano,533050,195233,36.63,0.0
870,2021-01-29,PAB,1497,510,987,882,282,295,4,7,1,4,0,0,22,24,1473,ITH,ITH1,4,Provincia Autonoma Bolzano / Bozen,P.A. Bolzano,533050,196730,36.91,0.28
871,2021-03-18,PAB,1302,531,771,50,16,51,0,10,15,1056,69,0,35,226,1076,ITH,ITH1,4,Provincia Autonoma Bolzano / Bozen,P.A. Bolzano,533050,198032,37.15,0.24
872,2021-03-12,PAB,1664,734,930,150,173,82,101,9,268,524,134,204,19,1251,413,ITH,ITH1,4,Provincia Autonoma Bolzano / Bozen,P.A. Bolzano,533050,199696,37.46,0.31
873,2021-02-15,PAB,72,42,30,17,2,40,0,0,1,7,0,0,5,26,46,ITH,ITH1,4,Provincia Autonoma Bolzano / Bozen,P.A. Bolzano,533050,199768,37.48,0.01
874,2021-01-07,LIG,3230,1095,2135,2340,315,466,4,18,5,0,0,1,81,3230,0,ITC,ITC3,7,Liguria,Liguria,1550640,3230,0.21,0.21
875,2021-01-08,LIG,2926,999,1927,2083,343,431,4,12,0,0,0,1,52,2926,0,ITC,ITC3,7,Liguria,Liguria,1550640,6156,0.4,0.19
876,2021-02-18,LIG,2762,1126,1636,958,195,350,2,22,7,1006,35,0,187,2431,331,ITC,ITC3,7,Liguria,Liguria,1550640,8918,0.58,0.18
877,2021-02-19,LIG,3098,1280,1818,990,246,97,3,39,22,1450,0,4,247,2922,176,ITC,ITC3,7,Liguria,Liguria,1550640,12016,0.77,0.2
878,2021-04-28,LIG,14400,6504,7896,275,181,85,332,3099,4038,3116,2864,59,351,6424,7976,ITC,ITC3,7,Liguria,Liguria,1550640,26416,1.7,0.93
879,2021-04-10,LIG,7877,3556,4321,216,90,34,9,172,3954,1578,1612,6,206,6963,914,ITC,ITC3,7,Liguria,Liguria,1550640,34293,2.21,0.51
880,2021-02-11,LIG,1964,762,1202,1242,230,456,6,2,1,0,4,0,23,1094,870,ITC,ITC3,7,Liguria,Liguria,1550640,36257,2.34,0.13
881,2021-03-13,LIG,3825,1614,2211,332,120,71,790,100,45,1782,11,179,395,2971,854,ITC,ITC3,7,Liguria,Liguria,1550640,40082,2.58,0.25
882,2021-01-18,LIG,2132,743,1389,1250,384,438,10,12,5,1,0,0,32,1976,156,ITC,ITC3,7,Liguria,Liguria,1550640,42214,2.72,0.14
883,2021-02-22,LIG,3330,1463,1867,713,104,236,2,2,13,2236,0,7,17,3192,138,ITC,ITC3,7,Liguria,Liguria,1550640,45544,2.94,0.21
884,2021-03-16,LIG,6069,2719,3350,935,176,324,6,35,77,4275,142,14,85,2349,3720,ITC,ITC3,7,Liguria,Liguria,1550640,51613,3.33,0.39
885,2020-12-29,LIG,125,33,92,93,11,21,0,0,0,0,0,0,0,125,0,ITC,ITC3,7,Liguria,Liguria,1550640,51738,3.34,0.01
886,2021-03-26,LIG,9122,3854,5268,602,325,65,1297,221,265,3896,1840,377,234,5968,3154,ITC,ITC3,7,Liguria,Liguria,1550640,60860,3.92,0.59
887,2021-03-12,LIG,6152,2815,3337,1208,459,84,4,77,79,3504,53,590,94,3683,2469,ITC,ITC3,7,Liguria,Liguria,1550640,67012,4.32,0.4
888,2021-04-02,LIG,11661,5113,6548,434,225,40,905,355,3180,3623,2464,139,296,9175,2486,ITC,ITC3,7,Liguria,Liguria,1550640,78673,5.07,0.75
889,2021-01-16,LIG,1278,557,721,753,196,299,1,4,2,0,1,0,22,1278,0,ITC,ITC3,7,Liguria,Liguria,1550640,79951,5.16,0.08
890,2021-04-04,LIG,756,366,390,30,0,0,0,36,64,325,222,0,79,507,249,ITC,ITC3,7,Liguria,Liguria,1550640,80707,5.2,0.05
891,2021-01-01,LIG,144,55,89,139,5,0,0,0,0,0,0,0,0,144,0,ITC,ITC3,7,Liguria,Liguria,1550640,80851,5.21,0.01
892,2021-01-05,LIG,2879,896,1983,2308,240,261,7,7,1,17,0,0,38,2879,0,ITC,ITC3,7,Liguria,Liguria,1550640,83730,5.4,0.19
893,2021-04-01,LIG,12376,5467,6909,437,239,141,939,345,3489,3710,2546,188,342,9606,2770,ITC,ITC3,7,Liguria,Liguria,1550640,96106,6.2,0.8
894,2021-01-20,LIG,1549,554,995,727,332,480,2,0,2,0,0,0,6,1537,12,ITC,ITC3,7,Liguria,Liguria,1550640,97655,6.3,0.1
895,2021-04-03,LIG,5403,2497,2906,116,79,3,19,136,2419,1394,1124,9,104,4461,942,ITC,ITC3,7,Liguria,Liguria,1550640,103058,6.65,0.35
896,2021-01-15,LIG,2254,753,1501,1326,349,517,2,8,1,2,1,0,48,2254,0,ITC,ITC3,7,Liguria,Liguria,1550640,105312,6.79,0.15
897,2021-01-06,LIG,1660,616,1044,1230,142,113,3,36,10,65,0,0,61,1660,0,ITC,ITC3,7,Liguria,Liguria,1550640,106972,6.9,0.11
898,2021-01-10,LIG,648,262,386,369,101,176,0,1,0,0,0,0,1,648,0,ITC,ITC3,7,Liguria,Liguria,1550640,107620,6.94,0.04
899,2021-02-02,LIG,2668,1005,1663,1974,216,464,2,2,0,0,0,0,10,134,2534,ITC,ITC3,7,Liguria,Liguria,1550640,110288,7.11,0.17
900,2021-04-07,LIG,13576,6030,7546,433,296,108,574,491,4245,4285,2632,150,362,11297,2279,ITC,ITC3,7,Liguria,Liguria,1550640,123864,7.99,0.88
901,2021-01-28,LIG,2841,969,1872,2239,270,310,5,0,0,1,0,1,15,39,2802,ITC,ITC3,7,Liguria,Liguria,1550640,126705,8.17,0.18
902,2021-01-02,LIG,691,245,446,595,95,0,0,0,0,0,0,0,1,691,0,ITC,ITC3,7,Liguria,Liguria,1550640,127396,8.22,0.04
903,2021-04-09,LIG,12358,5538,6820,530,354,79,582,441,4131,3625,2243,61,312,10630,1728,ITC,ITC3,7,Liguria,Liguria,1550640,139754,9.01,0.8
904,2021-01-11,LIG,2654,990,1664,1992,314,315,1,7,0,0,1,0,24,2654,0,ITC,ITC3,7,Liguria,Liguria,1550640,142408,9.18,0.17
905,2021-01-14,LIG,2982,1056,1926,1872,524,553,1,5,0,0,0,2,25,2982,0,ITC,ITC3,7,Liguria,Liguria,1550640,145390,9.38,0.19
906,2021-03-03,LIG,4578,1846,2732,1038,202,308,4,4,5,2982,0,4,31,3555,1023,ITC,ITC3,7,Liguria,Liguria,1550640,149968,9.67,0.3
907,2021-01-09,LIG,1335,481,854,999,131,188,2,4,0,0,0,1,10,1335,0,ITC,ITC3,7,Liguria,Liguria,1550640,151303,9.76,0.09
908,2021-02-16,LIG,2393,950,1443,982,238,283,2,19,4,704,12,0,149,2000,393,ITC,ITC3,7,Liguria,Liguria,1550640,153696,9.91,0.15
909,2021-04-18,LIG,2604,1160,1444,217,93,44,1,19,825,520,879,0,6,2135,469,ITC,ITC3,7,Liguria,Liguria,1550640,156300,10.08,0.17
910,2021-04-24,LIG,8165,3784,4381,137,116,58,4,1877,2563,1286,1899,8,217,5013,3152,ITC,ITC3,7,Liguria,Liguria,1550640,164465,10.61,0.53
911,2021-04-29,LIG,15463,6944,8519,553,226,96,527,3458,4700,2921,2620,82,280,6678,8785,ITC,ITC3,7,Liguria,Liguria,1550640,179928,11.6,1.0
912,2021-02-10,LIG,2297,834,1463,1354,391,513,5,6,2,5,0,0,21,1015,1282,ITC,ITC3,7,Liguria,Liguria,1550640,182225,11.75,0.15
913,2021-01-31,LIG,624,270,354,418,71,135,0,0,0,0,0,0,0,9,615,ITC,ITC3,7,Liguria,Liguria,1550640,182849,11.79,0.04
914,2021-02-20,LIG,1335,636,699,160,107,122,0,34,5,589,0,4,314,1334,1,ITC,ITC3,7,Liguria,Liguria,1550640,184184,11.88,0.09
915,2021-01-21,LIG,1101,384,717,584,159,332,0,2,2,1,0,0,21,671,430,ITC,ITC3,7,Liguria,Liguria,1550640,185285,11.95,0.07
916,2021-05-04,LIG,2225,1024,1201,6,4,0,3,503,919,370,387,0,33,752,1473,ITC,ITC3,7,Liguria,Liguria,1550640,187510,12.09,0.14
917,2021-02-23,LIG,3804,1559,2245,687,163,116,1,5,5,2749,42,4,32,3695,109,ITC,ITC3,7,Liguria,Liguria,1550640,191314,12.34,0.25
918,2021-02-26,LIG,3760,1521,2239,782,147,168,2,16,26,2604,0,0,15,3432,328,ITC,ITC3,7,Liguria,Liguria,1550640,195074,12.58,0.24
919,2021-04-30,LIG,14068,6305,7763,331,162,21,512,2951,4259,2877,2626,57,272,5577,8491,ITC,ITC3,7,Liguria,Liguria,1550640,209142,13.49,0.91
920,2021-04-11,LIG,4246,1930,2316,66,57,24,73,66,2113,627,1174,10,36,3997,249,ITC,ITC3,7,Liguria,Liguria,1550640,213388,13.76,0.27
921,2021-02-13,LIG,1080,508,572,543,80,148,0,0,0,257,0,2,50,800,280,ITC,ITC3,7,Liguria,Liguria,1550640,214468,13.83,0.07
922,2021-02-24,LIG,3759,1558,2201,804,193,153,1,2,6,2581,1,0,18,3501,258,ITC,ITC3,7,Liguria,Liguria,1550640,218227,14.07,0.24
923,2021-03-20,LIG,2316,995,1321,224,81,0,0,12,44,1857,12,67,19,1142,1174,ITC,ITC3,7,Liguria,Liguria,1550640,220543,14.22,0.15
924,2021-02-17,LIG,2623,1164,1459,883,202,261,1,15,8,1121,0,8,124,2261,362,ITC,ITC3,7,Liguria,Liguria,1550640,223166,14.39,0.17
925,2021-03-06,LIG,3302,1841,1461,377,151,120,1,58,6,1537,0,559,493,2597,705,ITC,ITC3,7,Liguria,Liguria,1550640,226468,14.6,0.21
926,2021-01-25,LIG,2717,888,1829,2208,175,317,2,5,1,0,0,0,9,471,2246,ITC,ITC3,7,Liguria,Liguria,1550640,229185,14.78,0.18
927,2021-04-12,LIG,12358,5467,6891,528,224,111,45,539,4160,4205,2152,68,326,10342,2016,ITC,ITC3,7,Liguria,Liguria,1550640,241543,15.58,0.8
928,2021-02-12,LIG,1919,687,1232,871,203,394,1,2,1,431,0,7,9,898,1021,ITC,ITC3,7,Liguria,Liguria,1550640,243462,15.7,0.12
929,2021-03-10,LIG,5876,2837,3039,823,352,95,1,23,28,3752,43,610,149,3973,1903,ITC,ITC3,7,Liguria,Liguria,1550640,249338,16.08,0.38
930,2021-04-22,LIG,13808,6190,7618,530,166,50,534,2714,3376,3002,2957,135,344,8744,5064,ITC,ITC3,7,Liguria,Liguria,1550640,263146,16.97,0.89
931,2021-03-27,LIG,3920,1538,2382,176,175,36,706,26,89,2057,502,92,61,2525,1395,ITC,ITC3,7,Liguria,Liguria,1550640,267066,17.22,0.25
932,2021-03-31,LIG,11843,5207,6636,527,179,103,879,352,2610,4217,2445,219,312,9073,2770,ITC,ITC3,7,Liguria,Liguria,1550640,278909,17.99,0.76
933,2021-05-02,LIG,3309,1525,1784,28,12,2,0,266,1887,348,708,2,56,440,2869,ITC,ITC3,7,Liguria,Liguria,1550640,282218,18.2,0.21
934,2021-04-08,LIG,13707,6147,7560,685,322,109,651,461,4351,3929,2786,76,337,11663,2044,ITC,ITC3,7,Liguria,Liguria,1550640,295925,19.08,0.88
935,2021-03-02,LIG,4072,1687,2385,726,93,76,4,8,16,3088,42,3,16,3762,310,ITC,ITC3,7,Liguria,Liguria,1550640,299997,19.35,0.26
936,2021-03-01,LIG,3500,1427,2073,528,81,106,1,4,6,2751,0,0,23,3378,122,ITC,ITC3,7,Liguria,Liguria,1550640,303497,19.57,0.23
937,2021-03-30,LIG,12144,5378,6766,484,255,152,850,317,2406,4296,2815,280,289,8755,3389,ITC,ITC3,7,Liguria,Liguria,1550640,315641,20.36,0.78
938,2021-03-08,LIG,5621,2456,3165,1123,319,80,7,35,15,3570,11,384,77,3933,1688,ITC,ITC3,7,Liguria,Liguria,1550640,321262,20.72,0.36
939,2021-04-17,LIG,7283,3189,4094,177,153,106,4,1234,2623,1493,1320,8,165,6551,732,ITC,ITC3,7,Liguria,Liguria,1550640,328545,21.19,0.47
940,2021-03-17,LIG,5551,2368,3183,782,156,93,8,20,74,4258,109,4,47,2474,3077,ITC,ITC3,7,Liguria,Liguria,1550640,334096,21.55,0.36
941,2021-02-04,LIG,2814,985,1829,1866,460,471,8,0,0,0,0,1,8,179,2635,ITC,ITC3,7,Liguria,Liguria,1550640,336910,21.73,0.18
942,2021-01-23,LIG,809,295,514,633,129,43,1,2,1,0,0,0,0,153,656,ITC,ITC3,7,Liguria,Liguria,1550640,337719,21.78,0.05
943,2021-04-06,LIG,13164,5853,7311,543,269,208,553,376,4063,4149,2491,134,378,10924,2240,ITC,ITC3,7,Liguria,Liguria,1550640,350883,22.63,0.85
944,2021-02-15,LIG,2260,838,1422,1087,217,241,2,12,1,664,0,1,35,1863,397,ITC,ITC3,7,Liguria,Liguria,1550640,353143,22.77,0.15
945,2021-02-28,LIG,1060,581,479,12,2,4,0,63,7,474,0,0,498,1051,9,ITC,ITC3,7,Liguria,Liguria,1550640,354203,22.84,0.07
946,2020-12-30,LIG,12,5,7,12,0,0,0,0,0,0,0,0,0,12,0,ITC,ITC3,7,Liguria,Liguria,1550640,354215,22.84,0.0
947,2021-02-09,LIG,1906,684,1222,1089,325,455,22,2,0,0,0,0,13,256,1650,ITC,ITC3,7,Liguria,Liguria,1550640,356121,22.97,0.12
948,2021-03-22,LIG,7653,3394,4259,579,192,83,877,122,96,4086,1107,370,141,4720,2933,ITC,ITC3,7,Liguria,Liguria,1550640,363774,23.46,0.49
949,2021-01-17,LIG,861,300,561,516,30,262,1,4,2,0,0,0,46,861,0,ITC,ITC3,7,Liguria,Liguria,1550640,364635,23.52,0.06
950,2021-04-26,LIG,10402,4888,5514,350,110,123,3,3405,2501,1365,2328,58,159,7783,2619,ITC,ITC3,7,Liguria,Liguria,1550640,375037,24.19,0.67
951,2021-02-07,LIG,407,153,254,191,18,187,0,0,0,0,9,0,2,2,405,ITC,ITC3,7,Liguria,Liguria,1550640,375444,24.21,0.03
952,2021-03-11,LIG,6347,3052,3295,1145,170,262,2,42,39,3800,90,720,77,4342,2005,ITC,ITC3,7,Liguria,Liguria,1550640,381791,24.62,0.41
953,2021-04-05,LIG,3976,1751,2225,188,44,10,10,141,921,2211,338,5,108,2327,1649,ITC,ITC3,7,Liguria,Liguria,1550640,385767,24.88,0.26
954,2021-01-04,LIG,2616,854,1762,2198,158,176,3,22,3,0,1,0,55,2616,0,ITC,ITC3,7,Liguria,Liguria,1550640,388383,25.05,0.17
955,2021-05-03,LIG,2902,1290,1612,43,10,0,2,663,1222,516,424,0,22,1119,1783,ITC,ITC3,7,Liguria,Liguria,1550640,391285,25.23,0.19
956,2021-04-25,LIG,1936,921,1015,12,2,0,0,676,739,162,340,0,5,1521,415,ITC,ITC3,7,Liguria,Liguria,1550640,393221,25.36,0.12
957,2021-04-23,LIG,14588,6619,7969,352,220,72,544,3314,3468,3261,2978,90,289,8502,6086,ITC,ITC3,7,Liguria,Liguria,1550640,407809,26.3,0.94
958,2020-12-31,LIG,989,354,635,751,34,155,0,4,10,28,0,0,7,989,0,ITC,ITC3,7,Liguria,Liguria,1550640,408798,26.36,0.06
959,2021-03-15,LIG,7300,3074,4226,819,338,106,962,126,83,3781,628,304,153,4597,2703,ITC,ITC3,7,Liguria,Liguria,1550640,416098,26.83,0.47
960,2021-02-21,LIG,869,491,378,183,21,102,0,38,4,267,0,0,254,865,4,ITC,ITC3,7,Liguria,Liguria,1550640,416967,26.89,0.06
961,2021-02-06,LIG,1891,767,1124,1309,186,375,1,0,1,0,0,0,19,145,1746,ITC,ITC3,7,Liguria,Liguria,1550640,418858,27.01,0.12
962,2021-01-13,LIG,2755,1013,1742,1913,307,487,4,8,7,1,0,0,28,2755,0,ITC,ITC3,7,Liguria,Liguria,1550640,421613,27.19,0.18
963,2021-04-13,LIG,13038,5853,7185,513,228,111,103,592,4635,4359,2137,88,272,11017,2021,ITC,ITC3,7,Liguria,Liguria,1550640,434651,28.03,0.84
964,2021-01-03,LIG,734,230,504,658,62,0,1,2,0,0,0,0,11,734,0,ITC,ITC3,7,Liguria,Liguria,1550640,435385,28.08,0.05
965,2021-04-16,LIG,11937,5263,6674,489,249,113,42,1845,3422,3450,2031,77,219,10126,1811,ITC,ITC3,7,Liguria,Liguria,1550640,447322,28.85,0.77
966,2021-01-19,LIG,1366,435,931,716,312,328,3,1,0,0,0,0,6,1276,90,ITC,ITC3,7,Liguria,Liguria,1550640,448688,28.94,0.09
967,2021-01-30,LIG,1661,567,1094,1261,121,257,2,6,0,0,0,0,14,25,1636,ITC,ITC3,7,Liguria,Liguria,1550640,450349,29.04,0.11
968,2021-04-20,LIG,14218,6505,7713,460,131,171,378,3174,3312,3466,2790,18,318,9869,4349,ITC,ITC3,7,Liguria,Liguria,1550640,464567,29.96,0.92
969,2021-02-05,LIG,2673,986,1687,1743,417,494,4,1,1,0,0,0,13,304,2369,ITC,ITC3,7,Liguria,Liguria,1550640,467240,30.13,0.17
970,2021-02-03,LIG,2315,791,1524,1627,224,416,1,7,4,0,0,0,36,55,2260,ITC,ITC3,7,Liguria,Liguria,1550640,469555,30.28,0.15
971,2021-02-25,LIG,3442,1348,2094,551,135,88,1,7,2,2586,42,2,28,3313,129,ITC,ITC3,7,Liguria,Liguria,1550640,472997,30.5,0.22
972,2020-12-28,LIG,79,29,50,76,0,0,0,1,0,1,0,0,1,79,0,ITC,ITC3,7,Liguria,Liguria,1550640,473076,30.51,0.01
973,2021-01-24,LIG,756,237,519,632,61,60,0,0,0,0,0,0,3,113,643,ITC,ITC3,7,Liguria,Liguria,1550640,473832,30.56,0.05
974,2021-05-01,LIG,6982,3217,3765,161,53,1,3,686,3824,870,1227,6,151,1223,5759,ITC,ITC3,7,Liguria,Liguria,1550640,480814,31.01,0.45
975,2021-03-25,LIG,9586,4077,5509,660,265,172,1614,151,259,3733,2060,524,148,6195,3391,ITC,ITC3,7,Liguria,Liguria,1550640,490400,31.63,0.62
976,2021-03-24,LIG,8928,3828,5100,523,236,103,1337,154,140,4346,1378,556,155,5640,3288,ITC,ITC3,7,Liguria,Liguria,1550640,499328,32.2,0.58
977,2021-03-07,LIG,1857,1084,773,184,200,258,1,29,3,509,0,404,269,1556,301,ITC,ITC3,7,Liguria,Liguria,1550640,501185,32.32,0.12
978,2021-03-23,LIG,9028,4079,4949,663,222,126,1311,148,103,4052,1657,583,163,5818,3210,ITC,ITC3,7,Liguria,Liguria,1550640,510213,32.9,0.58
979,2021-04-14,LIG,12989,5644,7345,458,292,125,61,567,4736,4341,2127,38,244,10789,2200,ITC,ITC3,7,Liguria,Liguria,1550640,523202,33.74,0.84
980,2020-12-27,LIG,135,56,79,88,0,45,0,0,0,0,0,0,2,135,0,ITC,ITC3,7,Liguria,Liguria,1550640,523337,33.75,0.01
981,2021-01-27,LIG,1744,603,1141,1337,169,226,1,0,0,0,0,0,11,141,1603,ITC,ITC3,7,Liguria,Liguria,1550640,525081,33.86,0.11
982,2021-04-19,LIG,12808,5618,7190,551,168,101,247,2652,2940,3339,2551,35,224,9002,3806,ITC,ITC3,7,Liguria,Liguria,1550640,537889,34.69,0.83
983,2021-03-04,LIG,4735,2117,2618,921,171,289,4,3,8,2922,42,327,48,3891,844,ITC,ITC3,7,Liguria,Liguria,1550640,542624,34.99,0.31
984,2021-03-09,LIG,5927,2751,3176,1031,324,132,1,51,45,3585,42,630,86,4501,1426,ITC,ITC3,7,Liguria,Liguria,1550640,548551,35.38,0.38
985,2021-03-14,LIG,1658,752,906,66,68,176,431,70,13,577,3,52,202,1054,604,ITC,ITC3,7,Liguria,Liguria,1550640,550209,35.48,0.11
986,2021-04-21,LIG,14220,6419,7801,517,195,61,498,2662,3508,3661,2753,78,287,8897,5323,ITC,ITC3,7,Liguria,Liguria,1550640,564429,36.4,0.92
987,2021-02-14,LIG,233,122,111,31,0,112,0,0,0,60,0,0,30,233,0,ITC,ITC3,7,Liguria,Liguria,1550640,564662,36.41,0.02
988,2021-04-27,LIG,14669,6651,8018,319,169,87,320,3768,3737,3260,2719,42,248,7108,7561,ITC,ITC3,7,Liguria,Liguria,1550640,579331,37.36,0.95
989,2021-01-26,LIG,2484,803,1681,1965,253,252,5,1,0,0,1,0,7,13,2471,ITC,ITC3,7,Liguria,Liguria,1550640,581815,37.52,0.16
990,2021-03-29,LIG,10441,4511,5930,467,259,119,884,255,1566,3962,2396,205,328,7311,3130,ITC,ITC3,7,Liguria,Liguria,1550640,592256,38.19,0.67
991,2021-01-12,LIG,2460,886,1574,1750,250,439,2,2,1,0,0,1,15,2460,0,ITC,ITC3,7,Liguria,Liguria,1550640,594716,38.35,0.16
992,2021-03-28,LIG,1142,511,631,135,92,145,0,25,86,532,86,2,39,391,751,ITC,ITC3,7,Liguria,Liguria,1550640,595858,38.43,0.07
993,2021-02-01,LIG,2552,917,1635,1946,202,380,1,6,0,0,1,0,16,85,2467,ITC,ITC3,7,Liguria,Liguria,1550640,598410,38.59,0.16
994,2021-04-15,LIG,11847,5237,6610,485,257,138,58,485,4036,3708,2401,76,203,9998,1849,ITC,ITC3,7,Liguria,Liguria,1550640,610257,39.36,0.76
995,2021-02-08,LIG,1977,742,1235,1255,367,311,7,11,4,1,0,0,21,306,1671,ITC,ITC3,7,Liguria,Liguria,1550640,612234,39.48,0.13
996,2021-03-19,LIG,5291,2232,3059,734,202,137,83,54,80,3699,165,88,49,2159,3132,ITC,ITC3,7,Liguria,Liguria,1550640,617525,39.82,0.34
997,2021-03-21,LIG,552,221,331,7,3,0,0,0,13,525,1,0,3,69,483,ITC,ITC3,7,Liguria,Liguria,1550640,618077,39.86,0.04
998,2021-01-29,LIG,3077,1064,2013,2312,300,441,2,4,0,0,0,0,18,67,3010,ITC,ITC3,7,Liguria,Liguria,1550640,621154,40.06,0.2
999,2021-02-27,LIG,1888,921,967,139,18,5,0,61,0,1205,0,0,460,1759,129,ITC,ITC3,7,Liguria,Liguria,1550640,623042,40.18,0.12
1000,2021-01-22,LIG,1814,603,1211,1065,175,565,0,2,0,1,1,0,5,1328,486,ITC,ITC3,7,Liguria,Liguria,1550640,624856,40.3,0.12
1001,2021-03-18,LIG,4980,2123,2857,634,87,98,5,63,80,3691,219,6,97,2009,2971,ITC,ITC3,7,Liguria,Liguria,1550640,629836,40.62,0.32
1002,2021-03-05,LIG,4863,2148,2715,796,221,81,5,5,8,3339,6,365,37,3737,1126,ITC,ITC3,7,Liguria,Liguria,1550640,634699,40.93,0.31
1003,2020-12-31,EMR,2207,777,1430,1676,96,330,0,9,5,13,0,0,78,2207,0,ITH,ITH5,8,Emilia-Romagna,Emilia-Romagna,4459477,2207,0.05,0.05
1004,2021-04-12,EMR,19088,8942,10146,438,169,313,62,391,4512,6646,6426,95,36,14660,4428,ITH,ITH5,8,Emilia-Romagna,Emilia-Romagna,4459477,21295,0.48,0.43
1005,2021-02-07,EMR,4792,1536,3256,3689,565,446,3,8,1,10,0,0,70,1731,3061,ITH,ITH5,8,Emilia-Romagna,Emilia-Romagna,4459477,26087,0.58,0.11
1006,2021-03-28,EMR,12648,5637,7011,277,139,48,326,60,3970,4848,2660,246,74,9160,3488,ITH,ITH5,8,Emilia-Romagna,Emilia-Romagna,4459477,38735,0.87,0.28
1007,2021-01-17,EMR,2890,887,2003,1914,378,547,4,14,5,2,0,0,26,2644,246,ITH,ITH5,8,Emilia-Romagna,Emilia-Romagna,4459477,41625,0.93,0.06
1008,2021-03-19,EMR,15333,6665,8668,1124,555,118,338,79,844,10491,904,747,133,7571,7762,ITH,ITH5,8,Emilia-Romagna,Emilia-Romagna,4459477,56958,1.28,0.34
1009,2021-04-26,EMR,27530,12786,14744,873,244,80,17,1254,8825,5553,10401,136,147,18387,9143,ITH,ITH5,8,Emilia-Romagna,Emilia-Romagna,4459477,84488,1.89,0.62
1010,2021-03-20,EMR,16043,6814,9229,702,385,98,832,57,2957,9339,941,578,154,9109,6934,ITH,ITH5,8,Emilia-Romagna,Emilia-Romagna,4459477,100531,2.25,0.36
1011,2021-04-06,EMR,24583,11099,13484,639,206,187,410,239,5953,11504,5211,86,148,19853,4730,ITH,ITH5,8,Emilia-Romagna,Emilia-Romagna,4459477,125114,2.81,0.55
1012,2021-03-05,EMR,17629,5736,11893,3087,855,272,5943,59,40,6397,109,544,323,14192,3437,ITH,ITH5,8,Emilia-Romagna,Emilia-Romagna,4459477,142743,3.2,0.4
1013,2021-01-11,EMR,9333,3269,6064,6581,1347,1267,0,25,5,4,0,0,104,9333,0,ITH,ITH5,8,Emilia-Romagna,Emilia-Romagna,4459477,152076,3.41,0.21
1014,2021-01-25,EMR,6435,2137,4298,5252,317,679,0,21,2,3,0,0,161,201,6234,ITH,ITH5,8,Emilia-Romagna,Emilia-Romagna,4459477,158511,3.55,0.14
1015,2021-04-11,EMR,15112,6863,8249,405,136,104,59,355,2369,6818,4675,77,114,12080,3032,ITH,ITH5,8,Emilia-Romagna,Emilia-Romagna,4459477,173623,3.89,0.34
1016,2021-01-30,EMR,10075,3518,6557,7566,1400,801,0,45,5,2,0,0,256,142,9933,ITH,ITH5,8,Emilia-Romagna,Emilia-Romagna,4459477,183698,4.12,0.23
1017,2021-01-21,EMR,2155,727,1428,1286,156,653,0,9,1,0,0,0,50,810,1345,ITH,ITH5,8,Emilia-Romagna,Emilia-Romagna,4459477,185853,4.17,0.05
1018,2021-04-17,EMR,26954,12896,14058,390,148,66,57,352,8428,4204,13225,23,61,17683,9271,ITH,ITH5,8,Emilia-Romagna,Emilia-Romagna,4459477,212807,4.77,0.6
1019,2021-03-10,EMR,18670,7649,11021,1315,586,143,4540,28,66,10045,285,1594,68,13031,5639,ITH,ITH5,8,Emilia-Romagna,Emilia-Romagna,4459477,231477,5.19,0.42
1020,2021-04-18,EMR,17384,8335,9049,265,163,152,26,212,6250,2345,7936,14,21,12514,4870,ITH,ITH5,8,Emilia-Romagna,Emilia-Romagna,4459477,248861,5.58,0.39
1021,2021-03-06,EMR,20550,5869,14681,2716,412,49,10395,66,46,5920,111,565,270,17825,2725,ITH,ITH5,8,Emilia-Romagna,Emilia-Romagna,4459477,269411,6.04,0.46
1022,2021-04-22,EMR,28874,13364,15510,563,133,146,41,281,8346,8358,10956,13,37,14885,13989,ITH,ITH5,8,Emilia-Romagna,Emilia-Romagna,4459477,298285,6.69,0.65
1023,2021-04-04,EMR,9884,4718,5166,187,113,0,58,145,1630,4658,2876,54,163,7615,2269,ITH,ITH5,8,Emilia-Romagna,Emilia-Romagna,4459477,308169,6.91,0.22
1024,2021-03-16,EMR,12217,5013,7204,418,93,116,123,34,113,10890,391,9,30,4934,7283,ITH,ITH5,8,Emilia-Romagna,Emilia-Romagna,4459477,320386,7.18,0.27
1025,2021-01-22,EMR,1828,477,1351,942,66,722,0,19,1,10,0,0,68,1088,740,ITH,ITH5,8,Emilia-Romagna,Emilia-Romagna,4459477,322214,7.23,0.04
1026,2021-04-21,EMR,23682,10854,12828,382,89,79,48,202,7835,6701,8320,7,19,14064,9618,ITH,ITH5,8,Emilia-Romagna,Emilia-Romagna,4459477,345896,7.76,0.53
1027,2021-04-13,EMR,23460,10999,12461,469,144,186,51,345,10324,6107,5713,50,71,19185,4275,ITH,ITH5,8,Emilia-Romagna,Emilia-Romagna,4459477,369356,8.28,0.53
1028,2021-02-02,EMR,9475,3047,6428,6241,1347,1632,1,27,4,127,6,0,90,526,8949,ITH,ITH5,8,Emilia-Romagna,Emilia-Romagna,4459477,378831,8.49,0.21
1029,2021-03-14,EMR,8692,3744,4948,729,212,69,926,16,66,5530,650,407,87,4896,3796,ITH,ITH5,8,Emilia-Romagna,Emilia-Romagna,4459477,387523,8.69,0.19
1030,2021-01-31,EMR,7695,2761,4934,6174,1124,263,0,16,12,32,0,0,74,242,7453,ITH,ITH5,8,Emilia-Romagna,Emilia-Romagna,4459477,395218,8.86,0.17
1031,2021-03-17,EMR,13692,5686,8006,361,137,108,19,52,399,11871,667,1,77,5864,7828,ITH,ITH5,8,Emilia-Romagna,Emilia-Romagna,4459477,408910,9.17,0.31
1032,2021-01-06,EMR,8263,2943,5320,6853,641,648,0,13,9,44,0,1,54,8263,0,ITH,ITH5,8,Emilia-Romagna,Emilia-Romagna,4459477,417173,9.35,0.19
1033,2021-04-03,EMR,19924,8759,11165,376,192,39,428,194,2855,10577,5082,76,105,16186,3738,ITH,ITH5,8,Emilia-Romagna,Emilia-Romagna,4459477,437097,9.8,0.45
1034,2021-02-25,EMR,9227,3496,5731,799,187,157,95,47,41,7672,30,0,199,8272,955,ITH,ITH5,8,Emilia-Romagna,Emilia-Romagna,4459477,446324,10.01,0.21
1035,2021-04-24,EMR,28527,13194,15333,498,249,37,37,383,7204,8586,11409,33,91,14337,14190,ITH,ITH5,8,Emilia-Romagna,Emilia-Romagna,4459477,474851,10.65,0.64
1036,2021-01-26,EMR,8334,3000,5334,6609,537,1031,0,22,2,5,0,0,128,215,8119,ITH,ITH5,8,Emilia-Romagna,Emilia-Romagna,4459477,483185,10.84,0.19
1037,2021-02-04,EMR,9929,3201,6728,6435,1464,1675,0,39,11,160,5,0,140,1251,8678,ITH,ITH5,8,Emilia-Romagna,Emilia-Romagna,4459477,493114,11.06,0.22
1038,2021-04-27,EMR,29379,13561,15818,803,158,93,26,3318,7729,7030,9884,180,158,17151,12228,ITH,ITH5,8,Emilia-Romagna,Emilia-Romagna,4459477,522493,11.72,0.66
1039,2021-03-15,EMR,13222,6058,7164,812,461,190,531,25,101,9158,809,1075,60,6727,6495,ITH,ITH5,8,Emilia-Romagna,Emilia-Romagna,4459477,535715,12.01,0.3
1040,2021-03-29,EMR,21100,9391,11709,694,192,118,640,127,5483,9292,4245,204,105,16494,4606,ITH,ITH5,8,Emilia-Romagna,Emilia-Romagna,4459477,556815,12.49,0.47
1041,2021-01-12,EMR,9409,3111,6298,6377,1182,1690,0,31,2,32,0,0,95,9409,0,ITH,ITH5,8,Emilia-Romagna,Emilia-Romagna,4459477,566224,12.7,0.21
1042,2021-01-10,EMR,7130,2665,4465,5647,952,499,1,4,1,7,0,0,19,7130,0,ITH,ITH5,8,Emilia-Romagna,Emilia-Romagna,4459477,573354,12.86,0.16
1043,2021-03-21,EMR,11908,5266,6642,566,356,114,587,31,2734,6116,803,497,104,7304,4604,ITH,ITH5,8,Emilia-Romagna,Emilia-Romagna,4459477,585262,13.12,0.27
1044,2021-01-13,EMR,9070,2939,6131,6008,916,1745,1,39,12,91,0,0,258,9070,0,ITH,ITH5,8,Emilia-Romagna,Emilia-Romagna,4459477,594332,13.33,0.2
1045,2021-04-23,EMR,29232,13657,15575,499,113,112,54,288,7132,8913,12071,20,30,14578,14654,ITH,ITH5,8,Emilia-Romagna,Emilia-Romagna,4459477,623564,13.98,0.66
1046,2021-02-06,EMR,7598,2405,5193,5379,862,1221,0,13,4,51,0,1,67,2130,5468,ITH,ITH5,8,Emilia-Romagna,Emilia-Romagna,4459477,631162,14.15,0.17
1047,2021-02-26,EMR,7851,2989,4862,1060,360,258,312,24,28,5595,60,0,154,6805,1046,ITH,ITH5,8,Emilia-Romagna,Emilia-Romagna,4459477,639013,14.33,0.18
1048,2021-04-16,EMR,28642,13477,15165,612,149,90,71,368,10470,5813,10933,34,102,19871,8771,ITH,ITH5,8,Emilia-Romagna,Emilia-Romagna,4459477,667655,14.97,0.64
1049,2021-05-01,EMR,28229,12697,15532,593,138,9,52,4424,5015,6052,11904,19,23,15533,12696,ITH,ITH5,8,Emilia-Romagna,Emilia-Romagna,4459477,695884,15.6,0.63
1050,2021-02-05,EMR,9313,2966,6347,6217,1148,1611,1,19,9,223,3,0,82,1637,7676,ITH,ITH5,8,Emilia-Romagna,Emilia-Romagna,4459477,705197,15.81,0.21
1051,2021-01-24,EMR,2443,885,1558,2080,93,249,0,5,1,0,0,0,15,299,2144,ITH,ITH5,8,Emilia-Romagna,Emilia-Romagna,4459477,707640,15.87,0.05
1052,2021-04-02,EMR,23192,10439,12753,727,312,104,944,340,3799,10955,5697,227,87,18736,4456,ITH,ITH5,8,Emilia-Romagna,Emilia-Romagna,4459477,730832,16.39,0.52
1053,2021-02-13,EMR,3623,1085,2538,2789,382,144,0,8,7,244,0,0,49,3025,598,ITH,ITH5,8,Emilia-Romagna,Emilia-Romagna,4459477,734455,16.47,0.08
1054,2021-03-23,EMR,18690,8062,10628,1126,486,196,1362,80,3704,9340,1866,437,93,12004,6686,ITH,ITH5,8,Emilia-Romagna,Emilia-Romagna,4459477,753145,16.89,0.42
1055,2021-03-04,EMR,16393,5338,11055,2611,604,254,5438,50,55,6405,163,511,302,13390,3003,ITH,ITH5,8,Emilia-Romagna,Emilia-Romagna,4459477,769538,17.26,0.37
1056,2021-03-22,EMR,17451,7643,9808,1135,426,169,600,50,3597,9567,1242,587,78,10587,6864,ITH,ITH5,8,Emilia-Romagna,Emilia-Romagna,4459477,786989,17.65,0.39
1057,2021-04-10,EMR,20797,9241,11556,513,209,88,188,191,4087,8926,6500,24,71,16671,4126,ITH,ITH5,8,Emilia-Romagna,Emilia-Romagna,4459477,807786,18.11,0.47
1058,2021-03-24,EMR,21024,9284,11740,1215,377,124,1709,269,3449,10636,2700,394,151,13653,7371,ITH,ITH5,8,Emilia-Romagna,Emilia-Romagna,4459477,828810,18.59,0.47
1059,2021-04-29,EMR,44365,20882,23483,1387,255,79,64,7174,7517,8588,18862,70,369,27081,17284,ITH,ITH5,8,Emilia-Romagna,Emilia-Romagna,4459477,873175,19.58,0.99
1060,2021-02-08,EMR,5227,1532,3695,2840,577,1485,1,10,8,247,0,0,59,2313,2914,ITH,ITH5,8,Emilia-Romagna,Emilia-Romagna,4459477,878402,19.7,0.12
1061,2021-04-08,EMR,30609,14028,16581,2477,571,222,312,402,6640,11025,8591,135,234,25333,5276,ITH,ITH5,8,Emilia-Romagna,Emilia-Romagna,4459477,909011,20.38,0.69
1062,2021-02-22,EMR,7481,3091,4390,389,110,130,0,12,25,6797,9,0,9,7206,275,ITH,ITH5,8,Emilia-Romagna,Emilia-Romagna,4459477,916492,20.55,0.17
1063,2021-04-19,EMR,20800,9742,11058,328,108,164,25,169,8519,3396,8030,21,40,14551,6249,ITH,ITH5,8,Emilia-Romagna,Emilia-Romagna,4459477,937292,21.02,0.47
1064,2021-02-01,EMR,10318,3609,6709,7472,1502,1260,0,13,7,0,0,0,64,363,9955,ITH,ITH5,8,Emilia-Romagna,Emilia-Romagna,4459477,947610,21.25,0.23
1065,2021-02-03,EMR,9338,2991,6347,6239,1177,1653,0,29,15,126,7,1,91,972,8366,ITH,ITH5,8,Emilia-Romagna,Emilia-Romagna,4459477,956948,21.46,0.21
1066,2021-01-16,EMR,5595,1717,3878,3689,690,1110,1,18,2,0,0,3,82,5595,0,ITH,ITH5,8,Emilia-Romagna,Emilia-Romagna,4459477,962543,21.58,0.13
1067,2021-03-12,EMR,18069,7527,10542,1584,898,311,3026,47,73,9902,461,1554,213,11352,6717,ITH,ITH5,8,Emilia-Romagna,Emilia-Romagna,4459477,980612,21.99,0.41
1068,2021-04-01,EMR,23744,10683,13061,1019,267,118,994,217,4250,11282,5327,170,100,19282,4462,ITH,ITH5,8,Emilia-Romagna,Emilia-Romagna,4459477,1004356,22.52,0.53
1069,2021-01-19,EMR,2045,505,1540,747,133,1161,0,0,0,0,0,0,4,2028,17,ITH,ITH5,8,Emilia-Romagna,Emilia-Romagna,4459477,1006401,22.57,0.05
1070,2021-01-18,EMR,3126,879,2247,1681,239,1129,0,12,0,3,0,0,62,2449,677,ITH,ITH5,8,Emilia-Romagna,Emilia-Romagna,4459477,1009527,22.64,0.07
1071,2021-01-03,EMR,2754,941,1813,2504,61,170,0,3,0,0,0,0,16,2754,0,ITH,ITH5,8,Emilia-Romagna,Emilia-Romagna,4459477,1012281,22.7,0.06
1072,2021-01-04,EMR,7269,2514,4755,6172,350,578,0,16,9,43,0,1,100,7269,0,ITH,ITH5,8,Emilia-Romagna,Emilia-Romagna,4459477,1019550,22.86,0.16
1073,2021-03-08,EMR,12019,4965,7054,2306,614,324,2342,19,39,4339,82,1810,144,9349,2670,ITH,ITH5,8,Emilia-Romagna,Emilia-Romagna,4459477,1031569,23.13,0.27
1074,2021-01-15,EMR,7743,2403,5340,5303,946,1319,1,15,11,61,0,0,87,7743,0,ITH,ITH5,8,Emilia-Romagna,Emilia-Romagna,4459477,1039312,23.31,0.17
1075,2021-03-30,EMR,23259,10285,12974,871,246,164,1178,125,5417,10712,4289,140,117,18227,5032,ITH,ITH5,8,Emilia-Romagna,Emilia-Romagna,4459477,1062571,23.83,0.52
1076,2021-05-04,EMR,27426,12951,14475,577,131,45,56,5958,4741,6170,9644,37,67,14146,13280,ITH,ITH5,8,Emilia-Romagna,Emilia-Romagna,4459477,1089997,24.44,0.62
1077,2021-01-29,EMR,10410,3496,6914,8108,1084,1060,1,32,7,11,0,0,107,290,10120,ITH,ITH5,8,Emilia-Romagna,Emilia-Romagna,4459477,1100407,24.68,0.23
1078,2021-05-02,EMR,25122,11447,13675,567,118,63,58,5152,4463,5918,8652,95,36,13407,11715,ITH,ITH5,8,Emilia-Romagna,Emilia-Romagna,4459477,1125529,25.24,0.56
1079,2021-02-12,EMR,5320,1679,3641,3400,772,704,0,10,19,359,11,0,45,3917,1403,ITH,ITH5,8,Emilia-Romagna,Emilia-Romagna,4459477,1130849,25.36,0.12
1080,2021-04-09,EMR,25346,11501,13845,1367,275,196,433,263,4863,10664,7171,83,31,19697,5649,ITH,ITH5,8,Emilia-Romagna,Emilia-Romagna,4459477,1156195,25.93,0.57
1081,2021-04-15,EMR,28759,13687,15072,940,207,141,50,302,10033,5795,11133,34,124,19170,9589,ITH,ITH5,8,Emilia-Romagna,Emilia-Romagna,4459477,1184954,26.57,0.64
1082,2021-03-01,EMR,10084,3573,6511,1835,340,434,1254,25,37,5619,65,311,164,7831,2253,ITH,ITH5,8,Emilia-Romagna,Emilia-Romagna,4459477,1195038,26.8,0.23
1083,2021-04-30,EMR,36332,16657,19675,1254,254,118,100,5612,7375,7504,13745,79,291,21630,14702,ITH,ITH5,8,Emilia-Romagna,Emilia-Romagna,4459477,1231370,27.61,0.81
1084,2021-02-18,EMR,7039,2892,4147,894,180,236,0,4,13,5672,26,1,13,6456,583,ITH,ITH5,8,Emilia-Romagna,Emilia-Romagna,4459477,1238409,27.77,0.16
1085,2021-03-31,EMR,24930,10858,14072,1170,286,123,1286,185,4675,12375,4535,160,135,19511,5419,ITH,ITH5,8,Emilia-Romagna,Emilia-Romagna,4459477,1263339,28.33,0.56
1086,2021-01-09,EMR,9941,3439,6502,7865,1067,889,0,18,2,2,0,0,98,9941,0,ITH,ITH5,8,Emilia-Romagna,Emilia-Romagna,4459477,1273280,28.55,0.22
1087,2021-02-17,EMR,6538,2764,3774,804,258,404,0,10,15,4990,24,0,33,5765,773,ITH,ITH5,8,Emilia-Romagna,Emilia-Romagna,4459477,1279818,28.7,0.15
1088,2021-02-16,EMR,5766,2443,3323,745,339,437,0,8,7,4207,8,2,13,5235,531,ITH,ITH5,8,Emilia-Romagna,Emilia-Romagna,4459477,1285584,28.83,0.13
1089,2021-01-08,EMR,10835,3569,7266,8466,1135,1089,1,25,3,5,0,1,110,10835,0,ITH,ITH5,8,Emilia-Romagna,Emilia-Romagna,4459477,1296419,29.07,0.24
1090,2021-02-24,EMR,9320,3555,5765,651,156,228,63,50,29,7854,19,0,270,8443,877,ITH,ITH5,8,Emilia-Romagna,Emilia-Romagna,4459477,1305739,29.28,0.21
1091,2021-02-27,EMR,10958,3996,6962,1731,245,116,940,37,30,7755,8,0,96,9220,1738,ITH,ITH5,8,Emilia-Romagna,Emilia-Romagna,4459477,1316697,29.53,0.25
1092,2021-02-19,EMR,7327,3010,4317,821,214,257,0,4,18,5959,33,0,21,6813,514,ITH,ITH5,8,Emilia-Romagna,Emilia-Romagna,4459477,1324024,29.69,0.16
1093,2021-04-25,EMR,22176,10165,12011,773,129,6,32,249,6800,4097,9789,160,141,14749,7427,ITH,ITH5,8,Emilia-Romagna,Emilia-Romagna,4459477,1346200,30.19,0.5
1094,2021-05-03,EMR,27544,12998,14546,463,105,44,93,8649,5095,4678,8319,24,74,16707,10837,ITH,ITH5,8,Emilia-Romagna,Emilia-Romagna,4459477,1373744,30.81,0.62
1095,2021-04-05,EMR,14784,6775,8009,282,87,6,243,74,2910,7538,3578,28,38,11901,2883,ITH,ITH5,8,Emilia-Romagna,Emilia-Romagna,4459477,1388528,31.14,0.33
1096,2021-02-21,EMR,4450,1708,2742,396,108,190,0,4,11,3708,18,0,15,4010,440,ITH,ITH5,8,Emilia-Romagna,Emilia-Romagna,4459477,1392978,31.24,0.1
1097,2021-04-28,EMR,32281,14923,17358,850,144,118,147,5094,7169,6737,11706,42,274,19448,12833,ITH,ITH5,8,Emilia-Romagna,Emilia-Romagna,4459477,1425259,31.96,0.72
1098,2021-02-14,EMR,1401,378,1023,860,363,39,0,19,5,19,1,0,95,1281,120,ITH,ITH5,8,Emilia-Romagna,Emilia-Romagna,4459477,1426660,31.99,0.03
1099,2021-02-28,EMR,6822,2527,4295,1775,248,53,304,29,17,4251,8,4,133,4977,1845,ITH,ITH5,8,Emilia-Romagna,Emilia-Romagna,4459477,1433482,32.14,0.15
1100,2021-03-26,EMR,23391,9891,13500,1421,600,233,2642,174,4779,9342,3786,278,136,16960,6431,ITH,ITH5,8,Emilia-Romagna,Emilia-Romagna,4459477,1456873,32.67,0.52
1101,2021-02-09,EMR,4151,1246,2905,2219,376,1198,0,2,15,278,0,0,63,2306,1845,ITH,ITH5,8,Emilia-Romagna,Emilia-Romagna,4459477,1461024,32.76,0.09
1102,2021-01-20,EMR,1322,269,1053,392,131,787,0,0,0,1,0,0,11,1321,1,ITH,ITH5,8,Emilia-Romagna,Emilia-Romagna,4459477,1462346,32.79,0.03
1103,2021-01-02,EMR,2352,905,1447,2074,57,198,0,3,0,2,0,0,18,2352,0,ITH,ITH5,8,Emilia-Romagna,Emilia-Romagna,4459477,1464698,32.84,0.05
1104,2020-12-27,EMR,969,372,597,824,5,26,0,24,1,0,0,0,89,969,0,ITH,ITH5,8,Emilia-Romagna,Emilia-Romagna,4459477,1465667,32.87,0.02
1105,2021-04-20,EMR,22443,10319,12124,301,83,58,30,205,7736,5559,8430,21,20,14154,8289,ITH,ITH5,8,Emilia-Romagna,Emilia-Romagna,4459477,1488110,33.37,0.5
1106,2021-01-05,EMR,9347,3167,6180,7929,552,769,0,18,4,0,1,0,74,9347,0,ITH,ITH5,8,Emilia-Romagna,Emilia-Romagna,4459477,1497457,33.58,0.21
1107,2021-03-11,EMR,17209,7111,10098,1134,837,319,3830,35,52,8851,425,1532,194,11357,5852,ITH,ITH5,8,Emilia-Romagna,Emilia-Romagna,4459477,1514666,33.97,0.39
1108,2021-03-18,EMR,13660,5801,7859,449,150,94,49,47,472,10843,1358,5,193,5663,7997,ITH,ITH5,8,Emilia-Romagna,Emilia-Romagna,4459477,1528326,34.27,0.31
1109,2021-01-07,EMR,10217,3385,6832,8189,855,1068,0,20,5,3,0,0,77,10217,0,ITH,ITH5,8,Emilia-Romagna,Emilia-Romagna,4459477,1538543,34.5,0.23
1110,2021-02-23,EMR,8214,3218,4996,409,147,113,1,24,22,7455,23,0,20,7828,386,ITH,ITH5,8,Emilia-Romagna,Emilia-Romagna,4459477,1546757,34.68,0.18
1111,2021-04-07,EMR,25658,11658,14000,662,187,143,360,370,5587,12952,5219,78,100,19680,5978,ITH,ITH5,8,Emilia-Romagna,Emilia-Romagna,4459477,1572415,35.26,0.58
1112,2021-01-28,EMR,10241,3336,6905,8075,860,1126,0,28,10,0,0,0,142,351,9890,ITH,ITH5,8,Emilia-Romagna,Emilia-Romagna,4459477,1582656,35.49,0.23
1113,2021-03-03,EMR,15786,5235,10551,2533,524,154,4838,50,48,6848,95,342,354,13326,2460,ITH,ITH5,8,Emilia-Romagna,Emilia-Romagna,4459477,1598442,35.84,0.35
1114,2021-03-07,EMR,6851,2636,4215,1459,338,22,1250,10,14,2597,565,560,36,5334,1517,ITH,ITH5,8,Emilia-Romagna,Emilia-Romagna,4459477,1605293,36.0,0.15
1115,2021-01-23,EMR,2446,870,1576,1902,86,430,0,5,1,2,0,0,20,443,2003,ITH,ITH5,8,Emilia-Romagna,Emilia-Romagna,4459477,1607739,36.05,0.05
1116,2021-03-02,EMR,11811,3888,7923,1973,409,229,3047,42,40,5419,41,373,238,9790,2021,ITH,ITH5,8,Emilia-Romagna,Emilia-Romagna,4459477,1619550,36.32,0.26
1117,2021-01-14,EMR,8096,2576,5520,5398,920,1607,0,39,7,5,1,1,118,8096,0,ITH,ITH5,8,Emilia-Romagna,Emilia-Romagna,4459477,1627646,36.5,0.18
1118,2021-02-11,EMR,4246,1414,2832,2529,528,719,2,15,18,374,3,0,58,3407,839,ITH,ITH5,8,Emilia-Romagna,Emilia-Romagna,4459477,1631892,36.59,0.1
1119,2021-04-14,EMR,26733,12695,14038,654,193,138,71,527,10048,7356,7670,54,22,20697,6036,ITH,ITH5,8,Emilia-Romagna,Emilia-Romagna,4459477,1658625,37.19,0.6
1120,2021-03-13,EMR,16042,6298,9744,1251,479,81,3990,49,55,8277,567,1124,169,10730,5312,ITH,ITH5,8,Emilia-Romagna,Emilia-Romagna,4459477,1674667,37.55,0.36
1121,2021-03-25,EMR,21358,9331,12027,1101,351,165,2089,156,3063,9931,3622,724,156,14373,6985,ITH,ITH5,8,Emilia-Romagna,Emilia-Romagna,4459477,1696025,38.03,0.48
1122,2021-03-27,EMR,21516,9003,12513,754,293,48,2337,117,4192,9566,3817,237,155,14626,6890,ITH,ITH5,8,Emilia-Romagna,Emilia-Romagna,4459477,1717541,38.51,0.48
1123,2021-03-09,EMR,14617,5945,8672,1028,456,228,3566,21,56,7702,185,1332,43,10661,3956,ITH,ITH5,8,Emilia-Romagna,Emilia-Romagna,4459477,1732158,38.84,0.33
1124,2021-02-10,EMR,4012,1378,2634,2396,357,779,0,23,15,317,9,0,116,2759,1253,ITH,ITH5,8,Emilia-Romagna,Emilia-Romagna,4459477,1736170,38.93,0.09
1125,2021-01-27,EMR,8359,2947,5412,6907,653,672,0,26,4,2,0,1,94,464,7895,ITH,ITH5,8,Emilia-Romagna,Emilia-Romagna,4459477,1744529,39.12,0.19
1126,2021-02-20,EMR,5317,2094,3223,408,116,155,0,7,21,4591,5,0,14,5053,264,ITH,ITH5,8,Emilia-Romagna,Emilia-Romagna,4459477,1749846,39.24,0.12
1127,2021-02-15,EMR,2899,849,2050,1984,369,160,0,3,9,326,18,0,30,2773,126,ITH,ITH5,8,Emilia-Romagna,Emilia-Romagna,4459477,1752745,39.3,0.07
1128,2021-01-17,ABR,187,59,128,136,44,0,0,0,0,0,0,0,7,180,7,ITF,ITF1,13,Abruzzo,Abruzzo,1304970,187,0.01,0.01
1129,2021-03-17,ABR,4545,1876,2669,285,102,144,11,19,33,3876,16,36,23,2802,1743,ITF,ITF1,13,Abruzzo,Abruzzo,1304970,4732,0.36,0.35
1130,2021-02-28,ABR,1708,511,1197,23,6,0,1423,8,1,79,0,149,19,1706,2,ITF,ITF1,13,Abruzzo,Abruzzo,1304970,6440,0.49,0.13
1131,2021-02-09,ABR,908,311,597,612,161,131,0,1,1,1,0,0,1,499,409,ITF,ITF1,13,Abruzzo,Abruzzo,1304970,7348,0.56,0.07
1132,2021-02-04,ABR,1682,617,1065,1168,415,57,0,5,0,0,0,0,37,609,1073,ITF,ITF1,13,Abruzzo,Abruzzo,1304970,9030,0.69,0.13
1133,2021-04-06,ABR,7689,3583,4106,433,98,44,54,115,499,2350,3944,46,106,5369,2320,ITF,ITF1,13,Abruzzo,Abruzzo,1304970,16719,1.28,0.59
1134,2021-01-23,ABR,264,114,150,224,14,26,0,0,0,0,0,0,0,57,207,ITF,ITF1,13,Abruzzo,Abruzzo,1304970,16983,1.3,0.02
1135,2021-04-26,ABR,8569,4070,4499,138,104,131,20,1663,2915,1078,2329,38,153,7350,1219,ITF,ITF1,13,Abruzzo,Abruzzo,1304970,25552,1.96,0.66
1136,2021-03-22,ABR,4289,1853,2436,385,389,56,442,32,19,2578,10,234,144,2319,1970,ITF,ITF1,13,Abruzzo,Abruzzo,1304970,29841,2.29,0.33
1137,2021-01-21,ABR,157,47,110,10,6,141,0,0,0,0,0,0,0,157,0,ITF,ITF1,13,Abruzzo,Abruzzo,1304970,29998,2.3,0.01
1138,2021-03-28,ABR,2422,1021,1401,247,132,1,175,106,54,896,422,242,147,2050,372,ITF,ITF1,13,Abruzzo,Abruzzo,1304970,32420,2.48,0.19
1139,2021-02-07,ABR,777,307,470,646,111,1,0,3,0,0,0,0,16,201,576,ITF,ITF1,13,Abruzzo,Abruzzo,1304970,33197,2.54,0.06
1140,2021-03-29,ABR,5627,2525,3102,463,54,49,195,71,73,3616,907,63,136,2987,2640,ITF,ITF1,13,Abruzzo,Abruzzo,1304970,38824,2.98,0.43
1141,2021-03-19,ABR,5797,2584,3213,756,280,118,13,14,42,4400,19,103,52,2776,3021,ITF,ITF1,13,Abruzzo,Abruzzo,1304970,44621,3.42,0.44
1142,2021-02-15,ABR,1796,831,965,625,258,221,0,0,10,395,0,261,26,1754,42,ITF,ITF1,13,Abruzzo,Abruzzo,1304970,46417,3.56,0.14
1143,2021-02-21,ABR,1221,551,670,2,0,3,0,0,2,1210,0,2,2,1220,1,ITF,ITF1,13,Abruzzo,Abruzzo,1304970,47638,3.65,0.09
1144,2021-01-22,ABR,118,57,61,2,1,112,0,1,0,0,0,0,2,118,0,ITF,ITF1,13,Abruzzo,Abruzzo,1304970,47756,3.66,0.01
1145,2021-02-26,ABR,3920,1671,2249,1025,336,160,262,64,11,1651,6,270,135,2951,969,ITF,ITF1,13,Abruzzo,Abruzzo,1304970,51676,3.96,0.3
1146,2021-04-30,ABR,12195,5711,6484,345,140,74,99,1990,2803,1098,5375,33,238,6627,5568,ITF,ITF1,13,Abruzzo,Abruzzo,1304970,63871,4.89,0.93
1147,2021-02-12,ABR,1228,567,661,438,151,310,0,1,0,66,0,260,2,1039,189,ITF,ITF1,13,Abruzzo,Abruzzo,1304970,65099,4.99,0.09
1148,2021-03-06,ABR,4175,1354,2821,433,187,52,1559,29,8,1748,0,15,144,3605,570,ITF,ITF1,13,Abruzzo,Abruzzo,1304970,69274,5.31,0.32
1149,2021-01-12,ABR,1804,666,1138,1470,190,0,0,23,33,28,0,0,60,1804,0,ITF,ITF1,13,Abruzzo,Abruzzo,1304970,71078,5.45,0.14
1150,2021-03-21,ABR,2136,914,1222,9,0,1,130,7,9,1924,13,34,9,844,1292,ITF,ITF1,13,Abruzzo,Abruzzo,1304970,73214,5.61,0.16
1151,2021-03-05,ABR,5263,1938,3325,561,218,108,1353,77,4,2582,2,232,126,4565,698,ITF,ITF1,13,Abruzzo,Abruzzo,1304970,78477,6.01,0.4
1152,2021-03-18,ABR,3896,1651,2245,281,135,20,7,21,33,3297,4,68,30,2065,1831,ITF,ITF1,13,Abruzzo,Abruzzo,1304970,82373,6.31,0.3
1153,2021-02-13,ABR,851,384,467,554,207,72,0,1,1,8,0,0,8,437,414,ITF,ITF1,13,Abruzzo,Abruzzo,1304970,83224,6.38,0.07
1154,2021-03-01,ABR,3490,1393,2097,698,176,174,282,18,10,1915,2,131,84,2725,765,ITF,ITF1,13,Abruzzo,Abruzzo,1304970,86714,6.64,0.27
1155,2021-04-22,ABR,6668,3193,3475,83,46,116,28,313,2116,921,2870,37,138,4984,1684,ITF,ITF1,13,Abruzzo,Abruzzo,1304970,93382,7.16,0.51
1156,2021-03-03,ABR,4629,1883,2746,1222,211,105,855,28,0,1587,3,385,233,3723,906,ITF,ITF1,13,Abruzzo,Abruzzo,1304970,98011,7.51,0.35
1157,2021-04-17,ABR,7348,3399,3949,349,251,23,65,192,454,2264,3666,32,52,4295,3053,ITF,ITF1,13,Abruzzo,Abruzzo,1304970,105359,8.07,0.56
1158,2020-12-27,ABR,37,19,18,34,1,2,0,0,0,0,0,0,0,37,0,ITF,ITF1,13,Abruzzo,Abruzzo,1304970,105396,8.08,0.0
1159,2021-03-08,ABR,5128,1670,3458,1190,280,116,2195,51,3,1032,0,105,156,4153,975,ITF,ITF1,13,Abruzzo,Abruzzo,1304970,110524,8.47,0.39
1160,2021-03-31,ABR,6657,2884,3773,446,279,80,245,54,83,3259,2048,30,133,4589,2068,ITF,ITF1,13,Abruzzo,Abruzzo,1304970,117181,8.98,0.51
1161,2021-03-10,ABR,4951,1640,3311,736,300,248,1872,27,4,1520,11,130,103,3994,957,ITF,ITF1,13,Abruzzo,Abruzzo,1304970,122132,9.36,0.38
1162,2021-02-23,ABR,2784,1274,1510,324,184,217,100,4,8,1491,2,287,167,2773,11,ITF,ITF1,13,Abruzzo,Abruzzo,1304970,124916,9.57,0.21
1163,2021-04-19,ABR,6231,2860,3371,76,74,36,22,148,2251,1259,2221,26,118,3858,2373,ITF,ITF1,13,Abruzzo,Abruzzo,1304970,131147,10.05,0.48
1164,2021-04-18,ABR,5817,2727,3090,149,71,25,19,76,169,964,4306,13,25,4875,942,ITF,ITF1,13,Abruzzo,Abruzzo,1304970,136964,10.5,0.45
1165,2021-03-04,ABR,5937,2359,3578,1171,322,93,818,39,12,2992,5,329,156,5015,922,ITF,ITF1,13,Abruzzo,Abruzzo,1304970,142901,10.95,0.45
1166,2021-04-24,ABR,8716,3974,4742,84,138,137,23,324,1368,1227,5318,21,76,7184,1532,ITF,ITF1,13,Abruzzo,Abruzzo,1304970,151617,11.62,0.67
1167,2021-03-23,ABR,4786,2145,2641,180,183,183,400,14,23,3356,13,356,78,2217,2569,ITF,ITF1,13,Abruzzo,Abruzzo,1304970,156403,11.99,0.37
1168,2021-01-24,ABR,50,22,28,49,1,0,0,0,0,0,0,0,0,6,44,ITF,ITF1,13,Abruzzo,Abruzzo,1304970,156453,11.99,0.0
1169,2021-01-31,ABR,1502,488,1014,1154,236,103,0,1,0,0,0,0,8,287,1215,ITF,ITF1,13,Abruzzo,Abruzzo,1304970,157955,12.1,0.12
1170,2021-01-27,ABR,1364,515,849,1301,61,0,0,1,0,0,0,0,1,39,1325,ITF,ITF1,13,Abruzzo,Abruzzo,1304970,159319,12.21,0.1
1171,2021-03-09,ABR,5173,1796,3377,991,311,86,2046,31,3,1320,69,214,102,4234,939,ITF,ITF1,13,Abruzzo,Abruzzo,1304970,164492,12.61,0.4
1172,2021-01-04,ABR,1401,575,826,1396,5,0,0,0,0,0,0,0,0,1401,0,ITF,ITF1,13,Abruzzo,Abruzzo,1304970,165893,12.71,0.11
1173,2021-03-11,ABR,5430,2191,3239,1328,265,241,1565,50,20,1539,16,247,159,4291,1139,ITF,ITF1,13,Abruzzo,Abruzzo,1304970,171323,13.13,0.42
1174,2021-02-01,ABR,1632,573,1059,1384,228,1,0,3,0,0,0,0,16,271,1361,ITF,ITF1,13,Abruzzo,Abruzzo,1304970,172955,13.25,0.13
1175,2021-01-20,ABR,447,156,291,147,73,204,0,12,0,0,0,0,11,445,2,ITF,ITF1,13,Abruzzo,Abruzzo,1304970,173402,13.29,0.03
1176,2021-04-05,ABR,2698,1151,1547,137,205,4,16,31,41,1372,846,11,35,1818,880,ITF,ITF1,13,Abruzzo,Abruzzo,1304970,176100,13.49,0.21
1177,2021-01-03,ABR,471,185,286,464,7,0,0,0,0,0,0,0,0,471,0,ITF,ITF1,13,Abruzzo,Abruzzo,1304970,176571,13.53,0.04
1178,2021-03-15,ABR,3640,1399,2241,657,358,79,330,27,41,1964,2,55,127,1824,1816,ITF,ITF1,13,Abruzzo,Abruzzo,1304970,180211,13.81,0.28
1179,2021-04-13,ABR,5892,2757,3135,94,63,78,150,86,410,1261,3671,31,48,4691,1201,ITF,ITF1,13,Abruzzo,Abruzzo,1304970,186103,14.26,0.45
1180,2021-04-09,ABR,8744,4113,4631,312,121,32,45,101,807,3287,3903,40,96,6202,2542,ITF,ITF1,13,Abruzzo,Abruzzo,1304970,194847,14.93,0.67
1181,2021-04-07,ABR,7122,3284,3838,187,214,82,15,69,106,3220,3056,96,77,4396,2726,ITF,ITF1,13,Abruzzo,Abruzzo,1304970,201969,15.48,0.55
1182,2021-01-28,ABR,1433,495,938,1370,61,1,0,0,1,0,0,0,0,12,1421,ITF,ITF1,13,Abruzzo,Abruzzo,1304970,203402,15.59,0.11
1183,2021-02-03,ABR,2061,717,1344,1541,362,118,0,4,0,0,0,0,36,419,1642,ITF,ITF1,13,Abruzzo,Abruzzo,1304970,205463,15.74,0.16
1184,2021-01-19,ABR,111,55,56,27,3,50,0,8,0,0,0,0,23,91,20,ITF,ITF1,13,Abruzzo,Abruzzo,1304970,205574,15.75,0.01
1185,2021-03-27,ABR,6120,2620,3500,189,229,48,216,87,157,4264,736,77,117,3641,2479,ITF,ITF1,13,Abruzzo,Abruzzo,1304970,211694,16.22,0.47
1186,2021-05-01,ABR,10734,5046,5688,114,61,41,39,1235,1709,1133,6243,23,136,5757,4977,ITF,ITF1,13,Abruzzo,Abruzzo,1304970,222428,17.04,0.82
1187,2021-01-13,ABR,1253,440,813,1103,99,0,0,7,1,7,0,0,36,1253,0,ITF,ITF1,13,Abruzzo,Abruzzo,1304970,223681,17.14,0.1
1188,2021-03-07,ABR,2523,630,1893,28,99,4,1823,68,10,463,0,1,27,2523,0,ITF,ITF1,13,Abruzzo,Abruzzo,1304970,226204,17.33,0.19
1189,2021-03-24,ABR,6353,2766,3587,485,300,231,430,108,230,3409,541,344,275,4097,2256,ITF,ITF1,13,Abruzzo,Abruzzo,1304970,232557,17.82,0.49
1190,2021-03-30,ABR,5061,2199,2862,211,205,38,286,52,57,2745,1328,51,88,3236,1825,ITF,ITF1,13,Abruzzo,Abruzzo,1304970,237618,18.21,0.39
1191,2021-03-25,ABR,5691,2565,3126,249,211,40,448,59,102,3825,239,311,207,3074,2617,ITF,ITF1,13,Abruzzo,Abruzzo,1304970,243309,18.64,0.44
1192,2021-04-14,ABR,6507,2898,3609,336,94,119,61,84,434,1467,3848,18,46,4429,2078,ITF,ITF1,13,Abruzzo,Abruzzo,1304970,249816,19.14,0.5
1193,2021-03-13,ABR,4254,1460,2794,539,624,138,1061,82,36,1468,6,106,194,3178,1076,ITF,ITF1,13,Abruzzo,Abruzzo,1304970,254070,19.47,0.33
1194,2021-04-04,ABR,1626,766,860,94,57,2,4,8,280,446,718,2,15,1497,129,ITF,ITF1,13,Abruzzo,Abruzzo,1304970,255696,19.59,0.12
1195,2021-03-26,ABR,5292,2258,3034,264,213,37,449,75,122,3389,357,241,145,3231,2061,ITF,ITF1,13,Abruzzo,Abruzzo,1304970,260988,20.0,0.41
1196,2021-04-28,ABR,9505,4583,4922,162,149,74,20,2353,1816,848,3888,35,160,7480,2025,ITF,ITF1,13,Abruzzo,Abruzzo,1304970,270493,20.73,0.73
1197,2021-02-22,ABR,2644,1175,1469,477,275,46,251,4,4,1094,0,419,74,2614,30,ITF,ITF1,13,Abruzzo,Abruzzo,1304970,273137,20.93,0.2
1198,2021-03-12,ABR,6024,1990,4034,1006,593,138,2189,46,11,1727,1,144,169,4441,1583,ITF,ITF1,13,Abruzzo,Abruzzo,1304970,279161,21.39,0.46
1199,2021-04-02,ABR,6689,3097,3592,184,611,26,94,77,215,3308,2044,79,51,5202,1487,ITF,ITF1,13,Abruzzo,Abruzzo,1304970,285850,21.9,0.51
1200,2021-01-16,ABR,928,428,500,711,188,15,0,4,0,0,0,0,10,928,0,ITF,ITF1,13,Abruzzo,Abruzzo,1304970,286778,21.98,0.07
1201,2021-04-10,ABR,8774,4059,4715,390,302,13,147,224,1133,2931,3458,32,144,6266,2508,ITF,ITF1,13,Abruzzo,Abruzzo,1304970,295552,22.65,0.67
1202,2021-02-11,ABR,816,262,554,473,184,154,0,0,0,0,0,0,5,773,43,ITF,ITF1,13,Abruzzo,Abruzzo,1304970,296368,22.71,0.06
1203,2021-03-16,ABR,3486,1453,2033,284,74,169,12,19,44,2850,6,8,20,1831,1655,ITF,ITF1,13,Abruzzo,Abruzzo,1304970,299854,22.98,0.27
1204,2021-04-15,ABR,7751,3614,4137,201,97,92,53,87,331,1567,5245,22,56,5906,1845,ITF,ITF1,13,Abruzzo,Abruzzo,1304970,307605,23.57,0.59
1205,2021-01-06,ABR,1830,664,1166,1546,148,133,0,0,0,0,0,0,3,1830,0,ITF,ITF1,13,Abruzzo,Abruzzo,1304970,309435,23.71,0.14
1206,2021-04-03,ABR,5073,2213,2860,174,91,28,84,73,112,2401,1958,62,90,3479,1594,ITF,ITF1,13,Abruzzo,Abruzzo,1304970,314508,24.1,0.39
1207,2021-01-05,ABR,1614,604,1010,1604,10,0,0,0,0,0,0,0,0,1614,0,ITF,ITF1,13,Abruzzo,Abruzzo,1304970,316122,24.22,0.12
1208,2021-02-08,ABR,1201,398,803,710,218,264,0,1,0,0,0,0,8,491,710,ITF,ITF1,13,Abruzzo,Abruzzo,1304970,317323,24.32,0.09
1209,2021-05-04,ABR,10686,5036,5650,176,116,17,36,1760,2521,356,5309,45,350,7068,3618,ITF,ITF1,13,Abruzzo,Abruzzo,1304970,328009,25.14,0.82
1210,2021-01-18,ABR,122,48,74,106,8,2,0,3,0,0,0,0,3,46,76,ITF,ITF1,13,Abruzzo,Abruzzo,1304970,328131,25.14,0.01
1211,2021-04-01,ABR,5532,2450,3082,274,117,57,153,153,156,2914,1527,48,133,3443,2089,ITF,ITF1,13,Abruzzo,Abruzzo,1304970,333663,25.57,0.42
1212,2021-01-15,ABR,379,149,230,223,79,35,0,7,2,0,0,0,33,379,0,ITF,ITF1,13,Abruzzo,Abruzzo,1304970,334042,25.6,0.03
1213,2021-02-27,ABR,2809,1337,1472,253,84,125,874,17,6,732,1,656,61,2543,266,ITF,ITF1,13,Abruzzo,Abruzzo,1304970,336851,25.81,0.22
1214,2021-02-24,ABR,3304,1440,1864,391,180,248,131,13,12,1969,4,247,109,3128,176,ITF,ITF1,13,Abruzzo,Abruzzo,1304970,340155,26.07,0.25
1215,2021-01-29,ABR,1386,449,937,1290,95,0,0,1,0,0,0,0,0,74,1312,ITF,ITF1,13,Abruzzo,Abruzzo,1304970,341541,26.17,0.11
1216,2021-04-11,ABR,5332,2606,2726,15,8,7,6,93,628,784,3734,6,51,4849,483,ITF,ITF1,13,Abruzzo,Abruzzo,1304970,346873,26.58,0.41
1217,2021-01-25,ABR,1604,633,971,1584,19,0,0,0,0,0,0,0,1,20,1584,ITF,ITF1,13,Abruzzo,Abruzzo,1304970,348477,26.7,0.12
1218,2021-02-17,ABR,2077,952,1125,512,144,394,1,0,22,718,0,210,76,1794,283,ITF,ITF1,13,Abruzzo,Abruzzo,1304970,350554,26.86,0.16
1219,2021-03-20,ABR,4733,2159,2574,318,206,63,97,50,99,3653,45,99,103,2569,2164,ITF,ITF1,13,Abruzzo,Abruzzo,1304970,355287,27.23,0.36
1220,2021-04-12,ABR,6228,2951,3277,217,66,50,36,194,505,1300,3759,20,81,5056,1172,ITF,ITF1,13,Abruzzo,Abruzzo,1304970,361515,27.7,0.48
1221,2021-01-07,ABR,1603,552,1051,1566,37,0,0,0,0,0,0,0,0,1603,0,ITF,ITF1,13,Abruzzo,Abruzzo,1304970,363118,27.83,0.12
1222,2021-01-09,ABR,1483,565,918,1430,50,0,0,1,0,0,0,0,2,1483,0,ITF,ITF1,13,Abruzzo,Abruzzo,1304970,364601,27.94,0.11
1223,2021-01-08,ABR,1525,507,1018,1487,36,0,0,1,1,0,0,0,0,1525,0,ITF,ITF1,13,Abruzzo,Abruzzo,1304970,366126,28.06,0.12
1224,2021-02-18,ABR,2291,934,1357,670,297,417,0,3,5,612,0,215,72,2161,130,ITF,ITF1,13,Abruzzo,Abruzzo,1304970,368417,28.23,0.18
1225,2021-02-19,ABR,3301,1552,1749,990,346,371,8,10,9,1113,1,402,51,3201,100,ITF,ITF1,13,Abruzzo,Abruzzo,1304970,371718,28.48,0.25
1226,2021-02-16,ABR,1978,869,1109,841,278,139,0,4,2,561,0,75,78,1966,12,ITF,ITF1,13,Abruzzo,Abruzzo,1304970,373696,28.64,0.15
1227,2021-01-14,ABR,530,189,341,364,114,0,0,4,5,34,0,0,9,530,0,ITF,ITF1,13,Abruzzo,Abruzzo,1304970,374226,28.68,0.04
1228,2021-01-26,ABR,1542,567,975,1513,29,0,0,0,0,0,0,0,0,29,1513,ITF,ITF1,13,Abruzzo,Abruzzo,1304970,375768,28.8,0.12
1229,2021-04-21,ABR,6386,3101,3285,63,53,13,14,990,1514,1020,2597,9,113,4711,1675,ITF,ITF1,13,Abruzzo,Abruzzo,1304970,382154,29.28,0.49
1230,2021-02-25,ABR,3086,1347,1739,615,398,57,126,28,6,1508,2,262,84,2558,528,ITF,ITF1,13,Abruzzo,Abruzzo,1304970,385240,29.52,0.24
1231,2021-04-29,ABR,12655,5843,6812,286,87,85,109,2847,3182,817,4968,57,217,9557,3098,ITF,ITF1,13,Abruzzo,Abruzzo,1304970,397895,30.49,0.97
1232,2021-02-10,ABR,948,313,635,622,182,116,0,5,0,0,0,0,23,504,444,ITF,ITF1,13,Abruzzo,Abruzzo,1304970,398843,30.56,0.07
1233,2021-02-20,ABR,4782,1843,2939,310,444,193,1887,5,12,1417,1,406,107,4706,76,ITF,ITF1,13,Abruzzo,Abruzzo,1304970,403625,30.93,0.37
1234,2021-04-25,ABR,9067,4617,4450,67,54,22,5,4353,1779,589,2069,19,110,8256,811,ITF,ITF1,13,Abruzzo,Abruzzo,1304970,412692,31.62,0.69
1235,2021-01-10,ABR,1139,409,730,1091,44,0,0,0,0,0,0,0,4,1139,0,ITF,ITF1,13,Abruzzo,Abruzzo,1304970,413831,31.71,0.09
1236,2021-04-27,ABR,9096,4378,4718,115,101,22,34,1768,2361,959,3558,27,151,6624,2472,ITF,ITF1,13,Abruzzo,Abruzzo,1304970,422927,32.41,0.7
1237,2021-05-03,ABR,11105,5239,5866,279,119,65,93,1668,2763,490,5370,21,237,7256,3849,ITF,ITF1,13,Abruzzo,Abruzzo,1304970,434032,33.26,0.85
1238,2021-03-14,ABR,1895,733,1162,8,3,0,249,20,7,1489,0,2,117,1228,667,ITF,ITF1,13,Abruzzo,Abruzzo,1304970,435927,33.41,0.15
1239,2021-04-23,ABR,7354,3376,3978,158,67,122,27,533,1641,1521,3173,14,98,5068,2286,ITF,ITF1,13,Abruzzo,Abruzzo,1304970,443281,33.97,0.56
1240,2021-02-05,ABR,1536,521,1015,1188,188,107,0,9,0,0,0,0,44,789,747,ITF,ITF1,13,Abruzzo,Abruzzo,1304970,444817,34.09,0.12
1241,2021-04-20,ABR,5592,2691,2901,39,83,1,20,326,2182,920,1948,18,55,4181,1411,ITF,ITF1,13,Abruzzo,Abruzzo,1304970,450409,34.51,0.43
1242,2021-04-16,ABR,7542,3491,4051,157,79,46,33,168,271,1685,5048,12,43,5622,1920,ITF,ITF1,13,Abruzzo,Abruzzo,1304970,457951,35.09,0.58
1243,2021-01-30,ABR,1510,567,943,1349,112,47,0,0,0,0,0,0,2,69,1441,ITF,ITF1,13,Abruzzo,Abruzzo,1304970,459461,35.21,0.12
1244,2021-01-02,ABR,548,218,330,540,5,0,0,0,0,0,0,0,3,548,0,ITF,ITF1,13,Abruzzo,Abruzzo,1304970,460009,35.25,0.04
1245,2021-02-06,ABR,1611,742,869,1168,278,72,0,14,7,2,0,0,70,602,1009,ITF,ITF1,13,Abruzzo,Abruzzo,1304970,461620,35.37,0.12
1246,2021-01-11,ABR,1551,557,994,1337,152,48,0,3,0,0,0,0,11,1551,0,ITF,ITF1,13,Abruzzo,Abruzzo,1304970,463171,35.49,0.12
1247,2021-05-02,ABR,10424,5087,5337,149,78,4,20,1155,1683,336,6831,23,145,5216,5208,ITF,ITF1,13,Abruzzo,Abruzzo,1304970,473595,36.29,0.8
1248,2021-03-02,ABR,3964,1676,2288,934,220,53,405,82,3,1857,2,299,109,3280,684,ITF,ITF1,13,Abruzzo,Abruzzo,1304970,477559,36.6,0.3
1249,2021-04-08,ABR,7355,3322,4033,156,84,73,204,70,409,2634,3629,45,51,5074,2281,ITF,ITF1,13,Abruzzo,Abruzzo,1304970,484914,37.16,0.56
1250,2021-02-02,ABR,1798,677,1121,1243,404,142,0,1,0,0,0,0,8,241,1557,ITF,ITF1,13,Abruzzo,Abruzzo,1304970,486712,37.3,0.14
1251,2021-01-30,PAT,386,132,254,346,7,32,1,0,0,0,0,0,0,152,234,ITH,ITH2,4,Provincia Autonoma Trento,P.A. Trento,541380,386,0.07,0.07
1252,2021-03-05,PAT,2229,700,1529,126,70,102,775,5,24,957,1,158,11,1663,566,ITH,ITH2,4,Provincia Autonoma Trento,P.A. Trento,541380,2615,0.48,0.41
1253,2021-01-14,PAT,699,203,496,482,6,208,0,0,0,0,0,0,3,699,0,ITH,ITH2,4,Provincia Autonoma Trento,P.A. Trento,541380,3314,0.61,0.13
1254,2021-01-24,PAT,547,276,271,535,12,0,0,0,0,0,0,0,0,224,323,ITH,ITH2,4,Provincia Autonoma Trento,P.A. Trento,541380,3861,0.71,0.1
1255,2021-03-15,PAT,1410,545,865,58,130,26,175,3,285,624,15,54,40,946,464,ITH,ITH2,4,Provincia Autonoma Trento,P.A. Trento,541380,5271,0.97,0.26
1256,2021-01-21,PAT,351,94,257,320,13,16,0,0,0,0,0,0,2,228,123,ITH,ITH2,4,Provincia Autonoma Trento,P.A. Trento,541380,5622,1.04,0.06
1257,2021-04-29,PAT,4534,2191,2343,77,86,11,20,2461,1199,181,462,2,35,4343,191,ITH,ITH2,4,Provincia Autonoma Trento,P.A. Trento,541380,10156,1.88,0.84
1258,2021-03-04,PAT,2351,790,1561,161,26,23,347,14,12,1727,0,19,22,1572,779,ITH,ITH2,4,Provincia Autonoma Trento,P.A. Trento,541380,12507,2.31,0.43
1259,2021-03-21,PAT,129,69,60,34,1,0,18,2,18,0,56,0,0,129,0,ITH,ITH2,4,Provincia Autonoma Trento,P.A. Trento,541380,12636,2.33,0.02
1260,2021-04-25,PAT,1968,938,1030,9,4,0,0,1303,215,31,384,0,22,1959,9,ITH,ITH2,4,Provincia Autonoma Trento,P.A. Trento,541380,14604,2.7,0.36
1261,2021-04-14,PAT,3109,1463,1646,115,50,7,7,97,1486,1019,311,2,15,2373,736,ITH,ITH2,4,Provincia Autonoma Trento,P.A. Trento,541380,17713,3.27,0.57
1262,2021-03-03,PAT,1653,621,1032,74,11,60,203,4,5,1267,3,19,7,1136,517,ITH,ITH2,4,Provincia Autonoma Trento,P.A. Trento,541380,19366,3.58,0.31
1263,2021-04-05,PAT,33,16,17,0,0,0,1,21,11,0,0,0,0,33,0,ITH,ITH2,4,Provincia Autonoma Trento,P.A. Trento,541380,19399,3.58,0.01
1264,2021-04-19,PAT,2619,1234,1385,40,12,0,6,592,906,314,678,2,69,2593,26,ITH,ITH2,4,Provincia Autonoma Trento,P.A. Trento,541380,22018,4.07,0.48
1265,2021-02-23,PAT,1108,395,713,272,13,17,50,1,0,751,0,3,1,897,211,ITH,ITH2,4,Provincia Autonoma Trento,P.A. Trento,541380,23126,4.27,0.2
1266,2021-01-13,PAT,421,123,298,392,6,23,0,0,0,0,0,0,0,421,0,ITH,ITH2,4,Provincia Autonoma Trento,P.A. Trento,541380,23547,4.35,0.08
1267,2021-03-07,PAT,22,6,16,0,0,0,22,0,0,0,0,0,0,22,0,ITH,ITH2,4,Provincia Autonoma Trento,P.A. Trento,541380,23569,4.35,0.0
1268,2021-01-27,PAT,802,277,525,463,33,304,0,0,0,1,0,0,1,91,711,ITH,ITH2,4,Provincia Autonoma Trento,P.A. Trento,541380,24371,4.5,0.15
1269,2021-01-29,PAT,1352,331,1021,724,74,542,0,0,0,3,0,0,9,55,1297,ITH,ITH2,4,Provincia Autonoma Trento,P.A. Trento,541380,25723,4.75,0.25
1270,2021-04-15,PAT,3173,1433,1740,179,111,16,3,129,1514,525,680,1,15,3021,152,ITH,ITH2,4,Provincia Autonoma Trento,P.A. Trento,541380,28896,5.34,0.59
1271,2021-03-18,PAT,2307,951,1356,63,1,2,3,9,533,1669,16,2,9,1225,1082,ITH,ITH2,4,Provincia Autonoma Trento,P.A. Trento,541380,31203,5.76,0.43
1272,2021-02-13,PAT,536,333,203,373,4,0,0,1,0,158,0,0,0,171,365,ITH,ITH2,4,Provincia Autonoma Trento,P.A. Trento,541380,31739,5.86,0.1
1273,2021-03-27,PAT,1612,707,905,271,362,0,165,12,352,61,227,135,27,1360,252,ITH,ITH2,4,Provincia Autonoma Trento,P.A. Trento,541380,33351,6.16,0.3
1274,2021-02-12,PAT,1010,340,670,335,54,55,0,2,9,553,0,0,2,589,421,ITH,ITH2,4,Provincia Autonoma Trento,P.A. Trento,541380,34361,6.35,0.19
1275,2021-03-20,PAT,871,402,469,154,97,0,69,0,343,78,127,0,3,670,201,ITH,ITH2,4,Provincia Autonoma Trento,P.A. Trento,541380,35232,6.51,0.16
1276,2021-03-10,PAT,2398,925,1473,356,36,25,316,4,10,1421,2,221,7,1477,921,ITH,ITH2,4,Provincia Autonoma Trento,P.A. Trento,541380,37630,6.95,0.44
1277,2021-01-09,PAT,190,40,150,146,13,31,0,0,0,0,0,0,0,190,0,ITH,ITH2,4,Provincia Autonoma Trento,P.A. Trento,541380,37820,6.99,0.04
1278,2021-03-08,PAT,1398,433,965,65,15,0,277,2,6,1017,1,7,8,1045,353,ITH,ITH2,4,Provincia Autonoma Trento,P.A. Trento,541380,39218,7.24,0.26
1279,2021-03-29,PAT,2452,957,1495,98,30,5,91,33,802,1004,99,4,286,1717,735,ITH,ITH2,4,Provincia Autonoma Trento,P.A. Trento,541380,41670,7.7,0.45
1280,2021-04-17,PAT,2201,1119,1082,13,2,0,0,146,1503,77,449,0,11,2144,57,ITH,ITH2,4,Provincia Autonoma Trento,P.A. Trento,541380,43871,8.1,0.41
1281,2021-01-22,PAT,1668,433,1235,904,121,631,3,3,5,1,0,0,0,329,1339,ITH,ITH2,4,Provincia Autonoma Trento,P.A. Trento,541380,45539,8.41,0.31
1282,2021-02-16,PAT,663,244,419,73,2,3,10,0,8,563,0,0,4,658,5,ITH,ITH2,4,Provincia Autonoma Trento,P.A. Trento,541380,46202,8.53,0.12
1283,2021-02-24,PAT,1318,523,795,236,5,29,66,4,2,974,1,1,0,922,396,ITH,ITH2,4,Provincia Autonoma Trento,P.A. Trento,541380,47520,8.78,0.24
1284,2021-01-23,PAT,577,334,243,487,2,88,0,0,0,0,0,0,0,388,189,ITH,ITH2,4,Provincia Autonoma Trento,P.A. Trento,541380,48097,8.88,0.11
1285,2021-03-17,PAT,2075,795,1280,399,15,55,10,4,279,1270,23,1,19,1202,873,ITH,ITH2,4,Provincia Autonoma Trento,P.A. Trento,541380,50172,9.27,0.38
1286,2021-03-02,PAT,1302,440,862,138,16,55,146,4,9,925,1,1,7,926,376,ITH,ITH2,4,Provincia Autonoma Trento,P.A. Trento,541380,51474,9.51,0.24
1287,2021-02-26,PAT,1218,435,783,250,12,19,105,3,2,823,0,1,3,923,295,ITH,ITH2,4,Provincia Autonoma Trento,P.A. Trento,541380,52692,9.73,0.22
1288,2021-04-07,PAT,2589,1008,1581,264,27,29,101,19,630,1364,131,9,15,1649,940,ITH,ITH2,4,Provincia Autonoma Trento,P.A. Trento,541380,55281,10.21,0.48
1289,2021-04-08,PAT,3111,1293,1818,182,25,46,38,57,1023,1414,307,3,16,1993,1118,ITH,ITH2,4,Provincia Autonoma Trento,P.A. Trento,541380,58392,10.79,0.57
1290,2021-03-13,PAT,829,380,449,203,15,30,259,0,0,44,0,278,0,781,48,ITH,ITH2,4,Provincia Autonoma Trento,P.A. Trento,541380,59221,10.94,0.15
1291,2021-01-08,PAT,1449,313,1136,775,128,530,0,0,7,7,0,0,2,1449,0,ITH,ITH2,4,Provincia Autonoma Trento,P.A. Trento,541380,60670,11.21,0.27
1292,2021-04-11,PAT,2332,1131,1201,45,57,8,175,26,1753,21,235,7,5,2241,91,ITH,ITH2,4,Provincia Autonoma Trento,P.A. Trento,541380,63002,11.64,0.43
1293,2020-12-31,PAT,1624,449,1175,841,105,676,0,0,1,1,0,0,0,1624,0,ITH,ITH2,4,Provincia Autonoma Trento,P.A. Trento,541380,64626,11.94,0.3
1294,2021-02-15,PAT,533,187,346,145,21,27,11,1,1,322,0,0,5,419,114,ITH,ITH2,4,Provincia Autonoma Trento,P.A. Trento,541380,65159,12.04,0.1
1295,2021-03-01,PAT,1237,454,783,74,1,10,95,5,8,1037,0,3,4,942,295,ITH,ITH2,4,Provincia Autonoma Trento,P.A. Trento,541380,66396,12.26,0.23
1296,2021-02-09,PAT,914,287,627,447,8,73,0,2,1,381,0,0,2,441,473,ITH,ITH2,4,Provincia Autonoma Trento,P.A. Trento,541380,67310,12.43,0.17
1297,2021-04-22,PAT,3123,1458,1665,74,49,8,0,1315,899,242,518,2,16,3077,46,ITH,ITH2,4,Provincia Autonoma Trento,P.A. Trento,541380,70433,13.01,0.58
1298,2021-03-06,PAT,773,277,496,362,11,0,195,3,0,195,0,5,2,622,151,ITH,ITH2,4,Provincia Autonoma Trento,P.A. Trento,541380,71206,13.15,0.14
1299,2021-04-30,PAT,4635,2277,2358,58,126,14,28,2676,854,149,571,3,156,4487,148,ITH,ITH2,4,Provincia Autonoma Trento,P.A. Trento,541380,75841,14.01,0.86
1300,2021-01-06,PAT,42,13,29,42,0,0,0,0,0,0,0,0,0,42,0,ITH,ITH2,4,Provincia Autonoma Trento,P.A. Trento,541380,75883,14.02,0.01
1301,2021-01-18,PAT,643,154,489,529,35,73,0,1,0,1,0,0,4,588,55,ITH,ITH2,4,Provincia Autonoma Trento,P.A. Trento,541380,76526,14.14,0.12
1302,2021-01-05,PAT,709,232,477,495,46,162,0,1,1,0,0,0,4,709,0,ITH,ITH2,4,Provincia Autonoma Trento,P.A. Trento,541380,77235,14.27,0.13
1303,2021-04-20,PAT,2860,1369,1491,40,20,0,4,942,1274,175,388,2,15,2820,40,ITH,ITH2,4,Provincia Autonoma Trento,P.A. Trento,541380,80095,14.79,0.53
1304,2021-03-26,PAT,3149,1225,1924,136,178,108,554,30,1095,901,63,46,38,2550,599,ITH,ITH2,4,Provincia Autonoma Trento,P.A. Trento,541380,83244,15.38,0.58
1305,2021-04-23,PAT,3579,1740,1839,33,16,20,9,1591,798,200,882,1,29,3522,57,ITH,ITH2,4,Provincia Autonoma Trento,P.A. Trento,541380,86823,16.04,0.66
1306,2021-02-06,PAT,574,298,276,179,0,0,0,1,0,391,0,0,3,433,141,ITH,ITH2,4,Provincia Autonoma Trento,P.A. Trento,541380,87397,16.14,0.11
1307,2021-02-21,PAT,155,92,63,154,0,0,1,0,0,0,0,0,0,43,112,ITH,ITH2,4,Provincia Autonoma Trento,P.A. Trento,541380,87552,16.17,0.03
1308,2021-01-20,PAT,290,72,218,231,10,48,0,0,0,0,0,0,1,278,12,ITH,ITH2,4,Provincia Autonoma Trento,P.A. Trento,541380,87842,16.23,0.05
1309,2021-01-02,PAT,502,143,359,336,21,141,0,0,0,3,0,0,1,502,0,ITH,ITH2,4,Provincia Autonoma Trento,P.A. Trento,541380,88344,16.32,0.09
1310,2021-04-01,PAT,2891,1227,1664,192,137,8,125,35,501,1644,120,24,105,1798,1093,ITH,ITH2,4,Provincia Autonoma Trento,P.A. Trento,541380,91235,16.85,0.53
1311,2021-03-11,PAT,2293,851,1442,105,50,41,391,8,13,1587,22,59,17,1471,822,ITH,ITH2,4,Provincia Autonoma Trento,P.A. Trento,541380,93528,17.28,0.42
1312,2021-02-02,PAT,907,240,667,507,33,189,0,2,5,170,0,0,1,190,717,ITH,ITH2,4,Provincia Autonoma Trento,P.A. Trento,541380,94435,17.44,0.17
1313,2021-01-11,PAT,730,221,509,523,49,153,0,1,0,0,0,0,4,730,0,ITH,ITH2,4,Provincia Autonoma Trento,P.A. Trento,541380,95165,17.58,0.13
1314,2021-04-18,PAT,1853,844,1009,10,54,4,3,1025,509,23,219,0,6,1845,8,ITH,ITH2,4,Provincia Autonoma Trento,P.A. Trento,541380,97018,17.92,0.34
1315,2021-01-15,PAT,594,131,463,463,18,111,0,0,1,0,0,0,1,594,0,ITH,ITH2,4,Provincia Autonoma Trento,P.A. Trento,541380,97612,18.03,0.11
1316,2021-05-04,PAT,3287,1779,1508,23,41,3,17,1331,328,73,310,96,1065,3226,61,ITH,ITH2,4,Provincia Autonoma Trento,P.A. Trento,541380,100899,18.64,0.61
1317,2021-04-21,PAT,2891,1347,1544,47,12,3,1,1175,920,195,531,0,7,2836,55,ITH,ITH2,4,Provincia Autonoma Trento,P.A. Trento,541380,103790,19.17,0.53
1318,2021-02-17,PAT,1110,425,685,326,9,35,12,3,11,709,0,3,2,1020,90,ITH,ITH2,4,Provincia Autonoma Trento,P.A. Trento,541380,104900,19.38,0.21
1319,2021-03-23,PAT,2439,941,1498,146,111,71,163,7,845,1011,35,34,16,1699,740,ITH,ITH2,4,Provincia Autonoma Trento,P.A. Trento,541380,107339,19.83,0.45
1320,2021-03-24,PAT,2374,940,1434,207,89,42,225,6,237,1450,66,42,10,1554,820,ITH,ITH2,4,Provincia Autonoma Trento,P.A. Trento,541380,109713,20.27,0.44
1321,2020-12-27,PAT,103,40,63,76,4,21,0,0,0,0,0,0,2,103,0,ITH,ITH2,4,Provincia Autonoma Trento,P.A. Trento,541380,109816,20.28,0.02
1322,2021-03-14,PAT,107,65,42,102,0,0,5,0,0,0,0,0,0,20,87,ITH,ITH2,4,Provincia Autonoma Trento,P.A. Trento,541380,109923,20.3,0.02
1323,2021-04-24,PAT,3440,1654,1786,3,30,3,2,2124,338,43,884,0,13,3421,19,ITH,ITH2,4,Provincia Autonoma Trento,P.A. Trento,541380,113363,20.94,0.64
1324,2021-04-27,PAT,3860,1859,2001,26,104,1,5,2092,901,147,529,16,39,3795,65,ITH,ITH2,4,Provincia Autonoma Trento,P.A. Trento,541380,117223,21.65,0.71
1325,2021-01-10,PAT,84,19,65,54,18,12,0,0,0,0,0,0,0,84,0,ITH,ITH2,4,Provincia Autonoma Trento,P.A. Trento,541380,117307,21.67,0.02
1326,2021-01-31,PAT,75,15,60,55,13,6,0,1,0,0,0,0,0,1,74,ITH,ITH2,4,Provincia Autonoma Trento,P.A. Trento,541380,117382,21.68,0.01
1327,2021-02-10,PAT,850,290,560,310,7,51,0,1,0,481,0,0,0,509,341,ITH,ITH2,4,Provincia Autonoma Trento,P.A. Trento,541380,118232,21.84,0.16
1328,2021-04-02,PAT,2773,1140,1633,152,65,44,297,58,1168,689,133,15,152,2109,664,ITH,ITH2,4,Provincia Autonoma Trento,P.A. Trento,541380,121005,22.35,0.51
1329,2021-01-12,PAT,505,158,347,418,25,61,0,0,0,0,0,0,1,505,0,ITH,ITH2,4,Provincia Autonoma Trento,P.A. Trento,541380,121510,22.44,0.09
1330,2021-01-01,PAT,213,50,163,114,11,88,0,0,0,0,0,0,0,213,0,ITH,ITH2,4,Provincia Autonoma Trento,P.A. Trento,541380,121723,22.48,0.04
1331,2021-02-11,PAT,1132,365,767,332,3,48,0,0,5,739,0,0,5,796,336,ITH,ITH2,4,Provincia Autonoma Trento,P.A. Trento,541380,122855,22.69,0.21
1332,2021-03-09,PAT,1579,588,991,98,44,31,199,2,8,1102,1,92,2,936,643,ITH,ITH2,4,Provincia Autonoma Trento,P.A. Trento,541380,124434,22.98,0.29
1333,2021-04-12,PAT,3076,1400,1676,136,35,31,364,76,1319,754,318,12,31,2581,495,ITH,ITH2,4,Provincia Autonoma Trento,P.A. Trento,541380,127510,23.55,0.57
1334,2021-02-01,PAT,1220,335,885,767,70,375,0,1,1,0,0,0,6,92,1128,ITH,ITH2,4,Provincia Autonoma Trento,P.A. Trento,541380,128730,23.78,0.23
1335,2021-03-12,PAT,2493,931,1562,207,253,106,557,10,26,1120,5,203,6,1688,805,ITH,ITH2,4,Provincia Autonoma Trento,P.A. Trento,541380,131223,24.24,0.46
1336,2021-01-07,PAT,1270,310,960,649,46,557,0,1,4,13,0,0,0,1270,0,ITH,ITH2,4,Provincia Autonoma Trento,P.A. Trento,541380,132493,24.47,0.23
1337,2021-02-27,PAT,1025,456,569,459,5,2,113,0,2,435,0,4,5,604,421,ITH,ITH2,4,Provincia Autonoma Trento,P.A. Trento,541380,133518,24.66,0.19
1338,2021-02-20,PAT,406,245,161,330,10,30,31,0,0,1,0,3,1,122,284,ITH,ITH2,4,Provincia Autonoma Trento,P.A. Trento,541380,133924,24.74,0.07
1339,2021-01-25,PAT,817,215,602,524,27,263,0,0,0,2,0,0,1,23,794,ITH,ITH2,4,Provincia Autonoma Trento,P.A. Trento,541380,134741,24.89,0.15
1340,2021-02-08,PAT,1151,318,833,551,53,237,1,1,4,303,0,0,1,342,809,ITH,ITH2,4,Provincia Autonoma Trento,P.A. Trento,541380,135892,25.1,0.21
1341,2021-03-31,PAT,2552,983,1569,147,34,5,227,26,480,1474,101,6,52,1695,857,ITH,ITH2,4,Provincia Autonoma Trento,P.A. Trento,541380,138444,25.57,0.47
1342,2021-02-04,PAT,972,304,668,543,10,89,0,1,2,325,0,0,2,420,552,ITH,ITH2,4,Provincia Autonoma Trento,P.A. Trento,541380,139416,25.75,0.18
1343,2021-02-05,PAT,802,271,531,467,19,66,0,1,0,248,0,0,1,283,519,ITH,ITH2,4,Provincia Autonoma Trento,P.A. Trento,541380,140218,25.9,0.15
1344,2021-04-10,PAT,2789,1305,1484,21,8,1,187,42,2183,67,257,11,12,1995,794,ITH,ITH2,4,Provincia Autonoma Trento,P.A. Trento,541380,143007,26.42,0.52
1345,2021-03-22,PAT,2304,972,1332,82,132,8,103,11,849,994,61,38,26,1429,875,ITH,ITH2,4,Provincia Autonoma Trento,P.A. Trento,541380,145311,26.84,0.43
1346,2021-01-17,PAT,251,195,56,251,0,0,0,0,0,0,0,0,0,251,0,ITH,ITH2,4,Provincia Autonoma Trento,P.A. Trento,541380,145562,26.89,0.05
1347,2021-04-16,PAT,2820,1336,1484,82,28,25,8,224,1243,389,794,2,25,2675,145,ITH,ITH2,4,Provincia Autonoma Trento,P.A. Trento,541380,148382,27.41,0.52
1348,2021-01-16,PAT,319,148,171,304,0,15,0,0,0,0,0,0,0,319,0,ITH,ITH2,4,Provincia Autonoma Trento,P.A. Trento,541380,148701,27.47,0.06
1349,2021-02-18,PAT,1205,426,779,300,25,35,55,2,3,782,0,3,0,1143,62,ITH,ITH2,4,Provincia Autonoma Trento,P.A. Trento,541380,149906,27.69,0.22
1350,2021-05-02,PAT,3259,1811,1448,17,137,0,3,1319,133,21,219,128,1282,3221,38,ITH,ITH2,4,Provincia Autonoma Trento,P.A. Trento,541380,153165,28.29,0.6
1351,2021-02-28,PAT,242,121,121,231,0,0,11,0,0,0,0,0,0,242,0,ITH,ITH2,4,Provincia Autonoma Trento,P.A. Trento,541380,153407,28.34,0.04
1352,2021-04-06,PAT,2254,948,1306,39,6,9,101,11,849,1068,141,18,12,1488,766,ITH,ITH2,4,Provincia Autonoma Trento,P.A. Trento,541380,155661,28.75,0.42
1353,2021-03-28,PAT,746,290,456,18,413,0,2,9,18,8,167,107,4,743,3,ITH,ITH2,4,Provincia Autonoma Trento,P.A. Trento,541380,156407,28.89,0.14
1354,2021-04-03,PAT,1133,471,662,143,266,0,31,10,146,60,365,107,5,966,167,ITH,ITH2,4,Provincia Autonoma Trento,P.A. Trento,541380,157540,29.1,0.21
1355,2021-02-22,PAT,745,259,486,119,4,70,45,1,4,501,0,0,1,661,84,ITH,ITH2,4,Provincia Autonoma Trento,P.A. Trento,541380,158285,29.24,0.14
1356,2021-04-26,PAT,2635,1243,1392,18,12,0,10,667,1147,148,615,1,17,2544,91,ITH,ITH2,4,Provincia Autonoma Trento,P.A. Trento,541380,160920,29.72,0.49
1357,2021-03-19,PAT,2423,915,1508,321,70,53,68,17,758,1065,50,2,19,1571,852,ITH,ITH2,4,Provincia Autonoma Trento,P.A. Trento,541380,163343,30.17,0.45
1358,2021-02-19,PAT,927,358,569,169,38,93,28,5,11,582,0,1,0,869,58,ITH,ITH2,4,Provincia Autonoma Trento,P.A. Trento,541380,164270,30.34,0.17
1359,2021-01-28,PAT,530,147,383,390,29,107,0,1,1,2,0,0,0,48,482,ITH,ITH2,4,Provincia Autonoma Trento,P.A. Trento,541380,164800,30.44,0.1
1360,2021-03-16,PAT,1391,506,885,221,7,36,5,1,24,1073,11,0,13,608,783,ITH,ITH2,4,Provincia Autonoma Trento,P.A. Trento,541380,166191,30.7,0.26
1361,2021-01-04,PAT,870,227,643,486,41,336,0,2,4,1,0,0,0,870,0,ITH,ITH2,4,Provincia Autonoma Trento,P.A. Trento,541380,167061,30.86,0.16
1362,2021-04-09,PAT,2705,1143,1562,86,27,27,196,60,1290,897,111,4,7,1506,1199,ITH,ITH2,4,Provincia Autonoma Trento,P.A. Trento,541380,169766,31.36,0.5
1363,2021-02-25,PAT,1639,642,997,120,9,32,93,2,3,1377,0,1,2,1199,440,ITH,ITH2,4,Provincia Autonoma Trento,P.A. Trento,541380,171405,31.66,0.3
1364,2021-01-03,PAT,492,160,332,419,9,63,0,0,0,0,0,0,1,492,0,ITH,ITH2,4,Provincia Autonoma Trento,P.A. Trento,541380,171897,31.75,0.09
1365,2021-04-28,PAT,4165,1934,2231,91,43,5,21,2371,894,168,532,1,39,4026,139,ITH,ITH2,4,Provincia Autonoma Trento,P.A. Trento,541380,176062,32.52,0.77
1366,2021-01-19,PAT,405,77,328,365,3,36,0,0,0,0,0,0,1,405,0,ITH,ITH2,4,Provincia Autonoma Trento,P.A. Trento,541380,176467,32.6,0.07
1367,2021-02-03,PAT,846,314,532,356,13,73,0,1,2,400,0,0,1,414,432,ITH,ITH2,4,Provincia Autonoma Trento,P.A. Trento,541380,177313,32.75,0.16
1368,2021-02-14,PAT,246,186,60,246,0,0,0,0,0,0,0,0,0,11,235,ITH,ITH2,4,Provincia Autonoma Trento,P.A. Trento,541380,177559,32.8,0.05
1369,2021-04-13,PAT,2544,1053,1491,25,12,3,387,40,1218,693,144,2,20,2037,507,ITH,ITH2,4,Provincia Autonoma Trento,P.A. Trento,541380,180103,33.27,0.47
1370,2020-12-30,PAT,7,3,4,4,1,2,0,0,0,0,0,0,0,7,0,ITH,ITH2,4,Provincia Autonoma Trento,P.A. Trento,541380,180110,33.27,0.0
1371,2021-05-03,PAT,3681,1902,1779,77,69,3,2,1933,367,96,496,96,542,3545,136,ITH,ITH2,4,Provincia Autonoma Trento,P.A. Trento,541380,183791,33.95,0.68
1372,2021-05-01,PAT,4735,2416,2319,25,71,0,4,2860,173,45,530,80,947,4696,39,ITH,ITH2,4,Provincia Autonoma Trento,P.A. Trento,541380,188526,34.82,0.87
1373,2021-03-25,PAT,2871,1103,1768,183,141,28,359,32,631,1326,83,25,63,1822,1049,ITH,ITH2,4,Provincia Autonoma Trento,P.A. Trento,541380,191397,35.35,0.53
1374,2021-03-30,PAT,2379,970,1409,71,60,53,176,18,792,1048,94,9,58,1742,637,ITH,ITH2,4,Provincia Autonoma Trento,P.A. Trento,541380,193776,35.79,0.44
1375,2021-01-26,PAT,542,154,388,441,16,84,0,0,0,0,0,0,1,27,515,ITH,ITH2,4,Provincia Autonoma Trento,P.A. Trento,541380,194318,35.89,0.1
1376,2021-04-10,CAM,28339,13486,14853,259,61,90,733,333,7070,6314,12857,211,411,23424,4915,ITF,ITF3,15,Campania,Campania,5801692,28339,0.49,0.49
1377,2021-04-04,CAM,7951,4007,3944,177,28,6,73,48,1215,1996,4044,63,301,6908,1043,ITF,ITF3,15,Campania,Campania,5801692,36290,0.63,0.14
1378,2021-04-28,CAM,36433,17621,18812,168,46,52,226,7011,6955,3742,15806,335,2092,26699,9734,ITF,ITF3,15,Campania,Campania,5801692,72723,1.25,0.63
1379,2021-01-12,CAM,5214,2563,2651,3439,722,340,0,104,29,7,0,0,573,5214,0,ITF,ITF3,15,Campania,Campania,5801692,77937,1.34,0.09
1380,2021-04-02,CAM,21733,10409,11324,263,48,108,1063,138,6340,3968,8557,515,733,19415,2318,ITF,ITF3,15,Campania,Campania,5801692,99670,1.72,0.37
1381,2021-02-19,CAM,9554,3556,5998,1663,169,161,2192,103,35,4457,0,0,774,8904,650,ITF,ITF3,15,Campania,Campania,5801692,109224,1.88,0.16
1382,2021-01-01,CAM,919,506,413,831,85,0,0,2,0,0,0,0,1,919,0,ITF,ITF3,15,Campania,Campania,5801692,110143,1.9,0.02
1383,2021-03-26,CAM,19453,8929,10524,363,40,142,1634,100,3152,7624,5466,464,468,15643,3810,ITF,ITF3,15,Campania,Campania,5801692,129596,2.23,0.34
1384,2021-02-11,CAM,6278,2704,3574,1861,279,129,0,238,90,2410,0,0,1271,6212,66,ITF,ITF3,15,Campania,Campania,5801692,135874,2.34,0.11
1385,2021-01-18,CAM,957,399,558,576,93,187,0,12,4,17,0,0,68,713,244,ITF,ITF3,15,Campania,Campania,5801692,136831,2.36,0.02
1386,2021-02-22,CAM,10664,3292,7372,545,60,143,5542,63,38,3899,0,0,374,10401,263,ITF,ITF3,15,Campania,Campania,5801692,147495,2.54,0.18
1387,2021-04-03,CAM,21106,10310,10796,203,50,185,558,106,5970,4524,8849,207,454,18730,2376,ITF,ITF3,15,Campania,Campania,5801692,168601,2.91,0.36
1388,2021-02-08,CAM,5112,2449,2663,1387,320,226,0,327,180,1436,0,0,1236,4310,802,ITF,ITF3,15,Campania,Campania,5801692,173713,2.99,0.09
1389,2021-01-16,CAM,3369,1675,1694,1355,230,373,0,231,63,32,0,0,1085,3369,0,ITF,ITF3,15,Campania,Campania,5801692,177082,3.05,0.06
1390,2021-04-01,CAM,24304,11665,12639,415,63,83,1626,170,4315,7021,9396,572,643,20173,4131,ITF,ITF3,15,Campania,Campania,5801692,201386,3.47,0.42
1391,2021-03-13,CAM,14252,6793,7459,404,136,193,3685,84,27,6717,0,2322,684,8967,5285,ITF,ITF3,15,Campania,Campania,5801692,215638,3.72,0.25
1392,2021-01-06,CAM,7652,3749,3903,5781,838,300,0,116,29,4,0,0,584,7652,0,ITF,ITF3,15,Campania,Campania,5801692,223290,3.85,0.13
1393,2021-03-16,CAM,8088,3519,4569,289,61,60,114,47,85,6876,235,29,292,3774,4314,ITF,ITF3,15,Campania,Campania,5801692,231378,3.99,0.14
1394,2021-03-12,CAM,14247,7095,7152,1022,156,82,2802,114,56,6606,0,2438,971,8164,6083,ITF,ITF3,15,Campania,Campania,5801692,245625,4.23,0.25
1395,2021-04-15,CAM,34297,16646,17651,313,46,21,318,4261,7019,6153,15610,121,435,24422,9875,ITF,ITF3,15,Campania,Campania,5801692,279922,4.82,0.59
1396,2020-12-27,CAM,720,422,298,703,14,0,0,0,1,0,0,0,2,720,0,ITF,ITF3,15,Campania,Campania,5801692,280642,4.84,0.01
1397,2021-05-04,CAM,47288,22771,24517,201,115,89,233,11176,7349,2072,17103,473,8477,38433,8855,ITF,ITF3,15,Campania,Campania,5801692,327930,5.65,0.82
1398,2021-04-18,CAM,27159,13263,13896,108,23,7,240,3940,5519,5346,11734,84,158,18265,8894,ITF,ITF3,15,Campania,Campania,5801692,355089,6.12,0.47
1399,2021-01-29,CAM,10052,4812,5240,6405,1052,259,0,307,75,19,0,0,1935,47,10005,ITF,ITF3,15,Campania,Campania,5801692,365141,6.29,0.17
1400,2021-04-12,CAM,23303,10920,12383,149,64,70,218,1027,10306,3270,7759,129,311,20266,3037,ITF,ITF3,15,Campania,Campania,5801692,388444,6.7,0.4
1401,2021-02-17,CAM,7388,3210,4178,1013,208,38,362,129,70,4913,0,0,655,6328,1060,ITF,ITF3,15,Campania,Campania,5801692,395832,6.82,0.13
1402,2021-02-16,CAM,5435,2410,3025,983,276,169,1,118,43,3189,0,0,656,4664,771,ITF,ITF3,15,Campania,Campania,5801692,401267,6.92,0.09
1403,2021-04-21,CAM,30279,14738,15541,103,43,6,266,5934,7880,3780,11925,104,238,18061,12218,ITF,ITF3,15,Campania,Campania,5801692,431546,7.44,0.52
1404,2021-01-25,CAM,5744,2926,2818,4743,644,56,0,46,13,2,0,0,240,164,5580,ITF,ITF3,15,Campania,Campania,5801692,437290,7.54,0.1
1405,2021-02-27,CAM,13943,4471,9472,825,290,82,8311,245,112,3184,0,0,894,12301,1642,ITF,ITF3,15,Campania,Campania,5801692,451233,7.78,0.24
1406,2021-01-09,CAM,10566,5024,5542,6759,1256,269,0,253,64,21,0,0,1944,10566,0,ITF,ITF3,15,Campania,Campania,5801692,461799,7.96,0.18
1407,2021-04-24,CAM,36298,17518,18780,147,36,7,371,4560,8223,4164,18178,148,464,25066,11232,ITF,ITF3,15,Campania,Campania,5801692,498097,8.59,0.63
1408,2021-02-18,CAM,9080,3812,5268,1752,241,89,438,142,57,5562,0,1,798,8372,708,ITF,ITF3,15,Campania,Campania,5801692,507177,8.74,0.16
1409,2021-01-08,CAM,10455,4968,5487,6714,1147,212,0,309,80,18,0,0,1975,10455,0,ITF,ITF3,15,Campania,Campania,5801692,517632,8.92,0.18
1410,2021-04-11,CAM,17522,8607,8915,116,34,2,203,313,5114,1835,9597,82,226,15443,2079,ITF,ITF3,15,Campania,Campania,5801692,535154,9.22,0.3
1411,2021-04-29,CAM,41269,20002,21267,267,106,76,674,7035,7486,3623,19968,344,1690,24812,16457,ITF,ITF3,15,Campania,Campania,5801692,576423,9.94,0.71
1412,2021-02-25,CAM,12423,4479,7944,803,119,124,4806,144,81,5692,0,0,654,11235,1188,ITF,ITF3,15,Campania,Campania,5801692,588846,10.15,0.21
1413,2021-01-14,CAM,7073,2977,4096,3707,1264,350,0,206,61,14,0,0,1471,7073,0,ITF,ITF3,15,Campania,Campania,5801692,595919,10.27,0.12
1414,2021-02-20,CAM,8564,3079,5485,1023,158,145,1966,57,13,4588,0,0,614,8261,303,ITF,ITF3,15,Campania,Campania,5801692,604483,10.42,0.15
1415,2021-04-27,CAM,32075,15571,16504,228,270,36,456,6666,6227,2853,14053,279,1007,24164,7911,ITF,ITF3,15,Campania,Campania,5801692,636558,10.97,0.55
1416,2021-01-26,CAM,7340,3726,3614,5775,847,231,0,87,27,5,0,0,368,353,6987,ITF,ITF3,15,Campania,Campania,5801692,643898,11.1,0.13
1417,2021-02-14,CAM,3924,1921,2003,626,102,15,0,130,122,2472,0,0,457,3890,34,ITF,ITF3,15,Campania,Campania,5801692,647822,11.17,0.07
1418,2021-04-13,CAM,26597,12677,13920,226,69,97,244,2699,11288,4204,7135,135,500,21069,5528,ITF,ITF3,15,Campania,Campania,5801692,674419,11.62,0.46
1419,2021-03-14,CAM,8505,3721,4784,328,115,2,2018,56,27,4563,0,975,421,4367,4138,ITF,ITF3,15,Campania,Campania,5801692,682924,11.77,0.15
1420,2021-02-10,CAM,6904,3413,3491,1945,284,98,0,448,235,2218,0,0,1676,6728,176,ITF,ITF3,15,Campania,Campania,5801692,689828,11.89,0.12
1421,2021-05-03,CAM,40716,19862,20854,158,69,74,272,6906,8088,2221,14031,370,8527,28875,11841,ITF,ITF3,15,Campania,Campania,5801692,730544,12.59,0.7
1422,2021-02-06,CAM,5341,2665,2676,1990,520,459,0,427,176,58,0,0,1711,2103,3238,ITF,ITF3,15,Campania,Campania,5801692,735885,12.68,0.09
1423,2021-01-10,CAM,8165,3736,4429,5179,1010,97,0,232,62,13,0,0,1572,8165,0,ITF,ITF3,15,Campania,Campania,5801692,744050,12.82,0.14
1424,2021-04-20,CAM,32094,15545,16549,152,40,199,332,7679,7198,4717,11293,142,342,20773,11321,ITF,ITF3,15,Campania,Campania,5801692,776144,13.38,0.55
1425,2021-01-05,CAM,7236,3637,3599,5809,923,106,0,68,20,4,0,0,306,7236,0,ITF,ITF3,15,Campania,Campania,5801692,783380,13.5,0.12
1426,2021-01-30,CAM,10721,5079,5642,6930,1278,227,0,251,68,18,0,0,1949,39,10682,ITF,ITF3,15,Campania,Campania,5801692,794101,13.69,0.18
1427,2021-04-25,CAM,30686,15165,15521,343,104,5,200,8496,5521,2241,13361,89,326,25301,5385,ITF,ITF3,15,Campania,Campania,5801692,824787,14.22,0.53
1428,2021-04-23,CAM,32322,15514,16808,161,42,69,319,5736,6225,3796,15470,181,323,23188,9134,ITF,ITF3,15,Campania,Campania,5801692,857109,14.77,0.56
1429,2021-02-05,CAM,7261,3463,3798,3447,995,308,0,348,140,35,0,0,1988,2133,5128,ITF,ITF3,15,Campania,Campania,5801692,864370,14.9,0.13
1430,2021-01-11,CAM,4072,1871,2201,2386,681,252,0,111,28,14,0,0,600,4072,0,ITF,ITF3,15,Campania,Campania,5801692,868442,14.97,0.07
1431,2021-04-16,CAM,34284,16546,17738,236,50,108,314,3195,6274,6624,16838,277,368,23630,10654,ITF,ITF3,15,Campania,Campania,5801692,902726,15.56,0.59
1432,2021-05-02,CAM,43484,21531,21953,130,37,5,305,7583,6674,1847,17106,213,9584,32158,11326,ITF,ITF3,15,Campania,Campania,5801692,946210,16.31,0.75
1433,2021-03-27,CAM,21275,10028,11247,356,39,63,1957,88,4053,7142,6936,210,431,17412,3863,ITF,ITF3,15,Campania,Campania,5801692,967485,16.68,0.37
1434,2021-03-22,CAM,12743,5921,6822,308,762,72,2470,80,3639,3502,588,922,400,10705,2038,ITF,ITF3,15,Campania,Campania,5801692,980228,16.9,0.22
1435,2021-03-17,CAM,11586,5096,6490,490,134,49,137,55,158,10009,141,43,370,5007,6579,ITF,ITF3,15,Campania,Campania,5801692,991814,17.1,0.2
1436,2021-03-01,CAM,12122,4245,7877,1153,319,147,5786,304,181,3104,0,0,1128,8011,4111,ITF,ITF3,15,Campania,Campania,5801692,1003936,17.3,0.21
1437,2021-02-04,CAM,7943,3429,4514,3965,1245,292,0,328,140,25,0,0,1948,1308,6635,ITF,ITF3,15,Campania,Campania,5801692,1011879,17.44,0.14
1438,2021-03-31,CAM,22676,10901,11775,340,85,111,1164,143,7470,5176,7334,307,546,19238,3438,ITF,ITF3,15,Campania,Campania,5801692,1034555,17.83,0.39
1439,2021-03-02,CAM,12745,4550,8195,1294,197,147,5899,365,225,3279,0,2,1337,8402,4343,ITF,ITF3,15,Campania,Campania,5801692,1047300,18.05,0.22
1440,2021-01-23,CAM,3838,2028,1810,3161,343,69,0,40,8,0,0,0,217,273,3565,ITF,ITF3,15,Campania,Campania,5801692,1051138,18.12,0.07
1441,2021-02-09,CAM,4643,2202,2441,1148,178,6,0,356,211,1381,0,0,1363,4391,252,ITF,ITF3,15,Campania,Campania,5801692,1055781,18.2,0.08
1442,2021-02-15,CAM,5470,2516,2954,987,238,94,1,98,64,3403,1,1,583,5297,173,ITF,ITF3,15,Campania,Campania,5801692,1061251,18.29,0.09
1443,2021-03-28,CAM,15548,7497,8051,79,156,18,679,55,3590,5102,5532,165,172,13925,1623,ITF,ITF3,15,Campania,Campania,5801692,1076799,18.56,0.27
1444,2021-02-24,CAM,11768,4146,7622,845,194,145,4189,45,24,5963,1,0,362,11080,688,ITF,ITF3,15,Campania,Campania,5801692,1088567,18.76,0.2
1445,2021-04-06,CAM,24382,11421,12961,306,116,141,1554,102,10173,5375,5995,208,412,19865,4517,ITF,ITF3,15,Campania,Campania,5801692,1112949,19.18,0.42
1446,2021-02-28,CAM,10411,3206,7205,496,116,22,5496,302,139,2261,0,0,1579,8511,1900,ITF,ITF3,15,Campania,Campania,5801692,1123360,19.36,0.18
1447,2021-02-07,CAM,2929,1382,1547,706,189,225,0,260,155,342,0,0,1052,2158,771,ITF,ITF3,15,Campania,Campania,5801692,1126289,19.41,0.05
1448,2020-12-31,CAM,1490,811,679,1273,150,1,0,11,2,0,0,0,53,1490,0,ITF,ITF3,15,Campania,Campania,5801692,1127779,19.44,0.03
1449,2021-03-20,CAM,13894,6433,7461,295,43,35,2883,76,1677,6516,772,1020,577,10155,3739,ITF,ITF3,15,Campania,Campania,5801692,1141673,19.68,0.24
1450,2021-04-26,CAM,33890,16588,17302,216,140,4,165,8369,4157,2322,18044,148,325,28274,5616,ITF,ITF3,15,Campania,Campania,5801692,1175563,20.26,0.58
1451,2021-01-17,CAM,1155,551,604,718,54,151,0,22,7,3,0,0,200,702,453,ITF,ITF3,15,Campania,Campania,5801692,1176718,20.28,0.02
1452,2021-02-21,CAM,5833,2239,3594,780,45,22,508,56,14,3871,0,0,537,5608,225,ITF,ITF3,15,Campania,Campania,5801692,1182551,20.38,0.1
1453,2021-03-19,CAM,11030,4868,6162,392,68,21,853,70,134,8441,474,138,439,7161,3869,ITF,ITF3,15,Campania,Campania,5801692,1193581,20.57,0.19
1454,2021-01-21,CAM,2093,1116,977,1379,153,75,0,95,32,22,0,0,337,677,1416,ITF,ITF3,15,Campania,Campania,5801692,1195674,20.61,0.04
1455,2021-03-29,CAM,18950,9134,9816,362,51,129,1198,83,4477,5050,6846,304,450,17406,1544,ITF,ITF3,15,Campania,Campania,5801692,1214624,20.94,0.33
1456,2021-02-26,CAM,13327,4228,9099,951,127,220,7829,130,65,3422,0,1,582,11992,1335,ITF,ITF3,15,Campania,Campania,5801692,1227951,21.17,0.23
1457,2021-03-18,CAM,12163,5376,6787,460,79,34,459,72,260,9973,231,99,496,5975,6188,ITF,ITF3,15,Campania,Campania,5801692,1240114,21.38,0.21
1458,2021-03-05,CAM,16476,6347,10129,1683,243,64,5788,320,141,6364,0,4,1869,9816,6660,ITF,ITF3,15,Campania,Campania,5801692,1256590,21.66,0.28
1459,2021-01-07,CAM,8910,4166,4744,6313,1087,332,0,193,29,11,0,0,945,8910,0,ITF,ITF3,15,Campania,Campania,5801692,1265500,21.81,0.15
1460,2021-03-06,CAM,16304,6750,9554,993,135,173,5486,250,170,7145,0,1105,847,10637,5667,ITF,ITF3,15,Campania,Campania,5801692,1281804,22.09,0.28
1461,2021-04-22,CAM,33913,16513,17400,226,53,21,306,5244,6686,5071,15843,135,328,21519,12394,ITF,ITF3,15,Campania,Campania,5801692,1315717,22.68,0.58
1462,2021-04-30,CAM,42180,20098,22082,314,67,68,1043,6343,8478,3533,19039,529,2766,25794,16386,ITF,ITF3,15,Campania,Campania,5801692,1357897,23.41,0.73
1463,2021-03-03,CAM,13916,5492,8424,2088,240,156,4232,469,251,4809,0,4,1667,7287,6629,ITF,ITF3,15,Campania,Campania,5801692,1371813,23.65,0.24
1464,2021-04-17,CAM,36165,17496,18669,217,41,7,433,4708,6962,6358,16959,140,340,24641,11524,ITF,ITF3,15,Campania,Campania,5801692,1407978,24.27,0.62
1465,2021-03-10,CAM,15241,7375,7866,705,246,26,2468,121,44,8441,1,2345,844,8411,6830,ITF,ITF3,15,Campania,Campania,5801692,1423219,24.53,0.26
1466,2021-03-21,CAM,9982,4592,5390,168,28,17,1677,46,3787,2935,762,383,179,7593,2389,ITF,ITF3,15,Campania,Campania,5801692,1433201,24.7,0.17
1467,2021-03-08,CAM,14535,6715,7820,888,248,70,4957,156,78,4873,0,2275,990,9760,4775,ITF,ITF3,15,Campania,Campania,5801692,1447736,24.95,0.25
1468,2021-02-23,CAM,10995,3385,7610,520,87,295,5939,57,30,3760,0,0,307,10469,526,ITF,ITF3,15,Campania,Campania,5801692,1458731,25.14,0.19
1469,2021-01-22,CAM,1523,775,748,970,120,209,0,28,6,4,0,0,186,673,850,ITF,ITF3,15,Campania,Campania,5801692,1460254,25.17,0.03
1470,2021-02-12,CAM,6527,2859,3668,1885,306,208,4,160,69,3061,0,0,834,6341,186,ITF,ITF3,15,Campania,Campania,5801692,1466781,25.28,0.11
1471,2021-03-04,CAM,14649,5349,9300,1901,305,136,4836,302,98,5595,0,1,1475,8756,5893,ITF,ITF3,15,Campania,Campania,5801692,1481430,25.53,0.25
1472,2021-03-23,CAM,15331,7055,8276,359,491,181,3292,160,2743,4739,2113,577,676,12826,2505,ITF,ITF3,15,Campania,Campania,5801692,1496761,25.8,0.26
1473,2021-03-24,CAM,17618,8081,9537,410,99,70,2442,111,1943,6725,4802,621,395,14667,2951,ITF,ITF3,15,Campania,Campania,5801692,1514379,26.1,0.3
1474,2021-01-24,CAM,4128,2123,2005,3140,410,166,0,46,10,0,0,0,356,383,3745,ITF,ITF3,15,Campania,Campania,5801692,1518507,26.17,0.07
1475,2021-03-25,CAM,19996,9338,10658,308,52,8,2483,124,2563,7454,6030,395,579,16494,3502,ITF,ITF3,15,Campania,Campania,5801692,1538503,26.52,0.34
1476,2021-02-13,CAM,5509,2550,2959,960,114,131,2,160,127,3622,0,0,393,5292,217,ITF,ITF3,15,Campania,Campania,5801692,1544012,26.61,0.09
1477,2021-04-19,CAM,30459,14748,15711,177,51,91,241,7794,5423,5106,11192,121,263,18896,11563,ITF,ITF3,15,Campania,Campania,5801692,1574471,27.14,0.53
1478,2021-02-01,CAM,3985,1813,2172,2504,656,152,0,102,26,14,0,0,531,110,3875,ITF,ITF3,15,Campania,Campania,5801692,1578456,27.21,0.07
1479,2021-01-02,CAM,3673,1962,1711,3167,340,0,0,22,8,0,0,0,136,3673,0,ITF,ITF3,15,Campania,Campania,5801692,1582129,27.27,0.06
1480,2021-01-20,CAM,1257,650,607,395,146,101,0,101,100,17,0,0,397,1257,0,ITF,ITF3,15,Campania,Campania,5801692,1583386,27.29,0.02
1481,2021-03-09,CAM,13838,6619,7219,797,276,184,4187,177,49,4512,1,2515,1140,10057,3781,ITF,ITF3,15,Campania,Campania,5801692,1597224,27.53,0.24
1482,2021-04-05,CAM,11635,5542,6093,141,23,6,432,31,2455,2878,5306,111,252,9213,2422,ITF,ITF3,15,Campania,Campania,5801692,1608859,27.73,0.2
1483,2021-01-27,CAM,7738,3820,3918,5839,875,270,0,118,32,4,0,0,600,163,7575,ITF,ITF3,15,Campania,Campania,5801692,1616597,27.86,0.13
1484,2021-01-31,CAM,8066,3711,4355,5106,1012,67,0,238,61,12,0,0,1570,23,8043,ITF,ITF3,15,Campania,Campania,5801692,1624663,28.0,0.14
1485,2021-01-19,CAM,1095,474,621,534,129,171,0,36,7,1,0,0,217,1092,3,ITF,ITF3,15,Campania,Campania,5801692,1625758,28.02,0.02
1486,2021-03-11,CAM,17574,8666,8908,1049,295,105,2834,180,87,8956,0,2956,1112,10297,7277,ITF,ITF3,15,Campania,Campania,5801692,1643332,28.33,0.3
1487,2021-01-28,CAM,8833,4122,4711,6216,1094,347,0,190,32,12,0,0,942,135,8698,ITF,ITF3,15,Campania,Campania,5801692,1652165,28.48,0.15
1488,2021-01-04,CAM,5826,2963,2863,4850,679,0,0,45,5,1,0,0,246,5826,0,ITF,ITF3,15,Campania,Campania,5801692,1657991,28.58,0.1
1489,2021-04-09,CAM,29812,13950,15862,261,74,39,958,183,9292,7321,10730,353,601,23696,6116,ITF,ITF3,15,Campania,Campania,5801692,1687803,29.09,0.51
1490,2021-02-02,CAM,5722,2804,2918,3640,828,354,0,140,50,22,0,0,688,443,5279,ITF,ITF3,15,Campania,Campania,5801692,1693525,29.19,0.1
1491,2021-03-15,CAM,12936,6087,6849,821,142,78,2561,82,1445,6287,12,1065,443,8191,4745,ITF,ITF3,15,Campania,Campania,5801692,1706461,29.41,0.22
1492,2021-02-03,CAM,8902,4002,4900,4736,1101,714,0,295,74,34,0,0,1948,878,8024,ITF,ITF3,15,Campania,Campania,5801692,1715363,29.57,0.15
1493,2021-04-08,CAM,28265,13636,14629,283,131,58,1040,135,6668,7227,11877,401,445,22430,5835,ITF,ITF3,15,Campania,Campania,5801692,1743628,30.05,0.49
1494,2021-01-15,CAM,4980,2381,2599,2740,832,191,0,159,72,22,0,0,964,4980,0,ITF,ITF3,15,Campania,Campania,5801692,1748608,30.14,0.09
1495,2021-04-14,CAM,27638,13328,14310,268,55,22,268,3204,11170,5110,7059,133,349,19075,8563,ITF,ITF3,15,Campania,Campania,5801692,1776246,30.62,0.48
1496,2021-01-03,CAM,3837,2009,1828,3191,401,0,0,31,6,0,0,0,208,3837,0,ITF,ITF3,15,Campania,Campania,5801692,1780083,30.68,0.07
1497,2021-05-01,CAM,46280,22640,23640,161,60,1,636,6334,6260,3650,22213,319,6646,30187,16093,ITF,ITF3,15,Campania,Campania,5801692,1826363,31.48,0.8
1498,2021-03-07,CAM,11911,5344,6567,533,110,85,4351,158,134,4030,0,1953,557,8070,3841,ITF,ITF3,15,Campania,Campania,5801692,1838274,31.69,0.21
1499,2021-03-30,CAM,21723,10271,11452,278,47,182,1836,155,5858,5685,6765,284,633,18767,2956,ITF,ITF3,15,Campania,Campania,5801692,1859997,32.06,0.37
1500,2021-01-13,CAM,8019,3665,4354,4350,1031,587,0,267,65,30,0,0,1689,8019,0,ITF,ITF3,15,Campania,Campania,5801692,1868016,32.2,0.14
1501,2021-04-07,CAM,24735,11769,12966,347,206,62,1043,135,7508,6622,7999,274,539,20013,4722,ITF,ITF3,15,Campania,Campania,5801692,1892751,32.62,0.43
1502,2021-01-31,LAZ,4430,1839,2591,3572,142,244,0,58,43,154,0,0,217,447,3983,ITI,ITI4,12,Lazio,Lazio,5879082,4430,0.08,0.08
1503,2021-01-26,LAZ,7946,3120,4826,6594,219,631,0,86,47,161,0,0,208,714,7232,ITI,ITI4,12,Lazio,Lazio,5879082,12376,0.21,0.14
1504,2021-02-13,LAZ,6578,2607,3971,2125,100,280,0,63,70,3721,0,0,219,6194,384,ITI,ITI4,12,Lazio,Lazio,5879082,18954,0.32,0.11
1505,2021-03-18,LAZ,14217,6073,8144,1025,94,330,6,378,1038,9671,1285,15,375,7828,6389,ITI,ITI4,12,Lazio,Lazio,5879082,33171,0.56,0.24
1506,2021-04-13,LAZ,25474,11805,13669,753,109,296,57,4921,8113,7825,2926,23,451,17782,7692,ITI,ITI4,12,Lazio,Lazio,5879082,58645,1.0,0.43
1507,2021-01-27,LAZ,6102,2378,3724,4797,228,457,0,106,50,150,0,0,314,985,5117,ITI,ITI4,12,Lazio,Lazio,5879082,64747,1.1,0.1
1508,2021-02-10,LAZ,8160,3385,4775,2647,278,634,0,96,80,4056,0,0,369,4847,3313,ITI,ITI4,12,Lazio,Lazio,5879082,72907,1.24,0.14
1509,2021-02-25,LAZ,12653,5517,7136,1754,440,489,2611,139,117,5235,1,1423,444,11603,1050,ITI,ITI4,12,Lazio,Lazio,5879082,85560,1.46,0.22
1510,2021-03-08,LAZ,20049,8305,11744,1580,135,380,4725,937,272,9236,906,1104,774,14777,5272,ITI,ITI4,12,Lazio,Lazio,5879082,105609,1.8,0.34
1511,2021-04-08,LAZ,26573,12122,14451,1232,94,187,59,3600,9056,8456,2522,164,1203,18901,7672,ITI,ITI4,12,Lazio,Lazio,5879082,132182,2.25,0.45
1512,2021-03-02,LAZ,16953,7406,9547,1478,362,229,3767,464,96,8230,328,1280,719,13019,3934,ITI,ITI4,12,Lazio,Lazio,5879082,149135,2.54,0.29
1513,2021-01-10,LAZ,4039,1700,2339,3424,160,252,0,35,27,24,0,0,117,4039,0,ITI,ITI4,12,Lazio,Lazio,5879082,153174,2.61,0.07
1514,2021-01-20,LAZ,4797,1937,2860,3282,233,427,0,91,59,379,0,0,326,3254,1543,ITI,ITI4,12,Lazio,Lazio,5879082,157971,2.69,0.08
1515,2021-04-20,LAZ,30758,14129,16629,700,142,230,75,7357,10154,7961,3684,35,420,19559,11199,ITI,ITI4,12,Lazio,Lazio,5879082,188729,3.21,0.52
1516,2021-01-24,LAZ,5687,2226,3461,4945,132,134,0,56,107,170,0,0,143,605,5082,ITI,ITI4,12,Lazio,Lazio,5879082,194416,3.31,0.1
1517,2021-03-15,LAZ,19276,8331,10945,1606,136,411,2535,710,1680,9759,813,967,659,12540,6736,ITI,ITI4,12,Lazio,Lazio,5879082,213692,3.63,0.33
1518,2021-01-28,LAZ,8269,3162,5107,6811,381,514,0,112,39,150,0,0,262,773,7496,ITI,ITI4,12,Lazio,Lazio,5879082,221961,3.78,0.14
1519,2021-04-07,LAZ,24904,11276,13628,1140,89,190,94,2830,8843,8433,2081,120,1084,17629,7275,ITI,ITI4,12,Lazio,Lazio,5879082,246865,4.2,0.42
1520,2021-01-30,LAZ,6955,2864,4091,5299,283,651,0,114,70,187,0,0,351,753,6202,ITI,ITI4,12,Lazio,Lazio,5879082,253820,4.32,0.12
1521,2021-04-14,LAZ,29072,13196,15876,672,85,151,82,5053,9713,9098,3741,19,458,18966,10106,ITI,ITI4,12,Lazio,Lazio,5879082,282892,4.81,0.49
1522,2021-01-11,LAZ,5527,2104,3423,4554,311,569,0,12,9,14,0,0,58,5527,0,ITI,ITI4,12,Lazio,Lazio,5879082,288419,4.91,0.09
1523,2021-03-07,LAZ,14093,5429,8664,1002,27,148,3542,311,137,7469,405,701,351,10501,3592,ITI,ITI4,12,Lazio,Lazio,5879082,302512,5.15,0.24
1524,2021-04-19,LAZ,29933,13614,16319,639,107,157,38,6882,9940,8285,3374,45,466,19319,10614,ITI,ITI4,12,Lazio,Lazio,5879082,332445,5.65,0.51
1525,2021-01-13,LAZ,5669,2145,3524,4147,273,1009,0,39,12,28,0,0,161,5669,0,ITI,ITI4,12,Lazio,Lazio,5879082,338114,5.75,0.1
1526,2021-02-22,LAZ,11441,4982,6459,1780,130,473,2226,36,30,5276,1,1392,97,10939,502,ITI,ITI4,12,Lazio,Lazio,5879082,349555,5.95,0.19
1527,2021-02-24,LAZ,12040,5198,6842,1799,435,337,2404,75,64,5245,0,1329,352,11046,994,ITI,ITI4,12,Lazio,Lazio,5879082,361595,6.15,0.2
1528,2021-04-10,LAZ,23789,10308,13481,678,60,111,87,3950,7288,7864,3220,33,498,16616,7173,ITI,ITI4,12,Lazio,Lazio,5879082,385384,6.56,0.4
1529,2021-03-22,LAZ,21638,9028,12610,885,80,245,3878,424,4388,9342,1380,560,456,15011,6627,ITI,ITI4,12,Lazio,Lazio,5879082,407022,6.92,0.37
1530,2021-03-16,LAZ,13537,5731,7806,1194,70,280,6,215,849,9689,860,9,365,7095,6442,ITI,ITI4,12,Lazio,Lazio,5879082,420559,7.15,0.23
1531,2020-12-30,LAZ,1630,629,1001,1603,0,27,0,0,0,0,0,0,0,1630,0,ITI,ITI4,12,Lazio,Lazio,5879082,422189,7.18,0.03
1532,2021-01-17,LAZ,4867,2016,2851,3263,149,189,0,54,81,915,0,0,216,4655,212,ITI,ITI4,12,Lazio,Lazio,5879082,427056,7.26,0.08
1533,2021-04-26,LAZ,29105,13374,15731,980,83,349,57,7376,11284,5655,2670,431,220,19921,9184,ITI,ITI4,12,Lazio,Lazio,5879082,456161,7.76,0.5
1534,2021-04-09,LAZ,27151,12182,14969,853,150,163,70,4185,8876,8617,2909,159,1169,18946,8205,ITI,ITI4,12,Lazio,Lazio,5879082,483312,8.22,0.46
1535,2021-04-02,LAZ,28356,13265,15091,1173,114,166,197,3314,9050,9407,3368,293,1274,21041,7315,ITI,ITI4,12,Lazio,Lazio,5879082,511668,8.7,0.48
1536,2021-03-20,LAZ,18222,6810,11412,910,148,360,3054,397,2119,9118,1479,215,422,12339,5883,ITI,ITI4,12,Lazio,Lazio,5879082,529890,9.01,0.31
1537,2021-04-28,LAZ,32703,14951,17752,2031,166,68,94,8049,11203,5910,4253,329,600,21226,11477,ITI,ITI4,12,Lazio,Lazio,5879082,562593,9.57,0.56
1538,2020-12-29,LAZ,488,176,312,486,2,0,0,0,0,0,0,0,0,488,0,ITI,ITI4,12,Lazio,Lazio,5879082,563081,9.58,0.01
1539,2021-03-28,LAZ,18837,7542,11295,550,22,77,2617,1393,4242,8571,961,140,264,13528,5309,ITI,ITI4,12,Lazio,Lazio,5879082,581918,9.9,0.32
1540,2021-01-09,LAZ,6294,2561,3733,5116,240,620,0,61,41,39,0,0,177,6294,0,ITI,ITI4,12,Lazio,Lazio,5879082,588212,10.01,0.11
1541,2021-01-05,LAZ,7371,2802,4569,6691,98,577,0,1,1,1,0,1,1,7371,0,ITI,ITI4,12,Lazio,Lazio,5879082,595583,10.13,0.13
1542,2021-03-19,LAZ,17193,7342,9851,1161,149,389,1011,399,2081,9700,1489,268,546,10866,6327,ITI,ITI4,12,Lazio,Lazio,5879082,612776,10.42,0.29
1543,2020-12-28,LAZ,959,412,547,957,2,0,0,0,0,0,0,0,0,959,0,ITI,ITI4,12,Lazio,Lazio,5879082,613735,10.44,0.02
1544,2021-05-01,LAZ,37758,17011,20747,1633,251,44,51,10750,11586,3857,3687,74,5825,25898,11860,ITI,ITI4,12,Lazio,Lazio,5879082,651493,11.08,0.64
1545,2021-02-07,LAZ,4932,2019,2913,3252,139,218,1,84,96,911,0,0,231,386,4546,ITI,ITI4,12,Lazio,Lazio,5879082,656425,11.17,0.08
1546,2021-02-08,LAZ,9736,4152,5584,3789,430,918,0,134,101,3832,0,0,532,4508,5228,ITI,ITI4,12,Lazio,Lazio,5879082,666161,11.33,0.17
1547,2021-03-29,LAZ,23925,10745,13180,771,94,143,805,1560,7501,9778,2417,369,487,16905,7020,ITI,ITI4,12,Lazio,Lazio,5879082,690086,11.74,0.41
1548,2021-02-27,LAZ,11410,4261,7149,1361,403,516,2710,83,103,4901,12,1122,199,10455,955,ITI,ITI4,12,Lazio,Lazio,5879082,701496,11.93,0.19
1549,2021-01-22,LAZ,3996,1629,2367,3380,76,70,0,54,23,177,0,0,216,481,3515,ITI,ITI4,12,Lazio,Lazio,5879082,705492,12.0,0.07
1550,2021-03-05,LAZ,18759,7937,10822,1787,180,256,3975,1080,188,8585,562,1323,823,14027,4732,ITI,ITI4,12,Lazio,Lazio,5879082,724251,12.32,0.32
1551,2021-04-18,LAZ,23725,10540,13185,449,23,37,27,6149,7903,7090,1860,12,175,16110,7615,ITI,ITI4,12,Lazio,Lazio,5879082,747976,12.72,0.4
1552,2021-03-21,LAZ,17860,6828,11032,1148,33,111,3449,115,3168,8281,1233,118,204,12811,5049,ITI,ITI4,12,Lazio,Lazio,5879082,765836,13.03,0.3
1553,2021-02-04,LAZ,6298,2478,3820,4460,358,892,0,105,70,123,0,0,290,987,5311,ITI,ITI4,12,Lazio,Lazio,5879082,772134,13.13,0.11
1554,2021-04-06,LAZ,23859,10646,13213,1124,88,94,167,2640,8583,8201,1925,234,803,16769,7090,ITI,ITI4,12,Lazio,Lazio,5879082,795993,13.54,0.41
1555,2021-03-10,LAZ,21968,9462,12506,1890,177,452,4622,2216,547,9061,913,1180,910,16324,5644,ITI,ITI4,12,Lazio,Lazio,5879082,817961,13.91,0.37
1556,2021-04-24,LAZ,32870,14734,18136,702,97,155,93,8537,11029,7228,3907,553,569,20452,12418,ITI,ITI4,12,Lazio,Lazio,5879082,850831,14.47,0.56
1557,2021-02-18,LAZ,9989,4963,5026,2162,111,473,1,168,63,4985,0,1665,361,9188,801,ITI,ITI4,12,Lazio,Lazio,5879082,860820,14.64,0.17
1558,2021-02-19,LAZ,10023,5062,4961,2172,105,408,34,94,94,5137,0,1639,340,9207,816,ITI,ITI4,12,Lazio,Lazio,5879082,870843,14.81,0.17
1559,2021-04-17,LAZ,32206,14136,18070,832,101,219,55,7170,9298,9328,4397,10,796,20288,11918,ITI,ITI4,12,Lazio,Lazio,5879082,903049,15.36,0.55
1560,2021-02-14,LAZ,5764,2367,3397,1647,38,127,0,74,131,3502,0,0,245,5301,463,ITI,ITI4,12,Lazio,Lazio,5879082,908813,15.46,0.1
1561,2021-01-14,LAZ,5453,2133,3320,3890,306,811,0,63,38,109,0,0,236,5453,0,ITI,ITI4,12,Lazio,Lazio,5879082,914266,15.55,0.09
1562,2021-04-29,LAZ,38276,17071,21205,3407,439,218,127,9485,11873,6026,5221,315,1165,25199,13077,ITI,ITI4,12,Lazio,Lazio,5879082,952542,16.2,0.65
1563,2021-01-02,LAZ,6705,2630,4075,6269,77,358,0,0,0,0,0,0,1,6705,0,ITI,ITI4,12,Lazio,Lazio,5879082,959247,16.32,0.11
1564,2021-03-09,LAZ,20868,8938,11930,1906,113,338,4636,1509,333,9103,1060,1234,636,15673,5195,ITI,ITI4,12,Lazio,Lazio,5879082,980115,16.67,0.35
1565,2021-03-04,LAZ,18581,7950,10631,2014,216,507,3906,926,133,8282,429,1322,846,13565,5016,ITI,ITI4,12,Lazio,Lazio,5879082,998696,16.99,0.32
1566,2021-01-04,LAZ,7480,2908,4572,7077,86,316,1,0,0,0,0,0,0,7480,0,ITI,ITI4,12,Lazio,Lazio,5879082,1006176,17.11,0.13
1567,2021-02-01,LAZ,5673,2175,3498,4785,193,559,0,17,27,30,1,0,61,354,5319,ITI,ITI4,12,Lazio,Lazio,5879082,1011849,17.21,0.1
1568,2021-03-11,LAZ,23770,10568,13202,1996,133,440,4459,2785,736,9466,1072,1896,787,17542,6228,ITI,ITI4,12,Lazio,Lazio,5879082,1035619,17.62,0.4
1569,2021-04-23,LAZ,37203,17843,19360,769,156,176,88,8127,12126,7775,5592,679,1715,22189,15014,ITI,ITI4,12,Lazio,Lazio,5879082,1072822,18.25,0.63
1570,2021-01-07,LAZ,7743,2901,4842,6898,182,566,0,16,10,9,0,0,62,7743,0,ITI,ITI4,12,Lazio,Lazio,5879082,1080565,18.38,0.13
1571,2021-02-20,LAZ,9140,4240,4900,1943,123,298,22,114,116,4856,0,1313,355,8426,714,ITI,ITI4,12,Lazio,Lazio,5879082,1089705,18.54,0.16
1572,2021-04-05,LAZ,19770,8991,10779,504,36,29,63,1815,8173,7595,1250,20,285,13593,6177,ITI,ITI4,12,Lazio,Lazio,5879082,1109475,18.87,0.34
1573,2021-05-03,LAZ,38682,17474,21208,2224,92,70,47,10437,12495,4024,3926,89,5278,26415,12267,ITI,ITI4,12,Lazio,Lazio,5879082,1148157,19.53,0.66
1574,2021-01-03,LAZ,5250,1972,3278,5125,50,65,0,1,4,1,0,0,4,5250,0,ITI,ITI4,12,Lazio,Lazio,5879082,1153407,19.62,0.09
1575,2021-02-06,LAZ,5380,2226,3154,3279,218,680,0,140,156,610,0,0,297,813,4567,ITI,ITI4,12,Lazio,Lazio,5879082,1158787,19.71,0.09
1576,2021-04-16,LAZ,34180,15594,18586,708,140,335,86,6822,10434,9649,4994,53,959,22165,12015,ITI,ITI4,12,Lazio,Lazio,5879082,1192967,20.29,0.58
1577,2021-02-05,LAZ,7270,2957,4313,5095,380,995,0,118,94,257,0,0,331,1182,6088,ITI,ITI4,12,Lazio,Lazio,5879082,1200237,20.42,0.12
1578,2021-03-13,LAZ,21398,8396,13002,1377,120,330,3751,3193,1278,9185,722,860,582,15504,5894,ITI,ITI4,12,Lazio,Lazio,5879082,1221635,20.78,0.36
1579,2021-02-03,LAZ,6453,2460,3993,4621,342,1078,0,65,38,86,0,0,223,959,5494,ITI,ITI4,12,Lazio,Lazio,5879082,1228088,20.89,0.11
1580,2021-03-24,LAZ,25858,11275,14583,1030,103,107,3624,1745,6517,9668,1820,280,964,19626,6232,ITI,ITI4,12,Lazio,Lazio,5879082,1253946,21.33,0.44
1581,2021-03-23,LAZ,23453,10193,13260,1036,101,181,3863,1058,4934,9333,1411,640,896,16897,6556,ITI,ITI4,12,Lazio,Lazio,5879082,1277399,21.73,0.4
1582,2021-01-19,LAZ,4761,1951,2810,2968,223,424,0,115,122,463,0,0,446,4307,454,ITI,ITI4,12,Lazio,Lazio,5879082,1282160,21.81,0.08
1583,2021-01-18,LAZ,6261,2554,3707,3925,388,736,0,114,77,520,0,0,501,5283,978,ITI,ITI4,12,Lazio,Lazio,5879082,1288421,21.92,0.11
1584,2021-03-30,LAZ,25212,11552,13660,1241,96,249,296,2461,7847,9620,2340,380,682,18080,7132,ITI,ITI4,12,Lazio,Lazio,5879082,1313633,22.34,0.43
1585,2021-04-15,LAZ,31668,14206,17462,702,121,333,86,5424,10354,9655,4111,45,837,20889,10779,ITI,ITI4,12,Lazio,Lazio,5879082,1345301,22.88,0.54
1586,2021-03-25,LAZ,26870,11481,15389,936,95,318,3522,2239,6678,9902,1960,234,986,20285,6585,ITI,ITI4,12,Lazio,Lazio,5879082,1372171,23.34,0.46
1587,2021-03-27,LAZ,25981,10380,15601,1316,127,290,3480,2066,5487,9662,2257,205,1091,19537,6444,ITI,ITI4,12,Lazio,Lazio,5879082,1398152,23.78,0.44
1588,2021-05-02,LAZ,32531,14299,18232,1626,141,34,30,9430,10341,3007,2723,45,5154,23209,9322,ITI,ITI4,12,Lazio,Lazio,5879082,1430683,24.34,0.55
1589,2021-01-29,LAZ,7914,3032,4882,6374,262,704,0,89,47,135,0,0,303,795,7119,ITI,ITI4,12,Lazio,Lazio,5879082,1438597,24.47,0.13
1590,2021-02-11,LAZ,6970,2990,3980,2197,179,500,0,79,39,3685,0,0,291,6467,503,ITI,ITI4,12,Lazio,Lazio,5879082,1445567,24.59,0.12
1591,2021-02-28,LAZ,10232,3998,6234,1601,265,77,2599,88,45,4677,5,682,193,9718,514,ITI,ITI4,12,Lazio,Lazio,5879082,1455799,24.76,0.17
1592,2021-01-01,LAZ,3554,1382,2172,3483,2,68,0,0,0,0,0,0,1,3554,0,ITI,ITI4,12,Lazio,Lazio,5879082,1459353,24.82,0.06
1593,2021-03-26,LAZ,28208,12238,15970,1018,119,332,3294,1992,6728,10288,2601,310,1526,21374,6834,ITI,ITI4,12,Lazio,Lazio,5879082,1487561,25.3,0.48
1594,2021-03-12,LAZ,22863,10111,12752,2005,188,401,3964,2404,1173,9644,916,1198,970,16551,6312,ITI,ITI4,12,Lazio,Lazio,5879082,1510424,25.69,0.39
1595,2021-01-23,LAZ,7184,2852,4332,6064,255,417,0,45,48,182,0,0,173,555,6629,ITI,ITI4,12,Lazio,Lazio,5879082,1517608,25.81,0.12
1596,2021-04-04,LAZ,17463,8036,9427,307,40,11,42,1821,7369,6805,877,17,174,12197,5266,ITI,ITI4,12,Lazio,Lazio,5879082,1535071,26.11,0.3
1597,2021-01-12,LAZ,5391,1974,3417,4343,344,584,0,21,11,10,0,0,78,5391,0,ITI,ITI4,12,Lazio,Lazio,5879082,1540462,26.2,0.09
1598,2021-01-16,LAZ,5630,2273,3357,3358,246,1064,0,73,91,549,0,0,249,5630,0,ITI,ITI4,12,Lazio,Lazio,5879082,1546092,26.3,0.1
1599,2021-01-15,LAZ,6556,2695,3861,4498,423,988,0,94,66,196,0,0,291,6556,0,ITI,ITI4,12,Lazio,Lazio,5879082,1552648,26.41,0.11
1600,2021-01-21,LAZ,5583,2336,3247,4781,92,232,0,59,18,178,0,0,223,531,5052,ITI,ITI4,12,Lazio,Lazio,5879082,1558231,26.5,0.09
1601,2021-02-02,LAZ,5897,2206,3691,4712,368,571,0,57,38,37,0,0,114,626,5271,ITI,ITI4,12,Lazio,Lazio,5879082,1564128,26.6,0.1
1602,2021-05-04,LAZ,38705,17806,20899,2143,166,97,53,10113,12191,3833,4125,549,5435,25759,12946,ITI,ITI4,12,Lazio,Lazio,5879082,1602833,27.26,0.66
1603,2021-02-21,LAZ,6956,3162,3794,1245,65,51,16,88,93,4580,0,608,210,6523,433,ITI,ITI4,12,Lazio,Lazio,5879082,1609789,27.38,0.12
1604,2021-04-01,LAZ,28349,13005,15344,1141,112,284,256,3041,9003,9722,3290,341,1159,21214,7135,ITI,ITI4,12,Lazio,Lazio,5879082,1638138,27.86,0.48
1605,2020-12-27,LAZ,272,131,141,272,0,0,0,0,0,0,0,0,0,272,0,ITI,ITI4,12,Lazio,Lazio,5879082,1638410,27.87,0.0
1606,2021-02-15,LAZ,8070,3584,4486,2447,378,379,0,89,87,4291,0,11,388,7441,629,ITI,ITI4,12,Lazio,Lazio,5879082,1646480,28.01,0.14
1607,2021-04-03,LAZ,24338,10876,13462,844,72,111,214,3096,8248,8594,2200,44,915,17653,6685,ITI,ITI4,12,Lazio,Lazio,5879082,1670818,28.42,0.41
1608,2021-04-30,LAZ,40748,18050,22698,4561,579,80,201,9338,11875,6110,6206,342,1456,26821,13927,ITI,ITI4,12,Lazio,Lazio,5879082,1711566,29.11,0.69
1609,2021-02-26,LAZ,13058,5690,7368,1913,542,352,2744,118,95,5267,4,1385,638,11707,1351,ITI,ITI4,12,Lazio,Lazio,5879082,1724624,29.33,0.22
1610,2021-02-17,LAZ,9158,4589,4569,2282,247,499,1,124,62,4278,0,1345,320,8297,861,ITI,ITI4,12,Lazio,Lazio,5879082,1733782,29.49,0.16
1611,2021-02-12,LAZ,6837,2841,3996,1997,183,302,0,85,43,3844,0,1,382,6433,404,ITI,ITI4,12,Lazio,Lazio,5879082,1740619,29.61,0.12
1612,2021-04-21,LAZ,32740,14885,17855,698,122,135,70,7633,10789,8211,4426,50,606,20440,12300,ITI,ITI4,12,Lazio,Lazio,5879082,1773359,30.16,0.56
1613,2021-01-25,LAZ,8109,3244,4865,7006,218,363,0,66,72,143,0,0,241,769,7340,ITI,ITI4,12,Lazio,Lazio,5879082,1781468,30.3,0.14
1614,2021-03-06,LAZ,18236,7017,11219,1508,119,327,3783,2226,143,8033,583,934,580,13982,4254,ITI,ITI4,12,Lazio,Lazio,5879082,1799704,30.61,0.31
1615,2021-04-11,LAZ,19105,8430,10675,392,30,50,31,3821,6135,6532,2003,14,97,13225,5880,ITI,ITI4,12,Lazio,Lazio,5879082,1818809,30.94,0.32
1616,2021-04-12,LAZ,23596,10609,12987,656,77,101,72,4147,7671,7743,2645,108,376,16706,6890,ITI,ITI4,12,Lazio,Lazio,5879082,1842405,31.34,0.4
1617,2021-03-17,LAZ,13765,5882,7883,1045,100,255,14,291,938,9700,967,7,448,7510,6255,ITI,ITI4,12,Lazio,Lazio,5879082,1856170,31.57,0.23
1618,2021-03-14,LAZ,17086,6609,10477,1163,96,81,3466,452,1103,8439,543,567,1176,11932,5154,ITI,ITI4,12,Lazio,Lazio,5879082,1873256,31.86,0.29
1619,2021-03-01,LAZ,17005,7302,9703,1325,531,385,3580,389,144,8188,390,1406,667,13122,3883,ITI,ITI4,12,Lazio,Lazio,5879082,1890261,32.15,0.29
1620,2021-02-16,LAZ,8390,4077,4313,2060,125,261,1,137,94,4264,0,952,496,7796,594,ITI,ITI4,12,Lazio,Lazio,5879082,1898651,32.3,0.14
1621,2021-01-08,LAZ,7726,2894,4832,6519,196,798,0,36,32,32,0,0,113,7726,0,ITI,ITI4,12,Lazio,Lazio,5879082,1906377,32.43,0.13
1622,2021-03-03,LAZ,17276,7327,9949,1560,211,380,3943,695,117,8194,259,1251,666,12984,4292,ITI,ITI4,12,Lazio,Lazio,5879082,1923653,32.72,0.29
1623,2021-01-06,LAZ,5119,1960,3159,4619,154,320,1,1,4,8,5,1,6,5119,0,ITI,ITI4,12,Lazio,Lazio,5879082,1928772,32.81,0.09
1624,2021-04-25,LAZ,24402,11179,13223,794,23,10,21,7122,9686,5211,1117,152,266,16601,7801,ITI,ITI4,12,Lazio,Lazio,5879082,1953174,33.22,0.42
1625,2021-02-23,LAZ,11076,4772,6304,1897,119,309,1913,68,59,5226,0,1015,470,10326,750,ITI,ITI4,12,Lazio,Lazio,5879082,1964250,33.41,0.19
1626,2021-03-31,LAZ,26040,12002,14038,1021,96,135,255,2521,8151,9629,2835,371,1026,18964,7076,ITI,ITI4,12,Lazio,Lazio,5879082,1990290,33.85,0.44
1627,2021-04-27,LAZ,30471,13749,16722,1478,163,44,79,7603,11125,5824,3346,386,423,19686,10785,ITI,ITI4,12,Lazio,Lazio,5879082,2020761,34.37,0.52
1628,2021-02-09,LAZ,8791,3765,5026,3258,246,548,0,115,123,4068,0,0,433,4580,4211,ITI,ITI4,12,Lazio,Lazio,5879082,2029552,34.52,0.15
1629,2020-12-31,LAZ,5291,2121,3170,4987,20,279,0,1,0,0,0,0,4,5291,0,ITI,ITI4,12,Lazio,Lazio,5879082,2034843,34.61,0.09
1630,2021-04-22,LAZ,38216,18794,19422,871,114,296,78,7981,11749,8198,5094,478,3357,23776,14440,ITI,ITI4,12,Lazio,Lazio,5879082,2073059,35.26,0.65
1631,2021-03-29,VEN,31442,13660,17782,634,429,514,445,985,5771,17000,3659,932,1073,27555,3887,ITH,ITH3,5,Veneto,Veneto,4905854,31442,0.64,0.64
1632,2021-01-02,VEN,5742,1765,3977,4820,233,544,3,24,2,3,0,0,113,5742,0,ITH,ITH3,5,Veneto,Veneto,4905854,37184,0.76,0.12
1633,2021-03-15,VEN,16594,7259,9335,1390,772,429,1969,145,599,9248,1061,709,272,11379,5215,ITH,ITH3,5,Veneto,Veneto,4905854,53778,1.1,0.34
1634,2021-03-09,VEN,16456,7377,9079,1353,348,749,2948,108,60,8545,687,1116,542,10144,6312,ITH,ITH3,5,Veneto,Veneto,4905854,70234,1.43,0.34
1635,2021-04-20,VEN,22154,9397,12757,534,121,513,155,832,4559,9761,5220,31,428,8241,13913,ITH,ITH3,5,Veneto,Veneto,4905854,92388,1.88,0.45
1636,2021-02-05,VEN,8370,2536,5834,4450,1466,2165,14,66,21,8,1,6,173,1425,6945,ITH,ITH3,5,Veneto,Veneto,4905854,100758,2.05,0.17
1637,2021-04-23,VEN,30656,13620,17036,638,305,309,116,1016,13386,6992,7092,38,764,22010,8646,ITH,ITH3,5,Veneto,Veneto,4905854,131414,2.68,0.62
1638,2021-01-07,VEN,8358,2318,6040,5565,858,1802,2,41,18,35,0,0,37,8358,0,ITH,ITH3,5,Veneto,Veneto,4905854,139772,2.85,0.17
1639,2021-03-18,VEN,12598,5133,7465,1685,482,495,855,105,140,7504,1055,36,241,7372,5226,ITH,ITH3,5,Veneto,Veneto,4905854,152370,3.11,0.26
1640,2021-02-26,VEN,8288,3266,5022,1803,544,747,315,64,30,4380,145,91,169,7036,1252,ITH,ITH3,5,Veneto,Veneto,4905854,160658,3.27,0.17
1641,2021-01-13,VEN,5986,1607,4379,2889,1128,1889,2,21,6,3,2,1,45,5986,0,ITH,ITH3,5,Veneto,Veneto,4905854,166644,3.4,0.12
1642,2021-03-21,VEN,11982,4755,7227,1600,1131,42,2532,130,201,4244,1639,180,283,8522,3460,ITH,ITH3,5,Veneto,Veneto,4905854,178626,3.64,0.24
1643,2021-03-11,VEN,19693,8766,10927,1839,958,889,3689,191,72,9321,728,1287,719,14110,5583,ITH,ITH3,5,Veneto,Veneto,4905854,198319,4.04,0.4
1644,2021-02-23,VEN,7367,3245,4122,1101,205,245,183,50,21,5342,49,69,102,7105,262,ITH,ITH3,5,Veneto,Veneto,4905854,205686,4.19,0.15
1645,2021-03-01,VEN,9388,3711,5677,2146,421,954,2519,107,21,2608,164,272,176,7567,1821,ITH,ITH3,5,Veneto,Veneto,4905854,215074,4.38,0.19
1646,2021-02-16,VEN,6633,2869,3764,727,241,478,3,18,14,5020,35,2,95,6456,177,ITH,ITH3,5,Veneto,Veneto,4905854,221707,4.52,0.14
1647,2021-02-17,VEN,6022,2772,3250,424,158,361,4,23,11,4946,26,5,64,5928,94,ITH,ITH3,5,Veneto,Veneto,4905854,227729,4.64,0.12
1648,2021-03-06,VEN,10637,4320,6317,3561,566,1491,1329,63,26,1971,1274,168,188,7366,3271,ITH,ITH3,5,Veneto,Veneto,4905854,238366,4.86,0.22
1649,2021-01-22,VEN,1080,332,748,962,52,57,3,1,0,0,0,0,5,25,1055,ITH,ITH3,5,Veneto,Veneto,4905854,239446,4.88,0.02
1650,2021-04-17,VEN,22226,9006,13220,807,216,129,86,497,3408,10312,6463,16,292,14940,7286,ITH,ITH3,5,Veneto,Veneto,4905854,261672,5.33,0.45
1651,2021-01-29,VEN,9014,2785,6229,6198,1230,1437,6,64,18,4,0,2,55,368,8646,ITH,ITH3,5,Veneto,Veneto,4905854,270686,5.52,0.18
1652,2021-03-03,VEN,12032,4591,7441,3356,661,1239,2342,101,41,3377,145,442,328,8538,3494,ITH,ITH3,5,Veneto,Veneto,4905854,282718,5.76,0.25
1653,2021-03-31,VEN,38447,16159,22288,1898,664,811,414,1251,9244,18496,4128,482,1059,31003,7444,ITH,ITH3,5,Veneto,Veneto,4905854,321165,6.55,0.78
1654,2021-04-22,VEN,31445,13690,17755,675,295,373,110,1036,13008,9180,5906,45,817,15787,15658,ITH,ITH3,5,Veneto,Veneto,4905854,352610,7.19,0.64
1655,2021-02-28,VEN,4136,1389,2747,1741,942,15,15,22,1,992,301,76,31,3299,837,ITH,ITH3,5,Veneto,Veneto,4905854,356746,7.27,0.08
1656,2021-02-04,VEN,7318,2015,5303,3584,1102,2380,6,34,15,20,1,0,176,553,6765,ITH,ITH3,5,Veneto,Veneto,4905854,364064,7.42,0.15
1657,2021-03-10,VEN,18930,8634,10296,1566,791,560,4150,189,86,9048,651,1318,571,13246,5684,ITH,ITH3,5,Veneto,Veneto,4905854,382994,7.81,0.39
1658,2021-01-31,VEN,4768,1563,3205,3753,562,377,4,16,2,5,2,13,34,394,4374,ITH,ITH3,5,Veneto,Veneto,4905854,387762,7.9,0.1
1659,2021-02-09,VEN,5244,1890,3354,3099,643,1269,6,41,10,21,1,1,153,3445,1799,ITH,ITH3,5,Veneto,Veneto,4905854,393006,8.01,0.11
1660,2021-02-21,VEN,4630,1208,3422,495,0,18,3694,0,0,417,0,2,4,4627,3,ITH,ITH3,5,Veneto,Veneto,4905854,397636,8.11,0.09
1661,2021-01-26,VEN,6915,2090,4825,5363,521,977,5,9,3,0,0,1,36,154,6761,ITH,ITH3,5,Veneto,Veneto,4905854,404551,8.25,0.14
1662,2021-03-17,VEN,14625,5982,8643,2252,486,317,700,126,192,8778,1428,26,320,7845,6780,ITH,ITH3,5,Veneto,Veneto,4905854,419176,8.54,0.3
1663,2021-01-09,VEN,7928,2538,5390,5245,975,1573,6,37,4,3,22,12,51,7928,0,ITH,ITH3,5,Veneto,Veneto,4905854,427104,8.71,0.16
1664,2021-04-13,VEN,13893,6264,7629,743,175,300,66,342,2211,5168,4481,26,381,8418,5475,ITH,ITH3,5,Veneto,Veneto,4905854,440997,8.99,0.28
1665,2021-03-14,VEN,15162,5931,9231,3409,1054,100,3661,155,1441,3750,996,275,321,14267,895,ITH,ITH3,5,Veneto,Veneto,4905854,456159,9.3,0.31
1666,2021-02-07,VEN,2315,862,1453,1974,238,50,2,14,3,2,0,7,25,714,1601,ITH,ITH3,5,Veneto,Veneto,4905854,458474,9.35,0.05
1667,2021-01-04,VEN,6735,2033,4702,5341,426,913,6,14,2,1,0,0,32,6735,0,ITH,ITH3,5,Veneto,Veneto,4905854,465209,9.48,0.14
1668,2021-01-18,VEN,2763,777,1986,1224,478,992,1,11,4,8,0,1,44,2564,199,ITH,ITH3,5,Veneto,Veneto,4905854,467972,9.54,0.06
1669,2020-12-30,VEN,699,245,454,598,52,39,2,0,0,0,0,0,8,699,0,ITH,ITH3,5,Veneto,Veneto,4905854,468671,9.55,0.01
1670,2021-02-01,VEN,8557,2500,6057,4422,1543,2136,10,69,25,267,0,0,85,161,8396,ITH,ITH3,5,Veneto,Veneto,4905854,477228,9.73,0.17
1671,2021-01-19,VEN,1309,472,837,726,218,326,0,6,3,7,1,0,22,1159,150,ITH,ITH3,5,Veneto,Veneto,4905854,478537,9.75,0.03
1672,2021-03-12,VEN,18550,8112,10438,2137,1193,754,3510,210,117,8048,861,1009,711,11806,6744,ITH,ITH3,5,Veneto,Veneto,4905854,497087,10.13,0.38
1673,2020-12-31,VEN,3219,1042,2177,2765,94,252,2,23,0,0,0,0,83,3219,0,ITH,ITH3,5,Veneto,Veneto,4905854,500306,10.2,0.07
1674,2021-04-05,VEN,19146,8371,10775,660,392,327,176,338,9871,5520,1710,22,130,13694,5452,ITH,ITH3,5,Veneto,Veneto,4905854,519452,10.59,0.39
1675,2021-01-03,VEN,5158,1563,3595,4607,255,249,2,13,1,0,0,0,31,5158,0,ITH,ITH3,5,Veneto,Veneto,4905854,524610,10.69,0.11
1676,2021-05-04,VEN,41353,19579,21774,466,126,70,2357,22653,6508,1507,6271,46,1349,33604,7749,ITH,ITH3,5,Veneto,Veneto,4905854,565963,11.54,0.84
1677,2021-01-21,VEN,2291,719,1572,2052,74,141,3,11,0,0,0,0,10,21,2270,ITH,ITH3,5,Veneto,Veneto,4905854,568254,11.58,0.05
1678,2021-03-30,VEN,35846,15209,20637,869,406,584,478,1509,8618,16800,4765,562,1255,30601,5245,ITH,ITH3,5,Veneto,Veneto,4905854,604100,12.31,0.73
1679,2021-02-03,VEN,5935,1662,4273,2948,1141,1750,6,23,7,3,3,0,54,480,5455,ITH,ITH3,5,Veneto,Veneto,4905854,610035,12.43,0.12
1680,2021-01-30,VEN,8745,2671,6074,6335,1026,1235,9,53,4,4,2,13,64,692,8053,ITH,ITH3,5,Veneto,Veneto,4905854,618780,12.61,0.18
1681,2021-02-13,VEN,3267,1474,1793,1592,198,1438,1,11,2,3,1,1,20,3247,20,ITH,ITH3,5,Veneto,Veneto,4905854,622047,12.68,0.07
1682,2021-05-01,VEN,38562,18116,20446,490,177,42,274,19814,6433,4327,6034,36,935,29682,8880,ITH,ITH3,5,Veneto,Veneto,4905854,660609,13.47,0.79
1683,2021-02-06,VEN,4093,1353,2740,3098,542,367,4,19,5,3,0,1,54,709,3384,ITH,ITH3,5,Veneto,Veneto,4905854,664702,13.55,0.08
1684,2021-01-24,VEN,4117,1219,2898,3763,94,222,4,5,1,1,1,0,26,28,4089,ITH,ITH3,5,Veneto,Veneto,4905854,668819,13.63,0.08
1685,2021-04-16,VEN,24300,10438,13862,744,300,443,123,544,5845,10053,5698,35,515,12387,11913,ITH,ITH3,5,Veneto,Veneto,4905854,693119,14.13,0.5
1686,2021-03-22,VEN,18086,8131,9955,1478,1154,549,2496,211,2765,6701,1614,783,335,13044,5042,ITH,ITH3,5,Veneto,Veneto,4905854,711205,14.5,0.37
1687,2021-03-23,VEN,22141,10185,11956,1303,1131,678,2868,284,5283,6687,2361,1046,500,17423,4718,ITH,ITH3,5,Veneto,Veneto,4905854,733346,14.95,0.45
1688,2021-03-24,VEN,22020,9503,12517,1215,1051,807,3108,264,1505,10424,2227,970,449,15212,6808,ITH,ITH3,5,Veneto,Veneto,4905854,755366,15.4,0.45
1689,2021-04-10,VEN,27361,11934,15427,591,313,407,115,431,9432,10762,4994,15,301,18884,8477,ITH,ITH3,5,Veneto,Veneto,4905854,782727,15.95,0.56
1690,2021-04-02,VEN,23902,10520,13382,1214,510,379,299,496,7187,9632,3573,210,402,17572,6330,ITH,ITH3,5,Veneto,Veneto,4905854,806629,16.44,0.49
1691,2021-03-04,VEN,12906,4819,8087,3218,844,1422,2833,91,56,3415,318,471,238,9441,3465,ITH,ITH3,5,Veneto,Veneto,4905854,819535,16.71,0.26
1692,2021-04-19,VEN,21493,8906,12587,966,187,287,209,545,3114,11437,4402,22,324,5079,16414,ITH,ITH3,5,Veneto,Veneto,4905854,841028,17.14,0.44
1693,2021-04-29,VEN,49837,23202,26635,639,215,430,217,22871,10552,5626,7914,161,1212,36668,13169,ITH,ITH3,5,Veneto,Veneto,4905854,890865,18.16,1.02
1694,2021-02-22,VEN,7013,3041,3972,758,138,362,244,26,15,5401,40,1,28,6626,387,ITH,ITH3,5,Veneto,Veneto,4905854,897878,18.3,0.14
1695,2021-02-08,VEN,4974,1540,3434,2823,784,1178,4,37,8,12,1,0,127,1930,3044,ITH,ITH3,5,Veneto,Veneto,4905854,902852,18.4,0.1
1696,2021-01-01,VEN,1527,471,1056,1513,7,1,3,0,0,0,0,0,3,1527,0,ITH,ITH3,5,Veneto,Veneto,4905854,904379,18.43,0.03
1697,2021-01-27,VEN,7140,2065,5075,5406,723,879,9,89,23,2,0,0,9,245,6895,ITH,ITH3,5,Veneto,Veneto,4905854,911519,18.58,0.15
1698,2021-01-05,VEN,7329,2182,5147,5447,662,1122,5,23,2,1,0,2,65,7329,0,ITH,ITH3,5,Veneto,Veneto,4905854,918848,18.73,0.15
1699,2021-01-20,VEN,1038,368,670,695,116,213,1,5,1,2,0,0,5,386,652,ITH,ITH3,5,Veneto,Veneto,4905854,919886,18.75,0.02
1700,2021-02-02,VEN,6410,1847,4563,2999,1135,1999,3,27,6,153,6,0,82,392,6018,ITH,ITH3,5,Veneto,Veneto,4905854,926296,18.88,0.13
1701,2021-04-18,VEN,17509,7254,10255,520,155,69,110,380,2324,7390,6311,14,236,9916,7593,ITH,ITH3,5,Veneto,Veneto,4905854,943805,19.24,0.36
1702,2021-04-27,VEN,27869,12657,15212,864,222,283,75,3071,13292,4537,4958,45,522,20951,6918,ITH,ITH3,5,Veneto,Veneto,4905854,971674,19.81,0.57
1703,2020-12-27,VEN,880,395,485,875,1,0,1,0,1,0,0,0,2,880,0,ITH,ITH3,5,Veneto,Veneto,4905854,972554,19.82,0.02
1704,2021-04-03,VEN,21872,9592,12280,1868,302,150,129,385,6142,8258,4129,31,478,14155,7717,ITH,ITH3,5,Veneto,Veneto,4905854,994426,20.27,0.45
1705,2021-01-28,VEN,9208,2662,6546,6585,1080,1451,5,40,2,7,2,0,36,173,9035,ITH,ITH3,5,Veneto,Veneto,4905854,1003634,20.46,0.19
1706,2021-04-21,VEN,31851,12972,18879,997,304,395,119,658,10422,13281,5168,16,491,15891,15960,ITH,ITH3,5,Veneto,Veneto,4905854,1035485,21.11,0.65
1707,2021-04-08,VEN,32171,14270,17901,1156,388,585,443,861,11059,10114,6948,120,497,24292,7879,ITH,ITH3,5,Veneto,Veneto,4905854,1067656,21.76,0.66
1708,2021-01-10,VEN,5032,1671,3361,3893,565,462,1,10,2,4,0,2,93,5032,0,ITH,ITH3,5,Veneto,Veneto,4905854,1072688,21.87,0.1
1709,2021-04-24,VEN,24581,10756,13825,606,262,106,59,631,10445,7045,4847,17,563,15516,9065,ITH,ITH3,5,Veneto,Veneto,4905854,1097269,22.37,0.5
1710,2021-02-18,VEN,5828,2455,3373,976,265,667,8,34,15,3798,3,1,61,5764,64,ITH,ITH3,5,Veneto,Veneto,4905854,1103097,22.49,0.12
1711,2021-02-27,VEN,8990,2693,6297,2322,180,65,4137,44,14,1964,32,86,146,8138,852,ITH,ITH3,5,Veneto,Veneto,4905854,1112087,22.67,0.18
1712,2021-04-04,VEN,7775,3531,4244,24,40,1,13,128,4953,1318,1257,2,39,6623,1152,ITH,ITH3,5,Veneto,Veneto,4905854,1119862,22.83,0.16
1713,2021-03-16,VEN,12482,5342,7140,1479,382,485,129,125,113,7719,1769,21,260,6872,5610,ITH,ITH3,5,Veneto,Veneto,4905854,1132344,23.08,0.25
1714,2021-02-25,VEN,7899,3339,4560,1548,342,476,297,34,35,4936,21,109,101,7294,605,ITH,ITH3,5,Veneto,Veneto,4905854,1140243,23.24,0.16
1715,2021-03-26,VEN,29490,13074,16416,1294,1752,1229,1922,467,8141,9813,3172,986,714,24025,5465,ITH,ITH3,5,Veneto,Veneto,4905854,1169733,23.84,0.6
1716,2021-02-19,VEN,7321,3139,4182,1561,573,664,9,35,16,4367,5,4,87,7117,204,ITH,ITH3,5,Veneto,Veneto,4905854,1177054,23.99,0.15
1717,2021-01-06,VEN,8131,2385,5746,6514,672,808,10,83,24,2,2,2,14,8131,0,ITH,ITH3,5,Veneto,Veneto,4905854,1185185,24.16,0.17
1718,2021-02-14,VEN,125,56,69,97,22,0,0,2,0,0,0,0,4,112,13,ITH,ITH3,5,Veneto,Veneto,4905854,1185310,24.16,0.0
1719,2021-01-08,VEN,9405,2835,6570,6133,1323,1807,12,65,18,4,1,1,41,9405,0,ITH,ITH3,5,Veneto,Veneto,4905854,1194715,24.35,0.19
1720,2021-04-28,VEN,31930,14974,16956,680,243,569,91,4650,15559,2747,6403,36,952,22968,8962,ITH,ITH3,5,Veneto,Veneto,4905854,1226645,25.0,0.65
1721,2021-05-03,VEN,40153,19564,20589,318,126,80,711,23103,6036,1623,6819,27,1310,33801,6352,ITH,ITH3,5,Veneto,Veneto,4905854,1266798,25.82,0.82
1722,2021-01-16,VEN,4607,1541,3066,3196,670,657,0,14,6,0,0,1,63,4607,0,ITH,ITH3,5,Veneto,Veneto,4905854,1271405,25.92,0.09
1723,2021-03-20,VEN,12932,5336,7596,710,269,320,2403,152,1615,4728,2100,219,416,10833,2099,ITH,ITH3,5,Veneto,Veneto,4905854,1284337,26.18,0.26
1724,2021-04-01,VEN,24861,10906,13955,1055,604,586,161,669,7029,9825,4145,291,496,18490,6371,ITH,ITH3,5,Veneto,Veneto,4905854,1309198,26.69,0.51
1725,2021-03-19,VEN,13790,5668,8122,2161,862,516,727,157,127,7564,1254,55,367,7695,6095,ITH,ITH3,5,Veneto,Veneto,4905854,1322988,26.97,0.28
1726,2021-04-26,VEN,20568,9377,11191,463,156,122,87,907,10573,2997,4638,49,576,15414,5154,ITH,ITH3,5,Veneto,Veneto,4905854,1343556,27.39,0.42
1727,2021-01-17,VEN,1933,781,1152,1589,193,120,2,3,1,3,0,0,22,1584,349,ITH,ITH3,5,Veneto,Veneto,4905854,1345489,27.43,0.04
1728,2021-04-25,VEN,18259,8129,10130,354,94,112,59,416,9064,4025,3907,4,224,13432,4827,ITH,ITH3,5,Veneto,Veneto,4905854,1363748,27.8,0.37
1729,2021-04-06,VEN,28695,13196,15499,443,202,389,105,523,16640,5361,4744,69,219,23621,5074,ITH,ITH3,5,Veneto,Veneto,4905854,1392443,28.38,0.58
1730,2021-02-24,VEN,8612,3678,4934,1592,411,521,14,35,28,5592,38,273,108,8128,484,ITH,ITH3,5,Veneto,Veneto,4905854,1401055,28.56,0.18
1731,2021-03-28,VEN,31285,13597,17688,1467,1447,172,2445,1170,8603,9244,3871,56,2810,27612,3673,ITH,ITH3,5,Veneto,Veneto,4905854,1432340,29.2,0.64
1732,2021-02-12,VEN,4313,1447,2866,2768,441,692,8,43,14,6,0,4,337,3741,572,ITH,ITH3,5,Veneto,Veneto,4905854,1436653,29.28,0.09
1733,2021-01-25,VEN,6467,2075,4392,5137,377,904,2,13,2,6,0,0,26,160,6307,ITH,ITH3,5,Veneto,Veneto,4905854,1443120,29.42,0.13
1734,2021-04-30,VEN,49360,23230,26130,639,310,397,242,21179,10455,5524,9167,102,1345,33779,15581,ITH,ITH3,5,Veneto,Veneto,4905854,1492480,30.42,1.01
1735,2021-03-05,VEN,13282,4978,8304,3643,692,1467,2979,109,50,3091,474,353,424,9622,3660,ITH,ITH3,5,Veneto,Veneto,4905854,1505762,30.69,0.27
1736,2021-01-11,VEN,7239,2101,5138,3688,1161,1958,8,58,22,254,6,0,84,7239,0,ITH,ITH3,5,Veneto,Veneto,4905854,1513001,30.84,0.15
1737,2021-01-15,VEN,5866,1821,4045,3124,992,1570,4,46,18,9,0,5,98,5866,0,ITH,ITH3,5,Veneto,Veneto,4905854,1518867,30.96,0.12
1738,2021-04-11,VEN,20956,8854,12102,1896,137,83,345,322,4310,8185,5404,11,263,14646,6310,ITH,ITH3,5,Veneto,Veneto,4905854,1539823,31.39,0.43
1739,2021-04-12,VEN,14758,6262,8496,693,117,122,939,273,2068,6044,4223,19,260,6623,8135,ITH,ITH3,5,Veneto,Veneto,4905854,1554581,31.69,0.3
1740,2021-03-08,VEN,13523,6186,7337,717,201,385,2947,84,54,7165,475,1149,346,9462,4061,ITH,ITH3,5,Veneto,Veneto,4905854,1568104,31.96,0.28
1741,2021-04-15,VEN,20721,8556,12165,758,255,487,688,432,3861,8857,4937,8,438,9912,10809,ITH,ITH3,5,Veneto,Veneto,4905854,1588825,32.39,0.42
1742,2021-05-02,VEN,37076,17187,19889,695,174,21,534,18901,4824,4499,6517,21,890,26762,10314,ITH,ITH3,5,Veneto,Veneto,4905854,1625901,33.14,0.76
1743,2021-01-14,VEN,7061,1924,5137,3349,1065,2491,4,26,7,17,1,0,101,7061,0,ITH,ITH3,5,Veneto,Veneto,4905854,1632962,33.29,0.14
1744,2021-04-07,VEN,35640,15999,19641,2016,689,758,358,950,18057,5562,6045,118,1087,28309,7331,ITH,ITH3,5,Veneto,Veneto,4905854,1668602,34.01,0.73
1745,2021-04-14,VEN,15734,6834,8900,815,264,183,137,407,3633,5523,4332,24,416,9107,6627,ITH,ITH3,5,Veneto,Veneto,4905854,1684336,34.33,0.32
1746,2021-02-11,VEN,4013,1239,2774,2661,390,804,8,20,8,10,6,2,104,3385,628,ITH,ITH3,5,Veneto,Veneto,4905854,1688349,34.41,0.08
1747,2021-01-12,VEN,5230,1516,3714,2275,855,1753,5,29,16,176,0,0,121,5230,0,ITH,ITH3,5,Veneto,Veneto,4905854,1693579,34.52,0.11
1748,2021-03-07,VEN,4464,1753,2711,1909,195,23,832,24,4,982,388,49,58,3911,553,ITH,ITH3,5,Veneto,Veneto,4905854,1698043,34.61,0.09
1749,2021-03-02,VEN,11449,4614,6835,2930,775,1197,1869,95,34,3290,465,468,326,8171,3278,ITH,ITH3,5,Veneto,Veneto,4905854,1709492,34.85,0.23
1750,2021-01-23,VEN,4051,1246,2805,3424,173,436,3,3,2,1,1,0,8,33,4018,ITH,ITH3,5,Veneto,Veneto,4905854,1713543,34.93,0.08
1751,2021-04-09,VEN,31053,13671,17382,1751,910,609,199,926,8474,9885,7274,97,928,22729,8324,ITH,ITH3,5,Veneto,Veneto,4905854,1744596,35.56,0.63
1752,2021-03-27,VEN,32012,13967,18045,2284,1676,197,1581,668,6996,12303,4038,222,2047,26204,5808,ITH,ITH3,5,Veneto,Veneto,4905854,1776608,36.21,0.65
1753,2021-03-13,VEN,17175,7256,9919,2682,1651,109,4041,274,210,4814,2103,462,829,14041,3134,ITH,ITH3,5,Veneto,Veneto,4905854,1793783,36.56,0.35
1754,2021-02-10,VEN,4751,1588,3163,3175,552,783,2,50,19,6,1,0,163,3697,1054,ITH,ITH3,5,Veneto,Veneto,4905854,1798534,36.66,0.1
1755,2021-02-15,VEN,4386,1821,2565,486,84,383,2,19,9,3272,55,14,62,4145,241,ITH,ITH3,5,Veneto,Veneto,4905854,1802920,36.75,0.09
1756,2021-03-25,VEN,25827,10948,14879,1535,1437,1020,2263,350,5621,9923,2251,842,585,19707,6120,ITH,ITH3,5,Veneto,Veneto,4905854,1828747,37.28,0.53
1757,2021-02-20,VEN,6421,2015,4406,1905,114,100,3243,31,10,968,3,6,41,6352,69,ITH,ITH3,5,Veneto,Veneto,4905854,1835168,37.41,0.13
1758,2021-04-07,FVG,7502,3324,4178,340,299,114,34,5,2712,2100,1878,13,7,6717,785,ITH,ITH4,6,Friuli-Venezia Giulia,Friuli Venezia Giulia,1215220,7502,0.62,0.62
1759,2021-02-27,FVG,3426,1178,2248,203,140,4,1503,1,0,1523,27,25,0,3425,1,ITH,ITH4,6,Friuli-Venezia Giulia,Friuli Venezia Giulia,1215220,10928,0.9,0.28
1760,2021-01-02,FVG,1217,471,746,1150,67,0,0,0,0,0,0,0,0,1217,0,ITH,ITH4,6,Friuli-Venezia Giulia,Friuli Venezia Giulia,1215220,12145,1.0,0.1
1761,2021-01-24,FVG,305,119,186,277,27,1,0,0,0,0,0,0,0,1,304,ITH,ITH4,6,Friuli-Venezia Giulia,Friuli Venezia Giulia,1215220,12450,1.02,0.03
1762,2021-01-14,FVG,2588,789,1799,1608,550,430,0,0,0,0,0,0,0,2588,0,ITH,ITH4,6,Friuli-Venezia Giulia,Friuli Venezia Giulia,1215220,15038,1.24,0.21
1763,2021-01-07,FVG,2092,718,1374,1760,222,110,0,0,0,0,0,0,0,2092,0,ITH,ITH4,6,Friuli-Venezia Giulia,Friuli Venezia Giulia,1215220,17130,1.41,0.17
1764,2021-04-28,FVG,7182,3179,4003,256,131,39,4,357,2050,1825,2477,3,40,3711,3471,ITH,ITH4,6,Friuli-Venezia Giulia,Friuli Venezia Giulia,1215220,24312,2.0,0.59
1765,2021-03-04,FVG,3425,1591,1834,357,216,96,402,1,1,1815,33,504,0,2783,642,ITH,ITH4,6,Friuli-Venezia Giulia,Friuli Venezia Giulia,1215220,27737,2.28,0.28
1766,2021-01-08,FVG,2322,747,1575,1680,242,396,0,1,0,0,0,0,3,2322,0,ITH,ITH4,6,Friuli-Venezia Giulia,Friuli Venezia Giulia,1215220,30059,2.47,0.19
1767,2021-03-26,FVG,5806,2429,3377,500,212,234,754,22,650,2050,1264,88,32,3791,2015,ITH,ITH4,6,Friuli-Venezia Giulia,Friuli Venezia Giulia,1215220,35865,2.95,0.48
1768,2021-04-19,FVG,6692,3127,3565,190,155,39,29,264,1103,1762,3138,2,10,3281,3411,ITH,ITH4,6,Friuli-Venezia Giulia,Friuli Venezia Giulia,1215220,42557,3.5,0.55
1769,2021-02-18,FVG,3217,1492,1725,229,122,331,983,0,0,1502,16,34,0,2811,406,ITH,ITH4,6,Friuli-Venezia Giulia,Friuli Venezia Giulia,1215220,45774,3.77,0.26
1770,2021-02-19,FVG,3254,1290,1964,568,309,315,426,0,0,1589,11,35,1,2825,429,ITH,ITH4,6,Friuli-Venezia Giulia,Friuli Venezia Giulia,1215220,49028,4.03,0.27
1771,2021-02-20,FVG,2068,933,1135,11,1,148,306,0,2,1584,16,0,0,1924,144,ITH,ITH4,6,Friuli-Venezia Giulia,Friuli Venezia Giulia,1215220,51096,4.2,0.17
1772,2021-03-12,FVG,3942,1545,2397,178,63,47,589,1,5,2865,92,101,1,2562,1380,ITH,ITH4,6,Friuli-Venezia Giulia,Friuli Venezia Giulia,1215220,55038,4.53,0.32
1773,2021-02-01,FVG,2097,688,1409,1590,372,135,0,0,0,0,0,0,0,16,2081,ITH,ITH4,6,Friuli-Venezia Giulia,Friuli Venezia Giulia,1215220,57135,4.7,0.17
1774,2021-02-13,FVG,567,179,388,337,230,0,0,0,0,0,0,0,0,561,6,ITH,ITH4,6,Friuli-Venezia Giulia,Friuli Venezia Giulia,1215220,57702,4.75,0.05
1775,2021-02-08,FVG,2357,694,1663,1401,521,435,0,0,0,0,0,0,0,92,2265,ITH,ITH4,6,Friuli-Venezia Giulia,Friuli Venezia Giulia,1215220,60059,4.94,0.19
1776,2021-01-18,FVG,1962,607,1355,1360,492,110,0,0,0,0,0,0,0,1868,94,ITH,ITH4,6,Friuli-Venezia Giulia,Friuli Venezia Giulia,1215220,62021,5.1,0.16
1777,2021-01-27,FVG,1272,425,847,851,357,64,0,0,0,0,0,0,0,450,822,ITH,ITH4,6,Friuli-Venezia Giulia,Friuli Venezia Giulia,1215220,63293,5.21,0.1
1778,2021-02-12,FVG,1200,428,772,674,392,128,1,0,1,2,1,0,1,1150,50,ITH,ITH4,6,Friuli-Venezia Giulia,Friuli Venezia Giulia,1215220,64493,5.31,0.1
1779,2021-04-30,FVG,7148,3156,3992,336,238,43,7,323,1141,1721,3293,2,44,3578,3570,ITH,ITH4,6,Friuli-Venezia Giulia,Friuli Venezia Giulia,1215220,71641,5.9,0.59
1780,2021-04-15,FVG,6472,2852,3620,218,66,83,5,251,1122,1954,2751,1,21,5199,1273,ITH,ITH4,6,Friuli-Venezia Giulia,Friuli Venezia Giulia,1215220,78113,6.43,0.53
1781,2021-03-08,FVG,4041,1574,2467,694,513,140,436,0,7,2190,22,39,0,1953,2088,ITH,ITH4,6,Friuli-Venezia Giulia,Friuli Venezia Giulia,1215220,82154,6.76,0.33
1782,2021-05-04,FVG,7208,3244,3964,239,89,3,7,420,1021,1473,3945,5,6,4066,3142,ITH,ITH4,6,Friuli-Venezia Giulia,Friuli Venezia Giulia,1215220,89362,7.35,0.59
1783,2021-04-10,FVG,4985,2158,2827,157,187,81,77,28,733,2086,1600,14,22,3760,1225,ITH,ITH4,6,Friuli-Venezia Giulia,Friuli Venezia Giulia,1215220,94347,7.76,0.41
1784,2021-03-01,FVG,2958,1042,1916,93,81,176,949,1,1,1636,17,4,0,2905,53,ITH,ITH4,6,Friuli-Venezia Giulia,Friuli Venezia Giulia,1215220,97305,8.01,0.24
1785,2021-01-29,FVG,2414,814,1600,1856,321,237,0,0,0,0,0,0,0,264,2150,ITH,ITH4,6,Friuli-Venezia Giulia,Friuli Venezia Giulia,1215220,99719,8.21,0.2
1786,2021-03-22,FVG,3544,1344,2200,150,88,206,464,0,1,2471,155,6,3,1589,1955,ITH,ITH4,6,Friuli-Venezia Giulia,Friuli Venezia Giulia,1215220,103263,8.5,0.29
1787,2021-03-31,FVG,8039,3503,4536,170,108,296,878,5,2336,2163,1969,112,2,7190,849,ITH,ITH4,6,Friuli-Venezia Giulia,Friuli Venezia Giulia,1215220,111302,9.16,0.66
1788,2021-04-02,FVG,6580,2918,3662,370,243,84,3,1,609,3137,2093,15,25,4744,1836,ITH,ITH4,6,Friuli-Venezia Giulia,Friuli Venezia Giulia,1215220,117882,9.7,0.54
1789,2021-02-22,FVG,2493,1196,1297,431,312,115,5,1,0,1369,14,246,0,2075,418,ITH,ITH4,6,Friuli-Venezia Giulia,Friuli Venezia Giulia,1215220,120375,9.91,0.21
1790,2021-02-28,FVG,2669,989,1680,234,162,0,1488,0,0,405,1,379,0,2274,395,ITH,ITH4,6,Friuli-Venezia Giulia,Friuli Venezia Giulia,1215220,123044,10.13,0.22
1791,2021-02-25,FVG,3076,1608,1468,22,5,299,744,0,1,1557,12,436,0,3051,25,ITH,ITH4,6,Friuli-Venezia Giulia,Friuli Venezia Giulia,1215220,126120,10.38,0.25
1792,2021-02-21,FVG,800,281,519,213,166,27,1,0,0,382,10,1,0,423,377,ITH,ITH4,6,Friuli-Venezia Giulia,Friuli Venezia Giulia,1215220,126920,10.44,0.07
1793,2021-04-29,FVG,6535,2872,3663,350,147,6,7,392,1209,1469,2895,3,57,4044,2491,ITH,ITH4,6,Friuli-Venezia Giulia,Friuli Venezia Giulia,1215220,133455,10.98,0.54
1794,2021-03-15,FVG,3765,1637,2128,329,256,180,234,1,1,2426,101,237,0,1445,2320,ITH,ITH4,6,Friuli-Venezia Giulia,Friuli Venezia Giulia,1215220,137220,11.29,0.31
1795,2021-04-03,FVG,3982,1970,2012,36,580,4,149,3,3,2248,919,36,4,2653,1329,ITH,ITH4,6,Friuli-Venezia Giulia,Friuli Venezia Giulia,1215220,141202,11.62,0.33
1796,2021-01-04,FVG,1510,559,951,1392,118,0,0,0,0,0,0,0,0,1510,0,ITH,ITH4,6,Friuli-Venezia Giulia,Friuli Venezia Giulia,1215220,142712,11.74,0.12
1797,2021-01-19,FVG,7,2,5,5,0,2,0,0,0,0,0,0,0,7,0,ITH,ITH4,6,Friuli-Venezia Giulia,Friuli Venezia Giulia,1215220,142719,11.74,0.0
1798,2021-04-05,FVG,2868,1427,1441,34,222,13,121,3,607,468,1373,27,0,2852,16,ITH,ITH4,6,Friuli-Venezia Giulia,Friuli Venezia Giulia,1215220,145587,11.98,0.24
1799,2020-12-30,FVG,630,246,384,601,29,0,0,0,0,0,0,0,0,630,0,ITH,ITH4,6,Friuli-Venezia Giulia,Friuli Venezia Giulia,1215220,146217,12.03,0.05
1800,2021-04-27,FVG,8018,3682,4336,294,287,29,2,575,1893,2112,2785,1,40,3561,4457,ITH,ITH4,6,Friuli-Venezia Giulia,Friuli Venezia Giulia,1215220,154235,12.69,0.66
1801,2020-12-31,FVG,1053,384,669,1011,42,0,0,0,0,0,0,0,0,1053,0,ITH,ITH4,6,Friuli-Venezia Giulia,Friuli Venezia Giulia,1215220,155288,12.78,0.09
1802,2021-02-07,FVG,1562,483,1079,867,693,2,0,0,0,0,0,0,0,386,1176,ITH,ITH4,6,Friuli-Venezia Giulia,Friuli Venezia Giulia,1215220,156850,12.91,0.13
1803,2021-01-03,FVG,312,122,190,285,26,1,0,0,0,0,0,0,0,312,0,ITH,ITH4,6,Friuli-Venezia Giulia,Friuli Venezia Giulia,1215220,157162,12.93,0.03
1804,2021-02-05,FVG,2613,784,1829,1612,511,490,0,0,0,0,0,0,0,90,2523,ITH,ITH4,6,Friuli-Venezia Giulia,Friuli Venezia Giulia,1215220,159775,13.15,0.22
1805,2021-04-13,FVG,7360,3286,4074,349,306,189,23,245,2202,2232,1787,12,15,5754,1606,ITH,ITH4,6,Friuli-Venezia Giulia,Friuli Venezia Giulia,1215220,167135,13.75,0.61
1806,2021-03-30,FVG,7095,3143,3952,421,335,404,139,14,2004,1937,1785,53,3,6175,920,ITH,ITH4,6,Friuli-Venezia Giulia,Friuli Venezia Giulia,1215220,174230,14.34,0.58
1807,2021-01-30,FVG,2271,744,1527,1475,354,442,0,0,0,0,0,0,0,270,2001,ITH,ITH4,6,Friuli-Venezia Giulia,Friuli Venezia Giulia,1215220,176501,14.52,0.19
1808,2021-02-03,FVG,2647,791,1856,1702,558,386,0,0,0,1,0,0,0,23,2624,ITH,ITH4,6,Friuli-Venezia Giulia,Friuli Venezia Giulia,1215220,179148,14.74,0.22
1809,2021-05-03,FVG,6976,3184,3792,215,182,52,11,302,1345,1248,3589,9,23,3241,3735,ITH,ITH4,6,Friuli-Venezia Giulia,Friuli Venezia Giulia,1215220,186124,15.32,0.57
1810,2021-04-23,FVG,7420,3358,4062,300,138,53,8,418,1197,2202,3071,4,29,3573,3847,ITH,ITH4,6,Friuli-Venezia Giulia,Friuli Venezia Giulia,1215220,193544,15.93,0.61
1811,2021-01-10,FVG,2941,919,2022,1745,951,245,0,0,0,0,0,0,0,2941,0,ITH,ITH4,6,Friuli-Venezia Giulia,Friuli Venezia Giulia,1215220,196485,16.17,0.24
1812,2021-01-13,FVG,2651,834,1817,1822,599,230,0,0,0,0,0,0,0,2651,0,ITH,ITH4,6,Friuli-Venezia Giulia,Friuli Venezia Giulia,1215220,199136,16.39,0.22
1813,2021-02-02,FVG,2467,806,1661,1658,393,416,0,0,0,0,0,0,0,217,2250,ITH,ITH4,6,Friuli-Venezia Giulia,Friuli Venezia Giulia,1215220,201603,16.59,0.2
1814,2021-03-06,FVG,3492,1194,2298,182,249,5,1465,0,0,1565,6,20,0,3166,326,ITH,ITH4,6,Friuli-Venezia Giulia,Friuli Venezia Giulia,1215220,205095,16.88,0.29
1815,2021-04-22,FVG,6731,3070,3661,122,110,34,2,329,1559,2117,2441,1,16,3059,3672,ITH,ITH4,6,Friuli-Venezia Giulia,Friuli Venezia Giulia,1215220,211826,17.43,0.55
1816,2021-05-01,FVG,7117,3216,3901,215,36,0,2,215,107,577,5904,3,58,6076,1041,ITH,ITH4,6,Friuli-Venezia Giulia,Friuli Venezia Giulia,1215220,218943,18.02,0.59
1817,2021-04-16,FVG,6890,2985,3905,289,182,171,16,308,982,2030,2891,1,20,4971,1919,ITH,ITH4,6,Friuli-Venezia Giulia,Friuli Venezia Giulia,1215220,225833,18.58,0.57
1818,2021-03-24,FVG,3772,1530,2242,183,183,148,427,1,21,2324,419,62,4,2290,1482,ITH,ITH4,6,Friuli-Venezia Giulia,Friuli Venezia Giulia,1215220,229605,18.89,0.31
1819,2021-04-18,FVG,5981,2770,3211,320,75,81,2,397,1485,728,2865,0,28,5575,406,ITH,ITH4,6,Friuli-Venezia Giulia,Friuli Venezia Giulia,1215220,235586,19.39,0.49
1820,2021-03-23,FVG,3761,1561,2200,321,303,245,241,0,3,2449,169,29,1,1618,2143,ITH,ITH4,6,Friuli-Venezia Giulia,Friuli Venezia Giulia,1215220,239347,19.7,0.31
1821,2021-03-03,FVG,3643,1629,2014,750,546,104,427,0,0,1331,15,470,0,2365,1278,ITH,ITH4,6,Friuli-Venezia Giulia,Friuli Venezia Giulia,1215220,242990,20.0,0.3
1822,2020-12-27,FVG,262,149,113,259,3,0,0,0,0,0,0,0,0,262,0,ITH,ITH4,6,Friuli-Venezia Giulia,Friuli Venezia Giulia,1215220,243252,20.02,0.02
1823,2021-04-17,FVG,7367,3206,4161,317,116,1,3,625,592,2425,3262,3,23,5885,1482,ITH,ITH4,6,Friuli-Venezia Giulia,Friuli Venezia Giulia,1215220,250619,20.62,0.61
1824,2021-02-06,FVG,1154,338,816,755,208,191,0,0,0,0,0,0,0,22,1132,ITH,ITH4,6,Friuli-Venezia Giulia,Friuli Venezia Giulia,1215220,251773,20.72,0.09
1825,2021-01-22,FVG,90,30,60,89,1,0,0,0,0,0,0,0,0,0,90,ITH,ITH4,6,Friuli-Venezia Giulia,Friuli Venezia Giulia,1215220,251863,20.73,0.01
1826,2021-04-24,FVG,6644,2926,3718,430,55,0,1,522,281,1987,3311,1,56,5400,1244,ITH,ITH4,6,Friuli-Venezia Giulia,Friuli Venezia Giulia,1215220,258507,21.27,0.55
1827,2021-01-31,FVG,2715,836,1879,1693,1004,18,0,0,0,0,0,0,0,385,2330,ITH,ITH4,6,Friuli-Venezia Giulia,Friuli Venezia Giulia,1215220,261222,21.5,0.22
1828,2021-03-17,FVG,3236,1268,1968,430,219,199,6,0,1,2247,131,3,0,743,2493,ITH,ITH4,6,Friuli-Venezia Giulia,Friuli Venezia Giulia,1215220,264458,21.76,0.27
1829,2021-03-10,FVG,3362,1494,1868,306,301,209,195,0,1,1973,67,309,1,1570,1792,ITH,ITH4,6,Friuli-Venezia Giulia,Friuli Venezia Giulia,1215220,267820,22.04,0.28
1830,2021-03-27,FVG,4983,2560,2423,60,811,1,98,3,906,1990,1096,16,2,3572,1411,ITH,ITH4,6,Friuli-Venezia Giulia,Friuli Venezia Giulia,1215220,272803,22.45,0.41
1831,2021-04-21,FVG,7697,3440,4257,108,73,30,9,549,2463,2057,2398,4,6,4015,3682,ITH,ITH4,6,Friuli-Venezia Giulia,Friuli Venezia Giulia,1215220,280500,23.08,0.63
1832,2021-03-14,FVG,1397,548,849,0,1,0,797,0,0,248,16,335,0,1144,253,ITH,ITH4,6,Friuli-Venezia Giulia,Friuli Venezia Giulia,1215220,281897,23.2,0.11
1833,2021-02-10,FVG,1352,496,856,745,487,119,1,0,0,0,0,0,0,1266,86,ITH,ITH4,6,Friuli-Venezia Giulia,Friuli Venezia Giulia,1215220,283249,23.31,0.11
1834,2021-04-08,FVG,7172,3002,4170,261,145,237,34,4,1533,2973,1971,4,10,5250,1922,ITH,ITH4,6,Friuli-Venezia Giulia,Friuli Venezia Giulia,1215220,290421,23.9,0.59
1835,2021-01-26,FVG,1975,647,1328,1442,152,381,0,0,0,0,0,0,0,214,1761,ITH,ITH4,6,Friuli-Venezia Giulia,Friuli Venezia Giulia,1215220,292396,24.06,0.16
1836,2021-03-29,FVG,6878,3002,3876,240,211,161,316,10,2110,2417,1358,47,8,5298,1580,ITH,ITH4,6,Friuli-Venezia Giulia,Friuli Venezia Giulia,1215220,299274,24.63,0.57
1837,2021-01-12,FVG,2260,713,1547,1529,370,361,0,0,0,0,0,0,0,2260,0,ITH,ITH4,6,Friuli-Venezia Giulia,Friuli Venezia Giulia,1215220,301534,24.81,0.19
1838,2021-03-09,FVG,3863,1590,2273,657,480,200,424,2,4,2005,28,60,3,1110,2753,ITH,ITH4,6,Friuli-Venezia Giulia,Friuli Venezia Giulia,1215220,305397,25.13,0.32
1839,2021-03-28,FVG,4808,2272,2536,13,745,5,1306,8,1526,425,662,111,7,4668,140,ITH,ITH4,6,Friuli-Venezia Giulia,Friuli Venezia Giulia,1215220,310205,25.53,0.4
1840,2021-03-19,FVG,3236,1341,1895,107,47,296,134,0,0,2513,139,0,0,1302,1934,ITH,ITH4,6,Friuli-Venezia Giulia,Friuli Venezia Giulia,1215220,313441,25.79,0.27
1841,2021-01-17,FVG,1720,524,1196,674,560,486,0,0,0,0,0,0,0,1720,0,ITH,ITH4,6,Friuli-Venezia Giulia,Friuli Venezia Giulia,1215220,315161,25.93,0.14
1842,2021-04-26,FVG,5421,2442,2979,186,147,16,14,328,2093,700,1884,5,48,3783,1638,ITH,ITH4,6,Friuli-Venezia Giulia,Friuli Venezia Giulia,1215220,320582,26.38,0.45
1843,2021-01-25,FVG,1584,568,1016,1371,141,72,0,0,0,0,0,0,0,194,1390,ITH,ITH4,6,Friuli-Venezia Giulia,Friuli Venezia Giulia,1215220,322166,26.51,0.13
1844,2021-02-23,FVG,2615,1252,1363,104,44,247,1,0,2,1943,19,255,0,2437,178,ITH,ITH4,6,Friuli-Venezia Giulia,Friuli Venezia Giulia,1215220,324781,26.73,0.22
1845,2021-02-26,FVG,3740,2094,1646,75,26,561,299,0,2,1739,5,1033,0,3593,147,ITH,ITH4,6,Friuli-Venezia Giulia,Friuli Venezia Giulia,1215220,328521,27.03,0.31
1846,2021-04-12,FVG,7242,3180,4062,281,182,230,22,97,1739,2081,2585,4,21,6115,1127,ITH,ITH4,6,Friuli-Venezia Giulia,Friuli Venezia Giulia,1215220,335763,27.63,0.6
1847,2021-03-21,FVG,2600,937,1663,6,9,88,1119,0,0,1333,3,27,15,2192,408,ITH,ITH4,6,Friuli-Venezia Giulia,Friuli Venezia Giulia,1215220,338363,27.84,0.21
1848,2021-01-21,FVG,895,345,550,864,31,0,0,0,0,0,0,0,0,1,894,ITH,ITH4,6,Friuli-Venezia Giulia,Friuli Venezia Giulia,1215220,339258,27.92,0.07
1849,2021-04-11,FVG,3436,1521,1915,233,100,7,27,13,535,1225,1270,7,19,2530,906,ITH,ITH4,6,Friuli-Venezia Giulia,Friuli Venezia Giulia,1215220,342694,28.2,0.28
1850,2021-03-18,FVG,3375,1423,1952,60,23,168,4,1,1,2865,253,0,0,1693,1682,ITH,ITH4,6,Friuli-Venezia Giulia,Friuli Venezia Giulia,1215220,346069,28.48,0.28
1851,2021-03-05,FVG,3742,1481,2261,1050,654,77,146,0,8,1733,26,46,2,2669,1073,ITH,ITH4,6,Friuli-Venezia Giulia,Friuli Venezia Giulia,1215220,349811,28.79,0.31
1852,2021-01-23,FVG,816,324,492,768,48,0,0,0,0,0,0,0,0,4,812,ITH,ITH4,6,Friuli-Venezia Giulia,Friuli Venezia Giulia,1215220,350627,28.85,0.07
1853,2021-03-07,FVG,2537,926,1611,1,5,153,1782,0,0,143,0,453,0,2536,1,ITH,ITH4,6,Friuli-Venezia Giulia,Friuli Venezia Giulia,1215220,353164,29.06,0.21
1854,2021-03-02,FVG,4220,1518,2702,1163,659,203,634,0,1,1538,17,5,0,2717,1503,ITH,ITH4,6,Friuli-Venezia Giulia,Friuli Venezia Giulia,1215220,357384,29.41,0.35
1855,2021-04-09,FVG,7698,3501,4197,298,172,77,23,56,1280,2622,3162,0,8,6478,1220,ITH,ITH4,6,Friuli-Venezia Giulia,Friuli Venezia Giulia,1215220,365082,30.04,0.63
1856,2021-02-24,FVG,2518,1082,1436,23,5,312,297,1,0,1835,15,0,30,2500,18,ITH,ITH4,6,Friuli-Venezia Giulia,Friuli Venezia Giulia,1215220,367600,30.25,0.21
1857,2021-04-14,FVG,7188,3108,4080,336,224,77,3,281,1563,2148,2546,2,8,5473,1715,ITH,ITH4,6,Friuli-Venezia Giulia,Friuli Venezia Giulia,1215220,374788,30.84,0.59
1858,2021-02-11,FVG,1935,665,1270,1134,566,230,0,0,1,3,0,1,0,1742,193,ITH,ITH4,6,Friuli-Venezia Giulia,Friuli Venezia Giulia,1215220,376723,31.0,0.16
1859,2021-03-20,FVG,3347,1353,1994,415,279,10,66,2,1,2382,13,179,0,1252,2095,ITH,ITH4,6,Friuli-Venezia Giulia,Friuli Venezia Giulia,1215220,380070,31.28,0.28
1860,2021-02-17,FVG,2352,998,1354,329,178,230,0,0,0,1555,14,46,0,1873,479,ITH,ITH4,6,Friuli-Venezia Giulia,Friuli Venezia Giulia,1215220,382422,31.47,0.19
1861,2021-02-16,FVG,2516,1135,1381,260,244,221,0,0,3,1760,28,0,0,2400,116,ITH,ITH4,6,Friuli-Venezia Giulia,Friuli Venezia Giulia,1215220,384938,31.68,0.21
1862,2021-03-16,FVG,3155,1288,1867,330,256,245,1,0,3,2203,117,0,0,1075,2080,ITH,ITH4,6,Friuli-Venezia Giulia,Friuli Venezia Giulia,1215220,388093,31.94,0.26
1863,2021-02-09,FVG,1848,556,1292,1053,509,286,0,0,0,0,0,0,0,1559,289,ITH,ITH4,6,Friuli-Venezia Giulia,Friuli Venezia Giulia,1215220,389941,32.09,0.15
1864,2021-03-25,FVG,5313,2261,3052,55,57,303,835,3,956,2059,980,63,2,3178,2135,ITH,ITH4,6,Friuli-Venezia Giulia,Friuli Venezia Giulia,1215220,395254,32.53,0.44
1865,2021-02-15,FVG,2454,909,1545,700,390,316,0,0,4,1034,10,0,0,2204,250,ITH,ITH4,6,Friuli-Venezia Giulia,Friuli Venezia Giulia,1215220,397708,32.73,0.2
1866,2021-01-09,FVG,2518,841,1677,1519,406,593,0,0,0,0,0,0,0,2518,0,ITH,ITH4,6,Friuli-Venezia Giulia,Friuli Venezia Giulia,1215220,400226,32.93,0.21
1867,2021-03-13,FVG,2935,1119,1816,12,4,86,723,1,2,2058,9,40,0,1662,1273,ITH,ITH4,6,Friuli-Venezia Giulia,Friuli Venezia Giulia,1215220,403161,33.18,0.24
1868,2021-01-20,FVG,751,323,428,719,32,0,0,0,0,0,0,0,0,12,739,ITH,ITH4,6,Friuli-Venezia Giulia,Friuli Venezia Giulia,1215220,403912,33.24,0.06
1869,2021-01-05,FVG,1680,551,1129,1350,133,197,0,0,0,0,0,0,0,1680,0,ITH,ITH4,6,Friuli-Venezia Giulia,Friuli Venezia Giulia,1215220,405592,33.38,0.14
1870,2021-02-04,FVG,2731,807,1924,1723,543,465,0,0,0,0,0,0,0,36,2695,ITH,ITH4,6,Friuli-Venezia Giulia,Friuli Venezia Giulia,1215220,408323,33.6,0.22
1871,2021-04-06,FVG,6282,2773,3509,256,204,132,29,5,1099,2696,1838,19,4,5130,1152,ITH,ITH4,6,Friuli-Venezia Giulia,Friuli Venezia Giulia,1215220,414605,34.12,0.52
1872,2021-04-25,FVG,2360,988,1372,331,50,0,1,733,478,66,684,0,17,2349,11,ITH,ITH4,6,Friuli-Venezia Giulia,Friuli Venezia Giulia,1215220,416965,34.31,0.19
1873,2021-01-16,FVG,1231,360,871,771,212,248,0,0,0,0,0,0,0,1231,0,ITH,ITH4,6,Friuli-Venezia Giulia,Friuli Venezia Giulia,1215220,418196,34.41,0.1
1874,2021-04-01,FVG,6326,2999,3327,172,118,208,94,2,1171,2058,2435,57,11,5311,1015,ITH,ITH4,6,Friuli-Venezia Giulia,Friuli Venezia Giulia,1215220,424522,34.93,0.52
1875,2021-04-20,FVG,7102,3056,4046,498,314,38,8,430,1150,2362,2295,1,6,3198,3904,ITH,ITH4,6,Friuli-Venezia Giulia,Friuli Venezia Giulia,1215220,431624,35.52,0.58
1876,2021-01-06,FVG,710,264,446,515,195,0,0,0,0,0,0,0,0,710,0,ITH,ITH4,6,Friuli-Venezia Giulia,Friuli Venezia Giulia,1215220,432334,35.58,0.06
1877,2021-03-11,FVG,3343,1405,1938,263,114,290,504,1,2,2014,35,118,2,1594,1749,ITH,ITH4,6,Friuli-Venezia Giulia,Friuli Venezia Giulia,1215220,435677,35.85,0.28
1878,2021-01-28,FVG,2237,793,1444,1756,287,194,0,0,0,0,0,0,0,354,1883,ITH,ITH4,6,Friuli-Venezia Giulia,Friuli Venezia Giulia,1215220,437914,36.04,0.18
1879,2021-05-02,FVG,6703,3159,3544,262,104,1,6,415,429,1131,4314,2,39,3806,2897,ITH,ITH4,6,Friuli-Venezia Giulia,Friuli Venezia Giulia,1215220,444617,36.59,0.55
1880,2021-01-15,FVG,2028,606,1422,1283,370,375,0,0,0,0,0,0,0,2028,0,ITH,ITH4,6,Friuli-Venezia Giulia,Friuli Venezia Giulia,1215220,446645,36.75,0.17
1881,2021-01-11,FVG,1884,609,1275,1502,336,46,0,0,0,0,0,0,0,1884,0,ITH,ITH4,6,Friuli-Venezia Giulia,Friuli Venezia Giulia,1215220,448529,36.91,0.16
1882,2021-04-18,SIC,19800,9895,9905,243,84,105,95,6005,1815,2686,8669,15,83,15411,4389,ITG,ITG1,19,Sicilia,Sicilia,4999891,19800,0.4,0.4
1883,2021-04-24,SIC,31334,14798,16536,443,161,353,136,4690,2833,5667,16656,99,296,23643,7691,ITG,ITG1,19,Sicilia,Sicilia,4999891,51134,1.02,0.63
1884,2021-01-31,SIC,4113,1959,2154,2602,835,295,0,61,26,26,0,0,268,114,3999,ITG,ITG1,19,Sicilia,Sicilia,4999891,55247,1.1,0.08
1885,2021-02-10,SIC,4434,1819,2615,1975,1154,741,0,59,33,18,0,0,454,4009,425,ITG,ITG1,19,Sicilia,Sicilia,4999891,59681,1.19,0.09
1886,2021-02-17,SIC,5434,3294,2140,1531,719,887,2,39,8,10,0,1999,239,4760,674,ITG,ITG1,19,Sicilia,Sicilia,4999891,65115,1.3,0.11
1887,2021-04-21,SIC,22652,10878,11774,552,222,348,121,1670,1614,3738,14108,29,250,16454,6198,ITG,ITG1,19,Sicilia,Sicilia,4999891,87767,1.76,0.45
1888,2021-03-23,SIC,21146,10117,11029,886,434,433,1648,185,3540,5914,7399,405,302,15490,5656,ITG,ITG1,19,Sicilia,Sicilia,4999891,108913,2.18,0.42
1889,2021-03-14,SIC,8835,3951,4884,571,415,180,678,146,1692,4351,148,67,587,4977,3858,ITG,ITG1,19,Sicilia,Sicilia,4999891,117748,2.36,0.18
1890,2021-04-27,SIC,26399,12700,13699,618,224,408,103,1794,1786,4414,16758,97,197,15570,10829,ITG,ITG1,19,Sicilia,Sicilia,4999891,144147,2.88,0.53
1891,2021-01-10,SIC,3619,1615,2004,2127,552,464,0,42,22,92,0,0,320,3619,0,ITG,ITG1,19,Sicilia,Sicilia,4999891,147766,2.96,0.07
1892,2021-03-15,SIC,10876,4736,6140,1255,496,731,1155,60,1533,4920,134,308,284,5803,5073,ITG,ITG1,19,Sicilia,Sicilia,4999891,158642,3.17,0.22
1893,2021-01-28,SIC,9334,4403,4931,7470,1371,295,0,35,11,4,0,0,148,414,8920,ITG,ITG1,19,Sicilia,Sicilia,4999891,167976,3.36,0.19
1894,2021-02-14,SIC,1057,402,655,433,300,236,0,9,3,4,0,0,72,917,140,ITG,ITG1,19,Sicilia,Sicilia,4999891,169033,3.38,0.02
1895,2021-03-16,SIC,10177,4467,5710,1665,549,852,218,60,128,5733,621,75,276,4025,6152,ITG,ITG1,19,Sicilia,Sicilia,4999891,179210,3.58,0.2
1896,2021-04-20,SIC,19363,9117,10246,475,281,458,59,1477,1443,3614,11411,22,123,14003,5360,ITG,ITG1,19,Sicilia,Sicilia,4999891,198573,3.97,0.39
1897,2021-01-02,SIC,4876,2536,2340,4315,144,0,0,87,7,2,0,0,321,4876,0,ITG,ITG1,19,Sicilia,Sicilia,4999891,203449,4.07,0.1
1898,2021-04-28,SIC,29511,13845,15666,653,236,450,96,2462,2176,4518,18393,170,357,20285,9226,ITG,ITG1,19,Sicilia,Sicilia,4999891,232960,4.66,0.59
1899,2021-02-02,SIC,5542,2624,2918,3157,1562,429,0,50,7,21,0,0,316,634,4908,ITG,ITG1,19,Sicilia,Sicilia,4999891,238502,4.77,0.11
1900,2021-05-03,SIC,23508,10847,12661,613,268,284,88,1695,1780,3072,15404,128,176,13608,9900,ITG,ITG1,19,Sicilia,Sicilia,4999891,262010,5.24,0.47
1901,2021-05-01,SIC,24429,11313,13116,439,163,146,105,2722,2076,2534,15977,78,189,19235,5194,ITG,ITG1,19,Sicilia,Sicilia,4999891,286439,5.73,0.49
1902,2020-12-28,SIC,207,124,83,205,2,0,0,0,0,0,0,0,0,207,0,ITG,ITG1,19,Sicilia,Sicilia,4999891,286646,5.73,0.0
1903,2021-01-15,SIC,5082,2234,2848,2826,1047,479,0,67,19,2,0,0,642,5082,0,ITG,ITG1,19,Sicilia,Sicilia,4999891,291728,5.83,0.1
1904,2021-03-11,SIC,15506,6547,8959,1611,1276,1026,3325,200,2112,4052,158,993,753,12932,2574,ITG,ITG1,19,Sicilia,Sicilia,4999891,307234,6.14,0.31
1905,2021-01-11,SIC,5906,2592,3314,3923,1015,382,0,83,17,89,0,0,397,5906,0,ITG,ITG1,19,Sicilia,Sicilia,4999891,313140,6.26,0.12
1906,2021-03-24,SIC,21189,9916,11273,958,493,608,1463,346,3222,5953,7634,200,312,15300,5889,ITG,ITG1,19,Sicilia,Sicilia,4999891,334329,6.69,0.42
1907,2021-03-07,SIC,9300,3471,5829,968,561,479,3299,88,12,3462,18,227,186,8216,1084,ITG,ITG1,19,Sicilia,Sicilia,4999891,343629,6.87,0.19
1908,2021-03-26,SIC,17965,8370,9595,1074,582,365,1308,225,2838,5585,5621,125,242,12427,5538,ITG,ITG1,19,Sicilia,Sicilia,4999891,361594,7.23,0.36
1909,2021-02-28,SIC,7181,3072,4109,871,410,112,1359,90,7,3359,2,268,703,6551,630,ITG,ITG1,19,Sicilia,Sicilia,4999891,368775,7.38,0.14
1910,2021-04-07,SIC,15768,7766,8002,764,386,473,182,244,1685,4453,7162,81,338,8597,7171,ITG,ITG1,19,Sicilia,Sicilia,4999891,384543,7.69,0.32
1911,2021-01-16,SIC,2776,1195,1581,1329,561,298,0,24,15,6,0,0,543,2776,0,ITG,ITG1,19,Sicilia,Sicilia,4999891,387319,7.75,0.06
1912,2021-04-04,SIC,6988,3384,3604,192,106,184,44,114,855,2489,2895,17,92,5695,1293,ITG,ITG1,19,Sicilia,Sicilia,4999891,394307,7.89,0.14
1913,2021-01-23,SIC,4200,2168,2032,3961,200,16,0,1,2,0,0,0,20,225,3975,ITG,ITG1,19,Sicilia,Sicilia,4999891,398507,7.97,0.08
1914,2021-02-11,SIC,5335,2103,3232,2458,1444,891,0,77,25,7,0,0,433,4868,467,ITG,ITG1,19,Sicilia,Sicilia,4999891,403842,8.08,0.11
1915,2021-04-06,SIC,18193,8728,9465,807,279,609,188,280,1951,5486,8035,105,453,13863,4330,ITG,ITG1,19,Sicilia,Sicilia,4999891,422035,8.44,0.36
1916,2021-03-13,SIC,12466,5493,6973,1174,771,513,1768,210,2143,4707,133,203,844,7859,4607,ITG,ITG1,19,Sicilia,Sicilia,4999891,434501,8.69,0.25
1917,2021-02-04,SIC,6971,3200,3771,4431,1465,574,0,49,13,18,0,0,421,1460,5511,ITG,ITG1,19,Sicilia,Sicilia,4999891,441472,8.83,0.14
1918,2021-02-15,SIC,3987,1884,2103,1704,1004,636,26,28,10,14,11,352,202,3418,569,ITG,ITG1,19,Sicilia,Sicilia,4999891,445459,8.91,0.08
1919,2021-04-01,SIC,14513,6713,7800,625,239,520,191,129,2244,5124,4895,405,141,9784,4729,ITG,ITG1,19,Sicilia,Sicilia,4999891,459972,9.2,0.29
1920,2021-02-19,SIC,5179,2763,2416,1488,854,610,239,31,13,83,2,1541,318,4608,571,ITG,ITG1,19,Sicilia,Sicilia,4999891,465151,9.3,0.1
1921,2021-02-18,SIC,5507,3174,2333,1636,885,842,96,21,8,11,5,1836,167,5075,432,ITG,ITG1,19,Sicilia,Sicilia,4999891,470658,9.41,0.11
1922,2021-02-21,SIC,5178,2508,2670,379,165,174,153,38,6,3920,3,174,166,5070,108,ITG,ITG1,19,Sicilia,Sicilia,4999891,475836,9.52,0.1
1923,2021-05-04,SIC,18003,8458,9545,433,217,236,70,1488,1559,2520,11048,203,229,10638,7365,ITG,ITG1,19,Sicilia,Sicilia,4999891,493839,9.88,0.36
1924,2021-01-18,SIC,1579,659,920,723,167,229,0,22,11,0,0,0,427,1433,146,ITG,ITG1,19,Sicilia,Sicilia,4999891,495418,9.91,0.03
1925,2021-04-03,SIC,16400,7801,8599,439,167,283,199,1007,4322,4984,4565,36,398,13557,2843,ITG,ITG1,19,Sicilia,Sicilia,4999891,511818,10.24,0.33
1926,2021-03-27,SIC,15816,7465,8351,652,410,366,742,248,1826,5663,5580,56,273,10895,4921,ITG,ITG1,19,Sicilia,Sicilia,4999891,527634,10.55,0.32
1927,2021-02-12,SIC,4747,1853,2894,2301,1398,644,0,45,17,10,0,0,332,4416,331,ITG,ITG1,19,Sicilia,Sicilia,4999891,532381,10.65,0.09
1928,2021-01-27,SIC,7535,3839,3696,6331,819,152,0,44,11,7,0,0,171,189,7346,ITG,ITG1,19,Sicilia,Sicilia,4999891,539916,10.8,0.15
1929,2021-04-02,SIC,14077,6626,7451,633,223,377,205,131,2133,5229,4906,79,161,9284,4793,ITG,ITG1,19,Sicilia,Sicilia,4999891,553993,11.08,0.28
1930,2021-02-13,SIC,3107,1168,1939,1296,921,570,0,36,19,13,0,0,252,2850,257,ITG,ITG1,19,Sicilia,Sicilia,4999891,557100,11.14,0.06
1931,2021-01-25,SIC,7517,3701,3816,6638,577,70,0,21,7,44,0,0,160,322,7195,ITG,ITG1,19,Sicilia,Sicilia,4999891,564617,11.29,0.15
1932,2021-04-12,SIC,19109,9304,9805,427,153,399,118,1396,1675,3667,11053,27,194,11751,7358,ITG,ITG1,19,Sicilia,Sicilia,4999891,583726,11.67,0.38
1933,2021-03-20,SIC,18944,9094,9850,836,316,434,1221,191,2527,5565,7308,113,433,13554,5390,ITG,ITG1,19,Sicilia,Sicilia,4999891,602670,12.05,0.38
1934,2021-04-11,SIC,15512,7631,7881,220,102,188,97,795,1033,3252,9693,15,117,8482,7030,ITG,ITG1,19,Sicilia,Sicilia,4999891,618182,12.36,0.31
1935,2021-03-09,SIC,13247,5635,7612,1595,1210,713,3699,112,19,4036,218,1138,507,10871,2376,ITG,ITG1,19,Sicilia,Sicilia,4999891,631429,12.63,0.26
1936,2021-02-24,SIC,9602,4871,4731,1424,755,504,923,25,23,4101,1,1618,228,9006,596,ITG,ITG1,19,Sicilia,Sicilia,4999891,641031,12.82,0.19
1937,2021-04-22,SIC,27096,12803,14293,629,165,380,98,3052,2046,4402,16080,36,208,20571,6525,ITG,ITG1,19,Sicilia,Sicilia,4999891,668127,13.36,0.54
1938,2021-02-08,SIC,4086,1759,2327,2346,1028,397,0,37,5,16,0,0,257,2128,1958,ITG,ITG1,19,Sicilia,Sicilia,4999891,672213,13.44,0.08
1939,2021-01-07,SIC,9174,4240,4934,7695,974,210,0,64,8,2,0,0,221,9174,0,ITG,ITG1,19,Sicilia,Sicilia,4999891,681387,13.63,0.18
1940,2021-02-16,SIC,4414,2300,2114,1465,976,818,1,35,9,27,8,878,197,3947,467,ITG,ITG1,19,Sicilia,Sicilia,4999891,685801,13.72,0.09
1941,2021-01-09,SIC,7326,3424,3902,5034,1070,456,0,117,36,41,0,0,572,7326,0,ITG,ITG1,19,Sicilia,Sicilia,4999891,693127,13.86,0.15
1942,2021-03-31,SIC,14676,6776,7900,649,299,539,190,140,2230,5251,5095,108,175,9648,5028,ITG,ITG1,19,Sicilia,Sicilia,4999891,707803,14.16,0.29
1943,2021-03-08,SIC,13587,5851,7736,2014,1127,715,4001,135,24,3936,73,1025,537,10773,2814,ITG,ITG1,19,Sicilia,Sicilia,4999891,721390,14.43,0.27
1944,2021-03-29,SIC,15054,7051,8003,877,349,342,304,130,2532,5053,5184,104,179,10536,4518,ITG,ITG1,19,Sicilia,Sicilia,4999891,736444,14.73,0.3
1945,2021-01-30,SIC,7840,3570,4270,5453,1611,475,0,47,12,4,0,0,238,175,7665,ITG,ITG1,19,Sicilia,Sicilia,4999891,744284,14.89,0.16
1946,2021-01-14,SIC,5259,2518,2741,3052,1281,259,0,106,34,90,0,0,437,5259,0,ITG,ITG1,19,Sicilia,Sicilia,4999891,749543,14.99,0.11
1947,2021-03-21,SIC,15228,7338,7890,489,228,75,958,161,2142,4573,6221,112,269,11253,3975,ITG,ITG1,19,Sicilia,Sicilia,4999891,764771,15.3,0.3
1948,2021-01-13,SIC,5266,2491,2775,3046,1192,461,0,92,28,27,0,1,419,5266,0,ITG,ITG1,19,Sicilia,Sicilia,4999891,770037,15.4,0.11
1949,2021-03-04,SIC,15217,6561,8656,2812,1839,750,3832,117,36,4034,27,1207,563,11012,4205,ITG,ITG1,19,Sicilia,Sicilia,4999891,785254,15.71,0.3
1950,2021-03-05,SIC,15948,6877,9071,3193,1697,757,4085,94,30,4081,106,1489,416,11622,4326,ITG,ITG1,19,Sicilia,Sicilia,4999891,801202,16.02,0.32
1951,2021-04-29,SIC,31851,14851,17000,913,289,429,108,2656,2208,4638,20178,152,280,22397,9454,ITG,ITG1,19,Sicilia,Sicilia,4999891,833053,16.66,0.64
1952,2021-01-24,SIC,4343,2266,2077,3998,265,3,0,12,6,37,0,0,22,148,4195,ITG,ITG1,19,Sicilia,Sicilia,4999891,837396,16.75,0.09
1953,2021-02-23,SIC,8951,4690,4261,1268,736,535,581,16,9,4077,2,1486,241,8461,490,ITG,ITG1,19,Sicilia,Sicilia,4999891,846347,16.93,0.18
1954,2021-04-19,SIC,18595,8799,9796,671,435,387,80,917,1255,3505,11184,24,137,12867,5728,ITG,ITG1,19,Sicilia,Sicilia,4999891,864942,17.3,0.37
1955,2021-04-25,SIC,21330,10187,11143,252,135,126,51,3358,1751,3634,11823,54,146,16410,4920,ITG,ITG1,19,Sicilia,Sicilia,4999891,886272,17.73,0.43
1956,2021-01-04,SIC,8373,4172,4201,7595,547,6,0,26,8,2,0,0,189,8373,0,ITG,ITG1,19,Sicilia,Sicilia,4999891,894645,17.89,0.17
1957,2021-03-03,SIC,14721,6548,8173,2409,1522,526,3833,68,15,4374,44,1427,503,11622,3099,ITG,ITG1,19,Sicilia,Sicilia,4999891,909366,18.19,0.29
1958,2021-04-23,SIC,28930,13854,15076,641,221,411,109,4086,2412,4344,16434,64,208,22985,5945,ITG,ITG1,19,Sicilia,Sicilia,4999891,938296,18.77,0.58
1959,2021-04-05,SIC,8194,4035,4159,232,72,177,56,116,964,2926,3584,5,62,6753,1441,ITG,ITG1,19,Sicilia,Sicilia,4999891,946490,18.93,0.16
1960,2021-02-25,SIC,10175,5279,4896,1772,927,527,672,30,7,4058,26,1743,413,8995,1180,ITG,ITG1,19,Sicilia,Sicilia,4999891,956665,19.13,0.2
1961,2021-02-01,SIC,6080,2685,3395,4168,1239,318,0,47,13,44,0,0,251,304,5776,ITG,ITG1,19,Sicilia,Sicilia,4999891,962745,19.26,0.12
1962,2021-04-14,SIC,20674,9943,10731,601,191,395,100,1634,1626,4180,11761,29,157,11836,8838,ITG,ITG1,19,Sicilia,Sicilia,4999891,983419,19.67,0.41
1963,2021-01-26,SIC,9530,4686,4844,8393,768,254,0,21,7,2,0,0,85,265,9265,ITG,ITG1,19,Sicilia,Sicilia,4999891,992949,19.86,0.19
1964,2021-04-09,SIC,20699,10101,10598,740,355,385,285,916,1937,4401,11350,89,241,11505,9194,ITG,ITG1,19,Sicilia,Sicilia,4999891,1013648,20.27,0.41
1965,2021-01-03,SIC,4695,2455,2240,4363,206,0,0,34,3,1,0,0,88,4695,0,ITG,ITG1,19,Sicilia,Sicilia,4999891,1018343,20.37,0.09
1966,2021-02-06,SIC,5071,2229,2842,2537,1496,592,0,36,12,5,0,0,393,1488,3583,ITG,ITG1,19,Sicilia,Sicilia,4999891,1023414,20.47,0.1
1967,2021-01-19,SIC,1276,523,753,525,125,238,0,20,13,18,0,0,337,1094,182,ITG,ITG1,19,Sicilia,Sicilia,4999891,1024690,20.49,0.03
1968,2021-02-03,SIC,6107,2860,3247,3360,1499,624,0,91,20,11,0,0,502,756,5351,ITG,ITG1,19,Sicilia,Sicilia,4999891,1030797,20.62,0.12
1969,2021-04-13,SIC,20161,9801,10360,674,217,330,127,1599,1867,3813,11356,41,137,11299,8862,ITG,ITG1,19,Sicilia,Sicilia,4999891,1050958,21.02,0.4
1970,2021-04-16,SIC,28851,14480,14371,746,332,661,107,8351,2388,4283,11771,33,179,20464,8387,ITG,ITG1,19,Sicilia,Sicilia,4999891,1079809,21.6,0.58
1971,2021-02-07,SIC,2349,997,1352,1611,435,157,0,16,9,1,0,0,120,675,1674,ITG,ITG1,19,Sicilia,Sicilia,4999891,1082158,21.64,0.05
1972,2021-04-08,SIC,17040,8401,8639,701,430,484,158,235,1585,3877,9160,132,278,8516,8524,ITG,ITG1,19,Sicilia,Sicilia,4999891,1099198,21.98,0.34
1973,2021-03-02,SIC,14958,6390,8568,2384,1211,525,4334,50,5,4535,57,1411,446,12133,2825,ITG,ITG1,19,Sicilia,Sicilia,4999891,1114156,22.28,0.3
1974,2021-05-02,SIC,24778,11491,13287,469,152,113,102,2785,1832,2255,16694,62,314,18136,6642,ITG,ITG1,19,Sicilia,Sicilia,4999891,1138934,22.78,0.5
1975,2021-03-25,SIC,20557,9552,11005,1330,541,630,1381,256,3206,5611,7179,195,228,15015,5542,ITG,ITG1,19,Sicilia,Sicilia,4999891,1159491,23.19,0.41
1976,2021-03-30,SIC,14630,6773,7857,717,403,390,255,149,2531,5128,4720,171,166,9802,4828,ITG,ITG1,19,Sicilia,Sicilia,4999891,1174121,23.48,0.29
1977,2021-01-20,SIC,810,412,398,424,59,192,0,20,2,0,0,0,113,573,237,ITG,ITG1,19,Sicilia,Sicilia,4999891,1174931,23.5,0.02
1978,2021-01-17,SIC,1299,587,712,621,319,160,0,12,8,3,0,0,176,1245,54,ITG,ITG1,19,Sicilia,Sicilia,4999891,1176230,23.53,0.03
1979,2021-04-26,SIC,21978,10406,11572,490,221,475,73,1392,1356,3696,14081,51,143,13821,8157,ITG,ITG1,19,Sicilia,Sicilia,4999891,1198208,23.96,0.44
1980,2020-12-29,SIC,235,146,89,235,0,0,0,0,0,0,0,0,0,235,0,ITG,ITG1,19,Sicilia,Sicilia,4999891,1198443,23.97,0.0
1981,2021-03-06,SIC,12956,5184,7772,2003,1212,878,3652,106,20,3963,65,704,353,10049,2907,ITG,ITG1,19,Sicilia,Sicilia,4999891,1211399,24.23,0.26
1982,2021-03-22,SIC,16871,7949,8922,916,359,370,1231,151,2166,5647,5682,121,228,11318,5553,ITG,ITG1,19,Sicilia,Sicilia,4999891,1228270,24.57,0.34
1983,2021-04-10,SIC,20690,10104,10586,487,196,367,240,1395,1768,4248,11738,44,207,11631,9059,ITG,ITG1,19,Sicilia,Sicilia,4999891,1248960,24.98,0.41
1984,2021-02-05,SIC,7217,3232,3985,3618,1903,856,0,74,32,109,0,0,625,2132,5085,ITG,ITG1,19,Sicilia,Sicilia,4999891,1256177,25.12,0.14
1985,2020-12-30,SIC,173,101,72,156,11,0,0,0,0,0,0,0,6,173,0,ITG,ITG1,19,Sicilia,Sicilia,4999891,1256350,25.13,0.0
1986,2021-04-30,SIC,34966,16361,18605,952,358,294,183,2954,2630,5030,22017,203,345,23744,11222,ITG,ITG1,19,Sicilia,Sicilia,4999891,1291316,25.83,0.7
1987,2021-02-26,SIC,12249,5978,6271,1837,1124,399,2454,47,18,3954,1,1854,561,10559,1690,ITG,ITG1,19,Sicilia,Sicilia,4999891,1303565,26.07,0.24
1988,2021-02-09,SIC,4372,1831,2541,2241,872,640,0,59,27,15,0,0,518,3365,1007,ITG,ITG1,19,Sicilia,Sicilia,4999891,1307937,26.16,0.09
1989,2021-03-17,SIC,15459,7578,7881,1406,547,688,306,158,206,5778,6051,73,246,9512,5947,ITG,ITG1,19,Sicilia,Sicilia,4999891,1323396,26.47,0.31
1990,2021-02-22,SIC,8042,4164,3878,1110,452,561,322,30,10,4149,0,1153,255,7548,494,ITG,ITG1,19,Sicilia,Sicilia,4999891,1331438,26.63,0.16
1991,2021-03-19,SIC,16556,8145,8411,1266,590,622,456,149,579,5435,7124,52,283,10811,5745,ITG,ITG1,19,Sicilia,Sicilia,4999891,1347994,26.96,0.33
1992,2021-01-06,SIC,6472,3403,3069,5718,434,2,0,51,31,15,0,0,221,6472,0,ITG,ITG1,19,Sicilia,Sicilia,4999891,1354466,27.09,0.13
1993,2021-04-15,SIC,21421,10412,11009,801,448,345,112,1746,1531,4207,11997,35,199,11831,9590,ITG,ITG1,19,Sicilia,Sicilia,4999891,1375887,27.52,0.43
1994,2021-01-08,SIC,8328,3864,4464,6591,942,213,0,78,33,23,0,0,448,8328,0,ITG,ITG1,19,Sicilia,Sicilia,4999891,1384215,27.68,0.17
1995,2021-03-01,SIC,12985,6131,6854,1559,1042,395,3154,58,18,4377,34,1859,489,11326,1659,ITG,ITG1,19,Sicilia,Sicilia,4999891,1397200,27.94,0.26
1996,2021-03-28,SIC,11043,5186,5857,536,303,171,187,90,948,4521,4117,28,142,7026,4017,ITG,ITG1,19,Sicilia,Sicilia,4999891,1408243,28.17,0.22
1997,2021-01-12,SIC,4543,2235,2308,2863,1177,195,0,61,14,29,0,0,204,4543,0,ITG,ITG1,19,Sicilia,Sicilia,4999891,1412786,28.26,0.09
1998,2020-12-31,SIC,878,470,408,828,6,0,0,4,0,0,0,0,40,878,0,ITG,ITG1,19,Sicilia,Sicilia,4999891,1413664,28.27,0.02
1999,2021-01-05,SIC,10528,5160,5368,9075,915,207,0,47,7,4,0,0,273,10528,0,ITG,ITG1,19,Sicilia,Sicilia,4999891,1424192,28.48,0.21
2000,2021-01-22,SIC,1239,628,611,1039,59,118,0,3,0,0,0,0,20,242,997,ITG,ITG1,19,Sicilia,Sicilia,4999891,1425431,28.51,0.02
2001,2021-01-01,SIC,815,437,378,740,29,0,0,10,0,0,0,0,36,815,0,ITG,ITG1,19,Sicilia,Sicilia,4999891,1426246,28.53,0.02
2002,2021-01-29,SIC,9365,4323,5042,7155,1601,305,0,27,8,79,1,0,189,433,8932,ITG,ITG1,19,Sicilia,Sicilia,4999891,1435611,28.71,0.19
2003,2021-03-18,SIC,15647,7796,7851,1285,500,617,37,162,191,5468,7023,73,291,9920,5727,ITG,ITG1,19,Sicilia,Sicilia,4999891,1451258,29.03,0.31
2004,2021-03-12,SIC,13146,5622,7524,1391,873,751,2407,238,1989,3885,158,627,827,10922,2224,ITG,ITG1,19,Sicilia,Sicilia,4999891,1464404,29.29,0.26
2005,2021-02-27,SIC,12450,5570,6880,1515,777,280,3371,149,11,3976,2,1146,1223,11239,1211,ITG,ITG1,19,Sicilia,Sicilia,4999891,1476854,29.54,0.25
2006,2021-03-10,SIC,13991,5977,8014,1481,1362,983,3767,148,24,4189,154,1120,763,11600,2391,ITG,ITG1,19,Sicilia,Sicilia,4999891,1490845,29.82,0.28
2007,2021-01-21,SIC,1342,653,689,1013,125,138,0,11,4,0,0,0,51,500,842,ITG,ITG1,19,Sicilia,Sicilia,4999891,1492187,29.84,0.03
2008,2021-04-17,SIC,26214,13243,12971,324,118,249,89,7813,2371,3876,11185,31,158,19056,7158,ITG,ITG1,19,Sicilia,Sicilia,4999891,1518401,30.37,0.52
2009,2020-12-27,SIC,90,54,36,62,1,26,0,0,0,0,0,0,1,90,0,ITG,ITG1,19,Sicilia,Sicilia,4999891,1518491,30.37,0.0
2010,2021-02-20,SIC,7285,3737,3548,848,712,561,175,39,14,3987,9,730,210,7033,252,ITG,ITG1,19,Sicilia,Sicilia,4999891,1525776,30.52,0.15
2011,2021-01-26,BAS,793,350,443,622,70,35,0,18,0,0,0,0,48,101,692,ITF,ITF5,17,Basilicata,Basilicata,559084,793,0.14,0.14
2012,2021-01-31,BAS,77,24,53,75,2,0,0,0,0,0,0,0,0,0,77,ITF,ITF5,17,Basilicata,Basilicata,559084,870,0.16,0.01
2013,2021-02-10,BAS,547,237,310,176,153,127,1,0,0,90,0,0,0,495,52,ITF,ITF5,17,Basilicata,Basilicata,559084,1417,0.25,0.1
2014,2021-04-13,BAS,2147,1064,1083,149,15,1,73,425,443,824,179,7,31,1312,835,ITF,ITF5,17,Basilicata,Basilicata,559084,3564,0.64,0.38
2015,2021-03-27,BAS,2083,778,1305,18,34,0,381,14,22,1560,30,5,19,1767,316,ITF,ITF5,17,Basilicata,Basilicata,559084,5647,1.01,0.37
2016,2021-04-15,BAS,3456,1677,1779,115,37,1,35,243,207,739,2039,6,34,2646,810,ITF,ITF5,17,Basilicata,Basilicata,559084,9103,1.63,0.62
2017,2021-03-10,BAS,1650,814,836,101,57,33,273,1,4,877,2,300,2,811,839,ITF,ITF5,17,Basilicata,Basilicata,559084,10753,1.92,0.3
2018,2021-03-08,BAS,1450,707,743,221,158,38,273,7,12,410,2,299,30,840,610,ITF,ITF5,17,Basilicata,Basilicata,559084,12203,2.18,0.26
2019,2021-03-28,BAS,2149,746,1403,92,6,8,714,3,8,1279,7,2,30,2126,23,ITF,ITF5,17,Basilicata,Basilicata,559084,14352,2.57,0.38
2020,2021-03-20,BAS,1286,566,720,45,69,0,178,0,8,950,30,5,1,275,1011,ITF,ITF5,17,Basilicata,Basilicata,559084,15638,2.8,0.23
2021,2021-04-06,BAS,1423,486,937,211,72,7,597,29,8,348,62,27,62,1227,196,ITF,ITF5,17,Basilicata,Basilicata,559084,17061,3.05,0.25
2022,2021-04-26,BAS,4467,2163,2304,24,12,0,74,440,1008,180,2636,17,76,4245,222,ITF,ITF5,17,Basilicata,Basilicata,559084,21528,3.85,0.8
2023,2021-03-19,BAS,2285,989,1296,58,96,0,142,1,8,1950,3,22,5,261,2024,ITF,ITF5,17,Basilicata,Basilicata,559084,23813,4.26,0.41
2024,2021-01-29,BAS,613,229,384,398,38,70,0,41,2,16,0,0,48,63,550,ITF,ITF5,17,Basilicata,Basilicata,559084,24426,4.37,0.11
2025,2021-02-24,BAS,1803,743,1060,85,14,2,0,4,8,1686,0,1,3,1734,69,ITF,ITF5,17,Basilicata,Basilicata,559084,26229,4.69,0.32
2026,2021-02-07,BAS,373,159,214,259,74,40,0,0,0,0,0,0,0,49,324,ITF,ITF5,17,Basilicata,Basilicata,559084,26602,4.76,0.07
2027,2021-01-17,BAS,328,133,195,233,12,54,0,5,1,0,0,0,23,327,1,ITF,ITF5,17,Basilicata,Basilicata,559084,26930,4.82,0.06
2028,2021-04-11,BAS,849,330,519,74,3,9,225,3,5,47,475,3,5,788,61,ITF,ITF5,17,Basilicata,Basilicata,559084,27779,4.97,0.15
2029,2021-01-21,BAS,30,10,20,0,0,0,0,2,0,4,0,0,24,30,0,ITF,ITF5,17,Basilicata,Basilicata,559084,27809,4.97,0.01
2030,2021-04-12,BAS,2269,1095,1174,229,24,31,102,729,442,523,163,14,12,1695,574,ITF,ITF5,17,Basilicata,Basilicata,559084,30078,5.38,0.41
2031,2021-02-23,BAS,1901,771,1130,159,24,35,0,4,15,1658,0,0,6,1763,138,ITF,ITF5,17,Basilicata,Basilicata,559084,31979,5.72,0.34
2032,2021-02-26,BAS,2148,904,1244,88,94,1,0,2,6,1954,0,0,3,2069,79,ITF,ITF5,17,Basilicata,Basilicata,559084,34127,6.1,0.38
2033,2021-01-25,BAS,1022,429,593,830,80,1,0,33,2,0,0,0,76,74,948,ITF,ITF5,17,Basilicata,Basilicata,559084,35149,6.29,0.18
2034,2021-03-21,BAS,1047,482,565,32,1,0,159,2,9,805,0,0,39,352,695,ITF,ITF5,17,Basilicata,Basilicata,559084,36196,6.47,0.19
2035,2021-03-05,BAS,1849,855,994,298,157,72,309,6,12,689,2,296,8,1104,745,ITF,ITF5,17,Basilicata,Basilicata,559084,38045,6.8,0.33
2036,2021-01-07,BAS,640,319,321,556,8,29,0,16,0,0,0,0,31,640,0,ITF,ITF5,17,Basilicata,Basilicata,559084,38685,6.92,0.11
2037,2021-04-04,BAS,543,215,328,9,8,0,88,7,0,406,20,4,1,130,413,ITF,ITF5,17,Basilicata,Basilicata,559084,39228,7.02,0.1
2038,2021-04-17,BAS,3457,1656,1801,53,7,0,10,13,17,1235,2105,12,5,2192,1265,ITF,ITF5,17,Basilicata,Basilicata,559084,42685,7.63,0.62
2039,2021-04-22,BAS,5037,2346,2691,61,17,23,85,273,903,1451,2080,61,83,3434,1603,ITF,ITF5,17,Basilicata,Basilicata,559084,47722,8.54,0.9
2040,2021-03-03,BAS,1740,813,927,191,298,99,244,3,3,590,58,253,1,1184,556,ITF,ITF5,17,Basilicata,Basilicata,559084,49462,8.85,0.31
2041,2021-03-06,BAS,1351,535,816,296,140,57,259,0,2,383,0,212,2,757,594,ITF,ITF5,17,Basilicata,Basilicata,559084,50813,9.09,0.24
2042,2021-01-22,BAS,67,24,43,6,0,0,0,13,10,19,0,0,19,67,0,ITF,ITF5,17,Basilicata,Basilicata,559084,50880,9.1,0.01
2043,2021-03-25,BAS,1767,582,1185,38,53,11,677,4,12,917,28,24,3,1453,314,ITF,ITF5,17,Basilicata,Basilicata,559084,52647,9.42,0.32
2044,2021-03-16,BAS,1900,799,1101,103,30,0,62,4,13,1672,2,6,8,228,1672,ITF,ITF5,17,Basilicata,Basilicata,559084,54547,9.76,0.34
2045,2021-01-09,BAS,557,160,397,386,55,67,1,7,0,0,0,0,41,557,0,ITF,ITF5,17,Basilicata,Basilicata,559084,55104,9.86,0.1
2046,2021-02-15,BAS,621,232,389,191,134,46,0,0,3,246,0,1,0,580,41,ITF,ITF5,17,Basilicata,Basilicata,559084,55725,9.97,0.11
2047,2021-03-13,BAS,1794,888,906,82,325,46,213,2,6,864,1,245,10,749,1045,ITF,ITF5,17,Basilicata,Basilicata,559084,57519,10.29,0.32
2048,2021-02-09,BAS,491,213,278,200,237,54,0,0,0,0,0,0,0,316,175,ITF,ITF5,17,Basilicata,Basilicata,559084,58010,10.38,0.09
2049,2020-12-27,BAS,106,41,65,104,0,0,0,0,0,0,0,0,2,106,0,ITF,ITF5,17,Basilicata,Basilicata,559084,58116,10.39,0.02
2050,2021-05-01,BAS,4704,2133,2571,78,23,9,339,432,704,94,2708,33,284,3954,750,ITF,ITF5,17,Basilicata,Basilicata,559084,62820,11.24,0.84
2051,2021-01-27,BAS,411,175,236,299,17,26,0,12,9,25,0,0,23,113,298,ITF,ITF5,17,Basilicata,Basilicata,559084,63231,11.31,0.07
2052,2021-01-02,BAS,949,380,569,855,43,0,3,9,0,0,0,0,39,949,0,ITF,ITF5,17,Basilicata,Basilicata,559084,64180,11.48,0.17
2053,2021-01-05,BAS,945,409,536,861,44,0,0,12,0,0,0,0,28,945,0,ITF,ITF5,17,Basilicata,Basilicata,559084,65125,11.65,0.17
2054,2021-01-20,BAS,84,22,62,0,0,0,0,10,8,43,0,0,23,84,0,ITF,ITF5,17,Basilicata,Basilicata,559084,65209,11.66,0.02
2055,2021-03-09,BAS,1391,706,685,222,51,33,238,2,2,545,0,292,6,787,604,ITF,ITF5,17,Basilicata,Basilicata,559084,66600,11.91,0.25
2056,2021-03-23,BAS,1198,492,706,49,5,2,279,5,2,827,5,21,3,1091,107,ITF,ITF5,17,Basilicata,Basilicata,559084,67798,12.13,0.21
2057,2021-04-20,BAS,4034,1917,2117,32,13,10,60,57,213,1699,1924,10,16,2197,1837,ITF,ITF5,17,Basilicata,Basilicata,559084,71832,12.85,0.72
2058,2021-01-15,BAS,813,350,463,578,21,174,0,5,1,1,0,0,33,813,0,ITF,ITF5,17,Basilicata,Basilicata,559084,72645,12.99,0.15
2059,2021-05-02,BAS,4187,2004,2183,54,8,0,175,296,766,24,2729,10,125,3558,629,ITF,ITF5,17,Basilicata,Basilicata,559084,76832,13.74,0.75
2060,2021-04-19,BAS,4215,1925,2290,79,21,58,125,30,103,1590,2159,11,39,2554,1661,ITF,ITF5,17,Basilicata,Basilicata,559084,81047,14.5,0.75
2061,2021-04-08,BAS,891,409,482,267,57,0,188,17,9,85,200,37,31,880,11,ITF,ITF5,17,Basilicata,Basilicata,559084,81938,14.66,0.16
2062,2021-01-11,BAS,183,66,117,107,21,41,0,4,0,0,0,0,10,183,0,ITF,ITF5,17,Basilicata,Basilicata,559084,82121,14.69,0.03
2063,2021-01-28,BAS,903,401,502,717,24,81,0,30,0,1,0,0,50,119,784,ITF,ITF5,17,Basilicata,Basilicata,559084,83024,14.85,0.16
2064,2021-03-11,BAS,1783,919,864,163,83,77,223,5,5,905,3,289,30,824,959,ITF,ITF5,17,Basilicata,Basilicata,559084,84807,15.17,0.32
2065,2021-03-02,BAS,791,381,410,110,33,5,213,5,4,184,0,237,0,656,135,ITF,ITF5,17,Basilicata,Basilicata,559084,85598,15.31,0.14
2066,2021-02-11,BAS,951,401,550,200,158,107,0,0,6,472,0,4,4,868,83,ITF,ITF5,17,Basilicata,Basilicata,559084,86549,15.48,0.17
2067,2021-04-14,BAS,2082,1011,1071,34,4,2,92,296,602,676,337,14,25,1392,690,ITF,ITF5,17,Basilicata,Basilicata,559084,88631,15.85,0.37
2068,2021-01-12,BAS,217,88,129,87,22,99,0,1,0,0,0,0,8,217,0,ITF,ITF5,17,Basilicata,Basilicata,559084,88848,15.89,0.04
2069,2021-01-23,BAS,712,301,411,597,38,1,0,18,2,8,0,0,48,33,679,ITF,ITF5,17,Basilicata,Basilicata,559084,89560,16.02,0.13
2070,2021-04-09,BAS,1156,353,803,142,16,1,624,12,13,138,128,50,32,1088,68,ITF,ITF5,17,Basilicata,Basilicata,559084,90716,16.23,0.21
2071,2021-01-14,BAS,969,413,556,504,112,323,0,6,0,0,0,0,24,969,0,ITF,ITF5,17,Basilicata,Basilicata,559084,91685,16.4,0.17
2072,2021-03-07,BAS,882,308,574,39,12,4,471,2,0,328,0,22,4,844,38,ITF,ITF5,17,Basilicata,Basilicata,559084,92567,16.56,0.16
2073,2021-01-18,BAS,463,157,306,364,52,45,0,0,0,0,0,0,2,364,99,ITF,ITF5,17,Basilicata,Basilicata,559084,93030,16.64,0.08
2074,2021-04-07,BAS,1407,582,825,271,21,20,585,8,10,109,340,23,20,1372,35,ITF,ITF5,17,Basilicata,Basilicata,559084,94437,16.89,0.25
2075,2021-05-03,BAS,4517,2045,2472,232,21,27,286,278,714,187,2633,16,123,3694,823,ITF,ITF5,17,Basilicata,Basilicata,559084,98954,17.7,0.81
2076,2021-03-04,BAS,1872,889,983,217,151,66,241,1,5,843,41,302,5,1079,793,ITF,ITF5,17,Basilicata,Basilicata,559084,100826,18.03,0.33
2077,2021-04-28,BAS,4712,2161,2551,117,51,11,41,335,1154,135,2736,11,121,4270,442,ITF,ITF5,17,Basilicata,Basilicata,559084,105538,18.88,0.84
2078,2021-02-20,BAS,1161,531,630,77,171,80,0,0,9,810,11,0,3,1043,118,ITF,ITF5,17,Basilicata,Basilicata,559084,106699,19.08,0.21
2079,2021-04-05,BAS,445,166,279,2,3,0,78,2,1,338,16,4,1,143,302,ITF,ITF5,17,Basilicata,Basilicata,559084,107144,19.16,0.08
2080,2021-02-14,BAS,151,48,103,55,12,65,0,0,1,18,0,0,0,151,0,ITF,ITF5,17,Basilicata,Basilicata,559084,107295,19.19,0.03
2081,2021-02-19,BAS,1622,737,885,219,360,66,0,1,13,962,0,0,1,1560,62,ITF,ITF5,17,Basilicata,Basilicata,559084,108917,19.48,0.29
2082,2021-03-26,BAS,1959,708,1251,196,8,3,475,13,9,1209,22,8,16,1697,262,ITF,ITF5,17,Basilicata,Basilicata,559084,110876,19.83,0.35
2083,2021-01-08,BAS,554,219,335,383,33,59,0,36,0,0,0,0,43,554,0,ITF,ITF5,17,Basilicata,Basilicata,559084,111430,19.93,0.1
2084,2021-02-01,BAS,242,91,151,156,24,48,0,4,1,0,0,0,9,46,196,ITF,ITF5,17,Basilicata,Basilicata,559084,111672,19.97,0.04
2085,2021-01-16,BAS,721,304,417,466,17,161,2,17,0,1,0,0,57,721,0,ITF,ITF5,17,Basilicata,Basilicata,559084,112393,20.1,0.13
2086,2021-03-12,BAS,1896,975,921,266,64,37,258,1,8,985,0,274,3,798,1098,ITF,ITF5,17,Basilicata,Basilicata,559084,114289,20.44,0.34
2087,2021-01-19,BAS,199,84,115,78,48,44,0,3,6,8,0,0,12,199,0,ITF,ITF5,17,Basilicata,Basilicata,559084,114488,20.48,0.04
2088,2021-04-25,BAS,2988,1460,1528,18,10,12,85,184,649,33,1947,10,40,2932,56,ITF,ITF5,17,Basilicata,Basilicata,559084,117476,21.01,0.53
2089,2021-01-04,BAS,607,271,336,550,49,0,2,1,0,0,0,0,5,607,0,ITF,ITF5,17,Basilicata,Basilicata,559084,118083,21.12,0.11
2090,2021-04-01,BAS,2851,1154,1697,79,33,24,293,15,23,2193,104,18,69,2136,715,ITF,ITF5,17,Basilicata,Basilicata,559084,120934,21.63,0.51
2091,2021-03-14,BAS,1008,477,531,41,110,8,249,0,3,516,0,79,2,539,469,ITF,ITF5,17,Basilicata,Basilicata,559084,121942,21.81,0.18
2092,2021-04-24,BAS,4543,2201,2342,50,16,2,102,371,878,771,2250,14,89,3560,983,ITF,ITF5,17,Basilicata,Basilicata,559084,126485,22.62,0.81
2093,2021-03-17,BAS,1449,606,843,22,12,0,2,6,9,1391,0,5,2,27,1422,ITF,ITF5,17,Basilicata,Basilicata,559084,127934,22.88,0.26
2094,2021-04-21,BAS,3937,1848,2089,20,6,0,66,114,231,1494,1963,21,22,2269,1668,ITF,ITF5,17,Basilicata,Basilicata,559084,131871,23.59,0.7
2095,2021-04-30,BAS,5294,2377,2917,133,58,2,381,350,895,478,2809,58,130,4128,1166,ITF,ITF5,17,Basilicata,Basilicata,559084,137165,24.53,0.95
2096,2021-05-04,BAS,4125,1986,2139,60,12,0,89,369,760,190,2435,10,200,3602,523,ITF,ITF5,17,Basilicata,Basilicata,559084,141290,25.27,0.74
2097,2021-02-12,BAS,775,332,443,288,192,90,0,3,4,192,0,6,0,744,31,ITF,ITF5,17,Basilicata,Basilicata,559084,142065,25.41,0.14
2098,2021-02-16,BAS,905,377,528,250,93,67,0,1,1,492,0,1,0,807,98,ITF,ITF5,17,Basilicata,Basilicata,559084,142970,25.57,0.16
2099,2021-02-27,BAS,1986,856,1130,103,123,21,0,16,6,1678,4,0,35,1822,164,ITF,ITF5,17,Basilicata,Basilicata,559084,144956,25.93,0.36
2100,2021-02-17,BAS,1135,493,642,123,53,57,1,0,12,885,0,1,3,1059,76,ITF,ITF5,17,Basilicata,Basilicata,559084,146091,26.13,0.2
2101,2021-02-04,BAS,1096,443,653,639,106,281,0,26,1,3,0,0,40,63,1033,ITF,ITF5,17,Basilicata,Basilicata,559084,147187,26.33,0.2
2102,2021-03-31,BAS,3254,1295,1959,69,46,0,234,20,13,2673,131,21,47,2470,784,ITF,ITF5,17,Basilicata,Basilicata,559084,150441,26.91,0.58
2103,2021-04-27,BAS,4727,2243,2484,81,21,5,23,340,1159,215,2794,18,71,4399,328,ITF,ITF5,17,Basilicata,Basilicata,559084,155168,27.75,0.85
2104,2021-01-06,BAS,294,129,165,229,9,36,0,6,0,0,0,0,14,294,0,ITF,ITF5,17,Basilicata,Basilicata,559084,155462,27.81,0.05
2105,2021-03-01,BAS,541,279,262,122,107,4,50,1,1,169,0,86,1,376,165,ITF,ITF5,17,Basilicata,Basilicata,559084,156003,27.9,0.1
2106,2021-02-18,BAS,1070,401,669,270,59,150,0,0,0,588,0,0,3,855,215,ITF,ITF5,17,Basilicata,Basilicata,559084,157073,28.09,0.19
2107,2021-03-18,BAS,1348,562,786,32,0,0,0,1,7,1306,0,0,2,24,1324,ITF,ITF5,17,Basilicata,Basilicata,559084,158421,28.34,0.24
2108,2021-02-28,BAS,802,342,460,32,29,0,0,0,0,740,0,0,1,774,28,ITF,ITF5,17,Basilicata,Basilicata,559084,159223,28.48,0.14
2109,2021-04-29,BAS,4851,2393,2458,191,62,1,13,550,834,76,2966,33,125,4429,422,ITF,ITF5,17,Basilicata,Basilicata,559084,164074,29.35,0.87
2110,2021-02-21,BAS,284,113,171,16,1,11,1,0,1,254,0,0,0,284,0,ITF,ITF5,17,Basilicata,Basilicata,559084,164358,29.4,0.05
2111,2021-02-25,BAS,1787,736,1051,67,3,0,0,1,6,1705,0,1,4,1741,46,ITF,ITF5,17,Basilicata,Basilicata,559084,166145,29.72,0.32
2112,2021-02-22,BAS,1790,773,1017,125,23,2,0,2,7,1627,0,0,4,1737,53,ITF,ITF5,17,Basilicata,Basilicata,559084,167935,30.04,0.32
2113,2021-02-08,BAS,557,193,364,436,72,49,0,0,0,0,0,0,0,151,406,ITF,ITF5,17,Basilicata,Basilicata,559084,168492,30.14,0.1
2114,2021-04-18,BAS,3725,1847,1878,30,6,0,17,44,214,1343,2053,15,3,2355,1370,ITF,ITF5,17,Basilicata,Basilicata,559084,172217,30.8,0.67
2115,2021-04-03,BAS,1823,759,1064,43,3,0,314,12,8,1113,294,14,22,1479,344,ITF,ITF5,17,Basilicata,Basilicata,559084,174040,31.13,0.33
2116,2021-03-29,BAS,2692,989,1703,71,20,1,674,15,10,1790,61,8,42,2352,340,ITF,ITF5,17,Basilicata,Basilicata,559084,176732,31.61,0.48
2117,2021-03-15,BAS,2347,981,1366,78,30,0,266,3,6,1934,1,23,6,520,1827,ITF,ITF5,17,Basilicata,Basilicata,559084,179079,32.03,0.42
2118,2021-02-02,BAS,367,143,224,212,15,102,0,9,1,0,0,2,26,175,192,ITF,ITF5,17,Basilicata,Basilicata,559084,179446,32.1,0.07
2119,2021-01-30,BAS,704,227,477,424,82,126,0,20,0,0,0,0,52,128,576,ITF,ITF5,17,Basilicata,Basilicata,559084,180150,32.22,0.13
2120,2021-02-03,BAS,666,300,366,425,15,172,0,40,1,0,0,0,13,32,634,ITF,ITF5,17,Basilicata,Basilicata,559084,180816,32.34,0.12
2121,2021-04-23,BAS,4544,2185,2359,75,29,6,46,233,997,766,2249,22,121,3538,1006,ITF,ITF5,17,Basilicata,Basilicata,559084,185360,33.15,0.81
2122,2021-01-03,BAS,900,344,556,790,53,0,2,7,0,0,0,0,48,900,0,ITF,ITF5,17,Basilicata,Basilicata,559084,186260,33.32,0.16
2123,2021-01-10,BAS,77,24,53,9,2,0,0,7,4,0,0,0,55,77,0,ITF,ITF5,17,Basilicata,Basilicata,559084,186337,33.33,0.01
2124,2021-03-30,BAS,2931,1197,1734,37,15,0,513,8,15,2206,99,13,25,2586,345,ITF,ITF5,17,Basilicata,Basilicata,559084,189268,33.85,0.52
2125,2021-02-05,BAS,984,443,541,611,38,191,0,23,8,5,0,0,108,64,920,ITF,ITF5,17,Basilicata,Basilicata,559084,190252,34.03,0.18
2126,2021-01-13,BAS,916,387,529,699,11,148,1,37,1,1,0,0,18,916,0,ITF,ITF5,17,Basilicata,Basilicata,559084,191168,34.19,0.16
2127,2021-03-24,BAS,1566,638,928,69,24,0,430,5,8,957,6,45,22,1210,356,ITF,ITF5,17,Basilicata,Basilicata,559084,192734,34.47,0.28
2128,2021-04-02,BAS,2329,1052,1277,98,34,2,25,18,33,1747,271,42,59,1722,607,ITF,ITF5,17,Basilicata,Basilicata,559084,195063,34.89,0.42
2129,2021-01-24,BAS,836,300,536,708,46,1,0,13,0,0,0,0,68,58,778,ITF,ITF5,17,Basilicata,Basilicata,559084,195899,35.04,0.15
2130,2021-02-06,BAS,902,367,535,546,186,168,1,1,0,0,0,0,0,146,756,ITF,ITF5,17,Basilicata,Basilicata,559084,196801,35.2,0.16
2131,2021-04-16,BAS,3357,1648,1709,32,21,1,71,19,35,888,2269,6,15,2439,918,ITF,ITF5,17,Basilicata,Basilicata,559084,200158,35.8,0.6
2132,2021-03-22,BAS,1173,530,643,46,68,0,385,2,5,642,7,16,2,626,547,ITF,ITF5,17,Basilicata,Basilicata,559084,201331,36.01,0.21
2133,2021-04-10,BAS,1043,386,657,65,12,8,490,5,4,148,283,21,7,961,82,ITF,ITF5,17,Basilicata,Basilicata,559084,202374,36.2,0.19
2134,2021-02-13,BAS,799,313,486,279,155,115,0,5,14,201,0,2,28,738,61,ITF,ITF5,17,Basilicata,Basilicata,559084,203173,36.34,0.14
2135,2021-04-27,MAR,9414,4315,5099,146,57,37,290,1367,3923,1045,2468,37,44,5414,4000,ITI,ITI3,11,Marche,Marche,1525271,9414,0.62,0.62
2136,2021-02-16,MAR,1292,475,817,737,434,92,0,3,2,0,0,0,24,1262,30,ITI,ITI3,11,Marche,Marche,1525271,10706,0.7,0.08
2137,2021-02-28,MAR,2841,1251,1590,19,6,0,2,2,3,2800,0,2,7,2835,6,ITI,ITI3,11,Marche,Marche,1525271,13547,0.89,0.19
2138,2021-03-25,MAR,6657,2774,3883,464,148,373,519,95,27,4383,258,122,268,3247,3410,ITI,ITI3,11,Marche,Marche,1525271,20204,1.32,0.44
2139,2021-01-23,MAR,560,190,370,441,55,63,0,0,0,0,0,0,1,123,437,ITI,ITI3,11,Marche,Marche,1525271,20764,1.36,0.04
2140,2021-03-22,MAR,5661,2378,3283,408,232,70,433,14,14,4183,19,238,50,2532,3129,ITI,ITI3,11,Marche,Marche,1525271,26425,1.73,0.37
2141,2021-04-29,MAR,13251,6066,7185,264,136,92,636,1908,3647,1415,4965,90,98,7158,6093,ITI,ITI3,11,Marche,Marche,1525271,39676,2.6,0.87
2142,2021-02-21,MAR,377,142,235,204,62,57,1,11,1,0,0,0,41,376,1,ITI,ITI3,11,Marche,Marche,1525271,40053,2.63,0.02
2143,2021-03-29,MAR,5898,2587,3311,228,147,39,215,34,67,4280,732,75,81,3446,2452,ITI,ITI3,11,Marche,Marche,1525271,45951,3.01,0.39
2144,2021-03-09,MAR,5533,2376,3157,754,226,41,1070,20,4,2588,124,652,54,4644,889,ITI,ITI3,11,Marche,Marche,1525271,51484,3.38,0.36
2145,2021-01-02,MAR,453,139,314,444,9,0,0,0,0,0,0,0,0,453,0,ITI,ITI3,11,Marche,Marche,1525271,51937,3.41,0.03
2146,2021-02-15,MAR,973,413,560,544,390,1,0,4,1,1,12,0,20,960,13,ITI,ITI3,11,Marche,Marche,1525271,52910,3.47,0.06
2147,2021-02-03,MAR,2125,742,1383,1344,569,166,0,4,5,2,0,0,35,119,2006,ITI,ITI3,11,Marche,Marche,1525271,55035,3.61,0.14
2148,2021-01-15,MAR,1771,500,1271,985,357,366,0,9,3,0,0,0,51,1771,0,ITI,ITI3,11,Marche,Marche,1525271,56806,3.72,0.12
2149,2021-04-23,MAR,11164,5141,6023,182,84,73,53,2841,3419,1686,2723,45,58,8108,3056,ITI,ITI3,11,Marche,Marche,1525271,67970,4.46,0.73
2150,2021-01-24,MAR,894,344,550,775,118,0,0,0,0,0,0,0,1,17,877,ITI,ITI3,11,Marche,Marche,1525271,68864,4.51,0.06
2151,2021-04-20,MAR,10726,5007,5719,181,74,101,87,1953,4637,594,3053,21,25,9301,1425,ITI,ITI3,11,Marche,Marche,1525271,79590,5.22,0.7
2152,2021-03-15,MAR,4513,2120,2393,300,81,11,242,38,8,3478,27,217,111,1423,3090,ITI,ITI3,11,Marche,Marche,1525271,84103,5.51,0.3
2153,2021-04-01,MAR,7606,3195,4411,391,239,46,284,37,159,4615,1692,70,73,4180,3426,ITI,ITI3,11,Marche,Marche,1525271,91709,6.01,0.5
2154,2021-01-03,MAR,896,348,548,759,130,0,0,1,0,0,0,0,6,896,0,ITI,ITI3,11,Marche,Marche,1525271,92605,6.07,0.06
2155,2021-01-04,MAR,1502,564,938,1291,195,11,0,1,0,0,0,0,4,1502,0,ITI,ITI3,11,Marche,Marche,1525271,94107,6.17,0.1
2156,2021-01-19,MAR,226,82,144,121,20,85,0,0,0,0,0,0,0,141,85,ITI,ITI3,11,Marche,Marche,1525271,94333,6.18,0.01
2157,2021-03-11,MAR,6832,2930,3902,1094,386,52,1148,25,9,3227,86,700,105,5461,1371,ITI,ITI3,11,Marche,Marche,1525271,101165,6.63,0.45
2158,2021-03-13,MAR,5877,2708,3169,664,168,58,237,26,10,4248,13,353,100,1916,3961,ITI,ITI3,11,Marche,Marche,1525271,107042,7.02,0.39
2159,2021-05-02,MAR,8905,3939,4966,275,116,4,936,1937,2169,745,2641,39,43,3163,5742,ITI,ITI3,11,Marche,Marche,1525271,115947,7.6,0.58
2160,2021-04-16,MAR,10171,4748,5423,324,155,76,513,228,3854,697,4094,21,209,9634,537,ITI,ITI3,11,Marche,Marche,1525271,126118,8.27,0.67
2161,2021-03-30,MAR,7449,3057,4392,524,321,277,367,44,113,4273,1385,80,65,4610,2839,ITI,ITI3,11,Marche,Marche,1525271,133567,8.76,0.49
2162,2021-01-13,MAR,2105,746,1359,1408,578,76,0,6,5,15,0,0,17,2105,0,ITI,ITI3,11,Marche,Marche,1525271,135672,8.89,0.14
2163,2021-02-06,MAR,2460,900,1560,1402,536,415,0,21,8,4,0,0,74,523,1937,ITI,ITI3,11,Marche,Marche,1525271,138132,9.06,0.16
2164,2021-02-05,MAR,2157,653,1504,1318,347,419,0,6,8,2,0,0,57,440,1717,ITI,ITI3,11,Marche,Marche,1525271,140289,9.2,0.14
2165,2021-04-19,MAR,9613,4500,5113,245,124,13,64,1479,4118,975,2416,36,143,8030,1583,ITI,ITI3,11,Marche,Marche,1525271,149902,9.83,0.63
2166,2021-02-19,MAR,1971,716,1255,1273,405,203,2,7,4,2,13,0,62,1836,135,ITI,ITI3,11,Marche,Marche,1525271,151873,9.96,0.13
2167,2021-02-18,MAR,2105,746,1359,1150,502,402,1,14,4,1,0,0,31,1817,288,ITI,ITI3,11,Marche,Marche,1525271,153978,10.1,0.14
2168,2021-03-27,MAR,7421,3084,4337,278,170,144,711,77,107,4087,1536,133,178,5052,2369,ITI,ITI3,11,Marche,Marche,1525271,161399,10.58,0.49
2169,2021-01-31,MAR,1929,773,1156,1533,392,0,0,1,0,0,0,0,3,105,1824,ITI,ITI3,11,Marche,Marche,1525271,163328,10.71,0.13
2170,2021-01-14,MAR,2010,692,1318,1112,558,298,0,4,1,0,0,0,37,2010,0,ITI,ITI3,11,Marche,Marche,1525271,165338,10.84,0.13
2171,2021-02-10,MAR,1439,452,987,881,292,215,0,6,1,0,0,0,44,1080,359,ITI,ITI3,11,Marche,Marche,1525271,166777,10.93,0.09
2172,2021-04-17,MAR,11752,5332,6420,204,152,130,614,326,4109,921,5166,14,116,10677,1075,ITI,ITI3,11,Marche,Marche,1525271,178529,11.7,0.77
2173,2021-03-10,MAR,5784,2490,3294,721,411,114,1042,12,11,2675,100,652,46,4647,1137,ITI,ITI3,11,Marche,Marche,1525271,184313,12.08,0.38
2174,2021-01-18,MAR,673,230,443,370,116,132,0,5,8,30,0,0,12,547,126,ITI,ITI3,11,Marche,Marche,1525271,184986,12.13,0.04
2175,2020-12-30,MAR,17,5,12,14,3,0,0,0,0,0,0,0,0,17,0,ITI,ITI3,11,Marche,Marche,1525271,185003,12.13,0.0
2176,2021-02-24,MAR,3496,1518,1978,229,191,214,1,5,4,2823,22,3,4,3416,80,ITI,ITI3,11,Marche,Marche,1525271,188499,12.36,0.23
2177,2021-01-17,MAR,1604,685,919,969,367,46,0,50,30,4,0,0,138,1550,54,ITI,ITI3,11,Marche,Marche,1525271,190103,12.46,0.11
2178,2021-03-02,MAR,4967,1943,3024,589,184,260,538,12,3,3320,4,3,54,4401,566,ITI,ITI3,11,Marche,Marche,1525271,195070,12.79,0.33
2179,2021-02-20,MAR,4127,1708,2419,118,118,261,0,17,13,3581,0,3,16,4016,111,ITI,ITI3,11,Marche,Marche,1525271,199197,13.06,0.27
2180,2021-04-28,MAR,10732,4891,5841,217,60,84,322,1631,3738,990,3400,42,248,6001,4731,ITI,ITI3,11,Marche,Marche,1525271,209929,13.76,0.7
2181,2021-04-09,MAR,9689,4263,5426,273,74,104,1321,108,2334,1619,3693,70,93,9487,202,ITI,ITI3,11,Marche,Marche,1525271,219618,14.4,0.64
2182,2021-04-26,MAR,8994,3987,5007,158,70,30,179,1740,4042,898,1776,42,59,5969,3025,ITI,ITI3,11,Marche,Marche,1525271,228612,14.99,0.59
2183,2021-03-20,MAR,4146,1745,2401,181,63,114,89,10,4,3641,14,12,18,1054,3092,ITI,ITI3,11,Marche,Marche,1525271,232758,15.26,0.27
2184,2021-04-05,MAR,5696,2359,3337,253,84,103,758,54,1005,2268,1112,28,31,4427,1269,ITI,ITI3,11,Marche,Marche,1525271,238454,15.63,0.37
2185,2021-04-11,MAR,7137,3126,4011,282,97,10,783,47,2168,1233,2453,44,20,6851,286,ITI,ITI3,11,Marche,Marche,1525271,245591,16.1,0.47
2186,2021-03-28,MAR,4134,1744,2390,45,45,6,396,17,32,2667,873,11,42,2439,1695,ITI,ITI3,11,Marche,Marche,1525271,249725,16.37,0.27
2187,2021-01-09,MAR,1709,605,1104,1406,238,0,0,17,2,0,0,0,46,1709,0,ITI,ITI3,11,Marche,Marche,1525271,251434,16.48,0.11
2188,2021-04-12,MAR,8593,3787,4806,179,83,88,1157,107,2848,1321,2613,79,118,8106,487,ITI,ITI3,11,Marche,Marche,1525271,260027,17.05,0.56
2189,2021-01-25,MAR,1597,560,1037,1426,111,56,0,0,0,2,0,0,2,97,1500,ITI,ITI3,11,Marche,Marche,1525271,261624,17.15,0.1
2190,2021-01-07,MAR,1802,633,1169,1480,279,0,0,8,0,0,0,0,35,1802,0,ITI,ITI3,11,Marche,Marche,1525271,263426,17.27,0.12
2191,2021-03-19,MAR,3870,1605,2265,495,135,293,6,5,7,2838,63,13,15,343,3527,ITI,ITI3,11,Marche,Marche,1525271,267296,17.52,0.25
2192,2021-02-12,MAR,1583,618,965,815,423,88,0,32,14,3,0,0,208,1431,152,ITI,ITI3,11,Marche,Marche,1525271,268879,17.63,0.1
2193,2021-04-21,MAR,10811,4978,5833,273,111,46,81,2394,4300,557,2874,43,132,9612,1199,ITI,ITI3,11,Marche,Marche,1525271,279690,18.34,0.71
2194,2021-02-04,MAR,2342,810,1532,1406,602,275,0,11,3,1,0,0,44,112,2230,ITI,ITI3,11,Marche,Marche,1525271,282032,18.49,0.15
2195,2021-04-06,MAR,8888,3698,5190,310,185,161,1729,97,1740,1890,2582,98,96,8073,815,ITI,ITI3,11,Marche,Marche,1525271,290920,19.07,0.58
2196,2021-04-25,MAR,8854,4119,4735,207,37,1,20,4116,2156,677,1603,22,15,7212,1642,ITI,ITI3,11,Marche,Marche,1525271,299774,19.65,0.58
2197,2021-01-22,MAR,487,167,320,315,74,87,0,1,0,0,0,0,10,194,293,ITI,ITI3,11,Marche,Marche,1525271,300261,19.69,0.03
2198,2021-03-14,MAR,2517,1036,1481,442,58,1,456,4,3,1537,5,2,9,1919,598,ITI,ITI3,11,Marche,Marche,1525271,302778,19.85,0.17
2199,2021-03-05,MAR,6294,2957,3337,1128,324,144,803,52,27,2389,185,1116,126,4827,1467,ITI,ITI3,11,Marche,Marche,1525271,309072,20.26,0.41
2200,2021-02-09,MAR,125,42,83,78,21,26,0,0,0,0,0,0,0,47,78,ITI,ITI3,11,Marche,Marche,1525271,309197,20.27,0.01
2201,2021-03-01,MAR,3728,1489,2239,388,138,87,286,4,1,2793,4,5,22,3480,248,ITI,ITI3,11,Marche,Marche,1525271,312925,20.52,0.24
2202,2021-04-30,MAR,13942,6102,7840,343,78,92,1476,1651,3683,1645,4814,55,105,5402,8540,ITI,ITI3,11,Marche,Marche,1525271,326867,21.43,0.91
2203,2021-03-03,MAR,6764,3096,3668,820,374,256,783,36,12,3134,195,1056,98,5883,881,ITI,ITI3,11,Marche,Marche,1525271,333631,21.87,0.44
2204,2021-02-27,MAR,3374,1440,1934,186,142,161,1,6,1,2848,17,6,6,3165,209,ITI,ITI3,11,Marche,Marche,1525271,337005,22.09,0.22
2205,2021-01-06,MAR,2181,792,1389,1738,261,147,0,5,1,0,0,0,29,2181,0,ITI,ITI3,11,Marche,Marche,1525271,339186,22.24,0.14
2206,2021-02-23,MAR,3274,1400,1874,219,57,118,0,7,4,2826,0,8,35,3218,56,ITI,ITI3,11,Marche,Marche,1525271,342460,22.45,0.21
2207,2021-03-31,MAR,7382,3087,4295,477,327,162,257,31,103,4560,1300,87,78,4356,3026,ITI,ITI3,11,Marche,Marche,1525271,349842,22.94,0.48
2208,2021-04-14,MAR,10279,4596,5683,418,161,80,1013,182,3551,902,3795,41,136,9905,374,ITI,ITI3,11,Marche,Marche,1525271,360121,23.61,0.67
2209,2021-02-11,MAR,1988,658,1330,1155,370,212,0,32,22,32,0,0,165,1599,389,ITI,ITI3,11,Marche,Marche,1525271,362109,23.74,0.13
2210,2021-02-22,MAR,3414,1499,1915,326,89,77,2,7,0,2869,1,5,38,3339,75,ITI,ITI3,11,Marche,Marche,1525271,365523,23.96,0.22
2211,2021-04-10,MAR,11114,4716,6398,313,170,80,1112,210,2823,2242,4035,53,76,10795,319,ITI,ITI3,11,Marche,Marche,1525271,376637,24.69,0.73
2212,2021-03-16,MAR,3577,1549,2028,317,71,56,5,7,6,2931,46,111,27,394,3183,ITI,ITI3,11,Marche,Marche,1525271,380214,24.93,0.23
2213,2021-04-04,MAR,3828,1793,2035,189,117,7,84,10,633,2010,755,10,13,2657,1171,ITI,ITI3,11,Marche,Marche,1525271,384042,25.18,0.25
2214,2021-03-07,MAR,5183,2108,3075,607,167,32,896,13,2,3007,76,336,47,4430,753,ITI,ITI3,11,Marche,Marche,1525271,389225,25.52,0.34
2215,2021-04-02,MAR,7002,3033,3969,389,210,112,424,47,735,2701,2129,213,42,6259,743,ITI,ITI3,11,Marche,Marche,1525271,396227,25.98,0.46
2216,2021-01-12,MAR,1226,413,813,912,255,50,0,2,0,0,0,0,7,1226,0,ITI,ITI3,11,Marche,Marche,1525271,397453,26.06,0.08
2217,2021-02-02,MAR,1193,397,796,804,265,93,0,5,0,5,0,0,21,73,1120,ITI,ITI3,11,Marche,Marche,1525271,398646,26.14,0.08
2218,2021-05-01,MAR,9319,3923,5396,186,138,15,1281,2036,1825,875,2892,14,57,3577,5742,ITI,ITI3,11,Marche,Marche,1525271,407965,26.75,0.61
2219,2021-02-08,MAR,833,258,575,408,133,262,0,6,3,4,0,0,17,371,462,ITI,ITI3,11,Marche,Marche,1525271,408798,26.8,0.05
2220,2021-02-25,MAR,3563,1447,2116,432,137,423,1,8,5,2493,27,3,34,3384,179,ITI,ITI3,11,Marche,Marche,1525271,412361,27.04,0.23
2221,2021-01-05,MAR,1562,586,976,1436,112,0,0,3,2,0,0,0,9,1562,0,ITI,ITI3,11,Marche,Marche,1525271,413923,27.14,0.1
2222,2021-01-27,MAR,2122,780,1342,1754,156,140,0,13,10,8,0,0,41,122,2000,ITI,ITI3,11,Marche,Marche,1525271,416045,27.28,0.14
2223,2021-04-03,MAR,7597,3217,4380,322,152,60,293,76,827,2954,2820,20,73,6925,672,ITI,ITI3,11,Marche,Marche,1525271,423642,27.77,0.5
2224,2020-12-27,MAR,200,97,103,184,12,4,0,0,0,0,0,0,0,200,0,ITI,ITI3,11,Marche,Marche,1525271,423842,27.79,0.01
2225,2021-03-18,MAR,3445,1514,1931,326,188,125,3,7,8,2653,23,98,14,216,3229,ITI,ITI3,11,Marche,Marche,1525271,427287,28.01,0.23
2226,2021-01-10,MAR,1737,699,1038,1462,253,0,0,5,1,0,0,0,16,1737,0,ITI,ITI3,11,Marche,Marche,1525271,429024,28.13,0.11
2227,2021-02-07,MAR,1873,735,1138,1156,482,46,0,41,20,4,0,0,124,344,1529,ITI,ITI3,11,Marche,Marche,1525271,430897,28.25,0.12
2228,2021-04-08,MAR,7538,3290,4248,273,95,97,715,82,2073,1334,2804,26,39,7207,331,ITI,ITI3,11,Marche,Marche,1525271,438435,28.74,0.49
2229,2021-03-23,MAR,5819,2538,3281,260,104,139,328,23,7,4639,27,220,72,2272,3547,ITI,ITI3,11,Marche,Marche,1525271,444254,29.13,0.38
2230,2021-03-24,MAR,7038,2983,4055,484,152,202,592,40,25,4814,321,161,247,3369,3669,ITI,ITI3,11,Marche,Marche,1525271,451292,29.59,0.46
2231,2021-01-20,MAR,400,100,300,148,56,190,0,2,0,1,0,0,3,386,14,ITI,ITI3,11,Marche,Marche,1525271,451692,29.61,0.03
2232,2021-04-07,MAR,7822,3442,4380,189,143,176,973,75,1889,1335,2904,30,108,7486,336,ITI,ITI3,11,Marche,Marche,1525271,459514,30.13,0.51
2233,2021-01-11,MAR,1176,411,765,1021,155,0,0,0,0,0,0,0,0,1176,0,ITI,ITI3,11,Marche,Marche,1525271,460690,30.2,0.08
2234,2021-01-28,MAR,1975,661,1314,1583,238,101,0,9,1,0,0,0,43,167,1808,ITI,ITI3,11,Marche,Marche,1525271,462665,30.33,0.13
2235,2021-01-30,MAR,1908,669,1239,1566,293,0,0,12,0,0,0,0,37,29,1879,ITI,ITI3,11,Marche,Marche,1525271,464573,30.46,0.13
2236,2020-12-31,MAR,385,180,205,371,14,0,0,0,0,0,0,0,0,385,0,ITI,ITI3,11,Marche,Marche,1525271,464958,30.48,0.03
2237,2021-02-14,MAR,738,301,437,578,109,0,0,10,0,0,0,0,41,738,0,ITI,ITI3,11,Marche,Marche,1525271,465696,30.53,0.05
2238,2021-01-08,MAR,1576,588,988,1227,324,0,0,5,0,0,0,0,20,1576,0,ITI,ITI3,11,Marche,Marche,1525271,467272,30.64,0.1
2239,2021-01-26,MAR,2017,746,1271,1736,153,86,0,15,4,1,0,0,22,92,1925,ITI,ITI3,11,Marche,Marche,1525271,469289,30.77,0.13
2240,2021-04-15,MAR,10390,4679,5711,503,138,128,932,192,3639,780,3842,55,181,9825,565,ITI,ITI3,11,Marche,Marche,1525271,479679,31.45,0.68
2241,2021-02-13,MAR,1064,455,609,457,311,90,0,25,10,16,0,0,155,1012,52,ITI,ITI3,11,Marche,Marche,1525271,480743,31.52,0.07
2242,2021-04-22,MAR,10805,4942,5863,236,84,30,58,2750,3928,688,2953,37,41,9224,1581,ITI,ITI3,11,Marche,Marche,1525271,491548,32.23,0.71
2243,2021-03-04,MAR,6627,2978,3649,1064,375,115,769,53,18,2806,222,1041,164,5233,1394,ITI,ITI3,11,Marche,Marche,1525271,498175,32.66,0.43
2244,2021-03-08,MAR,6368,2809,3559,768,228,220,1015,8,2,3102,147,830,48,5366,1002,ITI,ITI3,11,Marche,Marche,1525271,504543,33.08,0.42
2245,2021-01-29,MAR,1992,730,1262,1480,404,74,0,6,0,3,0,0,25,168,1824,ITI,ITI3,11,Marche,Marche,1525271,506535,33.21,0.13
2246,2021-01-16,MAR,2006,723,1283,1059,415,285,0,53,42,21,0,0,131,2006,0,ITI,ITI3,11,Marche,Marche,1525271,508541,33.34,0.13
2247,2021-03-12,MAR,4718,2020,2698,821,445,17,929,20,11,1907,3,487,78,3472,1246,ITI,ITI3,11,Marche,Marche,1525271,513259,33.65,0.31
2248,2021-03-26,MAR,6346,2614,3732,336,222,190,501,58,31,4092,396,204,316,3535,2811,ITI,ITI3,11,Marche,Marche,1525271,519605,34.07,0.42
2249,2021-02-01,MAR,1365,480,885,1057,200,81,0,5,0,0,0,0,22,98,1267,ITI,ITI3,11,Marche,Marche,1525271,520970,34.16,0.09
2250,2021-04-13,MAR,9866,4277,5589,205,105,60,1076,163,3749,955,3471,32,50,9625,241,ITI,ITI3,11,Marche,Marche,1525271,530836,34.8,0.65
2251,2021-05-03,MAR,10199,4605,5594,247,77,33,812,1004,3632,963,3258,75,98,4789,5410,ITI,ITI3,11,Marche,Marche,1525271,541035,35.47,0.67
2252,2021-03-21,MAR,4512,1878,2634,87,42,57,205,19,7,4047,9,13,26,1632,2880,ITI,ITI3,11,Marche,Marche,1525271,545547,35.77,0.3
2253,2021-01-21,MAR,899,255,644,461,85,336,0,1,0,3,0,0,13,585,314,ITI,ITI3,11,Marche,Marche,1525271,546446,35.83,0.06
2254,2021-04-18,MAR,8843,4141,4702,261,67,2,455,1077,2952,377,3618,11,23,7922,921,ITI,ITI3,11,Marche,Marche,1525271,555289,36.41,0.58
2255,2021-05-04,MAR,10795,4775,6020,205,116,63,658,1100,3918,1038,3626,28,43,4937,5858,ITI,ITI3,11,Marche,Marche,1525271,566084,37.11,0.71
2256,2021-04-24,MAR,12033,5311,6722,132,134,46,78,2368,3734,1675,3744,33,89,7564,4469,ITI,ITI3,11,Marche,Marche,1525271,578117,37.9,0.79
2257,2021-02-17,MAR,1791,664,1127,968,472,309,0,6,1,1,22,0,12,1672,119,ITI,ITI3,11,Marche,Marche,1525271,579908,38.02,0.12
2258,2021-03-06,MAR,5735,2650,3085,973,225,172,747,37,7,2400,221,867,86,4467,1268,ITI,ITI3,11,Marche,Marche,1525271,585643,38.4,0.38
2259,2021-03-17,MAR,3435,1497,1938,301,79,117,5,10,10,2822,61,7,23,111,3324,ITI,ITI3,11,Marche,Marche,1525271,589078,38.62,0.23
2260,2021-02-26,MAR,3636,1503,2133,449,178,389,39,8,4,2521,31,4,13,3160,476,ITI,ITI3,11,Marche,Marche,1525271,592714,38.86,0.24
2261,2021-04-09,VDA,235,111,124,0,1,7,0,154,32,30,8,0,3,202,33,ITC,ITC2,2,Valle d'Aosta / Vallée d'Aoste,Valle d'Aosta,125666,235,0.19,0.19
2262,2021-01-29,VDA,316,138,178,259,32,16,0,6,3,0,0,0,0,2,314,ITC,ITC2,2,Valle d'Aosta / Vallée d'Aoste,Valle d'Aosta,125666,551,0.44,0.25
2263,2021-03-20,VDA,208,86,122,5,5,15,2,87,46,14,1,27,6,172,36,ITC,ITC2,2,Valle d'Aosta / Vallée d'Aoste,Valle d'Aosta,125666,759,0.6,0.17
2264,2021-02-24,VDA,183,82,101,30,9,13,7,0,4,66,0,54,0,164,19,ITC,ITC2,2,Valle d'Aosta / Vallée d'Aoste,Valle d'Aosta,125666,942,0.75,0.15
2265,2021-01-09,VDA,443,199,244,225,183,22,0,7,6,0,0,0,0,443,0,ITC,ITC2,2,Valle d'Aosta / Vallée d'Aoste,Valle d'Aosta,125666,1385,1.1,0.35
2266,2021-02-07,VDA,292,120,172,110,63,0,3,1,1,105,7,2,0,190,102,ITC,ITC2,2,Valle d'Aosta / Vallée d'Aoste,Valle d'Aosta,125666,1677,1.33,0.23
2267,2021-03-29,VDA,493,233,260,7,5,18,2,50,172,209,23,1,6,453,40,ITC,ITC2,2,Valle d'Aosta / Vallée d'Aoste,Valle d'Aosta,125666,2170,1.73,0.39
2268,2021-02-16,VDA,325,53,272,10,0,14,236,11,8,32,0,4,10,320,5,ITC,ITC2,2,Valle d'Aosta / Vallée d'Aoste,Valle d'Aosta,125666,2495,1.99,0.26
2269,2021-01-21,VDA,33,12,21,0,0,33,0,0,0,0,0,0,0,33,0,ITC,ITC2,2,Valle d'Aosta / Vallée d'Aoste,Valle d'Aosta,125666,2528,2.01,0.03
2270,2021-02-21,VDA,18,3,15,0,0,18,0,0,0,0,0,0,0,0,18,ITC,ITC2,2,Valle d'Aosta / Vallée d'Aoste,Valle d'Aosta,125666,2546,2.03,0.01
2271,2021-03-25,VDA,389,154,235,13,0,1,1,8,57,287,14,0,8,379,10,ITC,ITC2,2,Valle d'Aosta / Vallée d'Aoste,Valle d'Aosta,125666,2935,2.34,0.31
2272,2021-03-15,VDA,362,123,239,21,4,10,65,8,16,217,14,7,0,159,203,ITC,ITC2,2,Valle d'Aosta / Vallée d'Aoste,Valle d'Aosta,125666,3297,2.62,0.29
2273,2021-01-30,VDA,437,202,235,232,181,12,0,7,4,0,0,0,1,14,423,ITC,ITC2,2,Valle d'Aosta / Vallée d'Aoste,Valle d'Aosta,125666,3734,2.97,0.35
2274,2021-01-14,VDA,237,69,168,151,62,0,0,16,6,2,0,0,0,237,0,ITC,ITC2,2,Valle d'Aosta / Vallée d'Aoste,Valle d'Aosta,125666,3971,3.16,0.19
2275,2021-04-19,VDA,751,325,426,12,5,2,1,105,132,311,175,1,7,542,209,ITC,ITC2,2,Valle d'Aosta / Vallée d'Aoste,Valle d'Aosta,125666,4722,3.76,0.6
2276,2021-02-22,VDA,316,94,222,62,10,39,67,0,15,111,0,6,6,213,103,ITC,ITC2,2,Valle d'Aosta / Vallée d'Aoste,Valle d'Aosta,125666,5038,4.01,0.25
2277,2021-03-04,VDA,291,139,152,56,19,2,2,3,10,160,2,14,23,42,249,ITC,ITC2,2,Valle d'Aosta / Vallée d'Aoste,Valle d'Aosta,125666,5329,4.24,0.23
2278,2021-01-13,VDA,337,110,227,166,138,28,0,3,2,0,0,0,0,337,0,ITC,ITC2,2,Valle d'Aosta / Vallée d'Aoste,Valle d'Aosta,125666,5666,4.51,0.27
2279,2021-04-10,VDA,404,190,214,2,3,1,0,109,223,22,32,0,12,399,5,ITC,ITC2,2,Valle d'Aosta / Vallée d'Aoste,Valle d'Aosta,125666,6070,4.83,0.32
2280,2021-02-05,VDA,294,102,192,159,52,0,0,14,16,53,0,0,0,101,193,ITC,ITC2,2,Valle d'Aosta / Vallée d'Aoste,Valle d'Aosta,125666,6364,5.06,0.23
2281,2021-04-29,VDA,1291,634,657,9,3,39,0,242,506,243,223,6,20,757,534,ITC,ITC2,2,Valle d'Aosta / Vallée d'Aoste,Valle d'Aosta,125666,7655,6.09,1.03
2282,2021-04-16,VDA,599,261,338,63,10,2,0,235,81,26,172,0,10,597,2,ITC,ITC2,2,Valle d'Aosta / Vallée d'Aoste,Valle d'Aosta,125666,8254,6.57,0.48
2283,2021-03-13,VDA,145,86,59,3,11,0,3,82,0,0,0,24,22,145,0,ITC,ITC2,2,Valle d'Aosta / Vallée d'Aoste,Valle d'Aosta,125666,8399,6.68,0.12
2284,2021-05-02,VDA,765,345,420,3,4,0,1,353,277,35,82,1,9,605,160,ITC,ITC2,2,Valle d'Aosta / Vallée d'Aoste,Valle d'Aosta,125666,9164,7.29,0.61
2285,2021-04-14,VDA,935,425,510,16,3,0,1,83,257,405,150,3,17,712,223,ITC,ITC2,2,Valle d'Aosta / Vallée d'Aoste,Valle d'Aosta,125666,10099,8.04,0.74
2286,2021-04-15,VDA,809,377,432,30,1,0,1,232,135,241,155,2,12,670,139,ITC,ITC2,2,Valle d'Aosta / Vallée d'Aoste,Valle d'Aosta,125666,10908,8.68,0.64
2287,2021-03-27,VDA,333,164,169,24,12,14,1,111,72,66,4,21,8,302,31,ITC,ITC2,2,Valle d'Aosta / Vallée d'Aoste,Valle d'Aosta,125666,11241,8.95,0.26
2288,2021-03-07,VDA,64,30,34,16,3,0,1,1,4,26,0,2,11,11,53,ITC,ITC2,2,Valle d'Aosta / Vallée d'Aoste,Valle d'Aosta,125666,11305,9.0,0.05
2289,2021-01-18,VDA,213,74,139,29,7,27,0,104,0,46,0,0,0,213,0,ITC,ITC2,2,Valle d'Aosta / Vallée d'Aoste,Valle d'Aosta,125666,11518,9.17,0.17
2290,2021-02-27,VDA,230,84,146,69,8,2,0,10,4,128,0,4,5,124,106,ITC,ITC2,2,Valle d'Aosta / Vallée d'Aoste,Valle d'Aosta,125666,11748,9.35,0.18
2291,2021-01-02,VDA,6,5,1,0,0,6,0,0,0,0,0,0,0,6,0,ITC,ITC2,2,Valle d'Aosta / Vallée d'Aoste,Valle d'Aosta,125666,11754,9.35,0.0
2292,2021-03-18,VDA,136,43,93,4,0,26,0,0,2,102,1,1,0,99,37,ITC,ITC2,2,Valle d'Aosta / Vallée d'Aoste,Valle d'Aosta,125666,11890,9.46,0.11
2293,2021-01-22,VDA,56,21,35,36,0,20,0,0,0,0,0,0,0,20,36,ITC,ITC2,2,Valle d'Aosta / Vallée d'Aoste,Valle d'Aosta,125666,11946,9.51,0.04
2294,2021-02-06,VDA,289,104,185,170,36,0,0,1,2,74,5,1,0,92,197,ITC,ITC2,2,Valle d'Aosta / Vallée d'Aoste,Valle d'Aosta,125666,12235,9.74,0.23
2295,2021-03-10,VDA,437,182,255,9,0,17,0,1,19,362,20,7,2,225,212,ITC,ITC2,2,Valle d'Aosta / Vallée d'Aoste,Valle d'Aosta,125666,12672,10.08,0.35
2296,2021-03-02,VDA,339,166,173,17,9,39,5,34,1,145,0,65,24,336,3,ITC,ITC2,2,Valle d'Aosta / Vallée d'Aoste,Valle d'Aosta,125666,13011,10.35,0.27
2297,2021-01-20,VDA,23,8,15,0,0,6,0,0,0,17,0,0,0,23,0,ITC,ITC2,2,Valle d'Aosta / Vallée d'Aoste,Valle d'Aosta,125666,13034,10.37,0.02
2298,2021-03-11,VDA,195,74,121,4,0,8,2,1,10,167,1,1,1,65,130,ITC,ITC2,2,Valle d'Aosta / Vallée d'Aoste,Valle d'Aosta,125666,13229,10.53,0.16
2299,2021-02-20,VDA,251,210,41,6,17,11,9,3,2,8,0,183,12,241,10,ITC,ITC2,2,Valle d'Aosta / Vallée d'Aoste,Valle d'Aosta,125666,13480,10.73,0.2
2300,2021-04-08,VDA,584,282,302,6,0,4,2,50,146,281,82,0,13,440,144,ITC,ITC2,2,Valle d'Aosta / Vallée d'Aoste,Valle d'Aosta,125666,14064,11.19,0.46
2301,2021-01-11,VDA,325,112,213,238,50,30,0,3,3,0,0,0,1,325,0,ITC,ITC2,2,Valle d'Aosta / Vallée d'Aoste,Valle d'Aosta,125666,14389,11.45,0.26
2302,2021-04-17,VDA,638,407,231,8,8,0,2,158,199,46,207,0,10,636,2,ITC,ITC2,2,Valle d'Aosta / Vallée d'Aoste,Valle d'Aosta,125666,15027,11.96,0.51
2303,2021-04-11,VDA,479,208,271,3,4,0,3,265,142,6,47,0,9,479,0,ITC,ITC2,2,Valle d'Aosta / Vallée d'Aoste,Valle d'Aosta,125666,15506,12.34,0.38
2304,2021-02-23,VDA,216,123,93,0,1,0,16,0,0,0,0,46,153,216,0,ITC,ITC2,2,Valle d'Aosta / Vallée d'Aoste,Valle d'Aosta,125666,15722,12.51,0.17
2305,2021-03-17,VDA,433,185,248,36,4,16,7,14,23,254,9,42,28,273,160,ITC,ITC2,2,Valle d'Aosta / Vallée d'Aoste,Valle d'Aosta,125666,16155,12.86,0.34
2306,2021-02-09,VDA,251,84,167,78,16,14,53,8,3,75,2,1,1,68,183,ITC,ITC2,2,Valle d'Aosta / Vallée d'Aoste,Valle d'Aosta,125666,16406,13.06,0.2
2307,2021-02-17,VDA,327,144,183,25,1,30,0,0,16,237,0,17,1,227,100,ITC,ITC2,2,Valle d'Aosta / Vallée d'Aoste,Valle d'Aosta,125666,16733,13.32,0.26
2308,2021-03-06,VDA,22,4,18,13,0,5,0,0,0,4,0,0,0,22,0,ITC,ITC2,2,Valle d'Aosta / Vallée d'Aoste,Valle d'Aosta,125666,16755,13.33,0.02
2309,2021-02-26,VDA,206,57,149,67,8,6,1,6,6,102,1,4,5,122,84,ITC,ITC2,2,Valle d'Aosta / Vallée d'Aoste,Valle d'Aosta,125666,16961,13.5,0.16
2310,2021-04-30,VDA,831,355,476,65,9,5,2,227,233,28,212,14,36,485,346,ITC,ITC2,2,Valle d'Aosta / Vallée d'Aoste,Valle d'Aosta,125666,17792,14.16,0.66
2311,2021-04-21,VDA,868,410,458,24,16,1,5,66,152,285,259,10,50,619,249,ITC,ITC2,2,Valle d'Aosta / Vallée d'Aoste,Valle d'Aosta,125666,18660,14.85,0.69
2312,2021-01-05,VDA,150,54,96,127,11,11,0,0,1,0,0,0,0,150,0,ITC,ITC2,2,Valle d'Aosta / Vallée d'Aoste,Valle d'Aosta,125666,18810,14.97,0.12
2313,2021-01-08,VDA,299,130,169,240,35,16,0,5,3,0,0,0,0,299,0,ITC,ITC2,2,Valle d'Aosta / Vallée d'Aoste,Valle d'Aosta,125666,19109,15.21,0.24
2314,2021-04-25,VDA,848,408,440,3,7,0,1,299,334,55,127,1,21,709,139,ITC,ITC2,2,Valle d'Aosta / Vallée d'Aoste,Valle d'Aosta,125666,19957,15.88,0.67
2315,2020-12-31,VDA,18,4,14,16,2,0,0,0,0,0,0,0,0,18,0,ITC,ITC2,2,Valle d'Aosta / Vallée d'Aoste,Valle d'Aosta,125666,19975,15.9,0.01
2316,2021-03-14,VDA,392,200,192,8,21,0,52,205,1,0,0,34,71,392,0,ITC,ITC2,2,Valle d'Aosta / Vallée d'Aoste,Valle d'Aosta,125666,20367,16.21,0.31
2317,2021-03-01,VDA,181,66,115,19,8,29,0,0,3,116,2,2,2,147,34,ITC,ITC2,2,Valle d'Aosta / Vallée d'Aoste,Valle d'Aosta,125666,20548,16.35,0.14
2318,2021-04-22,VDA,1065,447,618,9,3,3,3,182,249,465,128,2,21,684,381,ITC,ITC2,2,Valle d'Aosta / Vallée d'Aoste,Valle d'Aosta,125666,21613,17.2,0.85
2319,2021-04-27,VDA,977,423,554,41,13,4,1,129,278,231,227,3,50,685,292,ITC,ITC2,2,Valle d'Aosta / Vallée d'Aoste,Valle d'Aosta,125666,22590,17.98,0.78
2320,2021-01-10,VDA,220,71,149,172,25,19,0,4,0,0,0,0,0,220,0,ITC,ITC2,2,Valle d'Aosta / Vallée d'Aoste,Valle d'Aosta,125666,22810,18.15,0.18
2321,2021-03-03,VDA,255,118,137,9,11,1,4,4,9,208,6,1,2,186,69,ITC,ITC2,2,Valle d'Aosta / Vallée d'Aoste,Valle d'Aosta,125666,23065,18.35,0.2
2322,2021-01-06,VDA,65,33,32,29,8,18,0,7,3,0,0,0,0,65,0,ITC,ITC2,2,Valle d'Aosta / Vallée d'Aoste,Valle d'Aosta,125666,23130,18.41,0.05
2323,2021-04-23,VDA,921,443,478,40,7,29,0,165,277,252,139,0,12,538,383,ITC,ITC2,2,Valle d'Aosta / Vallée d'Aoste,Valle d'Aosta,125666,24051,19.14,0.73
2324,2021-04-02,VDA,872,344,528,63,9,12,178,89,167,195,74,11,74,648,224,ITC,ITC2,2,Valle d'Aosta / Vallée d'Aoste,Valle d'Aosta,125666,24923,19.83,0.69
2325,2021-03-12,VDA,531,175,356,15,8,8,255,44,21,148,8,2,22,305,226,ITC,ITC2,2,Valle d'Aosta / Vallée d'Aoste,Valle d'Aosta,125666,25454,20.26,0.42
2326,2021-01-12,VDA,302,72,230,242,34,11,0,14,1,0,0,0,0,302,0,ITC,ITC2,2,Valle d'Aosta / Vallée d'Aoste,Valle d'Aosta,125666,25756,20.5,0.24
2327,2021-03-16,VDA,180,37,143,4,0,13,0,15,14,121,0,0,13,118,62,ITC,ITC2,2,Valle d'Aosta / Vallée d'Aoste,Valle d'Aosta,125666,25936,20.64,0.14
2328,2021-04-04,VDA,571,252,319,1,8,0,96,270,155,22,5,4,10,570,1,ITC,ITC2,2,Valle d'Aosta / Vallée d'Aoste,Valle d'Aosta,125666,26507,21.09,0.45
2329,2021-02-11,VDA,231,107,124,53,21,0,0,2,10,128,1,13,3,222,9,ITC,ITC2,2,Valle d'Aosta / Vallée d'Aoste,Valle d'Aosta,125666,26738,21.28,0.18
2330,2021-04-20,VDA,931,430,501,25,9,8,2,152,174,278,253,1,29,738,193,ITC,ITC2,2,Valle d'Aosta / Vallée d'Aoste,Valle d'Aosta,125666,27669,22.02,0.74
2331,2021-04-28,VDA,1215,631,584,24,7,30,0,81,597,235,212,1,28,712,503,ITC,ITC2,2,Valle d'Aosta / Vallée d'Aoste,Valle d'Aosta,125666,28884,22.98,0.97
2332,2021-03-26,VDA,498,204,294,4,2,0,227,54,79,100,3,3,26,491,7,ITC,ITC2,2,Valle d'Aosta / Vallée d'Aoste,Valle d'Aosta,125666,29382,23.38,0.4
2333,2021-01-15,VDA,218,82,136,116,32,28,0,18,17,6,0,0,1,218,0,ITC,ITC2,2,Valle d'Aosta / Vallée d'Aoste,Valle d'Aosta,125666,29600,23.55,0.17
2334,2021-03-24,VDA,515,230,285,11,5,0,1,16,34,420,18,3,7,258,257,ITC,ITC2,2,Valle d'Aosta / Vallée d'Aoste,Valle d'Aosta,125666,30115,23.96,0.41
2335,2021-05-01,VDA,937,561,376,14,1,0,1,231,287,56,140,184,23,454,483,ITC,ITC2,2,Valle d'Aosta / Vallée d'Aoste,Valle d'Aosta,125666,31052,24.71,0.75
2336,2021-05-04,VDA,700,322,378,16,2,1,101,69,191,147,143,10,20,169,531,ITC,ITC2,2,Valle d'Aosta / Vallée d'Aoste,Valle d'Aosta,125666,31752,25.27,0.56
2337,2020-12-27,VDA,20,9,11,20,0,0,0,0,0,0,0,0,0,20,0,ITC,ITC2,2,Valle d'Aosta / Vallée d'Aoste,Valle d'Aosta,125666,31772,25.28,0.02
2338,2021-04-01,VDA,776,394,382,1,1,0,0,205,306,201,55,0,7,764,12,ITC,ITC2,2,Valle d'Aosta / Vallée d'Aoste,Valle d'Aosta,125666,32548,25.9,0.62
2339,2021-02-08,VDA,223,83,140,28,19,3,25,82,0,64,0,0,2,25,198,ITC,ITC2,2,Valle d'Aosta / Vallée d'Aoste,Valle d'Aosta,125666,32771,26.08,0.18
2340,2021-02-02,VDA,271,70,201,225,34,3,0,8,1,0,0,0,0,2,269,ITC,ITC2,2,Valle d'Aosta / Vallée d'Aoste,Valle d'Aosta,125666,33042,26.29,0.22
2341,2021-03-23,VDA,378,150,228,14,2,7,9,37,18,279,0,9,3,244,134,ITC,ITC2,2,Valle d'Aosta / Vallée d'Aoste,Valle d'Aosta,125666,33420,26.59,0.3
2342,2021-04-07,VDA,907,473,434,16,0,0,1,84,271,390,92,0,53,678,229,ITC,ITC2,2,Valle d'Aosta / Vallée d'Aoste,Valle d'Aosta,125666,34327,27.32,0.72
2343,2021-03-22,VDA,560,205,355,37,5,18,19,54,37,340,29,11,10,333,227,ITC,ITC2,2,Valle d'Aosta / Vallée d'Aoste,Valle d'Aosta,125666,34887,27.76,0.45
2344,2021-02-10,VDA,248,77,171,51,14,26,18,4,3,128,0,1,3,141,107,ITC,ITC2,2,Valle d'Aosta / Vallée d'Aoste,Valle d'Aosta,125666,35135,27.96,0.2
2345,2021-01-17,VDA,131,56,75,49,2,20,0,1,0,59,0,0,0,131,0,ITC,ITC2,2,Valle d'Aosta / Vallée d'Aoste,Valle d'Aosta,125666,35266,28.06,0.1
2346,2021-04-26,VDA,715,327,388,13,2,0,2,80,246,213,126,7,26,545,170,ITC,ITC2,2,Valle d'Aosta / Vallée d'Aoste,Valle d'Aosta,125666,35981,28.63,0.57
2347,2021-02-15,VDA,264,136,128,24,2,25,2,0,6,173,2,29,1,229,35,ITC,ITC2,2,Valle d'Aosta / Vallée d'Aoste,Valle d'Aosta,125666,36245,28.84,0.21
2348,2021-03-28,VDA,522,212,310,52,10,0,47,168,99,53,18,55,20,521,1,ITC,ITC2,2,Valle d'Aosta / Vallée d'Aoste,Valle d'Aosta,125666,36767,29.26,0.42
2349,2021-03-19,VDA,322,85,237,9,1,21,211,42,1,9,0,1,27,286,36,ITC,ITC2,2,Valle d'Aosta / Vallée d'Aoste,Valle d'Aosta,125666,37089,29.51,0.26
2350,2021-01-28,VDA,290,123,167,202,35,6,0,12,7,2,0,0,26,56,234,ITC,ITC2,2,Valle d'Aosta / Vallée d'Aoste,Valle d'Aosta,125666,37379,29.74,0.23
2351,2021-04-13,VDA,373,171,202,2,1,8,0,69,108,120,56,0,9,329,44,ITC,ITC2,2,Valle d'Aosta / Vallée d'Aoste,Valle d'Aosta,125666,37752,30.04,0.3
2352,2021-01-27,VDA,151,71,80,55,8,18,0,10,3,53,0,0,4,79,72,ITC,ITC2,2,Valle d'Aosta / Vallée d'Aoste,Valle d'Aosta,125666,37903,30.16,0.12
2353,2021-03-09,VDA,206,96,110,3,0,23,26,56,5,36,0,39,18,174,32,ITC,ITC2,2,Valle d'Aosta / Vallée d'Aoste,Valle d'Aosta,125666,38109,30.33,0.16
2354,2021-02-13,VDA,216,196,20,0,0,0,0,0,0,0,0,216,0,215,1,ITC,ITC2,2,Valle d'Aosta / Vallée d'Aoste,Valle d'Aosta,125666,38325,30.5,0.17
2355,2021-01-19,VDA,256,77,179,160,10,15,0,10,3,57,0,0,1,256,0,ITC,ITC2,2,Valle d'Aosta / Vallée d'Aoste,Valle d'Aosta,125666,38581,30.7,0.2
2356,2021-02-14,VDA,48,16,32,6,0,42,0,0,0,0,0,0,0,1,47,ITC,ITC2,2,Valle d'Aosta / Vallée d'Aoste,Valle d'Aosta,125666,38629,30.74,0.04
2357,2021-01-26,VDA,139,48,91,115,11,12,0,0,1,0,0,0,0,0,139,ITC,ITC2,2,Valle d'Aosta / Vallée d'Aoste,Valle d'Aosta,125666,38768,30.85,0.11
2358,2021-02-12,VDA,263,96,167,51,13,28,5,2,10,133,18,0,3,217,46,ITC,ITC2,2,Valle d'Aosta / Vallée d'Aoste,Valle d'Aosta,125666,39031,31.06,0.21
2359,2021-02-03,VDA,351,114,237,157,136,52,0,4,1,1,0,0,0,14,337,ITC,ITC2,2,Valle d'Aosta / Vallée d'Aoste,Valle d'Aosta,125666,39382,31.34,0.28
2360,2021-01-25,VDA,147,65,82,125,13,6,0,3,0,0,0,0,0,0,147,ITC,ITC2,2,Valle d'Aosta / Vallée d'Aoste,Valle d'Aosta,125666,39529,31.46,0.12
2361,2021-04-12,VDA,483,185,298,8,9,22,2,89,60,229,61,0,3,321,162,ITC,ITC2,2,Valle d'Aosta / Vallée d'Aoste,Valle d'Aosta,125666,40012,31.84,0.38
2362,2021-02-01,VDA,403,127,276,268,56,70,0,2,2,3,0,0,2,87,316,ITC,ITC2,2,Valle d'Aosta / Vallée d'Aoste,Valle d'Aosta,125666,40415,32.16,0.32
2363,2021-05-03,VDA,839,400,439,16,5,1,24,201,331,50,191,3,17,488,351,ITC,ITC2,2,Valle d'Aosta / Vallée d'Aoste,Valle d'Aosta,125666,41254,32.83,0.67
2364,2021-03-31,VDA,555,302,253,7,1,0,0,22,309,203,6,0,7,529,26,ITC,ITC2,2,Valle d'Aosta / Vallée d'Aoste,Valle d'Aosta,125666,41809,33.27,0.44
2365,2021-01-07,VDA,275,111,164,224,38,5,0,3,2,0,0,0,3,275,0,ITC,ITC2,2,Valle d'Aosta / Vallée d'Aoste,Valle d'Aosta,125666,42084,33.49,0.22
2366,2021-03-08,VDA,482,231,251,29,1,13,1,6,25,365,7,28,7,237,245,ITC,ITC2,2,Valle d'Aosta / Vallée d'Aoste,Valle d'Aosta,125666,42566,33.87,0.38
2367,2021-03-30,VDA,402,223,179,11,2,5,5,32,180,124,28,9,6,382,20,ITC,ITC2,2,Valle d'Aosta / Vallée d'Aoste,Valle d'Aosta,125666,42968,34.19,0.32
2368,2021-04-18,VDA,520,253,267,11,6,4,4,203,82,13,183,0,14,516,4,ITC,ITC2,2,Valle d'Aosta / Vallée d'Aoste,Valle d'Aosta,125666,43488,34.61,0.41
2369,2021-03-05,VDA,275,124,151,51,10,13,5,4,10,138,18,0,26,53,222,ITC,ITC2,2,Valle d'Aosta / Vallée d'Aoste,Valle d'Aosta,125666,43763,34.82,0.22
2370,2021-01-16,VDA,236,80,156,127,32,22,0,2,2,51,0,0,0,236,0,ITC,ITC2,2,Valle d'Aosta / Vallée d'Aoste,Valle d'Aosta,125666,43999,35.01,0.19
2371,2021-04-06,VDA,741,381,360,24,4,1,0,55,192,239,160,14,52,629,112,ITC,ITC2,2,Valle d'Aosta / Vallée d'Aoste,Valle d'Aosta,125666,44740,35.6,0.59
2372,2021-04-24,VDA,722,400,322,14,7,7,1,131,174,96,238,4,50,555,167,ITC,ITC2,2,Valle d'Aosta / Vallée d'Aoste,Valle d'Aosta,125666,45462,36.18,0.57
2373,2021-02-04,VDA,294,86,208,168,76,34,0,12,3,1,0,0,0,8,286,ITC,ITC2,2,Valle d'Aosta / Vallée d'Aoste,Valle d'Aosta,125666,45756,36.41,0.23
2374,2021-02-28,VDA,260,86,174,78,36,24,4,7,10,94,0,3,4,77,183,ITC,ITC2,2,Valle d'Aosta / Vallée d'Aoste,Valle d'Aosta,125666,46016,36.62,0.21
2375,2021-03-21,VDA,355,165,190,2,5,0,30,208,57,1,0,27,25,355,0,ITC,ITC2,2,Valle d'Aosta / Vallée d'Aoste,Valle d'Aosta,125666,46371,36.9,0.28
2376,2021-01-31,VDA,290,90,200,231,33,18,0,5,0,0,0,0,3,58,232,ITC,ITC2,2,Valle d'Aosta / Vallée d'Aoste,Valle d'Aosta,125666,46661,37.13,0.23
2377,2021-04-05,VDA,461,222,239,18,4,0,35,186,118,8,84,0,8,457,4,ITC,ITC2,2,Valle d'Aosta / Vallée d'Aoste,Valle d'Aosta,125666,47122,37.5,0.37
2378,2021-02-18,VDA,349,153,196,61,9,45,8,6,17,184,0,16,3,261,88,ITC,ITC2,2,Valle d'Aosta / Vallée d'Aoste,Valle d'Aosta,125666,47471,37.78,0.28
2379,2021-02-19,VDA,292,102,190,17,1,35,65,3,16,154,0,0,1,268,24,ITC,ITC2,2,Valle d'Aosta / Vallée d'Aoste,Valle d'Aosta,125666,47763,38.01,0.23
2380,2021-01-04,VDA,142,59,83,126,14,0,0,2,0,0,0,0,0,142,0,ITC,ITC2,2,Valle d'Aosta / Vallée d'Aoste,Valle d'Aosta,125666,47905,38.12,0.11
2381,2021-02-25,VDA,201,101,100,6,4,12,2,84,1,0,0,27,65,194,7,ITC,ITC2,2,Valle d'Aosta / Vallée d'Aoste,Valle d'Aosta,125666,48106,38.28,0.16
2382,2021-04-03,VDA,676,341,335,13,11,4,1,117,333,58,72,5,62,661,15,ITC,ITC2,2,Valle d'Aosta / Vallée d'Aoste,Valle d'Aosta,125666,48782,38.82,0.54
2383,2021-04-14,CAL,8003,3870,4133,172,185,141,175,208,1539,1570,3826,74,113,6536,1467,ITF,ITF6,18,Calabria,Calabria,1947131,8003,0.41,0.41
2384,2021-01-30,CAL,2175,1148,1027,1976,189,0,0,3,0,1,0,0,6,358,1817,ITF,ITF6,18,Calabria,Calabria,1947131,10178,0.52,0.11
2385,2021-01-12,CAL,2059,1018,1041,1707,237,29,0,21,1,19,0,0,45,2059,0,ITF,ITF6,18,Calabria,Calabria,1947131,12237,0.63,0.11
2386,2021-04-02,CAL,8080,3689,4391,362,135,605,1154,115,177,2800,2247,198,287,4217,3863,ITF,ITF6,18,Calabria,Calabria,1947131,20317,1.04,0.41
2387,2021-04-04,CAL,1740,877,863,34,23,23,67,249,266,507,516,2,53,1237,503,ITF,ITF6,18,Calabria,Calabria,1947131,22057,1.13,0.09
2388,2021-02-25,CAL,2821,1519,1302,736,228,235,4,41,15,971,36,425,130,2242,579,ITF,ITF6,18,Calabria,Calabria,1947131,24878,1.28,0.14
2389,2021-02-11,CAL,2342,1044,1298,1465,372,241,0,25,18,156,0,0,65,1081,1261,ITF,ITF6,18,Calabria,Calabria,1947131,27220,1.4,0.12
2390,2021-03-07,CAL,3132,1561,1571,106,33,348,2,10,31,1741,474,363,24,3042,90,ITF,ITF6,18,Calabria,Calabria,1947131,30352,1.56,0.16
2391,2021-03-16,CAL,3778,1851,1927,460,203,22,30,49,79,2138,594,68,135,2180,1598,ITF,ITF6,18,Calabria,Calabria,1947131,34130,1.75,0.19
2392,2020-12-27,CAL,279,154,125,278,1,0,0,0,0,0,0,0,0,279,0,ITF,ITF6,18,Calabria,Calabria,1947131,34409,1.77,0.01
2393,2021-03-18,CAL,4248,1979,2269,360,210,232,45,65,115,2312,753,60,96,2278,1970,ITF,ITF6,18,Calabria,Calabria,1947131,38657,1.99,0.22
2394,2021-03-19,CAL,4188,1949,2239,486,121,295,102,64,114,2010,883,12,101,1900,2288,ITF,ITF6,18,Calabria,Calabria,1947131,42845,2.2,0.22
2395,2021-03-08,CAL,5323,2822,2501,708,245,453,3,49,65,1553,1138,849,260,4265,1058,ITF,ITF6,18,Calabria,Calabria,1947131,48168,2.47,0.27
2396,2021-01-29,CAL,2055,989,1066,1756,234,49,0,3,3,1,0,0,9,234,1821,ITF,ITF6,18,Calabria,Calabria,1947131,50223,2.58,0.11
2397,2021-01-27,CAL,1458,735,723,1227,201,23,0,4,0,0,0,0,3,396,1062,ITF,ITF6,18,Calabria,Calabria,1947131,51681,2.65,0.07
2398,2021-03-31,CAL,8830,4008,4822,378,283,653,2053,145,193,2693,1992,118,322,4890,3940,ITF,ITF6,18,Calabria,Calabria,1947131,60511,3.11,0.45
2399,2021-02-08,CAL,1847,733,1114,1214,406,121,0,14,1,0,0,0,91,661,1186,ITF,ITF6,18,Calabria,Calabria,1947131,62358,3.2,0.09
2400,2021-03-20,CAL,6483,2983,3500,432,100,408,466,72,124,3574,1022,75,210,4094,2389,ITF,ITF6,18,Calabria,Calabria,1947131,68841,3.54,0.33
2401,2021-02-24,CAL,1843,940,903,658,108,115,4,15,10,754,84,47,48,1368,475,ITF,ITF6,18,Calabria,Calabria,1947131,70684,3.63,0.09
2402,2021-01-22,CAL,658,274,384,298,146,112,0,37,29,4,0,0,32,656,2,ITF,ITF6,18,Calabria,Calabria,1947131,71342,3.66,0.03
2403,2021-04-21,CAL,11483,5782,5701,260,200,196,238,1608,2286,1124,5162,187,222,8571,2912,ITF,ITF6,18,Calabria,Calabria,1947131,82825,4.25,0.59
2404,2021-01-09,CAL,1916,1036,880,1529,315,0,0,26,2,1,0,0,43,1916,0,ITF,ITF6,18,Calabria,Calabria,1947131,84741,4.35,0.1
2405,2021-01-21,CAL,958,444,514,735,82,115,0,4,2,0,0,0,20,929,29,ITF,ITF6,18,Calabria,Calabria,1947131,85699,4.4,0.05
2406,2021-03-14,CAL,2543,1018,1525,322,103,312,722,15,30,811,128,30,70,2143,400,ITF,ITF6,18,Calabria,Calabria,1947131,88242,4.53,0.13
2407,2021-04-11,CAL,4085,1861,2224,136,49,51,167,59,209,1725,1621,12,56,2144,1941,ITF,ITF6,18,Calabria,Calabria,1947131,92327,4.74,0.21
2408,2021-04-24,CAL,18942,9454,9488,288,229,146,113,6014,3565,1944,6097,230,316,15545,3397,ITF,ITF6,18,Calabria,Calabria,1947131,111269,5.71,0.97
2409,2021-03-05,CAL,6175,3567,2608,698,257,712,5,46,61,2014,880,1405,97,5597,578,ITF,ITF6,18,Calabria,Calabria,1947131,117444,6.03,0.32
2410,2021-04-18,CAL,5776,2762,3014,150,89,102,79,130,1436,1202,2529,12,47,4897,879,ITF,ITF6,18,Calabria,Calabria,1947131,123220,6.33,0.3
2411,2021-02-28,CAL,2169,983,1186,114,39,190,0,10,24,1707,28,6,51,2017,152,ITF,ITF6,18,Calabria,Calabria,1947131,125389,6.44,0.11
2412,2021-02-09,CAL,2148,904,1244,1423,394,231,0,20,5,0,0,0,75,948,1200,ITF,ITF6,18,Calabria,Calabria,1947131,127537,6.55,0.11
2413,2021-02-06,CAL,2910,1338,1572,2095,368,248,0,45,9,10,0,0,135,442,2468,ITF,ITF6,18,Calabria,Calabria,1947131,130447,6.7,0.15
2414,2021-04-25,CAL,15822,8029,7793,150,314,121,122,5767,2982,746,4585,273,762,14701,1121,ITF,ITF6,18,Calabria,Calabria,1947131,146269,7.51,0.81
2415,2021-02-05,CAL,3798,1709,2089,2329,745,554,0,41,8,3,0,0,118,490,3308,ITF,ITF6,18,Calabria,Calabria,1947131,150067,7.71,0.2
2416,2021-03-03,CAL,4871,2655,2216,631,351,917,4,38,43,1408,462,935,82,3808,1063,ITF,ITF6,18,Calabria,Calabria,1947131,154938,7.96,0.25
2417,2021-04-26,CAL,10315,5183,5132,224,144,409,112,1388,1669,977,4864,401,127,7913,2402,ITF,ITF6,18,Calabria,Calabria,1947131,165253,8.49,0.53
2418,2021-04-06,CAL,7224,3237,3987,377,163,453,804,103,244,2468,2372,51,189,4147,3077,ITF,ITF6,18,Calabria,Calabria,1947131,172477,8.86,0.37
2419,2021-02-04,CAL,3391,1623,1768,2560,505,222,0,23,6,7,0,0,68,644,2747,ITF,ITF6,18,Calabria,Calabria,1947131,175868,9.03,0.17
2420,2021-04-17,CAL,10644,4995,5649,211,138,218,118,302,2656,2181,4526,98,196,8927,1717,ITF,ITF6,18,Calabria,Calabria,1947131,186512,9.58,0.55
2421,2021-01-17,CAL,867,418,449,527,121,48,0,17,4,33,0,0,117,801,66,ITF,ITF6,18,Calabria,Calabria,1947131,187379,9.62,0.04
2422,2021-04-16,CAL,10131,4955,5176,332,213,288,233,254,2333,1094,5020,133,231,8532,1599,ITF,ITF6,18,Calabria,Calabria,1947131,197510,10.14,0.52
2423,2021-02-27,CAL,3681,1913,1768,422,193,396,2,24,41,2075,96,348,84,3302,379,ITF,ITF6,18,Calabria,Calabria,1947131,201191,10.33,0.19
2424,2021-03-04,CAL,5390,3112,2278,646,252,744,2,63,46,1636,631,1237,133,4594,796,ITF,ITF6,18,Calabria,Calabria,1947131,206581,10.61,0.28
2425,2021-01-31,CAL,1108,554,554,765,282,58,0,1,0,0,0,0,2,155,953,ITF,ITF6,18,Calabria,Calabria,1947131,207689,10.67,0.06
2426,2021-03-28,CAL,2535,1172,1363,127,109,31,412,74,67,785,739,15,176,1405,1130,ITF,ITF6,18,Calabria,Calabria,1947131,210224,10.8,0.13
2427,2021-04-28,CAL,12488,6034,6454,174,152,237,167,2323,2219,630,6259,91,236,9686,2802,ITF,ITF6,18,Calabria,Calabria,1947131,222712,11.44,0.64
2428,2021-02-13,CAL,1331,583,748,731,144,111,0,31,9,167,0,0,138,968,363,ITF,ITF6,18,Calabria,Calabria,1947131,224043,11.51,0.07
2429,2021-02-18,CAL,1801,804,997,586,369,299,61,7,6,388,11,0,74,1578,223,ITF,ITF6,18,Calabria,Calabria,1947131,225844,11.6,0.09
2430,2021-01-25,CAL,1082,523,559,1037,35,0,0,0,1,0,0,0,9,156,926,ITF,ITF6,18,Calabria,Calabria,1947131,226926,11.65,0.06
2431,2021-03-10,CAL,6446,3281,3165,744,516,586,64,79,53,2233,1023,797,351,5252,1194,ITF,ITF6,18,Calabria,Calabria,1947131,233372,11.99,0.33
2432,2021-04-15,CAL,7394,3626,3768,161,153,162,199,144,1667,1064,3694,34,116,5790,1604,ITF,ITF6,18,Calabria,Calabria,1947131,240766,12.37,0.38
2433,2021-02-19,CAL,1461,652,809,544,208,195,0,9,9,422,57,1,16,1200,261,ITF,ITF6,18,Calabria,Calabria,1947131,242227,12.44,0.08
2434,2021-04-12,CAL,6695,3263,3432,219,136,276,104,105,858,1435,3433,37,92,5093,1602,ITF,ITF6,18,Calabria,Calabria,1947131,248922,12.78,0.34
2435,2021-02-12,CAL,1712,669,1043,816,300,136,0,64,32,210,0,0,154,944,768,ITF,ITF6,18,Calabria,Calabria,1947131,250634,12.87,0.09
2436,2021-01-11,CAL,2155,1041,1114,1760,301,3,0,17,4,39,0,0,31,2155,0,ITF,ITF6,18,Calabria,Calabria,1947131,252789,12.98,0.11
2437,2021-03-02,CAL,4137,2396,1741,705,202,430,2,26,24,1451,222,1003,72,3428,709,ITF,ITF6,18,Calabria,Calabria,1947131,256926,13.2,0.21
2438,2021-01-04,CAL,1008,499,509,980,28,0,0,0,0,0,0,0,0,1008,0,ITF,ITF6,18,Calabria,Calabria,1947131,257934,13.25,0.05
2439,2021-04-09,CAL,7822,3667,4155,342,139,471,306,151,506,2172,3495,31,209,4909,2913,ITF,ITF6,18,Calabria,Calabria,1947131,265756,13.65,0.4
2440,2021-03-15,CAL,3508,1675,1833,542,166,140,587,56,81,1183,431,177,145,2079,1429,ITF,ITF6,18,Calabria,Calabria,1947131,269264,13.83,0.18
2441,2021-02-02,CAL,2294,1115,1179,1868,341,75,0,1,1,1,0,0,7,177,2117,ITF,ITF6,18,Calabria,Calabria,1947131,271558,13.95,0.12
2442,2021-01-14,CAL,2557,1214,1343,1962,349,3,0,61,24,47,0,0,111,2557,0,ITF,ITF6,18,Calabria,Calabria,1947131,274115,14.08,0.13
2443,2021-04-05,CAL,3458,1633,1825,133,22,149,134,286,439,1181,1042,18,54,2557,901,ITF,ITF6,18,Calabria,Calabria,1947131,277573,14.26,0.18
2444,2021-01-10,CAL,929,524,405,830,99,0,0,0,0,0,0,0,0,929,0,ITF,ITF6,18,Calabria,Calabria,1947131,278502,14.3,0.05
2445,2021-02-07,CAL,860,428,432,567,121,81,0,10,0,0,0,0,81,147,713,ITF,ITF6,18,Calabria,Calabria,1947131,279362,14.35,0.04
2446,2021-01-23,CAL,400,186,214,325,25,23,0,2,0,1,0,0,24,358,42,ITF,ITF6,18,Calabria,Calabria,1947131,279762,14.37,0.02
2447,2021-03-25,CAL,7003,3315,3688,293,362,564,1100,112,124,2270,1839,80,259,4484,2519,ITF,ITF6,18,Calabria,Calabria,1947131,286765,14.73,0.36
2448,2021-02-10,CAL,2463,1074,1389,1469,340,357,0,56,25,72,0,0,144,839,1624,ITF,ITF6,18,Calabria,Calabria,1947131,289228,14.85,0.13
2449,2021-02-15,CAL,1137,538,599,499,121,164,1,11,20,294,4,0,23,989,148,ITF,ITF6,18,Calabria,Calabria,1947131,290365,14.91,0.06
2450,2021-04-23,CAL,12615,6268,6347,302,189,226,205,1709,2409,1203,5884,180,308,9372,3243,ITF,ITF6,18,Calabria,Calabria,1947131,302980,15.56,0.65
2451,2021-02-03,CAL,2767,1432,1335,2173,394,103,0,18,4,2,0,0,73,583,2184,ITF,ITF6,18,Calabria,Calabria,1947131,305747,15.7,0.14
2452,2021-01-13,CAL,2028,1022,1006,1800,152,34,0,14,4,4,0,0,20,2028,0,ITF,ITF6,18,Calabria,Calabria,1947131,307775,15.81,0.1
2453,2021-03-13,CAL,6676,2946,3730,425,159,356,685,95,43,3805,749,123,236,5683,993,ITF,ITF6,18,Calabria,Calabria,1947131,314451,16.15,0.34
2454,2021-01-19,CAL,1109,488,621,853,105,76,0,11,11,14,0,0,39,1098,11,ITF,ITF6,18,Calabria,Calabria,1947131,315560,16.21,0.06
2455,2021-04-27,CAL,9976,4895,5081,167,161,173,85,1992,2005,675,4507,75,136,8069,1907,ITF,ITF6,18,Calabria,Calabria,1947131,325536,16.72,0.51
2456,2021-03-01,CAL,2690,1534,1156,400,156,258,3,10,11,1053,71,656,72,2240,450,ITF,ITF6,18,Calabria,Calabria,1947131,328226,16.86,0.14
2457,2021-02-17,CAL,1683,673,1010,675,239,285,81,7,6,354,2,0,34,1472,211,ITF,ITF6,18,Calabria,Calabria,1947131,329909,16.94,0.09
2458,2021-04-03,CAL,8830,3789,5041,363,123,359,622,88,215,4982,1908,57,113,4209,4621,ITF,ITF6,18,Calabria,Calabria,1947131,338739,17.4,0.45
2459,2021-01-06,CAL,926,500,426,822,90,0,0,5,0,0,0,0,9,926,0,ITF,ITF6,18,Calabria,Calabria,1947131,339665,17.44,0.05
2460,2021-02-16,CAL,1534,643,891,659,191,265,0,14,23,334,1,0,47,1255,279,ITF,ITF6,18,Calabria,Calabria,1947131,341199,17.52,0.08
2461,2021-02-21,CAL,608,286,322,36,46,48,0,2,2,374,28,30,42,531,77,ITF,ITF6,18,Calabria,Calabria,1947131,341807,17.55,0.03
2462,2021-03-29,CAL,5638,2385,3253,207,320,134,1580,134,162,1130,1673,71,227,3883,1755,ITF,ITF6,18,Calabria,Calabria,1947131,347445,17.84,0.29
2463,2021-03-09,CAL,5827,3034,2793,803,267,461,18,65,71,1926,1124,934,158,4850,977,ITF,ITF6,18,Calabria,Calabria,1947131,353272,18.14,0.3
2464,2021-04-29,CAL,11632,5654,5978,288,216,208,170,2085,1940,920,5571,49,185,8292,3340,ITF,ITF6,18,Calabria,Calabria,1947131,364904,18.74,0.6
2465,2021-03-12,CAL,5093,2438,2655,468,397,220,786,61,38,2148,412,403,160,4050,1043,ITF,ITF6,18,Calabria,Calabria,1947131,369997,19.0,0.26
2466,2021-02-20,CAL,1359,735,624,439,185,55,2,13,5,490,54,19,97,1044,315,ITF,ITF6,18,Calabria,Calabria,1947131,371356,19.07,0.07
2467,2021-02-01,CAL,2504,1196,1308,2051,359,43,0,14,2,1,0,0,34,248,2256,ITF,ITF6,18,Calabria,Calabria,1947131,373860,19.2,0.13
2468,2021-04-30,CAL,14668,7211,7457,311,303,335,283,2532,2421,871,7273,104,235,10571,4097,ITF,ITF6,18,Calabria,Calabria,1947131,388528,19.95,0.75
2469,2021-05-04,CAL,16233,7457,8776,301,243,184,529,3032,2107,1451,7950,91,345,11608,4625,ITF,ITF6,18,Calabria,Calabria,1947131,404761,20.79,0.83
2470,2021-01-07,CAL,2183,1063,1120,1885,212,0,0,20,4,0,0,0,62,2183,0,ITF,ITF6,18,Calabria,Calabria,1947131,406944,20.9,0.11
2471,2021-03-21,CAL,4366,1883,2483,135,38,200,745,80,92,2129,695,83,169,2663,1703,ITF,ITF6,18,Calabria,Calabria,1947131,411310,21.12,0.22
2472,2021-02-23,CAL,1549,728,821,437,177,206,1,13,10,583,63,2,57,1434,115,ITF,ITF6,18,Calabria,Calabria,1947131,412859,21.2,0.08
2473,2021-01-18,CAL,1239,555,684,990,138,11,0,25,3,6,0,0,66,1040,199,ITF,ITF6,18,Calabria,Calabria,1947131,414098,21.27,0.06
2474,2021-03-06,CAL,7958,4063,3895,703,225,760,6,41,97,4059,1136,840,91,7202,756,ITF,ITF6,18,Calabria,Calabria,1947131,422056,21.68,0.41
2475,2021-01-28,CAL,2236,1110,1126,1924,284,0,0,2,1,0,0,0,25,84,2152,ITF,ITF6,18,Calabria,Calabria,1947131,424292,21.79,0.11
2476,2021-04-07,CAL,6198,2810,3388,193,70,399,539,113,181,2098,2442,32,131,3641,2557,ITF,ITF6,18,Calabria,Calabria,1947131,430490,22.11,0.32
2477,2021-03-17,CAL,3646,1626,2020,280,148,165,95,40,82,2179,584,31,42,1948,1698,ITF,ITF6,18,Calabria,Calabria,1947131,434136,22.3,0.19
2478,2021-02-26,CAL,3081,1632,1449,540,193,408,4,21,18,1362,84,370,81,2611,470,ITF,ITF6,18,Calabria,Calabria,1947131,437217,22.45,0.16
2479,2021-02-14,CAL,371,145,226,146,31,83,0,2,2,95,0,0,12,341,30,ITF,ITF6,18,Calabria,Calabria,1947131,437588,22.47,0.02
2480,2021-03-27,CAL,8322,3778,4544,306,389,149,1400,125,179,3416,1871,66,421,4460,3862,ITF,ITF6,18,Calabria,Calabria,1947131,445910,22.9,0.43
2481,2021-04-22,CAL,9354,4670,4684,236,170,274,96,1451,1801,966,4105,41,214,6666,2688,ITF,ITF6,18,Calabria,Calabria,1947131,455264,23.38,0.48
2482,2021-01-08,CAL,2113,1016,1097,1899,203,0,0,3,0,0,0,0,8,2113,0,ITF,ITF6,18,Calabria,Calabria,1947131,457377,23.49,0.11
2483,2021-01-26,CAL,1895,915,980,1608,202,70,0,1,0,0,0,0,14,285,1610,ITF,ITF6,18,Calabria,Calabria,1947131,459272,23.59,0.1
2484,2021-01-03,CAL,6,3,3,4,2,0,0,0,0,0,0,0,0,6,0,ITF,ITF6,18,Calabria,Calabria,1947131,459278,23.59,0.0
2485,2021-04-13,CAL,6491,3197,3294,245,92,40,106,103,1275,1273,3086,153,118,5233,1258,ITF,ITF6,18,Calabria,Calabria,1947131,465769,23.92,0.33
2486,2021-03-26,CAL,7648,3628,4020,511,371,218,1039,151,231,2562,2059,135,371,4533,3115,ITF,ITF6,18,Calabria,Calabria,1947131,473417,24.31,0.39
2487,2021-01-02,CAL,165,94,71,165,0,0,0,0,0,0,0,0,0,165,0,ITF,ITF6,18,Calabria,Calabria,1947131,473582,24.32,0.01
2488,2021-01-24,CAL,44,18,26,15,3,26,0,0,0,0,0,0,0,39,5,ITF,ITF6,18,Calabria,Calabria,1947131,473626,24.32,0.0
2489,2020-12-28,CAL,6,2,4,6,0,0,0,0,0,0,0,0,0,6,0,ITF,ITF6,18,Calabria,Calabria,1947131,473632,24.32,0.0
2490,2021-04-01,CAL,8356,3776,4580,455,247,680,1116,122,218,3070,1992,113,343,3852,4504,ITF,ITF6,18,Calabria,Calabria,1947131,481988,24.75,0.43
2491,2021-03-24,CAL,7391,3367,4024,386,289,700,1495,151,146,2605,1295,105,219,4212,3179,ITF,ITF6,18,Calabria,Calabria,1947131,489379,25.13,0.38
2492,2021-05-01,CAL,16441,7848,8593,174,277,48,326,2337,3051,2068,7734,108,318,12386,4055,ITF,ITF6,18,Calabria,Calabria,1947131,505820,25.98,0.84
2493,2021-03-23,CAL,5207,2442,2765,280,145,55,1083,98,74,2046,1078,102,246,3409,1798,ITF,ITF6,18,Calabria,Calabria,1947131,511027,26.25,0.27
2494,2021-01-05,CAL,1442,675,767,1309,120,0,0,2,0,0,0,0,11,1442,0,ITF,ITF6,18,Calabria,Calabria,1947131,512469,26.32,0.07
2495,2021-01-16,CAL,2394,1120,1274,1664,264,241,0,49,12,9,0,0,155,2394,0,ITF,ITF6,18,Calabria,Calabria,1947131,514863,26.44,0.12
2496,2021-03-30,CAL,5793,2490,3303,166,103,213,1122,154,196,1991,1473,89,286,3200,2593,ITF,ITF6,18,Calabria,Calabria,1947131,520656,26.74,0.3
2497,2021-05-03,CAL,14664,6717,7947,317,217,335,545,2713,2112,771,7080,114,460,10536,4128,ITF,ITF6,18,Calabria,Calabria,1947131,535320,27.49,0.75
2498,2021-03-11,CAL,6888,3283,3605,936,474,574,600,122,88,2560,873,412,249,5630,1258,ITF,ITF6,18,Calabria,Calabria,1947131,542208,27.85,0.35
2499,2021-04-08,CAL,9382,4412,4970,453,178,537,304,216,581,3377,3463,44,229,5704,3678,ITF,ITF6,18,Calabria,Calabria,1947131,551590,28.33,0.48
2500,2021-04-10,CAL,11182,5038,6144,424,161,463,303,145,704,5603,3147,49,183,6351,4831,ITF,ITF6,18,Calabria,Calabria,1947131,562772,28.9,0.57
2501,2021-03-22,CAL,4710,2203,2507,196,125,148,1125,49,50,1994,804,77,142,3041,1669,ITF,ITF6,18,Calabria,Calabria,1947131,567482,29.14,0.24
2502,2021-04-20,CAL,7645,3840,3805,295,300,137,165,420,1715,1066,3151,115,281,6023,1622,ITF,ITF6,18,Calabria,Calabria,1947131,575127,29.54,0.39
2503,2021-01-15,CAL,2793,1258,1535,1690,349,412,0,54,19,44,0,0,225,2793,0,ITF,ITF6,18,Calabria,Calabria,1947131,577920,29.68,0.14
2504,2021-01-20,CAL,1397,624,773,866,127,179,0,41,14,25,0,0,145,1396,1,ITF,ITF6,18,Calabria,Calabria,1947131,579317,29.75,0.07
2505,2021-02-22,CAL,1998,1014,984,729,231,166,5,32,7,678,33,3,114,1441,557,ITF,ITF6,18,Calabria,Calabria,1947131,581315,29.85,0.1
2506,2021-04-19,CAL,7699,3706,3993,291,132,64,156,244,1971,1172,3482,92,95,6081,1618,ITF,ITF6,18,Calabria,Calabria,1947131,589014,30.25,0.4
2507,2021-05-02,CAL,12429,5801,6628,146,177,25,261,2530,1902,829,6216,68,275,10653,1776,ITF,ITF6,18,Calabria,Calabria,1947131,601443,30.89,0.64
2508,2021-04-20,SAR,10707,4872,5835,143,97,75,31,3942,2450,2004,1897,6,62,7546,3161,ITG,ITG2,20,Sardegna,Sardegna,1639591,10707,0.65,0.65
2509,2021-03-29,SAR,4379,1546,2833,624,490,182,1411,22,117,1022,312,98,101,3791,588,ITG,ITG2,20,Sardegna,Sardegna,1639591,15086,0.92,0.27
2510,2021-01-02,SAR,60,21,39,60,0,0,0,0,0,0,0,0,0,60,0,ITG,ITG2,20,Sardegna,Sardegna,1639591,15146,0.92,0.0
2511,2021-03-09,SAR,5150,2371,2779,1057,567,287,310,9,32,2278,16,561,33,4421,729,ITG,ITG2,20,Sardegna,Sardegna,1639591,20296,1.24,0.31
2512,2021-03-15,SAR,2685,1216,1469,458,591,86,1019,7,10,325,8,170,11,2312,373,ITG,ITG2,20,Sardegna,Sardegna,1639591,22981,1.4,0.16
2513,2021-01-07,SAR,3111,1077,2034,2720,373,0,0,1,2,0,0,11,4,3111,0,ITG,ITG2,20,Sardegna,Sardegna,1639591,26092,1.59,0.19
2514,2021-04-23,SAR,12611,5631,6980,395,189,70,129,2321,2002,3524,3668,8,305,7352,5259,ITG,ITG2,20,Sardegna,Sardegna,1639591,38703,2.36,0.77
2515,2021-02-26,SAR,2800,1108,1692,1224,878,221,7,20,16,289,5,98,42,2494,306,ITG,ITG2,20,Sardegna,Sardegna,1639591,41503,2.53,0.17
2516,2021-02-05,SAR,1897,749,1148,1214,511,164,0,0,0,1,1,3,3,433,1464,ITG,ITG2,20,Sardegna,Sardegna,1639591,43400,2.65,0.12
2517,2021-02-23,SAR,1519,1010,509,602,387,89,0,7,6,16,0,374,38,1285,234,ITG,ITG2,20,Sardegna,Sardegna,1639591,44919,2.74,0.09
2518,2020-12-28,SAR,65,25,40,65,0,0,0,0,0,0,0,0,0,65,0,ITG,ITG2,20,Sardegna,Sardegna,1639591,44984,2.74,0.0
2519,2021-01-13,SAR,573,178,395,494,79,0,0,0,0,0,0,0,0,573,0,ITG,ITG2,20,Sardegna,Sardegna,1639591,45557,2.78,0.03
2520,2021-03-21,SAR,4030,1809,2221,64,240,1,575,14,56,2890,17,107,66,2590,1440,ITG,ITG2,20,Sardegna,Sardegna,1639591,49587,3.02,0.25
2521,2021-03-11,SAR,6035,2725,3310,1011,567,418,102,52,98,2957,120,643,67,4834,1201,ITG,ITG2,20,Sardegna,Sardegna,1639591,55622,3.39,0.37
2522,2021-03-18,SAR,7253,3069,4184,1078,315,354,63,55,639,4243,431,12,63,5650,1603,ITG,ITG2,20,Sardegna,Sardegna,1639591,62875,3.83,0.44
2523,2021-03-31,SAR,10142,4045,6097,396,575,230,1379,148,701,5008,1487,33,185,7695,2447,ITG,ITG2,20,Sardegna,Sardegna,1639591,73017,4.45,0.62
2524,2021-04-17,SAR,10037,4480,5557,299,90,108,24,1698,2717,3702,1224,3,172,5459,4578,ITG,ITG2,20,Sardegna,Sardegna,1639591,83054,5.07,0.61
2525,2021-01-29,SAR,2952,1067,1885,2581,366,3,0,0,0,0,0,0,2,48,2904,ITG,ITG2,20,Sardegna,Sardegna,1639591,86006,5.25,0.18
2526,2021-03-03,SAR,3834,2061,1773,1070,554,600,1,5,5,704,1,857,37,2607,1227,ITG,ITG2,20,Sardegna,Sardegna,1639591,89840,5.48,0.23
2527,2021-01-09,SAR,4026,1417,2609,3182,832,0,0,3,1,1,0,0,7,4026,0,ITG,ITG2,20,Sardegna,Sardegna,1639591,93866,5.72,0.25
2528,2021-03-01,SAR,2162,1055,1107,1137,341,141,1,8,19,104,10,391,10,1503,659,ITG,ITG2,20,Sardegna,Sardegna,1639591,96028,5.86,0.13
2529,2021-01-22,SAR,83,47,36,45,38,0,0,0,0,0,0,0,0,55,28,ITG,ITG2,20,Sardegna,Sardegna,1639591,96111,5.86,0.01
2530,2021-02-17,SAR,1407,577,830,690,338,313,0,1,0,0,1,33,31,1333,74,ITG,ITG2,20,Sardegna,Sardegna,1639591,97518,5.95,0.09
2531,2021-03-06,SAR,2639,1079,1560,1108,886,469,36,3,10,24,2,79,22,858,1781,ITG,ITG2,20,Sardegna,Sardegna,1639591,100157,6.11,0.16
2532,2021-02-16,SAR,700,289,411,376,211,112,0,0,0,0,0,0,1,673,27,ITG,ITG2,20,Sardegna,Sardegna,1639591,100857,6.15,0.04
2533,2021-04-22,SAR,10301,4560,5741,218,121,76,36,2635,1571,2887,2524,6,227,5456,4845,ITG,ITG2,20,Sardegna,Sardegna,1639591,111158,6.78,0.63
2534,2021-04-27,SAR,7579,3533,4046,164,68,51,42,532,879,1607,4096,2,138,5540,2039,ITG,ITG2,20,Sardegna,Sardegna,1639591,118737,7.24,0.46
2535,2021-03-10,SAR,6009,2917,3092,719,497,414,335,14,85,2986,29,902,28,5159,850,ITG,ITG2,20,Sardegna,Sardegna,1639591,124746,7.61,0.37
2536,2021-04-13,SAR,7591,3587,4004,216,62,45,15,486,3658,1492,1437,144,36,5768,1823,ITG,ITG2,20,Sardegna,Sardegna,1639591,132337,8.07,0.46
2537,2021-02-21,SAR,1589,710,879,67,28,59,0,0,7,1422,0,6,0,1559,30,ITG,ITG2,20,Sardegna,Sardegna,1639591,133926,8.17,0.1
2538,2021-02-28,SAR,368,169,199,245,76,47,0,0,0,0,0,0,0,142,226,ITG,ITG2,20,Sardegna,Sardegna,1639591,134294,8.19,0.02
2539,2021-01-26,SAR,1336,453,883,1296,39,0,1,0,0,0,0,0,0,27,1309,ITG,ITG2,20,Sardegna,Sardegna,1639591,135630,8.27,0.08
2540,2021-02-09,SAR,2286,837,1449,1308,471,497,1,4,0,1,2,0,2,1290,996,ITG,ITG2,20,Sardegna,Sardegna,1639591,137916,8.41,0.14
2541,2021-01-31,SAR,2121,750,1371,1544,555,0,0,6,0,1,1,0,14,48,2073,ITG,ITG2,20,Sardegna,Sardegna,1639591,140037,8.54,0.13
2542,2021-01-16,SAR,1492,525,967,1282,207,0,1,1,1,0,0,0,0,1492,0,ITG,ITG2,20,Sardegna,Sardegna,1639591,141529,8.63,0.09
2543,2021-04-25,SAR,4081,2088,1993,41,4,0,3,1290,882,599,1248,1,13,3566,515,ITG,ITG2,20,Sardegna,Sardegna,1639591,145610,8.88,0.25
2544,2021-02-24,SAR,2410,1292,1118,1193,521,301,0,6,2,7,0,366,14,2221,189,ITG,ITG2,20,Sardegna,Sardegna,1639591,148020,9.03,0.15
2545,2021-03-20,SAR,5193,2073,3120,696,307,127,855,19,91,2744,203,105,46,2916,2277,ITG,ITG2,20,Sardegna,Sardegna,1639591,153213,9.34,0.32
2546,2021-04-06,SAR,7445,3113,4332,657,252,226,456,102,1847,2833,597,35,440,5018,2427,ITG,ITG2,20,Sardegna,Sardegna,1639591,160658,9.8,0.45
2547,2021-03-28,SAR,4619,1814,2805,83,42,23,681,49,131,3276,216,13,105,4540,79,ITG,ITG2,20,Sardegna,Sardegna,1639591,165277,10.08,0.28
2548,2021-01-17,SAR,860,277,583,747,113,0,0,0,0,0,0,0,0,859,1,ITG,ITG2,20,Sardegna,Sardegna,1639591,166137,10.13,0.05
2549,2021-03-19,SAR,7264,3046,4218,1315,773,222,10,141,581,3509,325,247,141,5052,2212,ITG,ITG2,20,Sardegna,Sardegna,1639591,173401,10.58,0.44
2550,2021-04-01,SAR,10095,4023,6072,460,377,210,1257,169,896,4689,1534,203,300,7084,3011,ITG,ITG2,20,Sardegna,Sardegna,1639591,183496,11.19,0.62
2551,2021-04-26,SAR,6728,3224,3504,57,84,24,7,2320,1338,819,2039,4,36,5855,873,ITG,ITG2,20,Sardegna,Sardegna,1639591,190224,11.6,0.41
2552,2021-04-12,SAR,6958,3167,3791,89,83,44,11,599,2800,2203,1003,30,96,5245,1713,ITG,ITG2,20,Sardegna,Sardegna,1639591,197182,12.03,0.42
2553,2021-03-05,SAR,5033,2443,2590,1694,1153,669,10,29,14,647,14,747,56,2681,2352,ITG,ITG2,20,Sardegna,Sardegna,1639591,202215,12.33,0.31
2554,2021-04-30,SAR,10316,4912,5404,384,162,18,207,776,949,1369,5974,334,143,6409,3907,ITG,ITG2,20,Sardegna,Sardegna,1639591,212531,12.96,0.63
2555,2021-03-08,SAR,4004,1786,2218,740,1027,650,153,8,8,854,46,505,13,2784,1220,ITG,ITG2,20,Sardegna,Sardegna,1639591,216535,13.21,0.24
2556,2021-05-02,SAR,5486,2498,2988,78,58,1,54,669,918,405,3156,13,134,5031,455,ITG,ITG2,20,Sardegna,Sardegna,1639591,222021,13.54,0.33
2557,2021-01-11,SAR,1183,505,678,656,525,0,0,0,0,1,0,0,1,1183,0,ITG,ITG2,20,Sardegna,Sardegna,1639591,223204,13.61,0.07
2558,2021-01-25,SAR,588,212,376,553,34,0,0,0,0,0,0,0,1,22,566,ITG,ITG2,20,Sardegna,Sardegna,1639591,223792,13.65,0.04
2559,2021-04-09,SAR,12159,5390,6769,437,257,39,163,442,3510,4893,2163,37,218,7806,4353,ITG,ITG2,20,Sardegna,Sardegna,1639591,235951,14.39,0.74
2560,2021-02-12,SAR,2237,933,1304,986,720,501,0,4,0,1,4,0,21,2178,59,ITG,ITG2,20,Sardegna,Sardegna,1639591,238188,14.53,0.14
2561,2021-04-11,SAR,5389,2442,2947,62,16,1,20,26,3233,1860,150,9,12,4269,1120,ITG,ITG2,20,Sardegna,Sardegna,1639591,243577,14.86,0.33
2562,2021-01-15,SAR,1563,573,990,1170,384,0,0,0,0,0,6,3,0,1563,0,ITG,ITG2,20,Sardegna,Sardegna,1639591,245140,14.95,0.1
2563,2021-01-23,SAR,60,22,38,60,0,0,0,0,0,0,0,0,0,0,60,ITG,ITG2,20,Sardegna,Sardegna,1639591,245200,14.95,0.0
2564,2021-01-12,SAR,865,408,457,504,361,0,0,0,0,0,0,0,0,865,0,ITG,ITG2,20,Sardegna,Sardegna,1639591,246065,15.01,0.05
2565,2021-01-14,SAR,1105,426,679,885,220,0,0,0,0,0,0,0,0,1105,0,ITG,ITG2,20,Sardegna,Sardegna,1639591,247170,15.08,0.07
2566,2021-03-07,SAR,1657,750,907,323,230,78,2,4,1,1012,0,0,7,1117,540,ITG,ITG2,20,Sardegna,Sardegna,1639591,248827,15.18,0.1
2567,2021-03-02,SAR,2865,1459,1406,1067,608,381,2,8,10,324,1,461,3,1712,1153,ITG,ITG2,20,Sardegna,Sardegna,1639591,251692,15.35,0.17
2568,2021-02-11,SAR,1315,490,825,588,266,369,0,31,1,3,0,0,57,1204,111,ITG,ITG2,20,Sardegna,Sardegna,1639591,253007,15.43,0.08
2569,2021-04-07,SAR,13452,5973,7479,673,443,257,352,188,3337,5599,2358,72,173,7803,5649,ITG,ITG2,20,Sardegna,Sardegna,1639591,266459,16.25,0.82
2570,2021-04-14,SAR,8156,3857,4299,145,34,96,17,477,4874,833,1624,1,55,6920,1236,ITG,ITG2,20,Sardegna,Sardegna,1639591,274615,16.75,0.5
2571,2021-02-10,SAR,1959,765,1194,1169,299,488,1,0,1,0,0,0,1,1441,518,ITG,ITG2,20,Sardegna,Sardegna,1639591,276574,16.87,0.12
2572,2021-03-25,SAR,8790,3702,5088,815,312,189,1562,156,455,3870,947,343,141,7487,1303,ITG,ITG2,20,Sardegna,Sardegna,1639591,285364,17.4,0.54
2573,2021-02-20,SAR,2041,855,1186,484,150,195,1,2,4,1204,0,0,1,1707,334,ITG,ITG2,20,Sardegna,Sardegna,1639591,287405,17.53,0.12
2574,2021-02-15,SAR,958,349,609,440,231,279,0,2,0,0,3,0,3,927,31,ITG,ITG2,20,Sardegna,Sardegna,1639591,288363,17.59,0.06
2575,2021-03-13,SAR,2751,1072,1679,274,142,240,132,13,101,1765,22,44,18,2470,281,ITG,ITG2,20,Sardegna,Sardegna,1639591,291114,17.76,0.17
2576,2021-03-27,SAR,5712,2174,3538,331,322,217,1309,31,188,2635,507,83,89,5290,422,ITG,ITG2,20,Sardegna,Sardegna,1639591,296826,18.1,0.35
2577,2021-02-02,SAR,1482,655,827,988,475,0,0,0,0,0,0,0,19,241,1241,ITG,ITG2,20,Sardegna,Sardegna,1639591,298308,18.19,0.09
2578,2021-01-20,SAR,210,77,133,154,56,0,0,0,0,0,0,0,0,208,2,ITG,ITG2,20,Sardegna,Sardegna,1639591,298518,18.21,0.01
2579,2021-03-23,SAR,6143,2633,3510,1109,317,283,1140,34,166,2311,608,95,80,5065,1078,ITG,ITG2,20,Sardegna,Sardegna,1639591,304661,18.58,0.37
2580,2021-01-05,SAR,1327,446,881,1283,40,0,0,1,0,0,0,0,3,1327,0,ITG,ITG2,20,Sardegna,Sardegna,1639591,305988,18.66,0.08
2581,2021-04-03,SAR,4530,1744,2786,181,275,153,425,53,431,2684,209,23,96,2693,1837,ITG,ITG2,20,Sardegna,Sardegna,1639591,310518,18.94,0.28
2582,2020-12-27,SAR,65,34,31,65,0,0,0,0,0,0,0,0,0,65,0,ITG,ITG2,20,Sardegna,Sardegna,1639591,310583,18.94,0.0
2583,2021-04-18,SAR,5155,2239,2916,48,6,0,3,863,323,3472,418,11,11,2287,2868,ITG,ITG2,20,Sardegna,Sardegna,1639591,315738,19.26,0.31
2584,2021-01-27,SAR,1409,494,915,1304,103,0,0,0,0,0,0,0,2,79,1330,ITG,ITG2,20,Sardegna,Sardegna,1639591,317147,19.34,0.09
2585,2021-03-17,SAR,6556,2849,3707,1077,529,528,128,80,443,3343,369,5,54,4949,1607,ITG,ITG2,20,Sardegna,Sardegna,1639591,323703,19.74,0.4
2586,2021-04-24,SAR,10336,4841,5495,110,55,58,41,1956,1938,2266,3732,2,178,8007,2329,ITG,ITG2,20,Sardegna,Sardegna,1639591,334039,20.37,0.63
2587,2021-01-28,SAR,2968,1044,1924,2554,400,0,0,1,0,0,0,11,2,69,2899,ITG,ITG2,20,Sardegna,Sardegna,1639591,337007,20.55,0.18
2588,2021-01-10,SAR,2183,750,1433,1632,548,0,0,0,0,0,0,0,3,2183,0,ITG,ITG2,20,Sardegna,Sardegna,1639591,339190,20.69,0.13
2589,2021-03-14,SAR,606,376,230,34,210,0,12,2,1,251,0,87,9,606,0,ITG,ITG2,20,Sardegna,Sardegna,1639591,339796,20.72,0.04
2590,2021-04-21,SAR,12005,5537,6468,151,63,101,41,2750,1972,4293,2501,8,125,6527,5478,ITG,ITG2,20,Sardegna,Sardegna,1639591,351801,21.46,0.73
2591,2021-04-08,SAR,13421,5920,7501,715,198,77,288,393,2924,4978,3634,41,173,8303,5118,ITG,ITG2,20,Sardegna,Sardegna,1639591,365222,22.28,0.82
2592,2021-01-08,SAR,3258,1184,2074,2930,323,0,0,0,0,2,1,0,2,3258,0,ITG,ITG2,20,Sardegna,Sardegna,1639591,368480,22.47,0.2
2593,2021-02-18,SAR,1878,732,1146,1074,344,298,110,4,0,1,1,33,13,1814,64,ITG,ITG2,20,Sardegna,Sardegna,1639591,370358,22.59,0.11
2594,2021-02-27,SAR,1921,647,1274,1059,316,306,0,14,2,178,0,0,46,1366,555,ITG,ITG2,20,Sardegna,Sardegna,1639591,372279,22.71,0.12
2595,2021-04-04,SAR,1,0,1,0,0,0,0,0,0,1,0,0,0,0,1,ITG,ITG2,20,Sardegna,Sardegna,1639591,372280,22.71,0.0
2596,2021-02-04,SAR,2271,816,1455,1737,360,170,0,1,1,1,1,0,0,916,1355,ITG,ITG2,20,Sardegna,Sardegna,1639591,374551,22.84,0.14
2597,2021-02-19,SAR,1498,472,1026,677,390,388,0,4,4,1,13,1,20,1442,56,ITG,ITG2,20,Sardegna,Sardegna,1639591,376049,22.94,0.09
2598,2021-04-05,SAR,2036,784,1252,55,150,0,694,93,395,150,123,22,354,2035,1,ITG,ITG2,20,Sardegna,Sardegna,1639591,378085,23.06,0.12
2599,2021-05-03,SAR,8005,3752,4253,214,124,26,16,933,1251,624,4681,78,58,6522,1483,ITG,ITG2,20,Sardegna,Sardegna,1639591,386090,23.55,0.49
2600,2020-12-29,SAR,57,32,25,56,1,0,0,0,0,0,0,0,0,57,0,ITG,ITG2,20,Sardegna,Sardegna,1639591,386147,23.55,0.0
2601,2021-03-16,SAR,4374,1949,2425,663,224,352,8,36,163,2549,337,1,41,3452,922,ITG,ITG2,20,Sardegna,Sardegna,1639591,390521,23.82,0.27
2602,2021-03-26,SAR,8086,3178,4908,845,567,414,1522,140,466,2761,1002,227,142,6561,1525,ITG,ITG2,20,Sardegna,Sardegna,1639591,398607,24.31,0.49
2603,2021-04-28,SAR,8694,4106,4588,111,88,48,11,1014,1414,2152,3768,4,84,5026,3668,ITG,ITG2,20,Sardegna,Sardegna,1639591,407301,24.84,0.53
2604,2021-02-14,SAR,539,263,276,286,188,57,0,1,0,3,0,0,4,537,2,ITG,ITG2,20,Sardegna,Sardegna,1639591,407840,24.87,0.03
2605,2021-01-06,SAR,1615,549,1066,1510,99,0,0,0,0,1,0,0,5,1615,0,ITG,ITG2,20,Sardegna,Sardegna,1639591,409455,24.97,0.1
2606,2021-02-25,SAR,2898,1254,1644,1474,611,466,9,6,2,241,2,74,13,2293,605,ITG,ITG2,20,Sardegna,Sardegna,1639591,412353,25.15,0.18
2607,2021-03-12,SAR,5756,2408,3348,1048,766,464,159,33,56,2573,84,468,105,4448,1308,ITG,ITG2,20,Sardegna,Sardegna,1639591,418109,25.5,0.35
2608,2021-01-04,SAR,592,217,375,565,20,0,0,0,0,1,1,0,5,592,0,ITG,ITG2,20,Sardegna,Sardegna,1639591,418701,25.54,0.04
2609,2020-12-31,SAR,32,16,16,28,4,0,0,0,0,0,0,0,0,32,0,ITG,ITG2,20,Sardegna,Sardegna,1639591,418733,25.54,0.0
2610,2021-02-01,SAR,1524,605,919,896,551,77,0,0,0,0,0,0,0,225,1299,ITG,ITG2,20,Sardegna,Sardegna,1639591,420257,25.63,0.09
2611,2021-01-19,SAR,747,270,477,423,163,160,1,0,0,0,0,0,0,692,55,ITG,ITG2,20,Sardegna,Sardegna,1639591,421004,25.68,0.05
2612,2021-02-07,SAR,1116,394,722,975,141,0,0,0,0,0,0,0,0,228,888,ITG,ITG2,20,Sardegna,Sardegna,1639591,422120,25.75,0.07
2613,2021-01-18,SAR,904,326,578,714,188,0,0,0,0,0,0,1,1,780,124,ITG,ITG2,20,Sardegna,Sardegna,1639591,423024,25.8,0.06
2614,2021-03-30,SAR,8582,3436,5146,651,514,237,1453,104,894,3361,1211,60,97,6310,2272,ITG,ITG2,20,Sardegna,Sardegna,1639591,431606,26.32,0.52
2615,2021-01-03,SAR,90,36,54,89,1,0,0,0,0,0,0,0,0,90,0,ITG,ITG2,20,Sardegna,Sardegna,1639591,431696,26.33,0.01
2616,2021-01-30,SAR,3862,1392,2470,2987,873,0,0,0,0,1,0,0,1,362,3500,ITG,ITG2,20,Sardegna,Sardegna,1639591,435558,26.57,0.24
2617,2021-01-21,SAR,126,60,66,60,66,0,0,0,0,0,0,0,0,94,32,ITG,ITG2,20,Sardegna,Sardegna,1639591,435684,26.57,0.01
2618,2021-05-04,SAR,9115,4201,4914,343,175,13,12,1546,2025,476,4414,22,89,7330,1785,ITG,ITG2,20,Sardegna,Sardegna,1639591,444799,27.13,0.56
2619,2021-02-03,SAR,1119,419,700,920,169,19,0,1,0,0,0,0,10,426,693,ITG,ITG2,20,Sardegna,Sardegna,1639591,445918,27.2,0.07
2620,2021-04-02,SAR,8973,3540,5433,533,693,177,1309,96,803,4209,920,71,162,5744,3229,ITG,ITG2,20,Sardegna,Sardegna,1639591,454891,27.74,0.55
2621,2021-04-16,SAR,14428,6487,7941,477,159,107,27,2161,4363,4310,2686,19,119,9086,5342,ITG,ITG2,20,Sardegna,Sardegna,1639591,469319,28.62,0.88
2622,2021-01-24,SAR,90,34,56,89,1,0,0,0,0,0,0,0,0,5,85,ITG,ITG2,20,Sardegna,Sardegna,1639591,469409,28.63,0.01
2623,2021-03-24,SAR,7279,2994,4285,739,254,397,1059,58,400,3163,785,330,94,5920,1359,ITG,ITG2,20,Sardegna,Sardegna,1639591,476688,29.07,0.44
2624,2021-05-01,SAR,9032,4364,4668,115,39,10,5,491,1133,2476,4669,8,86,5186,3846,ITG,ITG2,20,Sardegna,Sardegna,1639591,485720,29.62,0.55
2625,2021-03-22,SAR,3548,1362,2186,838,344,109,1136,15,42,784,153,105,22,3035,513,ITG,ITG2,20,Sardegna,Sardegna,1639591,489268,29.84,0.22
2626,2021-04-10,SAR,10321,4654,5667,153,110,11,218,590,4668,3601,802,11,157,8386,1935,ITG,ITG2,20,Sardegna,Sardegna,1639591,499589,30.47,0.63
2627,2021-02-06,SAR,1970,697,1273,1544,284,139,1,0,1,0,0,0,1,569,1401,ITG,ITG2,20,Sardegna,Sardegna,1639591,501559,30.59,0.12
2628,2021-02-13,SAR,1456,565,891,732,433,256,5,4,3,1,1,0,21,1454,2,ITG,ITG2,20,Sardegna,Sardegna,1639591,503015,30.68,0.09
2629,2021-02-08,SAR,1470,533,937,998,337,126,0,1,0,1,1,1,5,856,614,ITG,ITG2,20,Sardegna,Sardegna,1639591,504485,30.77,0.09
2630,2021-01-01,SAR,32,17,15,30,0,0,0,0,0,0,2,0,0,32,0,ITG,ITG2,20,Sardegna,Sardegna,1639591,504517,30.77,0.0
2631,2021-04-19,SAR,10010,4544,5466,186,75,88,43,3704,3106,1397,1374,6,31,8657,1353,ITG,ITG2,20,Sardegna,Sardegna,1639591,514527,31.38,0.61
2632,2021-03-04,SAR,4002,1953,2049,987,552,542,42,44,18,1153,1,581,82,2747,1255,ITG,ITG2,20,Sardegna,Sardegna,1639591,518529,31.63,0.24
2633,2021-02-22,SAR,1638,948,690,606,294,190,0,6,3,5,11,516,7,1410,228,ITG,ITG2,20,Sardegna,Sardegna,1639591,520167,31.73,0.1
2634,2021-04-15,SAR,11771,5504,6267,271,93,134,20,1055,4000,3891,2144,29,134,6821,4950,ITG,ITG2,20,Sardegna,Sardegna,1639591,531938,32.44,0.72
2635,2021-04-29,SAR,10042,4670,5372,237,93,57,21,949,1173,1268,6090,5,149,6138,3904,ITG,ITG2,20,Sardegna,Sardegna,1639591,541980,33.06,0.61
