,data,area,Vaccinazioni giornaliere,sesso_maschile,sesso_femminile,prima_dose,seconda_dose,pregressa_infezione,codice_NUTS1,codice_NUTS2,codice_regione_ISTAT,nome_area,Regione,popolazione,Totale vaccinazioni,Totale vaccinazioni ogni cento ab,Vaccinazioni giornaliere ogni cento ab
0,2021-01-26,MAR,2022,747,1275,73,1940,9,ITI,ITI3,11,Marche,Marche,1525271,2022,0.13,0.13
1,2021-07-11,MAR,10399,5220,5179,1605,8657,137,ITI,ITI3,11,Marche,Marche,1525271,12421,0.81,0.68
2,2021-04-19,MAR,9608,4502,5106,7899,1586,123,ITI,ITI3,11,Marche,Marche,1525271,22029,1.44,0.63
3,2021-07-28,MAR,14202,7373,6829,3251,10719,232,ITI,ITI3,11,Marche,Marche,1525271,36231,2.38,0.93
4,2021-01-21,MAR,922,262,660,577,328,17,ITI,ITI3,11,Marche,Marche,1525271,37153,2.44,0.06
5,2021-05-01,MAR,9328,3927,5401,3500,5751,77,ITI,ITI3,11,Marche,Marche,1525271,46481,3.05,0.61
6,2021-05-20,MAR,12684,5961,6723,7537,4896,251,ITI,ITI3,11,Marche,Marche,1525271,59165,3.88,0.83
7,2021-02-07,MAR,1873,735,1138,331,1530,12,ITI,ITI3,11,Marche,Marche,1525271,61038,4.0,0.12
8,2021-07-23,MAR,15542,8280,7262,2529,12789,224,ITI,ITI3,11,Marche,Marche,1525271,76580,5.02,1.02
9,2021-04-05,MAR,5703,2368,3335,4353,1269,81,ITI,ITI3,11,Marche,Marche,1525271,82283,5.39,0.37
10,2021-06-27,MAR,9949,4819,5130,4486,5292,171,ITI,ITI3,11,Marche,Marche,1525271,92232,6.05,0.65
11,2021-03-19,MAR,3882,1621,2261,326,3544,12,ITI,ITI3,11,Marche,Marche,1525271,96114,6.3,0.25
12,2021-08-06,MAR,11703,6353,5350,4143,7278,282,ITI,ITI3,11,Marche,Marche,1525271,107817,7.07,0.77
13,2021-05-15,MAR,14119,6441,7678,7827,6044,248,ITI,ITI3,11,Marche,Marche,1525271,121936,7.99,0.93
14,2021-08-23,MAR,6196,3341,2855,2278,3650,268,ITI,ITI3,11,Marche,Marche,1525271,128132,8.4,0.41
15,2021-02-19,MAR,2002,739,1263,1826,135,41,ITI,ITI3,11,Marche,Marche,1525271,130134,8.53,0.13
16,2021-03-24,MAR,7098,3019,4079,3309,3716,73,ITI,ITI3,11,Marche,Marche,1525271,137232,9.0,0.47
17,2021-06-01,MAR,12055,6157,5898,9679,2090,286,ITI,ITI3,11,Marche,Marche,1525271,149287,9.79,0.79
18,2021-03-10,MAR,5713,2442,3271,4479,1180,54,ITI,ITI3,11,Marche,Marche,1525271,155000,10.16,0.37
19,2021-02-21,MAR,376,141,235,363,1,12,ITI,ITI3,11,Marche,Marche,1525271,155376,10.19,0.02
20,2021-05-27,MAR,13734,6819,6915,9180,4301,253,ITI,ITI3,11,Marche,Marche,1525271,169110,11.09,0.9
21,2021-03-31,MAR,7378,3089,4289,4267,3025,86,ITI,ITI3,11,Marche,Marche,1525271,176488,11.57,0.48
22,2021-08-11,MAR,7571,4099,3472,3170,4165,236,ITI,ITI3,11,Marche,Marche,1525271,184059,12.07,0.5
23,2021-06-15,MAR,13194,6568,6626,9823,3052,319,ITI,ITI3,11,Marche,Marche,1525271,197253,12.93,0.87
24,2021-01-12,MAR,1234,418,816,1221,0,13,ITI,ITI3,11,Marche,Marche,1525271,198487,13.01,0.08
25,2021-06-22,MAR,13219,6482,6737,6475,6461,283,ITI,ITI3,11,Marche,Marche,1525271,211706,13.88,0.87
26,2021-04-26,MAR,9173,4062,5111,6017,3026,130,ITI,ITI3,11,Marche,Marche,1525271,220879,14.48,0.6
27,2021-03-05,MAR,6226,2874,3352,4691,1469,66,ITI,ITI3,11,Marche,Marche,1525271,227105,14.89,0.41
28,2021-01-07,MAR,1820,641,1179,1803,0,17,ITI,ITI3,11,Marche,Marche,1525271,228925,15.01,0.12
29,2021-03-12,MAR,4681,1999,2682,3346,1280,55,ITI,ITI3,11,Marche,Marche,1525271,233606,15.32,0.31
30,2021-01-14,MAR,2019,696,1323,1995,0,24,ITI,ITI3,11,Marche,Marche,1525271,235625,15.45,0.13
31,2021-06-20,MAR,11161,5547,5614,5991,4988,182,ITI,ITI3,11,Marche,Marche,1525271,246786,16.18,0.73
32,2021-02-14,MAR,739,301,438,727,0,12,ITI,ITI3,11,Marche,Marche,1525271,247525,16.23,0.05
33,2021-08-16,MAR,5166,2781,2385,2984,2022,160,ITI,ITI3,11,Marche,Marche,1525271,252691,16.57,0.34
34,2021-05-08,MAR,12293,5486,6807,4853,7264,176,ITI,ITI3,11,Marche,Marche,1525271,264984,17.37,0.81
35,2021-07-30,MAR,14715,7864,6851,4869,9558,288,ITI,ITI3,11,Marche,Marche,1525271,279699,18.34,0.96
36,2021-01-19,MAR,233,87,146,140,90,3,ITI,ITI3,11,Marche,Marche,1525271,279932,18.35,0.02
37,2021-02-02,MAR,1193,398,795,70,1123,0,ITI,ITI3,11,Marche,Marche,1525271,281125,18.43,0.08
38,2021-05-13,MAR,12613,5698,6915,6826,5508,279,ITI,ITI3,11,Marche,Marche,1525271,293738,19.26,0.83
39,2021-04-12,MAR,8573,3775,4798,7933,482,158,ITI,ITI3,11,Marche,Marche,1525271,302311,19.82,0.56
40,2021-01-02,MAR,458,143,315,456,0,2,ITI,ITI3,11,Marche,Marche,1525271,302769,19.85,0.03
41,2021-03-17,MAR,3476,1525,1951,105,3369,2,ITI,ITI3,11,Marche,Marche,1525271,306245,20.08,0.23
42,2021-08-30,MAR,5679,2841,2838,2359,3049,271,ITI,ITI3,11,Marche,Marche,1525271,311924,20.45,0.37
43,2021-02-28,MAR,2836,1251,1585,2822,6,8,ITI,ITI3,11,Marche,Marche,1525271,314760,20.64,0.19
44,2021-06-08,MAR,14098,7094,7004,11195,2611,292,ITI,ITI3,11,Marche,Marche,1525271,328858,21.56,0.92
45,2021-07-18,MAR,12124,6310,5814,1333,10673,118,ITI,ITI3,11,Marche,Marche,1525271,340982,22.36,0.79
46,2021-01-31,MAR,1921,772,1149,93,1824,4,ITI,ITI3,11,Marche,Marche,1525271,342903,22.48,0.13
47,2021-04-07,MAR,8875,3932,4943,8361,369,145,ITI,ITI3,11,Marche,Marche,1525271,351778,23.06,0.58
48,2021-02-09,MAR,125,42,83,46,79,0,ITI,ITI3,11,Marche,Marche,1525271,351903,23.07,0.01
49,2021-07-16,MAR,15838,8239,7599,1844,13736,258,ITI,ITI3,11,Marche,Marche,1525271,367741,24.11,1.04
50,2021-06-12,MAR,13782,7316,6466,12104,1346,332,ITI,ITI3,11,Marche,Marche,1525271,381523,25.01,0.9
51,2021-04-16,MAR,10089,4707,5382,9352,526,211,ITI,ITI3,11,Marche,Marche,1525271,391612,25.67,0.66
52,2021-07-04,MAR,10896,5445,5451,3204,7531,161,ITI,ITI3,11,Marche,Marche,1525271,402508,26.39,0.71
53,2020-12-31,MAR,392,184,208,390,0,2,ITI,ITI3,11,Marche,Marche,1525271,402900,26.41,0.03
54,2021-07-09,MAR,14903,7502,7401,2557,12132,214,ITI,ITI3,11,Marche,Marche,1525271,417803,27.39,0.98
55,2021-03-29,MAR,5898,2584,3314,3391,2458,49,ITI,ITI3,11,Marche,Marche,1525271,423701,27.78,0.39
56,2021-06-03,MAR,14638,7483,7155,12081,2252,305,ITI,ITI3,11,Marche,Marche,1525271,438339,28.74,0.96
57,2021-08-18,MAR,6422,3421,3001,3215,2872,335,ITI,ITI3,11,Marche,Marche,1525271,444761,29.16,0.42
58,2021-08-04,MAR,12002,6380,5622,4059,7701,242,ITI,ITI3,11,Marche,Marche,1525271,456763,29.95,0.79
59,2021-01-23,MAR,557,190,367,118,436,3,ITI,ITI3,11,Marche,Marche,1525271,457320,29.98,0.04
60,2021-06-29,MAR,13371,6599,6772,4928,8215,228,ITI,ITI3,11,Marche,Marche,1525271,470691,30.86,0.88
61,2021-04-24,MAR,12174,5367,6807,7559,4467,148,ITI,ITI3,11,Marche,Marche,1525271,482865,31.66,0.8
62,2021-02-26,MAR,3681,1523,2158,3096,480,105,ITI,ITI3,11,Marche,Marche,1525271,486546,31.9,0.24
63,2021-05-12,MAR,10430,4691,5739,4732,5505,193,ITI,ITI3,11,Marche,Marche,1525271,496976,32.58,0.68
64,2021-08-20,MAR,4963,2693,2270,2952,1687,324,ITI,ITI3,11,Marche,Marche,1525271,501939,32.91,0.33
65,2021-09-03,MAR,5436,2865,2571,1693,3522,221,ITI,ITI3,11,Marche,Marche,1525271,507375,33.26,0.36
66,2021-07-08,MAR,15040,7539,7501,2788,12027,225,ITI,ITI3,11,Marche,Marche,1525271,522415,34.25,0.99
67,2021-01-09,MAR,1718,606,1112,1698,0,20,ITI,ITI3,11,Marche,Marche,1525271,524133,34.36,0.11
68,2021-04-02,MAR,6896,2987,3909,6043,739,114,ITI,ITI3,11,Marche,Marche,1525271,531029,34.82,0.45
69,2021-03-16,MAR,3522,1523,1999,285,3231,6,ITI,ITI3,11,Marche,Marche,1525271,534551,35.05,0.23
70,2021-06-24,MAR,13844,6679,7165,6187,7386,271,ITI,ITI3,11,Marche,Marche,1525271,548395,35.95,0.91
71,2021-08-25,MAR,5583,2989,2594,2724,2538,321,ITI,ITI3,11,Marche,Marche,1525271,553978,36.32,0.37
72,2021-03-07,MAR,5180,2107,3073,4378,754,48,ITI,ITI3,11,Marche,Marche,1525271,559158,36.66,0.34
73,2021-08-08,MAR,5637,3020,2617,1681,3845,111,ITI,ITI3,11,Marche,Marche,1525271,564795,37.03,0.37
74,2021-07-06,MAR,13965,6920,7045,3144,10598,223,ITI,ITI3,11,Marche,Marche,1525271,578760,37.94,0.92
75,2021-07-20,MAR,14398,7436,6962,1769,12454,175,ITI,ITI3,11,Marche,Marche,1525271,593158,38.89,0.94
76,2021-03-02,MAR,5002,1967,3035,4370,566,66,ITI,ITI3,11,Marche,Marche,1525271,598160,39.22,0.33
77,2021-06-10,MAR,14931,7696,7235,12575,2013,343,ITI,ITI3,11,Marche,Marche,1525271,613091,40.2,0.98
78,2021-09-01,MAR,6205,3280,2925,2020,3952,233,ITI,ITI3,11,Marche,Marche,1525271,619296,40.6,0.41
79,2021-08-15,MAR,225,112,113,205,13,7,ITI,ITI3,11,Marche,Marche,1525271,619521,40.62,0.01
80,2021-05-24,MAR,10999,5193,5806,7957,2865,177,ITI,ITI3,11,Marche,Marche,1525271,630520,41.34,0.72
81,2021-07-25,MAR,9355,4936,4419,1007,8249,99,ITI,ITI3,11,Marche,Marche,1525271,639875,41.95,0.61
82,2021-01-04,MAR,1528,575,953,1515,0,13,ITI,ITI3,11,Marche,Marche,1525271,641403,42.05,0.1
83,2021-04-14,MAR,10220,4565,5655,9652,369,199,ITI,ITI3,11,Marche,Marche,1525271,651623,42.72,0.67
84,2020-12-30,MAR,17,5,12,17,0,0,ITI,ITI3,11,Marche,Marche,1525271,651640,42.72,0.0
85,2021-02-18,MAR,2146,787,1359,1806,288,52,ITI,ITI3,11,Marche,Marche,1525271,653786,42.86,0.14
86,2021-05-29,MAR,12875,6239,6636,8117,4540,218,ITI,ITI3,11,Marche,Marche,1525271,666661,43.71,0.84
87,2021-02-16,MAR,1287,475,812,1225,30,32,ITI,ITI3,11,Marche,Marche,1525271,667948,43.79,0.08
88,2021-02-25,MAR,3561,1465,2096,3317,181,63,ITI,ITI3,11,Marche,Marche,1525271,671509,44.03,0.23
89,2021-08-01,MAR,7495,4049,3446,1833,5577,85,ITI,ITI3,11,Marche,Marche,1525271,679004,44.52,0.49
90,2021-06-05,MAR,13944,7011,6933,11520,2058,366,ITI,ITI3,11,Marche,Marche,1525271,692948,45.43,0.91
91,2021-04-23,MAR,11318,5222,6096,8098,3055,165,ITI,ITI3,11,Marche,Marche,1525271,704266,46.17,0.74
92,2021-02-23,MAR,3314,1432,1882,3243,56,15,ITI,ITI3,11,Marche,Marche,1525271,707580,46.39,0.22
93,2021-01-16,MAR,2040,735,1305,1989,0,51,ITI,ITI3,11,Marche,Marche,1525271,709620,46.52,0.13
94,2021-06-19,MAR,14695,7403,7292,7748,6681,266,ITI,ITI3,11,Marche,Marche,1525271,724315,47.49,0.96
95,2021-05-31,MAR,11782,5944,5838,8599,2931,252,ITI,ITI3,11,Marche,Marche,1525271,736097,48.26,0.77
96,2021-05-17,MAR,12047,5649,6398,7467,4353,227,ITI,ITI3,11,Marche,Marche,1525271,748144,49.05,0.79
97,2021-05-03,MAR,10410,4689,5721,4858,5413,139,ITI,ITI3,11,Marche,Marche,1525271,758554,49.73,0.68
98,2021-03-28,MAR,4127,1740,2387,2396,1693,38,ITI,ITI3,11,Marche,Marche,1525271,762681,50.0,0.27
99,2021-01-30,MAR,1905,668,1237,24,1881,0,ITI,ITI3,11,Marche,Marche,1525271,764586,50.13,0.12
100,2021-01-15,MAR,1772,500,1272,1755,0,17,ITI,ITI3,11,Marche,Marche,1525271,766358,50.24,0.12
101,2021-04-25,MAR,8605,3996,4609,6894,1578,133,ITI,ITI3,11,Marche,Marche,1525271,774963,50.81,0.56
102,2021-08-03,MAR,10878,5737,5141,4030,6582,266,ITI,ITI3,11,Marche,Marche,1525271,785841,51.52,0.71
103,2021-08-12,MAR,8018,4330,3688,3888,3769,361,ITI,ITI3,11,Marche,Marche,1525271,793859,52.05,0.53
104,2021-05-22,MAR,11941,5720,6221,7321,4449,171,ITI,ITI3,11,Marche,Marche,1525271,805800,52.83,0.78
105,2021-02-11,MAR,1988,657,1331,1557,390,41,ITI,ITI3,11,Marche,Marche,1525271,807788,52.96,0.13
106,2021-05-05,MAR,11696,5322,6374,5102,6432,162,ITI,ITI3,11,Marche,Marche,1525271,819484,53.73,0.77
107,2021-08-13,MAR,6751,3759,2992,3388,3151,212,ITI,ITI3,11,Marche,Marche,1525271,826235,54.17,0.44
108,2021-01-11,MAR,1182,413,769,1164,0,18,ITI,ITI3,11,Marche,Marche,1525271,827417,54.25,0.08
109,2021-04-21,MAR,10787,4970,5817,9428,1195,164,ITI,ITI3,11,Marche,Marche,1525271,838204,54.95,0.71
110,2021-01-28,MAR,2091,726,1365,159,1931,1,ITI,ITI3,11,Marche,Marche,1525271,840295,55.09,0.14
111,2021-04-04,MAR,3835,1797,2038,2614,1169,52,ITI,ITI3,11,Marche,Marche,1525271,844130,55.34,0.25
112,2021-07-13,MAR,14853,7278,7575,1456,13268,129,ITI,ITI3,11,Marche,Marche,1525271,858983,56.32,0.97
113,2021-08-31,MAR,4832,2562,2270,2016,2587,229,ITI,ITI3,11,Marche,Marche,1525271,863815,56.63,0.32
114,2021-06-09,MAR,14281,7417,6864,12110,1869,302,ITI,ITI3,11,Marche,Marche,1525271,878096,57.57,0.94
115,2021-06-07,MAR,13322,6589,6733,10569,2450,303,ITI,ITI3,11,Marche,Marche,1525271,891418,58.44,0.87
116,2021-02-27,MAR,3401,1457,1944,3158,209,34,ITI,ITI3,11,Marche,Marche,1525271,894819,58.67,0.22
117,2021-08-27,MAR,5715,3050,2665,2800,2514,401,ITI,ITI3,11,Marche,Marche,1525271,900534,59.04,0.37
118,2021-07-01,MAR,14696,7367,7329,4659,9759,278,ITI,ITI3,11,Marche,Marche,1525271,915230,60.0,0.96
119,2021-04-09,MAR,9572,4193,5379,9151,200,221,ITI,ITI3,11,Marche,Marche,1525271,924802,60.63,0.63
120,2021-07-27,MAR,14365,7533,6832,3033,11106,226,ITI,ITI3,11,Marche,Marche,1525271,939167,61.57,0.94
121,2021-01-06,MAR,2215,804,1411,2196,0,19,ITI,ITI3,11,Marche,Marche,1525271,941382,61.72,0.15
122,2021-03-04,MAR,6539,2894,3645,5081,1395,63,ITI,ITI3,11,Marche,Marche,1525271,947921,62.15,0.43
123,2021-03-13,MAR,5807,2681,3126,1765,4002,40,ITI,ITI3,11,Marche,Marche,1525271,953728,62.53,0.38
124,2021-08-17,MAR,7596,4042,3554,3086,4286,224,ITI,ITI3,11,Marche,Marche,1525271,961324,63.03,0.5
125,2021-05-10,MAR,9466,4346,5120,4761,4564,141,ITI,ITI3,11,Marche,Marche,1525271,970790,63.65,0.62
126,2021-03-14,MAR,2499,1032,1467,1897,592,10,ITI,ITI3,11,Marche,Marche,1525271,973289,63.81,0.16
127,2021-03-21,MAR,4506,1873,2633,1612,2877,17,ITI,ITI3,11,Marche,Marche,1525271,977795,64.11,0.3
128,2021-02-06,MAR,2463,902,1561,512,1942,9,ITI,ITI3,11,Marche,Marche,1525271,980258,64.27,0.16
129,2021-03-18,MAR,3440,1507,1933,149,3279,12,ITI,ITI3,11,Marche,Marche,1525271,983698,64.49,0.23
130,2021-06-26,MAR,13577,6906,6671,5688,7672,217,ITI,ITI3,11,Marche,Marche,1525271,997275,65.38,0.89
131,2021-05-23,MAR,9210,4284,4926,7414,1672,124,ITI,ITI3,11,Marche,Marche,1525271,1006485,65.99,0.6
132,2021-05-06,MAR,12661,5825,6836,5359,7075,227,ITI,ITI3,11,Marche,Marche,1525271,1019146,66.82,0.83
133,2021-02-12,MAR,1581,618,963,1404,151,26,ITI,ITI3,11,Marche,Marche,1525271,1020727,66.92,0.1
134,2021-04-30,MAR,14167,6205,7962,5396,8573,198,ITI,ITI3,11,Marche,Marche,1525271,1034894,67.85,0.93
135,2021-04-11,MAR,7120,3118,4002,6685,287,148,ITI,ITI3,11,Marche,Marche,1525271,1042014,68.32,0.47
136,2021-03-11,MAR,6636,2824,3812,5145,1412,79,ITI,ITI3,11,Marche,Marche,1525271,1048650,68.75,0.44
137,2021-03-25,MAR,6704,2794,3910,3188,3456,60,ITI,ITI3,11,Marche,Marche,1525271,1055354,69.19,0.44
138,2021-05-07,MAR,12845,5806,7039,3559,9185,101,ITI,ITI3,11,Marche,Marche,1525271,1068199,70.03,0.84
139,2021-02-13,MAR,1093,462,631,988,82,23,ITI,ITI3,11,Marche,Marche,1525271,1069292,70.11,0.07
140,2021-01-27,MAR,2120,778,1342,113,2005,2,ITI,ITI3,11,Marche,Marche,1525271,1071412,70.24,0.14
141,2021-01-13,MAR,2114,747,1367,2073,0,41,ITI,ITI3,11,Marche,Marche,1525271,1073526,70.38,0.14
142,2021-05-02,MAR,8907,3941,4966,3080,5742,85,ITI,ITI3,11,Marche,Marche,1525271,1082433,70.97,0.58
143,2021-08-10,MAR,9202,4815,4387,3333,5593,276,ITI,ITI3,11,Marche,Marche,1525271,1091635,71.57,0.6
144,2021-06-28,MAR,12362,6026,6336,4614,7511,237,ITI,ITI3,11,Marche,Marche,1525271,1103997,72.38,0.81
145,2021-03-22,MAR,5703,2412,3291,2478,3178,47,ITI,ITI3,11,Marche,Marche,1525271,1109700,72.75,0.37
146,2021-01-24,MAR,881,339,542,3,878,0,ITI,ITI3,11,Marche,Marche,1525271,1110581,72.81,0.06
147,2021-06-30,MAR,13650,6663,6987,4453,8986,211,ITI,ITI3,11,Marche,Marche,1525271,1124231,73.71,0.89
148,2021-05-04,MAR,10975,4841,6134,4927,5905,143,ITI,ITI3,11,Marche,Marche,1525271,1135206,74.43,0.72
149,2021-02-15,MAR,967,412,555,939,13,15,ITI,ITI3,11,Marche,Marche,1525271,1136173,74.49,0.06
150,2021-05-26,MAR,11889,5952,5937,8448,3227,214,ITI,ITI3,11,Marche,Marche,1525271,1148062,75.27,0.78
151,2021-03-30,MAR,7486,3079,4407,4576,2834,76,ITI,ITI3,11,Marche,Marche,1525271,1155548,75.76,0.49
152,2021-02-01,MAR,1363,479,884,93,1267,3,ITI,ITI3,11,Marche,Marche,1525271,1156911,75.85,0.09
153,2021-04-06,MAR,8877,3693,5184,7930,810,137,ITI,ITI3,11,Marche,Marche,1525271,1165788,76.43,0.58
154,2021-03-23,MAR,5839,2557,3282,2225,3576,38,ITI,ITI3,11,Marche,Marche,1525271,1171627,76.81,0.38
155,2021-02-08,MAR,834,259,575,366,463,5,ITI,ITI3,11,Marche,Marche,1525271,1172461,76.87,0.05
156,2021-07-15,MAR,16009,8286,7723,1750,14031,228,ITI,ITI3,11,Marche,Marche,1525271,1188470,77.92,1.05
157,2021-05-19,MAR,11665,5364,6301,8367,3101,197,ITI,ITI3,11,Marche,Marche,1525271,1200135,78.68,0.76
158,2021-07-03,MAR,13843,6991,6852,4136,9395,312,ITI,ITI3,11,Marche,Marche,1525271,1213978,79.59,0.91
159,2021-02-20,MAR,4163,1732,2431,4042,111,10,ITI,ITI3,11,Marche,Marche,1525271,1218141,79.86,0.27
160,2021-08-22,MAR,109,60,49,75,26,8,ITI,ITI3,11,Marche,Marche,1525271,1218250,79.87,0.01
161,2021-01-20,MAR,406,100,306,384,20,2,ITI,ITI3,11,Marche,Marche,1525271,1218656,79.9,0.03
162,2021-02-03,MAR,2129,743,1386,97,2011,21,ITI,ITI3,11,Marche,Marche,1525271,1220785,80.04,0.14
163,2021-08-14,MAR,2400,1378,1022,1033,1318,49,ITI,ITI3,11,Marche,Marche,1525271,1223185,80.19,0.16
164,2021-02-10,MAR,1441,452,989,1040,359,42,ITI,ITI3,11,Marche,Marche,1525271,1224626,80.29,0.09
165,2021-06-11,MAR,14003,7156,6847,11374,2324,305,ITI,ITI3,11,Marche,Marche,1525271,1238629,81.21,0.92
166,2021-05-25,MAR,11769,5798,5971,8497,3052,220,ITI,ITI3,11,Marche,Marche,1525271,1250398,81.98,0.77
167,2021-09-02,MAR,6395,3404,2991,2135,4046,214,ITI,ITI3,11,Marche,Marche,1525271,1256793,82.4,0.42
168,2021-03-01,MAR,3772,1520,2252,3503,248,21,ITI,ITI3,11,Marche,Marche,1525271,1260565,82.65,0.25
169,2021-06-21,MAR,12608,6184,6424,5480,6881,247,ITI,ITI3,11,Marche,Marche,1525271,1273173,83.47,0.83
170,2021-05-09,MAR,8867,4022,4845,3560,5229,78,ITI,ITI3,11,Marche,Marche,1525271,1282040,84.05,0.58
171,2021-04-17,MAR,11710,5319,6391,10397,1073,240,ITI,ITI3,11,Marche,Marche,1525271,1293750,84.82,0.77
172,2021-07-26,MAR,11029,5736,5293,2109,8715,205,ITI,ITI3,11,Marche,Marche,1525271,1304779,85.54,0.72
173,2021-08-09,MAR,9094,4828,4266,4051,4770,273,ITI,ITI3,11,Marche,Marche,1525271,1313873,86.14,0.6
174,2021-06-13,MAR,10753,5567,5186,9204,1299,250,ITI,ITI3,11,Marche,Marche,1525271,1324626,86.85,0.7
175,2020-12-27,MAR,209,100,109,207,0,2,ITI,ITI3,11,Marche,Marche,1525271,1324835,86.86,0.01
176,2021-08-02,MAR,11724,6208,5516,4599,6867,258,ITI,ITI3,11,Marche,Marche,1525271,1336559,87.63,0.77
177,2021-06-06,MAR,12452,6137,6315,10639,1578,235,ITI,ITI3,11,Marche,Marche,1525271,1349011,88.44,0.82
178,2021-03-06,MAR,5739,2642,3097,4419,1268,52,ITI,ITI3,11,Marche,Marche,1525271,1354750,88.82,0.38
179,2021-06-14,MAR,12840,6487,6353,9258,3310,272,ITI,ITI3,11,Marche,Marche,1525271,1367590,89.66,0.84
180,2021-08-28,MAR,3146,1696,1450,1202,1800,144,ITI,ITI3,11,Marche,Marche,1525271,1370736,89.87,0.21
181,2021-03-20,MAR,4178,1759,2419,1035,3129,14,ITI,ITI3,11,Marche,Marche,1525271,1374914,90.14,0.27
182,2021-01-22,MAR,489,168,321,193,294,2,ITI,ITI3,11,Marche,Marche,1525271,1375403,90.17,0.03
183,2021-07-07,MAR,14259,7070,7189,2937,11080,242,ITI,ITI3,11,Marche,Marche,1525271,1389662,91.11,0.93
184,2021-01-29,MAR,1994,731,1263,155,1834,5,ITI,ITI3,11,Marche,Marche,1525271,1391656,91.24,0.13
185,2021-05-18,MAR,11275,5349,5926,7492,3604,179,ITI,ITI3,11,Marche,Marche,1525271,1402931,91.98,0.74
186,2021-08-26,MAR,5680,3027,2653,2775,2545,360,ITI,ITI3,11,Marche,Marche,1525271,1408611,92.35,0.37
187,2021-08-21,MAR,2977,1663,1314,1492,1311,174,ITI,ITI3,11,Marche,Marche,1525271,1411588,92.55,0.2
188,2021-05-11,MAR,10625,4832,5793,5490,4943,192,ITI,ITI3,11,Marche,Marche,1525271,1422213,93.24,0.7
189,2021-03-15,MAR,4452,2061,2391,1291,3140,21,ITI,ITI3,11,Marche,Marche,1525271,1426665,93.54,0.29
190,2021-08-19,MAR,6273,3346,2927,3491,2453,329,ITI,ITI3,11,Marche,Marche,1525271,1432938,93.95,0.41
191,2021-06-23,MAR,13892,6818,7074,6626,7010,256,ITI,ITI3,11,Marche,Marche,1525271,1446830,94.86,0.91
192,2021-05-14,MAR,13638,6294,7344,6507,6915,216,ITI,ITI3,11,Marche,Marche,1525271,1460468,95.75,0.89
193,2021-07-02,MAR,14552,7177,7375,4674,9647,231,ITI,ITI3,11,Marche,Marche,1525271,1475020,96.71,0.95
194,2021-06-18,MAR,15346,7647,7699,8293,6753,300,ITI,ITI3,11,Marche,Marche,1525271,1490366,97.71,1.01
195,2021-04-20,MAR,10756,5030,5726,9148,1472,136,ITI,ITI3,11,Marche,Marche,1525271,1501122,98.42,0.71
196,2021-07-29,MAR,14848,7880,6968,4582,9955,311,ITI,ITI3,11,Marche,Marche,1525271,1515970,99.39,0.97
197,2021-01-25,MAR,1597,559,1038,90,1507,0,ITI,ITI3,11,Marche,Marche,1525271,1517567,99.49,0.1
198,2021-01-08,MAR,1583,592,991,1568,0,15,ITI,ITI3,11,Marche,Marche,1525271,1519150,99.6,0.1
199,2021-04-18,MAR,8824,4132,4692,7728,921,175,ITI,ITI3,11,Marche,Marche,1525271,1527974,100.18,0.58
200,2021-08-07,MAR,9452,5193,4259,3472,5742,238,ITI,ITI3,11,Marche,Marche,1525271,1537426,100.8,0.62
201,2021-07-21,MAR,14921,7617,7304,2065,12643,213,ITI,ITI3,11,Marche,Marche,1525271,1552347,101.78,0.98
202,2021-04-29,MAR,13453,6161,7292,7162,6108,183,ITI,ITI3,11,Marche,Marche,1525271,1565800,102.66,0.88
203,2021-07-17,MAR,15139,7792,7347,1384,13544,211,ITI,ITI3,11,Marche,Marche,1525271,1580939,103.65,0.99
204,2021-05-21,MAR,13909,6594,7315,7225,6472,212,ITI,ITI3,11,Marche,Marche,1525271,1594848,104.56,0.91
205,2021-08-29,MAR,453,255,198,245,182,26,ITI,ITI3,11,Marche,Marche,1525271,1595301,104.59,0.03
206,2021-05-28,MAR,13963,6741,7222,8801,4864,298,ITI,ITI3,11,Marche,Marche,1525271,1609264,105.51,0.92
207,2021-04-01,MAR,7579,3186,4393,4065,3418,96,ITI,ITI3,11,Marche,Marche,1525271,1616843,106.0,0.5
208,2021-07-24,MAR,13276,7117,6159,2944,10074,258,ITI,ITI3,11,Marche,Marche,1525271,1630119,106.87,0.87
209,2021-07-10,MAR,14161,7234,6927,1657,12301,203,ITI,ITI3,11,Marche,Marche,1525271,1644280,107.8,0.93
210,2021-04-22,MAR,10798,4931,5867,9078,1579,141,ITI,ITI3,11,Marche,Marche,1525271,1655078,108.51,0.71
211,2021-02-24,MAR,3534,1547,1987,3424,78,32,ITI,ITI3,11,Marche,Marche,1525271,1658612,108.74,0.23
212,2021-06-04,MAR,14338,7290,7048,11588,2440,310,ITI,ITI3,11,Marche,Marche,1525271,1672950,109.68,0.94
213,2021-04-08,MAR,9490,4157,5333,8961,370,159,ITI,ITI3,11,Marche,Marche,1525271,1682440,110.3,0.62
214,2021-03-03,MAR,6701,3077,3624,5717,885,99,ITI,ITI3,11,Marche,Marche,1525271,1689141,110.74,0.44
215,2021-01-05,MAR,1586,593,993,1567,0,19,ITI,ITI3,11,Marche,Marche,1525271,1690727,110.85,0.1
216,2021-04-15,MAR,10379,4675,5704,9571,565,243,ITI,ITI3,11,Marche,Marche,1525271,1701106,111.53,0.68
217,2021-02-17,MAR,1828,701,1127,1642,118,68,ITI,ITI3,11,Marche,Marche,1525271,1702934,111.65,0.12
218,2021-07-31,MAR,13203,7250,5953,5142,7731,330,ITI,ITI3,11,Marche,Marche,1525271,1716137,112.51,0.87
219,2021-07-14,MAR,13851,6818,7033,1784,11875,192,ITI,ITI3,11,Marche,Marche,1525271,1729988,113.42,0.91
220,2021-01-10,MAR,1746,702,1044,1732,0,14,ITI,ITI3,11,Marche,Marche,1525271,1731734,113.54,0.11
221,2021-07-12,MAR,13724,6805,6919,1228,12378,118,ITI,ITI3,11,Marche,Marche,1525271,1745458,114.44,0.9
222,2021-04-03,MAR,7577,3204,4373,6736,667,174,ITI,ITI3,11,Marche,Marche,1525271,1753035,114.93,0.5
223,2021-06-25,MAR,14344,7171,7173,6418,7637,289,ITI,ITI3,11,Marche,Marche,1525271,1767379,115.87,0.94
224,2021-02-04,MAR,2389,844,1545,107,2277,5,ITI,ITI3,11,Marche,Marche,1525271,1769768,116.03,0.16
225,2021-01-18,MAR,696,237,459,536,149,11,ITI,ITI3,11,Marche,Marche,1525271,1770464,116.08,0.05
226,2021-04-28,MAR,10938,4983,5955,6020,4743,175,ITI,ITI3,11,Marche,Marche,1525271,1781402,116.79,0.72
227,2021-03-26,MAR,6392,2626,3766,3475,2859,58,ITI,ITI3,11,Marche,Marche,1525271,1787794,117.21,0.42
228,2021-06-17,MAR,15206,7566,7640,8798,6111,297,ITI,ITI3,11,Marche,Marche,1525271,1803000,118.21,1.0
229,2021-03-09,MAR,5430,2293,3137,4458,881,91,ITI,ITI3,11,Marche,Marche,1525271,1808430,118.56,0.36
230,2021-07-22,MAR,15746,8048,7698,2018,13487,241,ITI,ITI3,11,Marche,Marche,1525271,1824176,119.6,1.03
231,2021-04-13,MAR,9840,4262,5578,9399,234,207,ITI,ITI3,11,Marche,Marche,1525271,1834016,120.24,0.65
232,2021-07-05,MAR,13167,6510,6657,2920,10075,172,ITI,ITI3,11,Marche,Marche,1525271,1847183,121.11,0.86
233,2021-06-16,MAR,13755,6912,6843,9126,4365,264,ITI,ITI3,11,Marche,Marche,1525271,1860938,122.01,0.9
234,2021-06-02,MAR,11902,5939,5963,11028,678,196,ITI,ITI3,11,Marche,Marche,1525271,1872840,122.79,0.78
235,2021-02-22,MAR,3461,1532,1929,3351,75,35,ITI,ITI3,11,Marche,Marche,1525271,1876301,123.01,0.23
236,2021-08-24,MAR,6443,3402,3041,3299,2762,382,ITI,ITI3,11,Marche,Marche,1525271,1882744,123.44,0.42
237,2021-08-05,MAR,11908,6393,5515,4082,7560,266,ITI,ITI3,11,Marche,Marche,1525271,1894652,124.22,0.78
238,2021-03-27,MAR,7430,3099,4331,4958,2397,75,ITI,ITI3,11,Marche,Marche,1525271,1902082,124.7,0.49
239,2021-04-10,MAR,10932,4626,6306,10371,314,247,ITI,ITI3,11,Marche,Marche,1525271,1913014,125.42,0.72
240,2021-01-03,MAR,912,358,554,902,0,10,ITI,ITI3,11,Marche,Marche,1525271,1913926,125.48,0.06
241,2021-07-19,MAR,14679,7532,7147,1926,12538,215,ITI,ITI3,11,Marche,Marche,1525271,1928605,126.44,0.96
242,2021-03-08,MAR,6300,2761,3539,5188,1002,110,ITI,ITI3,11,Marche,Marche,1525271,1934905,126.86,0.41
243,2021-02-05,MAR,2158,655,1503,438,1719,1,ITI,ITI3,11,Marche,Marche,1525271,1937063,127.0,0.14
244,2021-05-16,MAR,10900,4958,5942,6547,4231,122,ITI,ITI3,11,Marche,Marche,1525271,1947963,127.71,0.71
245,2021-05-30,MAR,9736,4691,5045,6546,2993,197,ITI,ITI3,11,Marche,Marche,1525271,1957699,128.35,0.64
246,2021-04-27,MAR,9594,4390,5204,5506,3990,98,ITI,ITI3,11,Marche,Marche,1525271,1967293,128.98,0.63
247,2021-01-17,MAR,1625,695,930,1555,64,6,ITI,ITI3,11,Marche,Marche,1525271,1968918,129.09,0.11
248,2021-03-09,CAL,6581,3436,3145,5521,989,71,ITF,ITF6,18,Calabria,Calabria,1947131,6581,0.34,0.34
249,2021-02-20,CAL,1506,788,718,1164,328,14,ITF,ITF6,18,Calabria,Calabria,1947131,8087,0.42,0.08
250,2021-08-22,CAL,1522,769,753,484,1019,19,ITF,ITF6,18,Calabria,Calabria,1947131,9609,0.49,0.08
251,2021-05-31,CAL,15301,7348,7953,7312,7908,81,ITF,ITF6,18,Calabria,Calabria,1947131,24910,1.28,0.79
252,2021-07-01,CAL,12397,5837,6560,5475,6838,84,ITF,ITF6,18,Calabria,Calabria,1947131,37307,1.92,0.64
253,2021-02-01,CAL,2558,1213,1345,237,2318,3,ITF,ITF6,18,Calabria,Calabria,1947131,39865,2.05,0.13
254,2021-07-08,CAL,12054,5619,6435,2697,9311,46,ITF,ITF6,18,Calabria,Calabria,1947131,51919,2.67,0.62
255,2021-08-10,CAL,9782,4915,4867,3595,6086,101,ITF,ITF6,18,Calabria,Calabria,1947131,61701,3.17,0.5
256,2021-06-14,CAL,14359,6511,7848,9628,4654,77,ITF,ITF6,18,Calabria,Calabria,1947131,76060,3.91,0.74
257,2021-03-04,CAL,5493,3197,2296,4673,800,20,ITF,ITF6,18,Calabria,Calabria,1947131,81553,4.19,0.28
258,2021-06-12,CAL,13247,6298,6949,10781,2398,68,ITF,ITF6,18,Calabria,Calabria,1947131,94800,4.87,0.68
259,2021-08-08,CAL,4218,2146,2072,1492,2698,28,ITF,ITF6,18,Calabria,Calabria,1947131,99018,5.09,0.22
260,2021-07-22,CAL,18334,9029,9305,3493,14750,91,ITF,ITF6,18,Calabria,Calabria,1947131,117352,6.03,0.94
261,2021-04-30,CAL,15110,7412,7698,10533,4499,78,ITF,ITF6,18,Calabria,Calabria,1947131,132462,6.8,0.78
262,2021-01-11,CAL,2190,1060,1130,2188,0,2,ITF,ITF6,18,Calabria,Calabria,1947131,134652,6.92,0.11
263,2021-01-25,CAL,1089,522,567,150,939,0,ITF,ITF6,18,Calabria,Calabria,1947131,135741,6.97,0.06
264,2021-05-05,CAL,13608,6508,7100,8406,5124,78,ITF,ITF6,18,Calabria,Calabria,1947131,149349,7.67,0.7
265,2021-08-17,CAL,7678,3911,3767,2757,4826,95,ITF,ITF6,18,Calabria,Calabria,1947131,157027,8.06,0.39
266,2021-04-18,CAL,5878,2808,3070,4936,917,25,ITF,ITF6,18,Calabria,Calabria,1947131,162905,8.37,0.3
267,2021-04-04,CAL,1574,789,785,1141,422,11,ITF,ITF6,18,Calabria,Calabria,1947131,164479,8.45,0.08
268,2021-06-26,CAL,15580,7201,8379,7575,7934,71,ITF,ITF6,18,Calabria,Calabria,1947131,180059,9.25,0.8
269,2021-07-27,CAL,17587,8993,8594,5024,12477,86,ITF,ITF6,18,Calabria,Calabria,1947131,197646,10.15,0.9
270,2021-01-06,CAL,955,519,436,955,0,0,ITF,ITF6,18,Calabria,Calabria,1947131,198601,10.2,0.05
271,2021-04-16,CAL,10342,5050,5292,8643,1641,58,ITF,ITF6,18,Calabria,Calabria,1947131,208943,10.73,0.53
272,2021-02-18,CAL,1885,874,1011,1633,233,19,ITF,ITF6,18,Calabria,Calabria,1947131,210828,10.83,0.1
273,2021-08-03,CAL,14096,7124,6972,3910,10112,74,ITF,ITF6,18,Calabria,Calabria,1947131,224924,11.55,0.72
274,2021-02-06,CAL,2934,1351,1583,440,2493,1,ITF,ITF6,18,Calabria,Calabria,1947131,227858,11.7,0.15
275,2021-07-10,CAL,15946,7539,8407,3248,12654,44,ITF,ITF6,18,Calabria,Calabria,1947131,243804,12.52,0.82
276,2021-01-23,CAL,403,188,215,360,43,0,ITF,ITF6,18,Calabria,Calabria,1947131,244207,12.54,0.02
277,2021-05-12,CAL,16494,8048,8446,10830,5567,97,ITF,ITF6,18,Calabria,Calabria,1947131,260701,13.39,0.85
278,2021-05-26,CAL,18743,9336,9407,10330,8321,92,ITF,ITF6,18,Calabria,Calabria,1947131,279444,14.35,0.96
279,2021-03-30,CAL,6514,2844,3670,3653,2837,24,ITF,ITF6,18,Calabria,Calabria,1947131,285958,14.69,0.33
280,2021-09-03,CAL,5857,2943,2914,2264,3459,134,ITF,ITF6,18,Calabria,Calabria,1947131,291815,14.99,0.3
281,2021-05-19,CAL,18326,9082,9244,11259,6991,76,ITF,ITF6,18,Calabria,Calabria,1947131,310141,15.93,0.94
282,2021-03-11,CAL,7312,3479,3833,5952,1308,52,ITF,ITF6,18,Calabria,Calabria,1947131,317453,16.3,0.38
283,2021-06-19,CAL,15852,7418,8434,8498,7286,68,ITF,ITF6,18,Calabria,Calabria,1947131,333305,17.12,0.81
284,2021-06-07,CAL,18007,8424,9583,14712,3214,81,ITF,ITF6,18,Calabria,Calabria,1947131,351312,18.04,0.92
285,2021-05-24,CAL,17788,8912,8876,9938,7768,82,ITF,ITF6,18,Calabria,Calabria,1947131,369100,18.96,0.91
286,2021-05-07,CAL,16284,7668,8616,9660,6533,91,ITF,ITF6,18,Calabria,Calabria,1947131,385384,19.79,0.84
287,2021-02-13,CAL,1418,612,806,1045,370,3,ITF,ITF6,18,Calabria,Calabria,1947131,386802,19.87,0.07
288,2021-08-15,CAL,51,24,27,17,33,1,ITF,ITF6,18,Calabria,Calabria,1947131,386853,19.87,0.0
289,2021-01-18,CAL,1308,594,714,1055,249,4,ITF,ITF6,18,Calabria,Calabria,1947131,388161,19.94,0.07
290,2021-07-03,CAL,15182,7148,8034,5284,9820,78,ITF,ITF6,18,Calabria,Calabria,1947131,403343,20.71,0.78
291,2021-04-11,CAL,4211,1913,2298,2243,1951,17,ITF,ITF6,18,Calabria,Calabria,1947131,407554,20.93,0.22
292,2021-07-20,CAL,17497,8485,9012,3201,14223,73,ITF,ITF6,18,Calabria,Calabria,1947131,425051,21.83,0.9
293,2021-02-25,CAL,2927,1576,1351,2284,603,40,ITF,ITF6,18,Calabria,Calabria,1947131,427978,21.98,0.15
294,2021-03-02,CAL,4424,2502,1922,3619,796,9,ITF,ITF6,18,Calabria,Calabria,1947131,432402,22.21,0.23
295,2021-03-16,CAL,3872,1900,1972,2183,1676,13,ITF,ITF6,18,Calabria,Calabria,1947131,436274,22.41,0.2
296,2021-07-29,CAL,17602,8777,8825,4725,12776,101,ITF,ITF6,18,Calabria,Calabria,1947131,453876,23.31,0.9
297,2021-02-11,CAL,2353,1053,1300,1064,1267,22,ITF,ITF6,18,Calabria,Calabria,1947131,456229,23.43,0.12
298,2021-06-21,CAL,15416,7101,8315,7996,7381,39,ITF,ITF6,18,Calabria,Calabria,1947131,471645,24.22,0.79
299,2021-01-04,CAL,1076,533,543,1073,0,3,ITF,ITF6,18,Calabria,Calabria,1947131,472721,24.28,0.06
300,2021-04-23,CAL,13151,6458,6693,9439,3613,99,ITF,ITF6,18,Calabria,Calabria,1947131,485872,24.95,0.68
301,2021-01-13,CAL,2110,1067,1043,2098,0,12,ITF,ITF6,18,Calabria,Calabria,1947131,487982,25.06,0.11
302,2021-03-28,CAL,2698,1236,1462,1566,1127,5,ITF,ITF6,18,Calabria,Calabria,1947131,490680,25.2,0.14
303,2021-08-29,CAL,1684,887,797,721,933,30,ITF,ITF6,18,Calabria,Calabria,1947131,492364,25.29,0.09
304,2021-01-30,CAL,2211,1170,1041,298,1910,3,ITF,ITF6,18,Calabria,Calabria,1947131,494575,25.4,0.11
305,2021-02-17,CAL,1879,833,1046,1649,213,17,ITF,ITF6,18,Calabria,Calabria,1947131,496454,25.5,0.1
306,2021-07-24,CAL,18184,9345,8839,4684,13399,101,ITF,ITF6,18,Calabria,Calabria,1947131,514638,26.43,0.93
307,2021-05-28,CAL,21018,10215,10803,11424,9481,113,ITF,ITF6,18,Calabria,Calabria,1947131,535656,27.51,1.08
308,2021-03-23,CAL,5267,2468,2799,3421,1823,23,ITF,ITF6,18,Calabria,Calabria,1947131,540923,27.78,0.27
309,2021-08-27,CAL,9157,4764,4393,3608,5389,160,ITF,ITF6,18,Calabria,Calabria,1947131,550080,28.25,0.47
310,2021-07-15,CAL,18282,8809,9473,2522,15708,52,ITF,ITF6,18,Calabria,Calabria,1947131,568362,29.19,0.94
311,2021-02-15,CAL,1181,566,615,1011,165,5,ITF,ITF6,18,Calabria,Calabria,1947131,569543,29.25,0.06
312,2021-05-14,CAL,19944,9582,10362,12944,6885,115,ITF,ITF6,18,Calabria,Calabria,1947131,589487,30.27,1.02
313,2021-04-27,CAL,9981,4908,5073,7963,1969,49,ITF,ITF6,18,Calabria,Calabria,1947131,599468,30.79,0.51
314,2021-02-03,CAL,2872,1481,1391,517,2350,5,ITF,ITF6,18,Calabria,Calabria,1947131,602340,30.93,0.15
315,2021-07-19,CAL,19015,9106,9909,3033,15932,50,ITF,ITF6,18,Calabria,Calabria,1947131,621355,31.91,0.98
316,2021-08-05,CAL,12471,6290,6181,3880,8495,96,ITF,ITF6,18,Calabria,Calabria,1947131,633826,32.55,0.64
317,2021-06-11,CAL,17831,8759,9072,15128,2579,124,ITF,ITF6,18,Calabria,Calabria,1947131,651657,33.47,0.92
318,2021-01-08,CAL,2201,1049,1152,2194,0,7,ITF,ITF6,18,Calabria,Calabria,1947131,653858,33.58,0.11
319,2021-03-18,CAL,4500,2105,2395,2342,2132,26,ITF,ITF6,18,Calabria,Calabria,1947131,658358,33.81,0.23
320,2021-04-13,CAL,6968,3425,3543,5609,1333,26,ITF,ITF6,18,Calabria,Calabria,1947131,665326,34.17,0.36
321,2021-01-20,CAL,1410,630,780,1406,1,3,ITF,ITF6,18,Calabria,Calabria,1947131,666736,34.24,0.07
322,2021-01-03,CAL,6,3,3,6,0,0,ITF,ITF6,18,Calabria,Calabria,1947131,666742,34.24,0.0
323,2021-03-27,CAL,8847,4027,4820,4664,4138,45,ITF,ITF6,18,Calabria,Calabria,1947131,675589,34.7,0.45
324,2021-07-05,CAL,13383,6251,7132,4263,9056,64,ITF,ITF6,18,Calabria,Calabria,1947131,688972,35.38,0.69
325,2021-03-06,CAL,8543,4401,4142,7702,816,25,ITF,ITF6,18,Calabria,Calabria,1947131,697515,35.82,0.44
326,2021-08-19,CAL,5872,2944,2928,2348,3467,57,ITF,ITF6,18,Calabria,Calabria,1947131,703387,36.12,0.3
327,2021-05-09,CAL,9689,4527,5162,6043,3598,48,ITF,ITF6,18,Calabria,Calabria,1947131,713076,36.62,0.5
328,2021-01-29,CAL,2079,1004,1075,226,1852,1,ITF,ITF6,18,Calabria,Calabria,1947131,715155,36.73,0.11
329,2021-06-23,CAL,17233,7870,9363,8146,9004,83,ITF,ITF6,18,Calabria,Calabria,1947131,732388,37.61,0.89
330,2021-03-13,CAL,7023,3044,3979,5943,1043,37,ITF,ITF6,18,Calabria,Calabria,1947131,739411,37.97,0.36
331,2021-01-15,CAL,2819,1267,1552,2813,0,6,ITF,ITF6,18,Calabria,Calabria,1947131,742230,38.12,0.14
332,2021-04-25,CAL,15898,8068,7830,14800,1030,68,ITF,ITF6,18,Calabria,Calabria,1947131,758128,38.94,0.82
333,2021-08-26,CAL,7209,3603,3606,3182,3906,121,ITF,ITF6,18,Calabria,Calabria,1947131,765337,39.31,0.37
334,2021-06-30,CAL,16392,7507,8885,7020,9270,102,ITF,ITF6,18,Calabria,Calabria,1947131,781729,40.15,0.84
335,2021-06-28,CAL,13305,6126,7179,5375,7863,67,ITF,ITF6,18,Calabria,Calabria,1947131,795034,40.83,0.68
336,2021-03-20,CAL,6775,3105,3670,4182,2576,17,ITF,ITF6,18,Calabria,Calabria,1947131,801809,41.18,0.35
337,2021-02-27,CAL,4059,2093,1966,3665,387,7,ITF,ITF6,18,Calabria,Calabria,1947131,805868,41.39,0.21
338,2021-07-31,CAL,13811,7062,6749,3641,10098,72,ITF,ITF6,18,Calabria,Calabria,1947131,819679,42.1,0.71
339,2021-01-27,CAL,1491,757,734,384,1106,1,ITF,ITF6,18,Calabria,Calabria,1947131,821170,42.17,0.08
340,2021-04-15,CAL,7792,3817,3975,5991,1754,47,ITF,ITF6,18,Calabria,Calabria,1947131,828962,42.57,0.4
341,2021-04-01,CAL,8695,3960,4735,4154,4503,38,ITF,ITF6,18,Calabria,Calabria,1947131,837657,43.02,0.45
342,2021-04-08,CAL,9360,4434,4926,5825,3486,49,ITF,ITF6,18,Calabria,Calabria,1947131,847017,43.5,0.48
343,2021-02-10,CAL,2526,1086,1440,876,1635,15,ITF,ITF6,18,Calabria,Calabria,1947131,849543,43.63,0.13
344,2021-07-17,CAL,18338,9046,9292,2710,15560,68,ITF,ITF6,18,Calabria,Calabria,1947131,867881,44.57,0.94
345,2021-03-15,CAL,3657,1768,1889,2165,1479,13,ITF,ITF6,18,Calabria,Calabria,1947131,871538,44.76,0.19
346,2021-08-28,CAL,5306,2779,2527,1897,3316,93,ITF,ITF6,18,Calabria,Calabria,1947131,876844,45.03,0.27
347,2021-07-02,CAL,16276,7534,8742,6242,9950,84,ITF,ITF6,18,Calabria,Calabria,1947131,893120,45.87,0.84
348,2021-05-20,CAL,17002,8509,8493,11274,5659,69,ITF,ITF6,18,Calabria,Calabria,1947131,910122,46.74,0.87
349,2021-03-08,CAL,5523,2991,2532,4406,1084,33,ITF,ITF6,18,Calabria,Calabria,1947131,915645,47.03,0.28
350,2021-03-25,CAL,7550,3566,3984,4585,2930,35,ITF,ITF6,18,Calabria,Calabria,1947131,923195,47.41,0.39
351,2021-06-16,CAL,18340,8475,9865,12124,6125,91,ITF,ITF6,18,Calabria,Calabria,1947131,941535,48.35,0.94
352,2021-02-22,CAL,2099,1071,1028,1529,561,9,ITF,ITF6,18,Calabria,Calabria,1947131,943634,48.46,0.11
353,2021-06-02,CAL,12101,5799,6302,8789,3265,47,ITF,ITF6,18,Calabria,Calabria,1947131,955735,49.08,0.62
354,2021-08-07,CAL,9528,4873,4655,3019,6445,64,ITF,ITF6,18,Calabria,Calabria,1947131,965263,49.57,0.49
355,2021-05-16,CAL,13816,6741,7075,9919,3842,55,ITF,ITF6,18,Calabria,Calabria,1947131,979079,50.28,0.71
356,2021-08-24,CAL,6506,3228,3278,2322,4099,85,ITF,ITF6,18,Calabria,Calabria,1947131,985585,50.62,0.33
357,2021-07-21,CAL,22109,10616,11493,4515,17480,114,ITF,ITF6,18,Calabria,Calabria,1947131,1007694,51.75,1.14
358,2021-01-17,CAL,913,441,472,807,100,6,ITF,ITF6,18,Calabria,Calabria,1947131,1008607,51.8,0.05
359,2021-03-24,CAL,7968,3645,4323,4549,3394,25,ITF,ITF6,18,Calabria,Calabria,1947131,1016575,52.21,0.41
360,2021-04-10,CAL,11732,5310,6422,6822,4864,46,ITF,ITF6,18,Calabria,Calabria,1947131,1028307,52.81,0.6
361,2020-12-27,CAL,317,169,148,317,0,0,ITF,ITF6,18,Calabria,Calabria,1947131,1028624,52.83,0.02
362,2021-04-06,CAL,8178,3728,4450,4462,3680,36,ITF,ITF6,18,Calabria,Calabria,1947131,1036802,53.25,0.42
363,2021-02-08,CAL,1880,748,1132,667,1210,3,ITF,ITF6,18,Calabria,Calabria,1947131,1038682,53.34,0.1
364,2021-05-04,CAL,16525,7623,8902,11629,4794,102,ITF,ITF6,18,Calabria,Calabria,1947131,1055207,54.19,0.85
365,2021-08-12,CAL,7640,3878,3762,2799,4665,176,ITF,ITF6,18,Calabria,Calabria,1947131,1062847,54.59,0.39
366,2021-01-22,CAL,661,276,385,659,2,0,ITF,ITF6,18,Calabria,Calabria,1947131,1063508,54.62,0.03
367,2021-05-02,CAL,12559,5862,6697,10587,1908,64,ITF,ITF6,18,Calabria,Calabria,1947131,1076067,55.26,0.65
368,2021-03-29,CAL,5782,2500,3282,3978,1775,29,ITF,ITF6,18,Calabria,Calabria,1947131,1081849,55.56,0.3
369,2021-01-31,CAL,1130,562,568,148,982,0,ITF,ITF6,18,Calabria,Calabria,1947131,1082979,55.62,0.06
370,2021-07-07,CAL,13970,6582,7388,3900,9994,76,ITF,ITF6,18,Calabria,Calabria,1947131,1096949,56.34,0.72
371,2021-06-04,CAL,17547,8159,9388,12956,4522,69,ITF,ITF6,18,Calabria,Calabria,1947131,1114496,57.24,0.9
372,2021-05-21,CAL,21371,10884,10487,13858,7402,111,ITF,ITF6,18,Calabria,Calabria,1947131,1135867,58.34,1.1
373,2021-01-05,CAL,1551,731,820,1549,0,2,ITF,ITF6,18,Calabria,Calabria,1947131,1137418,58.42,0.08
374,2021-02-05,CAL,3865,1746,2119,473,3377,15,ITF,ITF6,18,Calabria,Calabria,1947131,1141283,58.61,0.2
375,2021-04-29,CAL,12511,6086,6425,8652,3801,58,ITF,ITF6,18,Calabria,Calabria,1947131,1153794,59.26,0.64
376,2021-04-12,CAL,7041,3427,3614,5351,1661,29,ITF,ITF6,18,Calabria,Calabria,1947131,1160835,59.62,0.36
377,2021-01-19,CAL,1132,499,633,1117,13,2,ITF,ITF6,18,Calabria,Calabria,1947131,1161967,59.68,0.06
378,2021-07-04,CAL,5955,2821,3134,1992,3927,36,ITF,ITF6,18,Calabria,Calabria,1947131,1167922,59.98,0.31
379,2021-06-17,CAL,15820,7227,8593,9596,6170,54,ITF,ITF6,18,Calabria,Calabria,1947131,1183742,60.79,0.81
380,2021-03-26,CAL,8116,3853,4263,4945,3138,33,ITF,ITF6,18,Calabria,Calabria,1947131,1191858,61.21,0.42
381,2021-09-02,CAL,7552,3925,3627,3171,4259,122,ITF,ITF6,18,Calabria,Calabria,1947131,1199410,61.6,0.39
382,2021-02-14,CAL,491,229,262,453,37,1,ITF,ITF6,18,Calabria,Calabria,1947131,1199901,61.62,0.03
383,2021-05-25,CAL,16425,8045,8380,10215,6123,87,ITF,ITF6,18,Calabria,Calabria,1947131,1216326,62.47,0.84
384,2021-01-26,CAL,1894,909,985,269,1624,1,ITF,ITF6,18,Calabria,Calabria,1947131,1218220,62.56,0.1
385,2021-07-28,CAL,21379,10733,10646,5896,15370,113,ITF,ITF6,18,Calabria,Calabria,1947131,1239599,63.66,1.1
386,2021-04-22,CAL,9831,4915,4916,6846,2931,54,ITF,ITF6,18,Calabria,Calabria,1947131,1249430,64.17,0.5
387,2021-05-06,CAL,13352,6320,7032,8925,4354,73,ITF,ITF6,18,Calabria,Calabria,1947131,1262782,64.85,0.69
388,2021-06-18,CAL,18919,8808,10111,11286,7517,116,ITF,ITF6,18,Calabria,Calabria,1947131,1281701,65.83,0.97
389,2021-03-10,CAL,6889,3510,3379,5473,1378,38,ITF,ITF6,18,Calabria,Calabria,1947131,1288590,66.18,0.35
390,2021-08-23,CAL,7681,3814,3867,2794,4781,106,ITF,ITF6,18,Calabria,Calabria,1947131,1296271,66.57,0.39
391,2021-02-07,CAL,871,435,436,143,726,2,ITF,ITF6,18,Calabria,Calabria,1947131,1297142,66.62,0.04
392,2021-05-18,CAL,15344,7677,7667,11846,3428,70,ITF,ITF6,18,Calabria,Calabria,1947131,1312486,67.41,0.79
393,2021-03-22,CAL,4998,2350,2648,3181,1792,25,ITF,ITF6,18,Calabria,Calabria,1947131,1317484,67.66,0.26
394,2021-02-09,CAL,2175,921,1254,950,1215,10,ITF,ITF6,18,Calabria,Calabria,1947131,1319659,67.77,0.11
395,2021-05-29,CAL,19298,8962,10336,9351,9870,77,ITF,ITF6,18,Calabria,Calabria,1947131,1338957,68.77,0.99
396,2021-07-25,CAL,6948,3570,3378,1469,5447,32,ITF,ITF6,18,Calabria,Calabria,1947131,1345905,69.12,0.36
397,2021-04-24,CAL,19304,9608,9696,15760,3455,89,ITF,ITF6,18,Calabria,Calabria,1947131,1365209,70.11,0.99
398,2021-02-26,CAL,3153,1678,1475,2675,463,15,ITF,ITF6,18,Calabria,Calabria,1947131,1368362,70.28,0.16
399,2021-08-02,CAL,15077,7536,7541,3724,11297,56,ITF,ITF6,18,Calabria,Calabria,1947131,1383439,71.05,0.77
400,2021-06-20,CAL,6651,3150,3501,3815,2808,28,ITF,ITF6,18,Calabria,Calabria,1947131,1390090,71.39,0.34
401,2021-06-06,CAL,13807,6638,7169,12016,1720,71,ITF,ITF6,18,Calabria,Calabria,1947131,1403897,72.1,0.71
402,2021-01-07,CAL,2223,1091,1132,2219,0,4,ITF,ITF6,18,Calabria,Calabria,1947131,1406120,72.21,0.11
403,2021-06-13,CAL,6853,3362,3491,5731,1067,55,ITF,ITF6,18,Calabria,Calabria,1947131,1412973,72.57,0.35
404,2021-04-17,CAL,10858,5076,5782,9022,1785,51,ITF,ITF6,18,Calabria,Calabria,1947131,1423831,73.12,0.56
405,2021-05-01,CAL,16749,7982,8767,12402,4256,91,ITF,ITF6,18,Calabria,Calabria,1947131,1440580,73.98,0.86
406,2021-03-05,CAL,6246,3626,2620,5651,579,16,ITF,ITF6,18,Calabria,Calabria,1947131,1446826,74.31,0.32
407,2021-08-09,CAL,13169,6710,6459,4639,8368,162,ITF,ITF6,18,Calabria,Calabria,1947131,1459995,74.98,0.68
408,2021-07-26,CAL,18792,9334,9458,5216,13487,89,ITF,ITF6,18,Calabria,Calabria,1947131,1478787,75.95,0.97
409,2021-08-14,CAL,2229,1193,1036,724,1489,16,ITF,ITF6,18,Calabria,Calabria,1947131,1481016,76.06,0.11
410,2021-07-14,CAL,22644,10678,11966,4159,18408,77,ITF,ITF6,18,Calabria,Calabria,1947131,1503660,77.22,1.16
411,2021-04-05,CAL,3643,1728,1915,2672,959,12,ITF,ITF6,18,Calabria,Calabria,1947131,1507303,77.41,0.19
412,2021-06-08,CAL,16687,7901,8786,14519,2046,122,ITF,ITF6,18,Calabria,Calabria,1947131,1523990,78.27,0.86
413,2021-03-17,CAL,4191,1877,2314,2189,1992,10,ITF,ITF6,18,Calabria,Calabria,1947131,1528181,78.48,0.22
414,2021-07-06,CAL,12504,5755,6749,3839,8599,66,ITF,ITF6,18,Calabria,Calabria,1947131,1540685,79.13,0.64
415,2021-01-02,CAL,166,94,72,166,0,0,ITF,ITF6,18,Calabria,Calabria,1947131,1540851,79.13,0.01
416,2021-05-11,CAL,15139,7332,7807,10245,4822,72,ITF,ITF6,18,Calabria,Calabria,1947131,1555990,79.91,0.78
417,2021-07-16,CAL,21059,10035,11024,3378,17605,76,ITF,ITF6,18,Calabria,Calabria,1947131,1577049,80.99,1.08
418,2021-03-12,CAL,5161,2471,2690,4074,1064,23,ITF,ITF6,18,Calabria,Calabria,1947131,1582210,81.26,0.27
419,2021-01-14,CAL,2675,1272,1403,2669,0,6,ITF,ITF6,18,Calabria,Calabria,1947131,1584885,81.4,0.14
420,2021-01-21,CAL,983,460,523,946,34,3,ITF,ITF6,18,Calabria,Calabria,1947131,1585868,81.45,0.05
421,2021-08-20,CAL,7568,3823,3745,3019,4458,91,ITF,ITF6,18,Calabria,Calabria,1947131,1593436,81.84,0.39
422,2021-01-24,CAL,47,20,27,41,6,0,ITF,ITF6,18,Calabria,Calabria,1947131,1593483,81.84,0.0
423,2021-07-09,CAL,15678,7307,8371,3639,11968,71,ITF,ITF6,18,Calabria,Calabria,1947131,1609161,82.64,0.81
424,2021-08-21,CAL,3644,1859,1785,1438,2159,47,ITF,ITF6,18,Calabria,Calabria,1947131,1612805,82.83,0.19
425,2020-12-28,CAL,6,2,4,6,0,0,ITF,ITF6,18,Calabria,Calabria,1947131,1612811,82.83,0.0
426,2021-04-14,CAL,8090,3906,4184,6584,1457,49,ITF,ITF6,18,Calabria,Calabria,1947131,1620901,83.25,0.42
427,2021-02-16,CAL,1752,745,1007,1466,281,5,ITF,ITF6,18,Calabria,Calabria,1947131,1622653,83.34,0.09
428,2021-07-23,CAL,22747,11354,11393,5560,17085,102,ITF,ITF6,18,Calabria,Calabria,1947131,1645400,84.5,1.17
429,2021-05-27,CAL,17673,8740,8933,9773,7817,83,ITF,ITF6,18,Calabria,Calabria,1947131,1663073,85.41,0.91
430,2021-08-01,CAL,4895,2562,2333,1172,3699,24,ITF,ITF6,18,Calabria,Calabria,1947131,1667968,85.66,0.25
431,2021-06-03,CAL,14255,6654,7601,9587,4614,54,ITF,ITF6,18,Calabria,Calabria,1947131,1682223,86.39,0.73
432,2021-04-07,CAL,9182,4172,5010,5056,4070,56,ITF,ITF6,18,Calabria,Calabria,1947131,1691405,86.87,0.47
433,2021-02-23,CAL,1614,764,850,1490,119,5,ITF,ITF6,18,Calabria,Calabria,1947131,1693019,86.95,0.08
434,2021-03-31,CAL,9156,4176,4980,5061,4059,36,ITF,ITF6,18,Calabria,Calabria,1947131,1702175,87.42,0.47
435,2021-04-09,CAL,8033,3769,4264,5053,2895,85,ITF,ITF6,18,Calabria,Calabria,1947131,1710208,87.83,0.41
436,2021-07-18,CAL,8789,4205,4584,1280,7477,32,ITF,ITF6,18,Calabria,Calabria,1947131,1718997,88.28,0.45
437,2021-06-05,CAL,20791,9713,11078,17633,3079,79,ITF,ITF6,18,Calabria,Calabria,1947131,1739788,89.35,1.07
438,2021-06-25,CAL,18832,8745,10087,8067,10679,86,ITF,ITF6,18,Calabria,Calabria,1947131,1758620,90.32,0.97
439,2021-07-13,CAL,17438,8159,9279,2308,15061,69,ITF,ITF6,18,Calabria,Calabria,1947131,1776058,91.21,0.9
440,2021-04-19,CAL,7904,3818,4086,6170,1686,48,ITF,ITF6,18,Calabria,Calabria,1947131,1783962,91.62,0.41
441,2021-01-09,CAL,2096,1123,973,2088,0,8,ITF,ITF6,18,Calabria,Calabria,1947131,1786058,91.73,0.11
442,2021-06-01,CAL,12883,5976,6907,7885,4939,59,ITF,ITF6,18,Calabria,Calabria,1947131,1798941,92.39,0.66
443,2021-05-13,CAL,15980,7690,8290,11174,4728,78,ITF,ITF6,18,Calabria,Calabria,1947131,1814921,93.21,0.82
444,2021-02-19,CAL,1520,688,832,1247,264,9,ITF,ITF6,18,Calabria,Calabria,1947131,1816441,93.29,0.08
445,2021-05-30,CAL,11004,5303,5701,6815,4154,35,ITF,ITF6,18,Calabria,Calabria,1947131,1827445,93.85,0.57
446,2021-09-01,CAL,9149,4698,4451,3509,5495,145,ITF,ITF6,18,Calabria,Calabria,1947131,1836594,94.32,0.47
447,2021-02-28,CAL,2373,1082,1291,2215,155,3,ITF,ITF6,18,Calabria,Calabria,1947131,1838967,94.44,0.12
448,2021-01-12,CAL,2093,1035,1058,2084,0,9,ITF,ITF6,18,Calabria,Calabria,1947131,1841060,94.55,0.11
449,2021-02-24,CAL,1947,995,952,1462,479,6,ITF,ITF6,18,Calabria,Calabria,1947131,1843007,94.65,0.1
450,2021-03-03,CAL,5114,2791,2323,4010,1090,14,ITF,ITF6,18,Calabria,Calabria,1947131,1848121,94.92,0.26
451,2021-08-04,CAL,16015,8118,7897,4248,11666,101,ITF,ITF6,18,Calabria,Calabria,1947131,1864136,95.74,0.82
452,2021-06-29,CAL,13077,6040,7037,5354,7672,51,ITF,ITF6,18,Calabria,Calabria,1947131,1877213,96.41,0.67
453,2021-05-03,CAL,14852,6804,8048,10464,4295,93,ITF,ITF6,18,Calabria,Calabria,1947131,1892065,97.17,0.76
454,2021-03-21,CAL,4469,1930,2539,2730,1728,11,ITF,ITF6,18,Calabria,Calabria,1947131,1896534,97.4,0.23
455,2021-03-07,CAL,3410,1741,1669,3303,93,14,ITF,ITF6,18,Calabria,Calabria,1947131,1899944,97.58,0.18
456,2021-08-11,CAL,11058,5673,5385,3521,7422,115,ITF,ITF6,18,Calabria,Calabria,1947131,1911002,98.14,0.57
457,2021-06-15,CAL,15160,7051,8109,10238,4830,92,ITF,ITF6,18,Calabria,Calabria,1947131,1926162,98.92,0.78
458,2021-03-14,CAL,2771,1072,1699,2283,481,7,ITF,ITF6,18,Calabria,Calabria,1947131,1928933,99.07,0.14
459,2021-08-18,CAL,9455,4849,4606,3390,5965,100,ITF,ITF6,18,Calabria,Calabria,1947131,1938388,99.55,0.49
460,2021-06-22,CAL,14625,6918,7707,7380,7149,96,ITF,ITF6,18,Calabria,Calabria,1947131,1953013,100.3,0.75
461,2021-05-10,CAL,13172,6127,7045,7692,5417,63,ITF,ITF6,18,Calabria,Calabria,1947131,1966185,100.98,0.68
462,2021-04-26,CAL,10195,5062,5133,7714,2433,48,ITF,ITF6,18,Calabria,Calabria,1947131,1976380,101.5,0.52
463,2021-05-17,CAL,14913,7464,7449,10140,4719,54,ITF,ITF6,18,Calabria,Calabria,1947131,1991293,102.27,0.77
464,2021-08-25,CAL,8845,4329,4516,3327,5385,133,ITF,ITF6,18,Calabria,Calabria,1947131,2000138,102.72,0.45
465,2021-02-21,CAL,666,306,360,586,79,1,ITF,ITF6,18,Calabria,Calabria,1947131,2000804,102.76,0.03
466,2021-04-28,CAL,12576,6099,6477,9624,2880,72,ITF,ITF6,18,Calabria,Calabria,1947131,2013380,103.4,0.65
467,2021-02-04,CAL,3675,1748,1927,646,3023,6,ITF,ITF6,18,Calabria,Calabria,1947131,2017055,103.59,0.19
468,2021-05-15,CAL,27278,13055,14223,20267,6875,136,ITF,ITF6,18,Calabria,Calabria,1947131,2044333,104.99,1.4
469,2021-08-06,CAL,15623,7934,7689,5087,10404,132,ITF,ITF6,18,Calabria,Calabria,1947131,2059956,105.79,0.8
470,2021-02-02,CAL,2375,1170,1205,176,2199,0,ITF,ITF6,18,Calabria,Calabria,1947131,2062331,105.92,0.12
471,2021-01-16,CAL,2426,1139,1287,2423,0,3,ITF,ITF6,18,Calabria,Calabria,1947131,2064757,106.04,0.12
472,2021-05-23,CAL,11394,5555,5839,6997,4354,43,ITF,ITF6,18,Calabria,Calabria,1947131,2076151,106.63,0.59
473,2021-03-01,CAL,2755,1562,1193,2290,461,4,ITF,ITF6,18,Calabria,Calabria,1947131,2078906,106.77,0.14
474,2021-06-09,CAL,18262,8623,9639,15900,2276,86,ITF,ITF6,18,Calabria,Calabria,1947131,2097168,107.71,0.94
475,2021-08-31,CAL,6832,3379,3453,2672,4033,127,ITF,ITF6,18,Calabria,Calabria,1947131,2104000,108.06,0.35
476,2021-07-12,CAL,17980,8539,9441,2686,15245,49,ITF,ITF6,18,Calabria,Calabria,1947131,2121980,108.98,0.92
477,2021-01-10,CAL,956,538,418,956,0,0,ITF,ITF6,18,Calabria,Calabria,1947131,2122936,109.03,0.05
478,2021-04-20,CAL,7897,3989,3908,6073,1746,78,ITF,ITF6,18,Calabria,Calabria,1947131,2130833,109.43,0.41
479,2021-08-16,CAL,6975,3567,3408,2377,4536,62,ITF,ITF6,18,Calabria,Calabria,1947131,2137808,109.79,0.36
480,2021-02-12,CAL,1717,673,1044,943,768,6,ITF,ITF6,18,Calabria,Calabria,1947131,2139525,109.88,0.09
481,2021-06-27,CAL,8425,3947,4478,4988,3397,40,ITF,ITF6,18,Calabria,Calabria,1947131,2147950,110.31,0.43
482,2021-04-03,CAL,9453,4089,5364,4529,4861,63,ITF,ITF6,18,Calabria,Calabria,1947131,2157403,110.8,0.49
483,2021-01-28,CAL,2300,1144,1156,79,2221,0,ITF,ITF6,18,Calabria,Calabria,1947131,2159703,110.92,0.12
484,2021-08-13,CAL,7593,3918,3675,2443,5082,68,ITF,ITF6,18,Calabria,Calabria,1947131,2167296,111.31,0.39
485,2021-05-08,CAL,18565,8427,10138,10512,7980,73,ITF,ITF6,18,Calabria,Calabria,1947131,2185861,112.26,0.95
486,2021-05-22,CAL,22200,10564,11636,14211,7898,91,ITF,ITF6,18,Calabria,Calabria,1947131,2208061,113.4,1.14
487,2021-08-30,CAL,9390,4723,4667,3162,6104,124,ITF,ITF6,18,Calabria,Calabria,1947131,2217451,113.88,0.48
488,2021-04-21,CAL,11622,5840,5782,8632,2931,59,ITF,ITF6,18,Calabria,Calabria,1947131,2229073,114.48,0.6
489,2021-07-30,CAL,19749,10067,9682,5528,14094,127,ITF,ITF6,18,Calabria,Calabria,1947131,2248822,115.49,1.01
490,2021-04-02,CAL,8547,3916,4631,4578,3935,34,ITF,ITF6,18,Calabria,Calabria,1947131,2257369,115.93,0.44
491,2021-06-24,CAL,15420,7025,8395,6983,8357,80,ITF,ITF6,18,Calabria,Calabria,1947131,2272789,116.73,0.79
492,2021-03-19,CAL,4251,1988,2263,1886,2358,7,ITF,ITF6,18,Calabria,Calabria,1947131,2277040,116.94,0.22
493,2021-07-11,CAL,6435,2985,3450,846,5578,11,ITF,ITF6,18,Calabria,Calabria,1947131,2283475,117.27,0.33
494,2021-06-10,CAL,15897,7334,8563,12988,2809,100,ITF,ITF6,18,Calabria,Calabria,1947131,2299372,118.09,0.82
495,2021-05-17,VEN,26553,13002,13551,15655,10077,821,ITH,ITH3,5,Veneto,Veneto,4905854,26553,0.54,0.54
496,2021-02-06,VEN,4099,1354,2745,708,3391,0,ITH,ITH3,5,Veneto,Veneto,4905854,30652,0.62,0.08
497,2021-08-25,VEN,20030,10864,9166,8015,11437,578,ITH,ITH3,5,Veneto,Veneto,4905854,50682,1.03,0.41
498,2021-02-23,VEN,7384,3253,4131,7030,270,84,ITH,ITH3,5,Veneto,Veneto,4905854,58066,1.18,0.15
499,2021-01-23,VEN,4057,1250,2807,31,4026,0,ITH,ITH3,5,Veneto,Veneto,4905854,62123,1.27,0.08
500,2021-06-29,VEN,45580,22736,22844,19052,25843,685,ITH,ITH3,5,Veneto,Veneto,4905854,107703,2.2,0.93
501,2021-03-21,VEN,11992,4756,7236,8286,3466,240,ITH,ITH3,5,Veneto,Veneto,4905854,119695,2.44,0.24
502,2021-01-16,VEN,4612,1542,3070,4612,0,0,ITH,ITH3,5,Veneto,Veneto,4905854,124307,2.53,0.09
503,2021-03-14,VEN,15186,5945,9241,13846,894,446,ITH,ITH3,5,Veneto,Veneto,4905854,139493,2.84,0.31
504,2021-07-27,VEN,42255,22179,20076,11788,30039,428,ITH,ITH3,5,Veneto,Veneto,4905854,181748,3.7,0.86
505,2021-08-01,VEN,27914,14943,12971,11040,16359,515,ITH,ITH3,5,Veneto,Veneto,4905854,209662,4.27,0.57
506,2021-04-23,VEN,31302,13855,17447,21433,8710,1159,ITH,ITH3,5,Veneto,Veneto,4905854,240964,4.91,0.64
507,2021-02-16,VEN,6644,2870,3774,6439,176,29,ITH,ITH3,5,Veneto,Veneto,4905854,247608,5.05,0.14
508,2021-06-17,VEN,51761,25934,25827,25555,25061,1145,ITH,ITH3,5,Veneto,Veneto,4905854,299369,6.1,1.06
509,2021-03-09,VEN,16566,7459,9107,9830,6338,398,ITH,ITH3,5,Veneto,Veneto,4905854,315935,6.44,0.34
510,2021-05-31,VEN,31656,16247,15409,20894,9936,826,ITH,ITH3,5,Veneto,Veneto,4905854,347591,7.09,0.65
511,2021-03-26,VEN,29618,13164,16454,23283,5468,867,ITH,ITH3,5,Veneto,Veneto,4905854,377209,7.69,0.6
512,2021-07-13,VEN,43576,22615,20961,5423,37845,308,ITH,ITH3,5,Veneto,Veneto,4905854,420785,8.58,0.89
513,2021-04-04,VEN,7789,3534,4255,6514,1148,127,ITH,ITH3,5,Veneto,Veneto,4905854,428574,8.74,0.16
514,2021-09-01,VEN,20945,10715,10230,7596,12597,752,ITH,ITH3,5,Veneto,Veneto,4905854,449519,9.16,0.43
515,2021-01-11,VEN,7244,2102,5142,7243,0,1,ITH,ITH3,5,Veneto,Veneto,4905854,456763,9.31,0.15
516,2021-04-21,VEN,32408,13205,19203,15566,16065,777,ITH,ITH3,5,Veneto,Veneto,4905854,489171,9.97,0.66
517,2021-05-22,VEN,34842,16710,18132,12719,21453,670,ITH,ITH3,5,Veneto,Veneto,4905854,524013,10.68,0.71
518,2021-02-11,VEN,4015,1238,2777,3349,628,38,ITH,ITH3,5,Veneto,Veneto,4905854,528028,10.76,0.08
519,2021-01-28,VEN,9216,2666,6550,169,9045,2,ITH,ITH3,5,Veneto,Veneto,4905854,537244,10.95,0.19
520,2021-07-18,VEN,37721,19762,17959,3848,33624,249,ITH,ITH3,5,Veneto,Veneto,4905854,574965,11.72,0.77
521,2021-02-25,VEN,7904,3345,4559,7159,607,138,ITH,ITH3,5,Veneto,Veneto,4905854,582869,11.88,0.16
522,2021-04-09,VEN,31205,13767,17438,21913,8350,942,ITH,ITH3,5,Veneto,Veneto,4905854,614074,12.52,0.64
523,2021-06-05,VEN,46876,24145,22731,37320,8103,1453,ITH,ITH3,5,Veneto,Veneto,4905854,660950,13.47,0.96
524,2021-08-13,VEN,24438,13818,10620,18295,5367,776,ITH,ITH3,5,Veneto,Veneto,4905854,685388,13.97,0.5
525,2021-08-27,VEN,26730,14300,12430,8260,17892,578,ITH,ITH3,5,Veneto,Veneto,4905854,712118,14.52,0.54
526,2021-05-05,VEN,44411,21278,23133,36223,6562,1626,ITH,ITH3,5,Veneto,Veneto,4905854,756529,15.42,0.91
527,2021-07-01,VEN,51011,26057,24954,20698,29307,1006,ITH,ITH3,5,Veneto,Veneto,4905854,807540,16.46,1.04
528,2021-05-10,VEN,36519,17087,19432,25416,9857,1246,ITH,ITH3,5,Veneto,Veneto,4905854,844059,17.21,0.74
529,2021-01-30,VEN,8764,2680,6084,690,8074,0,ITH,ITH3,5,Veneto,Veneto,4905854,852823,17.38,0.18
530,2021-03-07,VEN,4495,1769,2726,3862,560,73,ITH,ITH3,5,Veneto,Veneto,4905854,857318,17.48,0.09
531,2021-08-06,VEN,38312,20908,17404,19852,17583,877,ITH,ITH3,5,Veneto,Veneto,4905854,895630,18.26,0.78
532,2021-04-28,VEN,32466,15198,17268,22253,9024,1189,ITH,ITH3,5,Veneto,Veneto,4905854,928096,18.92,0.66
533,2021-07-20,VEN,44376,23690,20686,6880,36988,508,ITH,ITH3,5,Veneto,Veneto,4905854,972472,19.82,0.9
534,2021-01-18,VEN,2766,778,1988,2560,201,5,ITH,ITH3,5,Veneto,Veneto,4905854,975238,19.88,0.06
535,2021-02-04,VEN,7397,2029,5368,550,6846,1,ITH,ITH3,5,Veneto,Veneto,4905854,982635,20.03,0.15
536,2021-08-08,VEN,20528,11401,9127,10674,9544,310,ITH,ITH3,5,Veneto,Veneto,4905854,1003163,20.45,0.42
537,2021-03-02,VEN,11497,4628,6869,7935,3312,250,ITH,ITH3,5,Veneto,Veneto,4905854,1014660,20.68,0.23
538,2021-06-10,VEN,52405,27041,25364,41327,9380,1698,ITH,ITH3,5,Veneto,Veneto,4905854,1067065,21.75,1.07
539,2021-04-02,VEN,24122,10635,13487,17147,6332,643,ITH,ITH3,5,Veneto,Veneto,4905854,1091187,22.24,0.49
540,2021-03-28,VEN,31315,13610,17705,26887,3615,813,ITH,ITH3,5,Veneto,Veneto,4905854,1122502,22.88,0.64
541,2021-06-19,VEN,49304,25084,24220,25680,22595,1029,ITH,ITH3,5,Veneto,Veneto,4905854,1171806,23.89,1.01
542,2021-07-06,VEN,36150,18626,17524,13208,22310,632,ITH,ITH3,5,Veneto,Veneto,4905854,1207956,24.62,0.74
543,2021-04-14,VEN,15944,6916,9028,8766,6634,544,ITH,ITH3,5,Veneto,Veneto,4905854,1223900,24.95,0.32
544,2021-01-04,VEN,6740,2037,4703,6738,0,2,ITH,ITH3,5,Veneto,Veneto,4905854,1230640,25.09,0.14
545,2021-08-22,VEN,9245,5043,4202,5860,3107,278,ITH,ITH3,5,Veneto,Veneto,4905854,1239885,25.27,0.19
546,2021-05-14,VEN,46835,22277,24558,24296,20956,1583,ITH,ITH3,5,Veneto,Veneto,4905854,1286720,26.23,0.95
547,2021-05-29,VEN,33066,16703,16363,24251,7699,1116,ITH,ITH3,5,Veneto,Veneto,4905854,1319786,26.9,0.67
548,2021-02-18,VEN,5833,2456,3377,5730,64,39,ITH,ITH3,5,Veneto,Veneto,4905854,1325619,27.02,0.12
549,2021-07-25,VEN,33202,17544,15658,10848,21890,464,ITH,ITH3,5,Veneto,Veneto,4905854,1358821,27.7,0.68
550,2021-04-16,VEN,24470,10502,13968,11894,11893,683,ITH,ITH3,5,Veneto,Veneto,4905854,1383291,28.2,0.5
551,2021-05-24,VEN,33093,16436,16657,7630,25054,409,ITH,ITH3,5,Veneto,Veneto,4905854,1416384,28.87,0.67
552,2021-08-15,VEN,3104,1761,1343,2614,425,65,ITH,ITH3,5,Veneto,Veneto,4905854,1419488,28.93,0.06
553,2021-01-09,VEN,7937,2539,5398,7932,0,5,ITH,ITH3,5,Veneto,Veneto,4905854,1427425,29.1,0.16
554,2021-03-18,VEN,12626,5145,7481,7037,5236,353,ITH,ITH3,5,Veneto,Veneto,4905854,1440051,29.35,0.26
555,2021-06-12,VEN,48700,24501,24199,36404,10831,1465,ITH,ITH3,5,Veneto,Veneto,4905854,1488751,30.35,0.99
556,2021-05-12,VEN,37001,17912,19089,30251,5128,1622,ITH,ITH3,5,Veneto,Veneto,4905854,1525752,31.1,0.75
557,2021-07-08,VEN,46730,24315,22415,4504,41925,301,ITH,ITH3,5,Veneto,Veneto,4905854,1572482,32.05,0.95
558,2021-06-24,VEN,56220,28474,27746,17638,37899,683,ITH,ITH3,5,Veneto,Veneto,4905854,1628702,33.2,1.15
559,2021-03-16,VEN,12538,5358,7180,6642,5626,270,ITH,ITH3,5,Veneto,Veneto,4905854,1641240,33.45,0.26
560,2021-08-20,VEN,19436,10529,8907,11283,7565,588,ITH,ITH3,5,Veneto,Veneto,4905854,1660676,33.85,0.4
561,2021-05-03,VEN,40711,19812,20899,32802,6439,1470,ITH,ITH3,5,Veneto,Veneto,4905854,1701387,34.68,0.83
562,2021-05-28,VEN,46962,22979,23983,23681,22076,1205,ITH,ITH3,5,Veneto,Veneto,4905854,1748349,35.64,0.96
563,2021-07-24,VEN,41704,22362,19342,13299,27770,635,ITH,ITH3,5,Veneto,Veneto,4905854,1790053,36.49,0.85
564,2021-07-10,VEN,43197,23216,19981,6304,36541,352,ITH,ITH3,5,Veneto,Veneto,4905854,1833250,37.37,0.88
565,2021-04-30,VEN,50269,23622,26647,33169,15674,1426,ITH,ITH3,5,Veneto,Veneto,4905854,1883519,38.39,1.02
566,2021-01-20,VEN,1039,368,671,387,652,0,ITH,ITH3,5,Veneto,Veneto,4905854,1884558,38.41,0.02
567,2021-07-03,VEN,38706,20121,18585,11029,27102,575,ITH,ITH3,5,Veneto,Veneto,4905854,1923264,39.2,0.79
568,2021-09-03,VEN,22847,12200,10647,5019,17303,525,ITH,ITH3,5,Veneto,Veneto,4905854,1946111,39.67,0.47
569,2021-06-09,VEN,42832,21968,20864,33781,7502,1549,ITH,ITH3,5,Veneto,Veneto,4905854,1988943,40.54,0.87
570,2021-06-28,VEN,47673,24125,23548,18423,28546,704,ITH,ITH3,5,Veneto,Veneto,4905854,2036616,41.51,0.97
571,2021-01-25,VEN,6472,2077,4395,157,6315,0,ITH,ITH3,5,Veneto,Veneto,4905854,2043088,41.65,0.13
572,2021-07-29,VEN,47535,25130,22405,20148,26541,846,ITH,ITH3,5,Veneto,Veneto,4905854,2090623,42.61,0.97
573,2021-07-15,VEN,51433,26917,24516,6034,45023,376,ITH,ITH3,5,Veneto,Veneto,4905854,2142056,43.66,1.05
574,2021-02-20,VEN,6431,2018,4413,6275,75,81,ITH,ITH3,5,Veneto,Veneto,4905854,2148487,43.79,0.13
575,2021-06-02,VEN,20317,10239,10078,15350,4347,620,ITH,ITH3,5,Veneto,Veneto,4905854,2168804,44.21,0.41
576,2021-08-24,VEN,19870,10589,9281,8897,10442,531,ITH,ITH3,5,Veneto,Veneto,4905854,2188674,44.61,0.41
577,2021-08-05,VEN,39213,21429,17784,15688,22917,608,ITH,ITH3,5,Veneto,Veneto,4905854,2227887,45.41,0.8
578,2021-04-18,VEN,17531,7263,10268,9510,7567,454,ITH,ITH3,5,Veneto,Veneto,4905854,2245418,45.77,0.36
579,2021-01-08,VEN,9416,2837,6579,9402,0,14,ITH,ITH3,5,Veneto,Veneto,4905854,2254834,45.96,0.19
580,2021-01-13,VEN,5988,1606,4382,5985,0,3,ITH,ITH3,5,Veneto,Veneto,4905854,2260822,46.08,0.12
581,2021-05-02,VEN,37247,17266,19981,25611,10331,1305,ITH,ITH3,5,Veneto,Veneto,4905854,2298069,46.84,0.76
582,2021-06-14,VEN,42629,21560,21069,26298,15319,1012,ITH,ITH3,5,Veneto,Veneto,4905854,2340698,47.71,0.87
583,2021-03-06,VEN,10686,4357,6329,7215,3279,192,ITH,ITH3,5,Veneto,Veneto,4905854,2351384,47.93,0.22
584,2021-08-10,VEN,28480,15625,12855,16397,11475,608,ITH,ITH3,5,Veneto,Veneto,4905854,2379864,48.51,0.58
585,2020-12-30,VEN,699,245,454,699,0,0,ITH,ITH3,5,Veneto,Veneto,4905854,2380563,48.52,0.01
586,2021-08-12,VEN,24146,13073,11073,17284,6157,705,ITH,ITH3,5,Veneto,Veneto,4905854,2404709,49.02,0.49
587,2021-06-07,VEN,44700,23319,21381,36176,7043,1481,ITH,ITH3,5,Veneto,Veneto,4905854,2449409,49.93,0.91
588,2021-02-27,VEN,8994,2693,6301,7965,849,180,ITH,ITH3,5,Veneto,Veneto,4905854,2458403,50.11,0.18
589,2021-03-04,VEN,12990,4890,8100,9121,3479,390,ITH,ITH3,5,Veneto,Veneto,4905854,2471393,50.38,0.26
590,2021-04-20,VEN,22468,9508,12960,7882,14011,575,ITH,ITH3,5,Veneto,Veneto,4905854,2493861,50.83,0.46
591,2021-08-17,VEN,19243,10456,8787,11194,7584,465,ITH,ITH3,5,Veneto,Veneto,4905854,2513104,51.23,0.39
592,2021-05-09,VEN,35089,16144,18945,23791,10054,1244,ITH,ITH3,5,Veneto,Veneto,4905854,2548193,51.94,0.72
593,2021-05-26,VEN,31163,15233,15930,13988,16495,680,ITH,ITH3,5,Veneto,Veneto,4905854,2579356,52.58,0.64
594,2021-08-31,VEN,19653,10374,9279,6959,12099,595,ITH,ITH3,5,Veneto,Veneto,4905854,2599009,52.98,0.4
595,2021-03-23,VEN,22228,10249,11979,16871,4717,640,ITH,ITH3,5,Veneto,Veneto,4905854,2621237,53.43,0.45
596,2021-05-19,VEN,33159,15185,17974,16230,15994,935,ITH,ITH3,5,Veneto,Veneto,4905854,2654396,54.11,0.68
597,2021-02-08,VEN,5007,1559,3448,1923,3078,6,ITH,ITH3,5,Veneto,Veneto,4905854,2659403,54.21,0.1
598,2021-04-06,VEN,29032,13367,15665,23257,5046,729,ITH,ITH3,5,Veneto,Veneto,4905854,2688435,54.8,0.59
599,2021-07-07,VEN,40983,21325,19658,15647,24542,794,ITH,ITH3,5,Veneto,Veneto,4905854,2729418,55.64,0.84
600,2021-08-19,VEN,19536,10649,8887,12195,6807,534,ITH,ITH3,5,Veneto,Veneto,4905854,2748954,56.03,0.4
601,2021-05-11,VEN,33197,16515,16682,27146,4729,1322,ITH,ITH3,5,Veneto,Veneto,4905854,2782151,56.71,0.68
602,2021-01-22,VEN,1080,332,748,25,1055,0,ITH,ITH3,5,Veneto,Veneto,4905854,2783231,56.73,0.02
603,2021-08-21,VEN,12158,6862,5296,8264,3377,517,ITH,ITH3,5,Veneto,Veneto,4905854,2795389,56.98,0.25
604,2021-03-11,VEN,19838,8893,10945,13796,5576,466,ITH,ITH3,5,Veneto,Veneto,4905854,2815227,57.39,0.4
605,2021-04-27,VEN,28214,12799,15415,20136,6916,1162,ITH,ITH3,5,Veneto,Veneto,4905854,2843441,57.96,0.58
606,2021-06-16,VEN,47795,23579,24216,25265,21439,1091,ITH,ITH3,5,Veneto,Veneto,4905854,2891236,58.93,0.97
607,2021-01-01,VEN,1525,470,1055,1524,0,1,ITH,ITH3,5,Veneto,Veneto,4905854,2892761,58.97,0.03
608,2021-03-25,VEN,25975,11063,14912,18972,6104,899,ITH,ITH3,5,Veneto,Veneto,4905854,2918736,59.49,0.53
609,2021-04-11,VEN,21014,8878,12136,14228,6298,488,ITH,ITH3,5,Veneto,Veneto,4905854,2939750,59.92,0.43
610,2021-07-22,VEN,48394,25126,23268,13314,34430,650,ITH,ITH3,5,Veneto,Veneto,4905854,2988144,60.91,0.99
611,2021-04-13,VEN,14040,6328,7712,8058,5479,503,ITH,ITH3,5,Veneto,Veneto,4905854,3002184,61.2,0.29
612,2021-07-05,VEN,39143,20286,18857,14154,24194,795,ITH,ITH3,5,Veneto,Veneto,4905854,3041327,61.99,0.8
613,2021-01-03,VEN,5158,1562,3596,5158,0,0,ITH,ITH3,5,Veneto,Veneto,4905854,3046485,62.1,0.11
614,2021-03-08,VEN,13644,6282,7362,9304,4077,263,ITH,ITH3,5,Veneto,Veneto,4905854,3060129,62.38,0.28
615,2021-07-17,VEN,40611,21484,19127,4295,35973,343,ITH,ITH3,5,Veneto,Veneto,4905854,3100740,63.2,0.83
616,2021-08-29,VEN,13382,7345,6037,4491,8569,322,ITH,ITH3,5,Veneto,Veneto,4905854,3114122,63.48,0.27
617,2021-05-21,VEN,44863,22064,22799,19802,23956,1105,ITH,ITH3,5,Veneto,Veneto,4905854,3158985,64.39,0.91
618,2021-08-03,VEN,40724,21558,19166,17580,22426,718,ITH,ITH3,5,Veneto,Veneto,4905854,3199709,65.22,0.83
619,2021-04-25,VEN,18336,8156,10180,12905,4835,596,ITH,ITH3,5,Veneto,Veneto,4905854,3218045,65.6,0.37
620,2021-06-21,VEN,44336,22189,22147,20462,22965,909,ITH,ITH3,5,Veneto,Veneto,4905854,3262381,66.5,0.9
621,2021-01-06,VEN,8142,2391,5751,8139,0,3,ITH,ITH3,5,Veneto,Veneto,4905854,3270523,66.67,0.17
622,2021-06-23,VEN,49367,24458,24909,14560,34010,797,ITH,ITH3,5,Veneto,Veneto,4905854,3319890,67.67,1.01
623,2021-02-01,VEN,8563,2502,6061,157,8406,0,ITH,ITH3,5,Veneto,Veneto,4905854,3328453,67.85,0.17
624,2021-02-15,VEN,4392,1827,2565,4143,240,9,ITH,ITH3,5,Veneto,Veneto,4905854,3332845,67.94,0.09
625,2021-03-30,VEN,36008,15317,20691,29736,5253,1019,ITH,ITH3,5,Veneto,Veneto,4905854,3368853,68.67,0.73
626,2021-08-02,VEN,40097,21034,19063,16291,23169,637,ITH,ITH3,5,Veneto,Veneto,4905854,3408950,69.49,0.82
627,2021-04-10,VEN,27483,11987,15496,18377,8474,632,ITH,ITH3,5,Veneto,Veneto,4905854,3436433,70.05,0.56
628,2021-06-18,VEN,53661,26780,26881,23984,28637,1040,ITH,ITH3,5,Veneto,Veneto,4905854,3490094,71.14,1.09
629,2021-03-27,VEN,32093,14018,18075,25378,5807,908,ITH,ITH3,5,Veneto,Veneto,4905854,3522187,71.8,0.65
630,2021-06-03,VEN,54534,28044,26490,40878,12004,1652,ITH,ITH3,5,Veneto,Veneto,4905854,3576721,72.91,1.11
631,2021-03-01,VEN,9395,3717,5678,7410,1822,163,ITH,ITH3,5,Veneto,Veneto,4905854,3586116,73.1,0.19
632,2021-07-12,VEN,43248,22782,20466,4013,38913,322,ITH,ITH3,5,Veneto,Veneto,4905854,3629364,73.98,0.88
633,2021-04-03,VEN,21991,9644,12347,13865,7721,405,ITH,ITH3,5,Veneto,Veneto,4905854,3651355,74.43,0.45
634,2021-03-20,VEN,13036,5393,7643,10658,2082,296,ITH,ITH3,5,Veneto,Veneto,4905854,3664391,74.69,0.27
635,2021-01-17,VEN,1933,781,1152,1584,349,0,ITH,ITH3,5,Veneto,Veneto,4905854,3666324,74.73,0.04
636,2021-02-03,VEN,5955,1672,4283,474,5477,4,ITH,ITH3,5,Veneto,Veneto,4905854,3672279,74.86,0.12
637,2021-08-07,VEN,28949,16295,12654,16333,12067,549,ITH,ITH3,5,Veneto,Veneto,4905854,3701228,75.45,0.59
638,2021-04-29,VEN,50331,23412,26919,35411,13183,1737,ITH,ITH3,5,Veneto,Veneto,4905854,3751559,76.47,1.03
639,2021-07-21,VEN,43275,22338,20937,8699,34079,497,ITH,ITH3,5,Veneto,Veneto,4905854,3794834,77.35,0.88
640,2021-02-05,VEN,8390,2541,5849,1409,6972,9,ITH,ITH3,5,Veneto,Veneto,4905854,3803224,77.52,0.17
641,2021-02-22,VEN,7019,3044,3975,6581,391,47,ITH,ITH3,5,Veneto,Veneto,4905854,3810243,77.67,0.14
642,2021-05-16,VEN,28423,14015,14408,20322,7081,1020,ITH,ITH3,5,Veneto,Veneto,4905854,3838666,78.25,0.58
643,2021-05-04,VEN,43032,20383,22649,33359,8033,1640,ITH,ITH3,5,Veneto,Veneto,4905854,3881698,79.12,0.88
644,2021-01-24,VEN,4117,1219,2898,28,4089,0,ITH,ITH3,5,Veneto,Veneto,4905854,3885815,79.21,0.08
645,2021-04-07,VEN,36063,16205,19858,27608,7341,1114,ITH,ITH3,5,Veneto,Veneto,4905854,3921878,79.94,0.74
646,2021-07-16,VEN,44733,24064,20669,6957,37316,460,ITH,ITH3,5,Veneto,Veneto,4905854,3966611,80.85,0.91
647,2021-01-31,VEN,4789,1566,3223,408,4381,0,ITH,ITH3,5,Veneto,Veneto,4905854,3971400,80.95,0.1
648,2021-03-29,VEN,31474,13706,17768,26652,3827,995,ITH,ITH3,5,Veneto,Veneto,4905854,4002874,81.59,0.64
649,2021-05-13,VEN,44342,21882,22460,32587,9918,1837,ITH,ITH3,5,Veneto,Veneto,4905854,4047216,82.5,0.9
650,2021-02-02,VEN,6515,1881,4634,396,6119,0,ITH,ITH3,5,Veneto,Veneto,4905854,4053731,82.63,0.13
651,2021-07-09,VEN,45089,23781,21308,4126,40678,285,ITH,ITH3,5,Veneto,Veneto,4905854,4098820,83.55,0.92
652,2021-03-31,VEN,38978,16460,22518,30421,7507,1050,ITH,ITH3,5,Veneto,Veneto,4905854,4137798,84.34,0.79
653,2021-02-17,VEN,6022,2772,3250,5900,94,28,ITH,ITH3,5,Veneto,Veneto,4905854,4143820,84.47,0.12
654,2021-04-01,VEN,25405,11197,14208,18215,6414,776,ITH,ITH3,5,Veneto,Veneto,4905854,4169225,84.98,0.52
655,2021-04-15,VEN,20942,8654,12288,9361,10833,748,ITH,ITH3,5,Veneto,Veneto,4905854,4190167,85.41,0.43
656,2021-01-05,VEN,7335,2186,5149,7333,0,2,ITH,ITH3,5,Veneto,Veneto,4905854,4197502,85.56,0.15
657,2021-02-10,VEN,4761,1592,3169,3692,1060,9,ITH,ITH3,5,Veneto,Veneto,4905854,4202263,85.66,0.1
658,2021-04-08,VEN,32408,14387,18021,23346,7886,1176,ITH,ITH3,5,Veneto,Veneto,4905854,4234671,86.32,0.66
659,2021-06-04,VEN,49652,25841,23811,39835,8142,1675,ITH,ITH3,5,Veneto,Veneto,4905854,4284323,87.33,1.01
660,2021-02-24,VEN,8622,3680,4942,7999,489,134,ITH,ITH3,5,Veneto,Veneto,4905854,4292945,87.51,0.18
661,2021-01-10,VEN,5036,1673,3363,5035,0,1,ITH,ITH3,5,Veneto,Veneto,4905854,4297981,87.61,0.1
662,2021-05-23,VEN,34492,16470,18022,10621,23400,471,ITH,ITH3,5,Veneto,Veneto,4905854,4332473,88.31,0.7
663,2021-02-12,VEN,4314,1446,2868,3671,572,71,ITH,ITH3,5,Veneto,Veneto,4905854,4336787,88.4,0.09
664,2021-06-20,VEN,41208,20065,21143,18928,21540,740,ITH,ITH3,5,Veneto,Veneto,4905854,4377995,89.24,0.84
665,2021-02-19,VEN,7323,3141,4182,6995,204,124,ITH,ITH3,5,Veneto,Veneto,4905854,4385318,89.39,0.15
666,2021-08-23,VEN,24505,13022,11483,10563,13230,712,ITH,ITH3,5,Veneto,Veneto,4905854,4409823,89.89,0.5
667,2021-02-21,VEN,4640,1212,3428,4516,5,119,ITH,ITH3,5,Veneto,Veneto,4905854,4414463,89.98,0.09
668,2021-05-15,VEN,36275,17520,18755,24820,10023,1432,ITH,ITH3,5,Veneto,Veneto,4905854,4450738,90.72,0.74
669,2021-06-01,VEN,26996,13570,13426,15793,10559,644,ITH,ITH3,5,Veneto,Veneto,4905854,4477734,91.27,0.55
670,2021-03-10,VEN,19043,8728,10315,12960,5686,397,ITH,ITH3,5,Veneto,Veneto,4905854,4496777,91.66,0.39
671,2021-03-15,VEN,16673,7331,9342,10957,5212,504,ITH,ITH3,5,Veneto,Veneto,4905854,4513450,92.0,0.34
672,2021-05-18,VEN,27033,12551,14482,12636,13636,761,ITH,ITH3,5,Veneto,Veneto,4905854,4540483,92.55,0.55
673,2021-06-22,VEN,43744,21628,22116,18508,24386,850,ITH,ITH3,5,Veneto,Veneto,4905854,4584227,93.44,0.89
674,2021-08-18,VEN,23305,12560,10745,14181,8439,685,ITH,ITH3,5,Veneto,Veneto,4905854,4607532,93.92,0.48
675,2021-08-04,VEN,42434,22661,19773,22574,18763,1097,ITH,ITH3,5,Veneto,Veneto,4905854,4649966,94.78,0.86
676,2021-04-26,VEN,20733,9461,11272,14913,5140,680,ITH,ITH3,5,Veneto,Veneto,4905854,4670699,95.21,0.42
677,2021-06-15,VEN,47841,24302,23539,29144,17545,1152,ITH,ITH3,5,Veneto,Veneto,4905854,4718540,96.18,0.98
678,2021-08-11,VEN,26756,14777,11979,15617,10564,575,ITH,ITH3,5,Veneto,Veneto,4905854,4745296,96.73,0.55
679,2021-06-30,VEN,45818,23103,22715,17876,27195,747,ITH,ITH3,5,Veneto,Veneto,4905854,4791114,97.66,0.93
680,2021-03-22,VEN,18156,8184,9972,12587,5050,519,ITH,ITH3,5,Veneto,Veneto,4905854,4809270,98.03,0.37
681,2021-03-13,VEN,17240,7311,9929,13735,3132,373,ITH,ITH3,5,Veneto,Veneto,4905854,4826510,98.38,0.35
682,2021-01-15,VEN,5878,1819,4059,5872,0,6,ITH,ITH3,5,Veneto,Veneto,4905854,4832388,98.5,0.12
683,2021-08-28,VEN,20843,11581,9262,8637,11469,737,ITH,ITH3,5,Veneto,Veneto,4905854,4853231,98.93,0.42
684,2021-05-20,VEN,44850,21262,23588,19367,24379,1104,ITH,ITH3,5,Veneto,Veneto,4905854,4898081,99.84,0.91
685,2021-02-09,VEN,5250,1892,3358,3431,1806,13,ITH,ITH3,5,Veneto,Veneto,4905854,4903331,99.95,0.11
686,2021-07-11,VEN,34237,17925,16312,3700,30284,253,ITH,ITH3,5,Veneto,Veneto,4905854,4937568,100.65,0.7
687,2021-08-30,VEN,26878,14243,12635,7963,18299,616,ITH,ITH3,5,Veneto,Veneto,4905854,4964446,101.19,0.55
688,2021-05-27,VEN,46667,22924,23743,22366,23256,1045,ITH,ITH3,5,Veneto,Veneto,4905854,5011113,102.15,0.95
689,2021-02-07,VEN,2316,863,1453,714,1601,1,ITH,ITH3,5,Veneto,Veneto,4905854,5013429,102.19,0.05
690,2021-07-02,VEN,49560,25139,24421,16291,32489,780,ITH,ITH3,5,Veneto,Veneto,4905854,5062989,103.2,1.01
691,2021-03-24,VEN,22126,9581,12545,14667,6806,653,ITH,ITH3,5,Veneto,Veneto,4905854,5085115,103.65,0.45
692,2021-01-29,VEN,9029,2789,6240,365,8664,0,ITH,ITH3,5,Veneto,Veneto,4905854,5094144,103.84,0.18
693,2021-05-08,VEN,41529,18786,22743,28263,11836,1430,ITH,ITH3,5,Veneto,Veneto,4905854,5135673,104.68,0.85
694,2021-07-30,VEN,45576,24240,21336,22618,22081,877,ITH,ITH3,5,Veneto,Veneto,4905854,5181249,105.61,0.93
695,2021-08-16,VEN,19703,10667,9036,12944,6169,590,ITH,ITH3,5,Veneto,Veneto,4905854,5200952,106.02,0.4
696,2021-08-09,VEN,34766,18640,16126,17133,16861,772,ITH,ITH3,5,Veneto,Veneto,4905854,5235718,106.72,0.71
697,2021-08-26,VEN,22262,11859,10403,8294,13364,604,ITH,ITH3,5,Veneto,Veneto,4905854,5257980,107.18,0.45
698,2021-06-27,VEN,40242,20559,19683,15352,24311,579,ITH,ITH3,5,Veneto,Veneto,4905854,5298222,108.0,0.82
699,2021-03-19,VEN,13804,5672,8132,7404,6106,294,ITH,ITH3,5,Veneto,Veneto,4905854,5312026,108.28,0.28
700,2021-06-06,VEN,37450,19174,18276,31495,4732,1223,ITH,ITH3,5,Veneto,Veneto,4905854,5349476,109.04,0.76
701,2020-12-27,VEN,880,395,485,880,0,0,ITH,ITH3,5,Veneto,Veneto,4905854,5350356,109.06,0.02
702,2021-05-30,VEN,22550,11273,11277,15206,6691,653,ITH,ITH3,5,Veneto,Veneto,4905854,5372906,109.52,0.46
703,2021-07-26,VEN,43641,22942,20699,16997,26010,634,ITH,ITH3,5,Veneto,Veneto,4905854,5416547,110.41,0.89
704,2021-07-19,VEN,44748,23569,21179,7966,36388,394,ITH,ITH3,5,Veneto,Veneto,4905854,5461295,111.32,0.91
705,2021-02-26,VEN,8299,3274,5025,6944,1260,95,ITH,ITH3,5,Veneto,Veneto,4905854,5469594,111.49,0.17
706,2021-04-24,VEN,24769,10832,13937,14967,9080,722,ITH,ITH3,5,Veneto,Veneto,4905854,5494363,112.0,0.5
707,2021-01-14,VEN,7066,1927,5139,7046,0,20,ITH,ITH3,5,Veneto,Veneto,4905854,5501429,112.14,0.14
708,2021-03-12,VEN,18663,8196,10467,11329,6751,583,ITH,ITH3,5,Veneto,Veneto,4905854,5520092,112.52,0.38
709,2021-04-17,VEN,22451,9099,13352,14374,7278,799,ITH,ITH3,5,Veneto,Veneto,4905854,5542543,112.98,0.46
710,2021-01-07,VEN,8361,2317,6044,8360,0,1,ITH,ITH3,5,Veneto,Veneto,4905854,5550904,113.15,0.17
711,2021-06-13,VEN,37345,19259,18086,29320,6957,1068,ITH,ITH3,5,Veneto,Veneto,4905854,5588249,113.91,0.76
712,2021-01-21,VEN,2294,719,1575,19,2275,0,ITH,ITH3,5,Veneto,Veneto,4905854,5590543,113.96,0.05
713,2021-03-05,VEN,13341,5023,8318,9223,3674,444,ITH,ITH3,5,Veneto,Veneto,4905854,5603884,114.23,0.27
714,2020-12-31,VEN,3221,1042,2179,3221,0,0,ITH,ITH3,5,Veneto,Veneto,4905854,5607105,114.29,0.07
715,2021-07-04,VEN,33886,17580,16306,14996,18288,602,ITH,ITH3,5,Veneto,Veneto,4905854,5640991,114.98,0.69
716,2021-04-12,VEN,14919,6345,8574,6399,8218,302,ITH,ITH3,5,Veneto,Veneto,4905854,5655910,115.29,0.3
717,2021-01-02,VEN,5743,1767,3976,5742,0,1,ITH,ITH3,5,Veneto,Veneto,4905854,5661653,115.41,0.12
718,2021-01-19,VEN,1313,475,838,1163,149,1,ITH,ITH3,5,Veneto,Veneto,4905854,5662966,115.43,0.03
719,2021-07-23,VEN,44502,23461,21041,15144,28787,571,ITH,ITH3,5,Veneto,Veneto,4905854,5707468,116.34,0.91
720,2021-05-01,VEN,38875,18251,20624,28713,8929,1233,ITH,ITH3,5,Veneto,Veneto,4905854,5746343,117.13,0.79
721,2021-06-26,VEN,48091,24518,23573,13597,34005,489,ITH,ITH3,5,Veneto,Veneto,4905854,5794434,118.11,0.98
722,2021-05-07,VEN,48649,23309,25340,37609,8680,2360,ITH,ITH3,5,Veneto,Veneto,4905854,5843083,119.1,0.99
723,2021-01-27,VEN,7148,2069,5079,239,6908,1,ITH,ITH3,5,Veneto,Veneto,4905854,5850231,119.25,0.15
724,2021-02-13,VEN,3267,1473,1794,3231,20,16,ITH,ITH3,5,Veneto,Veneto,4905854,5853498,119.32,0.07
725,2021-09-02,VEN,22494,11985,10509,6032,15670,792,ITH,ITH3,5,Veneto,Veneto,4905854,5875992,119.78,0.46
726,2021-03-03,VEN,12101,4648,7453,8388,3502,211,ITH,ITH3,5,Veneto,Veneto,4905854,5888093,120.02,0.25
727,2021-06-11,VEN,47321,24620,22701,34714,11183,1424,ITH,ITH3,5,Veneto,Veneto,4905854,5935414,120.99,0.96
728,2021-06-25,VEN,51716,26166,25550,15073,36005,638,ITH,ITH3,5,Veneto,Veneto,4905854,5987130,122.04,1.05
729,2021-07-14,VEN,43625,22428,21197,5281,37950,394,ITH,ITH3,5,Veneto,Veneto,4905854,6030755,122.93,0.89
730,2021-04-22,VEN,32077,13946,18131,15471,15780,826,ITH,ITH3,5,Veneto,Veneto,4905854,6062832,123.58,0.65
731,2021-07-31,VEN,35163,18891,16272,17013,17503,647,ITH,ITH3,5,Veneto,Veneto,4905854,6097995,124.3,0.72
732,2021-08-14,VEN,9913,5805,4108,7260,2401,252,ITH,ITH3,5,Veneto,Veneto,4905854,6107908,124.5,0.2
733,2021-06-08,VEN,43858,22676,21182,36188,6152,1518,ITH,ITH3,5,Veneto,Veneto,4905854,6151766,125.4,0.89
734,2021-05-25,VEN,27868,13452,14416,11274,16096,498,ITH,ITH3,5,Veneto,Veneto,4905854,6179634,125.96,0.57
735,2021-02-14,VEN,125,55,70,112,13,0,ITH,ITH3,5,Veneto,Veneto,4905854,6179759,125.97,0.0
736,2021-02-28,VEN,4136,1389,2747,3224,837,75,ITH,ITH3,5,Veneto,Veneto,4905854,6183895,126.05,0.08
737,2021-03-17,VEN,14646,5991,8655,7526,6797,323,ITH,ITH3,5,Veneto,Veneto,4905854,6198541,126.35,0.3
738,2021-07-28,VEN,40294,20919,19375,12054,27790,450,ITH,ITH3,5,Veneto,Veneto,4905854,6238835,127.17,0.82
739,2021-01-12,VEN,5231,1517,3714,5223,0,8,ITH,ITH3,5,Veneto,Veneto,4905854,6244066,127.28,0.11
740,2021-04-19,VEN,21559,8930,12629,4711,16420,428,ITH,ITH3,5,Veneto,Veneto,4905854,6265625,127.72,0.44
741,2021-04-05,VEN,19165,8376,10789,13422,5439,304,ITH,ITH3,5,Veneto,Veneto,4905854,6284790,128.11,0.39
742,2021-01-26,VEN,6925,2092,4833,149,6776,0,ITH,ITH3,5,Veneto,Veneto,4905854,6291715,128.25,0.14
743,2021-05-06,VEN,47056,22068,24988,36580,8498,1978,ITH,ITH3,5,Veneto,Veneto,4905854,6338771,129.21,0.96
744,2021-03-26,LIG,9356,4040,5316,6092,3157,107,ITC,ITC3,7,Liguria,Liguria,1550640,9356,0.6,0.6
745,2021-07-04,LIG,4860,2582,2278,3816,999,45,ITC,ITC3,7,Liguria,Liguria,1550640,14216,0.92,0.31
746,2021-01-02,LIG,693,247,446,693,0,0,ITC,ITC3,7,Liguria,Liguria,1550640,14909,0.96,0.04
747,2021-01-28,LIG,2851,972,1879,37,2814,0,ITC,ITC3,7,Liguria,Liguria,1550640,17760,1.15,0.18
748,2021-07-18,LIG,2384,1223,1161,387,1984,13,ITC,ITC3,7,Liguria,Liguria,1550640,20144,1.3,0.15
749,2021-06-05,LIG,8104,4126,3978,4923,3156,25,ITC,ITC3,7,Liguria,Liguria,1550640,28248,1.82,0.52
750,2021-04-09,LIG,12482,5568,6914,10560,1787,135,ITC,ITC3,7,Liguria,Liguria,1550640,40730,2.63,0.8
751,2021-03-31,LIG,11953,5290,6663,9071,2780,102,ITC,ITC3,7,Liguria,Liguria,1550640,52683,3.4,0.77
752,2021-04-26,LIG,10588,4995,5593,7861,2642,85,ITC,ITC3,7,Liguria,Liguria,1550640,63271,4.08,0.68
753,2021-01-16,LIG,1279,558,721,1274,0,5,ITC,ITC3,7,Liguria,Liguria,1550640,64550,4.16,0.08
754,2021-02-02,LIG,2675,1007,1668,127,2546,2,ITC,ITC3,7,Liguria,Liguria,1550640,67225,4.34,0.17
755,2021-04-28,LIG,14468,6526,7942,6382,7999,87,ITC,ITC3,7,Liguria,Liguria,1550640,81693,5.27,0.93
756,2021-08-06,LIG,12192,6192,6000,3960,8116,116,ITC,ITC3,7,Liguria,Liguria,1550640,93885,6.05,0.79
757,2021-02-04,LIG,2820,990,1830,177,2643,0,ITC,ITC3,7,Liguria,Liguria,1550640,96705,6.24,0.18
758,2021-08-30,LIG,9781,5222,4559,2476,7235,70,ITC,ITC3,7,Liguria,Liguria,1550640,106486,6.87,0.63
759,2021-02-11,LIG,1990,772,1218,1093,888,9,ITC,ITC3,7,Liguria,Liguria,1550640,108476,7.0,0.13
760,2021-05-22,LIG,6657,3222,3435,4879,1687,91,ITC,ITC3,7,Liguria,Liguria,1550640,115133,7.42,0.43
761,2021-06-10,LIG,18890,9739,9151,13136,5671,83,ITC,ITC3,7,Liguria,Liguria,1550640,134023,8.64,1.22
762,2021-03-19,LIG,5301,2236,3065,2098,3152,51,ITC,ITC3,7,Liguria,Liguria,1550640,139324,8.98,0.34
763,2021-03-02,LIG,4081,1693,2388,3763,310,8,ITC,ITC3,7,Liguria,Liguria,1550640,143405,9.25,0.26
764,2021-07-11,LIG,2152,1195,957,1232,903,17,ITC,ITC3,7,Liguria,Liguria,1550640,145557,9.39,0.14
765,2021-02-28,LIG,1060,580,480,1048,11,1,ITC,ITC3,7,Liguria,Liguria,1550640,146617,9.46,0.07
766,2021-09-01,LIG,8481,4461,4020,2711,5707,63,ITC,ITC3,7,Liguria,Liguria,1550640,155098,10.0,0.55
767,2021-08-01,LIG,1490,857,633,152,1338,0,ITC,ITC3,7,Liguria,Liguria,1550640,156588,10.1,0.1
768,2021-02-16,LIG,2429,958,1471,1994,430,5,ITC,ITC3,7,Liguria,Liguria,1550640,159017,10.25,0.16
769,2021-07-23,LIG,19999,10304,9695,5132,14763,104,ITC,ITC3,7,Liguria,Liguria,1550640,179016,11.54,1.29
770,2021-05-27,LIG,17010,8719,8291,12680,4172,158,ITC,ITC3,7,Liguria,Liguria,1550640,196026,12.64,1.1
771,2021-04-14,LIG,13083,5674,7409,10751,2211,121,ITC,ITC3,7,Liguria,Liguria,1550640,209109,13.49,0.84
772,2021-05-29,LIG,6874,3255,3619,3977,2873,24,ITC,ITC3,7,Liguria,Liguria,1550640,215983,13.93,0.44
773,2021-03-14,LIG,1660,753,907,1043,605,12,ITC,ITC3,7,Liguria,Liguria,1550640,217643,14.04,0.11
774,2021-08-18,LIG,12195,6581,5614,4247,7837,111,ITC,ITC3,7,Liguria,Liguria,1550640,229838,14.82,0.79
775,2021-06-22,LIG,15800,7466,8334,7626,8117,57,ITC,ITC3,7,Liguria,Liguria,1550640,245638,15.84,1.02
776,2021-07-06,LIG,12370,6072,6298,5646,6650,74,ITC,ITC3,7,Liguria,Liguria,1550640,258008,16.64,0.8
777,2021-05-10,LIG,12662,5649,7013,6202,6382,78,ITC,ITC3,7,Liguria,Liguria,1550640,270670,17.46,0.82
778,2021-01-21,LIG,1109,385,724,677,431,1,ITC,ITC3,7,Liguria,Liguria,1550640,271779,17.53,0.07
779,2021-08-20,LIG,9368,4978,4390,3112,6173,83,ITC,ITC3,7,Liguria,Liguria,1550640,281147,18.13,0.6
780,2021-01-14,LIG,2983,1056,1927,2982,0,1,ITC,ITC3,7,Liguria,Liguria,1550640,284130,18.32,0.19
781,2021-06-15,LIG,17400,8469,8931,9274,8066,60,ITC,ITC3,7,Liguria,Liguria,1550640,301530,19.45,1.12
782,2021-03-07,LIG,1915,1139,776,1602,301,12,ITC,ITC3,7,Liguria,Liguria,1550640,303445,19.57,0.12
783,2021-06-17,LIG,16706,7940,8766,9093,7540,73,ITC,ITC3,7,Liguria,Liguria,1550640,320151,20.65,1.08
784,2021-01-09,LIG,1338,484,854,1337,0,1,ITC,ITC3,7,Liguria,Liguria,1550640,321489,20.73,0.09
785,2021-04-19,LIG,12841,5622,7219,8919,3834,88,ITC,ITC3,7,Liguria,Liguria,1550640,334330,21.56,0.83
786,2021-07-13,LIG,13101,6443,6658,3479,9580,42,ITC,ITC3,7,Liguria,Liguria,1550640,347431,22.41,0.84
787,2021-05-15,LIG,7324,3276,4048,4297,2961,66,ITC,ITC3,7,Liguria,Liguria,1550640,354755,22.88,0.47
788,2021-02-21,LIG,869,491,378,863,4,2,ITC,ITC3,7,Liguria,Liguria,1550640,355624,22.93,0.06
789,2020-12-28,LIG,80,30,50,80,0,0,ITC,ITC3,7,Liguria,Liguria,1550640,355704,22.94,0.01
790,2021-06-03,LIG,15551,7708,7843,9113,6390,48,ITC,ITC3,7,Liguria,Liguria,1550640,371255,23.94,1.0
791,2021-04-07,LIG,13694,6114,7580,11312,2292,90,ITC,ITC3,7,Liguria,Liguria,1550640,384949,24.83,0.88
792,2021-02-23,LIG,3809,1559,2250,3663,109,37,ITC,ITC3,7,Liguria,Liguria,1550640,388758,25.07,0.25
793,2021-08-10,LIG,13117,6551,6566,4276,8706,135,ITC,ITC3,7,Liguria,Liguria,1550640,401875,25.92,0.85
794,2021-06-14,LIG,15166,7321,7845,8224,6877,65,ITC,ITC3,7,Liguria,Liguria,1550640,417041,26.89,0.98
795,2021-06-24,LIG,11159,5451,5708,6242,4856,61,ITC,ITC3,7,Liguria,Liguria,1550640,428200,27.61,0.72
796,2021-04-02,LIG,11795,5222,6573,9222,2488,85,ITC,ITC3,7,Liguria,Liguria,1550640,439995,28.38,0.76
797,2021-04-21,LIG,14295,6461,7834,8861,5345,89,ITC,ITC3,7,Liguria,Liguria,1550640,454290,29.3,0.92
798,2021-07-30,LIG,16075,8329,7746,4668,11329,78,ITC,ITC3,7,Liguria,Liguria,1550640,470365,30.33,1.04
799,2021-08-13,LIG,10887,5622,5265,3931,6869,87,ITC,ITC3,7,Liguria,Liguria,1550640,481252,31.04,0.7
800,2021-05-08,LIG,7538,3337,4201,2273,5227,38,ITC,ITC3,7,Liguria,Liguria,1550640,488790,31.52,0.49
801,2021-01-25,LIG,2734,893,1841,475,2258,1,ITC,ITC3,7,Liguria,Liguria,1550640,491524,31.7,0.18
802,2021-05-05,LIG,13724,6142,7582,5178,8462,84,ITC,ITC3,7,Liguria,Liguria,1550640,505248,32.58,0.89
803,2021-07-25,LIG,6402,3270,3132,650,5742,10,ITC,ITC3,7,Liguria,Liguria,1550640,511650,33.0,0.41
804,2021-02-09,LIG,1956,696,1260,263,1691,2,ITC,ITC3,7,Liguria,Liguria,1550640,513606,33.12,0.13
805,2021-05-03,LIG,13267,5922,7345,6358,6822,87,ITC,ITC3,7,Liguria,Liguria,1550640,526873,33.98,0.86
806,2021-08-11,LIG,13121,6729,6392,4788,8227,106,ITC,ITC3,7,Liguria,Liguria,1550640,539994,34.82,0.85
807,2021-03-21,LIG,551,220,331,69,482,0,ITC,ITC3,7,Liguria,Liguria,1550640,540545,34.86,0.04
808,2021-08-25,LIG,9328,5020,4308,3214,6015,99,ITC,ITC3,7,Liguria,Liguria,1550640,549873,35.46,0.6
809,2021-01-23,LIG,813,297,516,156,657,0,ITC,ITC3,7,Liguria,Liguria,1550640,550686,35.51,0.05
810,2021-06-29,LIG,15186,7233,7953,8648,6457,81,ITC,ITC3,7,Liguria,Liguria,1550640,565872,36.49,0.98
811,2021-05-17,LIG,12046,5527,6519,8611,3370,65,ITC,ITC3,7,Liguria,Liguria,1550640,577918,37.27,0.78
812,2021-03-12,LIG,6222,2874,3348,3689,2475,58,ITC,ITC3,7,Liguria,Liguria,1550640,584140,37.67,0.4
813,2021-07-01,LIG,13572,6544,7028,7316,6170,86,ITC,ITC3,7,Liguria,Liguria,1550640,597712,38.55,0.88
814,2021-05-19,LIG,13583,5966,7617,10325,3126,132,ITC,ITC3,7,Liguria,Liguria,1550640,611295,39.42,0.88
815,2021-03-23,LIG,9296,4234,5062,5993,3217,86,ITC,ITC3,7,Liguria,Liguria,1550640,620591,40.02,0.6
816,2021-08-27,LIG,9199,4909,4290,2835,6296,68,ITC,ITC3,7,Liguria,Liguria,1550640,629790,40.61,0.59
817,2021-07-15,LIG,14782,7476,7306,5157,9508,117,ITC,ITC3,7,Liguria,Liguria,1550640,644572,41.57,0.95
818,2021-06-02,LIG,8543,4347,4196,5337,3177,29,ITC,ITC3,7,Liguria,Liguria,1550640,653115,42.12,0.55
819,2021-06-19,LIG,7415,3776,3639,5698,1671,46,ITC,ITC3,7,Liguria,Liguria,1550640,660530,42.6,0.48
820,2021-08-15,LIG,1410,785,625,849,528,33,ITC,ITC3,7,Liguria,Liguria,1550640,661940,42.69,0.09
821,2021-05-24,LIG,11889,5595,6294,9279,2511,99,ITC,ITC3,7,Liguria,Liguria,1550640,673829,43.45,0.77
822,2021-05-07,LIG,13616,6048,7568,5716,7812,88,ITC,ITC3,7,Liguria,Liguria,1550640,687445,44.33,0.88
823,2021-02-13,LIG,1080,508,572,797,280,3,ITC,ITC3,7,Liguria,Liguria,1550640,688525,44.4,0.07
824,2021-06-07,LIG,15719,7671,8048,8632,7036,51,ITC,ITC3,7,Liguria,Liguria,1550640,704244,45.42,1.01
825,2020-12-30,LIG,12,5,7,12,0,0,ITC,ITC3,7,Liguria,Liguria,1550640,704256,45.42,0.0
826,2021-07-03,LIG,8823,4372,4451,5457,3326,40,ITC,ITC3,7,Liguria,Liguria,1550640,713079,45.99,0.57
827,2021-04-11,LIG,4251,1930,2321,3958,249,44,ITC,ITC3,7,Liguria,Liguria,1550640,717330,46.26,0.27
828,2021-07-20,LIG,13980,6884,7096,2730,11199,51,ITC,ITC3,7,Liguria,Liguria,1550640,731310,47.16,0.9
829,2021-01-18,LIG,2146,749,1397,1987,157,2,ITC,ITC3,7,Liguria,Liguria,1550640,733456,47.3,0.14
830,2021-02-25,LIG,3459,1349,2110,3307,130,22,ITC,ITC3,7,Liguria,Liguria,1550640,736915,47.52,0.22
831,2021-04-23,LIG,14698,6653,8045,8461,6129,108,ITC,ITC3,7,Liguria,Liguria,1550640,751613,48.47,0.95
832,2021-03-11,LIG,6424,3103,3321,4359,2014,51,ITC,ITC3,7,Liguria,Liguria,1550640,758037,48.89,0.41
833,2021-01-13,LIG,2761,1016,1745,2760,0,1,ITC,ITC3,7,Liguria,Liguria,1550640,760798,49.06,0.18
834,2021-01-04,LIG,2624,857,1767,2623,0,1,ITC,ITC3,7,Liguria,Liguria,1550640,763422,49.23,0.17
835,2021-08-03,LIG,14131,7217,6914,3978,10063,90,ITC,ITC3,7,Liguria,Liguria,1550640,777553,50.14,0.91
836,2021-06-21,LIG,14845,7041,7804,8519,6253,73,ITC,ITC3,7,Liguria,Liguria,1550640,792398,51.1,0.96
837,2021-04-16,LIG,12011,5294,6717,10023,1832,156,ITC,ITC3,7,Liguria,Liguria,1550640,804409,51.88,0.77
838,2021-01-06,LIG,1666,618,1048,1663,0,3,ITC,ITC3,7,Liguria,Liguria,1550640,806075,51.98,0.11
839,2021-06-26,LIG,7224,3360,3864,4440,2719,65,ITC,ITC3,7,Liguria,Liguria,1550640,813299,52.45,0.47
840,2021-07-10,LIG,6905,3482,3423,2735,4132,38,ITC,ITC3,7,Liguria,Liguria,1550640,820204,52.89,0.45
841,2021-04-04,LIG,764,369,395,508,251,5,ITC,ITC3,7,Liguria,Liguria,1550640,820968,52.94,0.05
842,2021-04-18,LIG,2618,1165,1453,2094,469,55,ITC,ITC3,7,Liguria,Liguria,1550640,823586,53.11,0.17
843,2021-07-27,LIG,17432,8882,8550,4358,13000,74,ITC,ITC3,7,Liguria,Liguria,1550640,841018,54.24,1.12
844,2021-01-30,LIG,1666,572,1094,23,1642,1,ITC,ITC3,7,Liguria,Liguria,1550640,842684,54.34,0.11
845,2021-03-28,LIG,1142,511,631,382,752,8,ITC,ITC3,7,Liguria,Liguria,1550640,843826,54.42,0.07
846,2021-08-29,LIG,738,420,318,173,562,3,ITC,ITC3,7,Liguria,Liguria,1550640,844564,54.47,0.05
847,2021-06-28,LIG,11622,5622,6000,7228,4310,84,ITC,ITC3,7,Liguria,Liguria,1550640,856186,55.22,0.75
848,2021-03-20,LIG,2316,995,1321,1129,1174,13,ITC,ITC3,7,Liguria,Liguria,1550640,858502,55.36,0.15
849,2021-08-26,LIG,9011,4708,4303,2608,6340,63,ITC,ITC3,7,Liguria,Liguria,1550640,867513,55.95,0.58
850,2021-06-30,LIG,15094,7204,7890,8204,6815,75,ITC,ITC3,7,Liguria,Liguria,1550640,882607,56.92,0.97
851,2021-08-08,LIG,1208,650,558,545,659,4,ITC,ITC3,7,Liguria,Liguria,1550640,883815,57.0,0.08
852,2021-07-22,LIG,21442,10896,10546,4573,16770,99,ITC,ITC3,7,Liguria,Liguria,1550640,905257,58.38,1.38
853,2021-02-18,LIG,2772,1128,1644,2425,339,8,ITC,ITC3,7,Liguria,Liguria,1550640,908029,58.56,0.18
854,2021-05-14,LIG,13159,5868,7291,8635,4350,174,ITC,ITC3,7,Liguria,Liguria,1550640,921188,59.41,0.85
855,2021-08-22,LIG,760,441,319,175,579,6,ITC,ITC3,7,Liguria,Liguria,1550640,921948,59.46,0.05
856,2021-05-31,LIG,14729,7385,7344,9122,5525,82,ITC,ITC3,7,Liguria,Liguria,1550640,936677,60.41,0.95
857,2021-03-09,LIG,5939,2756,3183,4449,1432,58,ITC,ITC3,7,Liguria,Liguria,1550640,942616,60.79,0.38
858,2021-02-20,LIG,1337,639,698,1334,1,2,ITC,ITC3,7,Liguria,Liguria,1550640,943953,60.88,0.09
859,2021-08-07,LIG,5188,2648,2540,1114,4055,19,ITC,ITC3,7,Liguria,Liguria,1550640,949141,61.21,0.33
860,2021-05-16,LIG,3712,1863,1849,2119,1567,26,ITC,ITC3,7,Liguria,Liguria,1550640,952853,61.45,0.24
861,2021-08-24,LIG,8728,4527,4201,2915,5732,81,ITC,ITC3,7,Liguria,Liguria,1550640,961581,62.01,0.56
862,2021-02-22,LIG,3348,1478,1870,3196,143,9,ITC,ITC3,7,Liguria,Liguria,1550640,964929,62.23,0.22
863,2021-02-01,LIG,2574,929,1645,101,2473,0,ITC,ITC3,7,Liguria,Liguria,1550640,967503,62.39,0.17
864,2021-07-08,LIG,13658,6717,6941,6162,7409,87,ITC,ITC3,7,Liguria,Liguria,1550640,981161,63.27,0.88
865,2021-05-12,LIG,12120,5491,6629,6611,5408,101,ITC,ITC3,7,Liguria,Liguria,1550640,993281,64.06,0.78
866,2021-05-26,LIG,16698,8432,8266,12171,4382,145,ITC,ITC3,7,Liguria,Liguria,1550640,1009979,65.13,1.08
867,2021-03-30,LIG,12227,5432,6795,8752,3394,81,ITC,ITC3,7,Liguria,Liguria,1550640,1022206,65.92,0.79
868,2021-09-03,LIG,4920,2710,2210,1290,3589,41,ITC,ITC3,7,Liguria,Liguria,1550640,1027126,66.24,0.32
869,2021-08-17,LIG,9843,5165,4678,3647,6108,88,ITC,ITC3,7,Liguria,Liguria,1550640,1036969,66.87,0.63
870,2021-03-04,LIG,4744,2119,2625,3840,849,55,ITC,ITC3,7,Liguria,Liguria,1550640,1041713,67.18,0.31
871,2021-06-12,LIG,10259,4990,5269,7450,2760,49,ITC,ITC3,7,Liguria,Liguria,1550640,1051972,67.84,0.66
872,2021-04-30,LIG,14439,6451,7988,5773,8579,87,ITC,ITC3,7,Liguria,Liguria,1550640,1066411,68.77,0.93
873,2021-03-06,LIG,3305,1842,1463,2581,705,19,ITC,ITC3,7,Liguria,Liguria,1550640,1069716,68.99,0.21
874,2021-01-22,LIG,1828,606,1222,1337,489,2,ITC,ITC3,7,Liguria,Liguria,1550640,1071544,69.1,0.12
875,2021-05-02,LIG,3981,1837,2144,503,3472,6,ITC,ITC3,7,Liguria,Liguria,1550640,1075525,69.36,0.26
876,2021-02-06,LIG,1892,768,1124,145,1747,0,ITC,ITC3,7,Liguria,Liguria,1550640,1077417,69.48,0.12
877,2021-06-11,LIG,17869,9097,8772,11726,6082,61,ITC,ITC3,7,Liguria,Liguria,1550640,1095286,70.63,1.15
878,2021-04-15,LIG,11855,5242,6613,9893,1858,104,ITC,ITC3,7,Liguria,Liguria,1550640,1107141,71.4,0.76
879,2021-07-19,LIG,12110,6036,6074,3345,8695,70,ITC,ITC3,7,Liguria,Liguria,1550640,1119251,72.18,0.78
880,2021-08-05,LIG,14234,7354,6880,4116,10040,78,ITC,ITC3,7,Liguria,Liguria,1550640,1133485,73.1,0.92
881,2021-04-27,LIG,14822,6700,8122,7146,7609,67,ITC,ITC3,7,Liguria,Liguria,1550640,1148307,74.05,0.96
882,2021-02-03,LIG,2320,792,1528,51,2269,0,ITC,ITC3,7,Liguria,Liguria,1550640,1150627,74.2,0.15
883,2021-07-21,LIG,19201,9517,9684,3816,15314,71,ITC,ITC3,7,Liguria,Liguria,1550640,1169828,75.44,1.24
884,2021-04-29,LIG,15593,6984,8609,6647,8854,92,ITC,ITC3,7,Liguria,Liguria,1550640,1185421,76.45,1.01
885,2021-04-12,LIG,12394,5478,6916,10277,2022,95,ITC,ITC3,7,Liguria,Liguria,1550640,1197815,77.25,0.8
886,2021-01-08,LIG,2940,1001,1939,2938,0,2,ITC,ITC3,7,Liguria,Liguria,1550640,1200755,77.44,0.19
887,2021-01-27,LIG,1748,604,1144,139,1608,1,ITC,ITC3,7,Liguria,Liguria,1550640,1202503,77.55,0.11
888,2021-05-21,LIG,12870,5968,6902,9602,3136,132,ITC,ITC3,7,Liguria,Liguria,1550640,1215373,78.38,0.83
889,2021-02-27,LIG,1888,921,967,1755,129,4,ITC,ITC3,7,Liguria,Liguria,1550640,1217261,78.5,0.12
890,2021-06-16,LIG,16394,7923,8471,9203,7120,71,ITC,ITC3,7,Liguria,Liguria,1550640,1233655,79.56,1.06
891,2021-03-08,LIG,5631,2462,3169,3907,1692,32,ITC,ITC3,7,Liguria,Liguria,1550640,1239286,79.92,0.36
892,2021-03-25,LIG,9783,4235,5548,6245,3396,142,ITC,ITC3,7,Liguria,Liguria,1550640,1249069,80.55,0.63
893,2021-01-01,LIG,146,56,90,146,0,0,ITC,ITC3,7,Liguria,Liguria,1550640,1249215,80.56,0.01
894,2021-01-15,LIG,2264,756,1508,2259,0,5,ITC,ITC3,7,Liguria,Liguria,1550640,1251479,80.71,0.15
895,2021-04-25,LIG,1936,921,1015,1509,415,12,ITC,ITC3,7,Liguria,Liguria,1550640,1253415,80.83,0.12
896,2021-03-13,LIG,3852,1638,2214,2964,858,30,ITC,ITC3,7,Liguria,Liguria,1550640,1257267,81.08,0.25
897,2021-06-23,LIG,14350,6865,7485,9063,5208,79,ITC,ITC3,7,Liguria,Liguria,1550640,1271617,82.01,0.93
898,2021-02-14,LIG,233,122,111,233,0,0,ITC,ITC3,7,Liguria,Liguria,1550640,1271850,82.02,0.02
899,2021-05-25,LIG,14280,6959,7321,10961,3193,126,ITC,ITC3,7,Liguria,Liguria,1550640,1286130,82.94,0.92
900,2021-03-22,LIG,7759,3476,4283,4743,2943,73,ITC,ITC3,7,Liguria,Liguria,1550640,1293889,83.44,0.5
901,2021-02-07,LIG,407,153,254,2,405,0,ITC,ITC3,7,Liguria,Liguria,1550640,1294296,83.47,0.03
902,2021-05-18,LIG,13502,6136,7366,10061,3315,126,ITC,ITC3,7,Liguria,Liguria,1550640,1307798,84.34,0.87
903,2021-04-06,LIG,13265,5904,7361,10894,2265,106,ITC,ITC3,7,Liguria,Liguria,1550640,1321063,85.19,0.86
904,2021-02-08,LIG,1983,744,1239,299,1684,0,ITC,ITC3,7,Liguria,Liguria,1550640,1323046,85.32,0.13
905,2020-12-27,LIG,135,56,79,134,0,1,ITC,ITC3,7,Liguria,Liguria,1550640,1323181,85.33,0.01
906,2021-02-15,LIG,2264,839,1425,1854,399,11,ITC,ITC3,7,Liguria,Liguria,1550640,1325445,85.48,0.15
907,2021-01-03,LIG,737,232,505,735,0,2,ITC,ITC3,7,Liguria,Liguria,1550640,1326182,85.52,0.05
908,2021-02-10,LIG,2324,839,1485,1016,1305,3,ITC,ITC3,7,Liguria,Liguria,1550640,1328506,85.67,0.15
909,2021-08-14,LIG,3200,1708,1492,895,2289,16,ITC,ITC3,7,Liguria,Liguria,1550640,1331706,85.88,0.21
910,2021-03-18,LIG,4991,2125,2866,1978,2983,30,ITC,ITC3,7,Liguria,Liguria,1550640,1336697,86.2,0.32
911,2021-04-01,LIG,12440,5517,6923,9586,2776,78,ITC,ITC3,7,Liguria,Liguria,1550640,1349137,87.01,0.8
912,2021-01-19,LIG,1376,441,935,1282,90,4,ITC,ITC3,7,Liguria,Liguria,1550640,1350513,87.09,0.09
913,2021-02-05,LIG,2740,994,1746,299,2440,1,ITC,ITC3,7,Liguria,Liguria,1550640,1353253,87.27,0.18
914,2021-03-24,LIG,9193,4038,5155,5823,3290,80,ITC,ITC3,7,Liguria,Liguria,1550640,1362446,87.86,0.59
915,2021-07-02,LIG,12990,6374,6616,6386,6516,88,ITC,ITC3,7,Liguria,Liguria,1550640,1375436,88.7,0.84
916,2020-12-31,LIG,990,352,638,990,0,0,ITC,ITC3,7,Liguria,Liguria,1550640,1376426,88.77,0.06
917,2021-04-10,LIG,7894,3564,4330,6905,914,75,ITC,ITC3,7,Liguria,Liguria,1550640,1384320,89.27,0.51
918,2021-01-17,LIG,866,301,565,865,0,1,ITC,ITC3,7,Liguria,Liguria,1550640,1385186,89.33,0.06
919,2021-05-04,LIG,13663,6095,7568,5361,8236,66,ITC,ITC3,7,Liguria,Liguria,1550640,1398849,90.21,0.88
920,2021-08-12,LIG,12527,6442,6085,4599,7842,86,ITC,ITC3,7,Liguria,Liguria,1550640,1411376,91.02,0.81
921,2021-05-09,LIG,2826,1244,1582,1085,1711,30,ITC,ITC3,7,Liguria,Liguria,1550640,1414202,91.2,0.18
922,2021-01-29,LIG,3101,1070,2031,64,3037,0,ITC,ITC3,7,Liguria,Liguria,1550640,1417303,91.4,0.2
923,2021-07-26,LIG,17653,9005,8648,4713,12847,93,ITC,ITC3,7,Liguria,Liguria,1550640,1434956,92.54,1.14
924,2021-01-07,LIG,3228,1097,2131,3225,0,3,ITC,ITC3,7,Liguria,Liguria,1550640,1438184,92.75,0.21
925,2021-06-13,LIG,5640,2705,2935,5138,456,46,ITC,ITC3,7,Liguria,Liguria,1550640,1443824,93.11,0.36
926,2021-04-17,LIG,7390,3218,4172,6581,753,56,ITC,ITC3,7,Liguria,Liguria,1550640,1451214,93.59,0.48
927,2021-05-01,LIG,7153,3260,3893,1314,5809,30,ITC,ITC3,7,Liguria,Liguria,1550640,1458367,94.05,0.46
928,2021-03-05,LIG,4873,2153,2720,3690,1136,47,ITC,ITC3,7,Liguria,Liguria,1550640,1463240,94.36,0.31
929,2021-08-09,LIG,11981,6088,5893,4340,7525,116,ITC,ITC3,7,Liguria,Liguria,1550640,1475221,95.14,0.77
930,2021-06-06,LIG,3814,2032,1782,2940,862,12,ITC,ITC3,7,Liguria,Liguria,1550640,1479035,95.38,0.25
931,2021-04-24,LIG,8220,3798,4422,4983,3155,82,ITC,ITC3,7,Liguria,Liguria,1550640,1487255,95.91,0.53
932,2021-02-26,LIG,3771,1526,2245,3417,329,25,ITC,ITC3,7,Liguria,Liguria,1550640,1491026,96.16,0.24
933,2021-08-02,LIG,13095,6511,6584,2972,10048,75,ITC,ITC3,7,Liguria,Liguria,1550640,1504121,97.0,0.84
934,2021-06-20,LIG,1335,658,677,1044,275,16,ITC,ITC3,7,Liguria,Liguria,1550640,1505456,97.09,0.09
935,2021-01-20,LIG,1560,557,1003,1547,12,1,ITC,ITC3,7,Liguria,Liguria,1550640,1507016,97.19,0.1
936,2021-08-19,LIG,9814,5167,4647,2715,7007,92,ITC,ITC3,7,Liguria,Liguria,1550640,1516830,97.82,0.63
937,2021-08-28,LIG,4128,2336,1792,1009,3098,21,ITC,ITC3,7,Liguria,Liguria,1550640,1520958,98.09,0.27
938,2021-05-20,LIG,12950,6010,6940,8790,4039,121,ITC,ITC3,7,Liguria,Liguria,1550640,1533908,98.92,0.84
939,2021-07-09,LIG,12844,6330,6514,4191,8589,64,ITC,ITC3,7,Liguria,Liguria,1550640,1546752,99.75,0.83
940,2021-04-05,LIG,3985,1757,2228,2313,1651,21,ITC,ITC3,7,Liguria,Liguria,1550640,1550737,100.01,0.26
941,2021-07-16,LIG,12628,6223,6405,3137,9438,53,ITC,ITC3,7,Liguria,Liguria,1550640,1563365,100.82,0.81
942,2021-05-11,LIG,13940,6399,7541,7199,6630,111,ITC,ITC3,7,Liguria,Liguria,1550640,1577305,101.72,0.9
943,2021-03-29,LIG,10593,4628,5965,7363,3135,95,ITC,ITC3,7,Liguria,Liguria,1550640,1587898,102.4,0.68
944,2021-01-31,LIG,624,270,354,4,620,0,ITC,ITC3,7,Liguria,Liguria,1550640,1588522,102.44,0.04
945,2021-07-07,LIG,11784,5647,6137,4930,6783,71,ITC,ITC3,7,Liguria,Liguria,1550640,1600306,103.2,0.76
946,2021-09-02,LIG,8432,4496,3936,2849,5513,70,ITC,ITC3,7,Liguria,Liguria,1550640,1608738,103.75,0.54
947,2021-06-08,LIG,18124,9041,9083,11405,6652,67,ITC,ITC3,7,Liguria,Liguria,1550640,1626862,104.92,1.17
948,2021-03-17,LIG,5559,2371,3188,2455,3085,19,ITC,ITC3,7,Liguria,Liguria,1550640,1632421,105.27,0.36
949,2021-06-25,LIG,13852,6622,7230,6870,6922,60,ITC,ITC3,7,Liguria,Liguria,1550640,1646273,106.17,0.89
950,2021-07-14,LIG,11523,5673,5850,3430,8029,64,ITC,ITC3,7,Liguria,Liguria,1550640,1657796,106.91,0.74
951,2021-03-27,LIG,3934,1549,2385,2514,1397,23,ITC,ITC3,7,Liguria,Liguria,1550640,1661730,107.16,0.25
952,2021-07-05,LIG,11925,5776,6149,5317,6537,71,ITC,ITC3,7,Liguria,Liguria,1550640,1673655,107.93,0.77
953,2021-04-13,LIG,13090,5875,7215,10950,2029,111,ITC,ITC3,7,Liguria,Liguria,1550640,1686745,108.78,0.84
954,2021-07-28,LIG,18467,9512,8955,5803,12544,120,ITC,ITC3,7,Liguria,Liguria,1550640,1705212,109.97,1.19
955,2021-05-06,LIG,14542,6446,8096,6072,8342,128,ITC,ITC3,7,Liguria,Liguria,1550640,1719754,110.91,0.94
956,2021-01-26,LIG,2490,809,1681,16,2474,0,ITC,ITC3,7,Liguria,Liguria,1550640,1722244,111.07,0.16
957,2021-04-08,LIG,13796,6185,7611,11612,2049,135,ITC,ITC3,7,Liguria,Liguria,1550640,1736040,111.96,0.89
958,2021-07-17,LIG,6515,3361,3154,1806,4696,13,ITC,ITC3,7,Liguria,Liguria,1550640,1742555,112.38,0.42
959,2021-07-31,LIG,8261,4412,3849,1313,6924,24,ITC,ITC3,7,Liguria,Liguria,1550640,1750816,112.91,0.53
960,2021-06-04,LIG,14802,7268,7534,9241,5499,62,ITC,ITC3,7,Liguria,Liguria,1550640,1765618,113.86,0.95
961,2021-02-17,LIG,2701,1185,1516,2254,435,12,ITC,ITC3,7,Liguria,Liguria,1550640,1768319,114.04,0.17
962,2021-07-24,LIG,11604,6036,5568,2313,9245,46,ITC,ITC3,7,Liguria,Liguria,1550640,1779923,114.79,0.75
963,2021-05-28,LIG,16326,8157,8169,11623,4558,145,ITC,ITC3,7,Liguria,Liguria,1550640,1796249,115.84,1.05
964,2021-01-05,LIG,2879,896,1983,2879,0,0,ITC,ITC3,7,Liguria,Liguria,1550640,1799128,116.02,0.19
965,2021-03-03,LIG,4583,1848,2735,3445,1029,109,ITC,ITC3,7,Liguria,Liguria,1550640,1803711,116.32,0.3
966,2021-08-04,LIG,13851,6972,6879,3260,10487,104,ITC,ITC3,7,Liguria,Liguria,1550640,1817562,117.21,0.89
967,2021-02-24,LIG,3768,1561,2207,3457,259,52,ITC,ITC3,7,Liguria,Liguria,1550640,1821330,117.46,0.24
968,2020-12-29,LIG,125,33,92,125,0,0,ITC,ITC3,7,Liguria,Liguria,1550640,1821455,117.46,0.01
969,2021-01-12,LIG,2476,890,1586,2475,0,1,ITC,ITC3,7,Liguria,Liguria,1550640,1823931,117.62,0.16
970,2021-04-22,LIG,13879,6216,7663,8656,5089,134,ITC,ITC3,7,Liguria,Liguria,1550640,1837810,118.52,0.9
971,2021-08-21,LIG,3057,1662,1395,897,2116,44,ITC,ITC3,7,Liguria,Liguria,1550640,1840867,118.72,0.2
972,2021-05-13,LIG,13327,6092,7235,8896,4272,159,ITC,ITC3,7,Liguria,Liguria,1550640,1854194,119.58,0.86
973,2021-02-19,LIG,3223,1307,1916,3033,176,14,ITC,ITC3,7,Liguria,Liguria,1550640,1857417,119.78,0.21
974,2021-05-30,LIG,3307,1614,1693,1338,1946,23,ITC,ITC3,7,Liguria,Liguria,1550640,1860724,120.0,0.21
975,2021-08-23,LIG,10526,5490,5036,3519,6913,94,ITC,ITC3,7,Liguria,Liguria,1550640,1871250,120.68,0.68
976,2021-06-01,LIG,16350,8232,8118,10922,5376,52,ITC,ITC3,7,Liguria,Liguria,1550640,1887600,121.73,1.05
977,2021-06-18,LIG,15423,7507,7916,8124,7222,77,ITC,ITC3,7,Liguria,Liguria,1550640,1903023,122.73,0.99
978,2021-03-10,LIG,5925,2869,3056,3953,1917,55,ITC,ITC3,7,Liguria,Liguria,1550640,1908948,123.11,0.38
979,2021-07-29,LIG,17980,9197,8783,4406,13500,74,ITC,ITC3,7,Liguria,Liguria,1550640,1926928,124.27,1.16
980,2021-03-16,LIG,6090,2732,3358,2317,3735,38,ITC,ITC3,7,Liguria,Liguria,1550640,1933018,124.66,0.39
981,2021-01-11,LIG,2658,994,1664,2656,0,2,ITC,ITC3,7,Liguria,Liguria,1550640,1935676,124.83,0.17
982,2021-07-12,LIG,13432,6442,6990,4143,9234,55,ITC,ITC3,7,Liguria,Liguria,1550640,1949108,125.7,0.87
983,2021-01-10,LIG,651,264,387,647,0,4,ITC,ITC3,7,Liguria,Liguria,1550640,1949759,125.74,0.04
984,2021-04-20,LIG,14253,6524,7729,9743,4359,151,ITC,ITC3,7,Liguria,Liguria,1550640,1964012,126.66,0.92
985,2021-08-31,LIG,9520,5024,4496,2634,6831,55,ITC,ITC3,7,Liguria,Liguria,1550640,1973532,127.27,0.61
986,2021-05-23,LIG,2310,1121,1189,1172,1124,14,ITC,ITC3,7,Liguria,Liguria,1550640,1975842,127.42,0.15
987,2021-03-01,LIG,3541,1447,2094,3386,136,19,ITC,ITC3,7,Liguria,Liguria,1550640,1979383,127.65,0.23
988,2021-06-09,LIG,19096,9581,9515,12440,6588,68,ITC,ITC3,7,Liguria,Liguria,1550640,1998479,128.88,1.23
989,2021-04-03,LIG,5410,2500,2910,4435,944,31,ITC,ITC3,7,Liguria,Liguria,1550640,2003889,129.23,0.35
990,2021-01-24,LIG,761,241,520,116,645,0,ITC,ITC3,7,Liguria,Liguria,1550640,2004650,129.28,0.05
991,2021-06-27,LIG,1950,895,1055,684,1252,14,ITC,ITC3,7,Liguria,Liguria,1550640,2006600,129.4,0.13
992,2021-02-12,LIG,1942,692,1250,896,1045,1,ITC,ITC3,7,Liguria,Liguria,1550640,2008542,129.53,0.13
993,2021-08-16,LIG,9913,5127,4786,3770,6045,98,ITC,ITC3,7,Liguria,Liguria,1550640,2018455,130.17,0.64
994,2021-03-15,LIG,7369,3122,4247,4502,2820,47,ITC,ITC3,7,Liguria,Liguria,1550640,2025824,130.64,0.48
995,2021-03-28,LOM,20640,7882,12758,13968,6287,385,ITC,ITC4,3,Lombardia,Lombardia,10060574,20640,0.21,0.21
996,2021-04-14,LOM,47238,21049,26189,33539,12986,713,ITC,ITC4,3,Lombardia,Lombardia,10060574,67878,0.67,0.47
997,2021-01-04,LOM,6134,2119,4015,6127,0,7,ITC,ITC4,3,Lombardia,Lombardia,10060574,74012,0.74,0.06
998,2021-06-19,LOM,104404,52031,52373,56230,46752,1422,ITC,ITC4,3,Lombardia,Lombardia,10060574,178416,1.77,1.04
999,2021-07-06,LOM,102173,50884,51289,23097,77660,1416,ITC,ITC4,3,Lombardia,Lombardia,10060574,280589,2.79,1.02
1000,2021-08-06,LOM,85591,46644,38947,17788,66948,855,ITC,ITC4,3,Lombardia,Lombardia,10060574,366180,3.64,0.85
1001,2021-04-28,LOM,95808,43693,52115,66892,26947,1969,ITC,ITC4,3,Lombardia,Lombardia,10060574,461988,4.59,0.95
1002,2021-06-24,LOM,109769,56742,53027,78380,29010,2379,ITC,ITC4,3,Lombardia,Lombardia,10060574,571757,5.68,1.09
1003,2021-03-16,LOM,25536,10131,15405,16307,9107,122,ITC,ITC4,3,Lombardia,Lombardia,10060574,597293,5.94,0.25
1004,2021-05-12,LOM,87569,41776,45793,57283,27607,2679,ITC,ITC4,3,Lombardia,Lombardia,10060574,684862,6.81,0.87
1005,2021-07-20,LOM,95027,49095,45932,6920,87368,739,ITC,ITC4,3,Lombardia,Lombardia,10060574,779889,7.75,0.94
1006,2021-02-04,LOM,28015,8168,19847,2048,25962,5,ITC,ITC4,3,Lombardia,Lombardia,10060574,807904,8.03,0.28
1007,2021-07-18,LOM,97109,50596,46513,8547,87868,694,ITC,ITC4,3,Lombardia,Lombardia,10060574,905013,9.0,0.97
1008,2021-04-09,LOM,52453,22394,30059,35589,16022,842,ITC,ITC4,3,Lombardia,Lombardia,10060574,957466,9.52,0.52
1009,2021-07-13,LOM,108716,56844,51872,15457,92024,1235,ITC,ITC4,3,Lombardia,Lombardia,10060574,1066182,10.6,1.08
1010,2021-04-04,LOM,7615,3232,4383,3682,3899,34,ITC,ITC4,3,Lombardia,Lombardia,10060574,1073797,10.67,0.08
1011,2021-08-27,LOM,35739,19221,16518,18534,14619,2586,ITC,ITC4,3,Lombardia,Lombardia,10060574,1109536,11.03,0.36
1012,2021-06-05,LOM,102447,52962,49485,91103,9831,1513,ITC,ITC4,3,Lombardia,Lombardia,10060574,1211983,12.05,1.02
1013,2021-03-14,LOM,14883,5349,9534,11216,3290,377,ITC,ITC4,3,Lombardia,Lombardia,10060574,1226866,12.19,0.15
1014,2021-02-16,LOM,9528,3081,6447,8976,451,101,ITC,ITC4,3,Lombardia,Lombardia,10060574,1236394,12.29,0.09
1015,2021-06-10,LOM,102730,52272,50458,86430,14499,1801,ITC,ITC4,3,Lombardia,Lombardia,10060574,1339124,13.31,1.02
1016,2021-03-02,LOM,22842,9711,13131,19530,3047,265,ITC,ITC4,3,Lombardia,Lombardia,10060574,1361966,13.54,0.23
1017,2021-08-20,LOM,27113,15002,12111,14128,11890,1095,ITC,ITC4,3,Lombardia,Lombardia,10060574,1389079,13.81,0.27
1018,2021-08-01,LOM,53141,28434,24707,27338,24264,1539,ITC,ITC4,3,Lombardia,Lombardia,10060574,1442220,14.34,0.53
1019,2021-04-23,LOM,73634,33367,40267,55553,16651,1430,ITC,ITC4,3,Lombardia,Lombardia,10060574,1515854,15.07,0.73
1020,2021-09-01,LOM,60201,32349,27852,30536,25934,3731,ITC,ITC4,3,Lombardia,Lombardia,10060574,1576055,15.67,0.6
1021,2021-05-24,LOM,89624,43528,46096,48602,40085,937,ITC,ITC4,3,Lombardia,Lombardia,10060574,1665679,16.56,0.89
1022,2021-02-11,LOM,17133,5024,12109,9636,7418,79,ITC,ITC4,3,Lombardia,Lombardia,10060574,1682812,16.73,0.17
1023,2021-05-31,LOM,95744,47432,48312,78389,16252,1103,ITC,ITC4,3,Lombardia,Lombardia,10060574,1778556,17.68,0.95
1024,2021-01-16,LOM,15646,5786,9860,15635,0,11,ITC,ITC4,3,Lombardia,Lombardia,10060574,1794202,17.83,0.16
1025,2021-08-15,LOM,7000,3988,3012,2933,3884,183,ITC,ITC4,3,Lombardia,Lombardia,10060574,1801202,17.9,0.07
1026,2021-06-17,LOM,108659,52751,55908,50451,57029,1179,ITC,ITC4,3,Lombardia,Lombardia,10060574,1909861,18.98,1.08
1027,2021-03-09,LOM,33266,12882,20384,25249,7422,595,ITC,ITC4,3,Lombardia,Lombardia,10060574,1943127,19.31,0.33
1028,2021-08-13,LOM,53444,29607,23837,20521,31656,1267,ITC,ITC4,3,Lombardia,Lombardia,10060574,1996571,19.85,0.53
1029,2021-05-05,LOM,88136,42018,46118,70428,15360,2348,ITC,ITC4,3,Lombardia,Lombardia,10060574,2084707,20.72,0.88
1030,2021-07-01,LOM,105137,52890,52247,53340,49395,2402,ITC,ITC4,3,Lombardia,Lombardia,10060574,2189844,21.77,1.05
1031,2021-07-08,LOM,114708,58456,56252,13231,100450,1027,ITC,ITC4,3,Lombardia,Lombardia,10060574,2304552,22.91,1.14
1032,2021-07-25,LOM,86645,45738,40907,9429,76435,781,ITC,ITC4,3,Lombardia,Lombardia,10060574,2391197,23.77,0.86
1033,2021-04-16,LOM,53731,23940,29791,38418,14395,918,ITC,ITC4,3,Lombardia,Lombardia,10060574,2444928,24.3,0.53
1034,2021-05-03,LOM,83754,39786,43968,69446,12142,2166,ITC,ITC4,3,Lombardia,Lombardia,10060574,2528682,25.13,0.83
1035,2021-01-23,LOM,1127,361,766,925,199,3,ITC,ITC4,3,Lombardia,Lombardia,10060574,2529809,25.15,0.01
1036,2021-05-10,LOM,85349,40929,44420,61564,21600,2185,ITC,ITC4,3,Lombardia,Lombardia,10060574,2615158,25.99,0.85
1037,2021-01-30,LOM,12357,4585,7772,146,12202,9,ITC,ITC4,3,Lombardia,Lombardia,10060574,2627515,26.12,0.12
1038,2021-06-12,LOM,89328,48066,41262,84311,3174,1843,ITC,ITC4,3,Lombardia,Lombardia,10060574,2716843,27.0,0.89
1039,2021-02-23,LOM,11834,4807,7027,11292,332,210,ITC,ITC4,3,Lombardia,Lombardia,10060574,2728677,27.12,0.12
1040,2021-08-08,LOM,58838,31955,26883,16681,41363,794,ITC,ITC4,3,Lombardia,Lombardia,10060574,2787515,27.71,0.58
1041,2021-08-25,LOM,44515,24045,20470,21654,19751,3110,ITC,ITC4,3,Lombardia,Lombardia,10060574,2832030,28.15,0.44
1042,2021-05-17,LOM,94694,45375,49319,29505,64440,749,ITC,ITC4,3,Lombardia,Lombardia,10060574,2926724,29.09,0.94
1043,2021-04-02,LOM,41417,16952,24465,26214,14648,555,ITC,ITC4,3,Lombardia,Lombardia,10060574,2968141,29.5,0.41
1044,2021-08-12,LOM,56899,31254,25645,21999,33520,1380,ITC,ITC4,3,Lombardia,Lombardia,10060574,3025040,30.07,0.57
1045,2020-12-28,LOM,108,47,61,108,0,0,ITC,ITC4,3,Lombardia,Lombardia,10060574,3025148,30.07,0.0
1046,2021-04-21,LOM,71887,32583,39304,55817,14699,1371,ITC,ITC4,3,Lombardia,Lombardia,10060574,3097035,30.78,0.71
1047,2021-01-11,LOM,16312,5391,10921,16302,0,10,ITC,ITC4,3,Lombardia,Lombardia,10060574,3113347,30.95,0.16
1048,2021-01-28,LOM,12273,3722,8551,795,11471,7,ITC,ITC4,3,Lombardia,Lombardia,10060574,3125620,31.07,0.12
1049,2021-09-03,LOM,35746,19245,16501,13637,20736,1373,ITC,ITC4,3,Lombardia,Lombardia,10060574,3161366,31.42,0.36
1050,2021-07-27,LOM,104939,56845,48094,7482,96755,702,ITC,ITC4,3,Lombardia,Lombardia,10060574,3266305,32.47,1.04
1051,2021-03-26,LOM,41376,15729,25647,27506,13190,680,ITC,ITC4,3,Lombardia,Lombardia,10060574,3307681,32.88,0.41
1052,2021-05-22,LOM,70678,33867,36811,31727,38235,716,ITC,ITC4,3,Lombardia,Lombardia,10060574,3378359,33.58,0.7
1053,2021-05-29,LOM,88393,42441,45952,41397,46152,844,ITC,ITC4,3,Lombardia,Lombardia,10060574,3466752,34.46,0.88
1054,2021-02-18,LOM,14063,4930,9133,12826,1038,199,ITC,ITC4,3,Lombardia,Lombardia,10060574,3480815,34.6,0.14
1055,2021-01-09,LOM,12507,4612,7895,12499,0,8,ITC,ITC4,3,Lombardia,Lombardia,10060574,3493322,34.72,0.12
1056,2021-03-07,LOM,12097,5365,6732,9339,2563,195,ITC,ITC4,3,Lombardia,Lombardia,10060574,3505419,34.84,0.12
1057,2021-01-27,LOM,8072,2687,5385,807,7263,2,ITC,ITC4,3,Lombardia,Lombardia,10060574,3513491,34.92,0.08
1058,2021-07-03,LOM,102513,51719,50794,44538,55865,2110,ITC,ITC4,3,Lombardia,Lombardia,10060574,3616004,35.94,1.02
1059,2021-03-25,LOM,43044,16094,26950,29252,12879,913,ITC,ITC4,3,Lombardia,Lombardia,10060574,3659048,36.37,0.43
1060,2021-08-29,LOM,25188,13529,11659,12727,11160,1301,ITC,ITC4,3,Lombardia,Lombardia,10060574,3684236,36.62,0.25
1061,2021-05-21,LOM,93932,45280,48652,28391,64780,761,ITC,ITC4,3,Lombardia,Lombardia,10060574,3778168,37.55,0.93
1062,2021-01-18,LOM,9267,2991,6276,8277,975,15,ITC,ITC4,3,Lombardia,Lombardia,10060574,3787435,37.65,0.09
1063,2021-03-23,LOM,42635,15492,27143,28865,12905,865,ITC,ITC4,3,Lombardia,Lombardia,10060574,3830070,38.07,0.42
1064,2021-08-24,LOM,47554,25876,21678,24448,19467,3639,ITC,ITC4,3,Lombardia,Lombardia,10060574,3877624,38.54,0.47
1065,2021-06-21,LOM,113384,58086,55298,78281,32930,2173,ITC,ITC4,3,Lombardia,Lombardia,10060574,3991008,39.67,1.13
1066,2021-06-02,LOM,84703,43613,41090,76988,6395,1320,ITC,ITC4,3,Lombardia,Lombardia,10060574,4075711,40.51,0.84
1067,2021-03-11,LOM,36276,13502,22774,25637,9952,687,ITC,ITC4,3,Lombardia,Lombardia,10060574,4111987,40.87,0.36
1068,2021-06-29,LOM,107315,53218,54097,57430,47878,2007,ITC,ITC4,3,Lombardia,Lombardia,10060574,4219302,41.94,1.07
1069,2021-03-21,LOM,23522,8499,15023,17727,5197,598,ITC,ITC4,3,Lombardia,Lombardia,10060574,4242824,42.17,0.23
1070,2021-02-13,LOM,6427,2445,3982,4887,1479,61,ITC,ITC4,3,Lombardia,Lombardia,10060574,4249251,42.24,0.06
1071,2021-07-17,LOM,108506,57294,51212,10220,97360,926,ITC,ITC4,3,Lombardia,Lombardia,10060574,4357757,43.32,1.08
1072,2021-01-13,LOM,26481,8099,18382,26456,0,25,ITC,ITC4,3,Lombardia,Lombardia,10060574,4384238,43.58,0.26
1073,2021-05-19,LOM,83305,39787,43518,33120,49374,811,ITC,ITC4,3,Lombardia,Lombardia,10060574,4467543,44.41,0.83
1074,2021-02-08,LOM,10134,2935,7199,2125,8001,8,ITC,ITC4,3,Lombardia,Lombardia,10060574,4477677,44.51,0.1
1075,2021-02-25,LOM,15358,6371,8987,13536,1622,200,ITC,ITC4,3,Lombardia,Lombardia,10060574,4493035,44.66,0.15
1076,2021-02-06,LOM,15309,5556,9753,1014,14290,5,ITC,ITC4,3,Lombardia,Lombardia,10060574,4508344,44.81,0.15
1077,2021-04-11,LOM,32228,13946,18282,24319,7397,512,ITC,ITC4,3,Lombardia,Lombardia,10060574,4540572,45.13,0.32
1078,2021-01-01,LOM,24,7,17,24,0,0,ITC,ITC4,3,Lombardia,Lombardia,10060574,4540596,45.13,0.0
1079,2021-06-07,LOM,99040,50445,48595,84033,13382,1625,ITC,ITC4,3,Lombardia,Lombardia,10060574,4639636,46.12,0.98
1080,2021-02-27,LOM,13955,5876,8079,13153,645,157,ITC,ITC4,3,Lombardia,Lombardia,10060574,4653591,46.26,0.14
1081,2020-12-30,LOM,115,42,73,115,0,0,ITC,ITC4,3,Lombardia,Lombardia,10060574,4653706,46.26,0.0
1082,2021-06-16,LOM,99371,50478,48893,49859,48361,1151,ITC,ITC4,3,Lombardia,Lombardia,10060574,4753077,47.24,0.99
1083,2021-07-29,LOM,74424,40429,33995,33776,38696,1952,ITC,ITC4,3,Lombardia,Lombardia,10060574,4827501,47.98,0.74
1084,2021-02-20,LOM,9371,3872,5499,8846,328,197,ITC,ITC4,3,Lombardia,Lombardia,10060574,4836872,48.08,0.09
1085,2021-04-18,LOM,36441,16242,20199,30529,5246,666,ITC,ITC4,3,Lombardia,Lombardia,10060574,4873313,48.44,0.36
1086,2021-01-08,LOM,12755,3940,8815,12744,0,11,ITC,ITC4,3,Lombardia,Lombardia,10060574,4886068,48.57,0.13
1087,2021-08-05,LOM,90298,49276,41022,15761,73745,792,ITC,ITC4,3,Lombardia,Lombardia,10060574,4976366,49.46,0.9
1088,2021-03-04,LOM,29375,12135,17240,20066,9087,222,ITC,ITC4,3,Lombardia,Lombardia,10060574,5005741,49.76,0.29
1089,2021-05-07,LOM,92475,43767,48708,68011,22462,2002,ITC,ITC4,3,Lombardia,Lombardia,10060574,5098216,50.68,0.92
1090,2021-03-18,LOM,27462,10982,16480,15939,11296,227,ITC,ITC4,3,Lombardia,Lombardia,10060574,5125678,50.95,0.27
1091,2021-08-22,LOM,18212,10166,8046,7603,10067,542,ITC,ITC4,3,Lombardia,Lombardia,10060574,5143890,51.13,0.18
1092,2021-05-14,LOM,86046,41436,44610,53157,30368,2521,ITC,ITC4,3,Lombardia,Lombardia,10060574,5229936,51.98,0.86
1093,2021-01-15,LOM,25290,7456,17834,25238,0,52,ITC,ITC4,3,Lombardia,Lombardia,10060574,5255226,52.24,0.25
1094,2021-08-07,LOM,79724,43276,36448,16072,62847,805,ITC,ITC4,3,Lombardia,Lombardia,10060574,5334950,53.03,0.79
1095,2021-04-29,LOM,115657,53635,62022,83090,29912,2655,ITC,ITC4,3,Lombardia,Lombardia,10060574,5450607,54.18,1.15
1096,2021-06-25,LOM,108333,56259,52074,78362,27664,2307,ITC,ITC4,3,Lombardia,Lombardia,10060574,5558940,55.25,1.08
1097,2021-04-20,LOM,67722,30858,36864,55898,10359,1465,ITC,ITC4,3,Lombardia,Lombardia,10060574,5626662,55.93,0.67
1098,2021-01-10,LOM,10556,3982,6574,10547,0,9,ITC,ITC4,3,Lombardia,Lombardia,10060574,5637218,56.03,0.1
1099,2021-07-24,LOM,95887,50661,45226,9751,85279,857,ITC,ITC4,3,Lombardia,Lombardia,10060574,5733105,56.99,0.95
1100,2021-08-10,LOM,61457,33262,28195,18704,41687,1066,ITC,ITC4,3,Lombardia,Lombardia,10060574,5794562,57.6,0.61
1101,2021-05-02,LOM,83549,38354,45195,59232,22480,1837,ITC,ITC4,3,Lombardia,Lombardia,10060574,5878111,58.43,0.83
1102,2021-07-22,LOM,99404,52037,47367,12510,85441,1453,ITC,ITC4,3,Lombardia,Lombardia,10060574,5977515,59.42,0.99
1103,2021-04-13,LOM,47693,21287,26406,32927,14107,659,ITC,ITC4,3,Lombardia,Lombardia,10060574,6025208,59.89,0.47
1104,2021-04-30,LOM,117543,54897,62646,87200,27682,2661,ITC,ITC4,3,Lombardia,Lombardia,10060574,6142751,61.06,1.17
1105,2021-01-20,LOM,5713,1392,4321,5593,115,5,ITC,ITC4,3,Lombardia,Lombardia,10060574,6148464,61.11,0.06
1106,2021-03-30,LOM,39736,15633,24103,24258,14863,615,ITC,ITC4,3,Lombardia,Lombardia,10060574,6188200,61.51,0.39
1107,2021-01-06,LOM,7167,2531,4636,7161,0,6,ITC,ITC4,3,Lombardia,Lombardia,10060574,6195367,61.58,0.07
1108,2021-08-26,LOM,38676,20777,17899,20343,15540,2793,ITC,ITC4,3,Lombardia,Lombardia,10060574,6234043,61.97,0.38
1109,2021-05-18,LOM,88251,42174,46077,31857,55591,803,ITC,ITC4,3,Lombardia,Lombardia,10060574,6322294,62.84,0.88
1110,2021-06-04,LOM,104652,54322,50330,93204,9662,1786,ITC,ITC4,3,Lombardia,Lombardia,10060574,6426946,63.88,1.04
1111,2021-02-24,LOM,14728,5961,8767,13576,958,194,ITC,ITC4,3,Lombardia,Lombardia,10060574,6441674,64.03,0.15
1112,2021-05-16,LOM,68740,32518,36222,35547,32234,959,ITC,ITC4,3,Lombardia,Lombardia,10060574,6510414,64.71,0.68
1113,2021-02-05,LOM,25787,7493,18294,2427,23347,13,ITC,ITC4,3,Lombardia,Lombardia,10060574,6536201,64.97,0.26
1114,2021-02-22,LOM,11950,4822,7128,11441,310,199,ITC,ITC4,3,Lombardia,Lombardia,10060574,6548151,65.09,0.12
1115,2021-01-25,LOM,7123,2397,4726,513,6607,3,ITC,ITC4,3,Lombardia,Lombardia,10060574,6555274,65.16,0.07
1116,2021-02-01,LOM,16124,5337,10787,307,15815,2,ITC,ITC4,3,Lombardia,Lombardia,10060574,6571398,65.32,0.16
1117,2021-07-05,LOM,101933,49790,52143,31506,68537,1890,ITC,ITC4,3,Lombardia,Lombardia,10060574,6673331,66.33,1.01
1118,2021-08-31,LOM,62817,33491,29326,36691,21575,4551,ITC,ITC4,3,Lombardia,Lombardia,10060574,6736148,66.96,0.62
1119,2021-03-06,LOM,21363,9108,12255,16542,4519,302,ITC,ITC4,3,Lombardia,Lombardia,10060574,6757511,67.17,0.21
1120,2021-06-09,LOM,103739,52254,51485,87434,14579,1726,ITC,ITC4,3,Lombardia,Lombardia,10060574,6861250,68.2,1.03
1121,2021-03-08,LOM,29823,11212,18611,22168,7126,529,ITC,ITC4,3,Lombardia,Lombardia,10060574,6891073,68.5,0.3
1122,2021-05-04,LOM,86893,41104,45789,70267,14424,2202,ITC,ITC4,3,Lombardia,Lombardia,10060574,6977966,69.36,0.86
1123,2021-01-24,LOM,1202,458,744,538,664,0,ITC,ITC4,3,Lombardia,Lombardia,10060574,6979168,69.37,0.01
1124,2021-07-10,LOM,107272,54304,52968,13915,92175,1182,ITC,ITC4,3,Lombardia,Lombardia,10060574,7086440,70.44,1.07
1125,2021-06-26,LOM,105928,55457,50471,77785,25741,2402,ITC,ITC4,3,Lombardia,Lombardia,10060574,7192368,71.49,1.05
1126,2021-02-10,LOM,14460,4527,9933,7568,6863,29,ITC,ITC4,3,Lombardia,Lombardia,10060574,7206828,71.63,0.14
1127,2021-03-13,LOM,27231,9794,17437,20556,6120,555,ITC,ITC4,3,Lombardia,Lombardia,10060574,7234059,71.91,0.27
1128,2021-07-23,LOM,95530,50072,45458,11435,82839,1256,ITC,ITC4,3,Lombardia,Lombardia,10060574,7329589,72.85,0.95
1129,2021-08-09,LOM,68960,37020,31940,18627,49282,1051,ITC,ITC4,3,Lombardia,Lombardia,10060574,7398549,73.54,0.69
1130,2021-05-01,LOM,96102,43732,52370,65019,29321,1762,ITC,ITC4,3,Lombardia,Lombardia,10060574,7494651,74.5,0.96
1131,2021-01-21,LOM,5533,1612,3921,4820,696,17,ITC,ITC4,3,Lombardia,Lombardia,10060574,7500184,74.55,0.05
1132,2021-06-30,LOM,107006,53008,53998,56594,48290,2122,ITC,ITC4,3,Lombardia,Lombardia,10060574,7607190,75.61,1.06
1133,2021-03-22,LOM,40367,14315,26052,28950,10578,839,ITC,ITC4,3,Lombardia,Lombardia,10060574,7647557,76.02,0.4
1134,2021-04-08,LOM,52468,21796,30672,35301,16494,673,ITC,ITC4,3,Lombardia,Lombardia,10060574,7700025,76.54,0.52
1135,2020-12-29,LOM,106,45,61,106,0,0,ITC,ITC4,3,Lombardia,Lombardia,10060574,7700131,76.54,0.0
1136,2021-07-14,LOM,109446,56857,52589,14354,93684,1408,ITC,ITC4,3,Lombardia,Lombardia,10060574,7809577,77.63,1.09
1137,2021-07-31,LOM,71110,38777,32333,36368,32721,2021,ITC,ITC4,3,Lombardia,Lombardia,10060574,7880687,78.33,0.71
1138,2021-04-22,LOM,74075,33445,40630,56221,16442,1412,ITC,ITC4,3,Lombardia,Lombardia,10060574,7954762,79.07,0.74
1139,2021-03-03,LOM,27027,11531,15496,19490,7318,219,ITC,ITC4,3,Lombardia,Lombardia,10060574,7981789,79.34,0.27
1140,2021-01-22,LOM,3199,885,2314,3125,69,5,ITC,ITC4,3,Lombardia,Lombardia,10060574,7984988,79.37,0.03
1141,2021-01-17,LOM,8359,3350,5009,8152,201,6,ITC,ITC4,3,Lombardia,Lombardia,10060574,7993347,79.45,0.08
1142,2021-06-23,LOM,111076,57462,53614,76692,32247,2137,ITC,ITC4,3,Lombardia,Lombardia,10060574,8104423,80.56,1.1
1143,2021-03-15,LOM,31628,11357,20271,22426,8580,622,ITC,ITC4,3,Lombardia,Lombardia,10060574,8136051,80.87,0.31
1144,2021-04-27,LOM,86116,40014,46102,67636,16611,1869,ITC,ITC4,3,Lombardia,Lombardia,10060574,8222167,81.73,0.86
1145,2021-03-17,LOM,26338,10526,15812,15139,11039,160,ITC,ITC4,3,Lombardia,Lombardia,10060574,8248505,81.99,0.26
1146,2021-07-12,LOM,111880,57508,54372,14803,95938,1139,ITC,ITC4,3,Lombardia,Lombardia,10060574,8360385,83.1,1.11
1147,2021-04-03,LOM,36327,14899,21428,25790,10153,384,ITC,ITC4,3,Lombardia,Lombardia,10060574,8396712,83.46,0.36
1148,2021-05-30,LOM,74423,35612,38811,33794,40010,619,ITC,ITC4,3,Lombardia,Lombardia,10060574,8471135,84.2,0.74
1149,2021-07-26,LOM,109612,58920,50692,7714,101141,757,ITC,ITC4,3,Lombardia,Lombardia,10060574,8580747,85.29,1.09
1150,2021-05-23,LOM,60820,28964,31856,26297,34010,513,ITC,ITC4,3,Lombardia,Lombardia,10060574,8641567,85.9,0.6
1151,2021-02-12,LOM,14026,4389,9637,8885,4981,160,ITC,ITC4,3,Lombardia,Lombardia,10060574,8655593,86.03,0.14
1152,2021-08-19,LOM,28965,15936,13029,14773,13069,1123,ITC,ITC4,3,Lombardia,Lombardia,10060574,8684558,86.32,0.29
1153,2021-05-11,LOM,86948,41457,45491,58215,26246,2487,ITC,ITC4,3,Lombardia,Lombardia,10060574,8771506,87.19,0.86
1154,2021-09-02,LOM,56481,30568,25913,25784,27698,2999,ITC,ITC4,3,Lombardia,Lombardia,10060574,8827987,87.75,0.56
1155,2021-05-28,LOM,93695,44881,48814,42038,50744,913,ITC,ITC4,3,Lombardia,Lombardia,10060574,8921682,88.68,0.93
1156,2021-02-17,LOM,12035,3778,8257,10445,1392,198,ITC,ITC4,3,Lombardia,Lombardia,10060574,8933717,88.8,0.12
1157,2021-06-11,LOM,101532,51717,49815,84941,14698,1893,ITC,ITC4,3,Lombardia,Lombardia,10060574,9035249,89.81,1.01
1158,2021-02-07,LOM,7319,2829,4490,335,6981,3,ITC,ITC4,3,Lombardia,Lombardia,10060574,9042568,89.88,0.07
1159,2021-01-19,LOM,8062,2332,5730,7579,469,14,ITC,ITC4,3,Lombardia,Lombardia,10060574,9050630,89.96,0.08
1160,2021-08-11,LOM,61375,33586,27789,22450,37578,1347,ITC,ITC4,3,Lombardia,Lombardia,10060574,9112005,90.57,0.61
1161,2021-08-28,LOM,35012,19245,15767,17769,15039,2204,ITC,ITC4,3,Lombardia,Lombardia,10060574,9147017,90.92,0.35
1162,2021-05-20,LOM,95615,46244,49371,31717,63082,816,ITC,ITC4,3,Lombardia,Lombardia,10060574,9242632,91.87,0.95
1163,2021-08-21,LOM,21329,11877,9452,9485,11072,772,ITC,ITC4,3,Lombardia,Lombardia,10060574,9263961,92.08,0.21
1164,2021-07-19,LOM,96928,50320,46608,10808,85040,1080,ITC,ITC4,3,Lombardia,Lombardia,10060574,9360889,93.05,0.96
1165,2021-04-10,LOM,52821,21876,30945,40095,11976,750,ITC,ITC4,3,Lombardia,Lombardia,10060574,9413710,93.57,0.53
1166,2021-06-06,LOM,90138,46352,43786,79537,9222,1379,ITC,ITC4,3,Lombardia,Lombardia,10060574,9503848,94.47,0.9
1167,2021-01-07,LOM,11807,3657,8150,11766,0,41,ITC,ITC4,3,Lombardia,Lombardia,10060574,9515655,94.58,0.12
1168,2021-02-19,LOM,14230,5402,8828,13329,725,176,ITC,ITC4,3,Lombardia,Lombardia,10060574,9529885,94.73,0.14
1169,2021-04-17,LOM,48583,21331,27252,36980,10874,729,ITC,ITC4,3,Lombardia,Lombardia,10060574,9578468,95.21,0.48
1170,2021-02-26,LOM,18444,7572,10872,16330,1906,208,ITC,ITC4,3,Lombardia,Lombardia,10060574,9596912,95.39,0.18
1171,2021-07-30,LOM,73293,39792,33501,35084,36091,2118,ITC,ITC4,3,Lombardia,Lombardia,10060574,9670205,96.12,0.73
1172,2020-12-31,LOM,715,302,413,715,0,0,ITC,ITC4,3,Lombardia,Lombardia,10060574,9670920,96.13,0.01
1173,2021-06-18,LOM,107722,52911,54811,51859,54622,1241,ITC,ITC4,3,Lombardia,Lombardia,10060574,9778642,97.2,1.07
1174,2021-08-14,LOM,26544,14887,11657,11133,14861,550,ITC,ITC4,3,Lombardia,Lombardia,10060574,9805186,97.46,0.26
1175,2021-03-01,LOM,18801,8236,10565,16889,1708,204,ITC,ITC4,3,Lombardia,Lombardia,10060574,9823987,97.65,0.19
1176,2021-08-23,LOM,57475,31494,25981,23768,30421,3286,ITC,ITC4,3,Lombardia,Lombardia,10060574,9881462,98.22,0.57
1177,2021-07-04,LOM,86770,43401,43369,40192,44621,1957,ITC,ITC4,3,Lombardia,Lombardia,10060574,9968232,99.08,0.86
1178,2021-08-30,LOM,71221,37841,33380,43172,22399,5650,ITC,ITC4,3,Lombardia,Lombardia,10060574,10039453,99.79,0.71
1179,2021-07-02,LOM,104039,52147,51892,48885,52954,2200,ITC,ITC4,3,Lombardia,Lombardia,10060574,10143492,100.82,1.03
1180,2021-03-24,LOM,43416,15677,27739,30471,12048,897,ITC,ITC4,3,Lombardia,Lombardia,10060574,10186908,101.26,0.43
1181,2021-02-09,LOM,12232,3336,8896,4027,8191,14,ITC,ITC4,3,Lombardia,Lombardia,10060574,10199140,101.38,0.12
1182,2021-05-15,LOM,80991,38808,42183,45385,33445,2161,ITC,ITC4,3,Lombardia,Lombardia,10060574,10280131,102.18,0.81
1183,2021-07-11,LOM,90335,45701,44634,11765,77512,1058,ITC,ITC4,3,Lombardia,Lombardia,10060574,10370466,103.08,0.9
1184,2021-05-13,LOM,87232,41798,45434,55592,28900,2740,ITC,ITC4,3,Lombardia,Lombardia,10060574,10457698,103.95,0.87
1185,2021-02-02,LOM,20001,6645,13356,497,19501,3,ITC,ITC4,3,Lombardia,Lombardia,10060574,10477699,104.15,0.2
1186,2021-03-31,LOM,42269,17146,25123,26200,15385,684,ITC,ITC4,3,Lombardia,Lombardia,10060574,10519968,104.57,0.42
1187,2021-03-10,LOM,33364,12760,20604,24855,7907,602,ITC,ITC4,3,Lombardia,Lombardia,10060574,10553332,104.9,0.33
1188,2021-05-06,LOM,89961,42236,47725,70961,16581,2419,ITC,ITC4,3,Lombardia,Lombardia,10060574,10643293,105.79,0.89
1189,2021-01-26,LOM,8394,2718,5676,348,8045,1,ITC,ITC4,3,Lombardia,Lombardia,10060574,10651687,105.88,0.08
1190,2021-04-05,LOM,27391,11698,15693,19027,8109,255,ITC,ITC4,3,Lombardia,Lombardia,10060574,10679078,106.15,0.27
1191,2021-08-18,LOM,30879,17033,13846,17872,11637,1370,ITC,ITC4,3,Lombardia,Lombardia,10060574,10709957,106.45,0.31
1192,2021-07-07,LOM,112053,56169,55884,18001,92892,1160,ITC,ITC4,3,Lombardia,Lombardia,10060574,10822010,107.57,1.11
1193,2021-04-15,LOM,49492,21876,27616,34891,13840,761,ITC,ITC4,3,Lombardia,Lombardia,10060574,10871502,108.06,0.49
1194,2021-01-05,LOM,7876,2583,5293,7870,0,6,ITC,ITC4,3,Lombardia,Lombardia,10060574,10879378,108.14,0.08
1195,2021-03-27,LOM,32527,12411,20116,23116,8772,639,ITC,ITC4,3,Lombardia,Lombardia,10060574,10911905,108.46,0.32
1196,2021-01-03,LOM,857,316,541,856,0,1,ITC,ITC4,3,Lombardia,Lombardia,10060574,10912762,108.47,0.01
1197,2021-01-31,LOM,9824,3813,6011,29,9795,0,ITC,ITC4,3,Lombardia,Lombardia,10060574,10922586,108.57,0.1
1198,2021-05-25,LOM,91221,43645,47576,43859,46538,824,ITC,ITC4,3,Lombardia,Lombardia,10060574,11013807,109.47,0.91
1199,2021-02-14,LOM,3586,1547,2039,2934,637,15,ITC,ITC4,3,Lombardia,Lombardia,10060574,11017393,109.51,0.04
1200,2021-01-12,LOM,20338,6744,13594,20307,0,31,ITC,ITC4,3,Lombardia,Lombardia,10060574,11037731,109.71,0.2
1201,2021-02-03,LOM,25720,7950,17770,1078,24637,5,ITC,ITC4,3,Lombardia,Lombardia,10060574,11063451,109.97,0.26
1202,2021-04-01,LOM,43192,17319,25873,26086,16393,713,ITC,ITC4,3,Lombardia,Lombardia,10060574,11106643,110.4,0.43
1203,2021-06-01,LOM,94046,46131,47915,75805,17130,1111,ITC,ITC4,3,Lombardia,Lombardia,10060574,11200689,111.33,0.93
1204,2021-01-02,LOM,202,74,128,202,0,0,ITC,ITC4,3,Lombardia,Lombardia,10060574,11200891,111.33,0.0
1205,2021-06-08,LOM,102954,52319,50635,87172,14103,1679,ITC,ITC4,3,Lombardia,Lombardia,10060574,11303845,112.36,1.02
1206,2021-02-28,LOM,7886,3256,4630,7604,210,72,ITC,ITC4,3,Lombardia,Lombardia,10060574,11311731,112.44,0.08
1207,2021-08-04,LOM,90152,48827,41325,14473,75019,660,ITC,ITC4,3,Lombardia,Lombardia,10060574,11401883,113.33,0.9
1208,2021-04-26,LOM,88037,40957,47080,67041,19171,1825,ITC,ITC4,3,Lombardia,Lombardia,10060574,11489920,114.21,0.88
1209,2021-07-21,LOM,94008,48496,45512,8619,84526,863,ITC,ITC4,3,Lombardia,Lombardia,10060574,11583928,115.14,0.93
1210,2021-04-12,LOM,47344,20623,26721,32290,14401,653,ITC,ITC4,3,Lombardia,Lombardia,10060574,11631272,115.61,0.47
1211,2021-02-21,LOM,5055,1864,3191,4941,17,97,ITC,ITC4,3,Lombardia,Lombardia,10060574,11636327,115.66,0.05
1212,2021-07-28,LOM,77454,41729,35725,19118,56585,1751,ITC,ITC4,3,Lombardia,Lombardia,10060574,11713781,116.43,0.77
1213,2021-04-19,LOM,60408,27489,32919,49682,9420,1306,ITC,ITC4,3,Lombardia,Lombardia,10060574,11774189,117.03,0.6
1214,2021-06-15,LOM,96075,48892,47183,49024,45995,1056,ITC,ITC4,3,Lombardia,Lombardia,10060574,11870264,117.99,0.95
1215,2021-06-22,LOM,111255,58106,53149,79176,29956,2123,ITC,ITC4,3,Lombardia,Lombardia,10060574,11981519,119.09,1.11
1216,2021-07-09,LOM,115782,59012,56770,11740,103158,884,ITC,ITC4,3,Lombardia,Lombardia,10060574,12097301,120.24,1.15
1217,2021-06-03,LOM,97200,49742,47458,84616,10917,1667,ITC,ITC4,3,Lombardia,Lombardia,10060574,12194501,121.21,0.97
1218,2021-06-20,LOM,89047,44374,44673,52811,34995,1241,ITC,ITC4,3,Lombardia,Lombardia,10060574,12283548,122.1,0.89
1219,2021-03-12,LOM,35332,12989,22343,24457,10255,620,ITC,ITC4,3,Lombardia,Lombardia,10060574,12318880,122.45,0.35
1220,2021-03-29,LOM,40073,15555,24518,24537,14858,678,ITC,ITC4,3,Lombardia,Lombardia,10060574,12358953,122.85,0.4
1221,2021-08-03,LOM,85831,46542,39289,13484,71620,727,ITC,ITC4,3,Lombardia,Lombardia,10060574,12444784,123.7,0.85
1222,2021-04-25,LOM,51616,23664,27952,45522,4840,1254,ITC,ITC4,3,Lombardia,Lombardia,10060574,12496400,124.21,0.51
1223,2021-06-28,LOM,108094,55064,53030,74295,31191,2608,ITC,ITC4,3,Lombardia,Lombardia,10060574,12604494,125.29,1.07
1224,2021-07-15,LOM,109393,56280,53113,13385,94818,1190,ITC,ITC4,3,Lombardia,Lombardia,10060574,12713887,126.37,1.09
1225,2021-04-06,LOM,43101,17598,25503,24452,17956,693,ITC,ITC4,3,Lombardia,Lombardia,10060574,12756988,126.8,0.43
1226,2021-06-14,LOM,94880,48205,46675,49129,44633,1118,ITC,ITC4,3,Lombardia,Lombardia,10060574,12851868,127.74,0.94
1227,2021-08-17,LOM,33259,18410,14849,17405,14669,1185,ITC,ITC4,3,Lombardia,Lombardia,10060574,12885127,128.08,0.33
1228,2021-05-26,LOM,93786,44686,49100,42747,50148,891,ITC,ITC4,3,Lombardia,Lombardia,10060574,12978913,129.01,0.93
1229,2021-02-15,LOM,9054,3168,5886,8395,480,179,ITC,ITC4,3,Lombardia,Lombardia,10060574,12987967,129.1,0.09
1230,2021-03-20,LOM,32612,12172,20440,22248,9860,504,ITC,ITC4,3,Lombardia,Lombardia,10060574,13020579,129.42,0.32
1231,2020-12-27,LOM,718,414,304,718,0,0,ITC,ITC4,3,Lombardia,Lombardia,10060574,13021297,129.43,0.01
1232,2021-08-02,LOM,83634,45303,38331,18332,64390,912,ITC,ITC4,3,Lombardia,Lombardia,10060574,13104931,130.26,0.83
1233,2021-05-09,LOM,69739,32897,36842,54431,13282,2026,ITC,ITC4,3,Lombardia,Lombardia,10060574,13174670,130.95,0.69
1234,2021-01-29,LOM,13548,4148,9400,686,12859,3,ITC,ITC4,3,Lombardia,Lombardia,10060574,13188218,131.09,0.13
1235,2021-06-13,LOM,76007,40567,35440,72286,2131,1590,ITC,ITC4,3,Lombardia,Lombardia,10060574,13264225,131.84,0.76
1236,2021-03-05,LOM,29004,11971,17033,20252,8444,308,ITC,ITC4,3,Lombardia,Lombardia,10060574,13293229,132.13,0.29
1237,2021-06-27,LOM,90952,46822,44130,69781,18871,2300,ITC,ITC4,3,Lombardia,Lombardia,10060574,13384181,133.04,0.9
1238,2021-03-19,LOM,32508,12949,19559,18921,13264,323,ITC,ITC4,3,Lombardia,Lombardia,10060574,13416689,133.36,0.32
1239,2021-05-27,LOM,95018,45506,49512,40621,53606,791,ITC,ITC4,3,Lombardia,Lombardia,10060574,13511707,134.3,0.94
1240,2021-04-24,LOM,75861,33618,42243,53406,21163,1292,ITC,ITC4,3,Lombardia,Lombardia,10060574,13587568,135.06,0.75
1241,2021-01-14,LOM,26977,7822,19155,26925,0,52,ITC,ITC4,3,Lombardia,Lombardia,10060574,13614545,135.33,0.27
1242,2021-08-16,LOM,38925,21048,17877,16831,21053,1041,ITC,ITC4,3,Lombardia,Lombardia,10060574,13653470,135.71,0.39
1243,2021-05-08,LOM,87840,40793,47047,63435,22116,2289,ITC,ITC4,3,Lombardia,Lombardia,10060574,13741310,136.59,0.87
1244,2021-07-16,LOM,108925,56713,52212,11137,96625,1163,ITC,ITC4,3,Lombardia,Lombardia,10060574,13850235,137.67,1.08
1245,2021-04-07,LOM,50652,20949,29703,34082,15861,709,ITC,ITC4,3,Lombardia,Lombardia,10060574,13900887,138.17,0.5
1246,2021-04-11,SIC,15381,7595,7786,8229,7040,112,ITG,ITG1,19,Sicilia,Sicilia,4999891,15381,0.31,0.31
1247,2021-07-20,SIC,48505,23625,24880,12794,35356,355,ITG,ITG1,19,Sicilia,Sicilia,4999891,63886,1.28,0.97
1248,2020-12-30,SIC,186,110,76,185,0,1,ITG,ITG1,19,Sicilia,Sicilia,4999891,64072,1.28,0.0
1249,2021-01-16,SIC,2737,1221,1516,2716,0,21,ITG,ITG1,19,Sicilia,Sicilia,4999891,66809,1.34,0.05
1250,2021-07-01,SIC,31008,14087,16921,10762,19989,257,ITG,ITG1,19,Sicilia,Sicilia,4999891,97817,1.96,0.62
1251,2021-04-09,SIC,20229,9841,10388,10923,9044,262,ITG,ITG1,19,Sicilia,Sicilia,4999891,118046,2.36,0.4
1252,2021-03-23,SIC,20974,10090,10884,15232,5567,175,ITG,ITG1,19,Sicilia,Sicilia,4999891,139020,2.78,0.42
1253,2021-03-02,SIC,14785,6379,8406,11889,2781,115,ITG,ITG1,19,Sicilia,Sicilia,4999891,153805,3.08,0.3
1254,2021-01-04,SIC,8523,4253,4270,8473,0,50,ITG,ITG1,19,Sicilia,Sicilia,4999891,162328,3.25,0.17
1255,2021-01-18,SIC,1627,676,951,1456,160,11,ITG,ITG1,19,Sicilia,Sicilia,4999891,163955,3.28,0.03
1256,2021-04-28,SIC,29287,13724,15563,19720,9163,404,ITG,ITG1,19,Sicilia,Sicilia,4999891,193242,3.86,0.59
1257,2021-08-10,SIC,21832,10873,10959,10656,10916,260,ITG,ITG1,19,Sicilia,Sicilia,4999891,215074,4.3,0.44
1258,2021-01-30,SIC,7734,3555,4179,145,7586,3,ITG,ITG1,19,Sicilia,Sicilia,4999891,222808,4.46,0.15
1259,2021-03-28,SIC,10993,5152,5841,6915,4012,66,ITG,ITG1,19,Sicilia,Sicilia,4999891,233801,4.68,0.22
1260,2021-07-15,SIC,48395,22463,25932,7998,40135,262,ITG,ITG1,19,Sicilia,Sicilia,4999891,282196,5.64,0.97
1261,2021-08-03,SIC,32059,15724,16335,13872,17767,420,ITG,ITG1,19,Sicilia,Sicilia,4999891,314255,6.29,0.64
1262,2021-06-24,SIC,42369,19673,22696,17636,24373,360,ITG,ITG1,19,Sicilia,Sicilia,4999891,356624,7.13,0.85
1263,2021-06-07,SIC,49690,23417,26273,41116,8038,536,ITG,ITG1,19,Sicilia,Sicilia,4999891,406314,8.13,0.99
1264,2021-01-25,SIC,7452,3690,3762,267,7178,7,ITG,ITG1,19,Sicilia,Sicilia,4999891,413766,8.28,0.15
1265,2021-05-05,SIC,26408,12234,14174,16284,9684,440,ITG,ITG1,19,Sicilia,Sicilia,4999891,440174,8.8,0.53
1266,2021-05-19,SIC,42908,20776,22132,28194,14334,380,ITG,ITG1,19,Sicilia,Sicilia,4999891,483082,9.66,0.86
1267,2021-07-27,SIC,43333,21476,21857,19274,23596,463,ITG,ITG1,19,Sicilia,Sicilia,4999891,526415,10.53,0.87
1268,2021-08-29,SIC,14525,7927,6598,4756,9623,146,ITG,ITG1,19,Sicilia,Sicilia,4999891,540940,10.82,0.29
1269,2021-02-25,SIC,9945,5208,4737,8689,1164,92,ITG,ITG1,19,Sicilia,Sicilia,4999891,550885,11.02,0.2
1270,2021-06-05,SIC,59960,28521,31439,48735,10597,628,ITG,ITG1,19,Sicilia,Sicilia,4999891,610845,12.22,1.2
1271,2021-03-14,SIC,8781,3930,4851,4893,3836,52,ITG,ITG1,19,Sicilia,Sicilia,4999891,619626,12.39,0.18
1272,2021-02-13,SIC,2979,1124,1855,2686,256,37,ITG,ITG1,19,Sicilia,Sicilia,4999891,622605,12.45,0.06
1273,2021-05-24,SIC,35878,17444,18434,15588,20057,233,ITG,ITG1,19,Sicilia,Sicilia,4999891,658483,13.17,0.72
1274,2021-08-27,SIC,23360,11879,11481,9851,13182,327,ITG,ITG1,19,Sicilia,Sicilia,4999891,681843,13.64,0.47
1275,2021-08-15,SIC,2513,1428,1085,1509,954,50,ITG,ITG1,19,Sicilia,Sicilia,4999891,684356,13.69,0.05
1276,2021-08-01,SIC,19964,10431,9533,7851,11966,147,ITG,ITG1,19,Sicilia,Sicilia,4999891,704320,14.09,0.4
1277,2021-06-19,SIC,44301,21062,23239,18764,25218,319,ITG,ITG1,19,Sicilia,Sicilia,4999891,748621,14.97,0.89
1278,2021-04-23,SIC,28633,13723,14910,22409,5841,383,ITG,ITG1,19,Sicilia,Sicilia,4999891,777254,15.55,0.57
1279,2021-02-23,SIC,8785,4667,4118,8229,468,88,ITG,ITG1,19,Sicilia,Sicilia,4999891,786039,15.72,0.18
1280,2021-03-09,SIC,13172,5772,7400,10839,2202,131,ITG,ITG1,19,Sicilia,Sicilia,4999891,799211,15.98,0.26
1281,2021-01-11,SIC,5925,2616,3309,5866,0,59,ITG,ITG1,19,Sicilia,Sicilia,4999891,805136,16.1,0.12
1282,2020-12-28,SIC,225,138,87,224,0,1,ITG,ITG1,19,Sicilia,Sicilia,4999891,805361,16.11,0.0
1283,2021-02-11,SIC,5238,2060,3178,4652,467,119,ITG,ITG1,19,Sicilia,Sicilia,4999891,810599,16.21,0.1
1284,2021-04-16,SIC,28867,14502,14365,20248,8300,319,ITG,ITG1,19,Sicilia,Sicilia,4999891,839466,16.79,0.58
1285,2021-01-23,SIC,4488,2310,2178,208,4270,10,ITG,ITG1,19,Sicilia,Sicilia,4999891,843954,16.88,0.09
1286,2021-01-06,SIC,6269,3302,2967,6204,0,65,ITG,ITG1,19,Sicilia,Sicilia,4999891,850223,17.0,0.13
1287,2021-05-31,SIC,38125,17167,20958,21276,16553,296,ITG,ITG1,19,Sicilia,Sicilia,4999891,888348,17.77,0.76
1288,2021-08-22,SIC,10326,5501,4825,3914,6294,118,ITG,ITG1,19,Sicilia,Sicilia,4999891,898674,17.97,0.21
1289,2021-02-18,SIC,5341,3147,2194,4842,430,69,ITG,ITG1,19,Sicilia,Sicilia,4999891,904015,18.08,0.11
1290,2021-05-12,SIC,36862,17393,19469,21411,14927,524,ITG,ITG1,19,Sicilia,Sicilia,4999891,940877,18.82,0.74
1291,2021-08-20,SIC,18796,9359,9437,9857,8674,265,ITG,ITG1,19,Sicilia,Sicilia,4999891,959673,19.19,0.38
1292,2021-07-17,SIC,49327,24294,25033,9318,39709,300,ITG,ITG1,19,Sicilia,Sicilia,4999891,1009000,20.18,0.99
1293,2021-04-04,SIC,6798,3322,3476,5434,1295,69,ITG,ITG1,19,Sicilia,Sicilia,4999891,1015798,20.32,0.14
1294,2021-07-13,SIC,46115,21163,24952,6907,38991,217,ITG,ITG1,19,Sicilia,Sicilia,4999891,1061913,21.24,0.92
1295,2021-03-16,SIC,9644,4335,5309,3570,6003,71,ITG,ITG1,19,Sicilia,Sicilia,4999891,1071557,21.43,0.19
1296,2021-07-08,SIC,38396,17496,20900,6534,31639,223,ITG,ITG1,19,Sicilia,Sicilia,4999891,1109953,22.2,0.77
1297,2021-02-27,SIC,12241,5505,6736,10936,1204,101,ITG,ITG1,19,Sicilia,Sicilia,4999891,1122194,22.44,0.24
1298,2021-05-17,SIC,31944,15412,16532,19003,12646,295,ITG,ITG1,19,Sicilia,Sicilia,4999891,1154138,23.08,0.64
1299,2021-03-21,SIC,15227,7347,7880,11185,3970,72,ITG,ITG1,19,Sicilia,Sicilia,4999891,1169365,23.39,0.3
1300,2021-02-06,SIC,4736,2119,2617,1450,3266,20,ITG,ITG1,19,Sicilia,Sicilia,4999891,1174101,23.48,0.09
1301,2021-02-04,SIC,6763,3085,3678,1421,5312,30,ITG,ITG1,19,Sicilia,Sicilia,4999891,1180864,23.62,0.14
1302,2021-09-03,SIC,16563,8254,8309,7052,9239,272,ITG,ITG1,19,Sicilia,Sicilia,4999891,1197427,23.95,0.33
1303,2021-06-26,SIC,37268,17782,19486,16350,20610,308,ITG,ITG1,19,Sicilia,Sicilia,4999891,1234695,24.69,0.75
1304,2021-04-30,SIC,35062,16359,18703,23527,11055,480,ITG,ITG1,19,Sicilia,Sicilia,4999891,1269757,25.4,0.7
1305,2021-03-04,SIC,15259,6708,8551,11010,4122,127,ITG,ITG1,19,Sicilia,Sicilia,4999891,1285016,25.7,0.31
1306,2021-08-08,SIC,15316,8130,7186,7412,7715,189,ITG,ITG1,19,Sicilia,Sicilia,4999891,1300332,26.01,0.31
1307,2021-06-12,SIC,45802,22400,23402,39372,5895,535,ITG,ITG1,19,Sicilia,Sicilia,4999891,1346134,26.92,0.92
1308,2021-05-16,SIC,33716,16443,17273,21894,11526,296,ITG,ITG1,19,Sicilia,Sicilia,4999891,1379850,27.6,0.67
1309,2021-05-02,SIC,24619,11436,13183,17701,6605,313,ITG,ITG1,19,Sicilia,Sicilia,4999891,1404469,28.09,0.49
1310,2021-06-16,SIC,40446,18808,21638,21274,18813,359,ITG,ITG1,19,Sicilia,Sicilia,4999891,1444915,28.9,0.81
1311,2021-03-25,SIC,20480,9535,10945,14756,5547,177,ITG,ITG1,19,Sicilia,Sicilia,4999891,1465395,29.31,0.41
1312,2021-07-03,SIC,33887,16289,17598,9035,24607,245,ITG,ITG1,19,Sicilia,Sicilia,4999891,1499282,29.99,0.68
1313,2021-03-06,SIC,12652,5064,7588,9766,2783,103,ITG,ITG1,19,Sicilia,Sicilia,4999891,1511934,30.24,0.25
1314,2021-06-14,SIC,43493,20661,22832,28168,14896,429,ITG,ITG1,19,Sicilia,Sicilia,4999891,1555427,31.11,0.87
1315,2021-04-02,SIC,13904,6560,7344,9047,4737,120,ITG,ITG1,19,Sicilia,Sicilia,4999891,1569331,31.39,0.28
1316,2021-02-10,SIC,4354,1776,2578,3888,383,83,ITG,ITG1,19,Sicilia,Sicilia,4999891,1573685,31.47,0.09
1317,2021-05-21,SIC,48714,23078,25636,26665,21623,426,ITG,ITG1,19,Sicilia,Sicilia,4999891,1622399,32.45,0.97
1318,2021-08-12,SIC,15125,7583,7542,7980,6903,242,ITG,ITG1,19,Sicilia,Sicilia,4999891,1637524,32.75,0.3
1319,2021-04-08,SIC,19005,9341,9664,9268,9541,196,ITG,ITG1,19,Sicilia,Sicilia,4999891,1656529,33.13,0.38
1320,2021-02-20,SIC,7170,3707,3463,6803,272,95,ITG,ITG1,19,Sicilia,Sicilia,4999891,1663699,33.27,0.14
1321,2021-02-03,SIC,5945,2793,3152,708,5229,8,ITG,ITG1,19,Sicilia,Sicilia,4999891,1669644,33.39,0.12
1322,2021-06-04,SIC,57872,26769,31103,45402,11963,507,ITG,ITG1,19,Sicilia,Sicilia,4999891,1727516,34.55,1.16
1323,2021-04-06,SIC,17763,8484,9279,13256,4297,210,ITG,ITG1,19,Sicilia,Sicilia,4999891,1745279,34.91,0.36
1324,2021-02-22,SIC,7948,4132,3816,7373,493,82,ITG,ITG1,19,Sicilia,Sicilia,4999891,1753227,35.07,0.16
1325,2020-12-27,SIC,93,55,38,92,0,1,ITG,ITG1,19,Sicilia,Sicilia,4999891,1753320,35.07,0.0
1326,2021-06-02,SIC,35284,16298,18986,27104,7782,398,ITG,ITG1,19,Sicilia,Sicilia,4999891,1788604,35.77,0.71
1327,2021-01-01,SIC,825,441,384,821,0,4,ITG,ITG1,19,Sicilia,Sicilia,4999891,1789429,35.79,0.02
1328,2021-04-20,SIC,18993,9004,9989,13438,5249,306,ITG,ITG1,19,Sicilia,Sicilia,4999891,1808422,36.17,0.38
1329,2021-07-29,SIC,36208,17894,18314,14337,21528,343,ITG,ITG1,19,Sicilia,Sicilia,4999891,1844630,36.89,0.72
1330,2021-07-24,SIC,40743,21217,19526,16806,23629,308,ITG,ITG1,19,Sicilia,Sicilia,4999891,1885373,37.71,0.81
1331,2021-02-15,SIC,3777,1769,2008,3137,564,76,ITG,ITG1,19,Sicilia,Sicilia,4999891,1889150,37.78,0.08
1332,2021-07-22,SIC,40674,19967,20707,11230,29149,295,ITG,ITG1,19,Sicilia,Sicilia,4999891,1929824,38.6,0.81
1333,2021-05-26,SIC,44724,21032,23692,23898,20482,344,ITG,ITG1,19,Sicilia,Sicilia,4999891,1974548,39.49,0.89
1334,2021-01-03,SIC,4811,2514,2297,4777,0,34,ITG,ITG1,19,Sicilia,Sicilia,4999891,1979359,39.59,0.1
1335,2021-04-13,SIC,20272,9875,10397,11229,8843,200,ITG,ITG1,19,Sicilia,Sicilia,4999891,1999631,39.99,0.41
1336,2021-07-31,SIC,28758,14936,13822,10447,18045,266,ITG,ITG1,19,Sicilia,Sicilia,4999891,2028389,40.57,0.58
1337,2021-04-01,SIC,14329,6627,7702,9518,4668,143,ITG,ITG1,19,Sicilia,Sicilia,4999891,2042718,40.86,0.29
1338,2021-07-10,SIC,46915,22353,24562,6055,40652,208,ITG,ITG1,19,Sicilia,Sicilia,4999891,2089633,41.79,0.94
1339,2021-06-23,SIC,44515,20713,23802,17930,26249,336,ITG,ITG1,19,Sicilia,Sicilia,4999891,2134148,42.68,0.89
1340,2021-05-07,SIC,36604,17281,19323,24595,11625,384,ITG,ITG1,19,Sicilia,Sicilia,4999891,2170752,43.42,0.73
1341,2021-03-11,SIC,15459,6712,8747,12887,2418,154,ITG,ITG1,19,Sicilia,Sicilia,4999891,2186211,43.73,0.31
1342,2021-01-27,SIC,7295,3714,3581,167,7127,1,ITG,ITG1,19,Sicilia,Sicilia,4999891,2193506,43.87,0.15
1343,2021-01-13,SIC,5188,2445,2743,5154,0,34,ITG,ITG1,19,Sicilia,Sicilia,4999891,2198694,43.97,0.1
1344,2021-01-10,SIC,3566,1598,1968,3544,0,22,ITG,ITG1,19,Sicilia,Sicilia,4999891,2202260,44.05,0.07
1345,2021-01-05,SIC,10432,5128,5304,10349,0,83,ITG,ITG1,19,Sicilia,Sicilia,4999891,2212692,44.25,0.21
1346,2021-04-15,SIC,21592,10496,11096,12005,9356,231,ITG,ITG1,19,Sicilia,Sicilia,4999891,2234284,44.69,0.43
1347,2021-04-27,SIC,26460,12690,13770,15153,10959,348,ITG,ITG1,19,Sicilia,Sicilia,4999891,2260744,45.22,0.53
1348,2021-08-05,SIC,23861,11846,12015,11523,12032,306,ITG,ITG1,19,Sicilia,Sicilia,4999891,2284605,45.69,0.48
1349,2021-05-14,SIC,52251,24501,27750,35796,15682,773,ITG,ITG1,19,Sicilia,Sicilia,4999891,2336856,46.74,1.05
1350,2021-01-15,SIC,5325,2335,2990,5258,0,67,ITG,ITG1,19,Sicilia,Sicilia,4999891,2342181,46.84,0.11
1351,2021-04-25,SIC,21403,10208,11195,16144,5018,241,ITG,ITG1,19,Sicilia,Sicilia,4999891,2363584,47.27,0.43
1352,2021-02-01,SIC,5954,2642,3312,296,5644,14,ITG,ITG1,19,Sicilia,Sicilia,4999891,2369538,47.39,0.12
1353,2021-03-22,SIC,16692,7920,8772,11167,5429,96,ITG,ITG1,19,Sicilia,Sicilia,4999891,2386230,47.73,0.33
1354,2021-05-28,SIC,51267,22986,28281,24309,26545,413,ITG,ITG1,19,Sicilia,Sicilia,4999891,2437497,48.75,1.03
1355,2021-08-19,SIC,19607,9790,9817,10505,8792,310,ITG,ITG1,19,Sicilia,Sicilia,4999891,2457104,49.14,0.39
1356,2021-02-19,SIC,4980,2696,2284,4329,564,87,ITG,ITG1,19,Sicilia,Sicilia,4999891,2462084,49.24,0.1
1357,2021-03-08,SIC,13526,5975,7551,10782,2616,128,ITG,ITG1,19,Sicilia,Sicilia,4999891,2475610,49.51,0.27
1358,2021-08-21,SIC,13741,7166,6575,6201,7353,187,ITG,ITG1,19,Sicilia,Sicilia,4999891,2489351,49.79,0.27
1359,2021-05-30,SIC,35779,16177,19602,17425,18056,298,ITG,ITG1,19,Sicilia,Sicilia,4999891,2525130,50.5,0.72
1360,2021-05-13,SIC,47496,22273,25223,30301,16551,644,ITG,ITG1,19,Sicilia,Sicilia,4999891,2572626,51.45,0.95
1361,2021-01-31,SIC,4060,1943,2117,107,3951,2,ITG,ITG1,19,Sicilia,Sicilia,4999891,2576686,51.53,0.08
1362,2021-05-11,SIC,32691,15507,17184,19686,12500,505,ITG,ITG1,19,Sicilia,Sicilia,4999891,2609377,52.19,0.65
1363,2021-02-17,SIC,5221,3204,2017,4500,670,51,ITG,ITG1,19,Sicilia,Sicilia,4999891,2614598,52.29,0.1
1364,2021-03-20,SIC,18605,8987,9618,13367,5143,95,ITG,ITG1,19,Sicilia,Sicilia,4999891,2633203,52.67,0.37
1365,2021-08-24,SIC,23725,11757,11968,10964,12394,367,ITG,ITG1,19,Sicilia,Sicilia,4999891,2656928,53.14,0.47
1366,2021-06-28,SIC,31942,14877,17065,14906,16742,294,ITG,ITG1,19,Sicilia,Sicilia,4999891,2688870,53.78,0.64
1367,2021-07-05,SIC,37528,17614,19914,8911,28376,241,ITG,ITG1,19,Sicilia,Sicilia,4999891,2726398,54.53,0.75
1368,2021-06-21,SIC,40254,18636,21618,18421,21504,329,ITG,ITG1,19,Sicilia,Sicilia,4999891,2766652,55.33,0.81
1369,2021-05-09,SIC,28440,13321,15119,19770,8298,372,ITG,ITG1,19,Sicilia,Sicilia,4999891,2795092,55.9,0.57
1370,2021-08-17,SIC,18655,9541,9114,10155,8173,327,ITG,ITG1,19,Sicilia,Sicilia,4999891,2813747,56.28,0.37
1371,2021-03-01,SIC,12775,6077,6698,10992,1658,125,ITG,ITG1,19,Sicilia,Sicilia,4999891,2826522,56.53,0.26
1372,2021-06-09,SIC,49788,23683,26105,41910,7267,611,ITG,ITG1,19,Sicilia,Sicilia,4999891,2876310,57.53,1.0
1373,2021-01-20,SIC,969,513,456,691,275,3,ITG,ITG1,19,Sicilia,Sicilia,4999891,2877279,57.55,0.02
1374,2021-03-18,SIC,15415,7757,7658,9738,5622,55,ITG,ITG1,19,Sicilia,Sicilia,4999891,2892694,57.86,0.31
1375,2021-08-26,SIC,20021,10110,9911,9104,10609,308,ITG,ITG1,19,Sicilia,Sicilia,4999891,2912715,58.26,0.4
1376,2021-02-07,SIC,2324,984,1340,664,1650,10,ITG,ITG1,19,Sicilia,Sicilia,4999891,2915039,58.3,0.05
1377,2021-07-14,SIC,47543,22025,25518,7931,39352,260,ITG,ITG1,19,Sicilia,Sicilia,4999891,2962582,59.25,0.95
1378,2021-04-24,SIC,31216,14718,16498,23142,7640,434,ITG,ITG1,19,Sicilia,Sicilia,4999891,2993798,59.88,0.62
1379,2021-08-02,SIC,32948,16375,16573,12832,19770,346,ITG,ITG1,19,Sicilia,Sicilia,4999891,3026746,60.54,0.66
1380,2021-08-06,SIC,24785,12576,12209,13501,10875,409,ITG,ITG1,19,Sicilia,Sicilia,4999891,3051531,61.03,0.5
1381,2021-01-24,SIC,4335,2268,2067,123,4210,2,ITG,ITG1,19,Sicilia,Sicilia,4999891,3055866,61.12,0.09
1382,2021-05-04,SIC,26868,12482,14386,17152,9299,417,ITG,ITG1,19,Sicilia,Sicilia,4999891,3082734,61.66,0.54
1383,2021-06-30,SIC,32614,15039,17575,11448,20845,321,ITG,ITG1,19,Sicilia,Sicilia,4999891,3115348,62.31,0.65
1384,2020-12-29,SIC,245,152,93,244,0,1,ITG,ITG1,19,Sicilia,Sicilia,4999891,3115593,62.31,0.0
1385,2021-06-13,SIC,34548,17165,17383,30606,3509,433,ITG,ITG1,19,Sicilia,Sicilia,4999891,3150141,63.0,0.69
1386,2021-06-20,SIC,33453,15829,17624,15115,18078,260,ITG,ITG1,19,Sicilia,Sicilia,4999891,3183594,63.67,0.67
1387,2021-04-22,SIC,26773,12641,14132,19892,6461,420,ITG,ITG1,19,Sicilia,Sicilia,4999891,3210367,64.21,0.54
1388,2021-03-10,SIC,13960,6134,7826,11628,2187,145,ITG,ITG1,19,Sicilia,Sicilia,4999891,3224327,64.49,0.28
1389,2021-01-12,SIC,4374,2142,2232,4328,0,46,ITG,ITG1,19,Sicilia,Sicilia,4999891,3228701,64.58,0.09
1390,2021-06-18,SIC,43612,20153,23459,18865,24375,372,ITG,ITG1,19,Sicilia,Sicilia,4999891,3272313,65.45,0.87
1391,2021-06-27,SIC,25312,12203,13109,12097,12983,232,ITG,ITG1,19,Sicilia,Sicilia,4999891,3297625,65.95,0.51
1392,2021-05-15,SIC,56541,26408,30133,40377,15249,915,ITG,ITG1,19,Sicilia,Sicilia,4999891,3354166,67.08,1.13
1393,2021-03-19,SIC,16325,8061,8264,10652,5579,94,ITG,ITG1,19,Sicilia,Sicilia,4999891,3370491,67.41,0.33
1394,2021-08-23,SIC,24083,11901,12182,10793,12938,352,ITG,ITG1,19,Sicilia,Sicilia,4999891,3394574,67.89,0.48
1395,2021-09-01,SIC,24972,12737,12235,10592,14025,355,ITG,ITG1,19,Sicilia,Sicilia,4999891,3419546,68.39,0.5
1396,2021-03-12,SIC,12891,5573,7318,10665,2070,156,ITG,ITG1,19,Sicilia,Sicilia,4999891,3432437,68.65,0.26
1397,2021-02-05,SIC,6788,3005,3783,2086,4664,38,ITG,ITG1,19,Sicilia,Sicilia,4999891,3439225,68.79,0.14
1398,2021-04-03,SIC,16422,7818,8604,13421,2837,164,ITG,ITG1,19,Sicilia,Sicilia,4999891,3455647,69.11,0.33
1399,2021-03-27,SIC,15702,7409,8293,10687,4888,127,ITG,ITG1,19,Sicilia,Sicilia,4999891,3471349,69.43,0.31
1400,2021-01-29,SIC,9185,4256,4929,405,8768,12,ITG,ITG1,19,Sicilia,Sicilia,4999891,3480534,69.61,0.18
1401,2021-02-12,SIC,4606,1829,2777,4241,286,79,ITG,ITG1,19,Sicilia,Sicilia,4999891,3485140,69.7,0.09
1402,2021-05-23,SIC,34098,16603,17495,19847,14022,229,ITG,ITG1,19,Sicilia,Sicilia,4999891,3519238,70.39,0.68
1403,2021-03-15,SIC,10689,4734,5955,5655,4954,80,ITG,ITG1,19,Sicilia,Sicilia,4999891,3529927,70.6,0.21
1404,2021-04-26,SIC,21705,10276,11429,13301,8086,318,ITG,ITG1,19,Sicilia,Sicilia,4999891,3551632,71.03,0.43
1405,2021-02-02,SIC,5322,2497,2825,612,4700,10,ITG,ITG1,19,Sicilia,Sicilia,4999891,3556954,71.14,0.11
1406,2021-08-04,SIC,24343,12003,12340,10971,13050,322,ITG,ITG1,19,Sicilia,Sicilia,4999891,3581297,71.63,0.49
1407,2021-07-18,SIC,39285,19785,19500,8102,30950,233,ITG,ITG1,19,Sicilia,Sicilia,4999891,3620582,72.41,0.79
1408,2021-01-14,SIC,5267,2494,2773,5205,0,62,ITG,ITG1,19,Sicilia,Sicilia,4999891,3625849,72.52,0.11
1409,2021-08-09,SIC,25175,12857,12318,12483,12316,376,ITG,ITG1,19,Sicilia,Sicilia,4999891,3651024,73.02,0.5
1410,2021-01-19,SIC,1524,677,847,1268,241,15,ITG,ITG1,19,Sicilia,Sicilia,4999891,3652548,73.05,0.03
1411,2021-06-11,SIC,49977,23848,26129,41600,7710,667,ITG,ITG1,19,Sicilia,Sicilia,4999891,3702525,74.05,1.0
1412,2021-04-29,SIC,31823,14848,16975,21808,9562,453,ITG,ITG1,19,Sicilia,Sicilia,4999891,3734348,74.69,0.64
1413,2021-03-03,SIC,14590,6552,8038,11384,3075,131,ITG,ITG1,19,Sicilia,Sicilia,4999891,3748938,74.98,0.29
1414,2021-08-07,SIC,20060,10408,9652,10820,8903,337,ITG,ITG1,19,Sicilia,Sicilia,4999891,3768998,75.38,0.4
1415,2021-08-16,SIC,20440,10487,9953,10960,9166,314,ITG,ITG1,19,Sicilia,Sicilia,4999891,3789438,75.79,0.41
1416,2021-06-10,SIC,53056,24909,28147,45151,7252,653,ITG,ITG1,19,Sicilia,Sicilia,4999891,3842494,76.85,1.06
1417,2021-05-27,SIC,47611,21931,25680,24457,22733,421,ITG,ITG1,19,Sicilia,Sicilia,4999891,3890105,77.8,0.95
1418,2021-04-14,SIC,20587,9940,10647,11620,8772,195,ITG,ITG1,19,Sicilia,Sicilia,4999891,3910692,78.22,0.41
1419,2021-07-23,SIC,41497,20847,20650,14361,26812,324,ITG,ITG1,19,Sicilia,Sicilia,4999891,3952189,79.05,0.83
1420,2021-04-21,SIC,22400,10754,11646,15994,6127,279,ITG,ITG1,19,Sicilia,Sicilia,4999891,3974589,79.49,0.45
1421,2021-04-07,SIC,18449,9065,9384,9738,8517,194,ITG,ITG1,19,Sicilia,Sicilia,4999891,3993038,79.86,0.37
1422,2021-07-16,SIC,49349,23369,25980,8716,40344,289,ITG,ITG1,19,Sicilia,Sicilia,4999891,4042387,80.85,0.99
1423,2021-07-30,SIC,32496,16093,16403,12091,20117,288,ITG,ITG1,19,Sicilia,Sicilia,4999891,4074883,81.5,0.65
1424,2021-06-03,SIC,46009,21100,24909,33768,11719,522,ITG,ITG1,19,Sicilia,Sicilia,4999891,4120892,82.42,0.92
1425,2021-02-24,SIC,9380,4804,4576,8706,567,107,ITG,ITG1,19,Sicilia,Sicilia,4999891,4130272,82.61,0.19
1426,2021-01-21,SIC,1457,715,742,490,956,11,ITG,ITG1,19,Sicilia,Sicilia,4999891,4131729,82.64,0.03
1427,2021-05-01,SIC,24459,11322,13137,19004,5170,285,ITG,ITG1,19,Sicilia,Sicilia,4999891,4156188,83.13,0.49
1428,2021-08-25,SIC,21847,10844,11003,9969,11518,360,ITG,ITG1,19,Sicilia,Sicilia,4999891,4178035,83.56,0.44
1429,2021-06-29,SIC,31456,14737,16719,15727,15324,405,ITG,ITG1,19,Sicilia,Sicilia,4999891,4209491,84.19,0.63
1430,2021-07-06,SIC,37106,17157,19949,10278,26518,310,ITG,ITG1,19,Sicilia,Sicilia,4999891,4246597,84.93,0.74
1431,2021-05-10,SIC,28742,13799,14943,16185,12222,335,ITG,ITG1,19,Sicilia,Sicilia,4999891,4275339,85.51,0.57
1432,2021-08-18,SIC,22006,11372,10634,11687,9950,369,ITG,ITG1,19,Sicilia,Sicilia,4999891,4297345,85.95,0.44
1433,2021-03-26,SIC,17997,8361,9636,12341,5502,154,ITG,ITG1,19,Sicilia,Sicilia,4999891,4315342,86.31,0.36
1434,2021-01-28,SIC,9038,4278,4760,363,8674,1,ITG,ITG1,19,Sicilia,Sicilia,4999891,4324380,86.49,0.18
1435,2021-07-04,SIC,26514,12802,13712,7610,18729,175,ITG,ITG1,19,Sicilia,Sicilia,4999891,4350894,87.02,0.53
1436,2021-05-08,SIC,35674,17048,18626,24903,10322,449,ITG,ITG1,19,Sicilia,Sicilia,4999891,4386568,87.73,0.71
1437,2021-01-26,SIC,9581,4747,4834,215,9365,1,ITG,ITG1,19,Sicilia,Sicilia,4999891,4396149,87.92,0.19
1438,2021-07-28,SIC,37673,18873,18800,14691,22661,321,ITG,ITG1,19,Sicilia,Sicilia,4999891,4433822,88.68,0.75
1439,2021-06-22,SIC,40056,18411,21645,18344,21334,378,ITG,ITG1,19,Sicilia,Sicilia,4999891,4473878,89.48,0.8
1440,2021-05-22,SIC,48034,22815,25219,28312,19325,397,ITG,ITG1,19,Sicilia,Sicilia,4999891,4521912,90.44,0.96
1441,2021-08-30,SIC,28197,14366,13831,10214,17637,346,ITG,ITG1,19,Sicilia,Sicilia,4999891,4550109,91.0,0.56
1442,2021-02-28,SIC,7131,3032,4099,6456,630,45,ITG,ITG1,19,Sicilia,Sicilia,4999891,4557240,91.15,0.14
1443,2021-06-08,SIC,47709,22404,25305,40457,6713,539,ITG,ITG1,19,Sicilia,Sicilia,4999891,4604949,92.1,0.95
1444,2021-04-10,SIC,20448,9978,10470,11303,8972,173,ITG,ITG1,19,Sicilia,Sicilia,4999891,4625397,92.51,0.41
1445,2021-01-17,SIC,1314,598,716,1240,65,9,ITG,ITG1,19,Sicilia,Sicilia,4999891,4626711,92.54,0.03
1446,2021-07-02,SIC,30579,14239,16340,9943,20350,286,ITG,ITG1,19,Sicilia,Sicilia,4999891,4657290,93.15,0.61
1447,2021-07-19,SIC,48982,23600,25382,11660,36963,359,ITG,ITG1,19,Sicilia,Sicilia,4999891,4706272,94.13,0.98
1448,2021-08-11,SIC,16209,8341,7868,8734,7186,289,ITG,ITG1,19,Sicilia,Sicilia,4999891,4722481,94.45,0.32
1449,2021-01-09,SIC,7255,3425,3830,7194,0,61,ITG,ITG1,19,Sicilia,Sicilia,4999891,4729736,94.6,0.15
1450,2021-05-03,SIC,23325,10802,12523,13265,9796,264,ITG,ITG1,19,Sicilia,Sicilia,4999891,4753061,95.06,0.47
1451,2021-07-11,SIC,36041,16870,19171,3663,32283,95,ITG,ITG1,19,Sicilia,Sicilia,4999891,4789102,95.78,0.72
1452,2021-07-25,SIC,31810,16764,15046,11846,19705,259,ITG,ITG1,19,Sicilia,Sicilia,4999891,4820912,96.42,0.64
1453,2021-04-19,SIC,18291,8672,9619,12464,5590,237,ITG,ITG1,19,Sicilia,Sicilia,4999891,4839203,96.79,0.37
1454,2021-05-18,SIC,36146,17404,18742,23254,12490,402,ITG,ITG1,19,Sicilia,Sicilia,4999891,4875349,97.51,0.72
1455,2021-07-21,SIC,42971,20968,22003,10641,32018,312,ITG,ITG1,19,Sicilia,Sicilia,4999891,4918320,98.37,0.86
1456,2021-07-07,SIC,35418,16202,19216,6039,29140,239,ITG,ITG1,19,Sicilia,Sicilia,4999891,4953738,99.08,0.71
1457,2021-05-25,SIC,33563,15432,18131,13940,19367,256,ITG,ITG1,19,Sicilia,Sicilia,4999891,4987301,99.75,0.67
1458,2021-03-29,SIC,15049,7085,7964,10399,4500,150,ITG,ITG1,19,Sicilia,Sicilia,4999891,5002350,100.05,0.3
1459,2021-09-02,SIC,23194,11878,11316,10039,12766,389,ITG,ITG1,19,Sicilia,Sicilia,4999891,5025544,100.51,0.46
1460,2021-06-01,SIC,38991,17727,21264,24597,14043,351,ITG,ITG1,19,Sicilia,Sicilia,4999891,5064535,101.29,0.78
1461,2021-04-05,SIC,8024,3957,4067,6512,1442,70,ITG,ITG1,19,Sicilia,Sicilia,4999891,5072559,101.45,0.16
1462,2021-04-12,SIC,19023,9221,9802,11488,7276,259,ITG,ITG1,19,Sicilia,Sicilia,4999891,5091582,101.83,0.38
1463,2021-02-14,SIC,1055,402,653,905,140,10,ITG,ITG1,19,Sicilia,Sicilia,4999891,5092637,101.85,0.02
1464,2021-01-02,SIC,4886,2545,2341,4850,0,36,ITG,ITG1,19,Sicilia,Sicilia,4999891,5097523,101.95,0.1
1465,2021-02-21,SIC,5170,2502,2668,5045,107,18,ITG,ITG1,19,Sicilia,Sicilia,4999891,5102693,102.06,0.1
1466,2021-03-05,SIC,15789,6853,8936,11395,4244,150,ITG,ITG1,19,Sicilia,Sicilia,4999891,5118482,102.37,0.32
1467,2021-02-16,SIC,4202,2208,1994,3664,468,70,ITG,ITG1,19,Sicilia,Sicilia,4999891,5122684,102.46,0.08
1468,2021-06-17,SIC,41885,19502,22383,20360,21152,373,ITG,ITG1,19,Sicilia,Sicilia,4999891,5164569,103.29,0.84
1469,2020-12-31,SIC,897,477,420,889,0,8,ITG,ITG1,19,Sicilia,Sicilia,4999891,5165466,103.31,0.02
1470,2021-03-07,SIC,9271,3457,5814,8129,1083,59,ITG,ITG1,19,Sicilia,Sicilia,4999891,5174737,103.5,0.19
1471,2021-06-15,SIC,46152,21756,24396,28184,17532,436,ITG,ITG1,19,Sicilia,Sicilia,4999891,5220889,104.42,0.92
1472,2021-03-24,SIC,20988,9879,11109,15044,5743,201,ITG,ITG1,19,Sicilia,Sicilia,4999891,5241877,104.84,0.42
1473,2021-05-29,SIC,47192,21468,25724,23529,23214,449,ITG,ITG1,19,Sicilia,Sicilia,4999891,5289069,105.78,0.94
1474,2021-07-12,SIC,49003,22615,26388,6442,42360,201,ITG,ITG1,19,Sicilia,Sicilia,4999891,5338072,106.76,0.98
1475,2021-02-08,SIC,3889,1680,2209,2082,1759,48,ITG,ITG1,19,Sicilia,Sicilia,4999891,5341961,106.84,0.08
1476,2021-01-22,SIC,1294,641,653,261,1031,2,ITG,ITG1,19,Sicilia,Sicilia,4999891,5343255,106.87,0.03
1477,2021-01-08,SIC,8155,3796,4359,8062,0,93,ITG,ITG1,19,Sicilia,Sicilia,4999891,5351410,107.03,0.16
1478,2021-04-18,SIC,19836,9917,9919,15285,4363,188,ITG,ITG1,19,Sicilia,Sicilia,4999891,5371246,107.43,0.4
1479,2021-08-31,SIC,27986,14188,13798,10312,17376,298,ITG,ITG1,19,Sicilia,Sicilia,4999891,5399232,107.99,0.56
1480,2021-03-30,SIC,14587,6773,7814,9714,4771,102,ITG,ITG1,19,Sicilia,Sicilia,4999891,5413819,108.28,0.29
1481,2021-03-13,SIC,12225,5395,6830,7636,4499,90,ITG,ITG1,19,Sicilia,Sicilia,4999891,5426044,108.52,0.24
1482,2021-04-17,SIC,26010,13153,12857,18667,7068,275,ITG,ITG1,19,Sicilia,Sicilia,4999891,5452054,109.04,0.52
1483,2021-07-26,SIC,44552,22204,22348,16706,27474,372,ITG,ITG1,19,Sicilia,Sicilia,4999891,5496606,109.93,0.89
1484,2021-03-17,SIC,15055,7444,7611,9077,5852,126,ITG,ITG1,19,Sicilia,Sicilia,4999891,5511661,110.24,0.3
1485,2021-06-25,SIC,39803,18678,21125,17382,22082,339,ITG,ITG1,19,Sicilia,Sicilia,4999891,5551464,111.03,0.8
1486,2021-07-09,SIC,44825,20686,24139,6404,38238,183,ITG,ITG1,19,Sicilia,Sicilia,4999891,5596289,111.93,0.9
1487,2021-06-06,SIC,49533,23925,25608,41149,7828,556,ITG,ITG1,19,Sicilia,Sicilia,4999891,5645822,112.92,0.99
1488,2021-02-26,SIC,11988,5882,6106,10191,1681,116,ITG,ITG1,19,Sicilia,Sicilia,4999891,5657810,113.16,0.24
1489,2021-05-06,SIC,29487,14017,15470,18158,10840,489,ITG,ITG1,19,Sicilia,Sicilia,4999891,5687297,113.75,0.59
1490,2021-08-28,SIC,20870,11177,9693,7259,13391,220,ITG,ITG1,19,Sicilia,Sicilia,4999891,5708167,114.17,0.42
1491,2021-08-14,SIC,6148,3341,2807,3311,2716,121,ITG,ITG1,19,Sicilia,Sicilia,4999891,5714315,114.29,0.12
1492,2021-03-31,SIC,14524,6709,7815,9442,4934,148,ITG,ITG1,19,Sicilia,Sicilia,4999891,5728839,114.58,0.29
1493,2021-01-07,SIC,9076,4213,4863,8992,0,84,ITG,ITG1,19,Sicilia,Sicilia,4999891,5737915,114.76,0.18
1494,2021-08-13,SIC,11526,5970,5556,5987,5300,239,ITG,ITG1,19,Sicilia,Sicilia,4999891,5749441,114.99,0.23
1495,2021-02-09,SIC,4350,1800,2550,3248,1037,65,ITG,ITG1,19,Sicilia,Sicilia,4999891,5753791,115.08,0.09
1496,2021-05-20,SIC,44103,21131,22972,27752,15935,416,ITG,ITG1,19,Sicilia,Sicilia,4999891,5797894,115.96,0.88
1497,2021-05-22,TOS,26037,12667,13370,21490,4298,249,ITI,ITI1,9,Toscana,Toscana,3729641,26037,0.7,0.7
1498,2021-05-05,TOS,30163,13465,16698,14854,14573,736,ITI,ITI1,9,Toscana,Toscana,3729641,56200,1.51,0.81
1499,2021-08-13,TOS,23105,12517,10588,11332,11227,546,ITI,ITI1,9,Toscana,Toscana,3729641,79305,2.13,0.62
1500,2021-02-28,TOS,1649,667,982,852,727,70,ITI,ITI1,9,Toscana,Toscana,3729641,80954,2.17,0.04
1501,2021-02-11,TOS,5383,2022,3361,5060,242,81,ITI,ITI1,9,Toscana,Toscana,3729641,86337,2.31,0.14
1502,2021-02-09,TOS,4490,1470,3020,3765,611,114,ITI,ITI1,9,Toscana,Toscana,3729641,90827,2.44,0.12
1503,2021-06-22,TOS,31059,15629,15430,22462,8218,379,ITI,ITI1,9,Toscana,Toscana,3729641,121886,3.27,0.83
1504,2021-05-17,TOS,29780,14882,14898,20558,8943,279,ITI,ITI1,9,Toscana,Toscana,3729641,151666,4.07,0.8
1505,2021-03-21,TOS,3296,1629,1667,1819,1434,43,ITI,ITI1,9,Toscana,Toscana,3729641,154962,4.15,0.09
1506,2021-08-25,TOS,20290,10596,9694,10594,8970,726,ITI,ITI1,9,Toscana,Toscana,3729641,175252,4.7,0.54
1507,2021-01-23,TOS,3970,1360,2610,630,3334,6,ITI,ITI1,9,Toscana,Toscana,3729641,179222,4.81,0.11
1508,2021-06-29,TOS,37055,18043,19012,7983,28918,154,ITI,ITI1,9,Toscana,Toscana,3729641,216277,5.8,0.99
1509,2021-05-03,TOS,11944,5518,6426,10363,1333,248,ITI,ITI1,9,Toscana,Toscana,3729641,228221,6.12,0.32
1510,2021-08-01,TOS,29923,15318,14605,13787,15651,485,ITI,ITI1,9,Toscana,Toscana,3729641,258144,6.92,0.8
1511,2021-06-05,TOS,28455,13608,14847,20560,7621,274,ITI,ITI1,9,Toscana,Toscana,3729641,286599,7.68,0.76
1512,2021-08-08,TOS,25035,12919,12116,14610,9925,500,ITI,ITI1,9,Toscana,Toscana,3729641,311634,8.36,0.67
1513,2021-01-11,TOS,5095,1691,3404,4996,0,99,ITI,ITI1,9,Toscana,Toscana,3729641,316729,8.49,0.14
1514,2021-04-21,TOS,29652,12688,16964,16852,12161,639,ITI,ITI1,9,Toscana,Toscana,3729641,346381,9.29,0.8
1515,2021-02-23,TOS,7723,3325,4398,7209,162,352,ITI,ITI1,9,Toscana,Toscana,3729641,354104,9.49,0.21
1516,2021-06-03,TOS,32066,15457,16609,27153,4589,324,ITI,ITI1,9,Toscana,Toscana,3729641,386170,10.35,0.86
1517,2021-07-30,TOS,37912,20402,17510,10794,26762,356,ITI,ITI1,9,Toscana,Toscana,3729641,424082,11.37,1.02
1518,2021-07-13,TOS,29348,14736,14612,7715,21457,176,ITI,ITI1,9,Toscana,Toscana,3729641,453430,12.16,0.79
1519,2021-04-02,TOS,32036,13587,18449,23696,8085,255,ITI,ITI1,9,Toscana,Toscana,3729641,485466,13.02,0.86
1520,2021-01-16,TOS,3271,1046,2225,3213,0,58,ITI,ITI1,9,Toscana,Toscana,3729641,488737,13.1,0.09
1521,2021-04-26,TOS,10149,4936,5213,7456,2557,136,ITI,ITI1,9,Toscana,Toscana,3729641,498886,13.38,0.27
1522,2021-01-02,TOS,3499,1096,2403,3455,0,44,ITI,ITI1,9,Toscana,Toscana,3729641,502385,13.47,0.09
1523,2021-07-01,TOS,32082,15533,16549,10721,21079,282,ITI,ITI1,9,Toscana,Toscana,3729641,534467,14.33,0.86
1524,2021-03-26,TOS,20750,9432,11318,14709,5831,210,ITI,ITI1,9,Toscana,Toscana,3729641,555217,14.89,0.56
1525,2021-03-09,TOS,11144,4576,6568,5502,5563,79,ITI,ITI1,9,Toscana,Toscana,3729641,566361,15.19,0.3
1526,2021-04-09,TOS,24621,10585,14036,20717,3454,450,ITI,ITI1,9,Toscana,Toscana,3729641,590982,15.85,0.66
1527,2021-07-18,TOS,30386,15279,15107,8339,21837,210,ITI,ITI1,9,Toscana,Toscana,3729641,621368,16.66,0.81
1528,2021-06-17,TOS,32615,16710,15905,26707,5563,345,ITI,ITI1,9,Toscana,Toscana,3729641,653983,17.53,0.87
1529,2021-04-07,TOS,35860,15485,20375,28159,7278,423,ITI,ITI1,9,Toscana,Toscana,3729641,689843,18.5,0.96
1530,2021-08-27,TOS,16273,8698,7575,7751,7998,524,ITI,ITI1,9,Toscana,Toscana,3729641,706116,18.93,0.44
1531,2021-01-28,TOS,6286,1883,4403,346,5933,7,ITI,ITI1,9,Toscana,Toscana,3729641,712402,19.1,0.17
1532,2021-08-20,TOS,20211,11085,9126,9959,9756,496,ITI,ITI1,9,Toscana,Toscana,3729641,732613,19.64,0.54
1533,2021-03-28,TOS,6212,2807,3405,5876,253,83,ITI,ITI1,9,Toscana,Toscana,3729641,738825,19.81,0.17
1534,2021-01-30,TOS,4624,1623,3001,175,4431,18,ITI,ITI1,9,Toscana,Toscana,3729641,743449,19.93,0.12
1535,2021-07-06,TOS,25797,13040,12757,11039,14530,228,ITI,ITI1,9,Toscana,Toscana,3729641,769246,20.63,0.69
1536,2021-05-10,TOS,26242,12417,13825,15247,10648,347,ITI,ITI1,9,Toscana,Toscana,3729641,795488,21.33,0.7
1537,2021-03-14,TOS,7177,2571,4606,3149,3935,93,ITI,ITI1,9,Toscana,Toscana,3729641,802665,21.52,0.19
1538,2021-08-18,TOS,25940,13816,12124,12840,12496,604,ITI,ITI1,9,Toscana,Toscana,3729641,828605,22.22,0.7
1539,2021-09-01,TOS,23512,12380,11132,13335,9140,1037,ITI,ITI1,9,Toscana,Toscana,3729641,852117,22.85,0.63
1540,2021-06-10,TOS,26455,13572,12883,25547,559,349,ITI,ITI1,9,Toscana,Toscana,3729641,878572,23.56,0.71
1541,2021-05-24,TOS,33763,16727,17036,23897,9586,280,ITI,ITI1,9,Toscana,Toscana,3729641,912335,24.46,0.91
1542,2021-02-04,TOS,4255,1595,2660,933,3295,27,ITI,ITI1,9,Toscana,Toscana,3729641,916590,24.58,0.11
1543,2021-05-15,TOS,29372,13863,15509,22871,5905,596,ITI,ITI1,9,Toscana,Toscana,3729641,945962,25.36,0.79
1544,2021-04-28,TOS,19151,8193,10958,3446,15347,358,ITI,ITI1,9,Toscana,Toscana,3729641,965113,25.88,0.51
1545,2021-02-18,TOS,8825,3286,5539,7745,896,184,ITI,ITI1,9,Toscana,Toscana,3729641,973938,26.11,0.24
1546,2021-05-29,TOS,31581,15267,16314,23181,8172,228,ITI,ITI1,9,Toscana,Toscana,3729641,1005519,26.96,0.85
1547,2021-08-06,TOS,32958,17670,15288,15346,17136,476,ITI,ITI1,9,Toscana,Toscana,3729641,1038477,27.84,0.88
1548,2021-07-11,TOS,26191,12730,13461,9175,16842,174,ITI,ITI1,9,Toscana,Toscana,3729641,1064668,28.55,0.7
1549,2021-06-24,TOS,29467,14631,14836,19319,9752,396,ITI,ITI1,9,Toscana,Toscana,3729641,1094135,29.34,0.79
1550,2021-01-09,TOS,4487,1597,2890,4421,0,66,ITI,ITI1,9,Toscana,Toscana,3729641,1098622,29.46,0.12
1551,2021-02-16,TOS,9282,3340,5942,8331,721,230,ITI,ITI1,9,Toscana,Toscana,3729641,1107904,29.71,0.25
1552,2021-05-02,TOS,11180,4936,6244,8977,1969,234,ITI,ITI1,9,Toscana,Toscana,3729641,1119084,30.01,0.3
1553,2021-03-07,TOS,5649,2358,3291,1993,3545,111,ITI,ITI1,9,Toscana,Toscana,3729641,1124733,30.16,0.15
1554,2021-07-20,TOS,37344,19108,18236,7970,29182,192,ITI,ITI1,9,Toscana,Toscana,3729641,1162077,31.16,1.0
1555,2021-06-12,TOS,29406,15158,14248,24658,4393,355,ITI,ITI1,9,Toscana,Toscana,3729641,1191483,31.95,0.79
1556,2021-04-16,TOS,28991,12894,16097,21432,6925,634,ITI,ITI1,9,Toscana,Toscana,3729641,1220474,32.72,0.78
1557,2021-07-25,TOS,33939,16787,17152,7067,26691,181,ITI,ITI1,9,Toscana,Toscana,3729641,1254413,33.63,0.91
1558,2021-03-02,TOS,10604,3800,6804,7042,3448,114,ITI,ITI1,9,Toscana,Toscana,3729641,1265017,33.92,0.28
1559,2021-01-04,TOS,5067,1896,3171,5002,0,65,ITI,ITI1,9,Toscana,Toscana,3729641,1270084,34.05,0.14
1560,2021-04-14,TOS,20214,8354,11860,14510,5155,549,ITI,ITI1,9,Toscana,Toscana,3729641,1290298,34.6,0.54
1561,2021-06-14,TOS,31831,16351,15480,27427,4109,295,ITI,ITI1,9,Toscana,Toscana,3729641,1322129,35.45,0.85
1562,2021-03-19,TOS,10172,4475,5697,7127,2897,148,ITI,ITI1,9,Toscana,Toscana,3729641,1332301,35.72,0.27
1563,2021-01-21,TOS,1589,686,903,858,722,9,ITI,ITI1,9,Toscana,Toscana,3729641,1333890,35.76,0.04
1564,2021-01-25,TOS,5132,1895,3237,240,4888,4,ITI,ITI1,9,Toscana,Toscana,3729641,1339022,35.9,0.14
1565,2021-04-18,TOS,8372,4097,4275,7062,1034,276,ITI,ITI1,9,Toscana,Toscana,3729641,1347394,36.13,0.22
1566,2021-07-27,TOS,38729,20138,18591,11267,27116,346,ITI,ITI1,9,Toscana,Toscana,3729641,1386123,37.17,1.04
1567,2021-07-10,TOS,29316,14187,15129,7956,21170,190,ITI,ITI1,9,Toscana,Toscana,3729641,1415439,37.95,0.79
1568,2021-03-23,TOS,9453,4415,5038,6969,2285,199,ITI,ITI1,9,Toscana,Toscana,3729641,1424892,38.2,0.25
1569,2020-12-30,TOS,329,106,223,328,0,1,ITI,ITI1,9,Toscana,Toscana,3729641,1425221,38.21,0.01
1570,2021-08-24,TOS,21872,11468,10404,12723,8287,862,ITI,ITI1,9,Toscana,Toscana,3729641,1447093,38.8,0.59
1571,2021-08-05,TOS,34746,18020,16726,12126,22247,373,ITI,ITI1,9,Toscana,Toscana,3729641,1481839,39.73,0.93
1572,2021-03-18,TOS,9988,3987,6001,5857,3994,137,ITI,ITI1,9,Toscana,Toscana,3729641,1491827,40.0,0.27
1573,2021-06-26,TOS,34579,16773,17806,9992,24355,232,ITI,ITI1,9,Toscana,Toscana,3729641,1526406,40.93,0.93
1574,2021-06-09,TOS,34852,17584,17268,33960,463,429,ITI,ITI1,9,Toscana,Toscana,3729641,1561258,41.86,0.93
1575,2021-04-04,TOS,13927,6612,7315,13507,255,165,ITI,ITI1,9,Toscana,Toscana,3729641,1575185,42.23,0.37
1576,2021-08-10,TOS,25924,13486,12438,16350,8927,647,ITI,ITI1,9,Toscana,Toscana,3729641,1601109,42.93,0.7
1577,2021-02-25,TOS,10632,4305,6327,9464,998,170,ITI,ITI1,9,Toscana,Toscana,3729641,1611741,43.21,0.29
1578,2021-06-28,TOS,37705,18144,19561,8437,29100,168,ITI,ITI1,9,Toscana,Toscana,3729641,1649446,44.23,1.01
1579,2021-01-20,TOS,1335,641,694,1023,249,63,ITI,ITI1,9,Toscana,Toscana,3729641,1650781,44.26,0.04
1580,2021-04-30,TOS,40251,17813,22438,19653,19952,646,ITI,ITI1,9,Toscana,Toscana,3729641,1691032,45.34,1.08
1581,2021-04-25,TOS,11067,5252,5815,8760,2146,161,ITI,ITI1,9,Toscana,Toscana,3729641,1702099,45.64,0.3
1582,2021-03-04,TOS,17869,6964,10905,14627,3085,157,ITI,ITI1,9,Toscana,Toscana,3729641,1719968,46.12,0.48
1583,2021-08-17,TOS,25986,14021,11965,11459,14032,495,ITI,ITI1,9,Toscana,Toscana,3729641,1745954,46.81,0.7
1584,2021-06-21,TOS,31209,15499,15710,18144,12801,264,ITI,ITI1,9,Toscana,Toscana,3729641,1777163,47.65,0.84
1585,2021-01-06,TOS,4519,1460,3059,4467,0,52,ITI,ITI1,9,Toscana,Toscana,3729641,1781682,47.77,0.12
1586,2021-03-11,TOS,15972,6388,9584,12416,3373,183,ITI,ITI1,9,Toscana,Toscana,3729641,1797654,48.2,0.43
1587,2021-06-19,TOS,26524,13930,12594,21394,4791,339,ITI,ITI1,9,Toscana,Toscana,3729641,1824178,48.91,0.71
1588,2021-05-12,TOS,34232,15590,18642,13584,20062,586,ITI,ITI1,9,Toscana,Toscana,3729641,1858410,49.83,0.92
1589,2021-01-18,TOS,1120,637,483,972,98,50,ITI,ITI1,9,Toscana,Toscana,3729641,1859530,49.86,0.03
1590,2021-02-01,TOS,5514,1959,3555,510,4994,10,ITI,ITI1,9,Toscana,Toscana,3729641,1865044,50.01,0.15
1591,2021-06-02,TOS,27613,13632,13981,21867,5512,234,ITI,ITI1,9,Toscana,Toscana,3729641,1892657,50.75,0.74
1592,2021-04-06,TOS,22244,9838,12406,18080,3745,419,ITI,ITI1,9,Toscana,Toscana,3729641,1914901,51.34,0.6
1593,2021-02-08,TOS,4100,1362,2738,3530,459,111,ITI,ITI1,9,Toscana,Toscana,3729641,1919001,51.45,0.11
1594,2021-07-15,TOS,31260,15298,15962,8088,22924,248,ITI,ITI1,9,Toscana,Toscana,3729641,1950261,52.29,0.84
1595,2021-05-19,TOS,27977,13588,14389,18644,9066,267,ITI,ITI1,9,Toscana,Toscana,3729641,1978238,53.04,0.75
1596,2021-04-13,TOS,8498,3510,4988,5738,2477,283,ITI,ITI1,9,Toscana,Toscana,3729641,1986736,53.27,0.23
1597,2021-02-05,TOS,5751,2245,3506,1888,3829,34,ITI,ITI1,9,Toscana,Toscana,3729641,1992487,53.42,0.15
1598,2021-05-16,TOS,26691,12895,13796,23925,2470,296,ITI,ITI1,9,Toscana,Toscana,3729641,2019178,54.14,0.72
1599,2021-05-11,TOS,27972,12997,14975,12102,15490,380,ITI,ITI1,9,Toscana,Toscana,3729641,2047150,54.89,0.75
1600,2021-08-19,TOS,24189,12834,11355,11915,11645,629,ITI,ITI1,9,Toscana,Toscana,3729641,2071339,55.54,0.65
1601,2021-03-16,TOS,4906,1885,3021,2569,2256,81,ITI,ITI1,9,Toscana,Toscana,3729641,2076245,55.67,0.13
1602,2021-02-27,TOS,1984,756,1228,1006,902,76,ITI,ITI1,9,Toscana,Toscana,3729641,2078229,55.72,0.05
1603,2021-06-07,TOS,34978,17163,17815,30976,3654,348,ITI,ITI1,9,Toscana,Toscana,3729641,2113207,56.66,0.94
1604,2021-05-21,TOS,28958,13502,15456,17227,11474,257,ITI,ITI1,9,Toscana,Toscana,3729641,2142165,57.44,0.78
1605,2021-08-29,TOS,16868,8908,7960,7475,8821,572,ITI,ITI1,9,Toscana,Toscana,3729641,2159033,57.89,0.45
1606,2021-05-07,TOS,32186,14720,17466,11350,20223,613,ITI,ITI1,9,Toscana,Toscana,3729641,2191219,58.75,0.86
1607,2021-08-15,TOS,14688,7760,6928,5268,9236,184,ITI,ITI1,9,Toscana,Toscana,3729641,2205907,59.15,0.39
1608,2021-07-29,TOS,39410,20528,18882,12612,26452,346,ITI,ITI1,9,Toscana,Toscana,3729641,2245317,60.2,1.06
1609,2021-02-13,TOS,7788,2362,5426,7413,227,148,ITI,ITI1,9,Toscana,Toscana,3729641,2253105,60.41,0.21
1610,2021-01-08,TOS,5948,1644,4304,5855,0,93,ITI,ITI1,9,Toscana,Toscana,3729641,2259053,60.57,0.16
1611,2021-07-12,TOS,28286,14006,14280,9665,18317,304,ITI,ITI1,9,Toscana,Toscana,3729641,2287339,61.33,0.76
1612,2021-04-01,TOS,27157,11264,15893,16185,10731,241,ITI,ITI1,9,Toscana,Toscana,3729641,2314496,62.06,0.73
1613,2021-03-15,TOS,8713,3659,5054,4090,4448,175,ITI,ITI1,9,Toscana,Toscana,3729641,2323209,62.29,0.23
1614,2021-06-23,TOS,31582,15315,16267,19821,11397,364,ITI,ITI1,9,Toscana,Toscana,3729641,2354791,63.14,0.85
1615,2021-02-06,TOS,4529,1551,2978,1261,3236,32,ITI,ITI1,9,Toscana,Toscana,3729641,2359320,63.26,0.12
1616,2021-07-17,TOS,27758,14343,13415,8964,18553,241,ITI,ITI1,9,Toscana,Toscana,3729641,2387078,64.0,0.74
1617,2021-08-03,TOS,36348,18923,17425,12167,23803,378,ITI,ITI1,9,Toscana,Toscana,3729641,2423426,64.98,0.97
1618,2021-01-13,TOS,4063,1398,2665,3999,0,64,ITI,ITI1,9,Toscana,Toscana,3729641,2427489,65.09,0.11
1619,2021-04-23,TOS,25682,11433,14249,8801,16350,531,ITI,ITI1,9,Toscana,Toscana,3729641,2453171,65.77,0.69
1620,2021-09-02,TOS,17979,9381,8598,10989,6078,912,ITI,ITI1,9,Toscana,Toscana,3729641,2471150,66.26,0.48
1621,2021-07-22,TOS,39392,19799,19593,4482,34743,167,ITI,ITI1,9,Toscana,Toscana,3729641,2510542,67.31,1.06
1622,2021-05-26,TOS,35624,17117,18507,20148,15220,256,ITI,ITI1,9,Toscana,Toscana,3729641,2546166,68.27,0.96
1623,2021-03-30,TOS,17039,7647,9392,13267,3574,198,ITI,ITI1,9,Toscana,Toscana,3729641,2563205,68.73,0.46
1624,2021-09-03,TOS,9815,5048,4767,5275,4035,505,ITI,ITI1,9,Toscana,Toscana,3729641,2573020,68.99,0.26
1625,2021-07-08,TOS,21095,10370,10725,9267,11587,241,ITI,ITI1,9,Toscana,Toscana,3729641,2594115,69.55,0.57
1626,2021-01-10,TOS,3002,1105,1897,2947,0,55,ITI,ITI1,9,Toscana,Toscana,3729641,2597117,69.63,0.08
1627,2021-04-20,TOS,18162,8110,10052,12208,5590,364,ITI,ITI1,9,Toscana,Toscana,3729641,2615279,70.12,0.49
1628,2021-04-03,TOS,15017,6646,8371,13675,1126,216,ITI,ITI1,9,Toscana,Toscana,3729641,2630296,70.52,0.4
1629,2021-01-27,TOS,4837,1575,3262,200,4632,5,ITI,ITI1,9,Toscana,Toscana,3729641,2635133,70.65,0.13
1630,2021-08-30,TOS,24770,12529,12241,13118,10527,1125,ITI,ITI1,9,Toscana,Toscana,3729641,2659903,71.32,0.66
1631,2021-04-27,TOS,10377,4927,5450,3667,6506,204,ITI,ITI1,9,Toscana,Toscana,3729641,2670280,71.6,0.28
1632,2021-07-19,TOS,38039,18960,19079,8810,28939,290,ITI,ITI1,9,Toscana,Toscana,3729641,2708319,72.62,1.02
1633,2021-03-01,TOS,4474,1734,2740,765,3642,67,ITI,ITI1,9,Toscana,Toscana,3729641,2712793,72.74,0.12
1634,2021-03-13,TOS,9292,3311,5981,5170,3968,154,ITI,ITI1,9,Toscana,Toscana,3729641,2722085,72.99,0.25
1635,2021-07-14,TOS,28962,14296,14666,8608,20097,257,ITI,ITI1,9,Toscana,Toscana,3729641,2751047,73.76,0.78
1636,2021-01-29,TOS,6150,1702,4448,290,5848,12,ITI,ITI1,9,Toscana,Toscana,3729641,2757197,73.93,0.16
1637,2021-05-09,TOS,22555,9784,12771,9412,12881,262,ITI,ITI1,9,Toscana,Toscana,3729641,2779752,74.53,0.6
1638,2021-08-26,TOS,18578,9735,8843,9501,8358,719,ITI,ITI1,9,Toscana,Toscana,3729641,2798330,75.03,0.5
1639,2021-07-16,TOS,27684,14049,13635,7703,19727,254,ITI,ITI1,9,Toscana,Toscana,3729641,2826014,75.77,0.74
1640,2021-05-20,TOS,29781,13925,15856,18640,10856,285,ITI,ITI1,9,Toscana,Toscana,3729641,2855795,76.57,0.8
1641,2021-08-28,TOS,15778,8500,7278,6376,8949,453,ITI,ITI1,9,Toscana,Toscana,3729641,2871573,76.99,0.42
1642,2021-01-31,TOS,3052,1131,1921,100,2949,3,ITI,ITI1,9,Toscana,Toscana,3729641,2874625,77.08,0.08
1643,2021-04-05,TOS,15289,6826,8463,14370,739,180,ITI,ITI1,9,Toscana,Toscana,3729641,2889914,77.49,0.41
1644,2021-02-07,TOS,2810,955,1855,864,1926,20,ITI,ITI1,9,Toscana,Toscana,3729641,2892724,77.56,0.08
1645,2021-06-11,TOS,29761,15499,14262,24734,4661,366,ITI,ITI1,9,Toscana,Toscana,3729641,2922485,78.36,0.8
1646,2021-04-15,TOS,24493,10238,14255,15340,8621,532,ITI,ITI1,9,Toscana,Toscana,3729641,2946978,79.02,0.66
1647,2021-02-17,TOS,8178,3171,5007,7300,754,124,ITI,ITI1,9,Toscana,Toscana,3729641,2955156,79.23,0.22
1648,2021-07-24,TOS,38450,19373,19077,6850,31369,231,ITI,ITI1,9,Toscana,Toscana,3729641,2993606,80.27,1.03
1649,2021-05-28,TOS,30150,13957,16193,17428,12491,231,ITI,ITI1,9,Toscana,Toscana,3729641,3023756,81.07,0.81
1650,2021-04-22,TOS,35786,15317,20469,17402,17556,828,ITI,ITI1,9,Toscana,Toscana,3729641,3059542,82.03,0.96
1651,2021-02-24,TOS,10374,4467,5907,10036,198,140,ITI,ITI1,9,Toscana,Toscana,3729641,3069916,82.31,0.28
1652,2021-07-31,TOS,35839,19212,16627,12372,23018,449,ITI,ITI1,9,Toscana,Toscana,3729641,3105755,83.27,0.96
1653,2021-06-04,TOS,28343,13452,14891,20264,7811,268,ITI,ITI1,9,Toscana,Toscana,3729641,3134098,84.03,0.76
1654,2021-04-08,TOS,29767,12596,17171,22945,6453,369,ITI,ITI1,9,Toscana,Toscana,3729641,3163865,84.83,0.8
1655,2021-01-17,TOS,2536,871,1665,1987,514,35,ITI,ITI1,9,Toscana,Toscana,3729641,3166401,84.9,0.07
1656,2021-07-05,TOS,30531,15094,15437,10343,19957,231,ITI,ITI1,9,Toscana,Toscana,3729641,3196932,85.72,0.82
1657,2021-03-08,TOS,6714,2951,3763,1841,4826,47,ITI,ITI1,9,Toscana,Toscana,3729641,3203646,85.9,0.18
1658,2021-06-16,TOS,31798,16279,15519,26287,5189,322,ITI,ITI1,9,Toscana,Toscana,3729641,3235444,86.75,0.85
1659,2021-05-30,TOS,28704,13958,14746,21509,6953,242,ITI,ITI1,9,Toscana,Toscana,3729641,3264148,87.52,0.77
1660,2021-03-17,TOS,11431,4593,6838,6801,4537,93,ITI,ITI1,9,Toscana,Toscana,3729641,3275579,87.83,0.31
1661,2021-06-25,TOS,33650,16829,16821,12108,21259,283,ITI,ITI1,9,Toscana,Toscana,3729641,3309229,88.73,0.9
1662,2021-06-08,TOS,32610,16728,15882,31735,491,384,ITI,ITI1,9,Toscana,Toscana,3729641,3341839,89.6,0.87
1663,2021-02-26,TOS,10092,3841,6251,8662,1211,219,ITI,ITI1,9,Toscana,Toscana,3729641,3351931,89.87,0.27
1664,2021-06-06,TOS,28327,13664,14663,22591,5370,366,ITI,ITI1,9,Toscana,Toscana,3729641,3380258,90.63,0.76
1665,2021-03-20,TOS,6590,2978,3612,5361,1138,91,ITI,ITI1,9,Toscana,Toscana,3729641,3386848,90.81,0.18
1666,2021-01-22,TOS,2866,1064,1802,524,2339,3,ITI,ITI1,9,Toscana,Toscana,3729641,3389714,90.89,0.08
1667,2021-07-07,TOS,25645,12608,13037,9333,16120,192,ITI,ITI1,9,Toscana,Toscana,3729641,3415359,91.57,0.69
1668,2021-03-03,TOS,18233,6540,11693,14496,3609,128,ITI,ITI1,9,Toscana,Toscana,3729641,3433592,92.06,0.49
1669,2021-01-05,TOS,5249,1755,3494,5193,0,56,ITI,ITI1,9,Toscana,Toscana,3729641,3438841,92.2,0.14
1670,2021-01-19,TOS,1105,532,573,1063,0,42,ITI,ITI1,9,Toscana,Toscana,3729641,3439946,92.23,0.03
1671,2021-08-11,TOS,27057,14189,12868,16912,9410,735,ITI,ITI1,9,Toscana,Toscana,3729641,3467003,92.96,0.73
1672,2021-01-12,TOS,3583,1398,2185,3510,0,73,ITI,ITI1,9,Toscana,Toscana,3729641,3470586,93.05,0.1
1673,2021-03-27,TOS,8865,4155,4710,8511,216,138,ITI,ITI1,9,Toscana,Toscana,3729641,3479451,93.29,0.24
1674,2021-06-30,TOS,38284,18523,19761,8462,29602,220,ITI,ITI1,9,Toscana,Toscana,3729641,3517735,94.32,1.03
1675,2021-02-14,TOS,9001,2570,6431,8738,110,153,ITI,ITI1,9,Toscana,Toscana,3729641,3526736,94.56,0.24
1676,2021-05-25,TOS,34210,16517,17693,19293,14644,273,ITI,ITI1,9,Toscana,Toscana,3729641,3560946,95.48,0.92
1677,2021-03-29,TOS,9699,4850,4849,9213,351,135,ITI,ITI1,9,Toscana,Toscana,3729641,3570645,95.74,0.26
1678,2021-07-23,TOS,38459,19306,19153,4391,33911,157,ITI,ITI1,9,Toscana,Toscana,3729641,3609104,96.77,1.03
1679,2021-05-18,TOS,28848,14280,14568,19763,8831,254,ITI,ITI1,9,Toscana,Toscana,3729641,3637952,97.54,0.77
1680,2021-05-27,TOS,28382,13212,15170,13280,14880,222,ITI,ITI1,9,Toscana,Toscana,3729641,3666334,98.3,0.76
1681,2021-03-31,TOS,32787,13286,19501,20198,12246,343,ITI,ITI1,9,Toscana,Toscana,3729641,3699121,99.18,0.88
1682,2021-07-09,TOS,29141,14116,15025,7693,21252,196,ITI,ITI1,9,Toscana,Toscana,3729641,3728262,99.96,0.78
1683,2021-03-22,TOS,5261,2771,2490,4676,447,138,ITI,ITI1,9,Toscana,Toscana,3729641,3733523,100.1,0.14
1684,2021-07-04,TOS,31546,15318,16228,9361,21886,299,ITI,ITI1,9,Toscana,Toscana,3729641,3765069,100.95,0.85
1685,2020-12-31,TOS,802,201,601,798,0,4,ITI,ITI1,9,Toscana,Toscana,3729641,3765871,100.97,0.02
1686,2021-04-10,TOS,11753,5368,6385,10772,743,238,ITI,ITI1,9,Toscana,Toscana,3729641,3777624,101.29,0.32
1687,2021-05-23,TOS,28440,13675,14765,25609,2562,269,ITI,ITI1,9,Toscana,Toscana,3729641,3806064,102.05,0.76
1688,2021-08-31,TOS,20788,10834,9954,11301,8741,746,ITI,ITI1,9,Toscana,Toscana,3729641,3826852,102.61,0.56
1689,2021-08-14,TOS,22372,12208,10164,10449,11507,416,ITI,ITI1,9,Toscana,Toscana,3729641,3849224,103.21,0.6
1690,2021-08-12,TOS,25839,13442,12397,14304,10891,644,ITI,ITI1,9,Toscana,Toscana,3729641,3875063,103.9,0.69
1691,2021-07-26,TOS,38296,19866,18430,10083,27903,310,ITI,ITI1,9,Toscana,Toscana,3729641,3913359,104.93,1.03
1692,2021-02-10,TOS,4269,1286,2983,3587,526,156,ITI,ITI1,9,Toscana,Toscana,3729641,3917628,105.04,0.11
1693,2021-05-04,TOS,18330,8221,10109,12415,5469,446,ITI,ITI1,9,Toscana,Toscana,3729641,3935958,105.53,0.49
1694,2021-08-23,TOS,22734,11808,10926,11470,10535,729,ITI,ITI1,9,Toscana,Toscana,3729641,3958692,106.14,0.61
1695,2021-02-19,TOS,8294,2952,5342,7601,513,180,ITI,ITI1,9,Toscana,Toscana,3729641,3966986,106.36,0.22
1696,2020-12-27,TOS,620,267,353,615,0,5,ITI,ITI1,9,Toscana,Toscana,3729641,3967606,106.38,0.02
1697,2021-08-02,TOS,35303,18086,17217,13359,21552,392,ITI,ITI1,9,Toscana,Toscana,3729641,4002909,107.33,0.95
1698,2021-01-03,TOS,3338,1053,2285,3292,0,46,ITI,ITI1,9,Toscana,Toscana,3729641,4006247,107.42,0.09
1699,2021-02-15,TOS,8771,3377,5394,7772,826,173,ITI,ITI1,9,Toscana,Toscana,3729641,4015018,107.65,0.24
1700,2021-02-22,TOS,9824,4256,5568,9169,278,377,ITI,ITI1,9,Toscana,Toscana,3729641,4024842,107.91,0.26
1701,2021-05-08,TOS,29190,13132,16058,13263,15526,401,ITI,ITI1,9,Toscana,Toscana,3729641,4054032,108.7,0.78
1702,2021-03-12,TOS,16996,6627,10369,13271,3532,193,ITI,ITI1,9,Toscana,Toscana,3729641,4071028,109.15,0.46
1703,2021-08-16,TOS,29988,15744,14244,16590,12696,702,ITI,ITI1,9,Toscana,Toscana,3729641,4101016,109.96,0.8
1704,2021-01-14,TOS,3255,1179,2076,3219,0,36,ITI,ITI1,9,Toscana,Toscana,3729641,4104271,110.04,0.09
1705,2021-06-20,TOS,25189,12490,12699,15425,9522,242,ITI,ITI1,9,Toscana,Toscana,3729641,4129460,110.72,0.68
1706,2021-04-24,TOS,13449,6174,7275,5620,7460,369,ITI,ITI1,9,Toscana,Toscana,3729641,4142909,111.08,0.36
1707,2021-06-27,TOS,33309,16080,17229,5917,27259,133,ITI,ITI1,9,Toscana,Toscana,3729641,4176218,111.97,0.89
1708,2021-05-01,TOS,23342,10072,13270,13729,9228,385,ITI,ITI1,9,Toscana,Toscana,3729641,4199560,112.6,0.63
1709,2021-03-05,TOS,16884,6691,10193,11943,4760,181,ITI,ITI1,9,Toscana,Toscana,3729641,4216444,113.05,0.45
1710,2021-08-09,TOS,28959,14707,14252,18494,9756,709,ITI,ITI1,9,Toscana,Toscana,3729641,4245403,113.83,0.78
1711,2021-06-13,TOS,24621,12354,12267,22600,1659,362,ITI,ITI1,9,Toscana,Toscana,3729641,4270024,114.49,0.66
1712,2021-02-12,TOS,7619,2694,4925,7293,213,113,ITI,ITI1,9,Toscana,Toscana,3729641,4277643,114.69,0.2
1713,2021-07-28,TOS,38570,20164,18406,12109,26122,339,ITI,ITI1,9,Toscana,Toscana,3729641,4316213,115.73,1.03
1714,2021-01-26,TOS,5399,1794,3605,209,5186,4,ITI,ITI1,9,Toscana,Toscana,3729641,4321612,115.87,0.14
1715,2021-05-06,TOS,31437,13674,17763,13455,17287,695,ITI,ITI1,9,Toscana,Toscana,3729641,4353049,116.71,0.84
1716,2021-04-19,TOS,9105,4516,4589,7754,1034,317,ITI,ITI1,9,Toscana,Toscana,3729641,4362154,116.96,0.24
1717,2021-04-17,TOS,20582,9231,11351,17947,2145,490,ITI,ITI1,9,Toscana,Toscana,3729641,4382736,117.51,0.55
1718,2021-01-24,TOS,3349,1072,2277,196,3150,3,ITI,ITI1,9,Toscana,Toscana,3729641,4386085,117.6,0.09
1719,2021-01-07,TOS,6018,1751,4267,5932,0,86,ITI,ITI1,9,Toscana,Toscana,3729641,4392103,117.76,0.16
1720,2021-08-22,TOS,18520,9964,8556,7303,10902,315,ITI,ITI1,9,Toscana,Toscana,3729641,4410623,118.26,0.5
1721,2021-02-20,TOS,4664,1797,2867,3993,537,134,ITI,ITI1,9,Toscana,Toscana,3729641,4415287,118.38,0.13
1722,2021-05-31,TOS,30358,14651,15707,19268,10848,242,ITI,ITI1,9,Toscana,Toscana,3729641,4445645,119.2,0.81
1723,2021-05-14,TOS,33402,15461,17941,20021,12738,643,ITI,ITI1,9,Toscana,Toscana,3729641,4479047,120.09,0.9
1724,2021-01-01,TOS,2370,788,1582,2325,0,45,ITI,ITI1,9,Toscana,Toscana,3729641,4481417,120.16,0.06
1725,2021-04-11,TOS,3646,1681,1965,3334,156,156,ITI,ITI1,9,Toscana,Toscana,3729641,4485063,120.25,0.1
1726,2021-07-03,TOS,29429,14827,14602,11871,17173,385,ITI,ITI1,9,Toscana,Toscana,3729641,4514492,121.04,0.79
1727,2021-08-07,TOS,30466,16292,14174,14213,15766,487,ITI,ITI1,9,Toscana,Toscana,3729641,4544958,121.86,0.82
1728,2021-03-06,TOS,7114,2853,4261,2826,4203,85,ITI,ITI1,9,Toscana,Toscana,3729641,4552072,122.05,0.19
1729,2021-08-21,TOS,17924,9926,7998,8090,9458,376,ITI,ITI1,9,Toscana,Toscana,3729641,4569996,122.53,0.48
1730,2021-02-03,TOS,4226,1452,2774,236,3986,4,ITI,ITI1,9,Toscana,Toscana,3729641,4574222,122.65,0.11
1731,2021-01-15,TOS,3879,1348,2531,3819,0,60,ITI,ITI1,9,Toscana,Toscana,3729641,4578101,122.75,0.1
1732,2021-06-18,TOS,30829,16268,14561,25009,5407,413,ITI,ITI1,9,Toscana,Toscana,3729641,4608930,123.58,0.83
1733,2021-03-25,TOS,23986,10413,13573,15315,8409,262,ITI,ITI1,9,Toscana,Toscana,3729641,4632916,124.22,0.64
1734,2021-04-12,TOS,2624,1193,1431,1799,656,169,ITI,ITI1,9,Toscana,Toscana,3729641,4635540,124.29,0.07
1735,2021-07-21,TOS,38513,19656,18857,7347,30932,234,ITI,ITI1,9,Toscana,Toscana,3729641,4674053,125.32,1.03
1736,2021-05-13,TOS,35199,15548,19651,13204,21354,641,ITI,ITI1,9,Toscana,Toscana,3729641,4709252,126.27,0.94
1737,2021-08-04,TOS,34851,18031,16820,11356,23077,418,ITI,ITI1,9,Toscana,Toscana,3729641,4744103,127.2,0.93
1738,2021-04-29,TOS,39383,17742,21641,18560,20159,664,ITI,ITI1,9,Toscana,Toscana,3729641,4783486,128.26,1.06
1739,2021-03-24,TOS,20049,8319,11730,10416,9488,145,ITI,ITI1,9,Toscana,Toscana,3729641,4803535,128.79,0.54
1740,2021-02-21,TOS,5104,2088,3016,4730,170,204,ITI,ITI1,9,Toscana,Toscana,3729641,4808639,128.93,0.14
1741,2021-06-01,TOS,26963,13398,13565,22871,3838,254,ITI,ITI1,9,Toscana,Toscana,3729641,4835602,129.65,0.72
1742,2021-07-02,TOS,28311,14208,14103,10813,17200,298,ITI,ITI1,9,Toscana,Toscana,3729641,4863913,130.41,0.76
1743,2021-06-15,TOS,31235,16078,15157,26312,4574,349,ITI,ITI1,9,Toscana,Toscana,3729641,4895148,131.25,0.84
1744,2021-03-10,TOS,18374,7408,10966,14269,3998,107,ITI,ITI1,9,Toscana,Toscana,3729641,4913522,131.74,0.49
1745,2021-02-02,TOS,3744,1476,2268,187,3550,7,ITI,ITI1,9,Toscana,Toscana,3729641,4917266,131.84,0.1
1746,2021-05-26,LAZ,47672,21927,25745,34876,12149,647,ITI,ITI4,12,Lazio,Lazio,5879082,47672,0.81,0.81
1747,2021-03-04,LAZ,19465,8746,10719,14183,5034,248,ITI,ITI4,12,Lazio,Lazio,5879082,67137,1.14,0.33
1748,2021-06-12,LAZ,69946,32123,37823,39883,29417,646,ITI,ITI4,12,Lazio,Lazio,5879082,137083,2.33,1.19
1749,2021-06-14,LAZ,63092,29558,33534,32325,30200,567,ITI,ITI4,12,Lazio,Lazio,5879082,200175,3.4,1.07
1750,2021-03-21,LAZ,18292,7202,11090,13027,5071,194,ITI,ITI4,12,Lazio,Lazio,5879082,218467,3.72,0.31
1751,2021-03-16,LAZ,13642,5781,7861,7052,6506,84,ITI,ITI4,12,Lazio,Lazio,5879082,232109,3.95,0.23
1752,2021-03-09,LAZ,22044,9960,12084,16454,5226,364,ITI,ITI4,12,Lazio,Lazio,5879082,254153,4.32,0.37
1753,2021-01-11,LAZ,5704,2174,3530,5558,0,146,ITI,ITI4,12,Lazio,Lazio,5879082,259857,4.42,0.1
1754,2021-02-20,LAZ,9219,4275,4944,8366,780,73,ITI,ITI4,12,Lazio,Lazio,5879082,269076,4.58,0.16
1755,2021-05-31,LAZ,51805,23069,28736,30880,19904,1021,ITI,ITI4,12,Lazio,Lazio,5879082,320881,5.46,0.88
1756,2021-04-04,LAZ,17668,8202,9466,12262,5291,115,ITI,ITI4,12,Lazio,Lazio,5879082,338549,5.76,0.3
1757,2021-02-18,LAZ,10089,5018,5071,9106,876,107,ITI,ITI4,12,Lazio,Lazio,5879082,348638,5.93,0.17
1758,2021-05-12,LAZ,47621,21621,26000,30240,16689,692,ITI,ITI4,12,Lazio,Lazio,5879082,396259,6.74,0.81
1759,2021-02-01,LAZ,5685,2185,3500,354,5330,1,ITI,ITI4,12,Lazio,Lazio,5879082,401944,6.84,0.1
1760,2021-03-30,LAZ,27124,13193,13931,19541,7221,362,ITI,ITI4,12,Lazio,Lazio,5879082,429068,7.3,0.46
1761,2021-07-08,LAZ,64355,31591,32764,28183,35496,676,ITI,ITI4,12,Lazio,Lazio,5879082,493423,8.39,1.09
1762,2021-07-27,LAZ,56415,27398,29017,8101,47984,330,ITI,ITI4,12,Lazio,Lazio,5879082,549838,9.35,0.96
1763,2021-04-18,LAZ,23868,10608,13260,15852,7700,316,ITI,ITI4,12,Lazio,Lazio,5879082,573706,9.76,0.41
1764,2021-04-16,LAZ,34569,15765,18804,21919,12216,434,ITI,ITI4,12,Lazio,Lazio,5879082,608275,10.35,0.59
1765,2021-01-23,LAZ,7218,2870,4348,588,6630,0,ITI,ITI4,12,Lazio,Lazio,5879082,615493,10.47,0.12
1766,2021-01-06,LAZ,5201,1991,3210,5081,0,120,ITI,ITI4,12,Lazio,Lazio,5879082,620694,10.56,0.09
1767,2021-07-22,LAZ,61175,30569,30606,28497,31148,1530,ITI,ITI4,12,Lazio,Lazio,5879082,681869,11.6,1.04
1768,2021-09-03,LAZ,21413,11197,10216,6062,14948,403,ITI,ITI4,12,Lazio,Lazio,5879082,703282,11.96,0.36
1769,2021-05-17,LAZ,44649,20447,24202,35413,8621,615,ITI,ITI4,12,Lazio,Lazio,5879082,747931,12.72,0.76
1770,2021-02-06,LAZ,6241,2548,3693,904,5333,4,ITI,ITI4,12,Lazio,Lazio,5879082,754172,12.83,0.11
1771,2021-08-08,LAZ,50247,26010,24237,17978,31444,825,ITI,ITI4,12,Lazio,Lazio,5879082,804419,13.68,0.85
1772,2021-06-26,LAZ,56234,26506,29728,24709,30932,593,ITI,ITI4,12,Lazio,Lazio,5879082,860653,14.64,0.96
1773,2021-04-30,LAZ,41716,18484,23232,26622,14373,721,ITI,ITI4,12,Lazio,Lazio,5879082,902369,15.35,0.71
1774,2021-08-22,LAZ,8754,5289,3465,2523,6141,90,ITI,ITI4,12,Lazio,Lazio,5879082,911123,15.5,0.15
1775,2021-01-25,LAZ,8172,3285,4887,827,7345,0,ITI,ITI4,12,Lazio,Lazio,5879082,919295,15.64,0.14
1776,2021-05-05,LAZ,46859,21501,25358,30357,15872,630,ITI,ITI4,12,Lazio,Lazio,5879082,966154,16.43,0.8
1777,2021-03-02,LAZ,17241,7633,9608,13105,3956,180,ITI,ITI4,12,Lazio,Lazio,5879082,983395,16.73,0.29
1778,2021-01-18,LAZ,6388,2605,3783,5281,981,126,ITI,ITI4,12,Lazio,Lazio,5879082,989783,16.84,0.11
1779,2021-04-28,LAZ,33039,15075,17964,20912,11668,459,ITI,ITI4,12,Lazio,Lazio,5879082,1022822,17.4,0.56
1780,2020-12-30,LAZ,1658,640,1018,1647,0,11,ITI,ITI4,12,Lazio,Lazio,5879082,1024480,17.43,0.03
1781,2021-07-01,LAZ,48565,23233,25332,7199,41150,216,ITI,ITI4,12,Lazio,Lazio,5879082,1073045,18.25,0.83
1782,2021-04-09,LAZ,27732,12627,15105,19124,8279,329,ITI,ITI4,12,Lazio,Lazio,5879082,1100777,18.72,0.47
1783,2021-03-23,LAZ,25481,11964,13517,18482,6643,356,ITI,ITI4,12,Lazio,Lazio,5879082,1126258,19.16,0.43
1784,2021-02-15,LAZ,8045,3549,4496,7310,646,89,ITI,ITI4,12,Lazio,Lazio,5879082,1134303,19.29,0.14
1785,2021-02-25,LAZ,12818,5611,7207,11401,1215,202,ITI,ITI4,12,Lazio,Lazio,5879082,1147121,19.51,0.22
1786,2021-06-05,LAZ,66393,32709,33684,42937,22783,673,ITI,ITI4,12,Lazio,Lazio,5879082,1213514,20.64,1.13
1787,2021-07-15,LAZ,45029,22051,22978,6720,37885,424,ITI,ITI4,12,Lazio,Lazio,5879082,1258543,21.41,0.77
1788,2021-01-13,LAZ,5867,2245,3622,5705,0,162,ITI,ITI4,12,Lazio,Lazio,5879082,1264410,21.51,0.1
1789,2021-04-23,LAZ,37988,18294,19694,22043,15408,537,ITI,ITI4,12,Lazio,Lazio,5879082,1302398,22.15,0.65
1790,2021-08-03,LAZ,32197,16378,15819,5049,26952,196,ITI,ITI4,12,Lazio,Lazio,5879082,1334595,22.7,0.55
1791,2021-01-30,LAZ,7025,2898,4127,819,6205,1,ITI,ITI4,12,Lazio,Lazio,5879082,1341620,22.82,0.12
1792,2021-03-28,LAZ,19198,7837,11361,13543,5316,339,ITI,ITI4,12,Lazio,Lazio,5879082,1360818,23.15,0.33
1793,2021-08-10,LAZ,50819,26277,24542,21455,28389,975,ITI,ITI4,12,Lazio,Lazio,5879082,1411637,24.01,0.86
1794,2021-05-19,LAZ,47329,21746,25583,36491,10160,678,ITI,ITI4,12,Lazio,Lazio,5879082,1458966,24.82,0.81
1795,2021-08-27,LAZ,30569,16045,14524,7641,22367,561,ITI,ITI4,12,Lazio,Lazio,5879082,1489535,25.34,0.52
1796,2021-01-04,LAZ,7582,2942,4640,7476,0,106,ITI,ITI4,12,Lazio,Lazio,5879082,1497117,25.47,0.13
1797,2021-06-24,LAZ,64061,30559,33502,28623,34780,658,ITI,ITI4,12,Lazio,Lazio,5879082,1561178,26.55,1.09
1798,2021-06-07,LAZ,62666,29332,33334,32712,29353,601,ITI,ITI4,12,Lazio,Lazio,5879082,1623844,27.62,1.07
1799,2021-02-11,LAZ,7074,3066,4008,6447,602,25,ITI,ITI4,12,Lazio,Lazio,5879082,1630918,27.74,0.12
1800,2021-04-11,LAZ,19240,8532,10708,13121,5929,190,ITI,ITI4,12,Lazio,Lazio,5879082,1650158,28.07,0.33
1801,2021-02-13,LAZ,6613,2627,3986,6146,420,47,ITI,ITI4,12,Lazio,Lazio,5879082,1656771,28.18,0.11
1802,2021-07-20,LAZ,63433,31646,31787,28466,33729,1238,ITI,ITI4,12,Lazio,Lazio,5879082,1720204,29.26,1.08
1803,2021-05-24,LAZ,44044,20206,23838,33568,9823,653,ITI,ITI4,12,Lazio,Lazio,5879082,1764248,30.01,0.75
1804,2021-01-03,LAZ,5346,2016,3330,5287,0,59,ITI,ITI4,12,Lazio,Lazio,5879082,1769594,30.1,0.09
1805,2021-06-19,LAZ,66572,31407,35165,35279,30474,819,ITI,ITI4,12,Lazio,Lazio,5879082,1836166,31.23,1.13
1806,2021-05-07,LAZ,48334,22658,25676,29789,17822,723,ITI,ITI4,12,Lazio,Lazio,5879082,1884500,32.05,0.82
1807,2021-03-11,LAZ,25513,12034,13479,18866,6287,360,ITI,ITI4,12,Lazio,Lazio,5879082,1910013,32.49,0.43
1808,2021-08-15,LAZ,1498,922,576,780,696,22,ITI,ITI4,12,Lazio,Lazio,5879082,1911511,32.51,0.03
1809,2021-07-03,LAZ,53247,25072,28175,4644,48456,147,ITI,ITI4,12,Lazio,Lazio,5879082,1964758,33.42,0.91
1810,2021-03-27,LAZ,26553,10800,15753,19488,6517,548,ITI,ITI4,12,Lazio,Lazio,5879082,1991311,33.87,0.45
1811,2021-08-31,LAZ,30973,15335,15638,11649,18394,930,ITI,ITI4,12,Lazio,Lazio,5879082,2022284,34.4,0.53
1812,2021-07-05,LAZ,61716,29711,32005,25602,35047,1067,ITI,ITI4,12,Lazio,Lazio,5879082,2084000,35.45,1.05
1813,2021-05-23,LAZ,47183,22893,24290,39132,7406,645,ITI,ITI4,12,Lazio,Lazio,5879082,2131183,36.25,0.8
1814,2021-05-09,LAZ,37572,17271,20301,25782,11289,501,ITI,ITI4,12,Lazio,Lazio,5879082,2168755,36.89,0.64
1815,2021-08-17,LAZ,7951,4557,3394,3745,4110,96,ITI,ITI4,12,Lazio,Lazio,5879082,2176706,37.02,0.14
1816,2021-01-29,LAZ,8407,3200,5207,922,7483,2,ITI,ITI4,12,Lazio,Lazio,5879082,2185113,37.17,0.14
1817,2021-02-17,LAZ,9228,4621,4607,8260,897,71,ITI,ITI4,12,Lazio,Lazio,5879082,2194341,37.32,0.16
1818,2021-05-28,LAZ,57274,26639,30635,43149,13342,783,ITI,ITI4,12,Lazio,Lazio,5879082,2251615,38.3,0.97
1819,2021-08-19,LAZ,9114,5220,3894,2860,6150,104,ITI,ITI4,12,Lazio,Lazio,5879082,2260729,38.45,0.16
1820,2021-08-29,LAZ,27421,13955,13466,9021,17811,589,ITI,ITI4,12,Lazio,Lazio,5879082,2288150,38.92,0.47
1821,2021-04-01,LAZ,29790,14137,15653,22220,7178,392,ITI,ITI4,12,Lazio,Lazio,5879082,2317940,39.43,0.51
1822,2021-07-10,LAZ,71117,35693,35424,25046,45409,662,ITI,ITI4,12,Lazio,Lazio,5879082,2389057,40.64,1.21
1823,2021-07-24,LAZ,30768,15522,15246,3230,27382,156,ITI,ITI4,12,Lazio,Lazio,5879082,2419825,41.16,0.52
1824,2021-07-19,LAZ,63178,31066,32112,28320,33728,1130,ITI,ITI4,12,Lazio,Lazio,5879082,2483003,42.23,1.07
1825,2021-01-15,LAZ,6724,2771,3953,6553,0,171,ITI,ITI4,12,Lazio,Lazio,5879082,2489727,42.35,0.11
1826,2021-04-25,LAZ,24581,11280,13301,16374,7875,332,ITI,ITI4,12,Lazio,Lazio,5879082,2514308,42.77,0.42
1827,2021-04-06,LAZ,24665,11293,13372,17152,7185,328,ITI,ITI4,12,Lazio,Lazio,5879082,2538973,43.19,0.42
1828,2021-06-09,LAZ,70541,33409,37132,35992,33908,641,ITI,ITI4,12,Lazio,Lazio,5879082,2609514,44.39,1.2
1829,2021-04-27,LAZ,30835,13923,16912,19421,10960,454,ITI,ITI4,12,Lazio,Lazio,5879082,2640349,44.91,0.52
1830,2021-03-01,LAZ,17133,7371,9762,12982,3891,260,ITI,ITI4,12,Lazio,Lazio,5879082,2657482,45.2,0.29
1831,2021-08-05,LAZ,33455,17348,16107,21882,10552,1021,ITI,ITI4,12,Lazio,Lazio,5879082,2690937,45.77,0.57
1832,2021-02-22,LAZ,11518,5028,6490,10811,554,153,ITI,ITI4,12,Lazio,Lazio,5879082,2702455,45.97,0.2
1833,2021-04-13,LAZ,25840,11980,13860,17636,7749,455,ITI,ITI4,12,Lazio,Lazio,5879082,2728295,46.41,0.44
1834,2021-07-31,LAZ,56225,29552,26673,5556,50365,304,ITI,ITI4,12,Lazio,Lazio,5879082,2784520,47.36,0.96
1835,2021-01-08,LAZ,7964,2985,4979,7767,0,197,ITI,ITI4,12,Lazio,Lazio,5879082,2792484,47.5,0.14
1836,2021-07-29,LAZ,56049,28560,27489,7666,48005,378,ITI,ITI4,12,Lazio,Lazio,5879082,2848533,48.45,0.95
1837,2021-01-01,LAZ,3602,1398,2204,3562,0,40,ITI,ITI4,12,Lazio,Lazio,5879082,2852135,48.51,0.06
1838,2021-01-10,LAZ,4136,1739,2397,4069,0,67,ITI,ITI4,12,Lazio,Lazio,5879082,2856271,48.58,0.07
1839,2021-06-16,LAZ,64734,31087,33647,32077,32016,641,ITI,ITI4,12,Lazio,Lazio,5879082,2921005,49.68,1.1
1840,2021-04-20,LAZ,31180,14310,16870,19372,11369,439,ITI,ITI4,12,Lazio,Lazio,5879082,2952185,50.22,0.53
1841,2021-03-08,LAZ,20959,9104,11855,15349,5307,303,ITI,ITI4,12,Lazio,Lazio,5879082,2973144,50.57,0.36
1842,2021-06-23,LAZ,62359,29377,32982,28438,33417,504,ITI,ITI4,12,Lazio,Lazio,5879082,3035503,51.63,1.06
1843,2021-04-15,LAZ,32050,14356,17694,20659,10884,507,ITI,ITI4,12,Lazio,Lazio,5879082,3067553,52.18,0.55
1844,2021-08-26,LAZ,32097,16643,15454,8213,23331,553,ITI,ITI4,12,Lazio,Lazio,5879082,3099650,52.72,0.55
1845,2021-02-10,LAZ,8256,3454,4802,4851,3400,5,ITI,ITI4,12,Lazio,Lazio,5879082,3107906,52.86,0.14
1846,2021-05-21,LAZ,52126,25076,27050,37315,14109,702,ITI,ITI4,12,Lazio,Lazio,5879082,3160032,53.75,0.89
1847,2021-06-04,LAZ,62085,30272,31813,43573,17865,647,ITI,ITI4,12,Lazio,Lazio,5879082,3222117,54.81,1.06
1848,2021-05-04,LAZ,40300,18542,21758,26071,13706,523,ITI,ITI4,12,Lazio,Lazio,5879082,3262417,55.49,0.69
1849,2021-08-12,LAZ,47821,24763,23058,20697,26160,964,ITI,ITI4,12,Lazio,Lazio,5879082,3310238,56.31,0.81
1850,2021-02-03,LAZ,6499,2494,4005,963,5529,7,ITI,ITI4,12,Lazio,Lazio,5879082,3316737,56.42,0.11
1851,2021-01-20,LAZ,4833,1957,2876,3283,1545,5,ITI,ITI4,12,Lazio,Lazio,5879082,3321570,56.5,0.08
1852,2021-05-14,LAZ,51647,23601,28046,32419,18411,817,ITI,ITI4,12,Lazio,Lazio,5879082,3373217,57.38,0.88
1853,2021-03-18,LAZ,14309,6114,8195,7780,6439,90,ITI,ITI4,12,Lazio,Lazio,5879082,3387526,57.62,0.24
1854,2021-04-22,LAZ,39230,19517,19713,23815,14729,686,ITI,ITI4,12,Lazio,Lazio,5879082,3426756,58.29,0.67
1855,2021-03-10,LAZ,23378,10681,12697,17360,5666,352,ITI,ITI4,12,Lazio,Lazio,5879082,3450134,58.68,0.4
1856,2021-01-12,LAZ,5550,2048,3502,5407,0,143,ITI,ITI4,12,Lazio,Lazio,5879082,3455684,58.78,0.09
1857,2021-06-18,LAZ,64430,31042,33388,30305,33366,759,ITI,ITI4,12,Lazio,Lazio,5879082,3520114,59.88,1.1
1858,2020-12-27,LAZ,276,132,144,276,0,0,ITI,ITI4,12,Lazio,Lazio,5879082,3520390,59.88,0.0
1859,2021-03-20,LAZ,19278,7675,11603,13087,5923,268,ITI,ITI4,12,Lazio,Lazio,5879082,3539668,60.21,0.33
1860,2021-07-17,LAZ,43927,22157,21770,2180,41642,105,ITI,ITI4,12,Lazio,Lazio,5879082,3583595,60.96,0.75
1861,2021-06-30,LAZ,63035,29668,33367,29757,32730,548,ITI,ITI4,12,Lazio,Lazio,5879082,3646630,62.03,1.07
1862,2021-04-08,LAZ,26892,12328,14564,18762,7718,412,ITI,ITI4,12,Lazio,Lazio,5879082,3673522,62.48,0.46
1863,2021-03-06,LAZ,18396,7096,11300,13897,4276,223,ITI,ITI4,12,Lazio,Lazio,5879082,3691918,62.8,0.31
1864,2021-01-31,LAZ,4466,1858,2608,481,3985,0,ITI,ITI4,12,Lazio,Lazio,5879082,3696384,62.87,0.08
1865,2021-05-11,LAZ,48395,22227,26168,31124,16594,677,ITI,ITI4,12,Lazio,Lazio,5879082,3744779,63.7,0.82
1866,2021-07-16,LAZ,44029,21014,23015,2924,40925,180,ITI,ITI4,12,Lazio,Lazio,5879082,3788808,64.45,0.75
1867,2021-04-24,LAZ,33585,15155,18430,20140,12902,543,ITI,ITI4,12,Lazio,Lazio,5879082,3822393,65.02,0.57
1868,2021-08-02,LAZ,37313,19504,17809,6494,30586,233,ITI,ITI4,12,Lazio,Lazio,5879082,3859706,65.65,0.63
1869,2021-08-21,LAZ,10176,5852,4324,3209,6866,101,ITI,ITI4,12,Lazio,Lazio,5879082,3869882,65.82,0.17
1870,2021-05-30,LAZ,41277,17657,23620,33236,7376,665,ITI,ITI4,12,Lazio,Lazio,5879082,3911159,66.53,0.7
1871,2021-05-13,LAZ,50281,22603,27678,31653,17878,750,ITI,ITI4,12,Lazio,Lazio,5879082,3961440,67.38,0.86
1872,2021-07-12,LAZ,41448,20729,20719,5870,35347,231,ITI,ITI4,12,Lazio,Lazio,5879082,4002888,68.09,0.71
1873,2021-05-16,LAZ,51023,24573,26450,36905,13515,603,ITI,ITI4,12,Lazio,Lazio,5879082,4053911,68.95,0.87
1874,2021-08-24,LAZ,18687,9978,8709,11644,6332,711,ITI,ITI4,12,Lazio,Lazio,5879082,4072598,69.27,0.32
1875,2021-06-28,LAZ,58965,28196,30769,27492,31023,450,ITI,ITI4,12,Lazio,Lazio,5879082,4131563,70.28,1.0
1876,2021-06-02,LAZ,43534,21607,21927,31442,11535,557,ITI,ITI4,12,Lazio,Lazio,5879082,4175097,71.02,0.74
1877,2021-06-11,LAZ,69819,32852,36967,36684,32480,655,ITI,ITI4,12,Lazio,Lazio,5879082,4244916,72.2,1.19
1878,2021-08-07,LAZ,34810,18819,15991,21824,11870,1116,ITI,ITI4,12,Lazio,Lazio,5879082,4279726,72.8,0.59
1879,2021-05-06,LAZ,48886,22783,26103,30542,17611,733,ITI,ITI4,12,Lazio,Lazio,5879082,4328612,73.63,0.83
1880,2021-03-25,LAZ,29532,13718,15814,22377,6681,474,ITI,ITI4,12,Lazio,Lazio,5879082,4358144,74.13,0.5
1881,2021-01-27,LAZ,6183,2410,3773,1057,5126,0,ITI,ITI4,12,Lazio,Lazio,5879082,4364327,74.23,0.11
1882,2021-08-04,LAZ,47653,24004,23649,20593,26399,661,ITI,ITI4,12,Lazio,Lazio,5879082,4411980,75.05,0.81
1883,2021-06-29,LAZ,59519,28284,31235,27739,31185,595,ITI,ITI4,12,Lazio,Lazio,5879082,4471499,76.06,1.01
1884,2021-02-24,LAZ,12104,5233,6871,10935,1040,129,ITI,ITI4,12,Lazio,Lazio,5879082,4483603,76.26,0.21
1885,2021-07-07,LAZ,62697,31049,31648,28385,33708,604,ITI,ITI4,12,Lazio,Lazio,5879082,4546300,77.33,1.07
1886,2021-03-29,LAZ,25593,12155,13438,18196,7083,314,ITI,ITI4,12,Lazio,Lazio,5879082,4571893,77.77,0.44
1887,2021-03-15,LAZ,21036,9875,11161,14002,6770,264,ITI,ITI4,12,Lazio,Lazio,5879082,4592929,78.12,0.36
1888,2021-07-02,LAZ,48559,23272,25287,6621,41749,189,ITI,ITI4,12,Lazio,Lazio,5879082,4641488,78.95,0.83
1889,2021-03-17,LAZ,13885,5952,7933,7472,6295,118,ITI,ITI4,12,Lazio,Lazio,5879082,4655373,79.19,0.24
1890,2021-06-25,LAZ,63457,30654,32803,28140,34714,603,ITI,ITI4,12,Lazio,Lazio,5879082,4718830,80.26,1.08
1891,2021-06-27,LAZ,47264,21617,25647,20587,26190,487,ITI,ITI4,12,Lazio,Lazio,5879082,4766094,81.07,0.8
1892,2021-08-23,LAZ,22657,12349,10308,16296,5381,980,ITI,ITI4,12,Lazio,Lazio,5879082,4788751,81.45,0.39
1893,2021-02-04,LAZ,6449,2569,3880,1126,5322,1,ITI,ITI4,12,Lazio,Lazio,5879082,4795200,81.56,0.11
1894,2021-08-25,LAZ,31663,16621,15042,9886,21175,602,ITI,ITI4,12,Lazio,Lazio,5879082,4826863,82.1,0.54
1895,2021-02-12,LAZ,6871,2867,4004,6355,434,82,ITI,ITI4,12,Lazio,Lazio,5879082,4833734,82.22,0.12
1896,2020-12-31,LAZ,5375,2151,3224,5315,0,60,ITI,ITI4,12,Lazio,Lazio,5879082,4839109,82.31,0.09
1897,2021-04-10,LAZ,23954,10423,13531,16472,7206,276,ITI,ITI4,12,Lazio,Lazio,5879082,4863063,82.72,0.41
1898,2021-02-05,LAZ,7342,3003,4339,1220,6118,4,ITI,ITI4,12,Lazio,Lazio,5879082,4870405,82.84,0.12
1899,2021-04-03,LAZ,24857,11225,13632,17892,6737,228,ITI,ITI4,12,Lazio,Lazio,5879082,4895262,83.27,0.42
1900,2021-02-19,LAZ,10097,5103,4994,9078,870,149,ITI,ITI4,12,Lazio,Lazio,5879082,4905359,83.44,0.17
1901,2021-01-05,LAZ,7456,2832,4624,7353,0,103,ITI,ITI4,12,Lazio,Lazio,5879082,4912815,83.56,0.13
1902,2021-01-24,LAZ,5703,2230,3473,618,5085,0,ITI,ITI4,12,Lazio,Lazio,5879082,4918518,83.66,0.1
1903,2021-02-07,LAZ,4971,2049,2922,410,4560,1,ITI,ITI4,12,Lazio,Lazio,5879082,4923489,83.75,0.08
1904,2021-05-18,LAZ,45122,20644,24478,34896,9612,614,ITI,ITI4,12,Lazio,Lazio,5879082,4968611,84.51,0.77
1905,2021-01-14,LAZ,5668,2236,3432,5494,0,174,ITI,ITI4,12,Lazio,Lazio,5879082,4974279,84.61,0.1
1906,2021-04-07,LAZ,26041,12188,13853,18344,7325,372,ITI,ITI4,12,Lazio,Lazio,5879082,5000320,85.05,0.44
1907,2020-12-28,LAZ,961,414,547,956,0,5,ITI,ITI4,12,Lazio,Lazio,5879082,5001281,85.07,0.02
1908,2021-01-16,LAZ,5778,2337,3441,5630,0,148,ITI,ITI4,12,Lazio,Lazio,5879082,5007059,85.17,0.1
1909,2021-04-26,LAZ,29353,13510,15843,19548,9297,508,ITI,ITI4,12,Lazio,Lazio,5879082,5036412,85.67,0.5
1910,2021-02-02,LAZ,5920,2220,3700,640,5277,3,ITI,ITI4,12,Lazio,Lazio,5879082,5042332,85.77,0.1
1911,2021-07-18,LAZ,58396,29732,28664,22796,34802,798,ITI,ITI4,12,Lazio,Lazio,5879082,5100728,86.76,0.99
1912,2021-08-14,LAZ,2524,1427,1097,989,1503,32,ITI,ITI4,12,Lazio,Lazio,5879082,5103252,86.8,0.04
1913,2021-08-16,LAZ,3686,2032,1654,2051,1574,61,ITI,ITI4,12,Lazio,Lazio,5879082,5106938,86.87,0.06
1914,2021-01-17,LAZ,4957,2050,2907,4679,213,65,ITI,ITI4,12,Lazio,Lazio,5879082,5111895,86.95,0.08
1915,2021-01-19,LAZ,4789,1968,2821,4332,454,3,ITI,ITI4,12,Lazio,Lazio,5879082,5116684,87.03,0.08
1916,2021-06-17,LAZ,67066,32276,34790,31820,34520,726,ITI,ITI4,12,Lazio,Lazio,5879082,5183750,88.17,1.14
1917,2021-04-21,LAZ,33170,15077,18093,20237,12490,443,ITI,ITI4,12,Lazio,Lazio,5879082,5216920,88.74,0.56
1918,2021-07-30,LAZ,55958,28981,26977,7384,48217,357,ITI,ITI4,12,Lazio,Lazio,5879082,5272878,89.69,0.95
1919,2021-06-03,LAZ,56874,28738,28136,38285,17858,731,ITI,ITI4,12,Lazio,Lazio,5879082,5329752,90.66,0.97
1920,2021-08-06,LAZ,33479,17580,15899,22291,10131,1057,ITI,ITI4,12,Lazio,Lazio,5879082,5363231,91.23,0.57
1921,2021-06-10,LAZ,72265,34148,38117,37317,34096,852,ITI,ITI4,12,Lazio,Lazio,5879082,5435496,92.45,1.23
1922,2021-04-14,LAZ,29402,13327,16075,18851,10197,354,ITI,ITI4,12,Lazio,Lazio,5879082,5464898,92.95,0.5
1923,2021-07-23,LAZ,58479,29335,29144,26804,29901,1774,ITI,ITI4,12,Lazio,Lazio,5879082,5523377,93.95,0.99
1924,2021-04-29,LAZ,38860,17353,21507,24805,13372,683,ITI,ITI4,12,Lazio,Lazio,5879082,5562237,94.61,0.66
1925,2021-03-03,LAZ,17911,7896,10015,13343,4313,255,ITI,ITI4,12,Lazio,Lazio,5879082,5580148,94.92,0.3
1926,2021-08-09,LAZ,52558,26675,25883,21854,29641,1063,ITI,ITI4,12,Lazio,Lazio,5879082,5632706,95.81,0.89
1927,2021-01-26,LAZ,7988,3134,4854,743,7245,0,ITI,ITI4,12,Lazio,Lazio,5879082,5640694,95.95,0.14
1928,2021-05-22,LAZ,55225,27063,28162,43671,10709,845,ITI,ITI4,12,Lazio,Lazio,5879082,5695919,96.88,0.94
1929,2021-08-30,LAZ,30493,15396,15097,9977,19838,678,ITI,ITI4,12,Lazio,Lazio,5879082,5726412,97.4,0.52
1930,2021-05-15,LAZ,57510,27471,30039,40046,16585,879,ITI,ITI4,12,Lazio,Lazio,5879082,5783922,98.38,0.98
1931,2021-03-19,LAZ,17515,7599,9916,11003,6357,155,ITI,ITI4,12,Lazio,Lazio,5879082,5801437,98.68,0.3
1932,2021-09-01,LAZ,26381,13514,12867,8127,17739,515,ITI,ITI4,12,Lazio,Lazio,5879082,5827818,99.13,0.45
1933,2021-04-02,LAZ,29561,14176,15385,21760,7399,402,ITI,ITI4,12,Lazio,Lazio,5879082,5857379,99.63,0.5
1934,2021-07-11,LAZ,44156,22266,21890,3766,40238,152,ITI,ITI4,12,Lazio,Lazio,5879082,5901535,100.38,0.75
1935,2021-01-28,LAZ,8330,3183,5147,827,7502,1,ITI,ITI4,12,Lazio,Lazio,5879082,5909865,100.52,0.14
1936,2021-07-04,LAZ,46606,21698,24908,4124,42395,87,ITI,ITI4,12,Lazio,Lazio,5879082,5956471,101.32,0.79
1937,2021-05-08,LAZ,45515,20781,24734,29323,15457,735,ITI,ITI4,12,Lazio,Lazio,5879082,6001986,102.09,0.77
1938,2021-07-13,LAZ,42748,20957,21791,5515,36894,339,ITI,ITI4,12,Lazio,Lazio,5879082,6044734,102.82,0.73
1939,2021-03-26,LAZ,30371,14071,16300,23005,6907,459,ITI,ITI4,12,Lazio,Lazio,5879082,6075105,103.33,0.52
1940,2021-07-06,LAZ,62610,30383,32227,28562,33552,496,ITI,ITI4,12,Lazio,Lazio,5879082,6137715,104.4,1.06
1941,2021-08-11,LAZ,48839,25586,23253,20352,27617,870,ITI,ITI4,12,Lazio,Lazio,5879082,6186554,105.23,0.83
1942,2021-05-03,LAZ,39644,17901,21743,26182,12783,679,ITI,ITI4,12,Lazio,Lazio,5879082,6226198,105.9,0.67
1943,2021-07-25,LAZ,24659,12139,12520,2098,22511,50,ITI,ITI4,12,Lazio,Lazio,5879082,6250857,106.32,0.42
1944,2021-03-22,LAZ,23422,10564,12858,16355,6732,335,ITI,ITI4,12,Lazio,Lazio,5879082,6274279,106.72,0.4
1945,2020-12-29,LAZ,498,182,316,494,0,4,ITI,ITI4,12,Lazio,Lazio,5879082,6274777,106.73,0.01
1946,2021-06-13,LAZ,58456,26231,32225,33077,24871,508,ITI,ITI4,12,Lazio,Lazio,5879082,6333233,107.72,0.99
1947,2021-03-07,LAZ,14167,5480,8687,10348,3603,216,ITI,ITI4,12,Lazio,Lazio,5879082,6347400,107.97,0.24
1948,2021-06-15,LAZ,66218,32004,34214,33379,32266,573,ITI,ITI4,12,Lazio,Lazio,5879082,6413618,109.09,1.13
1949,2021-06-22,LAZ,62855,29080,33775,28597,33536,722,ITI,ITI4,12,Lazio,Lazio,5879082,6476473,110.16,1.07
1950,2021-03-14,LAZ,17302,6781,10521,11853,5181,268,ITI,ITI4,12,Lazio,Lazio,5879082,6493775,110.46,0.29
1951,2021-06-01,LAZ,49169,23728,25441,30088,18597,484,ITI,ITI4,12,Lazio,Lazio,5879082,6542944,111.29,0.84
1952,2021-04-05,LAZ,19987,9153,10834,13617,6215,155,ITI,ITI4,12,Lazio,Lazio,5879082,6562931,111.63,0.34
1953,2021-07-28,LAZ,57758,29240,28518,8108,49299,351,ITI,ITI4,12,Lazio,Lazio,5879082,6620689,112.61,0.98
1954,2021-05-25,LAZ,47643,22366,25277,35317,11732,594,ITI,ITI4,12,Lazio,Lazio,5879082,6668332,113.42,0.81
1955,2021-09-02,LAZ,26026,13366,12660,7881,17710,435,ITI,ITI4,12,Lazio,Lazio,5879082,6694358,113.87,0.44
1956,2021-04-12,LAZ,23947,10798,13149,16651,6967,329,ITI,ITI4,12,Lazio,Lazio,5879082,6718305,114.27,0.41
1957,2021-07-21,LAZ,62847,31735,31112,28653,32825,1369,ITI,ITI4,12,Lazio,Lazio,5879082,6781152,115.34,1.07
1958,2021-06-08,LAZ,66829,31901,34928,36155,30016,658,ITI,ITI4,12,Lazio,Lazio,5879082,6847981,116.48,1.14
1959,2021-07-14,LAZ,42212,20579,21633,6212,35636,364,ITI,ITI4,12,Lazio,Lazio,5879082,6890193,117.2,0.72
1960,2021-01-09,LAZ,6426,2617,3809,6313,0,113,ITI,ITI4,12,Lazio,Lazio,5879082,6896619,117.31,0.11
1961,2021-04-19,LAZ,30170,13720,16450,18960,10731,479,ITI,ITI4,12,Lazio,Lazio,5879082,6926789,117.82,0.51
1962,2021-02-21,LAZ,7000,3184,3816,6485,467,48,ITI,ITI4,12,Lazio,Lazio,5879082,6933789,117.94,0.12
1963,2021-02-14,LAZ,5808,2382,3426,5302,475,31,ITI,ITI4,12,Lazio,Lazio,5879082,6939597,118.04,0.1
1964,2021-02-28,LAZ,10288,4041,6247,9645,542,101,ITI,ITI4,12,Lazio,Lazio,5879082,6949885,118.21,0.17
1965,2021-01-02,LAZ,6842,2681,4161,6762,0,80,ITI,ITI4,12,Lazio,Lazio,5879082,6956727,118.33,0.12
1966,2021-03-24,LAZ,27995,13153,14842,21316,6277,402,ITI,ITI4,12,Lazio,Lazio,5879082,6984722,118.81,0.48
1967,2021-08-20,LAZ,8312,4680,3632,2066,6152,94,ITI,ITI4,12,Lazio,Lazio,5879082,6993034,118.95,0.14
1968,2021-05-29,LAZ,52111,23447,28664,40196,11051,864,ITI,ITI4,12,Lazio,Lazio,5879082,7045145,119.83,0.89
1969,2021-08-01,LAZ,39612,21122,18490,5679,33628,305,ITI,ITI4,12,Lazio,Lazio,5879082,7084757,120.51,0.67
1970,2021-05-10,LAZ,44521,20360,24161,30364,13446,711,ITI,ITI4,12,Lazio,Lazio,5879082,7129278,121.27,0.76
1971,2021-08-18,LAZ,9449,5465,3984,3233,6101,115,ITI,ITI4,12,Lazio,Lazio,5879082,7138727,121.43,0.16
1972,2021-05-27,LAZ,58557,27248,31309,43954,13810,793,ITI,ITI4,12,Lazio,Lazio,5879082,7197284,122.42,1.0
1973,2021-03-05,LAZ,19621,8694,10927,14621,4760,240,ITI,ITI4,12,Lazio,Lazio,5879082,7216905,122.76,0.33
1974,2021-02-16,LAZ,8373,4045,4328,7705,624,44,ITI,ITI4,12,Lazio,Lazio,5879082,7225278,122.9,0.14
1975,2021-06-21,LAZ,62028,28816,33212,28502,32910,616,ITI,ITI4,12,Lazio,Lazio,5879082,7287306,123.95,1.06
1976,2021-03-13,LAZ,21852,8757,13095,15700,5915,237,ITI,ITI4,12,Lazio,Lazio,5879082,7309158,124.32,0.37
1977,2021-02-08,LAZ,9755,4165,5590,4511,5242,2,ITI,ITI4,12,Lazio,Lazio,5879082,7318913,124.49,0.17
1978,2021-05-02,LAZ,32941,14463,18478,22941,9470,530,ITI,ITI4,12,Lazio,Lazio,5879082,7351854,125.05,0.56
1979,2021-01-22,LAZ,4034,1652,2382,518,3516,0,ITI,ITI4,12,Lazio,Lazio,5879082,7355888,125.12,0.07
1980,2021-02-27,LAZ,11540,4337,7203,10344,1050,146,ITI,ITI4,12,Lazio,Lazio,5879082,7367428,125.32,0.2
1981,2021-05-20,LAZ,51944,25069,26875,37227,13985,732,ITI,ITI4,12,Lazio,Lazio,5879082,7419372,126.2,0.88
1982,2021-08-28,LAZ,32532,16985,15547,11014,20774,744,ITI,ITI4,12,Lazio,Lazio,5879082,7451904,126.75,0.55
1983,2021-06-20,LAZ,55335,25450,29885,29612,24961,762,ITI,ITI4,12,Lazio,Lazio,5879082,7507239,127.69,0.94
1984,2021-06-06,LAZ,58284,28100,30184,35143,22540,601,ITI,ITI4,12,Lazio,Lazio,5879082,7565523,128.69,0.99
1985,2021-02-26,LAZ,13176,5749,7427,11544,1447,185,ITI,ITI4,12,Lazio,Lazio,5879082,7578699,128.91,0.22
1986,2021-07-09,LAZ,65061,31402,33659,27626,36682,753,ITI,ITI4,12,Lazio,Lazio,5879082,7643760,130.02,1.11
1987,2021-05-01,LAZ,38271,17210,21061,25708,12077,486,ITI,ITI4,12,Lazio,Lazio,5879082,7682031,130.67,0.65
1988,2021-04-17,LAZ,32490,14253,18237,19958,12068,464,ITI,ITI4,12,Lazio,Lazio,5879082,7714521,131.22,0.55
1989,2021-07-26,LAZ,50882,25069,25813,6667,43900,315,ITI,ITI4,12,Lazio,Lazio,5879082,7765403,132.09,0.87
1990,2021-03-12,LAZ,24115,11149,12966,17388,6365,362,ITI,ITI4,12,Lazio,Lazio,5879082,7789518,132.5,0.41
1991,2021-08-13,LAZ,43525,22638,20887,20060,22395,1070,ITI,ITI4,12,Lazio,Lazio,5879082,7833043,133.24,0.74
1992,2021-02-09,LAZ,8857,3808,5049,4582,4268,7,ITI,ITI4,12,Lazio,Lazio,5879082,7841900,133.39,0.15
1993,2021-02-23,LAZ,11117,4795,6322,10210,777,130,ITI,ITI4,12,Lazio,Lazio,5879082,7853017,133.58,0.19
1994,2021-01-21,LAZ,5743,2416,3327,631,5112,0,ITI,ITI4,12,Lazio,Lazio,5879082,7858760,133.67,0.1
1995,2021-03-31,LAZ,27886,13485,14401,20393,7149,344,ITI,ITI4,12,Lazio,Lazio,5879082,7886646,134.15,0.47
1996,2021-01-07,LAZ,7940,2981,4959,7783,0,157,ITI,ITI4,12,Lazio,Lazio,5879082,7894586,134.28,0.14
1997,2021-07-13,PAT,3838,1952,1886,1777,1933,128,ITH,ITH2,4,Provincia Autonoma Trento,P.A. Trento,541380,3838,0.71,0.71
1998,2021-04-21,PAT,2945,1372,1573,2739,51,155,ITH,ITH2,4,Provincia Autonoma Trento,P.A. Trento,541380,6783,1.25,0.54
1999,2021-01-28,PAT,554,156,398,51,503,0,ITH,ITH2,4,Provincia Autonoma Trento,P.A. Trento,541380,7337,1.36,0.1
2000,2021-01-11,PAT,765,235,530,765,0,0,ITH,ITH2,4,Provincia Autonoma Trento,P.A. Trento,541380,8102,1.5,0.14
2001,2021-04-09,PAT,2806,1195,1611,1528,1209,69,ITH,ITH2,4,Provincia Autonoma Trento,P.A. Trento,541380,10908,2.01,0.52
2002,2021-02-11,PAT,1171,377,794,803,367,1,ITH,ITH2,4,Provincia Autonoma Trento,P.A. Trento,541380,12079,2.23,0.22
2003,2021-07-18,PAT,464,243,221,118,339,7,ITH,ITH2,4,Provincia Autonoma Trento,P.A. Trento,541380,12543,2.32,0.09
2004,2021-02-25,PAT,1655,649,1006,1199,446,10,ITH,ITH2,4,Provincia Autonoma Trento,P.A. Trento,541380,14198,2.62,0.31
2005,2020-12-30,PAT,7,3,4,7,0,0,ITH,ITH2,4,Provincia Autonoma Trento,P.A. Trento,541380,14205,2.62,0.0
2006,2021-06-05,PAT,4132,1939,2193,689,3364,79,ITH,ITH2,4,Provincia Autonoma Trento,P.A. Trento,541380,18337,3.39,0.76
2007,2021-01-23,PAT,584,338,246,389,194,1,ITH,ITH2,4,Provincia Autonoma Trento,P.A. Trento,541380,18921,3.49,0.11
2008,2021-05-03,PAT,4311,2223,2088,3843,157,311,ITH,ITH2,4,Provincia Autonoma Trento,P.A. Trento,541380,23232,4.29,0.8
2009,2021-08-13,PAT,5951,3371,2580,2577,3225,149,ITH,ITH2,4,Provincia Autonoma Trento,P.A. Trento,541380,29183,5.39,1.1
2010,2021-07-01,PAT,7150,3737,3413,3595,3364,191,ITH,ITH2,4,Provincia Autonoma Trento,P.A. Trento,541380,36333,6.71,1.32
2011,2021-05-05,PAT,5059,2611,2448,4434,305,320,ITH,ITH2,4,Provincia Autonoma Trento,P.A. Trento,541380,41392,7.65,0.93
2012,2021-06-29,PAT,6427,3241,3186,2774,3533,120,ITH,ITH2,4,Provincia Autonoma Trento,P.A. Trento,541380,47819,8.83,1.19
2013,2021-06-12,PAT,5428,2717,2711,436,4942,50,ITH,ITH2,4,Provincia Autonoma Trento,P.A. Trento,541380,53247,9.84,1.0
2014,2021-03-21,PAT,136,74,62,131,0,5,ITH,ITH2,4,Provincia Autonoma Trento,P.A. Trento,541380,53383,9.86,0.03
2015,2021-05-24,PAT,4492,2077,2415,1269,3109,114,ITH,ITH2,4,Provincia Autonoma Trento,P.A. Trento,541380,57875,10.69,0.83
2016,2021-08-08,PAT,634,337,297,241,385,8,ITH,ITH2,4,Provincia Autonoma Trento,P.A. Trento,541380,58509,10.81,0.12
2017,2021-08-27,PAT,3795,2063,1732,927,2788,80,ITH,ITH2,4,Provincia Autonoma Trento,P.A. Trento,541380,62304,11.51,0.7
2018,2021-03-26,PAT,3277,1282,1995,2519,612,146,ITH,ITH2,4,Provincia Autonoma Trento,P.A. Trento,541380,65581,12.11,0.61
2019,2021-02-06,PAT,582,302,280,439,143,0,ITH,ITH2,4,Provincia Autonoma Trento,P.A. Trento,541380,66163,12.22,0.11
2020,2021-02-23,PAT,1128,403,725,887,218,23,ITH,ITH2,4,Provincia Autonoma Trento,P.A. Trento,541380,67291,12.43,0.21
2021,2021-05-17,PAT,4357,2157,2200,3752,363,242,ITH,ITH2,4,Provincia Autonoma Trento,P.A. Trento,541380,71648,13.23,0.8
2022,2021-08-25,PAT,4391,2345,2046,1083,3236,72,ITH,ITH2,4,Provincia Autonoma Trento,P.A. Trento,541380,76039,14.05,0.81
2023,2021-03-09,PAT,1670,620,1050,980,653,37,ITH,ITH2,4,Provincia Autonoma Trento,P.A. Trento,541380,77709,14.35,0.31
2024,2021-06-17,PAT,6751,3562,3189,2044,4537,170,ITH,ITH2,4,Provincia Autonoma Trento,P.A. Trento,541380,84460,15.6,1.25
2025,2021-07-27,PAT,4814,2545,2269,1752,2951,111,ITH,ITH2,4,Provincia Autonoma Trento,P.A. Trento,541380,89274,16.49,0.89
2026,2021-05-31,PAT,4805,2213,2592,1608,3087,110,ITH,ITH2,4,Provincia Autonoma Trento,P.A. Trento,541380,94079,17.38,0.89
2027,2021-05-22,PAT,3372,1665,1707,849,2432,91,ITH,ITH2,4,Provincia Autonoma Trento,P.A. Trento,541380,97451,18.0,0.62
2028,2021-05-29,PAT,2444,1328,1116,783,1570,91,ITH,ITH2,4,Provincia Autonoma Trento,P.A. Trento,541380,99895,18.45,0.45
2029,2021-04-02,PAT,2892,1178,1714,2044,684,164,ITH,ITH2,4,Provincia Autonoma Trento,P.A. Trento,541380,102787,18.99,0.53
2030,2021-04-16,PAT,2906,1377,1529,2597,150,159,ITH,ITH2,4,Provincia Autonoma Trento,P.A. Trento,541380,105693,19.52,0.54
2031,2021-02-18,PAT,1436,504,932,1349,69,18,ITH,ITH2,4,Provincia Autonoma Trento,P.A. Trento,541380,107129,19.79,0.27
2032,2021-07-25,PAT,366,205,161,139,218,9,ITH,ITH2,4,Provincia Autonoma Trento,P.A. Trento,541380,107495,19.86,0.07
2033,2021-02-16,PAT,676,248,428,660,5,11,ITH,ITH2,4,Provincia Autonoma Trento,P.A. Trento,541380,108171,19.98,0.12
2034,2021-04-23,PAT,3668,1786,1882,3430,56,182,ITH,ITH2,4,Provincia Autonoma Trento,P.A. Trento,541380,111839,20.66,0.68
2035,2021-01-30,PAT,396,136,260,155,241,0,ITH,ITH2,4,Provincia Autonoma Trento,P.A. Trento,541380,112235,20.73,0.07
2036,2021-05-10,PAT,3270,1678,1592,2532,518,220,ITH,ITH2,4,Provincia Autonoma Trento,P.A. Trento,541380,115505,21.34,0.6
2037,2021-04-14,PAT,3146,1480,1666,2253,738,155,ITH,ITH2,4,Provincia Autonoma Trento,P.A. Trento,541380,118651,21.92,0.58
2038,2021-03-28,PAT,768,304,464,717,2,49,ITH,ITH2,4,Provincia Autonoma Trento,P.A. Trento,541380,119419,22.06,0.14
2039,2021-01-04,PAT,905,250,655,903,0,2,ITH,ITH2,4,Provincia Autonoma Trento,P.A. Trento,541380,120324,22.23,0.17
2040,2021-07-06,PAT,5234,2762,2472,3114,1930,190,ITH,ITH2,4,Provincia Autonoma Trento,P.A. Trento,541380,125558,23.19,0.97
2041,2021-01-18,PAT,690,168,522,631,59,0,ITH,ITH2,4,Provincia Autonoma Trento,P.A. Trento,541380,126248,23.32,0.13
2042,2021-09-01,PAT,3916,2088,1828,829,3012,75,ITH,ITH2,4,Provincia Autonoma Trento,P.A. Trento,541380,130164,24.04,0.72
2043,2021-03-02,PAT,1323,446,877,910,382,31,ITH,ITH2,4,Provincia Autonoma Trento,P.A. Trento,541380,131487,24.29,0.24
2044,2021-06-10,PAT,6215,3027,3188,1813,4265,137,ITH,ITH2,4,Provincia Autonoma Trento,P.A. Trento,541380,137702,25.44,1.15
2045,2021-09-03,PAT,3068,1662,1406,636,2394,38,ITH,ITH2,4,Provincia Autonoma Trento,P.A. Trento,541380,140770,26.0,0.57
2046,2021-08-06,PAT,6473,3565,2908,2667,3685,121,ITH,ITH2,4,Provincia Autonoma Trento,P.A. Trento,541380,147243,27.2,1.2
2047,2021-01-16,PAT,322,148,174,322,0,0,ITH,ITH2,4,Provincia Autonoma Trento,P.A. Trento,541380,147565,27.26,0.06
2048,2021-04-28,PAT,4288,1993,2295,3895,139,254,ITH,ITH2,4,Provincia Autonoma Trento,P.A. Trento,541380,151853,28.05,0.79
2049,2021-06-19,PAT,3146,1722,1424,236,2879,31,ITH,ITH2,4,Provincia Autonoma Trento,P.A. Trento,541380,154999,28.63,0.58
2050,2021-07-08,PAT,4164,2213,1951,2514,1482,168,ITH,ITH2,4,Provincia Autonoma Trento,P.A. Trento,541380,159163,29.4,0.77
2051,2021-02-04,PAT,1014,321,693,430,583,1,ITH,ITH2,4,Provincia Autonoma Trento,P.A. Trento,541380,160177,29.59,0.19
2052,2021-03-14,PAT,110,67,43,19,89,2,ITH,ITH2,4,Provincia Autonoma Trento,P.A. Trento,541380,160287,29.61,0.02
2053,2021-03-07,PAT,24,6,18,24,0,0,ITH,ITH2,4,Provincia Autonoma Trento,P.A. Trento,541380,160311,29.61,0.0
2054,2021-01-09,PAT,195,42,153,195,0,0,ITH,ITH2,4,Provincia Autonoma Trento,P.A. Trento,541380,160506,29.65,0.04
2055,2021-06-24,PAT,6056,3171,2885,3652,2208,196,ITH,ITH2,4,Provincia Autonoma Trento,P.A. Trento,541380,166562,30.77,1.12
2056,2021-05-12,PAT,3347,1511,1836,1962,1219,166,ITH,ITH2,4,Provincia Autonoma Trento,P.A. Trento,541380,169909,31.38,0.62
2057,2021-03-16,PAT,1407,514,893,581,792,34,ITH,ITH2,4,Provincia Autonoma Trento,P.A. Trento,541380,171316,31.64,0.26
2058,2021-08-20,PAT,5212,2878,2334,1484,3629,99,ITH,ITH2,4,Provincia Autonoma Trento,P.A. Trento,541380,176528,32.61,0.96
2059,2021-05-14,PAT,5443,2614,2829,3714,1428,301,ITH,ITH2,4,Provincia Autonoma Trento,P.A. Trento,541380,181971,33.61,1.01
2060,2021-08-22,PAT,406,243,163,220,171,15,ITH,ITH2,4,Provincia Autonoma Trento,P.A. Trento,541380,182377,33.69,0.07
2061,2021-07-20,PAT,4828,2610,2218,1745,2933,150,ITH,ITH2,4,Provincia Autonoma Trento,P.A. Trento,541380,187205,34.58,0.89
2062,2021-02-20,PAT,412,247,165,124,287,1,ITH,ITH2,4,Provincia Autonoma Trento,P.A. Trento,541380,187617,34.66,0.08
2063,2021-01-06,PAT,43,13,30,43,0,0,ITH,ITH2,4,Provincia Autonoma Trento,P.A. Trento,541380,187660,34.66,0.01
2064,2021-08-05,PAT,6390,3495,2895,2949,3317,124,ITH,ITH2,4,Provincia Autonoma Trento,P.A. Trento,541380,194050,35.84,1.18
2065,2021-03-18,PAT,2335,964,1371,1221,1089,25,ITH,ITH2,4,Provincia Autonoma Trento,P.A. Trento,541380,196385,36.27,0.43
2066,2021-06-09,PAT,6327,3123,3204,2114,4129,84,ITH,ITH2,4,Provincia Autonoma Trento,P.A. Trento,541380,202712,37.44,1.17
2067,2021-06-26,PAT,1436,753,683,679,727,30,ITH,ITH2,4,Provincia Autonoma Trento,P.A. Trento,541380,204148,37.71,0.27
2068,2021-06-28,PAT,6954,3597,3357,2963,3869,122,ITH,ITH2,4,Provincia Autonoma Trento,P.A. Trento,541380,211102,38.99,1.28
2069,2021-04-06,PAT,2288,969,1319,1459,770,59,ITH,ITH2,4,Provincia Autonoma Trento,P.A. Trento,541380,213390,39.42,0.42
2070,2021-07-15,PAT,4298,2300,1998,1790,2364,144,ITH,ITH2,4,Provincia Autonoma Trento,P.A. Trento,541380,217688,40.21,0.79
2071,2021-08-24,PAT,4601,2467,2134,1287,3221,93,ITH,ITH2,4,Provincia Autonoma Trento,P.A. Trento,541380,222289,41.06,0.85
2072,2021-07-24,PAT,994,547,447,525,445,24,ITH,ITH2,4,Provincia Autonoma Trento,P.A. Trento,541380,223283,41.24,0.18
2073,2021-05-02,PAT,3564,1979,1585,3294,39,231,ITH,ITH2,4,Provincia Autonoma Trento,P.A. Trento,541380,226847,41.9,0.66
2074,2021-03-04,PAT,2388,807,1581,1556,790,42,ITH,ITH2,4,Provincia Autonoma Trento,P.A. Trento,541380,229235,42.34,0.44
2075,2021-01-27,PAT,873,310,563,115,756,2,ITH,ITH2,4,Provincia Autonoma Trento,P.A. Trento,541380,230108,42.5,0.16
2076,2021-04-01,PAT,2945,1251,1694,1745,1106,94,ITH,ITH2,4,Provincia Autonoma Trento,P.A. Trento,541380,233053,43.05,0.54
2077,2021-07-10,PAT,1098,565,533,148,920,30,ITH,ITH2,4,Provincia Autonoma Trento,P.A. Trento,541380,234151,43.25,0.2
2078,2021-03-23,PAT,2483,962,1521,1628,755,100,ITH,ITH2,4,Provincia Autonoma Trento,P.A. Trento,541380,236634,43.71,0.46
2079,2021-05-28,PAT,3805,1768,2037,1399,2265,141,ITH,ITH2,4,Provincia Autonoma Trento,P.A. Trento,541380,240439,44.41,0.7
2080,2021-01-25,PAT,849,231,618,25,824,0,ITH,ITH2,4,Provincia Autonoma Trento,P.A. Trento,541380,241288,44.57,0.16
2081,2021-03-25,PAT,2916,1128,1788,1742,1060,114,ITH,ITH2,4,Provincia Autonoma Trento,P.A. Trento,541380,244204,45.11,0.54
2082,2021-07-03,PAT,1268,681,587,78,1185,5,ITH,ITH2,4,Provincia Autonoma Trento,P.A. Trento,541380,245472,45.34,0.23
2083,2021-02-08,PAT,1194,333,861,347,847,0,ITH,ITH2,4,Provincia Autonoma Trento,P.A. Trento,541380,246666,45.56,0.22
2084,2021-08-29,PAT,615,346,269,310,281,24,ITH,ITH2,4,Provincia Autonoma Trento,P.A. Trento,541380,247281,45.68,0.11
2085,2021-07-17,PAT,1099,537,562,270,809,20,ITH,ITH2,4,Provincia Autonoma Trento,P.A. Trento,541380,248380,45.88,0.2
2086,2021-05-21,PAT,5214,2505,2709,3138,1804,272,ITH,ITH2,4,Provincia Autonoma Trento,P.A. Trento,541380,253594,46.84,0.96
2087,2021-02-01,PAT,1278,356,922,98,1180,0,ITH,ITH2,4,Provincia Autonoma Trento,P.A. Trento,541380,254872,47.08,0.24
2088,2021-08-31,PAT,4396,2289,2107,1239,3057,100,ITH,ITH2,4,Provincia Autonoma Trento,P.A. Trento,541380,259268,47.89,0.81
2089,2021-08-10,PAT,5992,3203,2789,2896,2911,185,ITH,ITH2,4,Provincia Autonoma Trento,P.A. Trento,541380,265260,49.0,1.11
2090,2021-03-13,PAT,965,496,469,841,48,76,ITH,ITH2,4,Provincia Autonoma Trento,P.A. Trento,541380,266225,49.18,0.18
2091,2021-07-05,PAT,5431,2849,2582,3794,1390,247,ITH,ITH2,4,Provincia Autonoma Trento,P.A. Trento,541380,271656,50.18,1.0
2092,2021-06-21,PAT,6260,3387,2873,3650,2425,185,ITH,ITH2,4,Provincia Autonoma Trento,P.A. Trento,541380,277916,51.33,1.16
2093,2021-01-08,PAT,1537,341,1196,1536,0,1,ITH,ITH2,4,Provincia Autonoma Trento,P.A. Trento,541380,279453,51.62,0.28
2094,2021-06-14,PAT,5819,3010,2809,2044,3656,119,ITH,ITH2,4,Provincia Autonoma Trento,P.A. Trento,541380,285272,52.69,1.07
2095,2021-04-18,PAT,1865,850,1015,1796,9,60,ITH,ITH2,4,Provincia Autonoma Trento,P.A. Trento,541380,287137,53.04,0.34
2096,2021-03-06,PAT,809,285,524,615,152,42,ITH,ITH2,4,Provincia Autonoma Trento,P.A. Trento,541380,287946,53.19,0.15
2097,2021-02-03,PAT,877,326,551,417,460,0,ITH,ITH2,4,Provincia Autonoma Trento,P.A. Trento,541380,288823,53.35,0.16
2098,2021-07-19,PAT,4810,2533,2277,1456,3224,130,ITH,ITH2,4,Provincia Autonoma Trento,P.A. Trento,541380,293633,54.24,0.89
2099,2021-05-23,PAT,1995,1015,980,432,1535,28,ITH,ITH2,4,Provincia Autonoma Trento,P.A. Trento,541380,295628,54.61,0.37
2100,2021-04-10,PAT,2876,1352,1524,1994,803,79,ITH,ITH2,4,Provincia Autonoma Trento,P.A. Trento,541380,298504,55.14,0.53
2101,2021-02-13,PAT,540,335,205,172,368,0,ITH,ITH2,4,Provincia Autonoma Trento,P.A. Trento,541380,299044,55.24,0.1
2102,2021-05-07,PAT,6092,3133,2959,4853,854,385,ITH,ITH2,4,Provincia Autonoma Trento,P.A. Trento,541380,305136,56.36,1.13
2103,2021-04-20,PAT,2908,1387,1521,2689,37,182,ITH,ITH2,4,Provincia Autonoma Trento,P.A. Trento,541380,308044,56.9,0.54
2104,2021-05-09,PAT,2354,1225,1129,1870,347,137,ITH,ITH2,4,Provincia Autonoma Trento,P.A. Trento,541380,310398,57.33,0.43
2105,2021-08-17,PAT,5442,2878,2564,1934,3377,131,ITH,ITH2,4,Provincia Autonoma Trento,P.A. Trento,541380,315840,58.34,1.01
2106,2021-02-15,PAT,547,193,354,419,126,2,ITH,ITH2,4,Provincia Autonoma Trento,P.A. Trento,541380,316387,58.44,0.1
2107,2021-05-26,PAT,3963,1870,2093,1116,2724,123,ITH,ITH2,4,Provincia Autonoma Trento,P.A. Trento,541380,320350,59.17,0.73
2108,2021-01-13,PAT,444,131,313,444,0,0,ITH,ITH2,4,Provincia Autonoma Trento,P.A. Trento,541380,320794,59.25,0.08
2109,2021-02-12,PAT,1033,346,687,592,439,2,ITH,ITH2,4,Provincia Autonoma Trento,P.A. Trento,541380,321827,59.45,0.19
2110,2021-03-01,PAT,1254,460,794,928,301,25,ITH,ITH2,4,Provincia Autonoma Trento,P.A. Trento,541380,323081,59.68,0.23
2111,2021-03-20,PAT,888,409,479,663,211,14,ITH,ITH2,4,Provincia Autonoma Trento,P.A. Trento,541380,323969,59.84,0.16
2112,2021-03-03,PAT,1672,628,1044,1115,520,37,ITH,ITH2,4,Provincia Autonoma Trento,P.A. Trento,541380,325641,60.15,0.31
2113,2021-09-02,PAT,3330,1746,1584,946,2337,47,ITH,ITH2,4,Provincia Autonoma Trento,P.A. Trento,541380,328971,60.77,0.62
2114,2021-06-11,PAT,7308,3476,3832,1491,5711,106,ITH,ITH2,4,Provincia Autonoma Trento,P.A. Trento,541380,336279,62.12,1.35
2115,2021-06-13,PAT,3734,2061,1673,279,3430,25,ITH,ITH2,4,Provincia Autonoma Trento,P.A. Trento,541380,340013,62.8,0.69
2116,2021-08-12,PAT,5693,3048,2645,2188,3330,175,ITH,ITH2,4,Provincia Autonoma Trento,P.A. Trento,541380,345706,63.86,1.05
2117,2021-07-29,PAT,5480,2912,2568,2649,2714,117,ITH,ITH2,4,Provincia Autonoma Trento,P.A. Trento,541380,351186,64.87,1.01
2118,2021-06-16,PAT,6325,3416,2909,1989,4212,124,ITH,ITH2,4,Provincia Autonoma Trento,P.A. Trento,541380,357511,66.04,1.17
2119,2021-03-30,PAT,2467,999,1468,1672,693,102,ITH,ITH2,4,Provincia Autonoma Trento,P.A. Trento,541380,359978,66.49,0.46
2120,2021-04-11,PAT,2392,1161,1231,2201,99,92,ITH,ITH2,4,Provincia Autonoma Trento,P.A. Trento,541380,362370,66.93,0.44
2121,2021-02-27,PAT,1054,468,586,606,428,20,ITH,ITH2,4,Provincia Autonoma Trento,P.A. Trento,541380,363424,67.13,0.19
2122,2021-08-03,PAT,6213,3357,2856,2488,3596,129,ITH,ITH2,4,Provincia Autonoma Trento,P.A. Trento,541380,369637,68.28,1.15
2123,2021-01-01,PAT,222,51,171,222,0,0,ITH,ITH2,4,Provincia Autonoma Trento,P.A. Trento,541380,369859,68.32,0.04
2124,2021-06-07,PAT,5885,2929,2956,2679,3025,181,ITH,ITH2,4,Provincia Autonoma Trento,P.A. Trento,541380,375744,69.4,1.09
2125,2021-04-25,PAT,2003,953,1050,1873,7,123,ITH,ITH2,4,Provincia Autonoma Trento,P.A. Trento,541380,377747,69.77,0.37
2126,2020-12-27,PAT,107,43,64,107,0,0,ITH,ITH2,4,Provincia Autonoma Trento,P.A. Trento,541380,377854,69.79,0.02
2127,2021-07-30,PAT,5848,3096,2752,2294,3447,107,ITH,ITH2,4,Provincia Autonoma Trento,P.A. Trento,541380,383702,70.87,1.08
2128,2021-08-16,PAT,4846,2559,2287,1806,2931,109,ITH,ITH2,4,Provincia Autonoma Trento,P.A. Trento,541380,388548,71.77,0.9
2129,2021-04-29,PAT,4700,2264,2436,4171,214,315,ITH,ITH2,4,Provincia Autonoma Trento,P.A. Trento,541380,393248,72.64,0.87
2130,2021-08-07,PAT,1624,931,693,819,769,36,ITH,ITH2,4,Provincia Autonoma Trento,P.A. Trento,541380,394872,72.94,0.3
2131,2021-01-22,PAT,1748,459,1289,350,1396,2,ITH,ITH2,4,Provincia Autonoma Trento,P.A. Trento,541380,396620,73.26,0.32
2132,2021-02-05,PAT,835,288,547,285,550,0,ITH,ITH2,4,Provincia Autonoma Trento,P.A. Trento,541380,397455,73.42,0.15
2133,2021-05-16,PAT,1358,756,602,1041,248,69,ITH,ITH2,4,Provincia Autonoma Trento,P.A. Trento,541380,398813,73.67,0.25
2134,2021-01-05,PAT,759,262,497,759,0,0,ITH,ITH2,4,Provincia Autonoma Trento,P.A. Trento,541380,399572,73.81,0.14
2135,2021-08-02,PAT,5376,2852,2524,1609,3701,66,ITH,ITH2,4,Provincia Autonoma Trento,P.A. Trento,541380,404948,74.8,0.99
2136,2021-02-10,PAT,872,295,577,513,358,1,ITH,ITH2,4,Provincia Autonoma Trento,P.A. Trento,541380,405820,74.96,0.16
2137,2021-07-26,PAT,3900,2058,1842,838,2995,67,ITH,ITH2,4,Provincia Autonoma Trento,P.A. Trento,541380,409720,75.68,0.72
2138,2021-04-08,PAT,3180,1334,1846,1952,1133,95,ITH,ITH2,4,Provincia Autonoma Trento,P.A. Trento,541380,412900,76.27,0.59
2139,2020-12-31,PAT,1701,480,1221,1701,0,0,ITH,ITH2,4,Provincia Autonoma Trento,P.A. Trento,541380,414601,76.58,0.31
2140,2021-06-22,PAT,6383,3479,2904,3628,2568,187,ITH,ITH2,4,Provincia Autonoma Trento,P.A. Trento,541380,420984,77.76,1.18
2141,2021-03-05,PAT,2308,736,1572,1643,569,96,ITH,ITH2,4,Provincia Autonoma Trento,P.A. Trento,541380,423292,78.19,0.43
2142,2021-01-07,PAT,1301,328,973,1298,0,3,ITH,ITH2,4,Provincia Autonoma Trento,P.A. Trento,541380,424593,78.43,0.24
2143,2021-03-15,PAT,1453,573,880,929,469,55,ITH,ITH2,4,Provincia Autonoma Trento,P.A. Trento,541380,426046,78.7,0.27
2144,2021-08-19,PAT,4624,2481,2143,1103,3438,83,ITH,ITH2,4,Provincia Autonoma Trento,P.A. Trento,541380,430670,79.55,0.85
2145,2021-01-17,PAT,255,199,56,255,0,0,ITH,ITH2,4,Provincia Autonoma Trento,P.A. Trento,541380,430925,79.6,0.05
2146,2021-06-23,PAT,6694,3547,3147,4627,1871,196,ITH,ITH2,4,Provincia Autonoma Trento,P.A. Trento,541380,437619,80.83,1.24
2147,2021-05-11,PAT,3743,1768,1975,2643,863,237,ITH,ITH2,4,Provincia Autonoma Trento,P.A. Trento,541380,441362,81.53,0.69
2148,2021-04-27,PAT,3955,1901,2054,3596,70,289,ITH,ITH2,4,Provincia Autonoma Trento,P.A. Trento,541380,445317,82.26,0.73
2149,2021-05-04,PAT,4570,2490,2080,4168,97,305,ITH,ITH2,4,Provincia Autonoma Trento,P.A. Trento,541380,449887,83.1,0.84
2150,2021-03-08,PAT,1426,439,987,1042,354,30,ITH,ITH2,4,Provincia Autonoma Trento,P.A. Trento,541380,451313,83.36,0.26
2151,2021-03-22,PAT,2349,995,1354,1406,885,58,ITH,ITH2,4,Provincia Autonoma Trento,P.A. Trento,541380,453662,83.8,0.43
2152,2021-01-24,PAT,562,285,277,226,336,0,ITH,ITH2,4,Provincia Autonoma Trento,P.A. Trento,541380,454224,83.9,0.1
2153,2021-06-30,PAT,6873,3530,3343,2696,4056,121,ITH,ITH2,4,Provincia Autonoma Trento,P.A. Trento,541380,461097,85.17,1.27
2154,2021-04-15,PAT,3234,1459,1775,2831,156,247,ITH,ITH2,4,Provincia Autonoma Trento,P.A. Trento,541380,464331,85.77,0.6
2155,2021-06-18,PAT,7068,3761,3307,1786,5190,92,ITH,ITH2,4,Provincia Autonoma Trento,P.A. Trento,541380,471399,87.07,1.31
2156,2021-03-27,PAT,1673,747,926,1323,263,87,ITH,ITH2,4,Provincia Autonoma Trento,P.A. Trento,541380,473072,87.38,0.31
2157,2021-06-04,PAT,5928,2651,3277,1732,4062,134,ITH,ITH2,4,Provincia Autonoma Trento,P.A. Trento,541380,479000,88.48,1.09
2158,2021-05-25,PAT,4867,2315,2552,1743,2975,149,ITH,ITH2,4,Provincia Autonoma Trento,P.A. Trento,541380,483867,89.38,0.9
2159,2021-05-08,PAT,3195,1743,1452,2571,426,198,ITH,ITH2,4,Provincia Autonoma Trento,P.A. Trento,541380,487062,89.97,0.59
2160,2021-02-14,PAT,250,189,61,11,239,0,ITH,ITH2,4,Provincia Autonoma Trento,P.A. Trento,541380,487312,90.01,0.05
2161,2021-08-18,PAT,4634,2553,2081,1428,3119,87,ITH,ITH2,4,Provincia Autonoma Trento,P.A. Trento,541380,491946,90.87,0.86
2162,2021-05-27,PAT,4379,2034,2345,1164,3081,134,ITH,ITH2,4,Provincia Autonoma Trento,P.A. Trento,541380,496325,91.68,0.81
2163,2021-06-06,PAT,2268,1080,1188,431,1816,21,ITH,ITH2,4,Provincia Autonoma Trento,P.A. Trento,541380,498593,92.1,0.42
2164,2021-07-12,PAT,4272,2152,2120,2040,2042,190,ITH,ITH2,4,Provincia Autonoma Trento,P.A. Trento,541380,502865,92.89,0.79
2165,2021-02-17,PAT,1175,450,725,1058,112,5,ITH,ITH2,4,Provincia Autonoma Trento,P.A. Trento,541380,504040,93.1,0.22
2166,2021-05-30,PAT,1777,876,901,865,843,69,ITH,ITH2,4,Provincia Autonoma Trento,P.A. Trento,541380,505817,93.43,0.33
2167,2021-01-31,PAT,77,16,61,1,76,0,ITH,ITH2,4,Provincia Autonoma Trento,P.A. Trento,541380,505894,93.45,0.01
2168,2021-07-04,PAT,225,125,100,66,157,2,ITH,ITH2,4,Provincia Autonoma Trento,P.A. Trento,541380,506119,93.49,0.04
2169,2021-08-30,PAT,3891,1985,1906,1183,2600,108,ITH,ITH2,4,Provincia Autonoma Trento,P.A. Trento,541380,510010,94.21,0.72
2170,2021-08-23,PAT,4339,2289,2050,1428,2746,165,ITH,ITH2,4,Provincia Autonoma Trento,P.A. Trento,541380,514349,95.01,0.8
2171,2021-07-11,PAT,1035,566,469,132,894,9,ITH,ITH2,4,Provincia Autonoma Trento,P.A. Trento,541380,515384,95.2,0.19
2172,2021-04-03,PAT,1179,485,694,934,177,68,ITH,ITH2,4,Provincia Autonoma Trento,P.A. Trento,541380,516563,95.42,0.22
2173,2021-04-24,PAT,3580,1714,1866,3353,16,211,ITH,ITH2,4,Provincia Autonoma Trento,P.A. Trento,541380,520143,96.08,0.66
2174,2021-02-26,PAT,1257,445,812,933,299,25,ITH,ITH2,4,Provincia Autonoma Trento,P.A. Trento,541380,521400,96.31,0.23
2175,2021-01-14,PAT,731,218,513,729,0,2,ITH,ITH2,4,Provincia Autonoma Trento,P.A. Trento,541380,522131,96.44,0.14
2176,2021-04-17,PAT,2253,1148,1105,2090,57,106,ITH,ITH2,4,Provincia Autonoma Trento,P.A. Trento,541380,524384,96.86,0.42
2177,2021-04-19,PAT,2646,1244,1402,2429,23,194,ITH,ITH2,4,Provincia Autonoma Trento,P.A. Trento,541380,527030,97.35,0.49
2178,2021-07-28,PAT,4868,2670,2198,2160,2572,136,ITH,ITH2,4,Provincia Autonoma Trento,P.A. Trento,541380,531898,98.25,0.9
2179,2021-06-15,PAT,6329,3341,2988,1630,4564,135,ITH,ITH2,4,Provincia Autonoma Trento,P.A. Trento,541380,538227,99.42,1.17
2180,2021-02-28,PAT,246,122,124,236,0,10,ITH,ITH2,4,Provincia Autonoma Trento,P.A. Trento,541380,538473,99.46,0.05
2181,2021-08-04,PAT,6209,3313,2896,2572,3499,138,ITH,ITH2,4,Provincia Autonoma Trento,P.A. Trento,541380,544682,100.61,1.15
2182,2021-06-08,PAT,6043,2918,3125,1786,4132,125,ITH,ITH2,4,Provincia Autonoma Trento,P.A. Trento,541380,550725,101.73,1.12
2183,2021-04-26,PAT,2676,1260,1416,2411,96,169,ITH,ITH2,4,Provincia Autonoma Trento,P.A. Trento,541380,553401,102.22,0.49
2184,2021-02-19,PAT,945,366,579,847,65,33,ITH,ITH2,4,Provincia Autonoma Trento,P.A. Trento,541380,554346,102.39,0.17
2185,2021-08-11,PAT,5843,3149,2694,3092,2590,161,ITH,ITH2,4,Provincia Autonoma Trento,P.A. Trento,541380,560189,103.47,1.08
2186,2021-02-24,PAT,1373,543,830,943,406,24,ITH,ITH2,4,Provincia Autonoma Trento,P.A. Trento,541380,561562,103.73,0.25
2187,2021-06-03,PAT,4845,2279,2566,1238,3515,92,ITH,ITH2,4,Provincia Autonoma Trento,P.A. Trento,541380,566407,104.62,0.89
2188,2021-01-19,PAT,434,89,345,434,0,0,ITH,ITH2,4,Provincia Autonoma Trento,P.A. Trento,541380,566841,104.7,0.08
2189,2021-01-10,PAT,87,20,67,87,0,0,ITH,ITH2,4,Provincia Autonoma Trento,P.A. Trento,541380,566928,104.72,0.02
2190,2021-01-29,PAT,1425,363,1062,56,1369,0,ITH,ITH2,4,Provincia Autonoma Trento,P.A. Trento,541380,568353,104.98,0.26
2191,2021-07-14,PAT,4188,2176,2012,1706,2354,128,ITH,ITH2,4,Provincia Autonoma Trento,P.A. Trento,541380,572541,105.76,0.77
2192,2021-04-22,PAT,3174,1481,1693,2945,46,183,ITH,ITH2,4,Provincia Autonoma Trento,P.A. Trento,541380,575715,106.34,0.59
2193,2021-07-31,PAT,1497,856,641,1075,383,39,ITH,ITH2,4,Provincia Autonoma Trento,P.A. Trento,541380,577212,106.62,0.28
2194,2021-07-23,PAT,4759,2440,2319,1672,2953,134,ITH,ITH2,4,Provincia Autonoma Trento,P.A. Trento,541380,581971,107.5,0.88
2195,2021-03-10,PAT,2486,973,1513,1473,948,65,ITH,ITH2,4,Provincia Autonoma Trento,P.A. Trento,541380,584457,107.96,0.46
2196,2021-08-28,PAT,1339,824,515,547,755,37,ITH,ITH2,4,Provincia Autonoma Trento,P.A. Trento,541380,585796,108.2,0.25
2197,2021-08-21,PAT,1319,783,536,602,678,39,ITH,ITH2,4,Provincia Autonoma Trento,P.A. Trento,541380,587115,108.45,0.24
2198,2021-06-25,PAT,7794,4157,3637,4184,3447,163,ITH,ITH2,4,Provincia Autonoma Trento,P.A. Trento,541380,594909,109.89,1.44
2199,2021-08-14,PAT,290,156,134,50,237,3,ITH,ITH2,4,Provincia Autonoma Trento,P.A. Trento,541380,595199,109.94,0.05
2200,2021-07-02,PAT,7424,4037,3387,3586,3596,242,ITH,ITH2,4,Provincia Autonoma Trento,P.A. Trento,541380,602623,111.31,1.37
2201,2021-01-15,PAT,628,149,479,627,0,1,ITH,ITH2,4,Provincia Autonoma Trento,P.A. Trento,541380,603251,111.43,0.12
2202,2021-05-20,PAT,5121,2407,2714,3149,1689,283,ITH,ITH2,4,Provincia Autonoma Trento,P.A. Trento,541380,608372,112.37,0.95
2203,2021-03-24,PAT,2415,963,1452,1468,827,120,ITH,ITH2,4,Provincia Autonoma Trento,P.A. Trento,541380,610787,112.82,0.45
2204,2021-02-09,PAT,952,303,649,448,503,1,ITH,ITH2,4,Provincia Autonoma Trento,P.A. Trento,541380,611739,113.0,0.18
2205,2021-03-17,PAT,2131,813,1318,1131,907,93,ITH,ITH2,4,Provincia Autonoma Trento,P.A. Trento,541380,613870,113.39,0.39
2206,2021-02-02,PAT,942,254,688,192,750,0,ITH,ITH2,4,Provincia Autonoma Trento,P.A. Trento,541380,614812,113.56,0.17
2207,2021-07-09,PAT,5153,2732,2421,3047,1884,222,ITH,ITH2,4,Provincia Autonoma Trento,P.A. Trento,541380,619965,114.52,0.95
2208,2021-05-13,PAT,3457,1606,1851,2103,1126,228,ITH,ITH2,4,Provincia Autonoma Trento,P.A. Trento,541380,623422,115.15,0.64
2209,2021-03-31,PAT,2621,1001,1620,1653,868,100,ITH,ITH2,4,Provincia Autonoma Trento,P.A. Trento,541380,626043,115.64,0.48
2210,2021-01-26,PAT,577,173,404,28,549,0,ITH,ITH2,4,Provincia Autonoma Trento,P.A. Trento,541380,626620,115.74,0.11
2211,2021-05-06,PAT,5616,2795,2821,4447,794,375,ITH,ITH2,4,Provincia Autonoma Trento,P.A. Trento,541380,632236,116.78,1.04
2212,2021-04-07,PAT,2655,1028,1627,1576,955,124,ITH,ITH2,4,Provincia Autonoma Trento,P.A. Trento,541380,634891,117.27,0.49
2213,2021-07-16,PAT,4598,2369,2229,1739,2706,153,ITH,ITH2,4,Provincia Autonoma Trento,P.A. Trento,541380,639489,118.12,0.85
2214,2021-06-27,PAT,1368,735,633,396,961,11,ITH,ITH2,4,Provincia Autonoma Trento,P.A. Trento,541380,640857,118.37,0.25
2215,2021-01-12,PAT,541,173,368,540,0,1,ITH,ITH2,4,Provincia Autonoma Trento,P.A. Trento,541380,641398,118.47,0.1
2216,2021-03-19,PAT,2467,925,1542,1503,881,83,ITH,ITH2,4,Provincia Autonoma Trento,P.A. Trento,541380,643865,118.93,0.46
2217,2021-04-05,PAT,35,17,18,30,2,3,ITH,ITH2,4,Provincia Autonoma Trento,P.A. Trento,541380,643900,118.94,0.01
2218,2021-04-13,PAT,2618,1090,1528,2026,509,83,ITH,ITH2,4,Provincia Autonoma Trento,P.A. Trento,541380,646518,119.42,0.48
2219,2021-01-20,PAT,308,77,231,296,12,0,ITH,ITH2,4,Provincia Autonoma Trento,P.A. Trento,541380,646826,119.48,0.06
2220,2021-04-30,PAT,4992,2434,2558,4443,163,386,ITH,ITH2,4,Provincia Autonoma Trento,P.A. Trento,541380,651818,120.4,0.92
2221,2021-05-19,PAT,5196,2514,2682,3672,1274,250,ITH,ITH2,4,Provincia Autonoma Trento,P.A. Trento,541380,657014,121.36,0.96
2222,2021-06-02,PAT,2883,1383,1500,895,1915,73,ITH,ITH2,4,Provincia Autonoma Trento,P.A. Trento,541380,659897,121.89,0.53
2223,2021-03-11,PAT,2619,983,1636,1506,1053,60,ITH,ITH2,4,Provincia Autonoma Trento,P.A. Trento,541380,662516,122.38,0.48
2224,2021-07-22,PAT,4778,2587,2191,1901,2738,139,ITH,ITH2,4,Provincia Autonoma Trento,P.A. Trento,541380,667294,123.26,0.88
2225,2021-07-07,PAT,4528,2431,2097,2923,1405,200,ITH,ITH2,4,Provincia Autonoma Trento,P.A. Trento,541380,671822,124.09,0.84
2226,2021-01-03,PAT,503,166,337,503,0,0,ITH,ITH2,4,Provincia Autonoma Trento,P.A. Trento,541380,672325,124.19,0.09
2227,2021-07-21,PAT,4707,2521,2186,1527,3085,95,ITH,ITH2,4,Provincia Autonoma Trento,P.A. Trento,541380,677032,125.06,0.87
2228,2021-08-09,PAT,5349,2854,2495,2282,2925,142,ITH,ITH2,4,Provincia Autonoma Trento,P.A. Trento,541380,682381,126.04,0.99
2229,2021-08-26,PAT,4121,2163,1958,1068,2956,97,ITH,ITH2,4,Provincia Autonoma Trento,P.A. Trento,541380,686502,126.81,0.76
2230,2021-02-22,PAT,755,262,493,663,86,6,ITH,ITH2,4,Provincia Autonoma Trento,P.A. Trento,541380,687257,126.95,0.14
2231,2021-05-18,PAT,4323,2047,2276,3169,869,285,ITH,ITH2,4,Provincia Autonoma Trento,P.A. Trento,541380,691580,127.74,0.8
2232,2021-03-12,PAT,2602,991,1611,1708,815,79,ITH,ITH2,4,Provincia Autonoma Trento,P.A. Trento,541380,694182,128.22,0.48
2233,2021-06-20,PAT,1900,1050,850,31,1864,5,ITH,ITH2,4,Provincia Autonoma Trento,P.A. Trento,541380,696082,128.58,0.35
2234,2021-01-02,PAT,522,149,373,522,0,0,ITH,ITH2,4,Provincia Autonoma Trento,P.A. Trento,541380,696604,128.67,0.1
2235,2021-03-29,PAT,2568,1011,1557,1696,742,130,ITH,ITH2,4,Provincia Autonoma Trento,P.A. Trento,541380,699172,129.15,0.47
2236,2021-04-12,PAT,3156,1455,1701,2527,504,125,ITH,ITH2,4,Provincia Autonoma Trento,P.A. Trento,541380,702328,129.73,0.58
2237,2021-01-21,PAT,376,104,272,247,129,0,ITH,ITH2,4,Provincia Autonoma Trento,P.A. Trento,541380,702704,129.8,0.07
2238,2021-05-01,PAT,4889,2486,2403,4553,37,299,ITH,ITH2,4,Provincia Autonoma Trento,P.A. Trento,541380,707593,130.7,0.9
2239,2021-02-21,PAT,158,95,63,44,114,0,ITH,ITH2,4,Provincia Autonoma Trento,P.A. Trento,541380,707751,130.73,0.03
2240,2021-05-15,PAT,1604,832,772,649,914,41,ITH,ITH2,4,Provincia Autonoma Trento,P.A. Trento,541380,709355,131.03,0.3
2241,2021-06-01,PAT,4103,1925,2178,1082,2910,111,ITH,ITH2,4,Provincia Autonoma Trento,P.A. Trento,541380,713458,131.79,0.76
2242,2021-07-16,PAB,4511,2448,2063,1071,3319,121,ITH,ITH1,4,Provincia Autonoma Bolzano / Bozen,P.A. Bolzano,533050,4511,0.85,0.85
2243,2021-04-24,PAB,5119,2458,2661,4630,487,2,ITH,ITH1,4,Provincia Autonoma Bolzano / Bozen,P.A. Bolzano,533050,9630,1.81,0.96
2244,2021-08-02,PAB,2132,1278,854,1169,874,89,ITH,ITH1,4,Provincia Autonoma Bolzano / Bozen,P.A. Bolzano,533050,11762,2.21,0.4
2245,2021-07-14,PAB,873,453,420,482,361,30,ITH,ITH1,4,Provincia Autonoma Bolzano / Bozen,P.A. Bolzano,533050,12635,2.37,0.16
2246,2021-04-05,PAB,304,147,157,24,280,0,ITH,ITH1,4,Provincia Autonoma Bolzano / Bozen,P.A. Bolzano,533050,12939,2.43,0.06
2247,2021-06-27,PAB,4429,2315,2114,590,3810,29,ITH,ITH1,4,Provincia Autonoma Bolzano / Bozen,P.A. Bolzano,533050,17368,3.26,0.83
2248,2021-01-12,PAB,1711,460,1251,1711,0,0,ITH,ITH1,4,Provincia Autonoma Bolzano / Bozen,P.A. Bolzano,533050,19079,3.58,0.32
2249,2021-01-26,PAB,810,291,519,1,809,0,ITH,ITH1,4,Provincia Autonoma Bolzano / Bozen,P.A. Bolzano,533050,19889,3.73,0.15
2250,2021-07-02,PAB,3202,1658,1544,857,2172,173,ITH,ITH1,4,Provincia Autonoma Bolzano / Bozen,P.A. Bolzano,533050,23091,4.33,0.6
2251,2021-03-24,PAB,2067,1002,1065,2048,13,6,ITH,ITH1,4,Provincia Autonoma Bolzano / Bozen,P.A. Bolzano,533050,25158,4.72,0.39
2252,2021-03-10,PAB,1277,537,740,1133,144,0,ITH,ITH1,4,Provincia Autonoma Bolzano / Bozen,P.A. Bolzano,533050,26435,4.96,0.24
2253,2021-05-06,PAB,5191,2752,2439,2375,2571,245,ITH,ITH1,4,Provincia Autonoma Bolzano / Bozen,P.A. Bolzano,533050,31626,5.93,0.97
2254,2021-02-12,PAB,730,217,513,482,248,0,ITH,ITH1,4,Provincia Autonoma Bolzano / Bozen,P.A. Bolzano,533050,32356,6.07,0.14
2255,2021-04-10,PAB,5416,2673,2743,4825,590,1,ITH,ITH1,4,Provincia Autonoma Bolzano / Bozen,P.A. Bolzano,533050,37772,7.09,1.02
2256,2020-12-31,PAB,929,528,401,929,0,0,ITH,ITH1,4,Provincia Autonoma Bolzano / Bozen,P.A. Bolzano,533050,38701,7.26,0.17
2257,2021-04-19,PAB,1876,860,1016,1694,182,0,ITH,ITH1,4,Provincia Autonoma Bolzano / Bozen,P.A. Bolzano,533050,40577,7.61,0.35
2258,2021-06-15,PAB,2045,1184,861,481,1534,30,ITH,ITH1,4,Provincia Autonoma Bolzano / Bozen,P.A. Bolzano,533050,42622,8.0,0.38
2259,2021-07-28,PAB,1437,784,653,881,495,61,ITH,ITH1,4,Provincia Autonoma Bolzano / Bozen,P.A. Bolzano,533050,44059,8.27,0.27
2260,2021-03-22,PAB,1159,527,632,1124,17,18,ITH,ITH1,4,Provincia Autonoma Bolzano / Bozen,P.A. Bolzano,533050,45218,8.48,0.22
2261,2021-05-20,PAB,4975,2502,2473,3346,1480,149,ITH,ITH1,4,Provincia Autonoma Bolzano / Bozen,P.A. Bolzano,533050,50193,9.42,0.93
2262,2021-08-11,PAB,1196,599,597,710,485,1,ITH,ITH1,4,Provincia Autonoma Bolzano / Bozen,P.A. Bolzano,533050,51389,9.64,0.22
2263,2021-08-28,PAB,3266,1835,1431,1056,2210,0,ITH,ITH1,4,Provincia Autonoma Bolzano / Bozen,P.A. Bolzano,533050,54655,10.25,0.61
2264,2021-07-09,PAB,5227,2612,2615,918,4168,141,ITH,ITH1,4,Provincia Autonoma Bolzano / Bozen,P.A. Bolzano,533050,59882,11.23,0.98
2265,2021-06-20,PAB,5250,2854,2396,620,4604,26,ITH,ITH1,4,Provincia Autonoma Bolzano / Bozen,P.A. Bolzano,533050,65132,12.22,0.98
2266,2021-02-07,PAB,2680,1186,1494,330,2350,0,ITH,ITH1,4,Provincia Autonoma Bolzano / Bozen,P.A. Bolzano,533050,67812,12.72,0.5
2267,2021-05-18,PAB,3364,1765,1599,2091,1191,82,ITH,ITH1,4,Provincia Autonoma Bolzano / Bozen,P.A. Bolzano,533050,71176,13.35,0.63
2268,2021-06-06,PAB,4553,2189,2364,812,3693,48,ITH,ITH1,4,Provincia Autonoma Bolzano / Bozen,P.A. Bolzano,533050,75729,14.21,0.85
2269,2021-02-26,PAB,1528,551,977,1498,30,0,ITH,ITH1,4,Provincia Autonoma Bolzano / Bozen,P.A. Bolzano,533050,77257,14.49,0.29
2270,2021-06-01,PAB,3676,2384,1292,2062,1478,136,ITH,ITH1,4,Provincia Autonoma Bolzano / Bozen,P.A. Bolzano,533050,80933,15.18,0.69
2271,2021-02-19,PAB,2252,512,1740,2241,11,0,ITH,ITH1,4,Provincia Autonoma Bolzano / Bozen,P.A. Bolzano,533050,83185,15.61,0.42
2272,2021-08-23,PAB,2127,1202,925,799,1326,2,ITH,ITH1,4,Provincia Autonoma Bolzano / Bozen,P.A. Bolzano,533050,85312,16.0,0.4
2273,2021-03-17,PAB,581,213,368,580,1,0,ITH,ITH1,4,Provincia Autonoma Bolzano / Bozen,P.A. Bolzano,533050,85893,16.11,0.11
2274,2021-08-21,PAB,1704,917,787,626,1075,3,ITH,ITH1,4,Provincia Autonoma Bolzano / Bozen,P.A. Bolzano,533050,87597,16.43,0.32
2275,2021-05-13,PAB,3005,1360,1645,1023,1934,48,ITH,ITH1,4,Provincia Autonoma Bolzano / Bozen,P.A. Bolzano,533050,90602,17.0,0.56
2276,2021-04-29,PAB,2639,1356,1283,1942,696,1,ITH,ITH1,4,Provincia Autonoma Bolzano / Bozen,P.A. Bolzano,533050,93241,17.49,0.5
2277,2021-06-29,PAB,1882,1016,866,246,1616,20,ITH,ITH1,4,Provincia Autonoma Bolzano / Bozen,P.A. Bolzano,533050,95123,17.85,0.35
2278,2021-08-09,PAB,1542,861,681,1124,413,5,ITH,ITH1,4,Provincia Autonoma Bolzano / Bozen,P.A. Bolzano,533050,96665,18.13,0.29
2279,2021-05-01,PAB,2105,1067,1038,1815,160,130,ITH,ITH1,4,Provincia Autonoma Bolzano / Bozen,P.A. Bolzano,533050,98770,18.53,0.39
2280,2021-03-12,PAB,1668,736,932,1252,413,3,ITH,ITH1,4,Provincia Autonoma Bolzano / Bozen,P.A. Bolzano,533050,100438,18.84,0.31
2281,2021-03-29,PAB,1172,500,672,411,760,1,ITH,ITH1,4,Provincia Autonoma Bolzano / Bozen,P.A. Bolzano,533050,101610,19.06,0.22
2282,2021-03-05,PAB,1843,627,1216,1397,443,3,ITH,ITH1,4,Provincia Autonoma Bolzano / Bozen,P.A. Bolzano,533050,103453,19.41,0.35
2283,2021-05-27,PAB,6211,3276,2935,3915,2014,282,ITH,ITH1,4,Provincia Autonoma Bolzano / Bozen,P.A. Bolzano,533050,109664,20.57,1.17
2284,2021-06-13,PAB,3689,2055,1634,453,3197,39,ITH,ITH1,4,Provincia Autonoma Bolzano / Bozen,P.A. Bolzano,533050,113353,21.26,0.69
2285,2021-05-25,PAB,3898,2024,1874,2910,888,100,ITH,ITH1,4,Provincia Autonoma Bolzano / Bozen,P.A. Bolzano,533050,117251,22.0,0.73
2286,2021-02-14,PAB,299,131,168,297,2,0,ITH,ITH1,4,Provincia Autonoma Bolzano / Bozen,P.A. Bolzano,533050,117550,22.05,0.06
2287,2021-08-16,PAB,1962,1114,848,875,1084,3,ITH,ITH1,4,Provincia Autonoma Bolzano / Bozen,P.A. Bolzano,533050,119512,22.42,0.37
2288,2021-05-08,PAB,4430,2383,2047,3575,664,191,ITH,ITH1,4,Provincia Autonoma Bolzano / Bozen,P.A. Bolzano,533050,123942,23.25,0.83
2289,2021-03-03,PAB,1181,395,786,1168,13,0,ITH,ITH1,4,Provincia Autonoma Bolzano / Bozen,P.A. Bolzano,533050,125123,23.47,0.22
2290,2021-04-17,PAB,5255,2609,2646,5210,44,1,ITH,ITH1,4,Provincia Autonoma Bolzano / Bozen,P.A. Bolzano,533050,130378,24.46,0.99
2291,2021-01-07,PAB,921,329,592,921,0,0,ITH,ITH1,4,Provincia Autonoma Bolzano / Bozen,P.A. Bolzano,533050,131299,24.63,0.17
2292,2021-07-21,PAB,3219,1881,1338,536,2644,39,ITH,ITH1,4,Provincia Autonoma Bolzano / Bozen,P.A. Bolzano,533050,134518,25.24,0.6
2293,2021-04-12,PAB,2110,948,1162,2104,6,0,ITH,ITH1,4,Provincia Autonoma Bolzano / Bozen,P.A. Bolzano,533050,136628,25.63,0.4
2294,2021-03-31,PAB,1835,695,1140,821,1014,0,ITH,ITH1,4,Provincia Autonoma Bolzano / Bozen,P.A. Bolzano,533050,138463,25.98,0.34
2295,2021-07-23,PAB,4357,2376,1981,1707,2391,259,ITH,ITH1,4,Provincia Autonoma Bolzano / Bozen,P.A. Bolzano,533050,142820,26.79,0.82
2296,2021-01-05,PAB,830,286,544,829,0,1,ITH,ITH1,4,Provincia Autonoma Bolzano / Bozen,P.A. Bolzano,533050,143650,26.95,0.16
2297,2021-01-23,PAB,197,117,80,0,197,0,ITH,ITH1,4,Provincia Autonoma Bolzano / Bozen,P.A. Bolzano,533050,143847,26.99,0.04
2298,2021-08-25,PAB,2732,1452,1280,819,1913,0,ITH,ITH1,4,Provincia Autonoma Bolzano / Bozen,P.A. Bolzano,533050,146579,27.5,0.51
2299,2021-08-04,PAB,3811,2017,1794,2724,978,109,ITH,ITH1,4,Provincia Autonoma Bolzano / Bozen,P.A. Bolzano,533050,150390,28.21,0.71
2300,2021-06-08,PAB,4266,2184,2082,893,3345,28,ITH,ITH1,4,Provincia Autonoma Bolzano / Bozen,P.A. Bolzano,533050,154656,29.01,0.8
2301,2021-01-24,PAB,12,10,2,0,12,0,ITH,ITH1,4,Provincia Autonoma Bolzano / Bozen,P.A. Bolzano,533050,154668,29.02,0.0
2302,2021-07-04,PAB,4421,2132,2289,160,4233,28,ITH,ITH1,4,Provincia Autonoma Bolzano / Bozen,P.A. Bolzano,533050,159089,29.85,0.83
2303,2021-08-30,PAB,2139,1125,1014,846,1293,0,ITH,ITH1,4,Provincia Autonoma Bolzano / Bozen,P.A. Bolzano,533050,161228,30.25,0.4
2304,2021-01-19,PAB,853,371,482,723,130,0,ITH,ITH1,4,Provincia Autonoma Bolzano / Bozen,P.A. Bolzano,533050,162081,30.41,0.16
2305,2021-06-25,PAB,4179,2308,1871,1026,3014,139,ITH,ITH1,4,Provincia Autonoma Bolzano / Bozen,P.A. Bolzano,533050,166260,31.19,0.78
2306,2021-02-09,PAB,317,126,191,1,316,0,ITH,ITH1,4,Provincia Autonoma Bolzano / Bozen,P.A. Bolzano,533050,166577,31.25,0.06
2307,2021-07-13,PAB,3383,1732,1651,1323,1930,130,ITH,ITH1,4,Provincia Autonoma Bolzano / Bozen,P.A. Bolzano,533050,169960,31.88,0.63
2308,2021-03-21,PAB,769,286,483,15,754,0,ITH,ITH1,4,Provincia Autonoma Bolzano / Bozen,P.A. Bolzano,533050,170729,32.03,0.14
2309,2021-06-12,PAB,5079,2754,2325,1675,3289,115,ITH,ITH1,4,Provincia Autonoma Bolzano / Bozen,P.A. Bolzano,533050,175808,32.98,0.95
2310,2021-01-14,PAB,1953,578,1375,1953,0,0,ITH,ITH1,4,Provincia Autonoma Bolzano / Bozen,P.A. Bolzano,533050,177761,33.35,0.37
2311,2021-04-07,PAB,1803,825,978,1262,541,0,ITH,ITH1,4,Provincia Autonoma Bolzano / Bozen,P.A. Bolzano,533050,179564,33.69,0.34
2312,2021-03-02,PAB,696,200,496,694,2,0,ITH,ITH1,4,Provincia Autonoma Bolzano / Bozen,P.A. Bolzano,533050,180260,33.82,0.13
2313,2021-03-19,PAB,1921,777,1144,801,1120,0,ITH,ITH1,4,Provincia Autonoma Bolzano / Bozen,P.A. Bolzano,533050,182181,34.18,0.36
2314,2021-08-08,PAB,1875,1024,851,1011,855,9,ITH,ITH1,4,Provincia Autonoma Bolzano / Bozen,P.A. Bolzano,533050,184056,34.53,0.35
2315,2021-01-21,PAB,969,452,517,140,829,0,ITH,ITH1,4,Provincia Autonoma Bolzano / Bozen,P.A. Bolzano,533050,185025,34.71,0.18
2316,2021-07-25,PAB,1891,1127,764,665,1146,80,ITH,ITH1,4,Provincia Autonoma Bolzano / Bozen,P.A. Bolzano,533050,186916,35.07,0.35
2317,2021-08-20,PAB,3922,2067,1855,946,2970,6,ITH,ITH1,4,Provincia Autonoma Bolzano / Bozen,P.A. Bolzano,533050,190838,35.8,0.74
2318,2021-05-10,PAB,3029,1306,1723,1338,1611,80,ITH,ITH1,4,Provincia Autonoma Bolzano / Bozen,P.A. Bolzano,533050,193867,36.37,0.57
2319,2021-03-07,PAB,440,150,290,19,420,1,ITH,ITH1,4,Provincia Autonoma Bolzano / Bozen,P.A. Bolzano,533050,194307,36.45,0.08
2320,2021-07-30,PAB,5299,2842,2457,3406,1542,351,ITH,ITH1,4,Provincia Autonoma Bolzano / Bozen,P.A. Bolzano,533050,199606,37.45,0.99
2321,2021-04-21,PAB,3016,1469,1547,2168,847,1,ITH,ITH1,4,Provincia Autonoma Bolzano / Bozen,P.A. Bolzano,533050,202622,38.01,0.57
2322,2021-06-24,PAB,3945,2042,1903,1570,2203,172,ITH,ITH1,4,Provincia Autonoma Bolzano / Bozen,P.A. Bolzano,533050,206567,38.75,0.74
2323,2021-01-09,PAB,612,326,286,612,0,0,ITH,ITH1,4,Provincia Autonoma Bolzano / Bozen,P.A. Bolzano,533050,207179,38.87,0.11
2324,2021-08-06,PAB,3637,1916,1721,1204,2427,6,ITH,ITH1,4,Provincia Autonoma Bolzano / Bozen,P.A. Bolzano,533050,210816,39.55,0.68
2325,2021-04-28,PAB,2469,1307,1162,2460,5,4,ITH,ITH1,4,Provincia Autonoma Bolzano / Bozen,P.A. Bolzano,533050,213285,40.01,0.46
2326,2021-01-16,PAB,2841,1265,1576,2841,0,0,ITH,ITH1,4,Provincia Autonoma Bolzano / Bozen,P.A. Bolzano,533050,216126,40.55,0.53
2327,2021-06-10,PAB,4498,2334,2164,1308,3098,92,ITH,ITH1,4,Provincia Autonoma Bolzano / Bozen,P.A. Bolzano,533050,220624,41.39,0.84
2328,2021-08-13,PAB,2908,1555,1353,1604,1300,4,ITH,ITH1,4,Provincia Autonoma Bolzano / Bozen,P.A. Bolzano,533050,223532,41.93,0.55
2329,2021-04-26,PAB,1550,776,774,1544,5,1,ITH,ITH1,4,Provincia Autonoma Bolzano / Bozen,P.A. Bolzano,533050,225082,42.23,0.29
2330,2021-06-05,PAB,6086,3034,3052,4699,1097,290,ITH,ITH1,4,Provincia Autonoma Bolzano / Bozen,P.A. Bolzano,533050,231168,43.37,1.14
2331,2021-08-27,PAB,2731,1419,1312,1004,1727,0,ITH,ITH1,4,Provincia Autonoma Bolzano / Bozen,P.A. Bolzano,533050,233899,43.88,0.51
2332,2021-05-15,PAB,7019,3695,3324,6336,294,389,ITH,ITH1,4,Provincia Autonoma Bolzano / Bozen,P.A. Bolzano,533050,240918,45.2,1.32
2333,2021-02-04,PAB,1966,596,1370,8,1958,0,ITH,ITH1,4,Provincia Autonoma Bolzano / Bozen,P.A. Bolzano,533050,242884,45.56,0.37
2334,2021-07-11,PAB,6075,3094,2981,1090,4879,106,ITH,ITH1,4,Provincia Autonoma Bolzano / Bozen,P.A. Bolzano,533050,248959,46.7,1.14
2335,2021-04-02,PAB,2090,841,1249,701,1357,32,ITH,ITH1,4,Provincia Autonoma Bolzano / Bozen,P.A. Bolzano,533050,251049,47.1,0.39
2336,2021-05-29,PAB,7340,3907,3433,4043,3144,153,ITH,ITH1,4,Provincia Autonoma Bolzano / Bozen,P.A. Bolzano,533050,258389,48.47,1.38
2337,2021-07-10,PAB,5813,3001,2812,955,4749,109,ITH,ITH1,4,Provincia Autonoma Bolzano / Bozen,P.A. Bolzano,533050,264202,49.56,1.09
2338,2021-01-18,PAB,1776,689,1087,1771,5,0,ITH,ITH1,4,Provincia Autonoma Bolzano / Bozen,P.A. Bolzano,533050,265978,49.9,0.33
2339,2021-08-01,PAB,1318,759,559,712,551,55,ITH,ITH1,4,Provincia Autonoma Bolzano / Bozen,P.A. Bolzano,533050,267296,50.14,0.25
2340,2021-08-18,PAB,879,461,418,379,498,2,ITH,ITH1,4,Provincia Autonoma Bolzano / Bozen,P.A. Bolzano,533050,268175,50.31,0.16
2341,2021-02-16,PAB,530,205,325,530,0,0,ITH,ITH1,4,Provincia Autonoma Bolzano / Bozen,P.A. Bolzano,533050,268705,50.41,0.1
2342,2021-01-28,PAB,872,309,563,9,863,0,ITH,ITH1,4,Provincia Autonoma Bolzano / Bozen,P.A. Bolzano,533050,269577,50.57,0.16
2343,2021-07-01,PAB,4638,2305,2333,1312,3167,159,ITH,ITH1,4,Provincia Autonoma Bolzano / Bozen,P.A. Bolzano,533050,274215,51.44,0.87
2344,2021-03-04,PAB,1721,1010,711,1488,229,4,ITH,ITH1,4,Provincia Autonoma Bolzano / Bozen,P.A. Bolzano,533050,275936,51.77,0.32
2345,2021-09-03,PAB,1982,1060,922,655,1327,0,ITH,ITH1,4,Provincia Autonoma Bolzano / Bozen,P.A. Bolzano,533050,277918,52.14,0.37
2346,2021-05-26,PAB,5019,2537,2482,2869,1978,172,ITH,ITH1,4,Provincia Autonoma Bolzano / Bozen,P.A. Bolzano,533050,282937,53.08,0.94
2347,2021-08-17,PAB,1246,688,558,851,391,4,ITH,ITH1,4,Provincia Autonoma Bolzano / Bozen,P.A. Bolzano,533050,284183,53.31,0.23
2348,2021-02-02,PAB,1752,509,1243,8,1744,0,ITH,ITH1,4,Provincia Autonoma Bolzano / Bozen,P.A. Bolzano,533050,285935,53.64,0.33
2349,2021-07-20,PAB,3133,1730,1403,1403,1524,206,ITH,ITH1,4,Provincia Autonoma Bolzano / Bozen,P.A. Bolzano,533050,289068,54.23,0.59
2350,2021-09-01,PAB,1054,501,553,605,449,0,ITH,ITH1,4,Provincia Autonoma Bolzano / Bozen,P.A. Bolzano,533050,290122,54.43,0.2
2351,2021-06-17,PAB,1773,982,791,623,1078,72,ITH,ITH1,4,Provincia Autonoma Bolzano / Bozen,P.A. Bolzano,533050,291895,54.76,0.33
2352,2021-01-02,PAB,91,48,43,91,0,0,ITH,ITH1,4,Provincia Autonoma Bolzano / Bozen,P.A. Bolzano,533050,291986,54.78,0.02
2353,2021-06-26,PAB,4548,2331,2217,1365,3077,106,ITH,ITH1,4,Provincia Autonoma Bolzano / Bozen,P.A. Bolzano,533050,296534,55.63,0.85
2354,2021-03-26,PAB,1663,737,926,524,1137,2,ITH,ITH1,4,Provincia Autonoma Bolzano / Bozen,P.A. Bolzano,533050,298197,55.94,0.31
2355,2021-04-09,PAB,2942,1303,1639,2211,730,1,ITH,ITH1,4,Provincia Autonoma Bolzano / Bozen,P.A. Bolzano,533050,301139,56.49,0.55
2356,2021-05-22,PAB,6843,3571,3272,4479,2168,196,ITH,ITH1,4,Provincia Autonoma Bolzano / Bozen,P.A. Bolzano,533050,307982,57.78,1.28
2357,2021-02-11,PAB,1095,433,662,239,856,0,ITH,ITH1,4,Provincia Autonoma Bolzano / Bozen,P.A. Bolzano,533050,309077,57.98,0.21
2358,2021-07-18,PAB,1868,1033,835,649,1150,69,ITH,ITH1,4,Provincia Autonoma Bolzano / Bozen,P.A. Bolzano,533050,310945,58.33,0.35
2359,2021-06-14,PAB,2984,1617,1367,577,2361,46,ITH,ITH1,4,Provincia Autonoma Bolzano / Bozen,P.A. Bolzano,533050,313929,58.89,0.56
2360,2021-02-15,PAB,72,42,30,26,46,0,ITH,ITH1,4,Provincia Autonoma Bolzano / Bozen,P.A. Bolzano,533050,314001,58.91,0.01
2361,2021-04-30,PAB,3348,1599,1749,1567,1778,3,ITH,ITH1,4,Provincia Autonoma Bolzano / Bozen,P.A. Bolzano,533050,317349,59.53,0.63
2362,2021-01-20,PAB,619,254,365,410,209,0,ITH,ITH1,4,Provincia Autonoma Bolzano / Bozen,P.A. Bolzano,533050,317968,59.65,0.12
2363,2021-07-22,PAB,3735,1940,1795,1736,1788,211,ITH,ITH1,4,Provincia Autonoma Bolzano / Bozen,P.A. Bolzano,533050,321703,60.35,0.7
2364,2021-01-06,PAB,59,18,41,59,0,0,ITH,ITH1,4,Provincia Autonoma Bolzano / Bozen,P.A. Bolzano,533050,321762,60.36,0.01
2365,2021-03-30,PAB,1302,532,770,220,1082,0,ITH,ITH1,4,Provincia Autonoma Bolzano / Bozen,P.A. Bolzano,533050,323064,60.61,0.24
2366,2021-04-16,PAB,2958,1424,1534,2445,512,1,ITH,ITH1,4,Provincia Autonoma Bolzano / Bozen,P.A. Bolzano,533050,326022,61.16,0.55
2367,2021-04-25,PAB,3078,1501,1577,2405,672,1,ITH,ITH1,4,Provincia Autonoma Bolzano / Bozen,P.A. Bolzano,533050,329100,61.74,0.58
2368,2021-08-03,PAB,2948,1585,1363,1979,838,131,ITH,ITH1,4,Provincia Autonoma Bolzano / Bozen,P.A. Bolzano,533050,332048,62.29,0.55
2369,2021-01-13,PAB,1727,569,1158,1727,0,0,ITH,ITH1,4,Provincia Autonoma Bolzano / Bozen,P.A. Bolzano,533050,333775,62.62,0.32
2370,2021-01-30,PAB,498,245,253,4,494,0,ITH,ITH1,4,Provincia Autonoma Bolzano / Bozen,P.A. Bolzano,533050,334273,62.71,0.09
2371,2021-08-15,PAB,614,332,282,281,333,0,ITH,ITH1,4,Provincia Autonoma Bolzano / Bozen,P.A. Bolzano,533050,334887,62.82,0.12
2372,2021-05-07,PAB,4200,2063,2137,3398,528,274,ITH,ITH1,4,Provincia Autonoma Bolzano / Bozen,P.A. Bolzano,533050,339087,63.61,0.79
2373,2021-07-03,PAB,5638,2792,2846,975,4565,98,ITH,ITH1,4,Provincia Autonoma Bolzano / Bozen,P.A. Bolzano,533050,344725,64.67,1.06
2374,2021-05-05,PAB,4161,1948,2213,1827,2118,216,ITH,ITH1,4,Provincia Autonoma Bolzano / Bozen,P.A. Bolzano,533050,348886,65.45,0.78
2375,2021-01-25,PAB,493,187,306,3,490,0,ITH,ITH1,4,Provincia Autonoma Bolzano / Bozen,P.A. Bolzano,533050,349379,65.54,0.09
2376,2021-03-23,PAB,1556,760,796,1543,1,12,ITH,ITH1,4,Provincia Autonoma Bolzano / Bozen,P.A. Bolzano,533050,350935,65.84,0.29
2377,2021-04-01,PAB,2791,1409,1382,2644,146,1,ITH,ITH1,4,Provincia Autonoma Bolzano / Bozen,P.A. Bolzano,533050,353726,66.36,0.52
2378,2021-07-05,PAB,2936,1406,1530,824,1984,128,ITH,ITH1,4,Provincia Autonoma Bolzano / Bozen,P.A. Bolzano,533050,356662,66.91,0.55
2379,2021-05-30,PAB,4793,2531,2262,733,4030,30,ITH,ITH1,4,Provincia Autonoma Bolzano / Bozen,P.A. Bolzano,533050,361455,67.81,0.9
2380,2021-07-12,PAB,3533,1755,1778,252,3243,38,ITH,ITH1,4,Provincia Autonoma Bolzano / Bozen,P.A. Bolzano,533050,364988,68.47,0.66
2381,2021-04-03,PAB,833,366,467,22,811,0,ITH,ITH1,4,Provincia Autonoma Bolzano / Bozen,P.A. Bolzano,533050,365821,68.63,0.16
2382,2021-05-31,PAB,3068,1514,1554,2087,868,113,ITH,ITH1,4,Provincia Autonoma Bolzano / Bozen,P.A. Bolzano,533050,368889,69.2,0.58
2383,2021-01-01,PAB,6,5,1,6,0,0,ITH,ITH1,4,Provincia Autonoma Bolzano / Bozen,P.A. Bolzano,533050,368895,69.2,0.0
2384,2021-06-07,PAB,2986,1554,1432,2524,324,138,ITH,ITH1,4,Provincia Autonoma Bolzano / Bozen,P.A. Bolzano,533050,371881,69.76,0.56
2385,2021-02-27,PAB,2458,759,1699,2448,10,0,ITH,ITH1,4,Provincia Autonoma Bolzano / Bozen,P.A. Bolzano,533050,374339,70.23,0.46
2386,2021-02-13,PAB,318,79,239,312,6,0,ITH,ITH1,4,Provincia Autonoma Bolzano / Bozen,P.A. Bolzano,533050,374657,70.29,0.06
2387,2021-04-11,PAB,2734,1301,1433,2555,178,1,ITH,ITH1,4,Provincia Autonoma Bolzano / Bozen,P.A. Bolzano,533050,377391,70.8,0.51
2388,2021-05-24,PAB,1459,769,690,1061,335,63,ITH,ITH1,4,Provincia Autonoma Bolzano / Bozen,P.A. Bolzano,533050,378850,71.07,0.27
2389,2021-02-20,PAB,1802,540,1262,1784,18,0,ITH,ITH1,4,Provincia Autonoma Bolzano / Bozen,P.A. Bolzano,533050,380652,71.41,0.34
2390,2021-07-27,PAB,3157,1885,1272,910,2181,66,ITH,ITH1,4,Provincia Autonoma Bolzano / Bozen,P.A. Bolzano,533050,383809,72.0,0.59
2391,2021-04-18,PAB,3116,1611,1505,2104,1011,1,ITH,ITH1,4,Provincia Autonoma Bolzano / Bozen,P.A. Bolzano,533050,386925,72.59,0.58
2392,2021-07-08,PAB,5511,2783,2728,549,4887,75,ITH,ITH1,4,Provincia Autonoma Bolzano / Bozen,P.A. Bolzano,533050,392436,73.62,1.03
2393,2021-06-19,PAB,5664,3016,2648,555,5037,72,ITH,ITH1,4,Provincia Autonoma Bolzano / Bozen,P.A. Bolzano,533050,398100,74.68,1.06
2394,2021-03-11,PAB,1691,830,861,1144,538,9,ITH,ITH1,4,Provincia Autonoma Bolzano / Bozen,P.A. Bolzano,533050,399791,75.0,0.32
2395,2021-02-25,PAB,1498,549,949,1497,1,0,ITH,ITH1,4,Provincia Autonoma Bolzano / Bozen,P.A. Bolzano,533050,401289,75.28,0.28
2396,2021-06-02,PAB,1468,824,644,978,459,31,ITH,ITH1,4,Provincia Autonoma Bolzano / Bozen,P.A. Bolzano,533050,402757,75.56,0.28
2397,2021-02-08,PAB,2,1,1,1,1,0,ITH,ITH1,4,Provincia Autonoma Bolzano / Bozen,P.A. Bolzano,533050,402759,75.56,0.0
2398,2021-08-19,PAB,1747,963,784,1130,614,3,ITH,ITH1,4,Provincia Autonoma Bolzano / Bozen,P.A. Bolzano,533050,404506,75.89,0.33
2399,2021-05-11,PAB,2854,1338,1516,1262,1523,69,ITH,ITH1,4,Provincia Autonoma Bolzano / Bozen,P.A. Bolzano,533050,407360,76.42,0.54
2400,2021-07-31,PAB,3168,1720,1448,2112,924,132,ITH,ITH1,4,Provincia Autonoma Bolzano / Bozen,P.A. Bolzano,533050,410528,77.01,0.59
2401,2021-01-29,PAB,1515,518,997,24,1491,0,ITH,ITH1,4,Provincia Autonoma Bolzano / Bozen,P.A. Bolzano,533050,412043,77.3,0.28
2402,2021-04-22,PAB,2938,1511,1427,1993,942,3,ITH,ITH1,4,Provincia Autonoma Bolzano / Bozen,P.A. Bolzano,533050,414981,77.85,0.55
2403,2021-05-09,PAB,4243,2410,1833,2935,1150,158,ITH,ITH1,4,Provincia Autonoma Bolzano / Bozen,P.A. Bolzano,533050,419224,78.65,0.8
2404,2021-03-06,PAB,3976,2082,1894,3765,211,0,ITH,ITH1,4,Provincia Autonoma Bolzano / Bozen,P.A. Bolzano,533050,423200,79.39,0.75
2405,2021-05-28,PAB,7466,3942,3524,5368,1895,203,ITH,ITH1,4,Provincia Autonoma Bolzano / Bozen,P.A. Bolzano,533050,430666,80.79,1.4
2406,2021-02-17,PAB,156,51,105,139,17,0,ITH,ITH1,4,Provincia Autonoma Bolzano / Bozen,P.A. Bolzano,533050,430822,80.82,0.03
2407,2021-03-18,PAB,1302,531,771,226,1076,0,ITH,ITH1,4,Provincia Autonoma Bolzano / Bozen,P.A. Bolzano,533050,432124,81.07,0.24
2408,2021-08-22,PAB,992,545,447,307,685,0,ITH,ITH1,4,Provincia Autonoma Bolzano / Bozen,P.A. Bolzano,533050,433116,81.25,0.19
2409,2021-05-14,PAB,5145,2323,2822,2904,2044,197,ITH,ITH1,4,Provincia Autonoma Bolzano / Bozen,P.A. Bolzano,533050,438261,82.22,0.97
2410,2021-03-16,PAB,1290,532,758,124,1166,0,ITH,ITH1,4,Provincia Autonoma Bolzano / Bozen,P.A. Bolzano,533050,439551,82.46,0.24
2411,2021-05-12,PAB,3805,2063,1742,3422,154,229,ITH,ITH1,4,Provincia Autonoma Bolzano / Bozen,P.A. Bolzano,533050,443356,83.17,0.71
2412,2021-02-01,PAB,1467,448,1019,14,1453,0,ITH,ITH1,4,Provincia Autonoma Bolzano / Bozen,P.A. Bolzano,533050,444823,83.45,0.28
2413,2021-08-29,PAB,868,479,389,370,498,0,ITH,ITH1,4,Provincia Autonoma Bolzano / Bozen,P.A. Bolzano,533050,445691,83.61,0.16
2414,2021-01-15,PAB,3292,1234,2058,3292,0,0,ITH,ITH1,4,Provincia Autonoma Bolzano / Bozen,P.A. Bolzano,533050,448983,84.23,0.62
2415,2021-08-14,PAB,2059,1119,940,786,1271,2,ITH,ITH1,4,Provincia Autonoma Bolzano / Bozen,P.A. Bolzano,533050,451042,84.62,0.39
2416,2021-06-18,PAB,4543,2350,2193,1468,2911,164,ITH,ITH1,4,Provincia Autonoma Bolzano / Bozen,P.A. Bolzano,533050,455585,85.47,0.85
2417,2021-01-08,PAB,1537,484,1053,1537,0,0,ITH,ITH1,4,Provincia Autonoma Bolzano / Bozen,P.A. Bolzano,533050,457122,85.76,0.29
2418,2021-08-07,PAB,2370,1349,1021,1688,664,18,ITH,ITH1,4,Provincia Autonoma Bolzano / Bozen,P.A. Bolzano,533050,459492,86.2,0.44
2419,2021-03-09,PAB,1194,543,651,1192,2,0,ITH,ITH1,4,Provincia Autonoma Bolzano / Bozen,P.A. Bolzano,533050,460686,86.42,0.22
2420,2021-05-23,PAB,4343,2305,2038,4141,8,194,ITH,ITH1,4,Provincia Autonoma Bolzano / Bozen,P.A. Bolzano,533050,465029,87.24,0.81
2421,2021-07-19,PAB,2781,1394,1387,624,2047,110,ITH,ITH1,4,Provincia Autonoma Bolzano / Bozen,P.A. Bolzano,533050,467810,87.76,0.52
2422,2021-02-03,PAB,1506,479,1027,5,1501,0,ITH,ITH1,4,Provincia Autonoma Bolzano / Bozen,P.A. Bolzano,533050,469316,88.04,0.28
2423,2021-03-25,PAB,2172,1080,1092,1725,444,3,ITH,ITH1,4,Provincia Autonoma Bolzano / Bozen,P.A. Bolzano,533050,471488,88.45,0.41
2424,2021-01-27,PAB,85,29,56,2,83,0,ITH,ITH1,4,Provincia Autonoma Bolzano / Bozen,P.A. Bolzano,533050,471573,88.47,0.02
2425,2021-02-10,PAB,1637,605,1032,27,1610,0,ITH,ITH1,4,Provincia Autonoma Bolzano / Bozen,P.A. Bolzano,533050,473210,88.77,0.31
2426,2021-08-31,PAB,1966,1056,910,723,1243,0,ITH,ITH1,4,Provincia Autonoma Bolzano / Bozen,P.A. Bolzano,533050,475176,89.14,0.37
2427,2021-05-21,PAB,7395,4064,3331,5230,1878,287,ITH,ITH1,4,Provincia Autonoma Bolzano / Bozen,P.A. Bolzano,533050,482571,90.53,1.39
2428,2021-08-24,PAB,1968,1027,941,572,1396,0,ITH,ITH1,4,Provincia Autonoma Bolzano / Bozen,P.A. Bolzano,533050,484539,90.9,0.37
2429,2021-05-16,PAB,2029,935,1094,1285,694,50,ITH,ITH1,4,Provincia Autonoma Bolzano / Bozen,P.A. Bolzano,533050,486568,91.28,0.38
2430,2021-05-19,PAB,3886,1996,1890,1963,1789,134,ITH,ITH1,4,Provincia Autonoma Bolzano / Bozen,P.A. Bolzano,533050,490454,92.01,0.73
2431,2021-01-03,PAB,41,16,25,41,0,0,ITH,ITH1,4,Provincia Autonoma Bolzano / Bozen,P.A. Bolzano,533050,490495,92.02,0.01
2432,2021-04-13,PAB,2399,1134,1265,2392,7,0,ITH,ITH1,4,Provincia Autonoma Bolzano / Bozen,P.A. Bolzano,533050,492894,92.47,0.45
2433,2021-04-23,PAB,4554,2157,2397,3258,1293,3,ITH,ITH1,4,Provincia Autonoma Bolzano / Bozen,P.A. Bolzano,533050,497448,93.32,0.85
2434,2021-01-11,PAB,1594,522,1072,1594,0,0,ITH,ITH1,4,Provincia Autonoma Bolzano / Bozen,P.A. Bolzano,533050,499042,93.62,0.3
2435,2021-07-15,PAB,4395,2319,2076,1516,2703,176,ITH,ITH1,4,Provincia Autonoma Bolzano / Bozen,P.A. Bolzano,533050,503437,94.44,0.82
2436,2021-04-06,PAB,2254,1120,1134,2151,102,1,ITH,ITH1,4,Provincia Autonoma Bolzano / Bozen,P.A. Bolzano,533050,505691,94.87,0.42
2437,2021-07-26,PAB,1628,940,688,1126,411,91,ITH,ITH1,4,Provincia Autonoma Bolzano / Bozen,P.A. Bolzano,533050,507319,95.17,0.31
2438,2021-02-22,PAB,526,143,383,514,12,0,ITH,ITH1,4,Provincia Autonoma Bolzano / Bozen,P.A. Bolzano,533050,507845,95.27,0.1
2439,2021-08-26,PAB,2236,1131,1105,880,1356,0,ITH,ITH1,4,Provincia Autonoma Bolzano / Bozen,P.A. Bolzano,533050,510081,95.69,0.42
2440,2021-07-07,PAB,1992,1033,959,601,1336,55,ITH,ITH1,4,Provincia Autonoma Bolzano / Bozen,P.A. Bolzano,533050,512073,96.06,0.37
2441,2021-02-18,PAB,1838,457,1381,1830,7,1,ITH,ITH1,4,Provincia Autonoma Bolzano / Bozen,P.A. Bolzano,533050,513911,96.41,0.34
2442,2021-07-29,PAB,1340,717,623,719,570,51,ITH,ITH1,4,Provincia Autonoma Bolzano / Bozen,P.A. Bolzano,533050,515251,96.66,0.25
2443,2020-12-30,PAB,389,183,206,389,0,0,ITH,ITH1,4,Provincia Autonoma Bolzano / Bozen,P.A. Bolzano,533050,515640,96.73,0.07
2444,2021-06-09,PAB,3868,1919,1949,1265,2496,107,ITH,ITH1,4,Provincia Autonoma Bolzano / Bozen,P.A. Bolzano,533050,519508,97.46,0.73
2445,2021-03-01,PAB,924,223,701,923,1,0,ITH,ITH1,4,Provincia Autonoma Bolzano / Bozen,P.A. Bolzano,533050,520432,97.63,0.17
2446,2021-08-05,PAB,3467,1886,1581,1801,1578,88,ITH,ITH1,4,Provincia Autonoma Bolzano / Bozen,P.A. Bolzano,533050,523899,98.28,0.65
2447,2021-03-15,PAB,1194,452,742,711,482,1,ITH,ITH1,4,Provincia Autonoma Bolzano / Bozen,P.A. Bolzano,533050,525093,98.51,0.22
2448,2021-04-27,PAB,2235,1015,1220,1156,1079,0,ITH,ITH1,4,Provincia Autonoma Bolzano / Bozen,P.A. Bolzano,533050,527328,98.93,0.42
2449,2021-01-17,PAB,2329,1044,1285,2318,11,0,ITH,ITH1,4,Provincia Autonoma Bolzano / Bozen,P.A. Bolzano,533050,529657,99.36,0.44
2450,2021-06-23,PAB,1153,595,558,333,768,52,ITH,ITH1,4,Provincia Autonoma Bolzano / Bozen,P.A. Bolzano,533050,530810,99.58,0.22
2451,2021-04-20,PAB,1565,785,780,1562,3,0,ITH,ITH1,4,Provincia Autonoma Bolzano / Bozen,P.A. Bolzano,533050,532375,99.87,0.29
2452,2021-01-10,PAB,2,2,0,2,0,0,ITH,ITH1,4,Provincia Autonoma Bolzano / Bozen,P.A. Bolzano,533050,532377,99.87,0.0
2453,2021-06-16,PAB,3823,2028,1795,11,3807,5,ITH,ITH1,4,Provincia Autonoma Bolzano / Bozen,P.A. Bolzano,533050,536200,100.59,0.72
2454,2021-03-08,PAB,1212,535,677,1184,27,1,ITH,ITH1,4,Provincia Autonoma Bolzano / Bozen,P.A. Bolzano,533050,537412,100.82,0.23
2455,2021-08-12,PAB,3358,1720,1638,647,2709,2,ITH,ITH1,4,Provincia Autonoma Bolzano / Bozen,P.A. Bolzano,533050,540770,101.45,0.63
2456,2021-05-04,PAB,3452,1844,1608,2269,1038,145,ITH,ITH1,4,Provincia Autonoma Bolzano / Bozen,P.A. Bolzano,533050,544222,102.1,0.65
2457,2021-07-17,PAB,3147,1801,1346,711,2352,84,ITH,ITH1,4,Provincia Autonoma Bolzano / Bozen,P.A. Bolzano,533050,547369,102.69,0.59
2458,2021-04-08,PAB,2795,1360,1435,2586,204,5,ITH,ITH1,4,Provincia Autonoma Bolzano / Bozen,P.A. Bolzano,533050,550164,103.21,0.52
2459,2020-12-27,PAB,144,65,79,144,0,0,ITH,ITH1,4,Provincia Autonoma Bolzano / Bozen,P.A. Bolzano,533050,550308,103.24,0.03
2460,2021-06-30,PAB,3064,1565,1499,400,2608,56,ITH,ITH1,4,Provincia Autonoma Bolzano / Bozen,P.A. Bolzano,533050,553372,103.81,0.57
2461,2021-06-11,PAB,5838,3003,2835,2140,3486,212,ITH,ITH1,4,Provincia Autonoma Bolzano / Bozen,P.A. Bolzano,533050,559210,104.91,1.1
2462,2021-09-02,PAB,1077,561,516,665,412,0,ITH,ITH1,4,Provincia Autonoma Bolzano / Bozen,P.A. Bolzano,533050,560287,105.11,0.2
2463,2021-03-20,PAB,1760,851,909,1130,625,5,ITH,ITH1,4,Provincia Autonoma Bolzano / Bozen,P.A. Bolzano,533050,562047,105.44,0.33
2464,2021-06-28,PAB,4613,2307,2306,217,4372,24,ITH,ITH1,4,Provincia Autonoma Bolzano / Bozen,P.A. Bolzano,533050,566660,106.31,0.87
2465,2021-05-03,PAB,1838,851,987,398,1419,21,ITH,ITH1,4,Provincia Autonoma Bolzano / Bozen,P.A. Bolzano,533050,568498,106.65,0.34
2466,2021-02-23,PAB,769,324,445,763,6,0,ITH,ITH1,4,Provincia Autonoma Bolzano / Bozen,P.A. Bolzano,533050,569267,106.79,0.14
2467,2021-05-17,PAB,3154,1525,1629,2287,697,170,ITH,ITH1,4,Provincia Autonoma Bolzano / Bozen,P.A. Bolzano,533050,572421,107.39,0.59
2468,2021-06-03,PAB,4890,2663,2227,3691,972,227,ITH,ITH1,4,Provincia Autonoma Bolzano / Bozen,P.A. Bolzano,533050,577311,108.3,0.92
2469,2021-07-06,PAB,1721,925,796,694,982,45,ITH,ITH1,4,Provincia Autonoma Bolzano / Bozen,P.A. Bolzano,533050,579032,108.63,0.32
2470,2021-06-22,PAB,2471,1423,1048,319,2126,26,ITH,ITH1,4,Provincia Autonoma Bolzano / Bozen,P.A. Bolzano,533050,581503,109.09,0.46
2471,2021-03-14,PAB,758,336,422,25,733,0,ITH,ITH1,4,Provincia Autonoma Bolzano / Bozen,P.A. Bolzano,533050,582261,109.23,0.14
2472,2021-04-14,PAB,3603,1650,1953,3507,95,1,ITH,ITH1,4,Provincia Autonoma Bolzano / Bozen,P.A. Bolzano,533050,585864,109.91,0.68
2473,2021-01-04,PAB,510,201,309,510,0,0,ITH,ITH1,4,Provincia Autonoma Bolzano / Bozen,P.A. Bolzano,533050,586374,110.0,0.1
2474,2021-02-06,PAB,2633,1176,1457,19,2614,0,ITH,ITH1,4,Provincia Autonoma Bolzano / Bozen,P.A. Bolzano,533050,589007,110.5,0.49
2475,2021-06-21,PAB,3168,1615,1553,260,2868,40,ITH,ITH1,4,Provincia Autonoma Bolzano / Bozen,P.A. Bolzano,533050,592175,111.09,0.59
2476,2021-03-28,PAB,569,212,357,11,558,0,ITH,ITH1,4,Provincia Autonoma Bolzano / Bozen,P.A. Bolzano,533050,592744,111.2,0.11
2477,2021-08-10,PAB,1847,1014,833,1561,279,7,ITH,ITH1,4,Provincia Autonoma Bolzano / Bozen,P.A. Bolzano,533050,594591,111.55,0.35
2478,2021-06-04,PAB,6720,3387,3333,4949,1537,234,ITH,ITH1,4,Provincia Autonoma Bolzano / Bozen,P.A. Bolzano,533050,601311,112.81,1.26
2479,2021-02-24,PAB,1368,407,961,1356,12,0,ITH,ITH1,4,Provincia Autonoma Bolzano / Bozen,P.A. Bolzano,533050,602679,113.06,0.26
2480,2021-03-27,PAB,3053,1554,1499,1544,1508,1,ITH,ITH1,4,Provincia Autonoma Bolzano / Bozen,P.A. Bolzano,533050,605732,113.64,0.57
2481,2021-03-13,PAB,2886,1460,1426,2785,101,0,ITH,ITH1,4,Provincia Autonoma Bolzano / Bozen,P.A. Bolzano,533050,608618,114.18,0.54
2482,2021-02-05,PAB,3203,1188,2015,8,3195,0,ITH,ITH1,4,Provincia Autonoma Bolzano / Bozen,P.A. Bolzano,533050,611821,114.78,0.6
2483,2021-04-15,PAB,4410,2314,2096,4141,266,3,ITH,ITH1,4,Provincia Autonoma Bolzano / Bozen,P.A. Bolzano,533050,616231,115.6,0.83
2484,2021-07-24,PAB,4829,2847,1982,1387,3329,113,ITH,ITH1,4,Provincia Autonoma Bolzano / Bozen,P.A. Bolzano,533050,621060,116.51,0.91
2485,2021-05-02,PAB,2453,1284,1169,1431,915,107,ITH,ITH1,4,Provincia Autonoma Bolzano / Bozen,P.A. Bolzano,533050,623513,116.97,0.46
2486,2021-01-22,PAB,248,143,105,124,124,0,ITH,ITH1,4,Provincia Autonoma Bolzano / Bozen,P.A. Bolzano,533050,623761,117.02,0.05
2487,2021-01-30,FVG,2285,745,1540,270,2015,0,ITH,ITH4,6,Friuli-Venezia Giulia,Friuli Venezia Giulia,1215220,2285,0.19,0.19
2488,2021-07-13,FVG,11083,5711,5372,1172,9760,151,ITH,ITH4,6,Friuli-Venezia Giulia,Friuli Venezia Giulia,1215220,13368,1.1,0.91
2489,2021-02-18,FVG,3230,1503,1727,2804,408,18,ITH,ITH4,6,Friuli-Venezia Giulia,Friuli Venezia Giulia,1215220,16598,1.37,0.27
2490,2021-04-02,FVG,6608,2937,3671,4638,1841,129,ITH,ITH4,6,Friuli-Venezia Giulia,Friuli Venezia Giulia,1215220,23206,1.91,0.54
2491,2021-04-28,FVG,7343,3242,4101,3691,3515,137,ITH,ITH4,6,Friuli-Venezia Giulia,Friuli Venezia Giulia,1215220,30549,2.51,0.6
2492,2021-01-23,FVG,816,323,493,5,811,0,ITH,ITH4,6,Friuli-Venezia Giulia,Friuli Venezia Giulia,1215220,31365,2.58,0.07
2493,2021-05-24,FVG,11480,5557,5923,7528,3649,303,ITH,ITH4,6,Friuli-Venezia Giulia,Friuli Venezia Giulia,1215220,42845,3.53,0.94
2494,2021-02-13,FVG,568,180,388,560,6,2,ITH,ITH4,6,Friuli-Venezia Giulia,Friuli Venezia Giulia,1215220,43413,3.57,0.05
2495,2021-08-15,FVG,1,1,0,0,1,0,ITH,ITH4,6,Friuli-Venezia Giulia,Friuli Venezia Giulia,1215220,43414,3.57,0.0
2496,2021-03-02,FVG,4224,1520,2704,2702,1500,22,ITH,ITH4,6,Friuli-Venezia Giulia,Friuli Venezia Giulia,1215220,47638,3.92,0.35
2497,2021-09-03,FVG,2576,1351,1225,1033,1423,120,ITH,ITH4,6,Friuli-Venezia Giulia,Friuli Venezia Giulia,1215220,50214,4.13,0.21
2498,2021-03-04,FVG,3460,1600,1860,2770,661,29,ITH,ITH4,6,Friuli-Venezia Giulia,Friuli Venezia Giulia,1215220,53674,4.42,0.28
2499,2021-06-12,FVG,8236,4720,3516,6804,1161,271,ITH,ITH4,6,Friuli-Venezia Giulia,Friuli Venezia Giulia,1215220,61910,5.09,0.68
2500,2021-07-08,FVG,13115,7086,6029,1363,11570,182,ITH,ITH4,6,Friuli-Venezia Giulia,Friuli Venezia Giulia,1215220,75025,6.17,1.08
2501,2021-02-04,FVG,2727,808,1919,35,2692,0,ITH,ITH4,6,Friuli-Venezia Giulia,Friuli Venezia Giulia,1215220,77752,6.4,0.22
2502,2021-08-08,FVG,4297,2337,1960,1884,2320,93,ITH,ITH4,6,Friuli-Venezia Giulia,Friuli Venezia Giulia,1215220,82049,6.75,0.35
2503,2021-04-30,FVG,7417,3270,4147,3577,3666,174,ITH,ITH4,6,Friuli-Venezia Giulia,Friuli Venezia Giulia,1215220,89466,7.36,0.61
2504,2021-03-28,FVG,4947,2356,2591,4691,158,98,ITH,ITH4,6,Friuli-Venezia Giulia,Friuli Venezia Giulia,1215220,94413,7.77,0.41
2505,2021-01-18,FVG,1964,608,1356,1870,94,0,ITH,ITH4,6,Friuli-Venezia Giulia,Friuli Venezia Giulia,1215220,96377,7.93,0.16
2506,2021-01-04,FVG,1508,559,949,1508,0,0,ITH,ITH4,6,Friuli-Venezia Giulia,Friuli Venezia Giulia,1215220,97885,8.05,0.12
2507,2021-08-29,FVG,3147,1772,1375,1793,1254,100,ITH,ITH4,6,Friuli-Venezia Giulia,Friuli Venezia Giulia,1215220,101032,8.31,0.26
2508,2021-06-24,FVG,11121,5674,5447,1899,9113,109,ITH,ITH4,6,Friuli-Venezia Giulia,Friuli Venezia Giulia,1215220,112153,9.23,0.92
2509,2021-03-16,FVG,3192,1302,1890,1023,2085,84,ITH,ITH4,6,Friuli-Venezia Giulia,Friuli Venezia Giulia,1215220,115345,9.49,0.26
2510,2021-08-20,FVG,6245,3530,2715,2676,3296,273,ITH,ITH4,6,Friuli-Venezia Giulia,Friuli Venezia Giulia,1215220,121590,10.01,0.51
2511,2021-05-12,FVG,11193,5179,6014,9354,1428,411,ITH,ITH4,6,Friuli-Venezia Giulia,Friuli Venezia Giulia,1215220,132783,10.93,0.92
2512,2021-07-20,FVG,9407,4931,4476,2447,6662,298,ITH,ITH4,6,Friuli-Venezia Giulia,Friuli Venezia Giulia,1215220,142190,11.7,0.77
2513,2021-08-03,FVG,10165,5354,4811,5244,4556,365,ITH,ITH4,6,Friuli-Venezia Giulia,Friuli Venezia Giulia,1215220,152355,12.54,0.84
2514,2021-04-11,FVG,3434,1519,1915,2414,907,113,ITH,ITH4,6,Friuli-Venezia Giulia,Friuli Venezia Giulia,1215220,155789,12.82,0.28
2515,2021-06-07,FVG,9228,4785,4443,7848,999,381,ITH,ITH4,6,Friuli-Venezia Giulia,Friuli Venezia Giulia,1215220,165017,13.58,0.76
2516,2020-12-28,FVG,1,0,1,1,0,0,ITH,ITH4,6,Friuli-Venezia Giulia,Friuli Venezia Giulia,1215220,165018,13.58,0.0
2517,2021-04-16,FVG,7015,3053,3962,4939,1942,134,ITH,ITH4,6,Friuli-Venezia Giulia,Friuli Venezia Giulia,1215220,172033,14.16,0.58
2518,2021-01-06,FVG,716,265,451,716,0,0,ITH,ITH4,6,Friuli-Venezia Giulia,Friuli Venezia Giulia,1215220,172749,14.22,0.06
2519,2021-02-11,FVG,1968,678,1290,1739,225,4,ITH,ITH4,6,Friuli-Venezia Giulia,Friuli Venezia Giulia,1215220,174717,14.38,0.16
2520,2021-04-09,FVG,8054,3735,4319,6577,1305,172,ITH,ITH4,6,Friuli-Venezia Giulia,Friuli Venezia Giulia,1215220,182771,15.04,0.66
2521,2021-04-04,FVG,4,2,2,2,2,0,ITH,ITH4,6,Friuli-Venezia Giulia,Friuli Venezia Giulia,1215220,182775,15.04,0.0
2522,2021-06-26,FVG,10389,5301,5088,4152,6173,64,ITH,ITH4,6,Friuli-Venezia Giulia,Friuli Venezia Giulia,1215220,193164,15.9,0.85
2523,2021-04-21,FVG,7784,3471,4313,4019,3684,81,ITH,ITH4,6,Friuli-Venezia Giulia,Friuli Venezia Giulia,1215220,200948,16.54,0.64
2524,2021-01-11,FVG,1895,613,1282,1894,0,1,ITH,ITH4,6,Friuli-Venezia Giulia,Friuli Venezia Giulia,1215220,202843,16.69,0.16
2525,2021-07-15,FVG,10092,5142,4950,944,8904,244,ITH,ITH4,6,Friuli-Venezia Giulia,Friuli Venezia Giulia,1215220,212935,17.52,0.83
2526,2021-04-23,FVG,7561,3426,4135,3522,3900,139,ITH,ITH4,6,Friuli-Venezia Giulia,Friuli Venezia Giulia,1215220,220496,18.14,0.62
2527,2021-08-01,FVG,3587,1922,1665,1467,1872,248,ITH,ITH4,6,Friuli-Venezia Giulia,Friuli Venezia Giulia,1215220,224083,18.44,0.3
2528,2021-02-06,FVG,1155,339,816,21,1133,1,ITH,ITH4,6,Friuli-Venezia Giulia,Friuli Venezia Giulia,1215220,225238,18.53,0.1
2529,2021-02-23,FVG,2650,1280,1370,2462,181,7,ITH,ITH4,6,Friuli-Venezia Giulia,Friuli Venezia Giulia,1215220,227888,18.75,0.22
2530,2021-05-17,FVG,8847,4111,4736,6080,2498,269,ITH,ITH4,6,Friuli-Venezia Giulia,Friuli Venezia Giulia,1215220,236735,19.48,0.73
2531,2021-03-09,FVG,4024,1729,2295,1244,2756,24,ITH,ITH4,6,Friuli-Venezia Giulia,Friuli Venezia Giulia,1215220,240759,19.81,0.33
2532,2021-03-21,FVG,2675,1002,1673,2213,410,52,ITH,ITH4,6,Friuli-Venezia Giulia,Friuli Venezia Giulia,1215220,243434,20.03,0.22
2533,2021-01-27,FVG,1272,426,846,449,821,2,ITH,ITH4,6,Friuli-Venezia Giulia,Friuli Venezia Giulia,1215220,244706,20.14,0.1
2534,2021-05-05,FVG,9803,4279,5524,6081,3478,244,ITH,ITH4,6,Friuli-Venezia Giulia,Friuli Venezia Giulia,1215220,254509,20.94,0.81
2535,2021-01-25,FVG,1593,570,1023,200,1393,0,ITH,ITH4,6,Friuli-Venezia Giulia,Friuli Venezia Giulia,1215220,256102,21.07,0.13
2536,2021-07-01,FVG,12386,6445,5941,2639,9491,256,ITH,ITH4,6,Friuli-Venezia Giulia,Friuli Venezia Giulia,1215220,268488,22.09,1.02
2537,2021-03-23,FVG,3908,1696,2212,1743,2145,20,ITH,ITH4,6,Friuli-Venezia Giulia,Friuli Venezia Giulia,1215220,272396,22.42,0.32
2538,2021-01-16,FVG,1232,362,870,1232,0,0,ITH,ITH4,6,Friuli-Venezia Giulia,Friuli Venezia Giulia,1215220,273628,22.52,0.1
2539,2021-07-03,FVG,11431,6097,5334,1098,10185,148,ITH,ITH4,6,Friuli-Venezia Giulia,Friuli Venezia Giulia,1215220,285059,23.46,0.94
2540,2021-03-25,FVG,5543,2431,3112,3331,2140,72,ITH,ITH4,6,Friuli-Venezia Giulia,Friuli Venezia Giulia,1215220,290602,23.91,0.46
2541,2021-08-27,FVG,6155,3320,2835,1387,4557,211,ITH,ITH4,6,Friuli-Venezia Giulia,Friuli Venezia Giulia,1215220,296757,24.42,0.51
2542,2021-06-19,FVG,8569,4467,4102,1353,7151,65,ITH,ITH4,6,Friuli-Venezia Giulia,Friuli Venezia Giulia,1215220,305326,25.13,0.71
2543,2021-03-11,FVG,3484,1520,1964,1715,1754,15,ITH,ITH4,6,Friuli-Venezia Giulia,Friuli Venezia Giulia,1215220,308810,25.41,0.29
2544,2021-08-22,FVG,2055,1179,876,785,1233,37,ITH,ITH4,6,Friuli-Venezia Giulia,Friuli Venezia Giulia,1215220,310865,25.58,0.17
2545,2021-05-19,FVG,12133,5990,6143,9326,2373,434,ITH,ITH4,6,Friuli-Venezia Giulia,Friuli Venezia Giulia,1215220,322998,26.58,1.0
2546,2021-03-14,FVG,1403,554,849,1125,252,26,ITH,ITH4,6,Friuli-Venezia Giulia,Friuli Venezia Giulia,1215220,324401,26.69,0.12
2547,2021-05-31,FVG,8958,4447,4511,6478,2229,251,ITH,ITH4,6,Friuli-Venezia Giulia,Friuli Venezia Giulia,1215220,333359,27.43,0.74
2548,2021-07-27,FVG,9518,4787,4731,2646,6643,229,ITH,ITH4,6,Friuli-Venezia Giulia,Friuli Venezia Giulia,1215220,342877,28.22,0.78
2549,2020-12-30,FVG,626,244,382,626,0,0,ITH,ITH4,6,Friuli-Venezia Giulia,Friuli Venezia Giulia,1215220,343503,28.27,0.05
2550,2021-06-05,FVG,10341,5345,4996,8401,1554,386,ITH,ITH4,6,Friuli-Venezia Giulia,Friuli Venezia Giulia,1215220,353844,29.12,0.85
2551,2021-02-25,FVG,3178,1660,1518,3116,30,32,ITH,ITH4,6,Friuli-Venezia Giulia,Friuli Venezia Giulia,1215220,357022,29.38,0.26
2552,2021-06-16,FVG,12203,5922,6281,3900,8039,264,ITH,ITH4,6,Friuli-Venezia Giulia,Friuli Venezia Giulia,1215220,369225,30.38,1.0
2553,2021-08-12,FVG,7936,4255,3681,5143,2498,295,ITH,ITH4,6,Friuli-Venezia Giulia,Friuli Venezia Giulia,1215220,377161,31.04,0.65
2554,2021-06-09,FVG,11365,5983,5382,9493,1399,473,ITH,ITH4,6,Friuli-Venezia Giulia,Friuli Venezia Giulia,1215220,388526,31.97,0.94
2555,2021-03-01,FVG,2969,1044,1925,2892,53,24,ITH,ITH4,6,Friuli-Venezia Giulia,Friuli Venezia Giulia,1215220,391495,32.22,0.24
2556,2021-06-04,FVG,12172,6238,5934,10290,1454,428,ITH,ITH4,6,Friuli-Venezia Giulia,Friuli Venezia Giulia,1215220,403667,33.22,1.0
2557,2021-07-05,FVG,9596,4881,4715,1319,8134,143,ITH,ITH4,6,Friuli-Venezia Giulia,Friuli Venezia Giulia,1215220,413263,34.01,0.79
2558,2021-06-21,FVG,9217,4507,4710,1828,7252,137,ITH,ITH4,6,Friuli-Venezia Giulia,Friuli Venezia Giulia,1215220,422480,34.77,0.76
2559,2021-03-13,FVG,2947,1125,1822,1660,1274,13,ITH,ITH4,6,Friuli-Venezia Giulia,Friuli Venezia Giulia,1215220,425427,35.01,0.24
2560,2021-05-07,FVG,10945,5010,5935,7188,3561,196,ITH,ITH4,6,Friuli-Venezia Giulia,Friuli Venezia Giulia,1215220,436372,35.91,0.9
2561,2021-05-09,FVG,7387,3317,4070,3376,3877,134,ITH,ITH4,6,Friuli-Venezia Giulia,Friuli Venezia Giulia,1215220,443759,36.52,0.61
2562,2021-07-31,FVG,7362,3784,3578,1269,6003,90,ITH,ITH4,6,Friuli-Venezia Giulia,Friuli Venezia Giulia,1215220,451121,37.12,0.61
2563,2021-08-17,FVG,3504,1886,1618,2671,598,235,ITH,ITH4,6,Friuli-Venezia Giulia,Friuli Venezia Giulia,1215220,454625,37.41,0.29
2564,2021-05-26,FVG,13474,6730,6744,9654,3467,353,ITH,ITH4,6,Friuli-Venezia Giulia,Friuli Venezia Giulia,1215220,468099,38.52,1.11
2565,2021-02-15,FVG,2461,914,1547,2201,254,6,ITH,ITH4,6,Friuli-Venezia Giulia,Friuli Venezia Giulia,1215220,470560,38.72,0.2
2566,2021-03-30,FVG,7620,3407,4213,6286,1199,135,ITH,ITH4,6,Friuli-Venezia Giulia,Friuli Venezia Giulia,1215220,478180,39.35,0.63
2567,2021-07-10,FVG,8807,4546,4261,143,8638,26,ITH,ITH4,6,Friuli-Venezia Giulia,Friuli Venezia Giulia,1215220,486987,40.07,0.72
2568,2021-04-08,FVG,7471,3235,4236,5407,1930,134,ITH,ITH4,6,Friuli-Venezia Giulia,Friuli Venezia Giulia,1215220,494458,40.69,0.61
2569,2021-05-21,FVG,11293,5044,6249,7914,3034,345,ITH,ITH4,6,Friuli-Venezia Giulia,Friuli Venezia Giulia,1215220,505751,41.62,0.93
2570,2021-02-10,FVG,1353,499,854,1265,88,0,ITH,ITH4,6,Friuli-Venezia Giulia,Friuli Venezia Giulia,1215220,507104,41.73,0.11
2571,2021-07-17,FVG,7388,3964,3424,621,6684,83,ITH,ITH4,6,Friuli-Venezia Giulia,Friuli Venezia Giulia,1215220,514492,42.34,0.61
2572,2021-02-01,FVG,2106,690,1416,17,2089,0,ITH,ITH4,6,Friuli-Venezia Giulia,Friuli Venezia Giulia,1215220,516598,42.51,0.17
2573,2021-08-31,FVG,7476,3996,3480,1345,5939,192,ITH,ITH4,6,Friuli-Venezia Giulia,Friuli Venezia Giulia,1215220,524074,43.13,0.62
2574,2021-05-14,FVG,10864,5400,5464,7929,2638,297,ITH,ITH4,6,Friuli-Venezia Giulia,Friuli Venezia Giulia,1215220,534938,44.02,0.89
2575,2021-02-03,FVG,2650,792,1858,22,2627,1,ITH,ITH4,6,Friuli-Venezia Giulia,Friuli Venezia Giulia,1215220,537588,44.24,0.22
2576,2021-02-08,FVG,2361,697,1664,90,2270,1,ITH,ITH4,6,Friuli-Venezia Giulia,Friuli Venezia Giulia,1215220,539949,44.43,0.19
2577,2021-06-13,FVG,8713,4536,4177,5178,3329,206,ITH,ITH4,6,Friuli-Venezia Giulia,Friuli Venezia Giulia,1215220,548662,45.15,0.72
2578,2021-07-24,FVG,6168,3334,2834,2916,3080,172,ITH,ITH4,6,Friuli-Venezia Giulia,Friuli Venezia Giulia,1215220,554830,45.66,0.51
2579,2021-08-24,FVG,6598,3568,3030,723,5742,133,ITH,ITH4,6,Friuli-Venezia Giulia,Friuli Venezia Giulia,1215220,561428,46.2,0.54
2580,2021-08-10,FVG,7280,4059,3221,5261,1657,362,ITH,ITH4,6,Friuli-Venezia Giulia,Friuli Venezia Giulia,1215220,568708,46.8,0.6
2581,2021-05-02,FVG,6913,3256,3657,3809,2962,142,ITH,ITH4,6,Friuli-Venezia Giulia,Friuli Venezia Giulia,1215220,575621,47.37,0.57
2582,2021-05-16,FVG,10026,4801,5225,8376,1406,244,ITH,ITH4,6,Friuli-Venezia Giulia,Friuli Venezia Giulia,1215220,585647,48.19,0.83
2583,2021-02-27,FVG,3538,1204,2334,3520,1,17,ITH,ITH4,6,Friuli-Venezia Giulia,Friuli Venezia Giulia,1215220,589185,48.48,0.29
2584,2021-04-25,FVG,2382,992,1390,2188,13,181,ITH,ITH4,6,Friuli-Venezia Giulia,Friuli Venezia Giulia,1215220,591567,48.68,0.2
2585,2021-01-01,FVG,2,2,0,2,0,0,ITH,ITH4,6,Friuli-Venezia Giulia,Friuli Venezia Giulia,1215220,591569,48.68,0.0
2586,2021-01-15,FVG,2020,605,1415,2019,0,1,ITH,ITH4,6,Friuli-Venezia Giulia,Friuli Venezia Giulia,1215220,593589,48.85,0.17
2587,2021-07-26,FVG,8556,4266,4290,1777,6569,210,ITH,ITH4,6,Friuli-Venezia Giulia,Friuli Venezia Giulia,1215220,602145,49.55,0.7
2588,2021-04-17,FVG,7468,3240,4228,5821,1484,163,ITH,ITH4,6,Friuli-Venezia Giulia,Friuli Venezia Giulia,1215220,609613,50.16,0.61
2589,2021-07-28,FVG,10496,5351,5145,4003,6041,452,ITH,ITH4,6,Friuli-Venezia Giulia,Friuli Venezia Giulia,1215220,620109,51.03,0.86
2590,2021-07-19,FVG,9444,4938,4506,852,8438,154,ITH,ITH4,6,Friuli-Venezia Giulia,Friuli Venezia Giulia,1215220,629553,51.81,0.78
2591,2021-04-10,FVG,5060,2217,2843,3753,1230,77,ITH,ITH4,6,Friuli-Venezia Giulia,Friuli Venezia Giulia,1215220,634613,52.22,0.42
2592,2021-05-23,FVG,10295,4868,5427,5923,4158,214,ITH,ITH4,6,Friuli-Venezia Giulia,Friuli Venezia Giulia,1215220,644908,53.07,0.85
2593,2021-07-29,FVG,9600,4893,4707,3216,6085,299,ITH,ITH4,6,Friuli-Venezia Giulia,Friuli Venezia Giulia,1215220,654508,53.86,0.79
2594,2021-04-20,FVG,7146,3078,4068,3099,3919,128,ITH,ITH4,6,Friuli-Venezia Giulia,Friuli Venezia Giulia,1215220,661654,54.45,0.59
2595,2021-03-18,FVG,3378,1424,1954,1684,1686,8,ITH,ITH4,6,Friuli-Venezia Giulia,Friuli Venezia Giulia,1215220,665032,54.73,0.28
2596,2021-06-28,FVG,9923,5000,4923,2153,7712,58,ITH,ITH4,6,Friuli-Venezia Giulia,Friuli Venezia Giulia,1215220,674955,55.54,0.82
2597,2021-03-20,FVG,3409,1413,1996,1300,2095,14,ITH,ITH4,6,Friuli-Venezia Giulia,Friuli Venezia Giulia,1215220,678364,55.82,0.28
2598,2021-01-13,FVG,2657,837,1820,2656,0,1,ITH,ITH4,6,Friuli-Venezia Giulia,Friuli Venezia Giulia,1215220,681021,56.04,0.22
2599,2021-04-06,FVG,6691,3142,3549,5428,1157,106,ITH,ITH4,6,Friuli-Venezia Giulia,Friuli Venezia Giulia,1215220,687712,56.59,0.55
2600,2020-12-27,FVG,262,149,113,261,0,1,ITH,ITH4,6,Friuli-Venezia Giulia,Friuli Venezia Giulia,1215220,687974,56.61,0.02
2601,2021-02-12,FVG,1195,428,767,1142,49,4,ITH,ITH4,6,Friuli-Venezia Giulia,Friuli Venezia Giulia,1215220,689169,56.71,0.1
2602,2021-06-23,FVG,12102,5859,6243,2000,9958,144,ITH,ITH4,6,Friuli-Venezia Giulia,Friuli Venezia Giulia,1215220,701271,57.71,1.0
2603,2021-08-19,FVG,4786,2561,2225,1627,3002,157,ITH,ITH4,6,Friuli-Venezia Giulia,Friuli Venezia Giulia,1215220,706057,58.1,0.39
2604,2021-08-05,FVG,7111,3656,3455,3214,3693,204,ITH,ITH4,6,Friuli-Venezia Giulia,Friuli Venezia Giulia,1215220,713168,58.69,0.59
2605,2021-04-27,FVG,8150,3743,4407,3551,4498,101,ITH,ITH4,6,Friuli-Venezia Giulia,Friuli Venezia Giulia,1215220,721318,59.36,0.67
2606,2021-05-04,FVG,9615,4341,5274,6003,3387,225,ITH,ITH4,6,Friuli-Venezia Giulia,Friuli Venezia Giulia,1215220,730933,60.15,0.79
2607,2021-04-01,FVG,6435,3074,3361,5327,1018,90,ITH,ITH4,6,Friuli-Venezia Giulia,Friuli Venezia Giulia,1215220,737368,60.68,0.53
2608,2021-05-28,FVG,10657,5107,5550,6232,4144,281,ITH,ITH4,6,Friuli-Venezia Giulia,Friuli Venezia Giulia,1215220,748025,61.55,0.88
2609,2021-07-12,FVG,10038,5156,4882,1111,8772,155,ITH,ITH4,6,Friuli-Venezia Giulia,Friuli Venezia Giulia,1215220,758063,62.38,0.83
2610,2021-02-19,FVG,3296,1318,1978,2839,442,15,ITH,ITH4,6,Friuli-Venezia Giulia,Friuli Venezia Giulia,1215220,761359,62.65,0.27
2611,2021-04-18,FVG,6063,2814,3249,5422,410,231,ITH,ITH4,6,Friuli-Venezia Giulia,Friuli Venezia Giulia,1215220,767422,63.15,0.5
2612,2021-01-08,FVG,2343,751,1592,2343,0,0,ITH,ITH4,6,Friuli-Venezia Giulia,Friuli Venezia Giulia,1215220,769765,63.34,0.19
2613,2021-06-14,FVG,10321,5010,5311,5191,4838,292,ITH,ITH4,6,Friuli-Venezia Giulia,Friuli Venezia Giulia,1215220,780086,64.19,0.85
2614,2021-02-20,FVG,2079,942,1137,1932,144,3,ITH,ITH4,6,Friuli-Venezia Giulia,Friuli Venezia Giulia,1215220,782165,64.36,0.17
2615,2021-01-22,FVG,117,56,61,28,89,0,ITH,ITH4,6,Friuli-Venezia Giulia,Friuli Venezia Giulia,1215220,782282,64.37,0.01
2616,2021-03-06,FVG,3512,1201,2311,3153,327,32,ITH,ITH4,6,Friuli-Venezia Giulia,Friuli Venezia Giulia,1215220,785794,64.66,0.29
2617,2021-09-02,FVG,6823,3670,3153,1862,4750,211,ITH,ITH4,6,Friuli-Venezia Giulia,Friuli Venezia Giulia,1215220,792617,65.22,0.56
2618,2021-05-25,FVG,12957,6406,6551,9290,3324,343,ITH,ITH4,6,Friuli-Venezia Giulia,Friuli Venezia Giulia,1215220,805574,66.29,1.07
2619,2021-08-16,FVG,4735,2546,2189,2602,1876,257,ITH,ITH4,6,Friuli-Venezia Giulia,Friuli Venezia Giulia,1215220,810309,66.68,0.39
2620,2021-06-11,FVG,10940,5965,4975,9640,838,462,ITH,ITH4,6,Friuli-Venezia Giulia,Friuli Venezia Giulia,1215220,821249,67.58,0.9
2621,2021-03-03,FVG,3654,1641,2013,2347,1277,30,ITH,ITH4,6,Friuli-Venezia Giulia,Friuli Venezia Giulia,1215220,824903,67.88,0.3
2622,2021-05-27,FVG,12865,6158,6707,7395,5247,223,ITH,ITH4,6,Friuli-Venezia Giulia,Friuli Venezia Giulia,1215220,837768,68.94,1.06
2623,2021-06-18,FVG,10979,5420,5559,3404,7312,263,ITH,ITH4,6,Friuli-Venezia Giulia,Friuli Venezia Giulia,1215220,848747,69.84,0.9
2624,2021-03-10,FVG,3601,1710,1891,1746,1796,59,ITH,ITH4,6,Friuli-Venezia Giulia,Friuli Venezia Giulia,1215220,852348,70.14,0.3
2625,2021-02-24,FVG,2532,1093,1439,2503,18,11,ITH,ITH4,6,Friuli-Venezia Giulia,Friuli Venezia Giulia,1215220,854880,70.35,0.21
2626,2021-03-27,FVG,5382,2921,2461,3922,1412,48,ITH,ITH4,6,Friuli-Venezia Giulia,Friuli Venezia Giulia,1215220,860262,70.79,0.44
2627,2021-01-10,FVG,2942,919,2023,2942,0,0,ITH,ITH4,6,Friuli-Venezia Giulia,Friuli Venezia Giulia,1215220,863204,71.03,0.24
2628,2021-07-14,FVG,10911,5583,5328,1258,9461,192,ITH,ITH4,6,Friuli-Venezia Giulia,Friuli Venezia Giulia,1215220,874115,71.93,0.9
2629,2021-04-05,FVG,2911,1449,1462,2833,16,62,ITH,ITH4,6,Friuli-Venezia Giulia,Friuli Venezia Giulia,1215220,877026,72.17,0.24
2630,2021-01-12,FVG,2271,719,1552,2271,0,0,ITH,ITH4,6,Friuli-Venezia Giulia,Friuli Venezia Giulia,1215220,879297,72.36,0.19
2631,2021-01-29,FVG,2419,815,1604,266,2153,0,ITH,ITH4,6,Friuli-Venezia Giulia,Friuli Venezia Giulia,1215220,881716,72.56,0.2
2632,2021-04-22,FVG,6801,3093,3708,3034,3695,72,ITH,ITH4,6,Friuli-Venezia Giulia,Friuli Venezia Giulia,1215220,888517,73.12,0.56
2633,2021-01-07,FVG,2108,726,1382,2108,0,0,ITH,ITH4,6,Friuli-Venezia Giulia,Friuli Venezia Giulia,1215220,890625,73.29,0.17
2634,2021-03-05,FVG,3831,1543,2288,2729,1079,23,ITH,ITH4,6,Friuli-Venezia Giulia,Friuli Venezia Giulia,1215220,894456,73.6,0.32
2635,2021-04-19,FVG,6732,3142,3590,3214,3426,92,ITH,ITH4,6,Friuli-Venezia Giulia,Friuli Venezia Giulia,1215220,901188,74.16,0.55
2636,2021-01-09,FVG,2532,846,1686,2531,0,1,ITH,ITH4,6,Friuli-Venezia Giulia,Friuli Venezia Giulia,1215220,903720,74.37,0.21
2637,2021-06-15,FVG,12174,6196,5978,5357,6541,276,ITH,ITH4,6,Friuli-Venezia Giulia,Friuli Venezia Giulia,1215220,915894,75.37,1.0
2638,2021-03-07,FVG,2556,938,1618,2497,1,58,ITH,ITH4,6,Friuli-Venezia Giulia,Friuli Venezia Giulia,1215220,918450,75.58,0.21
2639,2020-12-31,FVG,1048,381,667,1047,0,1,ITH,ITH4,6,Friuli-Venezia Giulia,Friuli Venezia Giulia,1215220,919498,75.67,0.09
2640,2021-01-24,FVG,307,121,186,2,305,0,ITH,ITH4,6,Friuli-Venezia Giulia,Friuli Venezia Giulia,1215220,919805,75.69,0.03
2641,2021-06-30,FVG,13205,6723,6482,1386,11645,174,ITH,ITH4,6,Friuli-Venezia Giulia,Friuli Venezia Giulia,1215220,933010,76.78,1.09
2642,2021-03-08,FVG,4134,1647,2487,2028,2091,15,ITH,ITH4,6,Friuli-Venezia Giulia,Friuli Venezia Giulia,1215220,937144,77.12,0.34
2643,2021-03-22,FVG,3669,1454,2215,1671,1959,39,ITH,ITH4,6,Friuli-Venezia Giulia,Friuli Venezia Giulia,1215220,940813,77.42,0.3
2644,2021-01-17,FVG,1715,522,1193,1713,0,2,ITH,ITH4,6,Friuli-Venezia Giulia,Friuli Venezia Giulia,1215220,942528,77.56,0.14
2645,2021-03-15,FVG,3961,1813,2148,1614,2324,23,ITH,ITH4,6,Friuli-Venezia Giulia,Friuli Venezia Giulia,1215220,946489,77.89,0.33
2646,2021-05-11,FVG,9188,4432,4756,7158,1812,218,ITH,ITH4,6,Friuli-Venezia Giulia,Friuli Venezia Giulia,1215220,955677,78.64,0.76
2647,2021-01-31,FVG,2726,842,1884,385,2341,0,ITH,ITH4,6,Friuli-Venezia Giulia,Friuli Venezia Giulia,1215220,958403,78.87,0.22
2648,2021-04-15,FVG,6526,2886,3640,5093,1275,158,ITH,ITH4,6,Friuli-Venezia Giulia,Friuli Venezia Giulia,1215220,964929,79.4,0.54
2649,2021-04-29,FVG,6808,2998,3810,4015,2606,187,ITH,ITH4,6,Friuli-Venezia Giulia,Friuli Venezia Giulia,1215220,971737,79.96,0.56
2650,2021-01-05,FVG,1679,552,1127,1677,0,2,ITH,ITH4,6,Friuli-Venezia Giulia,Friuli Venezia Giulia,1215220,973416,80.1,0.14
2651,2021-08-07,FVG,4766,2569,2197,2703,1932,131,ITH,ITH4,6,Friuli-Venezia Giulia,Friuli Venezia Giulia,1215220,978182,80.49,0.39
2652,2021-07-30,FVG,9071,4728,4343,2770,6038,263,ITH,ITH4,6,Friuli-Venezia Giulia,Friuli Venezia Giulia,1215220,987253,81.24,0.75
2653,2021-01-28,FVG,2249,797,1452,355,1894,0,ITH,ITH4,6,Friuli-Venezia Giulia,Friuli Venezia Giulia,1215220,989502,81.43,0.19
2654,2021-05-08,FVG,10344,4674,5670,5363,4793,188,ITH,ITH4,6,Friuli-Venezia Giulia,Friuli Venezia Giulia,1215220,999846,82.28,0.85
2655,2021-02-14,FVG,1,0,1,0,1,0,ITH,ITH4,6,Friuli-Venezia Giulia,Friuli Venezia Giulia,1215220,999847,82.28,0.0
2656,2021-08-18,FVG,4693,2499,2194,2988,1468,237,ITH,ITH4,6,Friuli-Venezia Giulia,Friuli Venezia Giulia,1215220,1004540,82.66,0.39
2657,2021-05-10,FVG,8008,3557,4451,6224,1544,240,ITH,ITH4,6,Friuli-Venezia Giulia,Friuli Venezia Giulia,1215220,1012548,83.32,0.66
2658,2021-04-24,FVG,6693,2952,3741,5208,1245,240,ITH,ITH4,6,Friuli-Venezia Giulia,Friuli Venezia Giulia,1215220,1019241,83.87,0.55
2659,2021-06-06,FVG,9502,4634,4868,7645,1567,290,ITH,ITH4,6,Friuli-Venezia Giulia,Friuli Venezia Giulia,1215220,1028743,84.65,0.78
2660,2021-02-26,FVG,3783,2129,1654,3580,171,32,ITH,ITH4,6,Friuli-Venezia Giulia,Friuli Venezia Giulia,1215220,1032526,84.97,0.31
2661,2021-02-17,FVG,2365,1006,1359,1874,489,2,ITH,ITH4,6,Friuli-Venezia Giulia,Friuli Venezia Giulia,1215220,1034891,85.16,0.19
2662,2021-08-23,FVG,4695,2422,2273,2561,1777,357,ITH,ITH4,6,Friuli-Venezia Giulia,Friuli Venezia Giulia,1215220,1039586,85.55,0.39
2663,2021-05-29,FVG,12043,5857,6186,6784,4996,263,ITH,ITH4,6,Friuli-Venezia Giulia,Friuli Venezia Giulia,1215220,1051629,86.54,0.99
2664,2021-07-25,FVG,3893,2025,1868,1916,1871,106,ITH,ITH4,6,Friuli-Venezia Giulia,Friuli Venezia Giulia,1215220,1055522,86.86,0.32
2665,2021-07-11,FVG,6870,3588,3282,2387,4183,300,ITH,ITH4,6,Friuli-Venezia Giulia,Friuli Venezia Giulia,1215220,1062392,87.42,0.57
2666,2021-08-30,FVG,7301,3884,3417,2475,4593,233,ITH,ITH4,6,Friuli-Venezia Giulia,Friuli Venezia Giulia,1215220,1069693,88.02,0.6
2667,2021-05-22,FVG,11604,5209,6395,7090,4242,272,ITH,ITH4,6,Friuli-Venezia Giulia,Friuli Venezia Giulia,1215220,1081297,88.98,0.95
2668,2021-07-18,FVG,5468,2958,2510,438,5006,24,ITH,ITH4,6,Friuli-Venezia Giulia,Friuli Venezia Giulia,1215220,1086765,89.43,0.45
2669,2021-05-30,FVG,11078,4997,6081,7238,3593,247,ITH,ITH4,6,Friuli-Venezia Giulia,Friuli Venezia Giulia,1215220,1097843,90.34,0.91
2670,2021-06-17,FVG,11441,5788,5653,2287,9047,107,ITH,ITH4,6,Friuli-Venezia Giulia,Friuli Venezia Giulia,1215220,1109284,91.28,0.94
2671,2021-06-22,FVG,11610,5978,5632,2366,9111,133,ITH,ITH4,6,Friuli-Venezia Giulia,Friuli Venezia Giulia,1215220,1120894,92.24,0.96
2672,2021-08-06,FVG,6451,3393,3058,2346,3932,173,ITH,ITH4,6,Friuli-Venezia Giulia,Friuli Venezia Giulia,1215220,1127345,92.77,0.53
2673,2021-08-11,FVG,7926,4186,3740,5218,2374,334,ITH,ITH4,6,Friuli-Venezia Giulia,Friuli Venezia Giulia,1215220,1135271,93.42,0.65
2674,2021-05-03,FVG,7256,3304,3952,3348,3793,115,ITH,ITH4,6,Friuli-Venezia Giulia,Friuli Venezia Giulia,1215220,1142527,94.02,0.6
2675,2021-01-14,FVG,2592,794,1798,2589,0,3,ITH,ITH4,6,Friuli-Venezia Giulia,Friuli Venezia Giulia,1215220,1145119,94.23,0.21
2676,2021-08-13,FVG,3801,2132,1669,2631,967,203,ITH,ITH4,6,Friuli-Venezia Giulia,Friuli Venezia Giulia,1215220,1148920,94.54,0.31
2677,2021-06-08,FVG,10556,5536,5020,9638,500,418,ITH,ITH4,6,Friuli-Venezia Giulia,Friuli Venezia Giulia,1215220,1159476,95.41,0.87
2678,2021-02-28,FVG,2692,1005,1687,2269,394,29,ITH,ITH4,6,Friuli-Venezia Giulia,Friuli Venezia Giulia,1215220,1162168,95.63,0.22
2679,2021-08-04,FVG,9325,4819,4506,4642,4380,303,ITH,ITH4,6,Friuli-Venezia Giulia,Friuli Venezia Giulia,1215220,1171493,96.4,0.77
2680,2021-04-26,FVG,5491,2466,3025,3716,1655,120,ITH,ITH4,6,Friuli-Venezia Giulia,Friuli Venezia Giulia,1215220,1176984,96.85,0.45
2681,2021-02-05,FVG,2631,792,1839,89,2542,0,ITH,ITH4,6,Friuli-Venezia Giulia,Friuli Venezia Giulia,1215220,1179615,97.07,0.22
2682,2021-04-14,FVG,7254,3135,4119,5411,1718,125,ITH,ITH4,6,Friuli-Venezia Giulia,Friuli Venezia Giulia,1215220,1186869,97.67,0.6
2683,2021-07-06,FVG,11222,5858,5364,1353,9757,112,ITH,ITH4,6,Friuli-Venezia Giulia,Friuli Venezia Giulia,1215220,1198091,98.59,0.92
2684,2021-07-23,FVG,9058,4644,4414,3041,5592,425,ITH,ITH4,6,Friuli-Venezia Giulia,Friuli Venezia Giulia,1215220,1207149,99.34,0.75
2685,2021-08-25,FVG,7844,4199,3645,3021,4459,364,ITH,ITH4,6,Friuli-Venezia Giulia,Friuli Venezia Giulia,1215220,1214993,99.98,0.65
2686,2021-06-03,FVG,12472,6762,5710,9920,2130,422,ITH,ITH4,6,Friuli-Venezia Giulia,Friuli Venezia Giulia,1215220,1227465,101.01,1.03
2687,2021-08-02,FVG,9025,4635,4390,2853,5915,257,ITH,ITH4,6,Friuli-Venezia Giulia,Friuli Venezia Giulia,1215220,1236490,101.75,0.74
2688,2021-04-03,FVG,4022,1994,2028,2623,1339,60,ITH,ITH4,6,Friuli-Venezia Giulia,Friuli Venezia Giulia,1215220,1240512,102.08,0.33
2689,2021-06-10,FVG,11588,6032,5556,9701,1485,402,ITH,ITH4,6,Friuli-Venezia Giulia,Friuli Venezia Giulia,1215220,1252100,103.03,0.95
2690,2021-01-19,FVG,6,2,4,6,0,0,ITH,ITH4,6,Friuli-Venezia Giulia,Friuli Venezia Giulia,1215220,1252106,103.04,0.0
2691,2021-08-14,FVG,198,146,52,180,4,14,ITH,ITH4,6,Friuli-Venezia Giulia,Friuli Venezia Giulia,1215220,1252304,103.05,0.02
2692,2021-08-28,FVG,2891,1571,1320,1776,957,158,ITH,ITH4,6,Friuli-Venezia Giulia,Friuli Venezia Giulia,1215220,1255195,103.29,0.24
2693,2021-05-06,FVG,11978,5568,6410,7714,3984,280,ITH,ITH4,6,Friuli-Venezia Giulia,Friuli Venezia Giulia,1215220,1267173,104.28,0.99
2694,2021-07-02,FVG,11116,5748,5368,2116,8808,192,ITH,ITH4,6,Friuli-Venezia Giulia,Friuli Venezia Giulia,1215220,1278289,105.19,0.91
2695,2021-06-25,FVG,11003,5530,5473,2394,8560,49,ITH,ITH4,6,Friuli-Venezia Giulia,Friuli Venezia Giulia,1215220,1289292,106.1,0.91
2696,2021-07-09,FVG,11955,6352,5603,2127,9540,288,ITH,ITH4,6,Friuli-Venezia Giulia,Friuli Venezia Giulia,1215220,1301247,107.08,0.98
2697,2021-03-17,FVG,3242,1270,1972,736,2496,10,ITH,ITH4,6,Friuli-Venezia Giulia,Friuli Venezia Giulia,1215220,1304489,107.35,0.27
2698,2021-08-21,FVG,2895,1558,1337,279,2574,42,ITH,ITH4,6,Friuli-Venezia Giulia,Friuli Venezia Giulia,1215220,1307384,107.58,0.24
2699,2021-05-13,FVG,11227,5429,5798,8751,2081,395,ITH,ITH4,6,Friuli-Venezia Giulia,Friuli Venezia Giulia,1215220,1318611,108.51,0.92
2700,2021-02-16,FVG,2518,1136,1382,2398,116,4,ITH,ITH4,6,Friuli-Venezia Giulia,Friuli Venezia Giulia,1215220,1321129,108.72,0.21
2701,2021-03-24,FVG,3987,1727,2260,2465,1484,38,ITH,ITH4,6,Friuli-Venezia Giulia,Friuli Venezia Giulia,1215220,1325116,109.04,0.33
2702,2021-05-20,FVG,12732,6332,6400,9798,2530,404,ITH,ITH4,6,Friuli-Venezia Giulia,Friuli Venezia Giulia,1215220,1337848,110.09,1.05
2703,2021-01-26,FVG,1979,649,1330,217,1761,1,ITH,ITH4,6,Friuli-Venezia Giulia,Friuli Venezia Giulia,1215220,1339827,110.25,0.16
2704,2021-02-09,FVG,1845,555,1290,1556,288,1,ITH,ITH4,6,Friuli-Venezia Giulia,Friuli Venezia Giulia,1215220,1341672,110.41,0.15
2705,2021-02-02,FVG,2480,812,1668,218,2262,0,ITH,ITH4,6,Friuli-Venezia Giulia,Friuli Venezia Giulia,1215220,1344152,110.61,0.2
2706,2021-03-31,FVG,8148,3574,4574,7172,850,126,ITH,ITH4,6,Friuli-Venezia Giulia,Friuli Venezia Giulia,1215220,1352300,111.28,0.67
2707,2021-09-01,FVG,8367,4517,3850,2007,6158,202,ITH,ITH4,6,Friuli-Venezia Giulia,Friuli Venezia Giulia,1215220,1360667,111.97,0.69
2708,2021-03-19,FVG,3278,1370,1908,1317,1946,15,ITH,ITH4,6,Friuli-Venezia Giulia,Friuli Venezia Giulia,1215220,1363945,112.24,0.27
2709,2021-06-27,FVG,7665,3828,3837,3749,3855,61,ITH,ITH4,6,Friuli-Venezia Giulia,Friuli Venezia Giulia,1215220,1371610,112.87,0.63
2710,2021-06-29,FVG,11383,5806,5577,1229,10047,107,ITH,ITH4,6,Friuli-Venezia Giulia,Friuli Venezia Giulia,1215220,1382993,113.81,0.94
2711,2021-07-16,FVG,9803,5238,4565,1698,7953,152,ITH,ITH4,6,Friuli-Venezia Giulia,Friuli Venezia Giulia,1215220,1392796,114.61,0.81
2712,2021-04-07,FVG,7860,3644,4216,6952,789,119,ITH,ITH4,6,Friuli-Venezia Giulia,Friuli Venezia Giulia,1215220,1400656,115.26,0.65
2713,2021-04-13,FVG,7394,3299,4095,5657,1609,128,ITH,ITH4,6,Friuli-Venezia Giulia,Friuli Venezia Giulia,1215220,1408050,115.87,0.61
2714,2021-01-03,FVG,313,123,190,313,0,0,ITH,ITH4,6,Friuli-Venezia Giulia,Friuli Venezia Giulia,1215220,1408363,115.89,0.03
2715,2021-07-22,FVG,7719,4105,3614,3269,4147,303,ITH,ITH4,6,Friuli-Venezia Giulia,Friuli Venezia Giulia,1215220,1416082,116.53,0.64
2716,2021-01-20,FVG,754,322,432,18,736,0,ITH,ITH4,6,Friuli-Venezia Giulia,Friuli Venezia Giulia,1215220,1416836,116.59,0.06
2717,2021-02-22,FVG,2494,1199,1295,2070,419,5,ITH,ITH4,6,Friuli-Venezia Giulia,Friuli Venezia Giulia,1215220,1419330,116.8,0.21
2718,2021-06-02,FVG,9429,4963,4466,8819,282,328,ITH,ITH4,6,Friuli-Venezia Giulia,Friuli Venezia Giulia,1215220,1428759,117.57,0.78
2719,2021-08-09,FVG,7830,4189,3641,2362,5282,186,ITH,ITH4,6,Friuli-Venezia Giulia,Friuli Venezia Giulia,1215220,1436589,118.22,0.64
2720,2021-02-07,FVG,1567,482,1085,384,1182,1,ITH,ITH4,6,Friuli-Venezia Giulia,Friuli Venezia Giulia,1215220,1438156,118.35,0.13
2721,2021-08-26,FVG,7458,4035,3423,1401,5823,234,ITH,ITH4,6,Friuli-Venezia Giulia,Friuli Venezia Giulia,1215220,1445614,118.96,0.61
2722,2021-05-18,FVG,10865,5433,5432,8403,2100,362,ITH,ITH4,6,Friuli-Venezia Giulia,Friuli Venezia Giulia,1215220,1456479,119.85,0.89
2723,2021-06-01,FVG,10145,5131,5014,7703,2128,314,ITH,ITH4,6,Friuli-Venezia Giulia,Friuli Venezia Giulia,1215220,1466624,120.69,0.83
2724,2021-06-20,FVG,6526,3239,3287,1493,4940,93,ITH,ITH4,6,Friuli-Venezia Giulia,Friuli Venezia Giulia,1215220,1473150,121.22,0.54
2725,2021-03-29,FVG,7038,3134,3904,5375,1589,74,ITH,ITH4,6,Friuli-Venezia Giulia,Friuli Venezia Giulia,1215220,1480188,121.8,0.58
2726,2021-07-07,FVG,11325,5799,5526,1451,9748,126,ITH,ITH4,6,Friuli-Venezia Giulia,Friuli Venezia Giulia,1215220,1491513,122.74,0.93
2727,2021-07-21,FVG,8653,4383,4270,2044,6347,262,ITH,ITH4,6,Friuli-Venezia Giulia,Friuli Venezia Giulia,1215220,1500166,123.45,0.71
2728,2021-05-15,FVG,12694,6120,6574,7688,4705,301,ITH,ITH4,6,Friuli-Venezia Giulia,Friuli Venezia Giulia,1215220,1512860,124.49,1.04
2729,2021-05-01,FVG,7215,3252,3963,5911,1046,258,ITH,ITH4,6,Friuli-Venezia Giulia,Friuli Venezia Giulia,1215220,1520075,125.09,0.59
2730,2021-01-21,FVG,899,347,552,3,896,0,ITH,ITH4,6,Friuli-Venezia Giulia,Friuli Venezia Giulia,1215220,1520974,125.16,0.07
2731,2021-02-21,FVG,802,281,521,421,379,2,ITH,ITH4,6,Friuli-Venezia Giulia,Friuli Venezia Giulia,1215220,1521776,125.23,0.07
2732,2021-07-04,FVG,9358,4797,4561,2893,6210,255,ITH,ITH4,6,Friuli-Venezia Giulia,Friuli Venezia Giulia,1215220,1531134,126.0,0.77
2733,2021-03-26,FVG,6059,2632,3427,3855,2029,175,ITH,ITH4,6,Friuli-Venezia Giulia,Friuli Venezia Giulia,1215220,1537193,126.5,0.5
2734,2021-03-12,FVG,4162,1735,2427,2751,1385,26,ITH,ITH4,6,Friuli-Venezia Giulia,Friuli Venezia Giulia,1215220,1541355,126.84,0.34
2735,2021-01-02,FVG,1217,470,747,1217,0,0,ITH,ITH4,6,Friuli-Venezia Giulia,Friuli Venezia Giulia,1215220,1542572,126.94,0.1
2736,2021-04-12,FVG,7288,3196,4092,5998,1136,154,ITH,ITH4,6,Friuli-Venezia Giulia,Friuli Venezia Giulia,1215220,1549860,127.54,0.6
2737,2021-07-15,PIE,42602,22012,20590,4103,38041,458,ITC,ITC1,1,Piemonte,Piemonte,4356406,42602,0.98,0.98
2738,2021-08-01,PIE,27230,14427,12803,8475,18286,469,ITC,ITC1,1,Piemonte,Piemonte,4356406,69832,1.6,0.63
2739,2021-04-23,PIE,27464,12611,14853,19988,6765,711,ITC,ITC1,1,Piemonte,Piemonte,4356406,97296,2.23,0.63
2740,2021-02-11,PIE,6772,2109,4663,2987,3766,19,ITC,ITC1,1,Piemonte,Piemonte,4356406,104068,2.39,0.16
2741,2021-04-09,PIE,25918,11411,14507,20834,4507,577,ITC,ITC1,1,Piemonte,Piemonte,4356406,129986,2.98,0.59
2742,2020-12-30,PIE,735,323,412,735,0,0,ITC,ITC1,1,Piemonte,Piemonte,4356406,130721,3.0,0.02
2743,2021-06-05,PIE,37003,18944,18059,31897,4461,645,ITC,ITC1,1,Piemonte,Piemonte,4356406,167724,3.85,0.85
2744,2021-02-25,PIE,12280,5299,6981,11546,547,187,ITC,ITC1,1,Piemonte,Piemonte,4356406,180004,4.13,0.28
2745,2021-03-23,PIE,13213,5575,7638,6644,6250,319,ITC,ITC1,1,Piemonte,Piemonte,4356406,193217,4.44,0.3
2746,2021-01-16,PIE,7776,2626,5150,7769,0,7,ITC,ITC1,1,Piemonte,Piemonte,4356406,200993,4.61,0.18
2747,2021-08-15,PIE,6570,3626,2944,5029,1268,273,ITC,ITC1,1,Piemonte,Piemonte,4356406,207563,4.76,0.15
2748,2021-09-01,PIE,18568,9589,8979,6702,11184,682,ITC,ITC1,1,Piemonte,Piemonte,4356406,226131,5.19,0.43
2749,2021-05-24,PIE,29020,13438,15582,16648,11984,388,ITC,ITC1,1,Piemonte,Piemonte,4356406,255151,5.86,0.67
2750,2021-03-02,PIE,11335,4616,6719,10328,815,192,ITC,ITC1,1,Piemonte,Piemonte,4356406,266486,6.12,0.26
2751,2021-06-19,PIE,40127,20350,19777,22892,16679,556,ITC,ITC1,1,Piemonte,Piemonte,4356406,306613,7.04,0.92
2752,2021-02-04,PIE,10231,3352,6879,582,9647,2,ITC,ITC1,1,Piemonte,Piemonte,4356406,316844,7.27,0.23
2753,2021-07-06,PIE,38325,19399,18926,8648,29125,552,ITC,ITC1,1,Piemonte,Piemonte,4356406,355169,8.15,0.88
2754,2021-03-28,PIE,16085,6904,9181,8122,7624,339,ITC,ITC1,1,Piemonte,Piemonte,4356406,371254,8.52,0.37
2755,2021-07-20,PIE,39098,20573,18525,5753,32777,568,ITC,ITC1,1,Piemonte,Piemonte,4356406,410352,9.42,0.9
2756,2021-04-11,PIE,20850,9325,11525,18231,2151,468,ITC,ITC1,1,Piemonte,Piemonte,4356406,431202,9.9,0.48
2757,2021-01-04,PIE,5581,1688,3893,5580,0,1,ITC,ITC1,1,Piemonte,Piemonte,4356406,436783,10.03,0.13
2758,2021-04-28,PIE,26090,11760,14330,15480,10058,552,ITC,ITC1,1,Piemonte,Piemonte,4356406,462873,10.63,0.6
2759,2021-08-27,PIE,17335,9252,8083,7461,9227,647,ITC,ITC1,1,Piemonte,Piemonte,4356406,480208,11.02,0.4
2760,2021-05-19,PIE,33193,15333,17860,21458,11140,595,ITC,ITC1,1,Piemonte,Piemonte,4356406,513401,11.78,0.76
2761,2021-03-14,PIE,8216,3340,4876,5175,2900,141,ITC,ITC1,1,Piemonte,Piemonte,4356406,521617,11.97,0.19
2762,2021-05-10,PIE,29078,14032,15046,15309,13137,632,ITC,ITC1,1,Piemonte,Piemonte,4356406,550695,12.64,0.67
2763,2021-01-30,PIE,5997,2143,3854,218,5778,1,ITC,ITC1,1,Piemonte,Piemonte,4356406,556692,12.78,0.14
2764,2021-06-24,PIE,39287,19719,19568,18341,20343,603,ITC,ITC1,1,Piemonte,Piemonte,4356406,595979,13.68,0.9
2765,2021-03-16,PIE,10534,4280,6254,4371,6069,94,ITC,ITC1,1,Piemonte,Piemonte,4356406,606513,13.92,0.24
2766,2021-08-20,PIE,16540,8881,7659,10313,5533,694,ITC,ITC1,1,Piemonte,Piemonte,4356406,623053,14.3,0.38
2767,2021-05-12,PIE,31953,15208,16745,18380,12945,628,ITC,ITC1,1,Piemonte,Piemonte,4356406,655006,15.04,0.73
2768,2021-06-07,PIE,34961,17883,17078,29534,4807,620,ITC,ITC1,1,Piemonte,Piemonte,4356406,689967,15.84,0.8
2769,2021-08-03,PIE,30168,15783,14385,9315,20387,466,ITC,ITC1,1,Piemonte,Piemonte,4356406,720135,16.53,0.69
2770,2021-04-02,PIE,20175,8330,11845,11337,8433,405,ITC,ITC1,1,Piemonte,Piemonte,4356406,740310,16.99,0.46
2771,2021-05-29,PIE,32849,15246,17603,20299,12189,361,ITC,ITC1,1,Piemonte,Piemonte,4356406,773159,17.75,0.75
2772,2021-02-18,PIE,4810,2109,2701,4293,429,88,ITC,ITC1,1,Piemonte,Piemonte,4356406,777969,17.86,0.11
2773,2021-07-25,PIE,28694,15223,13471,6595,21604,495,ITC,ITC1,1,Piemonte,Piemonte,4356406,806663,18.52,0.66
2774,2021-04-16,PIE,28467,13233,15234,22688,5013,766,ITC,ITC1,1,Piemonte,Piemonte,4356406,835130,19.17,0.65
2775,2021-06-26,PIE,41279,21005,20274,21970,18595,714,ITC,ITC1,1,Piemonte,Piemonte,4356406,876409,20.12,0.95
2776,2021-07-13,PIE,38894,20065,18829,3672,34887,335,ITC,ITC1,1,Piemonte,Piemonte,4356406,915303,21.01,0.89
2777,2021-04-04,PIE,9264,4059,5205,6397,2712,155,ITC,ITC1,1,Piemonte,Piemonte,4356406,924567,21.22,0.21
2778,2021-04-21,PIE,25797,11853,13944,19771,5357,669,ITC,ITC1,1,Piemonte,Piemonte,4356406,950364,21.82,0.59
2779,2021-01-11,PIE,8770,2991,5779,8764,0,6,ITC,ITC1,1,Piemonte,Piemonte,4356406,959134,22.02,0.2
2780,2021-01-18,PIE,6178,2051,4127,5923,251,4,ITC,ITC1,1,Piemonte,Piemonte,4356406,965312,22.16,0.14
2781,2021-05-17,PIE,31000,14635,16365,17381,13206,413,ITC,ITC1,1,Piemonte,Piemonte,4356406,996312,22.87,0.71
2782,2021-02-06,PIE,8005,2666,5339,396,7607,2,ITC,ITC1,1,Piemonte,Piemonte,4356406,1004317,23.05,0.18
2783,2021-02-23,PIE,9263,3729,5534,8501,587,175,ITC,ITC1,1,Piemonte,Piemonte,4356406,1013580,23.27,0.21
2784,2021-05-31,PIE,29156,14077,15079,20158,8587,411,ITC,ITC1,1,Piemonte,Piemonte,4356406,1042736,23.94,0.67
2785,2021-06-17,PIE,41198,20681,20517,24215,16359,624,ITC,ITC1,1,Piemonte,Piemonte,4356406,1083934,24.88,0.95
2786,2021-09-03,PIE,16384,8693,7691,5594,10233,557,ITC,ITC1,1,Piemonte,Piemonte,4356406,1100318,25.26,0.38
2787,2021-06-12,PIE,42688,22502,20186,39259,2629,800,ITC,ITC1,1,Piemonte,Piemonte,4356406,1143006,26.24,0.98
2788,2021-07-08,PIE,41024,20981,20043,7455,32997,572,ITC,ITC1,1,Piemonte,Piemonte,4356406,1184030,27.18,0.94
2789,2021-01-23,PIE,4263,1327,2936,878,3383,2,ITC,ITC1,1,Piemonte,Piemonte,4356406,1188293,27.28,0.1
2790,2021-03-21,PIE,10739,4744,5995,4028,6538,173,ITC,ITC1,1,Piemonte,Piemonte,4356406,1199032,27.52,0.25
2791,2021-08-13,PIE,19966,10645,9321,12048,7228,690,ITC,ITC1,1,Piemonte,Piemonte,4356406,1218998,27.98,0.46
2792,2021-05-05,PIE,34703,16255,18448,20336,13670,697,ITC,ITC1,1,Piemonte,Piemonte,4356406,1253701,28.78,0.8
2793,2021-07-01,PIE,41983,21011,20972,19812,21143,1028,ITC,ITC1,1,Piemonte,Piemonte,4356406,1295684,29.74,0.96
2794,2021-08-08,PIE,20261,10824,9437,8996,10926,339,ITC,ITC1,1,Piemonte,Piemonte,4356406,1315945,30.21,0.47
2795,2021-04-30,PIE,31987,14388,17599,17950,13346,691,ITC,ITC1,1,Piemonte,Piemonte,4356406,1347932,30.94,0.73
2796,2021-08-22,PIE,9596,5240,4356,5128,4098,370,ITC,ITC1,1,Piemonte,Piemonte,4356406,1357528,31.16,0.22
2797,2021-02-08,PIE,6925,2355,4570,661,6259,5,ITC,ITC1,1,Piemonte,Piemonte,4356406,1364453,31.32,0.16
2798,2020-12-28,PIE,1,1,0,1,0,0,ITC,ITC1,1,Piemonte,Piemonte,4356406,1364454,31.32,0.0
2799,2021-07-27,PIE,33786,17640,16146,8243,24982,561,ITC,ITC1,1,Piemonte,Piemonte,4356406,1398240,32.1,0.78
2800,2021-05-02,PIE,25159,11291,13868,14012,10751,396,ITC,ITC1,1,Piemonte,Piemonte,4356406,1423399,32.67,0.58
2801,2021-01-13,PIE,10090,3230,6860,10081,0,9,ITC,ITC1,1,Piemonte,Piemonte,4356406,1433489,32.91,0.23
2802,2021-06-16,PIE,40449,20266,20183,23547,16270,632,ITC,ITC1,1,Piemonte,Piemonte,4356406,1473938,33.83,0.93
2803,2021-08-12,PIE,22026,11819,10207,13466,7820,740,ITC,ITC1,1,Piemonte,Piemonte,4356406,1495964,34.34,0.51
2804,2021-06-28,PIE,38481,19109,19372,15134,22750,597,ITC,ITC1,1,Piemonte,Piemonte,4356406,1534445,35.22,0.88
2805,2021-04-06,PIE,20753,9049,11704,15090,5209,454,ITC,ITC1,1,Piemonte,Piemonte,4356406,1555198,35.7,0.48
2806,2020-12-27,PIE,914,370,544,914,0,0,ITC,ITC1,1,Piemonte,Piemonte,4356406,1556112,35.72,0.02
2807,2021-03-09,PIE,14331,5735,8596,11743,2353,235,ITC,ITC1,1,Piemonte,Piemonte,4356406,1570443,36.05,0.33
2808,2021-08-24,PIE,15208,8117,7091,7852,6724,632,ITC,ITC1,1,Piemonte,Piemonte,4356406,1585651,36.4,0.35
2809,2021-01-01,PIE,1041,396,645,1040,0,1,ITC,ITC1,1,Piemonte,Piemonte,4356406,1586692,36.42,0.02
2810,2021-07-12,PIE,39224,20230,18994,4562,34190,472,ITC,ITC1,1,Piemonte,Piemonte,4356406,1625916,37.32,0.9
2811,2021-07-29,PIE,36661,19057,17604,9351,26658,652,ITC,ITC1,1,Piemonte,Piemonte,4356406,1662577,38.16,0.84
2812,2021-04-20,PIE,25532,11688,13844,18544,6357,631,ITC,ITC1,1,Piemonte,Piemonte,4356406,1688109,38.75,0.59
2813,2021-05-07,PIE,33142,15680,17462,18371,14153,618,ITC,ITC1,1,Piemonte,Piemonte,4356406,1721251,39.51,0.76
2814,2021-01-27,PIE,4203,1453,2750,994,3207,2,ITC,ITC1,1,Piemonte,Piemonte,4356406,1725454,39.61,0.1
2815,2021-02-13,PIE,4166,1342,2824,2926,1224,16,ITC,ITC1,1,Piemonte,Piemonte,4356406,1729620,39.7,0.1
2816,2021-07-31,PIE,35721,18988,16733,10730,24626,365,ITC,ITC1,1,Piemonte,Piemonte,4356406,1765341,40.52,0.82
2817,2021-08-17,PIE,18039,9676,8363,11676,5594,769,ITC,ITC1,1,Piemonte,Piemonte,4356406,1783380,40.94,0.41
2818,2021-05-09,PIE,27169,12938,14231,13156,13623,390,ITC,ITC1,1,Piemonte,Piemonte,4356406,1810549,41.56,0.62
2819,2021-07-03,PIE,40133,20144,19989,15347,24046,740,ITC,ITC1,1,Piemonte,Piemonte,4356406,1850682,42.48,0.92
2820,2021-08-29,PIE,15111,8107,7004,5030,9661,420,ITC,ITC1,1,Piemonte,Piemonte,4356406,1865793,42.83,0.35
2821,2021-05-21,PIE,36241,16834,19407,20057,15664,520,ITC,ITC1,1,Piemonte,Piemonte,4356406,1902034,43.66,0.83
2822,2021-07-17,PIE,42025,22118,19907,4950,36582,493,ITC,ITC1,1,Piemonte,Piemonte,4356406,1944059,44.63,0.96
2823,2021-02-01,PIE,8690,3068,5622,579,8110,1,ITC,ITC1,1,Piemonte,Piemonte,4356406,1952749,44.82,0.2
2824,2021-05-14,PIE,33479,16306,17173,17357,15448,674,ITC,ITC1,1,Piemonte,Piemonte,4356406,1986228,45.59,0.77
2825,2021-07-05,PIE,35623,17823,17800,11697,23238,688,ITC,ITC1,1,Piemonte,Piemonte,4356406,2021851,46.41,0.82
2826,2021-02-20,PIE,3845,1262,2583,3570,174,101,ITC,ITC1,1,Piemonte,Piemonte,4356406,2025696,46.5,0.09
2827,2021-07-24,PIE,34858,18337,16521,7898,26361,599,ITC,ITC1,1,Piemonte,Piemonte,4356406,2060554,47.3,0.8
2828,2021-08-07,PIE,29747,15920,13827,12640,16643,464,ITC,ITC1,1,Piemonte,Piemonte,4356406,2090301,47.98,0.68
2829,2021-02-27,PIE,12708,4853,7855,12134,337,237,ITC,ITC1,1,Piemonte,Piemonte,4356406,2103009,48.27,0.29
2830,2021-04-25,PIE,20257,9319,10938,17291,2503,463,ITC,ITC1,1,Piemonte,Piemonte,4356406,2123266,48.74,0.46
2831,2021-01-15,PIE,9121,3011,6110,9115,0,6,ITC,ITC1,1,Piemonte,Piemonte,4356406,2132387,48.95,0.21
2832,2021-06-21,PIE,38509,19255,19254,17162,20780,567,ITC,ITC1,1,Piemonte,Piemonte,4356406,2170896,49.83,0.88
2833,2021-03-13,PIE,13047,4725,8322,11342,1432,273,ITC,ITC1,1,Piemonte,Piemonte,4356406,2183943,50.13,0.3
2834,2021-07-26,PIE,32807,17073,15734,8293,23882,632,ITC,ITC1,1,Piemonte,Piemonte,4356406,2216750,50.88,0.75
2835,2021-04-17,PIE,30504,14166,16338,26475,3311,718,ITC,ITC1,1,Piemonte,Piemonte,4356406,2247254,51.59,0.7
2836,2021-06-13,PIE,38061,20088,17973,33157,4134,770,ITC,ITC1,1,Piemonte,Piemonte,4356406,2285315,52.46,0.87
2837,2021-02-10,PIE,7555,2377,5178,1302,6238,15,ITC,ITC1,1,Piemonte,Piemonte,4356406,2292870,52.63,0.17
2838,2021-04-08,PIE,25347,11034,14313,20053,4728,566,ITC,ITC1,1,Piemonte,Piemonte,4356406,2318217,53.21,0.58
2839,2021-05-26,PIE,34211,15769,18442,15343,18509,359,ITC,ITC1,1,Piemonte,Piemonte,4356406,2352428,54.0,0.79
2840,2021-02-15,PIE,4440,1602,2838,3211,1206,23,ITC,ITC1,1,Piemonte,Piemonte,4356406,2356868,54.1,0.1
2841,2021-03-04,PIE,14738,5937,8801,11567,2947,224,ITC,ITC1,1,Piemonte,Piemonte,4356406,2371606,54.44,0.34
2842,2021-08-31,PIE,18966,10008,8958,6801,11619,546,ITC,ITC1,1,Piemonte,Piemonte,4356406,2390572,54.87,0.44
2843,2021-06-09,PIE,38707,20389,18318,35169,2745,793,ITC,ITC1,1,Piemonte,Piemonte,4356406,2429279,55.76,0.89
2844,2021-03-18,PIE,11778,4814,6964,3839,7746,193,ITC,ITC1,1,Piemonte,Piemonte,4356406,2441057,56.03,0.27
2845,2021-03-03,PIE,12384,4867,7517,11370,820,194,ITC,ITC1,1,Piemonte,Piemonte,4356406,2453441,56.32,0.28
2846,2021-03-20,PIE,11931,4900,7031,5779,5900,252,ITC,ITC1,1,Piemonte,Piemonte,4356406,2465372,56.59,0.27
2847,2021-08-14,PIE,15086,8124,6962,9773,4757,556,ITC,ITC1,1,Piemonte,Piemonte,4356406,2480458,56.94,0.35
2848,2021-05-06,PIE,33458,15799,17659,19300,13553,605,ITC,ITC1,1,Piemonte,Piemonte,4356406,2513916,57.71,0.77
2849,2021-05-23,PIE,28816,13167,15649,15486,13013,317,ITC,ITC1,1,Piemonte,Piemonte,4356406,2542732,58.37,0.66
2850,2021-01-06,PIE,3118,1106,2012,3117,0,1,ITC,ITC1,1,Piemonte,Piemonte,4356406,2545850,58.44,0.07
2851,2021-08-05,PIE,30316,16084,14232,11226,18551,539,ITC,ITC1,1,Piemonte,Piemonte,4356406,2576166,59.14,0.7
2852,2021-06-23,PIE,39798,19770,20028,16412,22881,505,ITC,ITC1,1,Piemonte,Piemonte,4356406,2615964,60.05,0.91
2853,2021-08-19,PIE,15861,8537,7324,10548,4594,719,ITC,ITC1,1,Piemonte,Piemonte,4356406,2631825,60.41,0.36
2854,2021-03-30,PIE,17005,7122,9883,8733,7875,397,ITC,ITC1,1,Piemonte,Piemonte,4356406,2648830,60.8,0.39
2855,2021-07-10,PIE,41205,20879,20326,6727,33938,540,ITC,ITC1,1,Piemonte,Piemonte,4356406,2690035,61.75,0.95
2856,2021-04-01,PIE,19428,8144,11284,10968,8137,323,ITC,ITC1,1,Piemonte,Piemonte,4356406,2709463,62.19,0.45
2857,2021-05-28,PIE,35114,16630,18484,18682,16020,412,ITC,ITC1,1,Piemonte,Piemonte,4356406,2744577,63.0,0.81
2858,2021-01-25,PIE,6229,1946,4283,975,5252,2,ITC,ITC1,1,Piemonte,Piemonte,4356406,2750806,63.14,0.14
2859,2021-04-18,PIE,22963,10815,12148,19631,2754,578,ITC,ITC1,1,Piemonte,Piemonte,4356406,2773769,63.67,0.53
2860,2021-01-08,PIE,5542,1764,3778,5540,0,2,ITC,ITC1,1,Piemonte,Piemonte,4356406,2779311,63.8,0.13
2861,2021-06-14,PIE,38065,19605,18460,30257,7098,710,ITC,ITC1,1,Piemonte,Piemonte,4356406,2817376,64.67,0.87
2862,2021-03-06,PIE,14031,5230,8801,11056,2795,180,ITC,ITC1,1,Piemonte,Piemonte,4356406,2831407,64.99,0.32
2863,2021-08-10,PIE,22023,11666,10357,12493,8889,641,ITC,ITC1,1,Piemonte,Piemonte,4356406,2853430,65.5,0.51
2864,2021-01-22,PIE,3878,1255,2623,2532,1345,1,ITC,ITC1,1,Piemonte,Piemonte,4356406,2857308,65.59,0.09
2865,2021-08-21,PIE,13291,7106,6185,7696,5083,512,ITC,ITC1,1,Piemonte,Piemonte,4356406,2870599,65.89,0.31
2866,2021-02-12,PIE,6912,2225,4687,3920,2967,25,ITC,ITC1,1,Piemonte,Piemonte,4356406,2877511,66.05,0.16
2867,2021-03-01,PIE,12180,4966,7214,11190,810,180,ITC,ITC1,1,Piemonte,Piemonte,4356406,2889691,66.33,0.28
2868,2021-09-02,PIE,16795,8760,8035,6122,10036,637,ITC,ITC1,1,Piemonte,Piemonte,4356406,2906486,66.72,0.39
2869,2021-05-25,PIE,31924,14794,17130,15634,15896,394,ITC,ITC1,1,Piemonte,Piemonte,4356406,2938410,67.45,0.73
2870,2021-06-11,PIE,43652,23099,20553,39993,2842,817,ITC,ITC1,1,Piemonte,Piemonte,4356406,2982062,68.45,1.0
2871,2021-04-29,PIE,48570,22010,26560,34715,12648,1207,ITC,ITC1,1,Piemonte,Piemonte,4356406,3030632,69.57,1.11
2872,2021-05-16,PIE,28222,12806,15416,14756,13089,377,ITC,ITC1,1,Piemonte,Piemonte,4356406,3058854,70.22,0.65
2873,2021-02-05,PIE,9625,3143,6482,655,8968,2,ITC,ITC1,1,Piemonte,Piemonte,4356406,3068479,70.44,0.22
2874,2021-06-25,PIE,45584,22713,22871,20286,24578,720,ITC,ITC1,1,Piemonte,Piemonte,4356406,3114063,71.48,1.05
2875,2021-04-03,PIE,19491,8202,11289,10603,8574,314,ITC,ITC1,1,Piemonte,Piemonte,4356406,3133554,71.93,0.45
2876,2021-01-10,PIE,5233,2284,2949,5231,0,2,ITC,ITC1,1,Piemonte,Piemonte,4356406,3138787,72.05,0.12
2877,2021-07-14,PIE,39047,20080,18967,3593,35026,428,ITC,ITC1,1,Piemonte,Piemonte,4356406,3177834,72.95,0.9
2878,2021-04-22,PIE,27691,12754,14937,20203,6695,793,ITC,ITC1,1,Piemonte,Piemonte,4356406,3205525,73.58,0.64
2879,2021-01-12,PIE,10096,3419,6677,10090,0,6,ITC,ITC1,1,Piemonte,Piemonte,4356406,3215621,73.81,0.23
2880,2021-07-19,PIE,39633,20622,19011,4490,34725,418,ITC,ITC1,1,Piemonte,Piemonte,4356406,3255254,74.72,0.91
2881,2021-04-10,PIE,30196,13425,16771,25271,4268,657,ITC,ITC1,1,Piemonte,Piemonte,4356406,3285450,75.42,0.69
2882,2021-04-15,PIE,29632,13577,16055,23413,5530,689,ITC,ITC1,1,Piemonte,Piemonte,4356406,3315082,76.1,0.68
2883,2021-01-05,PIE,5398,1610,3788,5391,0,7,ITC,ITC1,1,Piemonte,Piemonte,4356406,3320480,76.22,0.12
2884,2021-06-22,PIE,40686,20118,20568,17794,22331,561,ITC,ITC1,1,Piemonte,Piemonte,4356406,3361166,77.15,0.93
2885,2021-01-07,PIE,5395,1735,3660,5393,0,2,ITC,ITC1,1,Piemonte,Piemonte,4356406,3366561,77.28,0.12
2886,2021-03-05,PIE,15658,6302,9356,11543,3835,280,ITC,ITC1,1,Piemonte,Piemonte,4356406,3382219,77.64,0.36
2887,2021-07-28,PIE,34803,18085,16718,9156,25043,604,ITC,ITC1,1,Piemonte,Piemonte,4356406,3417022,78.44,0.8
2888,2021-06-15,PIE,39015,20090,18925,26536,11788,691,ITC,ITC1,1,Piemonte,Piemonte,4356406,3456037,79.33,0.9
2889,2021-03-07,PIE,12001,4672,7329,10870,877,254,ITC,ITC1,1,Piemonte,Piemonte,4356406,3468038,79.61,0.28
2890,2021-03-08,PIE,14306,5605,8701,11346,2717,243,ITC,ITC1,1,Piemonte,Piemonte,4356406,3482344,79.94,0.33
2891,2021-05-04,PIE,31585,14597,16988,17299,13694,592,ITC,ITC1,1,Piemonte,Piemonte,4356406,3513929,80.66,0.73
2892,2021-01-24,PIE,3160,964,2196,434,2724,2,ITC,ITC1,1,Piemonte,Piemonte,4356406,3517089,80.73,0.07
2893,2021-06-30,PIE,41326,20203,21123,18477,21970,879,ITC,ITC1,1,Piemonte,Piemonte,4356406,3558415,81.68,0.95
2894,2021-03-22,PIE,11541,4898,6643,3716,7608,217,ITC,ITC1,1,Piemonte,Piemonte,4356406,3569956,81.95,0.26
2895,2021-04-27,PIE,22655,10235,12420,16840,5160,655,ITC,ITC1,1,Piemonte,Piemonte,4356406,3592611,82.47,0.52
2896,2021-01-17,PIE,3527,1169,2358,2876,649,2,ITC,ITC1,1,Piemonte,Piemonte,4356406,3596138,82.55,0.08
2897,2021-03-15,PIE,10701,4199,6502,4934,5611,156,ITC,ITC1,1,Piemonte,Piemonte,4356406,3606839,82.79,0.25
2898,2021-05-11,PIE,32256,15551,16705,18366,13253,637,ITC,ITC1,1,Piemonte,Piemonte,4356406,3639095,83.53,0.74
2899,2021-01-31,PIE,4145,1765,2380,115,4030,0,ITC,ITC1,1,Piemonte,Piemonte,4356406,3643240,83.63,0.1
2900,2021-06-18,PIE,40693,20350,20343,25775,14233,685,ITC,ITC1,1,Piemonte,Piemonte,4356406,3683933,84.56,0.93
2901,2021-03-10,PIE,13945,5449,8496,11385,2294,266,ITC,ITC1,1,Piemonte,Piemonte,4356406,3697878,84.88,0.32
2902,2021-03-27,PIE,18416,7835,10581,9133,8833,450,ITC,ITC1,1,Piemonte,Piemonte,4356406,3716294,85.31,0.42
2903,2021-08-18,PIE,18064,9754,8310,11577,5753,734,ITC,ITC1,1,Piemonte,Piemonte,4356406,3734358,85.72,0.41
2904,2021-04-19,PIE,22577,10778,11799,17656,4357,564,ITC,ITC1,1,Piemonte,Piemonte,4356406,3756935,86.24,0.52
2905,2021-01-09,PIE,6193,2191,4002,6191,0,2,ITC,ITC1,1,Piemonte,Piemonte,4356406,3763128,86.38,0.14
2906,2021-01-26,PIE,6359,1894,4465,736,5622,1,ITC,ITC1,1,Piemonte,Piemonte,4356406,3769487,86.53,0.15
2907,2021-07-30,PIE,35794,18687,17107,9548,25754,492,ITC,ITC1,1,Piemonte,Piemonte,4356406,3805281,87.35,0.82
2908,2021-08-16,PIE,19215,10205,9010,11572,6809,834,ITC,ITC1,1,Piemonte,Piemonte,4356406,3824496,87.79,0.44
2909,2021-05-08,PIE,34334,16285,18049,18149,15660,525,ITC,ITC1,1,Piemonte,Piemonte,4356406,3858830,88.58,0.79
2910,2021-01-28,PIE,5608,1811,3797,380,5228,0,ITC,ITC1,1,Piemonte,Piemonte,4356406,3864438,88.71,0.13
2911,2021-02-14,PIE,1482,501,981,871,604,7,ITC,ITC1,1,Piemonte,Piemonte,4356406,3865920,88.74,0.03
2912,2021-05-30,PIE,27816,13225,14591,18043,9396,377,ITC,ITC1,1,Piemonte,Piemonte,4356406,3893736,89.38,0.64
2913,2021-02-19,PIE,5549,2181,3368,4926,501,122,ITC,ITC1,1,Piemonte,Piemonte,4356406,3899285,89.51,0.13
2914,2021-06-04,PIE,37669,19695,17974,34082,2966,621,ITC,ITC1,1,Piemonte,Piemonte,4356406,3936954,90.37,0.86
2915,2021-02-24,PIE,11402,4614,6788,10746,505,151,ITC,ITC1,1,Piemonte,Piemonte,4356406,3948356,90.63,0.26
2916,2021-07-18,PIE,32923,17266,15657,3247,29341,335,ITC,ITC1,1,Piemonte,Piemonte,4356406,3981279,91.39,0.76
2917,2021-02-07,PIE,3094,973,2121,442,2651,1,ITC,ITC1,1,Piemonte,Piemonte,4356406,3984373,91.46,0.07
2918,2021-07-11,PIE,33211,16927,16284,4528,28362,321,ITC,ITC1,1,Piemonte,Piemonte,4356406,4017584,92.22,0.76
2919,2021-08-30,PIE,20826,10863,9963,7211,12954,661,ITC,ITC1,1,Piemonte,Piemonte,4356406,4038410,92.7,0.48
2920,2021-05-22,PIE,33568,15159,18409,16917,16239,412,ITC,ITC1,1,Piemonte,Piemonte,4356406,4071978,93.47,0.77
2921,2021-06-06,PIE,35155,18362,16793,32111,2491,553,ITC,ITC1,1,Piemonte,Piemonte,4356406,4107133,94.28,0.81
2922,2021-08-02,PIE,29942,15809,14133,9373,20058,511,ITC,ITC1,1,Piemonte,Piemonte,4356406,4137075,94.97,0.69
2923,2021-02-17,PIE,4810,2167,2643,3758,990,62,ITC,ITC1,1,Piemonte,Piemonte,4356406,4141885,95.08,0.11
2924,2021-06-08,PIE,37745,19529,18216,34174,2856,715,ITC,ITC1,1,Piemonte,Piemonte,4356406,4179630,95.94,0.87
2925,2021-08-04,PIE,29295,15487,13808,8950,19848,497,ITC,ITC1,1,Piemonte,Piemonte,4356406,4208925,96.61,0.67
2926,2021-04-26,PIE,19836,8765,11071,14922,4400,514,ITC,ITC1,1,Piemonte,Piemonte,4356406,4228761,97.07,0.46
2927,2020-12-31,PIE,3891,1326,2565,3891,0,0,ITC,ITC1,1,Piemonte,Piemonte,4356406,4232652,97.16,0.09
2928,2021-08-11,PIE,23393,12582,10811,13418,9351,624,ITC,ITC1,1,Piemonte,Piemonte,4356406,4256045,97.7,0.54
2929,2021-05-03,PIE,26713,12219,14494,12046,14223,444,ITC,ITC1,1,Piemonte,Piemonte,4356406,4282758,98.31,0.61
2930,2021-02-26,PIE,12310,4939,7371,11358,741,211,ITC,ITC1,1,Piemonte,Piemonte,4356406,4295068,98.59,0.28
2931,2021-04-24,PIE,27544,12451,15093,21314,5664,566,ITC,ITC1,1,Piemonte,Piemonte,4356406,4322612,99.22,0.63
2932,2021-01-14,PIE,9788,3157,6631,9782,0,6,ITC,ITC1,1,Piemonte,Piemonte,4356406,4332400,99.45,0.22
2933,2021-01-19,PIE,6472,2108,4364,6454,9,9,ITC,ITC1,1,Piemonte,Piemonte,4356406,4338872,99.6,0.15
2934,2021-07-23,PIE,38135,20105,18030,8020,29485,630,ITC,ITC1,1,Piemonte,Piemonte,4356406,4377007,100.47,0.88
2935,2021-04-14,PIE,28338,12829,15509,23051,4569,718,ITC,ITC1,1,Piemonte,Piemonte,4356406,4405345,101.12,0.65
2936,2021-08-06,PIE,30453,16109,14344,13294,16506,653,ITC,ITC1,1,Piemonte,Piemonte,4356406,4435798,101.82,0.7
2937,2021-01-29,PIE,5955,1889,4066,452,5503,0,ITC,ITC1,1,Piemonte,Piemonte,4356406,4441753,101.96,0.14
2938,2021-08-25,PIE,16401,8850,7551,8263,7423,715,ITC,ITC1,1,Piemonte,Piemonte,4356406,4458154,102.34,0.38
2939,2021-06-03,PIE,34785,18003,16782,29748,4491,546,ITC,ITC1,1,Piemonte,Piemonte,4356406,4492939,103.13,0.8
2940,2021-07-02,PIE,43812,22038,21774,17370,25580,862,ITC,ITC1,1,Piemonte,Piemonte,4356406,4536751,104.14,1.01
2941,2021-08-28,PIE,17444,9188,8256,7280,9552,612,ITC,ITC1,1,Piemonte,Piemonte,4356406,4554195,104.54,0.4
2942,2021-05-13,PIE,35749,17560,18189,19892,15140,717,ITC,ITC1,1,Piemonte,Piemonte,4356406,4589944,105.36,0.82
2943,2021-02-02,PIE,10274,3517,6757,810,9463,1,ITC,ITC1,1,Piemonte,Piemonte,4356406,4600218,105.6,0.24
2944,2021-07-09,PIE,40471,20652,19819,5757,34181,533,ITC,ITC1,1,Piemonte,Piemonte,4356406,4640689,106.53,0.93
2945,2021-03-31,PIE,19140,8128,11012,10101,8696,343,ITC,ITC1,1,Piemonte,Piemonte,4356406,4659829,106.96,0.44
2946,2021-05-27,PIE,37501,17433,20068,18851,18200,450,ITC,ITC1,1,Piemonte,Piemonte,4356406,4697330,107.83,0.86
2947,2021-02-16,PIE,3985,1765,2220,3172,764,49,ITC,ITC1,1,Piemonte,Piemonte,4356406,4701315,107.92,0.09
2948,2021-03-24,PIE,15603,6409,9194,6102,9139,362,ITC,ITC1,1,Piemonte,Piemonte,4356406,4716918,108.28,0.36
2949,2021-05-20,PIE,38696,17977,20719,13358,24977,361,ITC,ITC1,1,Piemonte,Piemonte,4356406,4755614,109.16,0.89
2950,2021-02-09,PIE,7409,2319,5090,717,6690,2,ITC,ITC1,1,Piemonte,Piemonte,4356406,4763023,109.33,0.17
2951,2021-07-16,PIE,42117,21999,20118,3604,38096,417,ITC,ITC1,1,Piemonte,Piemonte,4356406,4805140,110.3,0.97
2952,2021-04-07,PIE,23651,10011,13640,17650,5462,539,ITC,ITC1,1,Piemonte,Piemonte,4356406,4828791,110.84,0.54
2953,2021-02-28,PIE,10833,4064,6769,10413,241,179,ITC,ITC1,1,Piemonte,Piemonte,4356406,4839624,111.09,0.25
2954,2021-03-17,PIE,12530,5062,7468,5037,7304,189,ITC,ITC1,1,Piemonte,Piemonte,4356406,4852154,111.38,0.29
2955,2021-06-10,PIE,40575,21211,19364,37103,2593,879,ITC,ITC1,1,Piemonte,Piemonte,4356406,4892729,112.31,0.93
2956,2021-06-27,PIE,37579,18621,18958,15208,21769,602,ITC,ITC1,1,Piemonte,Piemonte,4356406,4930308,113.17,0.86
2957,2021-03-19,PIE,11038,4522,6516,4220,6609,209,ITC,ITC1,1,Piemonte,Piemonte,4356406,4941346,113.43,0.25
2958,2021-04-05,PIE,14766,6243,8523,11952,2562,252,ITC,ITC1,1,Piemonte,Piemonte,4356406,4956112,113.77,0.34
2959,2021-06-29,PIE,40626,20290,20336,19221,20703,702,ITC,ITC1,1,Piemonte,Piemonte,4356406,4996738,114.7,0.93
2960,2021-06-02,PIE,26750,13091,13659,21657,4648,445,ITC,ITC1,1,Piemonte,Piemonte,4356406,5023488,115.31,0.61
2961,2021-02-22,PIE,8502,3474,5028,7802,595,105,ITC,ITC1,1,Piemonte,Piemonte,4356406,5031990,115.51,0.2
2962,2021-03-11,PIE,14033,5314,8719,10683,3099,251,ITC,ITC1,1,Piemonte,Piemonte,4356406,5046023,115.83,0.32
2963,2021-03-25,PIE,17157,7279,9878,8077,8637,443,ITC,ITC1,1,Piemonte,Piemonte,4356406,5063180,116.22,0.39
2964,2021-07-22,PIE,41634,21918,19716,7010,34031,593,ITC,ITC1,1,Piemonte,Piemonte,4356406,5104814,117.18,0.96
2965,2021-04-13,PIE,26739,12025,14714,22592,3464,683,ITC,ITC1,1,Piemonte,Piemonte,4356406,5131553,117.79,0.61
2966,2021-01-20,PIE,6619,2087,4532,5896,716,7,ITC,ITC1,1,Piemonte,Piemonte,4356406,5138172,117.95,0.15
2967,2021-02-03,PIE,10218,3311,6907,609,9607,2,ITC,ITC1,1,Piemonte,Piemonte,4356406,5148390,118.18,0.23
2968,2021-08-09,PIE,24713,12895,11818,12025,11993,695,ITC,ITC1,1,Piemonte,Piemonte,4356406,5173103,118.75,0.57
2969,2021-08-26,PIE,16854,9133,7721,8099,8011,744,ITC,ITC1,1,Piemonte,Piemonte,4356406,5189957,119.13,0.39
2970,2021-05-18,PIE,32218,14865,17353,19087,12684,447,ITC,ITC1,1,Piemonte,Piemonte,4356406,5222175,119.87,0.74
2971,2021-01-03,PIE,3067,972,2095,3066,0,1,ITC,ITC1,1,Piemonte,Piemonte,4356406,5225242,119.94,0.07
2972,2021-07-07,PIE,38022,18893,19129,9693,27741,588,ITC,ITC1,1,Piemonte,Piemonte,4356406,5263264,120.82,0.87
2973,2021-03-29,PIE,15268,6483,8785,8391,6615,262,ITC,ITC1,1,Piemonte,Piemonte,4356406,5278532,121.17,0.35
2974,2021-07-21,PIE,38030,20177,17853,6544,30966,520,ITC,ITC1,1,Piemonte,Piemonte,4356406,5316562,122.04,0.87
2975,2021-04-12,PIE,22967,10368,12599,19449,2995,523,ITC,ITC1,1,Piemonte,Piemonte,4356406,5339529,122.57,0.53
2976,2021-01-02,PIE,3550,1133,2417,3549,0,1,ITC,ITC1,1,Piemonte,Piemonte,4356406,5343079,122.65,0.08
2977,2021-05-01,PIE,28576,13009,15567,16323,11801,452,ITC,ITC1,1,Piemonte,Piemonte,4356406,5371655,123.3,0.66
2978,2021-01-21,PIE,6882,2314,4568,3374,3502,6,ITC,ITC1,1,Piemonte,Piemonte,4356406,5378537,123.46,0.16
2979,2021-08-23,PIE,18319,9841,8478,8813,8921,585,ITC,ITC1,1,Piemonte,Piemonte,4356406,5396856,123.88,0.42
2980,2021-05-15,PIE,33822,15767,18055,19411,13742,669,ITC,ITC1,1,Piemonte,Piemonte,4356406,5430678,124.66,0.78
2981,2021-06-01,PIE,29606,14879,14727,24489,4684,433,ITC,ITC1,1,Piemonte,Piemonte,4356406,5460284,125.34,0.68
2982,2021-02-21,PIE,5098,2085,3013,4944,104,50,ITC,ITC1,1,Piemonte,Piemonte,4356406,5465382,125.46,0.12
2983,2021-06-20,PIE,34125,17108,17017,18780,14780,565,ITC,ITC1,1,Piemonte,Piemonte,4356406,5499507,126.24,0.78
2984,2021-03-12,PIE,14226,5410,8816,10989,2945,292,ITC,ITC1,1,Piemonte,Piemonte,4356406,5513733,126.57,0.33
2985,2021-07-04,PIE,33822,17051,16771,11241,21956,625,ITC,ITC1,1,Piemonte,Piemonte,4356406,5547555,127.34,0.78
2986,2021-03-26,PIE,17942,7134,10808,8525,8887,530,ITC,ITC1,1,Piemonte,Piemonte,4356406,5565497,127.75,0.41
2987,2021-08-27,SAR,8386,4495,3891,4910,3335,141,ITG,ITG2,20,Sardegna,Sardegna,1639591,8386,0.51,0.51
2988,2021-05-19,SAR,17079,8681,8398,12632,4278,169,ITG,ITG2,20,Sardegna,Sardegna,1639591,25465,1.55,1.04
2989,2021-06-05,SAR,17888,8441,9447,11285,6468,135,ITG,ITG2,20,Sardegna,Sardegna,1639591,43353,2.64,1.09
2990,2021-02-25,SAR,2938,1274,1664,2295,608,35,ITG,ITG2,20,Sardegna,Sardegna,1639591,46291,2.82,0.18
2991,2021-03-14,SAR,611,379,232,601,1,9,ITG,ITG2,20,Sardegna,Sardegna,1639591,46902,2.86,0.04
2992,2021-03-09,SAR,5558,2750,2808,4755,732,71,ITG,ITG2,20,Sardegna,Sardegna,1639591,52460,3.2,0.34
2993,2021-08-13,SAR,9949,5418,4531,6314,3516,119,ITG,ITG2,20,Sardegna,Sardegna,1639591,62409,3.81,0.61
2994,2021-05-05,SAR,10279,4677,5602,8009,2060,210,ITG,ITG2,20,Sardegna,Sardegna,1639591,72688,4.43,0.63
2995,2021-02-11,SAR,1321,490,831,1207,114,0,ITG,ITG2,20,Sardegna,Sardegna,1639591,74009,4.51,0.08
2996,2021-09-01,SAR,8243,4310,3933,3114,5040,89,ITG,ITG2,20,Sardegna,Sardegna,1639591,82252,5.02,0.5
2997,2021-05-24,SAR,14488,7258,7230,8358,5998,132,ITG,ITG2,20,Sardegna,Sardegna,1639591,96740,5.9,0.88
2998,2021-02-13,SAR,1458,563,895,1452,2,4,ITG,ITG2,20,Sardegna,Sardegna,1639591,98198,5.99,0.09
2999,2021-06-19,SAR,15348,7517,7831,9121,6128,99,ITG,ITG2,20,Sardegna,Sardegna,1639591,113546,6.93,0.94
3000,2021-07-06,SAR,15935,7722,8213,4661,11174,100,ITG,ITG2,20,Sardegna,Sardegna,1639591,129481,7.9,0.97
3001,2021-03-28,SAR,4617,1822,2795,4464,79,74,ITG,ITG2,20,Sardegna,Sardegna,1639591,134098,8.18,0.28
3002,2021-01-04,SAR,608,230,378,608,0,0,ITG,ITG2,20,Sardegna,Sardegna,1639591,134706,8.22,0.04
3003,2021-07-01,SAR,19837,9767,10070,7259,12485,93,ITG,ITG2,20,Sardegna,Sardegna,1639591,154543,9.43,1.21
3004,2021-03-23,SAR,6497,2904,3593,5229,1089,179,ITG,ITG2,20,Sardegna,Sardegna,1639591,161040,9.82,0.4
3005,2021-07-15,SAR,18779,9238,9541,4647,14031,101,ITG,ITG2,20,Sardegna,Sardegna,1639591,179819,10.97,1.15
3006,2021-08-03,SAR,14573,7507,7066,7515,6862,196,ITG,ITG2,20,Sardegna,Sardegna,1639591,194392,11.86,0.89
3007,2021-08-01,SAR,3054,1501,1553,1030,1988,36,ITG,ITG2,20,Sardegna,Sardegna,1639591,197446,12.04,0.19
3008,2021-04-23,SAR,13064,5791,7273,7361,5556,147,ITG,ITG2,20,Sardegna,Sardegna,1639591,210510,12.84,0.8
3009,2021-05-10,SAR,9939,4417,5522,7207,2554,178,ITG,ITG2,20,Sardegna,Sardegna,1639591,220449,13.45,0.61
3010,2021-01-30,SAR,3946,1426,2520,368,3578,0,ITG,ITG2,20,Sardegna,Sardegna,1639591,224395,13.69,0.24
3011,2021-04-09,SAR,12472,5523,6949,7932,4398,142,ITG,ITG2,20,Sardegna,Sardegna,1639591,236867,14.45,0.76
3012,2021-07-20,SAR,16148,7931,8217,3653,12404,91,ITG,ITG2,20,Sardegna,Sardegna,1639591,253015,15.43,0.98
3013,2021-04-11,SAR,5416,2450,2966,4263,1124,29,ITG,ITG2,20,Sardegna,Sardegna,1639591,258431,15.76,0.33
3014,2021-06-07,SAR,12565,6145,6420,9436,3007,122,ITG,ITG2,20,Sardegna,Sardegna,1639591,270996,16.53,0.77
3015,2021-01-16,SAR,1498,530,968,1498,0,0,ITG,ITG2,20,Sardegna,Sardegna,1639591,272494,16.62,0.09
3016,2021-08-15,SAR,19,10,9,9,10,0,ITG,ITG2,20,Sardegna,Sardegna,1639591,272513,16.62,0.0
3017,2021-03-02,SAR,3058,1634,1424,1822,1162,74,ITG,ITG2,20,Sardegna,Sardegna,1639591,275571,16.81,0.19
3018,2021-04-28,SAR,9118,4305,4813,5212,3755,151,ITG,ITG2,20,Sardegna,Sardegna,1639591,284689,17.36,0.56
3019,2021-01-18,SAR,910,328,582,781,129,0,ITG,ITG2,20,Sardegna,Sardegna,1639591,285599,17.42,0.06
3020,2021-06-24,SAR,19201,9214,9987,8113,10984,104,ITG,ITG2,20,Sardegna,Sardegna,1639591,304800,18.59,1.17
3021,2021-03-16,SAR,4445,1967,2478,3471,930,44,ITG,ITG2,20,Sardegna,Sardegna,1639591,309245,18.86,0.27
3022,2021-04-30,SAR,11313,5342,5971,6824,4301,188,ITG,ITG2,20,Sardegna,Sardegna,1639591,320558,19.55,0.69
3023,2021-05-17,SAR,12841,6266,6575,9140,3554,147,ITG,ITG2,20,Sardegna,Sardegna,1639591,333399,20.33,0.78
3024,2021-02-06,SAR,1983,706,1277,566,1414,3,ITG,ITG2,20,Sardegna,Sardegna,1639591,335382,20.46,0.12
3025,2021-02-23,SAR,1577,1050,527,1278,282,17,ITG,ITG2,20,Sardegna,Sardegna,1639591,336959,20.55,0.1
3026,2021-06-12,SAR,14755,7194,7561,9935,4702,118,ITG,ITG2,20,Sardegna,Sardegna,1639591,351714,21.45,0.9
3027,2021-03-04,SAR,4393,2313,2080,3067,1260,66,ITG,ITG2,20,Sardegna,Sardegna,1639591,356107,21.72,0.27
3028,2021-03-21,SAR,4053,1815,2238,2586,1441,26,ITG,ITG2,20,Sardegna,Sardegna,1639591,360160,21.97,0.25
3029,2021-07-08,SAR,18444,8972,9472,3831,14528,85,ITG,ITG2,20,Sardegna,Sardegna,1639591,378604,23.09,1.12
3030,2021-07-25,SAR,4343,2142,2201,862,3466,15,ITG,ITG2,20,Sardegna,Sardegna,1639591,382947,23.36,0.26
3031,2021-04-16,SAR,14602,6529,8073,9004,5420,178,ITG,ITG2,20,Sardegna,Sardegna,1639591,397549,24.25,0.89
3032,2021-01-23,SAR,61,23,38,0,61,0,ITG,ITG2,20,Sardegna,Sardegna,1639591,397610,24.25,0.0
3033,2021-05-29,SAR,18028,8656,9372,13249,4611,168,ITG,ITG2,20,Sardegna,Sardegna,1639591,415638,25.35,1.1
3034,2021-02-18,SAR,1898,738,1160,1794,64,40,ITG,ITG2,20,Sardegna,Sardegna,1639591,417536,25.47,0.12
3035,2021-05-31,SAR,11371,5409,5962,8161,3112,98,ITG,ITG2,20,Sardegna,Sardegna,1639591,428907,26.16,0.69
3036,2021-07-27,SAR,16533,8385,8148,4217,12205,111,ITG,ITG2,20,Sardegna,Sardegna,1639591,445440,27.17,1.01
3037,2021-04-18,SAR,5152,2236,2916,2238,2885,29,ITG,ITG2,20,Sardegna,Sardegna,1639591,450592,27.48,0.31
3038,2021-01-08,SAR,3349,1235,2114,3347,0,2,ITG,ITG2,20,Sardegna,Sardegna,1639591,453941,27.69,0.2
3039,2021-08-20,SAR,10172,5353,4819,4794,5228,150,ITG,ITG2,20,Sardegna,Sardegna,1639591,464113,28.31,0.62
3040,2021-05-12,SAR,11223,5282,5941,7864,3154,205,ITG,ITG2,20,Sardegna,Sardegna,1639591,475336,28.99,0.68
3041,2021-09-03,SAR,7309,3963,3346,2396,4838,75,ITG,ITG2,20,Sardegna,Sardegna,1639591,482645,29.44,0.45
3042,2020-12-28,SAR,68,27,41,68,0,0,ITG,ITG2,20,Sardegna,Sardegna,1639591,482713,29.44,0.0
3043,2021-06-14,SAR,13750,6644,7106,9791,3817,142,ITG,ITG2,20,Sardegna,Sardegna,1639591,496463,30.28,0.84
3044,2021-03-06,SAR,2950,1219,1731,1081,1795,74,ITG,ITG2,20,Sardegna,Sardegna,1639591,499413,30.46,0.18
3045,2021-02-04,SAR,2302,825,1477,915,1384,3,ITG,ITG2,20,Sardegna,Sardegna,1639591,501715,30.6,0.14
3046,2021-04-02,SAR,9329,3626,5703,5930,3252,147,ITG,ITG2,20,Sardegna,Sardegna,1639591,511044,31.17,0.57
3047,2021-07-13,SAR,17806,8522,9284,3250,14478,78,ITG,ITG2,20,Sardegna,Sardegna,1639591,528850,32.25,1.09
3048,2021-04-04,SAR,2,1,1,0,2,0,ITG,ITG2,20,Sardegna,Sardegna,1639591,528852,32.26,0.0
3049,2021-08-08,SAR,1884,979,905,1020,841,23,ITG,ITG2,20,Sardegna,Sardegna,1639591,530736,32.37,0.11
3050,2021-06-26,SAR,19161,9013,10148,5454,13632,75,ITG,ITG2,20,Sardegna,Sardegna,1639591,549897,33.54,1.17
3051,2021-08-22,SAR,1162,650,512,403,756,3,ITG,ITG2,20,Sardegna,Sardegna,1639591,551059,33.61,0.07
3052,2021-04-21,SAR,12177,5578,6599,6477,5597,103,ITG,ITG2,20,Sardegna,Sardegna,1639591,563236,34.35,0.74
3053,2021-01-11,SAR,1217,520,697,1216,0,1,ITG,ITG2,20,Sardegna,Sardegna,1639591,564453,34.43,0.07
3054,2021-06-17,SAR,18463,8530,9933,9917,8425,121,ITG,ITG2,20,Sardegna,Sardegna,1639591,582916,35.55,1.13
3055,2021-01-25,SAR,611,228,383,23,588,0,ITG,ITG2,20,Sardegna,Sardegna,1639591,583527,35.59,0.04
3056,2021-08-24,SAR,10101,5401,4700,4811,5135,155,ITG,ITG2,20,Sardegna,Sardegna,1639591,593628,36.21,0.62
3057,2021-05-16,SAR,8247,3836,4411,6003,2161,83,ITG,ITG2,20,Sardegna,Sardegna,1639591,601875,36.71,0.5
3058,2021-07-12,SAR,15336,7414,7922,2401,12877,58,ITG,ITG2,20,Sardegna,Sardegna,1639591,617211,37.64,0.94
3059,2021-07-24,SAR,12384,6385,5999,1994,10362,28,ITG,ITG2,20,Sardegna,Sardegna,1639591,629595,38.4,0.76
3060,2021-08-10,SAR,14240,7508,6732,6250,7828,162,ITG,ITG2,20,Sardegna,Sardegna,1639591,643835,39.27,0.87
3061,2021-05-02,SAR,6076,2728,3348,5298,675,103,ITG,ITG2,20,Sardegna,Sardegna,1639591,649911,39.64,0.37
3062,2021-02-08,SAR,1477,536,941,859,617,1,ITG,ITG2,20,Sardegna,Sardegna,1639591,651388,39.73,0.09
3063,2021-08-12,SAR,12481,6615,5866,6627,5686,168,ITG,ITG2,20,Sardegna,Sardegna,1639591,663869,40.49,0.76
3064,2021-01-13,SAR,579,182,397,579,0,0,ITG,ITG2,20,Sardegna,Sardegna,1639591,664448,40.53,0.04
3065,2021-07-17,SAR,12871,6303,6568,3180,9624,67,ITG,ITG2,20,Sardegna,Sardegna,1639591,677319,41.31,0.79
3066,2021-02-22,SAR,1651,954,697,1391,234,26,ITG,ITG2,20,Sardegna,Sardegna,1639591,678970,41.41,0.1
3067,2021-03-11,SAR,6459,3107,3352,5169,1209,81,ITG,ITG2,20,Sardegna,Sardegna,1639591,685429,41.8,0.39
3068,2021-06-04,SAR,14506,6943,7563,9784,4563,159,ITG,ITG2,20,Sardegna,Sardegna,1639591,699935,42.69,0.88
3069,2021-06-02,SAR,9786,4692,5094,8060,1640,86,ITG,ITG2,20,Sardegna,Sardegna,1639591,709721,43.29,0.6
3070,2021-07-29,SAR,17901,9045,8856,6530,11205,166,ITG,ITG2,20,Sardegna,Sardegna,1639591,727622,44.38,1.09
3071,2021-04-20,SAR,11194,5064,6130,7797,3297,100,ITG,ITG2,20,Sardegna,Sardegna,1639591,738816,45.06,0.68
3072,2021-06-16,SAR,17634,8275,9359,12163,5310,161,ITG,ITG2,20,Sardegna,Sardegna,1639591,756450,46.14,1.08
3073,2021-01-01,SAR,33,17,16,33,0,0,ITG,ITG2,20,Sardegna,Sardegna,1639591,756483,46.14,0.0
3074,2021-02-27,SAR,1929,645,1284,1326,561,42,ITG,ITG2,20,Sardegna,Sardegna,1639591,758412,46.26,0.12
3075,2021-07-22,SAR,18336,9267,9069,4508,13719,109,ITG,ITG2,20,Sardegna,Sardegna,1639591,776748,47.37,1.12
3076,2021-04-13,SAR,7704,3624,4080,5785,1854,65,ITG,ITG2,20,Sardegna,Sardegna,1639591,784452,47.84,0.47
3077,2021-06-09,SAR,15472,7369,8103,11576,3745,151,ITG,ITG2,20,Sardegna,Sardegna,1639591,799924,48.79,0.94
3078,2021-07-31,SAR,10321,5457,4864,5277,4963,81,ITG,ITG2,20,Sardegna,Sardegna,1639591,810245,49.42,0.63
3079,2021-08-19,SAR,10760,5688,5072,5734,4894,132,ITG,ITG2,20,Sardegna,Sardegna,1639591,821005,50.07,0.66
3080,2021-05-28,SAR,18009,8712,9297,13525,4297,187,ITG,ITG2,20,Sardegna,Sardegna,1639591,839014,51.17,1.1
3081,2021-05-07,SAR,14595,6663,7932,9788,4553,254,ITG,ITG2,20,Sardegna,Sardegna,1639591,853609,52.06,0.89
3082,2021-01-27,SAR,1433,506,927,78,1355,0,ITG,ITG2,20,Sardegna,Sardegna,1639591,855042,52.15,0.09
3083,2021-07-03,SAR,15842,7562,8280,3235,12575,32,ITG,ITG2,20,Sardegna,Sardegna,1639591,870884,53.12,0.97
3084,2021-03-25,SAR,9270,4020,5250,7818,1308,144,ITG,ITG2,20,Sardegna,Sardegna,1639591,880154,53.68,0.57
3085,2021-08-29,SAR,467,250,217,355,98,14,ITG,ITG2,20,Sardegna,Sardegna,1639591,880621,53.71,0.03
3086,2021-05-21,SAR,22796,11231,11565,16383,6133,280,ITG,ITG2,20,Sardegna,Sardegna,1639591,903417,55.1,1.39
3087,2021-08-21,SAR,5620,3054,2566,3636,1894,90,ITG,ITG2,20,Sardegna,Sardegna,1639591,909037,55.44,0.34
3088,2021-03-08,SAR,4734,2464,2270,3455,1226,53,ITG,ITG2,20,Sardegna,Sardegna,1639591,913771,55.73,0.29
3089,2021-05-04,SAR,9682,4428,5254,7623,1904,155,ITG,ITG2,20,Sardegna,Sardegna,1639591,923453,56.32,0.59
3090,2021-01-24,SAR,91,35,56,5,86,0,ITG,ITG2,20,Sardegna,Sardegna,1639591,923544,56.33,0.01
3091,2021-06-21,SAR,14033,6737,7296,5122,8837,74,ITG,ITG2,20,Sardegna,Sardegna,1639591,937577,57.18,0.86
3092,2021-03-13,SAR,2773,1084,1689,2451,281,41,ITG,ITG2,20,Sardegna,Sardegna,1639591,940350,57.35,0.17
3093,2021-03-30,SAR,8923,3621,5302,6484,2285,154,ITG,ITG2,20,Sardegna,Sardegna,1639591,949273,57.9,0.54
3094,2021-01-06,SAR,1636,556,1080,1636,0,0,ITG,ITG2,20,Sardegna,Sardegna,1639591,950909,58.0,0.1
3095,2021-06-23,SAR,20547,9668,10879,6192,14262,93,ITG,ITG2,20,Sardegna,Sardegna,1639591,971456,59.25,1.25
3096,2021-01-20,SAR,215,78,137,213,2,0,ITG,ITG2,20,Sardegna,Sardegna,1639591,971671,59.26,0.01
3097,2021-03-29,SAR,4859,1886,2973,4169,595,95,ITG,ITG2,20,Sardegna,Sardegna,1639591,976530,59.56,0.3
3098,2021-04-15,SAR,11954,5574,6380,6816,5020,118,ITG,ITG2,20,Sardegna,Sardegna,1639591,988484,60.29,0.73
3099,2021-01-05,SAR,1358,458,900,1358,0,0,ITG,ITG2,20,Sardegna,Sardegna,1639591,989842,60.37,0.08
3100,2021-01-22,SAR,84,47,37,56,28,0,ITG,ITG2,20,Sardegna,Sardegna,1639591,989926,60.38,0.01
3101,2021-07-26,SAR,14603,7289,7314,4127,10399,77,ITG,ITG2,20,Sardegna,Sardegna,1639591,1004529,61.27,0.89
3102,2021-04-17,SAR,10173,4523,5650,5422,4668,83,ITG,ITG2,20,Sardegna,Sardegna,1639591,1014702,61.89,0.62
3103,2021-07-05,SAR,15584,7572,8012,3328,12207,49,ITG,ITG2,20,Sardegna,Sardegna,1639591,1030286,62.84,0.95
3104,2021-08-31,SAR,9295,4956,4339,4748,4388,159,ITG,ITG2,20,Sardegna,Sardegna,1639591,1039581,63.4,0.57
3105,2021-08-05,SAR,15655,8232,7423,8694,6800,161,ITG,ITG2,20,Sardegna,Sardegna,1639591,1055236,64.36,0.95
3106,2021-02-20,SAR,2044,856,1188,1683,337,24,ITG,ITG2,20,Sardegna,Sardegna,1639591,1057280,64.48,0.12
3107,2021-08-07,SAR,8214,4309,3905,5440,2706,68,ITG,ITG2,20,Sardegna,Sardegna,1639591,1065494,64.99,0.5
3108,2021-04-29,SAR,11271,5131,6140,6684,4431,156,ITG,ITG2,20,Sardegna,Sardegna,1639591,1076765,65.67,0.69
3109,2021-03-18,SAR,7316,3096,4220,5600,1639,77,ITG,ITG2,20,Sardegna,Sardegna,1639591,1084081,66.12,0.45
3110,2021-05-14,SAR,14657,6889,7768,10819,3651,187,ITG,ITG2,20,Sardegna,Sardegna,1639591,1098738,67.01,0.89
3111,2021-02-03,SAR,1122,419,703,426,695,1,ITG,ITG2,20,Sardegna,Sardegna,1639591,1099860,67.08,0.07
3112,2021-07-10,SAR,14241,6889,7352,2705,11503,33,ITG,ITG2,20,Sardegna,Sardegna,1639591,1114101,67.95,0.87
3113,2021-04-01,SAR,10292,4105,6187,7120,3024,148,ITG,ITG2,20,Sardegna,Sardegna,1639591,1124393,68.58,0.63
3114,2021-09-02,SAR,10326,5547,4779,3969,6246,111,ITG,ITG2,20,Sardegna,Sardegna,1639591,1134719,69.21,0.63
3115,2021-07-21,SAR,19393,9499,9894,3909,15400,84,ITG,ITG2,20,Sardegna,Sardegna,1639591,1154112,70.39,1.18
3116,2021-01-03,SAR,90,36,54,90,0,0,ITG,ITG2,20,Sardegna,Sardegna,1639591,1154202,70.4,0.01
3117,2021-07-07,SAR,15909,7730,8179,4085,11771,53,ITG,ITG2,20,Sardegna,Sardegna,1639591,1170111,71.37,0.97
3118,2021-02-17,SAR,1415,581,834,1279,74,62,ITG,ITG2,20,Sardegna,Sardegna,1639591,1171526,71.45,0.09
3119,2021-05-25,SAR,15157,7705,7452,8495,6487,175,ITG,ITG2,20,Sardegna,Sardegna,1639591,1186683,72.38,0.92
3120,2021-06-11,SAR,14783,7025,7758,9090,5538,155,ITG,ITG2,20,Sardegna,Sardegna,1639591,1201466,73.28,0.9
3121,2021-03-03,SAR,4138,2294,1844,2746,1306,86,ITG,ITG2,20,Sardegna,Sardegna,1639591,1205604,73.53,0.25
3122,2021-06-30,SAR,17774,8515,9259,4806,12886,82,ITG,ITG2,20,Sardegna,Sardegna,1639591,1223378,74.61,1.08
3123,2021-03-22,SAR,3744,1516,2228,3132,526,86,ITG,ITG2,20,Sardegna,Sardegna,1639591,1227122,74.84,0.23
3124,2021-08-09,SAR,13414,6972,6442,6474,6794,146,ITG,ITG2,20,Sardegna,Sardegna,1639591,1240536,75.66,0.82
3125,2021-08-26,SAR,9431,5001,4430,5359,3946,126,ITG,ITG2,20,Sardegna,Sardegna,1639591,1249967,76.24,0.58
3126,2021-05-18,SAR,14786,7386,7400,9428,5226,132,ITG,ITG2,20,Sardegna,Sardegna,1639591,1264753,77.14,0.9
3127,2021-06-18,SAR,16490,7509,8981,8604,7770,116,ITG,ITG2,20,Sardegna,Sardegna,1639591,1281243,78.14,1.01
3128,2021-03-10,SAR,6077,2962,3115,5147,855,75,ITG,ITG2,20,Sardegna,Sardegna,1639591,1287320,78.51,0.37
3129,2021-08-14,SAR,1794,1025,769,990,794,10,ITG,ITG2,20,Sardegna,Sardegna,1639591,1289114,78.62,0.11
3130,2021-05-06,SAR,13168,6063,7105,9733,3189,246,ITG,ITG2,20,Sardegna,Sardegna,1639591,1302282,79.43,0.8
3131,2021-03-01,SAR,2295,1166,1129,1598,667,30,ITG,ITG2,20,Sardegna,Sardegna,1639591,1304577,79.57,0.14
3132,2021-05-13,SAR,12453,5874,6579,8772,3470,211,ITG,ITG2,20,Sardegna,Sardegna,1639591,1317030,80.33,0.76
3133,2021-02-02,SAR,1534,681,853,258,1276,0,ITG,ITG2,20,Sardegna,Sardegna,1639591,1318564,80.42,0.09
3134,2021-08-23,SAR,10522,5566,4956,5635,4711,176,ITG,ITG2,20,Sardegna,Sardegna,1639591,1329086,81.06,0.64
3135,2021-05-15,SAR,13875,6442,7433,10244,3444,187,ITG,ITG2,20,Sardegna,Sardegna,1639591,1342961,81.91,0.85
3136,2021-07-11,SAR,6380,3119,3261,1424,4920,36,ITG,ITG2,20,Sardegna,Sardegna,1639591,1349341,82.3,0.39
3137,2021-02-05,SAR,1923,757,1166,435,1486,2,ITG,ITG2,20,Sardegna,Sardegna,1639591,1351264,82.41,0.12
3138,2021-04-03,SAR,4725,1824,2901,2670,1985,70,ITG,ITG2,20,Sardegna,Sardegna,1639591,1355989,82.7,0.29
3139,2021-05-30,SAR,9744,4841,4903,7311,2365,68,ITG,ITG2,20,Sardegna,Sardegna,1639591,1365733,83.3,0.59
3140,2021-02-19,SAR,1517,476,1041,1414,56,47,ITG,ITG2,20,Sardegna,Sardegna,1639591,1367250,83.39,0.09
3141,2021-03-27,SAR,5827,2215,3612,5310,423,94,ITG,ITG2,20,Sardegna,Sardegna,1639591,1373077,83.75,0.36
3142,2021-05-23,SAR,10036,4817,5219,7685,2255,96,ITG,ITG2,20,Sardegna,Sardegna,1639591,1383113,84.36,0.61
3143,2021-02-12,SAR,2249,938,1311,2183,60,6,ITG,ITG2,20,Sardegna,Sardegna,1639591,1385362,84.49,0.14
3144,2021-07-19,SAR,15230,7630,7600,2797,12383,50,ITG,ITG2,20,Sardegna,Sardegna,1639591,1400592,85.42,0.93
3145,2021-04-10,SAR,10600,4782,5818,8535,1961,104,ITG,ITG2,20,Sardegna,Sardegna,1639591,1411192,86.07,0.65
3146,2021-04-08,SAR,13604,5969,7635,8333,5154,117,ITG,ITG2,20,Sardegna,Sardegna,1639591,1424796,86.9,0.83
3147,2021-07-14,SAR,16907,8190,8717,3773,13023,111,ITG,ITG2,20,Sardegna,Sardegna,1639591,1441703,87.93,1.03
3148,2020-12-29,SAR,57,32,25,57,0,0,ITG,ITG2,20,Sardegna,Sardegna,1639591,1441760,87.93,0.0
3149,2021-04-22,SAR,10627,4685,5942,5541,4993,93,ITG,ITG2,20,Sardegna,Sardegna,1639591,1452387,88.58,0.65
3150,2021-01-12,SAR,890,417,473,890,0,0,ITG,ITG2,20,Sardegna,Sardegna,1639591,1453277,88.64,0.05
3151,2021-05-11,SAR,9109,4246,4863,6453,2519,137,ITG,ITG2,20,Sardegna,Sardegna,1639591,1462386,89.19,0.56
3152,2021-06-22,SAR,19343,8990,10353,7166,12076,101,ITG,ITG2,20,Sardegna,Sardegna,1639591,1481729,90.37,1.18
3153,2021-07-09,SAR,15879,7599,8280,3431,12365,83,ITG,ITG2,20,Sardegna,Sardegna,1639591,1497608,91.34,0.97
3154,2021-03-31,SAR,10631,4232,6399,8064,2437,130,ITG,ITG2,20,Sardegna,Sardegna,1639591,1508239,91.99,0.65
3155,2021-08-25,SAR,10063,5291,4772,4241,5711,111,ITG,ITG2,20,Sardegna,Sardegna,1639591,1518302,92.6,0.61
3156,2021-06-03,SAR,16398,7645,8753,10564,5693,141,ITG,ITG2,20,Sardegna,Sardegna,1639591,1534700,93.6,1.0
3157,2021-06-20,SAR,6295,2807,3488,3635,2628,32,ITG,ITG2,20,Sardegna,Sardegna,1639591,1540995,93.99,0.38
3158,2021-03-12,SAR,6020,2632,3388,4552,1317,151,ITG,ITG2,20,Sardegna,Sardegna,1639591,1547015,94.35,0.37
3159,2021-06-25,SAR,16513,7810,8703,3900,12556,57,ITG,ITG2,20,Sardegna,Sardegna,1639591,1563528,95.36,1.01
3160,2021-01-10,SAR,2220,762,1458,2219,0,1,ITG,ITG2,20,Sardegna,Sardegna,1639591,1565748,95.5,0.14
3161,2021-01-07,SAR,3169,1110,2059,3165,0,4,ITG,ITG2,20,Sardegna,Sardegna,1639591,1568917,95.69,0.19
3162,2021-06-10,SAR,17812,8479,9333,11644,6042,126,ITG,ITG2,20,Sardegna,Sardegna,1639591,1586729,96.78,1.09
3163,2021-08-06,SAR,13822,7174,6648,7989,5660,173,ITG,ITG2,20,Sardegna,Sardegna,1639591,1600551,97.62,0.84
3164,2020-12-31,SAR,41,22,19,41,0,0,ITG,ITG2,20,Sardegna,Sardegna,1639591,1600592,97.62,0.0
3165,2021-07-30,SAR,15212,7860,7352,6628,8417,167,ITG,ITG2,20,Sardegna,Sardegna,1639591,1615804,98.55,0.93
3166,2021-07-02,SAR,18944,8893,10051,4405,14441,98,ITG,ITG2,20,Sardegna,Sardegna,1639591,1634748,99.7,1.16
3167,2021-04-27,SAR,7755,3589,4166,5573,2071,111,ITG,ITG2,20,Sardegna,Sardegna,1639591,1642503,100.18,0.47
3168,2021-01-17,SAR,867,278,589,866,1,0,ITG,ITG2,20,Sardegna,Sardegna,1639591,1643370,100.23,0.05
3169,2021-03-15,SAR,2827,1328,1499,2408,377,42,ITG,ITG2,20,Sardegna,Sardegna,1639591,1646197,100.4,0.17
3170,2021-07-04,SAR,8206,3988,4218,2066,6125,15,ITG,ITG2,20,Sardegna,Sardegna,1639591,1654403,100.9,0.5
3171,2021-03-26,SAR,8632,3550,5082,6961,1532,139,ITG,ITG2,20,Sardegna,Sardegna,1639591,1663035,101.43,0.53
3172,2021-08-30,SAR,8751,4668,4083,4835,3759,157,ITG,ITG2,20,Sardegna,Sardegna,1639591,1671786,101.96,0.53
3173,2021-05-22,SAR,25067,12011,13056,19587,5176,304,ITG,ITG2,20,Sardegna,Sardegna,1639591,1696853,103.49,1.53
3174,2021-01-26,SAR,1380,474,906,27,1353,0,ITG,ITG2,20,Sardegna,Sardegna,1639591,1698233,103.58,0.08
3175,2021-08-16,SAR,8462,4412,4050,4551,3795,116,ITG,ITG2,20,Sardegna,Sardegna,1639591,1706695,104.09,0.52
3176,2021-05-08,SAR,13206,5996,7210,10756,2289,161,ITG,ITG2,20,Sardegna,Sardegna,1639591,1719901,104.9,0.81
3177,2021-01-19,SAR,751,271,480,695,55,1,ITG,ITG2,20,Sardegna,Sardegna,1639591,1720652,104.94,0.05
3178,2021-03-17,SAR,6627,2870,3757,4956,1633,38,ITG,ITG2,20,Sardegna,Sardegna,1639591,1727279,105.35,0.4
3179,2021-06-27,SAR,9019,4310,4709,2956,6035,28,ITG,ITG2,20,Sardegna,Sardegna,1639591,1736298,105.9,0.55
3180,2021-03-24,SAR,7505,3134,4371,5996,1360,149,ITG,ITG2,20,Sardegna,Sardegna,1639591,1743803,106.36,0.46
3181,2021-01-31,SAR,2153,765,1388,45,2108,0,ITG,ITG2,20,Sardegna,Sardegna,1639591,1745956,106.49,0.13
3182,2021-02-14,SAR,542,263,279,540,2,0,ITG,ITG2,20,Sardegna,Sardegna,1639591,1746498,106.52,0.03
3183,2021-07-18,SAR,5693,2874,2819,982,4701,10,ITG,ITG2,20,Sardegna,Sardegna,1639591,1752191,106.87,0.35
3184,2021-08-18,SAR,10692,5532,5160,5706,4856,130,ITG,ITG2,20,Sardegna,Sardegna,1639591,1762883,107.52,0.65
3185,2021-02-24,SAR,2447,1309,1138,2211,195,41,ITG,ITG2,20,Sardegna,Sardegna,1639591,1765330,107.67,0.15
3186,2021-08-28,SAR,4163,2395,1768,2853,1251,59,ITG,ITG2,20,Sardegna,Sardegna,1639591,1769493,107.92,0.25
3187,2021-06-06,SAR,10036,5001,5035,6314,3653,69,ITG,ITG2,20,Sardegna,Sardegna,1639591,1779529,108.53,0.61
3188,2021-04-05,SAR,2090,798,1292,2047,1,42,ITG,ITG2,20,Sardegna,Sardegna,1639591,1781619,108.66,0.13
3189,2021-06-29,SAR,17893,8606,9287,3753,14091,49,ITG,ITG2,20,Sardegna,Sardegna,1639591,1799512,109.75,1.09
3190,2021-02-10,SAR,1976,775,1201,1444,526,6,ITG,ITG2,20,Sardegna,Sardegna,1639591,1801488,109.87,0.12
3191,2021-04-12,SAR,7056,3200,3856,5257,1727,72,ITG,ITG2,20,Sardegna,Sardegna,1639591,1808544,110.3,0.43
3192,2021-01-02,SAR,61,22,39,61,0,0,ITG,ITG2,20,Sardegna,Sardegna,1639591,1808605,110.31,0.0
3193,2021-06-08,SAR,14835,7071,7764,11169,3511,155,ITG,ITG2,20,Sardegna,Sardegna,1639591,1823440,111.21,0.9
3194,2021-02-28,SAR,368,169,199,139,227,2,ITG,ITG2,20,Sardegna,Sardegna,1639591,1823808,111.24,0.02
3195,2021-08-04,SAR,16216,8528,7688,9599,6353,264,ITG,ITG2,20,Sardegna,Sardegna,1639591,1840024,112.22,0.99
3196,2021-04-26,SAR,6942,3294,3648,5921,926,95,ITG,ITG2,20,Sardegna,Sardegna,1639591,1846966,112.65,0.42
3197,2021-06-01,SAR,14328,6659,7669,9637,4595,96,ITG,ITG2,20,Sardegna,Sardegna,1639591,1861294,113.52,0.87
3198,2021-02-21,SAR,1589,709,880,1558,30,1,ITG,ITG2,20,Sardegna,Sardegna,1639591,1862883,113.62,0.1
3199,2021-07-28,SAR,16793,8620,8173,6319,10326,148,ITG,ITG2,20,Sardegna,Sardegna,1639591,1879676,114.64,1.02
3200,2021-04-19,SAR,10251,4643,5608,8663,1446,142,ITG,ITG2,20,Sardegna,Sardegna,1639591,1889927,115.27,0.63
3201,2021-01-09,SAR,4085,1443,2642,4085,0,0,ITG,ITG2,20,Sardegna,Sardegna,1639591,1894012,115.52,0.25
3202,2021-06-15,SAR,14687,6808,7879,9812,4741,134,ITG,ITG2,20,Sardegna,Sardegna,1639591,1908699,116.41,0.9
3203,2021-03-07,SAR,1663,752,911,1114,545,4,ITG,ITG2,20,Sardegna,Sardegna,1639591,1910362,116.51,0.1
3204,2021-07-23,SAR,15758,7786,7972,3404,12276,78,ITG,ITG2,20,Sardegna,Sardegna,1639591,1926120,117.48,0.96
3205,2021-04-14,SAR,8367,3927,4440,7029,1276,62,ITG,ITG2,20,Sardegna,Sardegna,1639591,1934487,117.99,0.51
3206,2021-05-01,SAR,10008,4797,5211,5421,4485,102,ITG,ITG2,20,Sardegna,Sardegna,1639591,1944495,118.6,0.61
3207,2021-01-21,SAR,140,69,71,98,42,0,ITG,ITG2,20,Sardegna,Sardegna,1639591,1944635,118.6,0.01
3208,2021-02-07,SAR,1128,397,731,228,899,1,ITG,ITG2,20,Sardegna,Sardegna,1639591,1945763,118.67,0.07
3209,2021-08-11,SAR,11925,6361,5564,6145,5600,180,ITG,ITG2,20,Sardegna,Sardegna,1639591,1957688,119.4,0.73
3210,2021-05-03,SAR,8335,3854,4481,6601,1623,111,ITG,ITG2,20,Sardegna,Sardegna,1639591,1966023,119.91,0.51
3211,2021-05-20,SAR,16414,7894,8520,11295,4913,206,ITG,ITG2,20,Sardegna,Sardegna,1639591,1982437,120.91,1.0
3212,2021-02-09,SAR,2297,839,1458,1290,1002,5,ITG,ITG2,20,Sardegna,Sardegna,1639591,1984734,121.05,0.14
3213,2021-02-26,SAR,2832,1115,1717,2473,308,51,ITG,ITG2,20,Sardegna,Sardegna,1639591,1987566,121.22,0.17
3214,2021-06-28,SAR,14994,7041,7953,3050,11878,66,ITG,ITG2,20,Sardegna,Sardegna,1639591,2002560,122.14,0.91
3215,2021-04-06,SAR,7575,3157,4418,5061,2439,75,ITG,ITG2,20,Sardegna,Sardegna,1639591,2010135,122.6,0.46
3216,2020-12-27,SAR,68,37,31,68,0,0,ITG,ITG2,20,Sardegna,Sardegna,1639591,2010203,122.6,0.0
3217,2021-04-25,SAR,4534,2282,2252,3701,784,49,ITG,ITG2,20,Sardegna,Sardegna,1639591,2014737,122.88,0.28
3218,2021-01-15,SAR,1574,574,1000,1572,0,2,ITG,ITG2,20,Sardegna,Sardegna,1639591,2016311,122.98,0.1
3219,2021-08-17,SAR,10608,5535,5073,6093,4389,126,ITG,ITG2,20,Sardegna,Sardegna,1639591,2026919,123.62,0.65
3220,2021-02-01,SAR,1554,620,934,226,1328,0,ITG,ITG2,20,Sardegna,Sardegna,1639591,2028473,123.72,0.09
3221,2021-05-09,SAR,6181,2889,3292,5162,926,93,ITG,ITG2,20,Sardegna,Sardegna,1639591,2034654,124.1,0.38
3222,2021-05-26,SAR,15549,8195,7354,9706,5661,182,ITG,ITG2,20,Sardegna,Sardegna,1639591,2050203,125.04,0.95
3223,2021-02-15,SAR,960,349,611,923,31,6,ITG,ITG2,20,Sardegna,Sardegna,1639591,2051163,125.1,0.06
3224,2021-03-20,SAR,5222,2079,3143,2909,2286,27,ITG,ITG2,20,Sardegna,Sardegna,1639591,2056385,125.42,0.32
3225,2021-06-13,SAR,9501,4677,4824,6161,3260,80,ITG,ITG2,20,Sardegna,Sardegna,1639591,2065886,126.0,0.58
3226,2021-01-29,SAR,3044,1118,1926,45,2997,2,ITG,ITG2,20,Sardegna,Sardegna,1639591,2068930,126.19,0.19
3227,2021-08-02,SAR,13117,6602,6515,6210,6729,178,ITG,ITG2,20,Sardegna,Sardegna,1639591,2082047,126.99,0.8
3228,2021-01-28,SAR,3037,1083,1954,68,2969,0,ITG,ITG2,20,Sardegna,Sardegna,1639591,2085084,127.17,0.19
3229,2021-05-27,SAR,17858,9267,8591,12107,5543,208,ITG,ITG2,20,Sardegna,Sardegna,1639591,2102942,128.26,1.09
3230,2021-02-16,SAR,703,291,412,667,27,9,ITG,ITG2,20,Sardegna,Sardegna,1639591,2103645,128.3,0.04
3231,2021-03-05,SAR,5234,2621,2613,2823,2372,39,ITG,ITG2,20,Sardegna,Sardegna,1639591,2108879,128.62,0.32
3232,2021-03-19,SAR,7321,3064,4257,5017,2244,60,ITG,ITG2,20,Sardegna,Sardegna,1639591,2116200,129.07,0.45
3233,2021-07-16,SAR,16934,8475,8459,4552,12247,135,ITG,ITG2,20,Sardegna,Sardegna,1639591,2133134,130.1,1.03
3234,2021-04-07,SAR,13727,6104,7623,7908,5738,81,ITG,ITG2,20,Sardegna,Sardegna,1639591,2146861,130.94,0.84
3235,2021-04-24,SAR,10521,4892,5629,7959,2429,133,ITG,ITG2,20,Sardegna,Sardegna,1639591,2157382,131.58,0.64
3236,2021-01-14,SAR,1128,433,695,1128,0,0,ITG,ITG2,20,Sardegna,Sardegna,1639591,2158510,131.65,0.07
3237,2021-07-03,UMB,6481,3248,3233,2833,3497,151,ITI,ITI2,10,Umbria,Umbria,882015,6481,0.73,0.73
3238,2021-07-20,UMB,8267,4107,4160,1096,7087,84,ITI,ITI2,10,Umbria,Umbria,882015,14748,1.67,0.94
3239,2021-08-10,UMB,7400,3935,3465,4001,3256,143,ITI,ITI2,10,Umbria,Umbria,882015,22148,2.51,0.84
3240,2021-06-14,UMB,5387,2750,2637,3254,2015,118,ITI,ITI2,10,Umbria,Umbria,882015,27535,3.12,0.61
3241,2021-04-06,UMB,5293,2167,3126,2865,2391,37,ITI,ITI2,10,Umbria,Umbria,882015,32828,3.72,0.6
3242,2021-03-28,UMB,1096,441,655,1041,24,31,ITI,ITI2,10,Umbria,Umbria,882015,33924,3.85,0.12
3243,2021-01-30,UMB,1575,486,1089,43,1532,0,ITI,ITI2,10,Umbria,Umbria,882015,35499,4.02,0.18
3244,2021-07-15,UMB,10573,5177,5396,566,9909,98,ITI,ITI2,10,Umbria,Umbria,882015,46072,5.22,1.2
3245,2021-06-02,UMB,3926,1886,2040,3805,42,79,ITI,ITI2,10,Umbria,Umbria,882015,49998,5.67,0.45
3246,2021-02-20,UMB,283,101,182,259,24,0,ITI,ITI2,10,Umbria,Umbria,882015,50281,5.7,0.03
3247,2021-03-09,UMB,4092,2002,2090,2795,1288,9,ITI,ITI2,10,Umbria,Umbria,882015,54373,6.16,0.46
3248,2021-02-13,UMB,114,27,87,111,3,0,ITI,ITI2,10,Umbria,Umbria,882015,54487,6.18,0.01
3249,2021-05-24,UMB,9077,4520,4557,8030,881,166,ITI,ITI2,10,Umbria,Umbria,882015,63564,7.21,1.03
3250,2021-04-18,UMB,1532,681,851,578,931,23,ITI,ITI2,10,Umbria,Umbria,882015,65096,7.38,0.17
3251,2021-01-11,UMB,1335,363,972,1335,0,0,ITI,ITI2,10,Umbria,Umbria,882015,66431,7.53,0.15
3252,2021-07-27,UMB,8144,4090,4054,2695,5333,116,ITI,ITI2,10,Umbria,Umbria,882015,74575,8.46,0.92
3253,2021-05-05,UMB,7223,3306,3917,3833,3306,84,ITI,ITI2,10,Umbria,Umbria,882015,81798,9.27,0.82
3254,2021-01-25,UMB,649,322,327,5,644,0,ITI,ITI2,10,Umbria,Umbria,882015,82447,9.35,0.07
3255,2021-08-15,UMB,4388,2384,2004,2861,1382,145,ITI,ITI2,10,Umbria,Umbria,882015,86835,9.85,0.5
3256,2021-07-29,UMB,8203,4228,3975,2145,5940,118,ITI,ITI2,10,Umbria,Umbria,882015,95038,10.78,0.93
3257,2021-05-07,UMB,10133,4716,5417,6655,3192,286,ITI,ITI2,10,Umbria,Umbria,882015,105171,11.92,1.15
3258,2021-08-29,UMB,1947,1004,943,685,1253,9,ITI,ITI2,10,Umbria,Umbria,882015,107118,12.14,0.22
3259,2021-03-23,UMB,3827,1714,2113,2159,1631,37,ITI,ITI2,10,Umbria,Umbria,882015,110945,12.58,0.43
3260,2021-08-27,UMB,4601,2419,2182,1500,3000,101,ITI,ITI2,10,Umbria,Umbria,882015,115546,13.1,0.52
3261,2021-07-01,UMB,9747,4819,4928,3304,6289,154,ITI,ITI2,10,Umbria,Umbria,882015,125293,14.21,1.11
3262,2021-02-08,UMB,637,203,434,88,549,0,ITI,ITI2,10,Umbria,Umbria,882015,125930,14.28,0.07
3263,2021-05-19,UMB,9431,4219,5212,5600,3745,86,ITI,ITI2,10,Umbria,Umbria,882015,135361,15.35,1.07
3264,2021-04-23,UMB,6658,2820,3838,3301,3158,199,ITI,ITI2,10,Umbria,Umbria,882015,142019,16.1,0.75
3265,2021-02-25,UMB,1334,496,838,1274,52,8,ITI,ITI2,10,Umbria,Umbria,882015,143353,16.25,0.15
3266,2021-03-11,UMB,3687,1799,1888,2668,1006,13,ITI,ITI2,10,Umbria,Umbria,882015,147040,16.67,0.42
3267,2021-01-13,UMB,451,139,312,451,0,0,ITI,ITI2,10,Umbria,Umbria,882015,147491,16.72,0.05
3268,2021-06-19,UMB,4589,2206,2383,2463,2033,93,ITI,ITI2,10,Umbria,Umbria,882015,152080,17.24,0.52
3269,2021-01-06,UMB,847,326,521,847,0,0,ITI,ITI2,10,Umbria,Umbria,882015,152927,17.34,0.1
3270,2021-06-12,UMB,7721,3688,4033,5962,1580,179,ITI,ITI2,10,Umbria,Umbria,882015,160648,18.21,0.88
3271,2021-04-16,UMB,8101,3744,4357,6084,1838,179,ITI,ITI2,10,Umbria,Umbria,882015,168749,19.13,0.92
3272,2021-04-25,UMB,4362,1687,2675,3868,83,411,ITI,ITI2,10,Umbria,Umbria,882015,173111,19.63,0.49
3273,2021-08-03,UMB,9206,4761,4445,3504,5519,183,ITI,ITI2,10,Umbria,Umbria,882015,182317,20.67,1.04
3274,2021-07-22,UMB,10075,4924,5151,1653,8317,105,ITI,ITI2,10,Umbria,Umbria,882015,192392,21.81,1.14
3275,2021-01-01,UMB,273,104,169,273,0,0,ITI,ITI2,10,Umbria,Umbria,882015,192665,21.84,0.03
3276,2021-04-11,UMB,3101,1506,1595,3035,49,17,ITI,ITI2,10,Umbria,Umbria,882015,195766,22.2,0.35
3277,2021-01-18,UMB,619,221,398,531,88,0,ITI,ITI2,10,Umbria,Umbria,882015,196385,22.27,0.07
3278,2021-03-18,UMB,2986,1178,1808,1712,1265,9,ITI,ITI2,10,Umbria,Umbria,882015,199371,22.6,0.34
3279,2021-06-26,UMB,9380,4758,4622,5582,3638,160,ITI,ITI2,10,Umbria,Umbria,882015,208751,23.67,1.06
3280,2021-07-10,UMB,7690,3810,3880,66,7610,14,ITI,ITI2,10,Umbria,Umbria,882015,216441,24.54,0.87
3281,2021-08-22,UMB,1469,772,697,478,977,14,ITI,ITI2,10,Umbria,Umbria,882015,217910,24.71,0.17
3282,2021-05-31,UMB,5824,2848,2976,4854,885,85,ITI,ITI2,10,Umbria,Umbria,882015,223734,25.37,0.66
3283,2021-05-14,UMB,5347,2526,2821,3355,1819,173,ITI,ITI2,10,Umbria,Umbria,882015,229081,25.97,0.61
3284,2021-02-01,UMB,1284,341,943,48,1236,0,ITI,ITI2,10,Umbria,Umbria,882015,230365,26.12,0.15
3285,2021-02-18,UMB,1497,583,914,1029,467,1,ITI,ITI2,10,Umbria,Umbria,882015,231862,26.29,0.17
3286,2021-07-08,UMB,9576,4634,4942,180,9349,47,ITI,ITI2,10,Umbria,Umbria,882015,241438,27.37,1.09
3287,2021-05-12,UMB,6528,3038,3490,4209,2149,170,ITI,ITI2,10,Umbria,Umbria,882015,247966,28.11,0.74
3288,2021-03-30,UMB,3988,1735,2253,2406,1544,38,ITI,ITI2,10,Umbria,Umbria,882015,251954,28.57,0.45
3289,2020-12-27,UMB,88,47,41,88,0,0,ITI,ITI2,10,Umbria,Umbria,882015,252042,28.58,0.01
3290,2021-04-04,UMB,57,20,37,22,35,0,ITI,ITI2,10,Umbria,Umbria,882015,252099,28.58,0.01
3291,2021-06-07,UMB,6959,3436,3523,6086,696,177,ITI,ITI2,10,Umbria,Umbria,882015,259058,29.37,0.79
3292,2021-03-16,UMB,3538,1454,2084,1909,1627,2,ITI,ITI2,10,Umbria,Umbria,882015,262596,29.77,0.4
3293,2021-02-27,UMB,1658,354,1304,1642,16,0,ITI,ITI2,10,Umbria,Umbria,882015,264254,29.96,0.19
3294,2021-04-03,UMB,2099,712,1387,1034,1054,11,ITI,ITI2,10,Umbria,Umbria,882015,266353,30.2,0.24
3295,2021-07-12,UMB,4631,2241,2390,105,4514,12,ITI,ITI2,10,Umbria,Umbria,882015,270984,30.72,0.53
3296,2021-02-06,UMB,435,162,273,34,401,0,ITI,ITI2,10,Umbria,Umbria,882015,271419,30.77,0.05
3297,2021-05-26,UMB,9665,4573,5092,8220,1253,192,ITI,ITI2,10,Umbria,Umbria,882015,281084,31.87,1.1
3298,2021-09-03,UMB,3460,1782,1678,1089,2321,50,ITI,ITI2,10,Umbria,Umbria,882015,284544,32.26,0.39
3299,2021-07-26,UMB,9090,4803,4287,3875,5088,127,ITI,ITI2,10,Umbria,Umbria,882015,293634,33.29,1.03
3300,2021-04-30,UMB,6257,2971,3286,2735,3400,122,ITI,ITI2,10,Umbria,Umbria,882015,299891,34.0,0.71
3301,2021-03-04,UMB,4485,1855,2630,3643,827,15,ITI,ITI2,10,Umbria,Umbria,882015,304376,34.51,0.51
3302,2021-08-08,UMB,5062,2711,2351,3551,1416,95,ITI,ITI2,10,Umbria,Umbria,882015,309438,35.08,0.57
3303,2021-01-20,UMB,603,221,382,603,0,0,ITI,ITI2,10,Umbria,Umbria,882015,310041,35.15,0.07
3304,2021-08-17,UMB,3664,1908,1756,2488,1088,88,ITI,ITI2,10,Umbria,Umbria,882015,313705,35.57,0.42
3305,2021-06-21,UMB,7552,3953,3599,5068,2338,146,ITI,ITI2,10,Umbria,Umbria,882015,321257,36.42,0.86
3306,2021-03-06,UMB,4307,1148,3159,4135,138,34,ITI,ITI2,10,Umbria,Umbria,882015,325564,36.91,0.49
3307,2021-01-22,UMB,276,105,171,32,244,0,ITI,ITI2,10,Umbria,Umbria,882015,325840,36.94,0.03
3308,2021-05-30,UMB,5982,2999,2983,5662,202,118,ITI,ITI2,10,Umbria,Umbria,882015,331822,37.62,0.68
3309,2021-03-08,UMB,3701,1825,1876,2327,1361,13,ITI,ITI2,10,Umbria,Umbria,882015,335523,38.04,0.42
3310,2021-06-16,UMB,6324,3095,3229,3070,3100,154,ITI,ITI2,10,Umbria,Umbria,882015,341847,38.76,0.72
3311,2021-03-25,UMB,3937,1728,2209,2826,1064,47,ITI,ITI2,10,Umbria,Umbria,882015,345784,39.2,0.45
3312,2021-03-27,UMB,4252,1514,2738,3856,340,56,ITI,ITI2,10,Umbria,Umbria,882015,350036,39.69,0.48
3313,2021-04-20,UMB,5451,2365,3086,3429,1947,75,ITI,ITI2,10,Umbria,Umbria,882015,355487,40.3,0.62
3314,2021-01-27,UMB,841,330,511,13,828,0,ITI,ITI2,10,Umbria,Umbria,882015,356328,40.4,0.1
3315,2021-01-10,UMB,1067,274,793,1067,0,0,ITI,ITI2,10,Umbria,Umbria,882015,357395,40.52,0.12
3316,2021-05-21,UMB,8981,3672,5309,4066,4830,85,ITI,ITI2,10,Umbria,Umbria,882015,366376,41.54,1.02
3317,2021-05-04,UMB,5544,2547,2997,2355,3127,62,ITI,ITI2,10,Umbria,Umbria,882015,371920,42.17,0.63
3318,2021-04-01,UMB,4474,1911,2563,2326,2110,38,ITI,ITI2,10,Umbria,Umbria,882015,376394,42.67,0.51
3319,2021-08-07,UMB,7231,3799,3432,2540,4619,72,ITI,ITI2,10,Umbria,Umbria,882015,383625,43.49,0.82
3320,2021-05-16,UMB,5227,2493,2734,5088,50,89,ITI,ITI2,10,Umbria,Umbria,882015,388852,44.09,0.59
3321,2021-08-24,UMB,4431,2246,2185,1868,2474,89,ITI,ITI2,10,Umbria,Umbria,882015,393283,44.59,0.5
3322,2021-02-22,UMB,1891,807,1084,1805,86,0,ITI,ITI2,10,Umbria,Umbria,882015,395174,44.8,0.21
3323,2021-06-11,UMB,7009,3519,3490,6001,772,236,ITI,ITI2,10,Umbria,Umbria,882015,402183,45.6,0.79
3324,2021-05-28,UMB,9600,4440,5160,7116,2300,184,ITI,ITI2,10,Umbria,Umbria,882015,411783,46.69,1.09
3325,2021-04-15,UMB,7665,3505,4160,5703,1889,73,ITI,ITI2,10,Umbria,Umbria,882015,419448,47.56,0.87
3326,2021-02-17,UMB,1619,748,871,1266,352,1,ITI,ITI2,10,Umbria,Umbria,882015,421067,47.74,0.18
3327,2021-07-24,UMB,8698,4368,4330,1347,7284,67,ITI,ITI2,10,Umbria,Umbria,882015,429765,48.73,0.99
3328,2021-04-13,UMB,7683,3402,4281,5924,1669,90,ITI,ITI2,10,Umbria,Umbria,882015,437448,49.6,0.87
3329,2021-02-15,UMB,1367,692,675,1364,1,2,ITI,ITI2,10,Umbria,Umbria,882015,438815,49.75,0.15
3330,2021-01-03,UMB,270,112,158,270,0,0,ITI,ITI2,10,Umbria,Umbria,882015,439085,49.78,0.03
3331,2021-07-31,UMB,4334,2262,2072,1478,2809,47,ITI,ITI2,10,Umbria,Umbria,882015,443419,50.27,0.49
3332,2021-04-22,UMB,5458,2251,3207,2702,2674,82,ITI,ITI2,10,Umbria,Umbria,882015,448877,50.89,0.62
3333,2021-03-01,UMB,1505,775,730,1385,114,6,ITI,ITI2,10,Umbria,Umbria,882015,450382,51.06,0.17
3334,2021-06-09,UMB,8162,3951,4211,7137,725,300,ITI,ITI2,10,Umbria,Umbria,882015,458544,51.99,0.93
3335,2021-06-23,UMB,11361,5807,5554,7682,3412,267,ITI,ITI2,10,Umbria,Umbria,882015,469905,53.28,1.29
3336,2021-03-15,UMB,4599,1941,2658,2827,1769,3,ITI,ITI2,10,Umbria,Umbria,882015,474504,53.8,0.52
3337,2021-02-10,UMB,715,350,365,700,15,0,ITI,ITI2,10,Umbria,Umbria,882015,475219,53.88,0.08
3338,2021-08-12,UMB,7350,3899,3451,4584,2546,220,ITI,ITI2,10,Umbria,Umbria,882015,482569,54.71,0.83
3339,2021-06-30,UMB,10551,5326,5225,3675,6724,152,ITI,ITI2,10,Umbria,Umbria,882015,493120,55.91,1.2
3340,2021-09-02,UMB,4355,2267,2088,959,3355,41,ITI,ITI2,10,Umbria,Umbria,882015,497475,56.4,0.49
3341,2021-07-07,UMB,9498,4502,4996,89,9379,30,ITI,ITI2,10,Umbria,Umbria,882015,506973,57.48,1.08
3342,2021-04-17,UMB,6695,3076,3619,5186,1342,167,ITI,ITI2,10,Umbria,Umbria,882015,513668,58.24,0.76
3343,2021-01-05,UMB,855,430,425,855,0,0,ITI,ITI2,10,Umbria,Umbria,882015,514523,58.33,0.1
3344,2021-08-05,UMB,9701,5076,4625,3842,5696,163,ITI,ITI2,10,Umbria,Umbria,882015,524224,59.43,1.1
3345,2021-07-19,UMB,7669,3842,3827,1525,6043,101,ITI,ITI2,10,Umbria,Umbria,882015,531893,60.3,0.87
3346,2021-04-27,UMB,5668,2401,3267,3054,2579,35,ITI,ITI2,10,Umbria,Umbria,882015,537561,60.95,0.64
3347,2021-02-03,UMB,727,174,553,67,660,0,ITI,ITI2,10,Umbria,Umbria,882015,538288,61.03,0.08
3348,2021-06-18,UMB,4813,2374,2439,1569,3165,79,ITI,ITI2,10,Umbria,Umbria,882015,543101,61.58,0.55
3349,2021-07-05,UMB,8423,4083,4340,153,8256,14,ITI,ITI2,10,Umbria,Umbria,882015,551524,62.53,0.95
3350,2021-05-13,UMB,5944,2671,3273,3730,2085,129,ITI,ITI2,10,Umbria,Umbria,882015,557468,63.2,0.67
3351,2021-08-21,UMB,2787,1464,1323,1607,1115,65,ITI,ITI2,10,Umbria,Umbria,882015,560255,63.52,0.32
3352,2021-02-19,UMB,743,293,450,525,217,1,ITI,ITI2,10,Umbria,Umbria,882015,560998,63.6,0.08
3353,2021-08-04,UMB,10666,5541,5125,3307,7193,166,ITI,ITI2,10,Umbria,Umbria,882015,571664,64.81,1.21
3354,2021-06-28,UMB,9830,4844,4986,3712,5990,128,ITI,ITI2,10,Umbria,Umbria,882015,581494,65.93,1.11
3355,2021-05-02,UMB,3782,1867,1915,1298,2455,29,ITI,ITI2,10,Umbria,Umbria,882015,585276,66.36,0.43
3356,2021-03-20,UMB,2320,845,1475,2290,25,5,ITI,ITI2,10,Umbria,Umbria,882015,587596,66.62,0.26
3357,2021-03-13,UMB,1735,524,1211,1486,249,0,ITI,ITI2,10,Umbria,Umbria,882015,589331,66.82,0.2
3358,2021-01-15,UMB,698,213,485,698,0,0,ITI,ITI2,10,Umbria,Umbria,882015,590029,66.9,0.08
3359,2021-01-29,UMB,1240,350,890,79,1161,0,ITI,ITI2,10,Umbria,Umbria,882015,591269,67.04,0.14
3360,2021-05-09,UMB,5764,2756,3008,5253,391,120,ITI,ITI2,10,Umbria,Umbria,882015,597033,67.69,0.65
3361,2021-04-08,UMB,5904,2525,3379,4026,1806,72,ITI,ITI2,10,Umbria,Umbria,882015,602937,68.36,0.67
3362,2021-07-17,UMB,7672,3855,3817,1287,6236,149,ITI,ITI2,10,Umbria,Umbria,882015,610609,69.23,0.87
3363,2021-06-04,UMB,8927,4413,4514,7541,1204,182,ITI,ITI2,10,Umbria,Umbria,882015,619536,70.24,1.01
3364,2021-06-13,UMB,6767,3558,3209,6393,230,144,ITI,ITI2,10,Umbria,Umbria,882015,626303,71.01,0.77
3365,2021-05-11,UMB,6260,2842,3418,3925,2193,142,ITI,ITI2,10,Umbria,Umbria,882015,632563,71.72,0.71
3366,2021-08-19,UMB,5719,3036,2683,3931,1610,178,ITI,ITI2,10,Umbria,Umbria,882015,638282,72.37,0.65
3367,2021-08-26,UMB,4059,2151,1908,1791,2158,110,ITI,ITI2,10,Umbria,Umbria,882015,642341,72.83,0.46
3368,2021-08-23,UMB,5289,2820,2469,1542,3662,85,ITI,ITI2,10,Umbria,Umbria,882015,647630,73.43,0.6
3369,2021-06-01,UMB,4388,2090,2298,4160,156,72,ITI,ITI2,10,Umbria,Umbria,882015,652018,73.92,0.5
3370,2021-03-10,UMB,4032,1943,2089,2760,1257,15,ITI,ITI2,10,Umbria,Umbria,882015,656050,74.38,0.46
3371,2021-01-16,UMB,203,61,142,202,0,1,ITI,ITI2,10,Umbria,Umbria,882015,656253,74.4,0.02
3372,2021-02-02,UMB,945,272,673,32,913,0,ITI,ITI2,10,Umbria,Umbria,882015,657198,74.51,0.11
3373,2021-01-24,UMB,258,106,152,1,257,0,ITI,ITI2,10,Umbria,Umbria,882015,657456,74.54,0.03
3374,2021-08-16,UMB,3517,1741,1776,1977,1472,68,ITI,ITI2,10,Umbria,Umbria,882015,660973,74.94,0.4
3375,2021-08-30,UMB,1950,950,1000,1500,372,78,ITI,ITI2,10,Umbria,Umbria,882015,662923,75.16,0.22
3376,2021-06-08,UMB,7397,3647,3750,6638,550,209,ITI,ITI2,10,Umbria,Umbria,882015,670320,76.0,0.84
3377,2021-02-05,UMB,783,234,549,18,765,0,ITI,ITI2,10,Umbria,Umbria,882015,671103,76.09,0.09
3378,2021-07-21,UMB,9855,4914,4941,1233,8535,87,ITI,ITI2,10,Umbria,Umbria,882015,680958,77.2,1.12
3379,2021-07-04,UMB,3411,1741,1670,2343,970,98,ITI,ITI2,10,Umbria,Umbria,882015,684369,77.59,0.39
3380,2021-04-12,UMB,7093,3081,4012,5316,1717,60,ITI,ITI2,10,Umbria,Umbria,882015,691462,78.4,0.8
3381,2021-01-19,UMB,102,23,79,102,0,0,ITI,ITI2,10,Umbria,Umbria,882015,691564,78.41,0.01
3382,2021-04-29,UMB,5239,2260,2979,2806,2342,91,ITI,ITI2,10,Umbria,Umbria,882015,696803,79.0,0.59
3383,2021-03-24,UMB,4105,1792,2313,2745,1323,37,ITI,ITI2,10,Umbria,Umbria,882015,700908,79.47,0.47
3384,2021-07-02,UMB,8757,4331,4426,2969,5609,179,ITI,ITI2,10,Umbria,Umbria,882015,709665,80.46,0.99
3385,2021-08-02,UMB,5537,2897,2640,259,5256,22,ITI,ITI2,10,Umbria,Umbria,882015,715202,81.09,0.63
3386,2021-06-20,UMB,6225,3007,3218,1577,4605,43,ITI,ITI2,10,Umbria,Umbria,882015,721427,81.79,0.71
3387,2021-04-24,UMB,4566,1962,2604,3277,1183,106,ITI,ITI2,10,Umbria,Umbria,882015,725993,82.31,0.52
3388,2021-01-12,UMB,838,247,591,838,0,0,ITI,ITI2,10,Umbria,Umbria,882015,726831,82.41,0.1
3389,2021-03-14,UMB,66,48,18,66,0,0,ITI,ITI2,10,Umbria,Umbria,882015,726897,82.41,0.01
3390,2021-06-22,UMB,8089,4104,3985,5148,2798,143,ITI,ITI2,10,Umbria,Umbria,882015,734986,83.33,0.92
3391,2021-03-12,UMB,2695,1082,1613,2191,496,8,ITI,ITI2,10,Umbria,Umbria,882015,737681,83.64,0.31
3392,2021-03-21,UMB,676,338,338,673,0,3,ITI,ITI2,10,Umbria,Umbria,882015,738357,83.71,0.08
3393,2021-08-25,UMB,4285,2229,2056,1541,2664,80,ITI,ITI2,10,Umbria,Umbria,882015,742642,84.2,0.49
3394,2021-06-29,UMB,9974,5083,4891,4112,5702,160,ITI,ITI2,10,Umbria,Umbria,882015,752616,85.33,1.13
3395,2021-07-09,UMB,9569,4631,4938,128,9417,24,ITI,ITI2,10,Umbria,Umbria,882015,762185,86.41,1.08
3396,2021-07-23,UMB,10662,5452,5210,1331,9225,106,ITI,ITI2,10,Umbria,Umbria,882015,772847,87.62,1.21
3397,2021-08-28,UMB,2768,1428,1340,1356,1341,71,ITI,ITI2,10,Umbria,Umbria,882015,775615,87.94,0.31
3398,2021-07-16,UMB,9630,4899,4731,667,8884,79,ITI,ITI2,10,Umbria,Umbria,882015,785245,89.03,1.09
3399,2021-05-20,UMB,9870,4609,5261,6103,3657,110,ITI,ITI2,10,Umbria,Umbria,882015,795115,90.15,1.12
3400,2021-06-27,UMB,7480,3738,3742,1732,5672,76,ITI,ITI2,10,Umbria,Umbria,882015,802595,91.0,0.85
3401,2021-07-28,UMB,8239,4334,3905,2971,5155,113,ITI,ITI2,10,Umbria,Umbria,882015,810834,91.93,0.93
3402,2021-04-26,UMB,5402,2342,3060,3105,2255,42,ITI,ITI2,10,Umbria,Umbria,882015,816236,92.54,0.61
3403,2021-04-09,UMB,6749,3130,3619,6411,216,122,ITI,ITI2,10,Umbria,Umbria,882015,822985,93.31,0.77
3404,2021-04-28,UMB,5393,2331,3062,2938,2398,57,ITI,ITI2,10,Umbria,Umbria,882015,828378,93.92,0.61
3405,2021-08-06,UMB,8238,4308,3930,3329,4821,88,ITI,ITI2,10,Umbria,Umbria,882015,836616,94.85,0.93
3406,2021-02-04,UMB,736,226,510,26,710,0,ITI,ITI2,10,Umbria,Umbria,882015,837352,94.94,0.08
3407,2021-05-15,UMB,4996,1885,3111,1765,3167,64,ITI,ITI2,10,Umbria,Umbria,882015,842348,95.5,0.57
3408,2021-02-21,UMB,1,0,1,1,0,0,ITI,ITI2,10,Umbria,Umbria,882015,842349,95.5,0.0
3409,2021-05-01,UMB,5376,2641,2735,2099,3231,46,ITI,ITI2,10,Umbria,Umbria,882015,847725,96.11,0.61
3410,2021-03-05,UMB,4623,1403,3220,3950,658,15,ITI,ITI2,10,Umbria,Umbria,882015,852348,96.64,0.52
3411,2021-08-09,UMB,6693,3546,3147,3502,3031,160,ITI,ITI2,10,Umbria,Umbria,882015,859041,97.4,0.76
3412,2021-03-03,UMB,4433,1772,2661,3719,711,3,ITI,ITI2,10,Umbria,Umbria,882015,863474,97.9,0.5
3413,2021-08-11,UMB,7621,4087,3534,3722,3715,184,ITI,ITI2,10,Umbria,Umbria,882015,871095,98.76,0.86
3414,2021-03-31,UMB,3900,1730,2170,2183,1685,32,ITI,ITI2,10,Umbria,Umbria,882015,874995,99.2,0.44
3415,2021-02-16,UMB,1308,655,653,1299,9,0,ITI,ITI2,10,Umbria,Umbria,882015,876303,99.35,0.15
3416,2021-05-27,UMB,9982,4871,5111,8475,1325,182,ITI,ITI2,10,Umbria,Umbria,882015,886285,100.48,1.13
3417,2021-01-04,UMB,810,397,413,810,0,0,ITI,ITI2,10,Umbria,Umbria,882015,887095,100.58,0.09
3418,2021-04-14,UMB,8159,3682,4477,6100,1980,79,ITI,ITI2,10,Umbria,Umbria,882015,895254,101.5,0.93
3419,2021-06-03,UMB,9050,4474,4576,8585,290,175,ITI,ITI2,10,Umbria,Umbria,882015,904304,102.53,1.03
3420,2021-04-07,UMB,5626,2305,3321,3534,2006,86,ITI,ITI2,10,Umbria,Umbria,882015,909930,103.16,0.64
3421,2021-02-23,UMB,1691,657,1034,1648,42,1,ITI,ITI2,10,Umbria,Umbria,882015,911621,103.36,0.19
3422,2021-06-06,UMB,7610,3906,3704,6790,694,126,ITI,ITI2,10,Umbria,Umbria,882015,919231,104.22,0.86
3423,2021-02-24,UMB,1521,564,957,1506,15,0,ITI,ITI2,10,Umbria,Umbria,882015,920752,104.39,0.17
3424,2021-08-18,UMB,4696,2457,2239,3432,1146,118,ITI,ITI2,10,Umbria,Umbria,882015,925448,104.92,0.53
3425,2021-07-06,UMB,8599,4093,4506,150,8426,23,ITI,ITI2,10,Umbria,Umbria,882015,934047,105.9,0.97
3426,2021-05-10,UMB,6011,2813,3198,3742,2152,117,ITI,ITI2,10,Umbria,Umbria,882015,940058,106.58,0.68
3427,2021-05-17,UMB,6378,3068,3310,4112,2180,86,ITI,ITI2,10,Umbria,Umbria,882015,946436,107.3,0.72
3428,2021-01-14,UMB,725,192,533,725,0,0,ITI,ITI2,10,Umbria,Umbria,882015,947161,107.39,0.08
3429,2021-03-19,UMB,1744,566,1178,1083,656,5,ITI,ITI2,10,Umbria,Umbria,882015,948905,107.58,0.2
3430,2021-05-08,UMB,8162,3749,4413,4806,3250,106,ITI,ITI2,10,Umbria,Umbria,882015,957067,108.51,0.93
3431,2021-01-28,UMB,1248,394,854,18,1230,0,ITI,ITI2,10,Umbria,Umbria,882015,958315,108.65,0.14
3432,2021-05-03,UMB,5091,2273,2818,2099,2888,104,ITI,ITI2,10,Umbria,Umbria,882015,963406,109.23,0.58
3433,2021-01-23,UMB,280,100,180,2,278,0,ITI,ITI2,10,Umbria,Umbria,882015,963686,109.26,0.03
3434,2021-01-21,UMB,609,203,406,339,269,1,ITI,ITI2,10,Umbria,Umbria,882015,964295,109.33,0.07
3435,2021-08-20,UMB,4340,2312,2028,2919,1277,144,ITI,ITI2,10,Umbria,Umbria,882015,968635,109.82,0.49
3436,2021-02-11,UMB,839,348,491,834,5,0,ITI,ITI2,10,Umbria,Umbria,882015,969474,109.92,0.1
3437,2021-05-22,UMB,6983,2761,4222,2602,4332,49,ITI,ITI2,10,Umbria,Umbria,882015,976457,110.71,0.79
3438,2021-04-10,UMB,7403,3481,3922,7183,85,135,ITI,ITI2,10,Umbria,Umbria,882015,983860,111.55,0.84
3439,2021-01-17,UMB,55,17,38,55,0,0,ITI,ITI2,10,Umbria,Umbria,882015,983915,111.55,0.01
3440,2020-12-31,UMB,322,127,195,322,0,0,ITI,ITI2,10,Umbria,Umbria,882015,984237,111.59,0.04
3441,2021-06-15,UMB,5990,3016,2974,3798,2074,118,ITI,ITI2,10,Umbria,Umbria,882015,990227,112.27,0.68
3442,2021-07-11,UMB,5875,2967,2908,89,5785,1,ITI,ITI2,10,Umbria,Umbria,882015,996102,112.93,0.67
3443,2021-04-02,UMB,4348,1781,2567,3548,755,45,ITI,ITI2,10,Umbria,Umbria,882015,1000450,113.43,0.49
3444,2021-01-09,UMB,1718,495,1223,1718,0,0,ITI,ITI2,10,Umbria,Umbria,882015,1002168,113.62,0.19
3445,2021-04-19,UMB,5038,2228,2810,2933,2048,57,ITI,ITI2,10,Umbria,Umbria,882015,1007206,114.19,0.57
3446,2021-03-29,UMB,3638,1604,2034,2153,1424,61,ITI,ITI2,10,Umbria,Umbria,882015,1010844,114.61,0.41
3447,2021-01-31,UMB,1061,276,785,25,1036,0,ITI,ITI2,10,Umbria,Umbria,882015,1011905,114.73,0.12
3448,2021-05-25,UMB,8824,4302,4522,7587,1064,173,ITI,ITI2,10,Umbria,Umbria,882015,1020729,115.73,1.0
3449,2021-05-18,UMB,7768,3364,4404,3837,3841,90,ITI,ITI2,10,Umbria,Umbria,882015,1028497,116.61,0.88
3450,2021-03-22,UMB,3562,1657,1905,2306,1246,10,ITI,ITI2,10,Umbria,Umbria,882015,1032059,117.01,0.4
3451,2021-04-05,UMB,4251,1729,2522,2182,2057,12,ITI,ITI2,10,Umbria,Umbria,882015,1036310,117.49,0.48
3452,2021-02-07,UMB,55,17,38,1,54,0,ITI,ITI2,10,Umbria,Umbria,882015,1036365,117.5,0.01
3453,2021-07-14,UMB,6206,3010,3196,1634,4264,308,ITI,ITI2,10,Umbria,Umbria,882015,1042571,118.2,0.7
3454,2021-08-01,UMB,3026,1532,1494,1330,1650,46,ITI,ITI2,10,Umbria,Umbria,882015,1045597,118.55,0.34
3455,2021-07-18,UMB,7853,4063,3790,273,7553,27,ITI,ITI2,10,Umbria,Umbria,882015,1053450,119.44,0.89
3456,2021-06-05,UMB,8232,3777,4455,5416,2655,161,ITI,ITI2,10,Umbria,Umbria,882015,1061682,120.37,0.93
3457,2021-07-25,UMB,7308,3850,3458,1166,6098,44,ITI,ITI2,10,Umbria,Umbria,882015,1068990,121.2,0.83
3458,2021-06-17,UMB,6979,3545,3434,4752,2081,146,ITI,ITI2,10,Umbria,Umbria,882015,1075969,121.99,0.79
3459,2021-03-26,UMB,4602,1721,2881,4345,173,84,ITI,ITI2,10,Umbria,Umbria,882015,1080571,122.51,0.52
3460,2021-01-02,UMB,304,111,193,304,0,0,ITI,ITI2,10,Umbria,Umbria,882015,1080875,122.55,0.03
3461,2021-03-07,UMB,846,180,666,838,7,1,ITI,ITI2,10,Umbria,Umbria,882015,1081721,122.64,0.1
3462,2021-05-29,UMB,7861,3613,4248,6177,1570,114,ITI,ITI2,10,Umbria,Umbria,882015,1089582,123.53,0.89
3463,2021-01-08,UMB,1193,344,849,1193,0,0,ITI,ITI2,10,Umbria,Umbria,882015,1090775,123.67,0.14
3464,2021-05-23,UMB,5074,1857,3217,637,4421,16,ITI,ITI2,10,Umbria,Umbria,882015,1095849,124.24,0.58
3465,2021-08-31,UMB,4128,2133,1995,1222,2836,70,ITI,ITI2,10,Umbria,Umbria,882015,1099977,124.71,0.47
3466,2021-08-14,UMB,5850,3232,2618,2917,2785,148,ITI,ITI2,10,Umbria,Umbria,882015,1105827,125.38,0.66
3467,2021-03-17,UMB,3331,1313,2018,1855,1474,2,ITI,ITI2,10,Umbria,Umbria,882015,1109158,125.75,0.38
3468,2021-01-07,UMB,1301,388,913,1301,0,0,ITI,ITI2,10,Umbria,Umbria,882015,1110459,125.9,0.15
3469,2021-06-25,UMB,10242,5318,4924,5254,4784,204,ITI,ITI2,10,Umbria,Umbria,882015,1120701,127.06,1.16
3470,2021-01-26,UMB,816,390,426,17,799,0,ITI,ITI2,10,Umbria,Umbria,882015,1121517,127.15,0.09
3471,2021-02-12,UMB,673,224,449,667,6,0,ITI,ITI2,10,Umbria,Umbria,882015,1122190,127.23,0.08
3472,2021-02-26,UMB,660,253,407,650,8,2,ITI,ITI2,10,Umbria,Umbria,882015,1122850,127.31,0.07
3473,2021-05-06,UMB,9474,4326,5148,6029,3316,129,ITI,ITI2,10,Umbria,Umbria,882015,1132324,128.38,1.07
3474,2021-09-01,UMB,4581,2359,2222,1132,3391,58,ITI,ITI2,10,Umbria,Umbria,882015,1136905,128.9,0.52
3475,2021-06-10,UMB,7566,3769,3797,6463,789,314,ITI,ITI2,10,Umbria,Umbria,882015,1144471,129.76,0.86
3476,2021-08-13,UMB,6967,3868,3099,4245,2524,198,ITI,ITI2,10,Umbria,Umbria,882015,1151438,130.55,0.79
3477,2021-07-13,UMB,4234,2006,2228,78,4148,8,ITI,ITI2,10,Umbria,Umbria,882015,1155672,131.03,0.48
3478,2021-04-21,UMB,5330,2320,3010,3060,2231,39,ITI,ITI2,10,Umbria,Umbria,882015,1161002,131.63,0.6
3479,2021-07-30,UMB,6219,3243,2976,3186,2913,120,ITI,ITI2,10,Umbria,Umbria,882015,1167221,132.34,0.71
3480,2021-03-02,UMB,3645,1346,2299,3636,6,3,ITI,ITI2,10,Umbria,Umbria,882015,1170866,132.75,0.41
3481,2021-06-24,UMB,10267,5169,5098,6027,4012,228,ITI,ITI2,10,Umbria,Umbria,882015,1181133,133.91,1.16
3482,2021-02-05,VDA,296,103,193,102,194,0,ITC,ITC2,2,Valle d'Aosta / Vallée d'Aoste,Valle d'Aosta,125666,296,0.24,0.24
3483,2021-02-22,VDA,317,94,223,211,104,2,ITC,ITC2,2,Valle d'Aosta / Vallée d'Aoste,Valle d'Aosta,125666,613,0.49,0.25
3484,2021-05-16,VDA,690,342,348,341,342,7,ITC,ITC2,2,Valle d'Aosta / Vallée d'Aoste,Valle d'Aosta,125666,1303,1.04,0.55
3485,2021-08-07,VDA,739,433,306,304,421,14,ITC,ITC2,2,Valle d'Aosta / Vallée d'Aoste,Valle d'Aosta,125666,2042,1.62,0.59
3486,2021-05-02,VDA,765,345,420,581,160,24,ITC,ITC2,2,Valle d'Aosta / Vallée d'Aoste,Valle d'Aosta,125666,2807,2.23,0.61
3487,2021-01-22,VDA,58,22,36,22,36,0,ITC,ITC2,2,Valle d'Aosta / Vallée d'Aoste,Valle d'Aosta,125666,2865,2.28,0.05
3488,2021-01-08,VDA,301,131,170,301,0,0,ITC,ITC2,2,Valle d'Aosta / Vallée d'Aoste,Valle d'Aosta,125666,3166,2.52,0.24
3489,2021-03-06,VDA,22,4,18,18,0,4,ITC,ITC2,2,Valle d'Aosta / Vallée d'Aoste,Valle d'Aosta,125666,3188,2.54,0.02
3490,2021-05-30,VDA,865,429,436,682,171,12,ITC,ITC2,2,Valle d'Aosta / Vallée d'Aoste,Valle d'Aosta,125666,4053,3.23,0.69
3491,2021-07-26,VDA,1006,512,494,316,682,8,ITC,ITC2,2,Valle d'Aosta / Vallée d'Aoste,Valle d'Aosta,125666,5059,4.03,0.8
3492,2021-05-28,VDA,977,415,562,546,413,18,ITC,ITC2,2,Valle d'Aosta / Vallée d'Aoste,Valle d'Aosta,125666,6036,4.8,0.78
3493,2021-02-17,VDA,329,146,183,225,101,3,ITC,ITC2,2,Valle d'Aosta / Vallée d'Aoste,Valle d'Aosta,125666,6365,5.07,0.26
3494,2021-04-15,VDA,814,378,436,643,140,31,ITC,ITC2,2,Valle d'Aosta / Vallée d'Aoste,Valle d'Aosta,125666,7179,5.71,0.65
3495,2021-07-07,VDA,794,441,353,414,363,17,ITC,ITC2,2,Valle d'Aosta / Vallée d'Aoste,Valle d'Aosta,125666,7973,6.34,0.63
3496,2021-07-24,VDA,1019,536,483,331,682,6,ITC,ITC2,2,Valle d'Aosta / Vallée d'Aoste,Valle d'Aosta,125666,8992,7.16,0.81
3497,2021-07-12,VDA,979,483,496,238,733,8,ITC,ITC2,2,Valle d'Aosta / Vallée d'Aoste,Valle d'Aosta,125666,9971,7.93,0.78
3498,2021-04-03,VDA,676,341,335,649,15,12,ITC,ITC2,2,Valle d'Aosta / Vallée d'Aoste,Valle d'Aosta,125666,10647,8.47,0.54
3499,2021-03-20,VDA,209,87,122,168,36,5,ITC,ITC2,2,Valle d'Aosta / Vallée d'Aoste,Valle d'Aosta,125666,10856,8.64,0.17
3500,2021-06-28,VDA,990,497,493,327,659,4,ITC,ITC2,2,Valle d'Aosta / Vallée d'Aoste,Valle d'Aosta,125666,11846,9.43,0.79
3501,2021-06-11,VDA,1048,484,564,753,283,12,ITC,ITC2,2,Valle d'Aosta / Vallée d'Aoste,Valle d'Aosta,125666,12894,10.26,0.83
3502,2021-01-27,VDA,156,75,81,80,76,0,ITC,ITC2,2,Valle d'Aosta / Vallée d'Aoste,Valle d'Aosta,125666,13050,10.38,0.12
3503,2021-04-20,VDA,935,430,505,710,194,31,ITC,ITC2,2,Valle d'Aosta / Vallée d'Aoste,Valle d'Aosta,125666,13985,11.13,0.74
3504,2021-01-10,VDA,220,71,149,212,0,8,ITC,ITC2,2,Valle d'Aosta / Vallée d'Aoste,Valle d'Aosta,125666,14205,11.3,0.18
3505,2020-12-27,VDA,20,9,11,20,0,0,ITC,ITC2,2,Valle d'Aosta / Vallée d'Aoste,Valle d'Aosta,125666,14225,11.32,0.02
3506,2021-09-02,VDA,520,271,249,89,416,15,ITC,ITC2,2,Valle d'Aosta / Vallée d'Aoste,Valle d'Aosta,125666,14745,11.73,0.41
3507,2021-02-03,VDA,354,116,238,15,339,0,ITC,ITC2,2,Valle d'Aosta / Vallée d'Aoste,Valle d'Aosta,125666,15099,12.02,0.28
3508,2021-04-01,VDA,778,394,384,747,12,19,ITC,ITC2,2,Valle d'Aosta / Vallée d'Aoste,Valle d'Aosta,125666,15877,12.63,0.62
3509,2021-03-08,VDA,488,233,255,240,245,3,ITC,ITC2,2,Valle d'Aosta / Vallée d'Aoste,Valle d'Aosta,125666,16365,13.02,0.39
3510,2021-08-12,VDA,375,204,171,115,248,12,ITC,ITC2,2,Valle d'Aosta / Vallée d'Aoste,Valle d'Aosta,125666,16740,13.32,0.3
3511,2021-05-04,VDA,1136,511,625,435,674,27,ITC,ITC2,2,Valle d'Aosta / Vallée d'Aoste,Valle d'Aosta,125666,17876,14.23,0.9
3512,2021-06-16,VDA,1064,565,499,666,394,4,ITC,ITC2,2,Valle d'Aosta / Vallée d'Aoste,Valle d'Aosta,125666,18940,15.07,0.85
3513,2021-03-15,VDA,387,141,246,175,203,9,ITC,ITC2,2,Valle d'Aosta / Vallée d'Aoste,Valle d'Aosta,125666,19327,15.38,0.31
3514,2021-08-19,VDA,265,158,107,70,180,15,ITC,ITC2,2,Valle d'Aosta / Vallée d'Aoste,Valle d'Aosta,125666,19592,15.59,0.21
3515,2021-05-11,VDA,649,326,323,472,150,27,ITC,ITC2,2,Valle d'Aosta / Vallée d'Aoste,Valle d'Aosta,125666,20241,16.11,0.52
3516,2021-04-27,VDA,979,424,555,653,292,34,ITC,ITC2,2,Valle d'Aosta / Vallée d'Aoste,Valle d'Aosta,125666,21220,16.89,0.78
3517,2021-01-17,VDA,131,56,75,131,0,0,ITC,ITC2,2,Valle d'Aosta / Vallée d'Aoste,Valle d'Aosta,125666,21351,16.99,0.1
3518,2021-06-23,VDA,1044,551,493,422,617,5,ITC,ITC2,2,Valle d'Aosta / Vallée d'Aoste,Valle d'Aosta,125666,22395,17.82,0.83
3519,2021-08-14,VDA,465,256,209,135,314,16,ITC,ITC2,2,Valle d'Aosta / Vallée d'Aoste,Valle d'Aosta,125666,22860,18.19,0.37
3520,2021-03-13,VDA,147,88,59,141,0,6,ITC,ITC2,2,Valle d'Aosta / Vallée d'Aoste,Valle d'Aosta,125666,23007,18.31,0.12
3521,2021-01-15,VDA,220,83,137,220,0,0,ITC,ITC2,2,Valle d'Aosta / Vallée d'Aoste,Valle d'Aosta,125666,23227,18.48,0.18
3522,2021-06-04,VDA,910,385,525,468,435,7,ITC,ITC2,2,Valle d'Aosta / Vallée d'Aoste,Valle d'Aosta,125666,24137,19.21,0.72
3523,2021-08-26,VDA,342,167,175,82,253,7,ITC,ITC2,2,Valle d'Aosta / Vallée d'Aoste,Valle d'Aosta,125666,24479,19.48,0.27
3524,2021-07-23,VDA,974,485,489,359,608,7,ITC,ITC2,2,Valle d'Aosta / Vallée d'Aoste,Valle d'Aosta,125666,25453,20.25,0.78
3525,2021-06-09,VDA,1053,559,494,1010,35,8,ITC,ITC2,2,Valle d'Aosta / Vallée d'Aoste,Valle d'Aosta,125666,26506,21.09,0.84
3526,2021-03-01,VDA,181,66,115,139,34,8,ITC,ITC2,2,Valle d'Aosta / Vallée d'Aoste,Valle d'Aosta,125666,26687,21.24,0.14
3527,2021-02-15,VDA,264,136,128,226,35,3,ITC,ITC2,2,Valle d'Aosta / Vallée d'Aoste,Valle d'Aosta,125666,26951,21.45,0.21
3528,2021-04-13,VDA,373,171,202,312,44,17,ITC,ITC2,2,Valle d'Aosta / Vallée d'Aoste,Valle d'Aosta,125666,27324,21.74,0.3
3529,2021-07-05,VDA,836,357,479,313,510,13,ITC,ITC2,2,Valle d'Aosta / Vallée d'Aoste,Valle d'Aosta,125666,28160,22.41,0.67
3530,2021-03-27,VDA,337,166,171,292,31,14,ITC,ITC2,2,Valle d'Aosta / Vallée d'Aoste,Valle d'Aosta,125666,28497,22.68,0.27
3531,2021-06-18,VDA,1000,443,557,586,400,14,ITC,ITC2,2,Valle d'Aosta / Vallée d'Aoste,Valle d'Aosta,125666,29497,23.47,0.8
3532,2021-02-10,VDA,248,77,171,141,107,0,ITC,ITC2,2,Valle d'Aosta / Vallée d'Aoste,Valle d'Aosta,125666,29745,23.67,0.2
3533,2021-03-25,VDA,389,154,235,364,10,15,ITC,ITC2,2,Valle d'Aosta / Vallée d'Aoste,Valle d'Aosta,125666,30134,23.98,0.31
3534,2021-05-21,VDA,933,443,490,523,401,9,ITC,ITC2,2,Valle d'Aosta / Vallée d'Aoste,Valle d'Aosta,125666,31067,24.72,0.74
3535,2021-04-17,VDA,638,407,231,596,2,40,ITC,ITC2,2,Valle d'Aosta / Vallée d'Aoste,Valle d'Aosta,125666,31705,25.23,0.51
3536,2021-01-07,VDA,280,113,167,280,0,0,ITC,ITC2,2,Valle d'Aosta / Vallée d'Aoste,Valle d'Aosta,125666,31985,25.45,0.22
3537,2021-05-23,VDA,999,465,534,654,340,5,ITC,ITC2,2,Valle d'Aosta / Vallée d'Aoste,Valle d'Aosta,125666,32984,26.25,0.79
3538,2021-01-29,VDA,321,139,182,2,319,0,ITC,ITC2,2,Valle d'Aosta / Vallée d'Aoste,Valle d'Aosta,125666,33305,26.5,0.26
3539,2021-08-31,VDA,672,344,328,135,531,6,ITC,ITC2,2,Valle d'Aosta / Vallée d'Aoste,Valle d'Aosta,125666,33977,27.04,0.53
3540,2021-04-22,VDA,1068,450,618,652,383,33,ITC,ITC2,2,Valle d'Aosta / Vallée d'Aoste,Valle d'Aosta,125666,35045,27.89,0.85
3541,2021-05-09,VDA,574,287,287,425,130,19,ITC,ITC2,2,Valle d'Aosta / Vallée d'Aoste,Valle d'Aosta,125666,35619,28.34,0.46
3542,2021-07-31,VDA,890,465,425,318,558,14,ITC,ITC2,2,Valle d'Aosta / Vallée d'Aoste,Valle d'Aosta,125666,36509,29.05,0.71
3543,2021-07-19,VDA,878,460,418,253,618,7,ITC,ITC2,2,Valle d'Aosta / Vallée d'Aoste,Valle d'Aosta,125666,37387,29.75,0.7
3544,2021-02-24,VDA,185,84,101,163,21,1,ITC,ITC2,2,Valle d'Aosta / Vallée d'Aoste,Valle d'Aosta,125666,37572,29.9,0.15
3545,2021-04-08,VDA,585,282,303,420,144,21,ITC,ITC2,2,Valle d'Aosta / Vallée d'Aoste,Valle d'Aosta,125666,38157,30.36,0.47
3546,2021-06-13,VDA,857,403,454,372,482,3,ITC,ITC2,2,Valle d'Aosta / Vallée d'Aoste,Valle d'Aosta,125666,39014,31.05,0.68
3547,2021-06-30,VDA,1120,543,577,416,695,9,ITC,ITC2,2,Valle d'Aosta / Vallée d'Aoste,Valle d'Aosta,125666,40134,31.94,0.89
3548,2021-03-31,VDA,555,302,253,511,26,18,ITC,ITC2,2,Valle d'Aosta / Vallée d'Aoste,Valle d'Aosta,125666,40689,32.38,0.44
3549,2021-05-27,VDA,1093,498,595,575,506,12,ITC,ITC2,2,Valle d'Aosta / Vallée d'Aoste,Valle d'Aosta,125666,41782,33.25,0.87
3550,2021-05-13,VDA,1146,561,585,523,602,21,ITC,ITC2,2,Valle d'Aosta / Vallée d'Aoste,Valle d'Aosta,125666,42928,34.16,0.91
3551,2021-02-02,VDA,287,73,214,3,284,0,ITC,ITC2,2,Valle d'Aosta / Vallée d'Aoste,Valle d'Aosta,125666,43215,34.39,0.23
3552,2021-07-09,VDA,945,446,499,279,656,10,ITC,ITC2,2,Valle d'Aosta / Vallée d'Aoste,Valle d'Aosta,125666,44160,35.14,0.75
3553,2021-06-25,VDA,978,445,533,325,651,2,ITC,ITC2,2,Valle d'Aosta / Vallée d'Aoste,Valle d'Aosta,125666,45138,35.92,0.78
3554,2021-08-21,VDA,441,221,220,93,331,17,ITC,ITC2,2,Valle d'Aosta / Vallée d'Aoste,Valle d'Aosta,125666,45579,36.27,0.35
3555,2021-01-19,VDA,256,77,179,256,0,0,ITC,ITC2,2,Valle d'Aosta / Vallée d'Aoste,Valle d'Aosta,125666,45835,36.47,0.2
3556,2021-04-12,VDA,487,187,300,305,164,18,ITC,ITC2,2,Valle d'Aosta / Vallée d'Aoste,Valle d'Aosta,125666,46322,36.86,0.39
3557,2021-04-29,VDA,1293,636,657,742,532,19,ITC,ITC2,2,Valle d'Aosta / Vallée d'Aoste,Valle d'Aosta,125666,47615,37.89,1.03
3558,2021-07-21,VDA,1168,638,530,311,849,8,ITC,ITC2,2,Valle d'Aosta / Vallée d'Aoste,Valle d'Aosta,125666,48783,38.82,0.93
3559,2021-07-04,VDA,1192,530,662,349,829,14,ITC,ITC2,2,Valle d'Aosta / Vallée d'Aoste,Valle d'Aosta,125666,49975,39.77,0.95
3560,2021-05-25,VDA,1117,532,585,530,575,12,ITC,ITC2,2,Valle d'Aosta / Vallée d'Aoste,Valle d'Aosta,125666,51092,40.66,0.89
3561,2021-02-14,VDA,48,16,32,1,47,0,ITC,ITC2,2,Valle d'Aosta / Vallée d'Aoste,Valle d'Aosta,125666,51140,40.7,0.04
3562,2021-05-08,VDA,908,543,365,500,382,26,ITC,ITC2,2,Valle d'Aosta / Vallée d'Aoste,Valle d'Aosta,125666,52048,41.42,0.72
3563,2021-03-29,VDA,494,233,261,450,40,4,ITC,ITC2,2,Valle d'Aosta / Vallée d'Aoste,Valle d'Aosta,125666,52542,41.81,0.39
3564,2021-06-20,VDA,1132,545,587,478,644,10,ITC,ITC2,2,Valle d'Aosta / Vallée d'Aoste,Valle d'Aosta,125666,53674,42.71,0.9
3565,2021-03-12,VDA,535,177,358,301,226,8,ITC,ITC2,2,Valle d'Aosta / Vallée d'Aoste,Valle d'Aosta,125666,54209,43.14,0.43
3566,2021-02-19,VDA,292,102,190,267,24,1,ITC,ITC2,2,Valle d'Aosta / Vallée d'Aoste,Valle d'Aosta,125666,54501,43.37,0.23
3567,2021-08-04,VDA,1046,571,475,370,658,18,ITC,ITC2,2,Valle d'Aosta / Vallée d'Aoste,Valle d'Aosta,125666,55547,44.2,0.83
3568,2021-01-05,VDA,151,55,96,151,0,0,ITC,ITC2,2,Valle d'Aosta / Vallée d'Aoste,Valle d'Aosta,125666,55698,44.32,0.12
3569,2021-01-14,VDA,237,69,168,237,0,0,ITC,ITC2,2,Valle d'Aosta / Vallée d'Aoste,Valle d'Aosta,125666,55935,44.51,0.19
3570,2021-08-02,VDA,760,407,353,304,446,10,ITC,ITC2,2,Valle d'Aosta / Vallée d'Aoste,Valle d'Aosta,125666,56695,45.12,0.6
3571,2021-04-24,VDA,723,401,322,534,167,22,ITC,ITC2,2,Valle d'Aosta / Vallée d'Aoste,Valle d'Aosta,125666,57418,45.69,0.58
3572,2021-06-08,VDA,772,408,364,731,33,8,ITC,ITC2,2,Valle d'Aosta / Vallée d'Aoste,Valle d'Aosta,125666,58190,46.31,0.61
3573,2021-02-26,VDA,210,58,152,110,86,14,ITC,ITC2,2,Valle d'Aosta / Vallée d'Aoste,Valle d'Aosta,125666,58400,46.47,0.17
3574,2021-04-10,VDA,405,191,214,389,5,11,ITC,ITC2,2,Valle d'Aosta / Vallée d'Aoste,Valle d'Aosta,125666,58805,46.79,0.32
3575,2020-12-31,VDA,18,4,14,18,0,0,ITC,ITC2,2,Valle d'Aosta / Vallée d'Aoste,Valle d'Aosta,125666,58823,46.81,0.01
3576,2021-06-06,VDA,1160,582,578,781,373,6,ITC,ITC2,2,Valle d'Aosta / Vallée d'Aoste,Valle d'Aosta,125666,59983,47.73,0.92
3577,2021-06-15,VDA,924,508,416,654,257,13,ITC,ITC2,2,Valle d'Aosta / Vallée d'Aoste,Valle d'Aosta,125666,60907,48.47,0.74
3578,2021-08-11,VDA,776,380,396,303,452,21,ITC,ITC2,2,Valle d'Aosta / Vallée d'Aoste,Valle d'Aosta,125666,61683,49.08,0.62
3579,2021-03-05,VDA,277,125,152,53,223,1,ITC,ITC2,2,Valle d'Aosta / Vallée d'Aoste,Valle d'Aosta,125666,61960,49.31,0.22
3580,2021-08-16,VDA,422,211,211,129,276,17,ITC,ITC2,2,Valle d'Aosta / Vallée d'Aoste,Valle d'Aosta,125666,62382,49.64,0.34
3581,2021-04-05,VDA,465,223,242,445,6,14,ITC,ITC2,2,Valle d'Aosta / Vallée d'Aoste,Valle d'Aosta,125666,62847,50.01,0.37
3582,2021-06-27,VDA,1254,609,645,312,931,11,ITC,ITC2,2,Valle d'Aosta / Vallée d'Aoste,Valle d'Aosta,125666,64101,51.01,1.0
3583,2021-07-14,VDA,1021,534,487,292,728,1,ITC,ITC2,2,Valle d'Aosta / Vallée d'Aoste,Valle d'Aosta,125666,65122,51.82,0.81
3584,2021-08-30,VDA,546,275,271,115,393,38,ITC,ITC2,2,Valle d'Aosta / Vallée d'Aoste,Valle d'Aosta,125666,65668,52.26,0.43
3585,2021-01-31,VDA,291,91,200,58,233,0,ITC,ITC2,2,Valle d'Aosta / Vallée d'Aoste,Valle d'Aosta,125666,65959,52.49,0.23
3586,2021-02-28,VDA,260,86,174,73,183,4,ITC,ITC2,2,Valle d'Aosta / Vallée d'Aoste,Valle d'Aosta,125666,66219,52.69,0.21
3587,2021-05-05,VDA,1038,566,472,434,582,22,ITC,ITC2,2,Valle d'Aosta / Vallée d'Aoste,Valle d'Aosta,125666,67257,53.52,0.83
3588,2021-08-13,VDA,494,273,221,204,281,9,ITC,ITC2,2,Valle d'Aosta / Vallée d'Aoste,Valle d'Aosta,125666,67751,53.91,0.39
3589,2021-03-10,VDA,439,184,255,220,214,5,ITC,ITC2,2,Valle d'Aosta / Vallée d'Aoste,Valle d'Aosta,125666,68190,54.26,0.35
3590,2021-02-21,VDA,18,3,15,0,18,0,ITC,ITC2,2,Valle d'Aosta / Vallée d'Aoste,Valle d'Aosta,125666,68208,54.28,0.01
3591,2021-06-01,VDA,873,470,403,510,354,9,ITC,ITC2,2,Valle d'Aosta / Vallée d'Aoste,Valle d'Aosta,125666,69081,54.97,0.69
3592,2021-08-23,VDA,404,205,199,91,299,14,ITC,ITC2,2,Valle d'Aosta / Vallée d'Aoste,Valle d'Aosta,125666,69485,55.29,0.32
3593,2021-05-18,VDA,972,484,488,349,619,4,ITC,ITC2,2,Valle d'Aosta / Vallée d'Aoste,Valle d'Aosta,125666,70457,56.07,0.77
3594,2021-02-07,VDA,292,120,172,190,102,0,ITC,ITC2,2,Valle d'Aosta / Vallée d'Aoste,Valle d'Aosta,125666,70749,56.3,0.23
3595,2021-08-09,VDA,674,335,339,252,401,21,ITC,ITC2,2,Valle d'Aosta / Vallée d'Aoste,Valle d'Aosta,125666,71423,56.84,0.54
3596,2021-05-01,VDA,941,564,377,440,484,17,ITC,ITC2,2,Valle d'Aosta / Vallée d'Aoste,Valle d'Aosta,125666,72364,57.58,0.75
3597,2021-04-14,VDA,942,430,512,692,224,26,ITC,ITC2,2,Valle d'Aosta / Vallée d'Aoste,Valle d'Aosta,125666,73306,58.33,0.75
3598,2021-07-06,VDA,885,480,405,158,722,5,ITC,ITC2,2,Valle d'Aosta / Vallée d'Aoste,Valle d'Aosta,125666,74191,59.04,0.7
3599,2021-01-02,VDA,6,5,1,6,0,0,ITC,ITC2,2,Valle d'Aosta / Vallée d'Aoste,Valle d'Aosta,125666,74197,59.04,0.0
3600,2021-03-26,VDA,498,204,294,481,7,10,ITC,ITC2,2,Valle d'Aosta / Vallée d'Aoste,Valle d'Aosta,125666,74695,59.44,0.4
3601,2021-06-17,VDA,991,530,461,637,342,12,ITC,ITC2,2,Valle d'Aosta / Vallée d'Aoste,Valle d'Aosta,125666,75686,60.23,0.79
3602,2021-05-20,VDA,1045,475,570,592,440,13,ITC,ITC2,2,Valle d'Aosta / Vallée d'Aoste,Valle d'Aosta,125666,76731,61.06,0.83
3603,2021-07-02,VDA,871,386,485,304,562,5,ITC,ITC2,2,Valle d'Aosta / Vallée d'Aoste,Valle d'Aosta,125666,77602,61.75,0.69
3604,2021-03-24,VDA,516,230,286,256,257,3,ITC,ITC2,2,Valle d'Aosta / Vallée d'Aoste,Valle d'Aosta,125666,78118,62.16,0.41
3605,2021-08-28,VDA,535,285,250,91,423,21,ITC,ITC2,2,Valle d'Aosta / Vallée d'Aoste,Valle d'Aosta,125666,78653,62.59,0.43
3606,2021-05-06,VDA,1083,516,567,664,385,34,ITC,ITC2,2,Valle d'Aosta / Vallée d'Aoste,Valle d'Aosta,125666,79736,63.45,0.86
3607,2021-02-16,VDA,327,53,274,315,6,6,ITC,ITC2,2,Valle d'Aosta / Vallée d'Aoste,Valle d'Aosta,125666,80063,63.71,0.26
3608,2021-07-28,VDA,1424,765,659,363,1048,13,ITC,ITC2,2,Valle d'Aosta / Vallée d'Aoste,Valle d'Aosta,125666,81487,64.84,1.13
3609,2021-04-19,VDA,753,326,427,521,209,23,ITC,ITC2,2,Valle d'Aosta / Vallée d'Aoste,Valle d'Aosta,125666,82240,65.44,0.6
3610,2021-01-16,VDA,238,80,158,238,0,0,ITC,ITC2,2,Valle d'Aosta / Vallée d'Aoste,Valle d'Aosta,125666,82478,65.63,0.19
3611,2021-03-22,VDA,561,205,356,326,229,6,ITC,ITC2,2,Valle d'Aosta / Vallée d'Aoste,Valle d'Aosta,125666,83039,66.08,0.45
3612,2021-01-21,VDA,33,12,21,33,0,0,ITC,ITC2,2,Valle d'Aosta / Vallée d'Aoste,Valle d'Aosta,125666,83072,66.11,0.03
3613,2021-01-04,VDA,144,61,83,144,0,0,ITC,ITC2,2,Valle d'Aosta / Vallée d'Aoste,Valle d'Aosta,125666,83216,66.22,0.11
3614,2021-03-28,VDA,524,213,311,497,0,27,ITC,ITC2,2,Valle d'Aosta / Vallée d'Aoste,Valle d'Aosta,125666,83740,66.64,0.42
3615,2021-03-11,VDA,392,164,228,152,239,1,ITC,ITC2,2,Valle d'Aosta / Vallée d'Aoste,Valle d'Aosta,125666,84132,66.95,0.31
3616,2021-08-01,VDA,842,445,397,286,547,9,ITC,ITC2,2,Valle d'Aosta / Vallée d'Aoste,Valle d'Aosta,125666,84974,67.62,0.67
3617,2021-01-28,VDA,294,124,170,55,239,0,ITC,ITC2,2,Valle d'Aosta / Vallée d'Aoste,Valle d'Aosta,125666,85268,67.85,0.23
3618,2021-02-23,VDA,217,124,93,216,0,1,ITC,ITC2,2,Valle d'Aosta / Vallée d'Aoste,Valle d'Aosta,125666,85485,68.03,0.17
3619,2021-06-03,VDA,1309,669,640,881,413,15,ITC,ITC2,2,Valle d'Aosta / Vallée d'Aoste,Valle d'Aosta,125666,86794,69.07,1.04
3620,2021-05-03,VDA,841,400,441,459,352,30,ITC,ITC2,2,Valle d'Aosta / Vallée d'Aoste,Valle d'Aosta,125666,87635,69.74,0.67
3621,2021-03-07,VDA,64,30,34,11,53,0,ITC,ITC2,2,Valle d'Aosta / Vallée d'Aoste,Valle d'Aosta,125666,87699,69.79,0.05
3622,2021-08-20,VDA,473,240,233,142,316,15,ITC,ITC2,2,Valle d'Aosta / Vallée d'Aoste,Valle d'Aosta,125666,88172,70.16,0.38
3623,2021-01-30,VDA,440,203,237,12,426,2,ITC,ITC2,2,Valle d'Aosta / Vallée d'Aoste,Valle d'Aosta,125666,88612,70.51,0.35
3624,2021-01-25,VDA,150,67,83,1,149,0,ITC,ITC2,2,Valle d'Aosta / Vallée d'Aoste,Valle d'Aosta,125666,88762,70.63,0.12
3625,2021-07-10,VDA,1295,670,625,320,964,11,ITC,ITC2,2,Valle d'Aosta / Vallée d'Aoste,Valle d'Aosta,125666,90057,71.66,1.03
3626,2021-08-22,VDA,177,88,89,8,169,0,ITC,ITC2,2,Valle d'Aosta / Vallée d'Aoste,Valle d'Aosta,125666,90234,71.8,0.14
3627,2021-05-14,VDA,964,444,520,264,670,30,ITC,ITC2,2,Valle d'Aosta / Vallée d'Aoste,Valle d'Aosta,125666,91198,72.57,0.77
3628,2021-04-07,VDA,910,474,436,655,229,26,ITC,ITC2,2,Valle d'Aosta / Vallée d'Aoste,Valle d'Aosta,125666,92108,73.3,0.72
3629,2021-02-09,VDA,255,86,169,70,184,1,ITC,ITC2,2,Valle d'Aosta / Vallée d'Aoste,Valle d'Aosta,125666,92363,73.5,0.2
3630,2021-06-12,VDA,1234,600,634,1060,167,7,ITC,ITC2,2,Valle d'Aosta / Vallée d'Aoste,Valle d'Aosta,125666,93597,74.48,0.98
3631,2021-03-19,VDA,322,85,237,285,35,2,ITC,ITC2,2,Valle d'Aosta / Vallée d'Aoste,Valle d'Aosta,125666,93919,74.74,0.26
3632,2021-06-02,VDA,1217,689,528,811,402,4,ITC,ITC2,2,Valle d'Aosta / Vallée d'Aoste,Valle d'Aosta,125666,95136,75.71,0.97
3633,2021-06-19,VDA,1295,671,624,658,621,16,ITC,ITC2,2,Valle d'Aosta / Vallée d'Aoste,Valle d'Aosta,125666,96431,76.74,1.03
3634,2021-08-24,VDA,672,370,302,144,518,10,ITC,ITC2,2,Valle d'Aosta / Vallée d'Aoste,Valle d'Aosta,125666,97103,77.27,0.53
3635,2021-03-09,VDA,206,96,110,167,32,7,ITC,ITC2,2,Valle d'Aosta / Vallée d'Aoste,Valle d'Aosta,125666,97309,77.43,0.16
3636,2021-02-20,VDA,256,214,42,243,10,3,ITC,ITC2,2,Valle d'Aosta / Vallée d'Aoste,Valle d'Aosta,125666,97565,77.64,0.2
3637,2021-06-22,VDA,1191,666,525,530,649,12,ITC,ITC2,2,Valle d'Aosta / Vallée d'Aoste,Valle d'Aosta,125666,98756,78.59,0.95
3638,2021-03-14,VDA,392,200,192,374,0,18,ITC,ITC2,2,Valle d'Aosta / Vallée d'Aoste,Valle d'Aosta,125666,99148,78.9,0.31
3639,2021-04-26,VDA,718,330,388,516,170,32,ITC,ITC2,2,Valle d'Aosta / Vallée d'Aoste,Valle d'Aosta,125666,99866,79.47,0.57
3640,2021-08-27,VDA,498,259,239,126,366,6,ITC,ITC2,2,Valle d'Aosta / Vallée d'Aoste,Valle d'Aosta,125666,100364,79.87,0.4
3641,2021-07-01,VDA,962,473,489,328,621,13,ITC,ITC2,2,Valle d'Aosta / Vallée d'Aoste,Valle d'Aosta,125666,101326,80.63,0.77
3642,2021-07-20,VDA,1121,585,536,390,724,7,ITC,ITC2,2,Valle d'Aosta / Vallée d'Aoste,Valle d'Aosta,125666,102447,81.52,0.89
3643,2021-04-18,VDA,523,255,268,495,2,26,ITC,ITC2,2,Valle d'Aosta / Vallée d'Aoste,Valle d'Aosta,125666,102970,81.94,0.42
3644,2021-06-14,VDA,1017,523,494,575,428,14,ITC,ITC2,2,Valle d'Aosta / Vallée d'Aoste,Valle d'Aosta,125666,103987,82.75,0.81
3645,2021-05-31,VDA,881,396,485,490,380,11,ITC,ITC2,2,Valle d'Aosta / Vallée d'Aoste,Valle d'Aosta,125666,104868,83.45,0.7
3646,2021-07-27,VDA,1121,596,525,564,552,5,ITC,ITC2,2,Valle d'Aosta / Vallée d'Aoste,Valle d'Aosta,125666,105989,84.34,0.89
3647,2021-04-25,VDA,850,409,441,674,139,37,ITC,ITC2,2,Valle d'Aosta / Vallée d'Aoste,Valle d'Aosta,125666,106839,85.02,0.68
3648,2021-06-21,VDA,1123,600,523,608,505,10,ITC,ITC2,2,Valle d'Aosta / Vallée d'Aoste,Valle d'Aosta,125666,107962,85.91,0.89
3649,2021-06-07,VDA,711,347,364,637,61,13,ITC,ITC2,2,Valle d'Aosta / Vallée d'Aoste,Valle d'Aosta,125666,108673,86.48,0.57
3650,2021-02-27,VDA,232,86,146,120,107,5,ITC,ITC2,2,Valle d'Aosta / Vallée d'Aoste,Valle d'Aosta,125666,108905,86.66,0.18
3651,2021-08-03,VDA,936,485,451,561,362,13,ITC,ITC2,2,Valle d'Aosta / Vallée d'Aoste,Valle d'Aosta,125666,109841,87.41,0.74
3652,2021-01-09,VDA,445,200,245,445,0,0,ITC,ITC2,2,Valle d'Aosta / Vallée d'Aoste,Valle d'Aosta,125666,110286,87.76,0.35
3653,2021-06-24,VDA,1226,631,595,381,837,8,ITC,ITC2,2,Valle d'Aosta / Vallée d'Aoste,Valle d'Aosta,125666,111512,88.74,0.98
3654,2021-07-03,VDA,936,485,451,390,537,9,ITC,ITC2,2,Valle d'Aosta / Vallée d'Aoste,Valle d'Aosta,125666,112448,89.48,0.74
3655,2021-08-29,VDA,209,120,89,6,202,1,ITC,ITC2,2,Valle d'Aosta / Vallée d'Aoste,Valle d'Aosta,125666,112657,89.65,0.17
3656,2021-02-01,VDA,409,128,281,86,320,3,ITC,ITC2,2,Valle d'Aosta / Vallée d'Aoste,Valle d'Aosta,125666,113066,89.97,0.33
3657,2021-07-08,VDA,1276,709,567,341,924,11,ITC,ITC2,2,Valle d'Aosta / Vallée d'Aoste,Valle d'Aosta,125666,114342,90.99,1.02
3658,2021-03-30,VDA,402,223,179,364,20,18,ITC,ITC2,2,Valle d'Aosta / Vallée d'Aoste,Valle d'Aosta,125666,114744,91.31,0.32
3659,2021-05-12,VDA,1144,550,594,449,671,24,ITC,ITC2,2,Valle d'Aosta / Vallée d'Aoste,Valle d'Aosta,125666,115888,92.22,0.91
3660,2021-07-17,VDA,987,521,466,253,730,4,ITC,ITC2,2,Valle d'Aosta / Vallée d'Aoste,Valle d'Aosta,125666,116875,93.0,0.79
3661,2021-02-08,VDA,224,83,141,25,199,0,ITC,ITC2,2,Valle d'Aosta / Vallée d'Aoste,Valle d'Aosta,125666,117099,93.18,0.18
3662,2021-03-23,VDA,380,150,230,229,135,16,ITC,ITC2,2,Valle d'Aosta / Vallée d'Aoste,Valle d'Aosta,125666,117479,93.49,0.3
3663,2021-05-19,VDA,993,498,495,410,575,8,ITC,ITC2,2,Valle d'Aosta / Vallée d'Aoste,Valle d'Aosta,125666,118472,94.28,0.79
3664,2021-03-16,VDA,185,37,148,109,67,9,ITC,ITC2,2,Valle d'Aosta / Vallée d'Aoste,Valle d'Aosta,125666,118657,94.42,0.15
3665,2021-05-07,VDA,566,247,319,514,30,22,ITC,ITC2,2,Valle d'Aosta / Vallée d'Aoste,Valle d'Aosta,125666,119223,94.87,0.45
3666,2021-04-23,VDA,923,443,480,511,383,29,ITC,ITC2,2,Valle d'Aosta / Vallée d'Aoste,Valle d'Aosta,125666,120146,95.61,0.73
3667,2021-01-13,VDA,338,110,228,338,0,0,ITC,ITC2,2,Valle d'Aosta / Vallée d'Aoste,Valle d'Aosta,125666,120484,95.88,0.27
3668,2021-07-29,VDA,996,508,488,320,666,10,ITC,ITC2,2,Valle d'Aosta / Vallée d'Aoste,Valle d'Aosta,125666,121480,96.67,0.79
3669,2021-07-15,VDA,1099,596,503,294,800,5,ITC,ITC2,2,Valle d'Aosta / Vallée d'Aoste,Valle d'Aosta,125666,122579,97.54,0.87
3670,2021-04-06,VDA,743,382,361,598,112,33,ITC,ITC2,2,Valle d'Aosta / Vallée d'Aoste,Valle d'Aosta,125666,123322,98.13,0.59
3671,2021-03-18,VDA,136,43,93,96,37,3,ITC,ITC2,2,Valle d'Aosta / Vallée d'Aoste,Valle d'Aosta,125666,123458,98.24,0.11
3672,2021-08-25,VDA,681,348,333,128,527,26,ITC,ITC2,2,Valle d'Aosta / Vallée d'Aoste,Valle d'Aosta,125666,124139,98.78,0.54
3673,2021-05-17,VDA,809,417,392,365,434,10,ITC,ITC2,2,Valle d'Aosta / Vallée d'Aoste,Valle d'Aosta,125666,124948,99.43,0.64
3674,2021-08-08,VDA,579,297,282,175,394,10,ITC,ITC2,2,Valle d'Aosta / Vallée d'Aoste,Valle d'Aosta,125666,125527,99.89,0.46
3675,2021-05-15,VDA,1067,614,453,368,686,13,ITC,ITC2,2,Valle d'Aosta / Vallée d'Aoste,Valle d'Aosta,125666,126594,100.74,0.85
3676,2021-02-04,VDA,295,86,209,8,287,0,ITC,ITC2,2,Valle d'Aosta / Vallée d'Aoste,Valle d'Aosta,125666,126889,100.97,0.23
3677,2021-04-28,VDA,1220,633,587,683,503,34,ITC,ITC2,2,Valle d'Aosta / Vallée d'Aoste,Valle d'Aosta,125666,128109,101.94,0.97
3678,2021-08-06,VDA,820,400,420,405,397,18,ITC,ITC2,2,Valle d'Aosta / Vallée d'Aoste,Valle d'Aosta,125666,128929,102.6,0.65
3679,2021-06-26,VDA,1065,512,553,351,707,7,ITC,ITC2,2,Valle d'Aosta / Vallée d'Aoste,Valle d'Aosta,125666,129994,103.44,0.85
3680,2021-03-04,VDA,291,139,152,39,250,2,ITC,ITC2,2,Valle d'Aosta / Vallée d'Aoste,Valle d'Aosta,125666,130285,103.68,0.23
3681,2021-05-26,VDA,1212,587,625,567,634,11,ITC,ITC2,2,Valle d'Aosta / Vallée d'Aoste,Valle d'Aosta,125666,131497,104.64,0.96
3682,2021-09-03,VDA,376,194,182,65,299,12,ITC,ITC2,2,Valle d'Aosta / Vallée d'Aoste,Valle d'Aosta,125666,131873,104.94,0.3
3683,2021-06-05,VDA,926,476,450,729,188,9,ITC,ITC2,2,Valle d'Aosta / Vallée d'Aoste,Valle d'Aosta,125666,132799,105.68,0.74
3684,2021-02-11,VDA,231,107,124,221,9,1,ITC,ITC2,2,Valle d'Aosta / Vallée d'Aoste,Valle d'Aosta,125666,133030,105.86,0.18
3685,2021-07-18,VDA,928,455,473,248,674,6,ITC,ITC2,2,Valle d'Aosta / Vallée d'Aoste,Valle d'Aosta,125666,133958,106.6,0.74
3686,2021-04-09,VDA,238,111,127,201,33,4,ITC,ITC2,2,Valle d'Aosta / Vallée d'Aoste,Valle d'Aosta,125666,134196,106.79,0.19
3687,2021-05-22,VDA,956,505,451,545,401,10,ITC,ITC2,2,Valle d'Aosta / Vallée d'Aoste,Valle d'Aosta,125666,135152,107.55,0.76
3688,2021-07-25,VDA,1021,494,527,265,749,7,ITC,ITC2,2,Valle d'Aosta / Vallée d'Aoste,Valle d'Aosta,125666,136173,108.36,0.81
3689,2021-04-16,VDA,599,261,338,566,2,31,ITC,ITC2,2,Valle d'Aosta / Vallée d'Aoste,Valle d'Aosta,125666,136772,108.84,0.48
3690,2021-04-02,VDA,875,345,530,626,226,23,ITC,ITC2,2,Valle d'Aosta / Vallée d'Aoste,Valle d'Aosta,125666,137647,109.53,0.7
3691,2021-05-29,VDA,800,436,364,554,239,7,ITC,ITC2,2,Valle d'Aosta / Vallée d'Aoste,Valle d'Aosta,125666,138447,110.17,0.64
3692,2021-07-11,VDA,908,472,436,254,643,11,ITC,ITC2,2,Valle d'Aosta / Vallée d'Aoste,Valle d'Aosta,125666,139355,110.89,0.72
3693,2021-02-25,VDA,202,101,101,190,8,4,ITC,ITC2,2,Valle d'Aosta / Vallée d'Aoste,Valle d'Aosta,125666,139557,111.05,0.16
3694,2021-08-05,VDA,786,406,380,278,482,26,ITC,ITC2,2,Valle d'Aosta / Vallée d'Aoste,Valle d'Aosta,125666,140343,111.68,0.63
3695,2021-01-06,VDA,66,34,32,66,0,0,ITC,ITC2,2,Valle d'Aosta / Vallée d'Aoste,Valle d'Aosta,125666,140409,111.73,0.05
3696,2021-02-18,VDA,349,153,196,256,88,5,ITC,ITC2,2,Valle d'Aosta / Vallée d'Aoste,Valle d'Aosta,125666,140758,112.01,0.28
3697,2021-08-10,VDA,852,437,415,580,262,10,ITC,ITC2,2,Valle d'Aosta / Vallée d'Aoste,Valle d'Aosta,125666,141610,112.69,0.68
3698,2021-02-06,VDA,290,104,186,91,198,1,ITC,ITC2,2,Valle d'Aosta / Vallée d'Aoste,Valle d'Aosta,125666,141900,112.92,0.23
3699,2021-04-30,VDA,833,357,476,469,347,17,ITC,ITC2,2,Valle d'Aosta / Vallée d'Aoste,Valle d'Aosta,125666,142733,113.58,0.66
3700,2021-01-20,VDA,64,15,49,64,0,0,ITC,ITC2,2,Valle d'Aosta / Vallée d'Aoste,Valle d'Aosta,125666,142797,113.63,0.05
3701,2021-07-22,VDA,981,519,462,271,704,6,ITC,ITC2,2,Valle d'Aosta / Vallée d'Aoste,Valle d'Aosta,125666,143778,114.41,0.78
3702,2021-01-18,VDA,214,74,140,214,0,0,ITC,ITC2,2,Valle d'Aosta / Vallée d'Aoste,Valle d'Aosta,125666,143992,114.58,0.17
3703,2021-04-11,VDA,479,208,271,462,0,17,ITC,ITC2,2,Valle d'Aosta / Vallée d'Aoste,Valle d'Aosta,125666,144471,114.96,0.38
3704,2021-03-17,VDA,438,185,253,259,165,14,ITC,ITC2,2,Valle d'Aosta / Vallée d'Aoste,Valle d'Aosta,125666,144909,115.31,0.35
3705,2021-03-03,VDA,258,119,139,182,71,5,ITC,ITC2,2,Valle d'Aosta / Vallée d'Aoste,Valle d'Aosta,125666,145167,115.52,0.21
3706,2021-07-16,VDA,1078,555,523,345,731,2,ITC,ITC2,2,Valle d'Aosta / Vallée d'Aoste,Valle d'Aosta,125666,146245,116.38,0.86
3707,2021-01-26,VDA,149,52,97,2,147,0,ITC,ITC2,2,Valle d'Aosta / Vallée d'Aoste,Valle d'Aosta,125666,146394,116.49,0.12
3708,2021-02-12,VDA,263,96,167,216,46,1,ITC,ITC2,2,Valle d'Aosta / Vallée d'Aoste,Valle d'Aosta,125666,146657,116.7,0.21
3709,2021-01-12,VDA,303,73,230,303,0,0,ITC,ITC2,2,Valle d'Aosta / Vallée d'Aoste,Valle d'Aosta,125666,146960,116.94,0.24
3710,2021-09-01,VDA,800,428,372,188,586,26,ITC,ITC2,2,Valle d'Aosta / Vallée d'Aoste,Valle d'Aosta,125666,147760,117.58,0.64
3711,2021-05-24,VDA,1138,517,621,676,447,15,ITC,ITC2,2,Valle d'Aosta / Vallée d'Aoste,Valle d'Aosta,125666,148898,118.49,0.91
3712,2021-05-10,VDA,784,383,401,533,235,16,ITC,ITC2,2,Valle d'Aosta / Vallée d'Aoste,Valle d'Aosta,125666,149682,119.11,0.62
3713,2021-08-18,VDA,687,356,331,235,433,19,ITC,ITC2,2,Valle d'Aosta / Vallée d'Aoste,Valle d'Aosta,125666,150369,119.66,0.55
3714,2021-07-30,VDA,965,501,464,419,525,21,ITC,ITC2,2,Valle d'Aosta / Vallée d'Aoste,Valle d'Aosta,125666,151334,120.43,0.77
3715,2021-04-21,VDA,869,410,459,588,249,32,ITC,ITC2,2,Valle d'Aosta / Vallée d'Aoste,Valle d'Aosta,125666,152203,121.12,0.69
3716,2021-07-13,VDA,1062,567,495,308,748,6,ITC,ITC2,2,Valle d'Aosta / Vallée d'Aoste,Valle d'Aosta,125666,153265,121.96,0.85
3717,2021-03-21,VDA,360,169,191,351,0,9,ITC,ITC2,2,Valle d'Aosta / Vallée d'Aoste,Valle d'Aosta,125666,153625,122.25,0.29
3718,2021-06-29,VDA,782,390,392,236,543,3,ITC,ITC2,2,Valle d'Aosta / Vallée d'Aoste,Valle d'Aosta,125666,154407,122.87,0.62
3719,2021-06-10,VDA,1058,611,447,1008,41,9,ITC,ITC2,2,Valle d'Aosta / Vallée d'Aoste,Valle d'Aosta,125666,155465,123.71,0.84
3720,2021-03-02,VDA,340,166,174,291,3,46,ITC,ITC2,2,Valle d'Aosta / Vallée d'Aoste,Valle d'Aosta,125666,155805,123.98,0.27
3721,2021-01-11,VDA,328,113,215,328,0,0,ITC,ITC2,2,Valle d'Aosta / Vallée d'Aoste,Valle d'Aosta,125666,156133,124.24,0.26
3722,2021-04-04,VDA,572,253,319,562,0,10,ITC,ITC2,2,Valle d'Aosta / Vallée d'Aoste,Valle d'Aosta,125666,156705,124.7,0.46
3723,2021-08-17,VDA,560,306,254,210,342,8,ITC,ITC2,2,Valle d'Aosta / Vallée d'Aoste,Valle d'Aosta,125666,157265,125.15,0.45
3724,2021-02-13,VDA,217,197,20,214,1,2,ITC,ITC2,2,Valle d'Aosta / Vallée d'Aoste,Valle d'Aosta,125666,157482,125.32,0.17
3725,2021-02-07,PUG,1584,669,915,253,1331,0,ITF,ITF4,16,Puglia,Puglia,4029053,1584,0.04,0.04
3726,2021-01-21,PUG,2132,905,1227,1268,862,2,ITF,ITF4,16,Puglia,Puglia,4029053,3716,0.09,0.05
3727,2021-05-01,PUG,27712,12690,15022,16722,10709,281,ITF,ITF4,16,Puglia,Puglia,4029053,31428,0.78,0.69
3728,2021-08-09,PUG,27911,14368,13543,11244,15801,866,ITF,ITF4,16,Puglia,Puglia,4029053,59339,1.47,0.69
3729,2021-01-02,PUG,2958,1306,1652,2958,0,0,ITF,ITF4,16,Puglia,Puglia,4029053,62297,1.55,0.07
3730,2021-04-12,PUG,29493,13871,15622,26151,3025,317,ITF,ITF4,16,Puglia,Puglia,4029053,91790,2.28,0.73
3731,2021-02-09,PUG,3854,1575,2279,2158,1676,20,ITF,ITF4,16,Puglia,Puglia,4029053,95644,2.37,0.1
3732,2021-05-20,PUG,33737,15309,18428,20767,12453,517,ITF,ITF4,16,Puglia,Puglia,4029053,129381,3.21,0.84
3733,2021-03-24,PUG,13624,6540,7084,6047,7457,120,ITF,ITF4,16,Puglia,Puglia,4029053,143005,3.55,0.34
3734,2021-08-28,PUG,5710,3124,2586,2014,3508,188,ITF,ITF4,16,Puglia,Puglia,4029053,148715,3.69,0.14
3735,2021-01-26,PUG,5381,2408,2973,563,4817,1,ITF,ITF4,16,Puglia,Puglia,4029053,154096,3.82,0.13
3736,2021-07-02,PUG,47455,22562,24893,17370,29159,926,ITF,ITF4,16,Puglia,Puglia,4029053,201551,5.0,1.18
3737,2021-04-19,PUG,27767,12902,14865,24379,3050,338,ITF,ITF4,16,Puglia,Puglia,4029053,229318,5.69,0.69
3738,2021-07-28,PUG,45365,22939,22426,14710,29764,891,ITF,ITF4,16,Puglia,Puglia,4029053,274683,6.82,1.13
3739,2021-04-24,PUG,29463,13423,16040,25172,3956,335,ITF,ITF4,16,Puglia,Puglia,4029053,304146,7.55,0.73
3740,2021-02-21,PUG,2179,475,1704,2065,63,51,ITF,ITF4,16,Puglia,Puglia,4029053,306325,7.6,0.05
3741,2021-06-01,PUG,35053,17559,17494,21652,13004,397,ITF,ITF4,16,Puglia,Puglia,4029053,341378,8.47,0.87
3742,2021-05-15,PUG,43719,19038,24681,22835,20172,712,ITF,ITF4,16,Puglia,Puglia,4029053,385097,9.56,1.09
3743,2021-06-03,PUG,50703,24598,26105,30543,19435,725,ITF,ITF4,16,Puglia,Puglia,4029053,435800,10.82,1.26
3744,2021-03-10,PUG,14856,6645,8211,11559,3137,160,ITF,ITF4,16,Puglia,Puglia,4029053,450656,11.19,0.37
3745,2021-01-12,PUG,4222,1774,2448,4221,0,1,ITF,ITF4,16,Puglia,Puglia,4029053,454878,11.29,0.1
3746,2021-04-07,PUG,15745,7150,8595,8837,6709,199,ITF,ITF4,16,Puglia,Puglia,4029053,470623,11.68,0.39
3747,2021-07-16,PUG,46592,22615,23977,12949,32832,811,ITF,ITF4,16,Puglia,Puglia,4029053,517215,12.84,1.16
3748,2021-04-05,PUG,12778,6205,6573,12103,534,141,ITF,ITF4,16,Puglia,Puglia,4029053,529993,13.15,0.32
3749,2021-03-19,PUG,7996,3670,4326,3368,4592,36,ITF,ITF4,16,Puglia,Puglia,4029053,537989,13.35,0.2
3750,2021-06-27,PUG,18575,9225,9350,9958,8352,265,ITF,ITF4,16,Puglia,Puglia,4029053,556564,13.81,0.46
3751,2021-03-05,PUG,17743,7200,10543,15201,2320,222,ITF,ITF4,16,Puglia,Puglia,4029053,574307,14.25,0.44
3752,2021-02-26,PUG,13802,5069,8733,12524,1079,199,ITF,ITF4,16,Puglia,Puglia,4029053,588109,14.6,0.34
3753,2020-12-31,PUG,1638,785,853,1638,0,0,ITF,ITF4,16,Puglia,Puglia,4029053,589747,14.64,0.04
3754,2021-08-11,PUG,23852,12262,11590,12066,10771,1015,ITF,ITF4,16,Puglia,Puglia,4029053,613599,15.23,0.59
3755,2021-06-15,PUG,42738,20894,21844,22389,19756,593,ITF,ITF4,16,Puglia,Puglia,4029053,656337,16.29,1.06
3756,2021-06-08,PUG,39401,19187,20214,20962,17877,562,ITF,ITF4,16,Puglia,Puglia,4029053,695738,17.27,0.98
3757,2021-07-11,PUG,12190,5762,6428,2577,9515,98,ITF,ITF4,16,Puglia,Puglia,4029053,707928,17.57,0.3
3758,2021-08-23,PUG,30251,15644,14607,10612,18746,893,ITF,ITF4,16,Puglia,Puglia,4029053,738179,18.32,0.75
3759,2021-05-06,PUG,39785,17402,22383,19304,19921,560,ITF,ITF4,16,Puglia,Puglia,4029053,777964,19.31,0.99
3760,2021-03-31,PUG,14584,6837,7747,8843,5590,151,ITF,ITF4,16,Puglia,Puglia,4029053,792548,19.67,0.36
3761,2021-02-02,PUG,4363,1856,2507,574,3788,1,ITF,ITF4,16,Puglia,Puglia,4029053,796911,19.78,0.11
3762,2021-07-21,PUG,45054,22210,22844,11884,32325,845,ITF,ITF4,16,Puglia,Puglia,4029053,841965,20.9,1.12
3763,2021-07-04,PUG,19946,9700,10246,7935,11725,286,ITF,ITF4,16,Puglia,Puglia,4029053,861911,21.39,0.5
3764,2021-07-23,PUG,43330,21922,21408,13642,28711,977,ITF,ITF4,16,Puglia,Puglia,4029053,905241,22.47,1.08
3765,2021-01-19,PUG,1221,452,769,1210,10,1,ITF,ITF4,16,Puglia,Puglia,4029053,906462,22.5,0.03
3766,2021-02-14,PUG,790,348,442,658,127,5,ITF,ITF4,16,Puglia,Puglia,4029053,907252,22.52,0.02
3767,2021-05-25,PUG,34844,16269,18575,20583,13675,586,ITF,ITF4,16,Puglia,Puglia,4029053,942096,23.38,0.86
3768,2021-05-08,PUG,54482,23063,31419,23967,29946,569,ITF,ITF4,16,Puglia,Puglia,4029053,996578,24.73,1.35
3769,2021-08-16,PUG,12054,6395,5659,7050,4364,640,ITF,ITF4,16,Puglia,Puglia,4029053,1008632,25.03,0.3
3770,2021-03-29,PUG,13583,6629,6954,6615,6769,199,ITF,ITF4,16,Puglia,Puglia,4029053,1022215,25.37,0.34
3771,2021-03-12,PUG,14323,6458,7865,10233,3948,142,ITF,ITF4,16,Puglia,Puglia,4029053,1036538,25.73,0.36
3772,2021-06-20,PUG,21622,10863,10759,14062,7234,326,ITF,ITF4,16,Puglia,Puglia,4029053,1058160,26.26,0.54
3773,2021-02-04,PUG,5938,2367,3571,1133,4801,4,ITF,ITF4,16,Puglia,Puglia,4029053,1064098,26.41,0.15
3774,2021-01-14,PUG,4081,1595,2486,4080,0,1,ITF,ITF4,16,Puglia,Puglia,4029053,1068179,26.51,0.1
3775,2021-01-07,PUG,5734,2469,3265,5734,0,0,ITF,ITF4,16,Puglia,Puglia,4029053,1073913,26.65,0.14
3776,2021-04-17,PUG,40097,19003,21094,36083,3591,423,ITF,ITF4,16,Puglia,Puglia,4029053,1114010,27.65,1.0
3777,2021-02-19,PUG,4752,2021,2731,4304,393,55,ITF,ITF4,16,Puglia,Puglia,4029053,1118762,27.77,0.12
3778,2021-06-22,PUG,42567,20652,21915,19065,22931,571,ITF,ITF4,16,Puglia,Puglia,4029053,1161329,28.82,1.06
3779,2021-04-26,PUG,26359,12080,14279,22728,3239,392,ITF,ITF4,16,Puglia,Puglia,4029053,1187688,29.48,0.65
3780,2021-08-04,PUG,35238,17948,17290,12396,21777,1065,ITF,ITF4,16,Puglia,Puglia,4029053,1222926,30.35,0.87
3781,2021-07-30,PUG,36392,18698,17694,13132,22382,878,ITF,ITF4,16,Puglia,Puglia,4029053,1259318,31.26,0.9
3782,2021-05-27,PUG,41021,19388,21633,22901,17443,677,ITF,ITF4,16,Puglia,Puglia,4029053,1300339,32.27,1.02
3783,2021-08-18,PUG,20134,10655,9479,10668,8542,924,ITF,ITF4,16,Puglia,Puglia,4029053,1320473,32.77,0.5
3784,2021-06-13,PUG,21885,10963,10922,16374,5225,286,ITF,ITF4,16,Puglia,Puglia,4029053,1342358,33.32,0.54
3785,2021-02-28,PUG,6078,1811,4267,5810,191,77,ITF,ITF4,16,Puglia,Puglia,4029053,1348436,33.47,0.15
3786,2021-05-12,PUG,36664,16351,20313,23534,12546,584,ITF,ITF4,16,Puglia,Puglia,4029053,1385100,34.38,0.91
3787,2021-08-30,PUG,28129,14633,13496,11419,15683,1027,ITF,ITF4,16,Puglia,Puglia,4029053,1413229,35.08,0.7
3788,2021-01-31,PUG,1824,835,989,74,1750,0,ITF,ITF4,16,Puglia,Puglia,4029053,1415053,35.12,0.05
3789,2021-05-29,PUG,30701,14471,16230,20604,9550,547,ITF,ITF4,16,Puglia,Puglia,4029053,1445754,35.88,0.76
3790,2021-04-02,PUG,12867,6011,6856,8186,4530,151,ITF,ITF4,16,Puglia,Puglia,4029053,1458621,36.2,0.32
3791,2021-07-09,PUG,37159,17901,19258,6401,30081,677,ITF,ITF4,16,Puglia,Puglia,4029053,1495780,37.12,0.92
3792,2021-05-13,PUG,38889,17339,21550,21009,17315,565,ITF,ITF4,16,Puglia,Puglia,4029053,1534669,38.09,0.97
3793,2021-03-17,PUG,10357,4706,5651,4104,6191,62,ITF,ITF4,16,Puglia,Puglia,4029053,1545026,38.35,0.26
3794,2021-07-20,PUG,47034,23075,23959,8212,38314,508,ITF,ITF4,16,Puglia,Puglia,4029053,1592060,39.51,1.17
3795,2021-07-08,PUG,41615,19302,22313,5436,35721,458,ITF,ITF4,16,Puglia,Puglia,4029053,1633675,40.55,1.03
3796,2021-01-04,PUG,4514,2017,2497,4512,0,2,ITF,ITF4,16,Puglia,Puglia,4029053,1638189,40.66,0.11
3797,2021-09-03,PUG,13181,6774,6407,5229,7176,776,ITF,ITF4,16,Puglia,Puglia,4029053,1651370,40.99,0.33
3798,2021-06-12,PUG,34664,17275,17389,25085,8984,595,ITF,ITF4,16,Puglia,Puglia,4029053,1686034,41.85,0.86
3799,2021-05-17,PUG,32982,15293,17689,20470,12011,501,ITF,ITF4,16,Puglia,Puglia,4029053,1719016,42.67,0.82
3800,2021-08-25,PUG,25519,13391,12128,10247,14332,940,ITF,ITF4,16,Puglia,Puglia,4029053,1744535,43.3,0.63
3801,2021-08-08,PUG,5120,2601,2519,1660,3410,50,ITF,ITF4,16,Puglia,Puglia,4029053,1749655,43.43,0.13
3802,2021-08-27,PUG,23786,12452,11334,9906,12937,943,ITF,ITF4,16,Puglia,Puglia,4029053,1773441,44.02,0.59
3803,2021-03-16,PUG,9891,4694,5197,3453,6380,58,ITF,ITF4,16,Puglia,Puglia,4029053,1783332,44.26,0.25
3804,2021-06-24,PUG,53038,25663,27375,23593,28656,789,ITF,ITF4,16,Puglia,Puglia,4029053,1836370,45.58,1.32
3805,2021-04-28,PUG,19888,8920,10968,14832,4792,264,ITF,ITF4,16,Puglia,Puglia,4029053,1856258,46.07,0.49
3806,2021-08-06,PUG,30291,15751,14540,9066,20464,761,ITF,ITF4,16,Puglia,Puglia,4029053,1886549,46.82,0.75
3807,2021-01-09,PUG,4899,2252,2647,4895,0,4,ITF,ITF4,16,Puglia,Puglia,4029053,1891448,46.95,0.12
3808,2021-07-01,PUG,48528,22718,25810,11452,36442,634,ITF,ITF4,16,Puglia,Puglia,4029053,1939976,48.15,1.2
3809,2021-08-20,PUG,17880,9291,8589,8179,8955,746,ITF,ITF4,16,Puglia,Puglia,4029053,1957856,48.59,0.44
3810,2021-01-23,PUG,3043,1294,1749,881,2161,1,ITF,ITF4,16,Puglia,Puglia,4029053,1960899,48.67,0.08
3811,2021-05-03,PUG,33427,14942,18485,22166,10696,565,ITF,ITF4,16,Puglia,Puglia,4029053,1994326,49.5,0.83
3812,2021-03-07,PUG,4995,2007,2988,4372,578,45,ITF,ITF4,16,Puglia,Puglia,4029053,1999321,49.62,0.12
3813,2021-05-05,PUG,39359,17280,22079,24506,14262,591,ITF,ITF4,16,Puglia,Puglia,4029053,2038680,50.6,0.98
3814,2021-08-13,PUG,13767,7320,6447,7274,5903,590,ITF,ITF4,16,Puglia,Puglia,4029053,2052447,50.94,0.34
3815,2021-06-17,PUG,42959,20992,21967,21402,20995,562,ITF,ITF4,16,Puglia,Puglia,4029053,2095406,52.01,1.07
3816,2021-03-30,PUG,12452,5970,6482,6197,6100,155,ITF,ITF4,16,Puglia,Puglia,4029053,2107858,52.32,0.31
3817,2021-02-01,PUG,3979,1667,2312,353,3625,1,ITF,ITF4,16,Puglia,Puglia,4029053,2111837,52.42,0.1
3818,2021-01-28,PUG,5489,2286,3203,441,5048,0,ITF,ITF4,16,Puglia,Puglia,4029053,2117326,52.55,0.14
3819,2021-08-15,PUG,55,34,21,55,0,0,ITF,ITF4,16,Puglia,Puglia,4029053,2117381,52.55,0.0
3820,2021-04-23,PUG,29627,13771,15856,23923,5289,415,ITF,ITF4,16,Puglia,Puglia,4029053,2147008,53.29,0.74
3821,2021-08-01,PUG,12421,6505,5916,4317,7982,122,ITF,ITF4,16,Puglia,Puglia,4029053,2159429,53.6,0.31
3822,2021-04-16,PUG,36152,16993,19159,32433,3289,430,ITF,ITF4,16,Puglia,Puglia,4029053,2195581,54.49,0.9
3823,2021-02-18,PUG,4389,1849,2540,3718,610,61,ITF,ITF4,16,Puglia,Puglia,4029053,2199970,54.6,0.11
3824,2021-07-25,PUG,14319,7404,6915,4282,9833,204,ITF,ITF4,16,Puglia,Puglia,4029053,2214289,54.96,0.36
3825,2021-04-09,PUG,22124,9537,12587,17088,4649,387,ITF,ITF4,16,Puglia,Puglia,4029053,2236413,55.51,0.55
3826,2021-02-11,PUG,3699,1401,2298,2392,1279,28,ITF,ITF4,16,Puglia,Puglia,4029053,2240112,55.6,0.09
3827,2021-07-17,PUG,30855,15490,15365,9538,20687,630,ITF,ITF4,16,Puglia,Puglia,4029053,2270967,56.36,0.77
3828,2021-05-14,PUG,45109,20617,24492,28014,16235,860,ITF,ITF4,16,Puglia,Puglia,4029053,2316076,57.48,1.12
3829,2021-08-22,PUG,1474,768,706,531,920,23,ITF,ITF4,16,Puglia,Puglia,4029053,2317550,57.52,0.04
3830,2021-02-23,PUG,9399,4432,4967,8811,496,92,ITF,ITF4,16,Puglia,Puglia,4029053,2326949,57.75,0.23
3831,2021-03-26,PUG,12043,5863,6180,7223,4680,140,ITF,ITF4,16,Puglia,Puglia,4029053,2338992,58.05,0.3
3832,2021-03-09,PUG,13699,6124,7575,11495,2020,184,ITF,ITF4,16,Puglia,Puglia,4029053,2352691,58.39,0.34
3833,2021-04-14,PUG,32069,15128,16941,28458,3305,306,ITF,ITF4,16,Puglia,Puglia,4029053,2384760,59.19,0.8
3834,2021-03-28,PUG,3550,1659,1891,1179,2336,35,ITF,ITF4,16,Puglia,Puglia,4029053,2388310,59.28,0.09
3835,2021-07-06,PUG,42438,19542,22896,6105,35916,417,ITF,ITF4,16,Puglia,Puglia,4029053,2430748,60.33,1.05
3836,2021-06-19,PUG,34830,17468,17362,22226,11950,654,ITF,ITF4,16,Puglia,Puglia,4029053,2465578,61.19,0.86
3837,2021-06-21,PUG,41963,20461,21502,21467,19859,637,ITF,ITF4,16,Puglia,Puglia,4029053,2507541,62.24,1.04
3838,2021-08-24,PUG,25045,12816,12229,9287,14934,824,ITF,ITF4,16,Puglia,Puglia,4029053,2532586,62.86,0.62
3839,2021-07-27,PUG,48648,24206,24442,13356,34484,808,ITF,ITF4,16,Puglia,Puglia,4029053,2581234,64.07,1.21
3840,2021-05-31,PUG,37985,18322,19663,23171,14258,556,ITF,ITF4,16,Puglia,Puglia,4029053,2619219,65.01,0.94
3841,2021-03-14,PUG,3381,1465,1916,2473,867,41,ITF,ITF4,16,Puglia,Puglia,4029053,2622600,65.09,0.08
3842,2021-01-16,PUG,2508,1035,1473,2507,0,1,ITF,ITF4,16,Puglia,Puglia,4029053,2625108,65.15,0.06
3843,2021-07-18,PUG,18845,9651,9194,6207,12301,337,ITF,ITF4,16,Puglia,Puglia,4029053,2643953,65.62,0.47
3844,2021-05-22,PUG,34781,15920,18861,23651,10584,546,ITF,ITF4,16,Puglia,Puglia,4029053,2678734,66.49,0.86
3845,2021-02-25,PUG,11998,5071,6927,10678,1183,137,ITF,ITF4,16,Puglia,Puglia,4029053,2690732,66.78,0.3
3846,2021-06-05,PUG,42681,20905,21776,29200,12760,721,ITF,ITF4,16,Puglia,Puglia,4029053,2733413,67.84,1.06
3847,2021-03-11,PUG,14865,6602,8263,11467,3194,204,ITF,ITF4,16,Puglia,Puglia,4029053,2748278,68.21,0.37
3848,2021-06-02,PUG,27104,13250,13854,21906,4841,357,ITF,ITF4,16,Puglia,Puglia,4029053,2775382,68.88,0.67
3849,2021-03-13,PUG,10486,4140,6346,8572,1817,97,ITF,ITF4,16,Puglia,Puglia,4029053,2785868,69.14,0.26
3850,2021-02-24,PUG,10069,4718,5351,9373,597,99,ITF,ITF4,16,Puglia,Puglia,4029053,2795937,69.39,0.25
3851,2021-03-18,PUG,9624,4375,5249,3344,6214,66,ITF,ITF4,16,Puglia,Puglia,4029053,2805561,69.63,0.24
3852,2021-06-26,PUG,32467,16353,16114,15900,15999,568,ITF,ITF4,16,Puglia,Puglia,4029053,2838028,70.44,0.81
3853,2021-03-04,PUG,15395,6116,9279,13723,1440,232,ITF,ITF4,16,Puglia,Puglia,4029053,2853423,70.82,0.38
3854,2021-06-09,PUG,42015,20807,21208,29983,11324,708,ITF,ITF4,16,Puglia,Puglia,4029053,2895438,71.86,1.04
3855,2021-02-15,PUG,3268,1272,1996,2601,622,45,ITF,ITF4,16,Puglia,Puglia,4029053,2898706,71.95,0.08
3856,2021-01-18,PUG,1848,772,1076,1496,351,1,ITF,ITF4,16,Puglia,Puglia,4029053,2900554,71.99,0.05
3857,2021-02-06,PUG,4556,1935,2621,1578,2963,15,ITF,ITF4,16,Puglia,Puglia,4029053,2905110,72.1,0.11
3858,2021-01-20,PUG,1547,541,1006,1537,8,2,ITF,ITF4,16,Puglia,Puglia,4029053,2906657,72.14,0.04
3859,2021-04-30,PUG,35049,15706,19343,22475,12008,566,ITF,ITF4,16,Puglia,Puglia,4029053,2941706,73.01,0.87
3860,2021-04-13,PUG,28792,13657,15135,24937,3539,316,ITF,ITF4,16,Puglia,Puglia,4029053,2970498,73.73,0.71
3861,2021-07-22,PUG,47645,23625,24020,8491,38468,686,ITF,ITF4,16,Puglia,Puglia,4029053,3018143,74.91,1.18
3862,2021-07-05,PUG,38972,18288,20684,7245,31174,553,ITF,ITF4,16,Puglia,Puglia,4029053,3057115,75.88,0.97
3863,2021-01-25,PUG,3837,1685,2152,424,3412,1,ITF,ITF4,16,Puglia,Puglia,4029053,3060952,75.97,0.1
3864,2021-07-10,PUG,22409,11036,11373,4461,17652,296,ITF,ITF4,16,Puglia,Puglia,4029053,3083361,76.53,0.56
3865,2021-04-08,PUG,17530,7614,9916,11118,6198,214,ITF,ITF4,16,Puglia,Puglia,4029053,3100891,76.96,0.44
3866,2021-06-06,PUG,30769,15500,15269,25377,5071,321,ITF,ITF4,16,Puglia,Puglia,4029053,3131660,77.73,0.76
3867,2021-04-10,PUG,30960,13131,17829,26110,4464,386,ITF,ITF4,16,Puglia,Puglia,4029053,3162620,78.5,0.77
3868,2021-07-19,PUG,49555,24349,25206,10954,37838,763,ITF,ITF4,16,Puglia,Puglia,4029053,3212175,79.73,1.23
3869,2021-04-25,PUG,11328,5243,6085,10050,1144,134,ITF,ITF4,16,Puglia,Puglia,4029053,3223503,80.01,0.28
3870,2021-02-27,PUG,14246,4827,9419,12826,1236,184,ITF,ITF4,16,Puglia,Puglia,4029053,3237749,80.36,0.35
3871,2021-08-03,PUG,36432,18485,17947,9191,26472,769,ITF,ITF4,16,Puglia,Puglia,4029053,3274181,81.26,0.9
3872,2021-01-01,PUG,150,61,89,150,0,0,ITF,ITF4,16,Puglia,Puglia,4029053,3274331,81.27,0.0
3873,2021-06-07,PUG,44473,21710,22763,30388,13320,765,ITF,ITF4,16,Puglia,Puglia,4029053,3318804,82.37,1.1
3874,2021-04-11,PUG,16491,7269,9222,14661,1648,182,ITF,ITF4,16,Puglia,Puglia,4029053,3335295,82.78,0.41
3875,2021-03-06,PUG,16186,6140,10046,13887,2126,173,ITF,ITF4,16,Puglia,Puglia,4029053,3351481,83.18,0.4
3876,2021-01-08,PUG,5695,2395,3300,5693,0,2,ITF,ITF4,16,Puglia,Puglia,4029053,3357176,83.32,0.14
3877,2021-06-14,PUG,42130,20611,21519,28860,12478,792,ITF,ITF4,16,Puglia,Puglia,4029053,3399306,84.37,1.05
3878,2021-04-18,PUG,22689,10857,11832,21435,1058,196,ITF,ITF4,16,Puglia,Puglia,4029053,3421995,84.93,0.56
3879,2021-02-20,PUG,2978,1080,1898,2688,257,33,ITF,ITF4,16,Puglia,Puglia,4029053,3424973,85.01,0.07
3880,2021-05-26,PUG,38743,18613,20130,26244,11843,656,ITF,ITF4,16,Puglia,Puglia,4029053,3463716,85.97,0.96
3881,2021-01-27,PUG,4606,1945,2661,617,3989,0,ITF,ITF4,16,Puglia,Puglia,4029053,3468322,86.08,0.11
3882,2021-05-07,PUG,50268,22431,27837,25977,23694,597,ITF,ITF4,16,Puglia,Puglia,4029053,3518590,87.33,1.25
3883,2021-07-29,PUG,43023,21751,21272,12282,29947,794,ITF,ITF4,16,Puglia,Puglia,4029053,3561613,88.4,1.07
3884,2021-01-13,PUG,4555,1734,2821,4554,0,1,ITF,ITF4,16,Puglia,Puglia,4029053,3566168,88.51,0.11
3885,2021-04-06,PUG,13870,6266,7604,6927,6773,170,ITF,ITF4,16,Puglia,Puglia,4029053,3580038,88.86,0.34
3886,2021-06-04,PUG,52892,25596,27296,34208,17854,830,ITF,ITF4,16,Puglia,Puglia,4029053,3632930,90.17,1.31
3887,2021-05-18,PUG,28989,13486,15503,15794,12910,285,ITF,ITF4,16,Puglia,Puglia,4029053,3661919,90.89,0.72
3888,2021-08-26,PUG,20199,10418,9781,8625,10700,874,ITF,ITF4,16,Puglia,Puglia,4029053,3682118,91.39,0.5
3889,2021-04-29,PUG,26325,12175,14150,19192,6706,427,ITF,ITF4,16,Puglia,Puglia,4029053,3708443,92.04,0.65
3890,2021-08-07,PUG,10088,5326,4762,3542,6249,297,ITF,ITF4,16,Puglia,Puglia,4029053,3718531,92.29,0.25
3891,2021-02-22,PUG,9656,4539,5117,9231,336,89,ITF,ITF4,16,Puglia,Puglia,4029053,3728187,92.53,0.24
3892,2021-02-05,PUG,5652,2278,3374,1311,4336,5,ITF,ITF4,16,Puglia,Puglia,4029053,3733839,92.67,0.14
3893,2021-05-16,PUG,24652,11120,13532,12469,11957,226,ITF,ITF4,16,Puglia,Puglia,4029053,3758491,93.28,0.61
3894,2021-05-21,PUG,39258,18648,20610,28273,10191,794,ITF,ITF4,16,Puglia,Puglia,4029053,3797749,94.26,0.97
3895,2021-08-31,PUG,24570,12647,11923,8202,15524,844,ITF,ITF4,16,Puglia,Puglia,4029053,3822319,94.87,0.61
3896,2021-05-19,PUG,26501,12810,13691,19567,6499,435,ITF,ITF4,16,Puglia,Puglia,4029053,3848820,95.53,0.66
3897,2021-03-23,PUG,11159,5665,5494,4532,6532,95,ITF,ITF4,16,Puglia,Puglia,4029053,3859979,95.8,0.28
3898,2021-08-14,PUG,1086,560,526,497,570,19,ITF,ITF4,16,Puglia,Puglia,4029053,3861065,95.83,0.03
3899,2021-01-15,PUG,4559,1867,2692,4554,0,5,ITF,ITF4,16,Puglia,Puglia,4029053,3865624,95.94,0.11
3900,2021-01-22,PUG,1414,579,835,992,421,1,ITF,ITF4,16,Puglia,Puglia,4029053,3867038,95.98,0.04
3901,2021-08-21,PUG,4292,2299,1993,1960,2098,234,ITF,ITF4,16,Puglia,Puglia,4029053,3871330,96.09,0.11
3902,2021-06-25,PUG,50937,25083,25854,23846,26191,900,ITF,ITF4,16,Puglia,Puglia,4029053,3922267,97.35,1.26
3903,2021-03-25,PUG,11779,6038,5741,5258,6420,101,ITF,ITF4,16,Puglia,Puglia,4029053,3934046,97.64,0.29
3904,2021-08-29,PUG,1285,663,622,422,835,28,ITF,ITF4,16,Puglia,Puglia,4029053,3935331,97.67,0.03
3905,2021-07-03,PUG,33312,16689,16623,13468,19341,503,ITF,ITF4,16,Puglia,Puglia,4029053,3968643,98.5,0.83
3906,2021-02-08,PUG,4011,1622,2389,1583,2413,15,ITF,ITF4,16,Puglia,Puglia,4029053,3972654,98.6,0.1
3907,2021-04-01,PUG,13983,6572,7411,7383,6382,218,ITF,ITF4,16,Puglia,Puglia,4029053,3986637,98.95,0.35
3908,2021-02-03,PUG,5056,2008,3048,705,4350,1,ITF,ITF4,16,Puglia,Puglia,4029053,3991693,99.07,0.13
3909,2021-07-12,PUG,45810,21627,24183,12744,32313,753,ITF,ITF4,16,Puglia,Puglia,4029053,4037503,100.21,1.14
3910,2021-02-10,PUG,3660,1444,2216,2127,1513,20,ITF,ITF4,16,Puglia,Puglia,4029053,4041163,100.3,0.09
3911,2021-05-23,PUG,17979,8407,9572,13879,3839,261,ITF,ITF4,16,Puglia,Puglia,4029053,4059142,100.75,0.45
3912,2021-02-17,PUG,4296,1754,2542,3616,640,40,ITF,ITF4,16,Puglia,Puglia,4029053,4063438,100.85,0.11
3913,2021-05-28,PUG,44142,20900,23242,27435,15905,802,ITF,ITF4,16,Puglia,Puglia,4029053,4107580,101.95,1.1
3914,2021-07-26,PUG,47984,23950,24034,17115,29944,925,ITF,ITF4,16,Puglia,Puglia,4029053,4155564,103.14,1.19
3915,2021-05-30,PUG,21063,10079,10984,15730,5076,257,ITF,ITF4,16,Puglia,Puglia,4029053,4176627,103.66,0.52
3916,2021-07-15,PUG,44910,21733,23177,8890,35343,677,ITF,ITF4,16,Puglia,Puglia,4029053,4221537,104.78,1.11
3917,2021-07-14,PUG,46278,22200,24078,13377,32066,835,ITF,ITF4,16,Puglia,Puglia,4029053,4267815,105.93,1.15
3918,2021-08-02,PUG,39708,20125,19583,14171,24309,1228,ITF,ITF4,16,Puglia,Puglia,4029053,4307523,106.91,0.99
3919,2021-03-01,PUG,15136,5882,9254,13597,1385,154,ITF,ITF4,16,Puglia,Puglia,4029053,4322659,107.29,0.38
3920,2021-05-02,PUG,21363,9679,11684,13904,7279,180,ITF,ITF4,16,Puglia,Puglia,4029053,4344022,107.82,0.53
3921,2021-08-10,PUG,27158,14112,13046,13960,12033,1165,ITF,ITF4,16,Puglia,Puglia,4029053,4371180,108.49,0.67
3922,2021-07-24,PUG,26757,13883,12874,8004,18280,473,ITF,ITF4,16,Puglia,Puglia,4029053,4397937,109.16,0.66
3923,2021-06-18,PUG,47900,23575,24325,28884,18090,926,ITF,ITF4,16,Puglia,Puglia,4029053,4445837,110.34,1.19
3924,2021-09-02,PUG,22669,11791,10878,7303,14514,852,ITF,ITF4,16,Puglia,Puglia,4029053,4468506,110.91,0.56
3925,2021-01-10,PUG,2351,1062,1289,2351,0,0,ITF,ITF4,16,Puglia,Puglia,4029053,4470857,110.97,0.06
3926,2021-04-20,PUG,21230,9860,11370,17475,3486,269,ITF,ITF4,16,Puglia,Puglia,4029053,4492087,111.49,0.53
3927,2020-12-27,PUG,510,252,258,510,0,0,ITF,ITF4,16,Puglia,Puglia,4029053,4492597,111.51,0.01
3928,2021-08-05,PUG,34333,17262,17071,9412,24040,881,ITF,ITF4,16,Puglia,Puglia,4029053,4526930,112.36,0.85
3929,2021-01-06,PUG,3964,1680,2284,3963,0,1,ITF,ITF4,16,Puglia,Puglia,4029053,4530894,112.46,0.1
3930,2021-08-12,PUG,19411,10320,9091,10946,7555,910,ITF,ITF4,16,Puglia,Puglia,4029053,4550305,112.94,0.48
3931,2021-06-16,PUG,42174,20757,21417,26923,14521,730,ITF,ITF4,16,Puglia,Puglia,4029053,4592479,113.98,1.05
3932,2020-12-30,PUG,1,0,1,1,0,0,ITF,ITF4,16,Puglia,Puglia,4029053,4592480,113.98,0.0
3933,2021-03-22,PUG,9986,5139,4847,4246,5669,71,ITF,ITF4,16,Puglia,Puglia,4029053,4602466,114.23,0.25
3934,2021-01-24,PUG,1673,754,919,151,1522,0,ITF,ITF4,16,Puglia,Puglia,4029053,4604139,114.27,0.04
3935,2021-06-30,PUG,47935,23251,24684,18841,28236,858,ITF,ITF4,16,Puglia,Puglia,4029053,4652074,115.46,1.19
3936,2021-03-15,PUG,12362,6160,6202,5739,6518,105,ITF,ITF4,16,Puglia,Puglia,4029053,4664436,115.77,0.31
3937,2021-08-19,PUG,17816,9283,8533,8718,8374,724,ITF,ITF4,16,Puglia,Puglia,4029053,4682252,116.21,0.44
3938,2021-01-17,PUG,1311,592,719,1241,70,0,ITF,ITF4,16,Puglia,Puglia,4029053,4683563,116.24,0.03
3939,2021-06-23,PUG,29447,14389,15058,16944,11892,611,ITF,ITF4,16,Puglia,Puglia,4029053,4713010,116.98,0.73
3940,2021-04-27,PUG,26738,12101,14637,20785,5626,327,ITF,ITF4,16,Puglia,Puglia,4029053,4739748,117.64,0.66
3941,2021-05-11,PUG,32743,14470,18273,13704,18550,489,ITF,ITF4,16,Puglia,Puglia,4029053,4772491,118.45,0.81
3942,2021-05-04,PUG,35233,14904,20329,18247,16565,421,ITF,ITF4,16,Puglia,Puglia,4029053,4807724,119.33,0.87
3943,2021-03-08,PUG,15017,6445,8572,12442,2415,160,ITF,ITF4,16,Puglia,Puglia,4029053,4822741,119.7,0.37
3944,2021-01-03,PUG,2010,945,1065,2009,0,1,ITF,ITF4,16,Puglia,Puglia,4029053,4824751,119.75,0.05
3945,2021-03-27,PUG,12184,5724,6460,6882,5190,112,ITF,ITF4,16,Puglia,Puglia,4029053,4836935,120.05,0.3
3946,2021-01-05,PUG,5118,2256,2862,5115,0,3,ITF,ITF4,16,Puglia,Puglia,4029053,4842053,120.18,0.13
3947,2021-04-15,PUG,32792,15303,17489,28609,3782,401,ITF,ITF4,16,Puglia,Puglia,4029053,4874845,120.99,0.81
3948,2021-07-07,PUG,38774,18563,20211,6092,32173,509,ITF,ITF4,16,Puglia,Puglia,4029053,4913619,121.95,0.96
3949,2021-03-02,PUG,16428,6106,10322,14871,1310,247,ITF,ITF4,16,Puglia,Puglia,4029053,4930047,122.36,0.41
3950,2021-06-10,PUG,47271,23245,24026,29413,17139,719,ITF,ITF4,16,Puglia,Puglia,4029053,4977318,123.54,1.17
3951,2021-04-04,PUG,5998,2977,3021,5909,7,82,ITF,ITF4,16,Puglia,Puglia,4029053,4983316,123.68,0.15
3952,2021-07-13,PUG,48850,23035,25815,7792,40473,585,ITF,ITF4,16,Puglia,Puglia,4029053,5032166,124.9,1.21
3953,2021-03-21,PUG,2697,1227,1470,578,2107,12,ITF,ITF4,16,Puglia,Puglia,4029053,5034863,124.96,0.07
3954,2021-06-29,PUG,46747,22421,24326,15367,30687,693,ITF,ITF4,16,Puglia,Puglia,4029053,5081610,126.12,1.16
3955,2021-01-11,PUG,3758,1592,2166,3757,0,1,ITF,ITF4,16,Puglia,Puglia,4029053,5085368,126.22,0.09
3956,2021-04-21,PUG,23174,10700,12474,19127,3746,301,ITF,ITF4,16,Puglia,Puglia,4029053,5108542,126.79,0.58
3957,2021-05-24,PUG,36226,17092,19134,24508,11106,612,ITF,ITF4,16,Puglia,Puglia,4029053,5144768,127.69,0.9
3958,2021-09-01,PUG,24365,12650,11715,9675,13635,1055,ITF,ITF4,16,Puglia,Puglia,4029053,5169133,128.3,0.6
3959,2021-02-16,PUG,3392,1456,1936,2712,649,31,ITF,ITF4,16,Puglia,Puglia,4029053,5172525,128.38,0.08
3960,2021-01-30,PUG,5542,2516,3026,380,5161,1,ITF,ITF4,16,Puglia,Puglia,4029053,5178067,128.52,0.14
3961,2021-05-10,PUG,37929,16764,21165,19319,18106,504,ITF,ITF4,16,Puglia,Puglia,4029053,5215996,129.46,0.94
3962,2021-08-17,PUG,19927,10340,9587,9261,9963,703,ITF,ITF4,16,Puglia,Puglia,4029053,5235923,129.95,0.49
3963,2021-02-13,PUG,3732,1460,2272,3020,696,16,ITF,ITF4,16,Puglia,Puglia,4029053,5239655,130.05,0.09
3964,2021-06-28,PUG,48734,23638,25096,21665,26272,797,ITF,ITF4,16,Puglia,Puglia,4029053,5288389,131.26,1.21
3965,2021-05-09,PUG,30847,12662,18185,14796,15678,373,ITF,ITF4,16,Puglia,Puglia,4029053,5319236,132.02,0.77
3966,2021-04-22,PUG,23073,10558,12515,17739,4948,386,ITF,ITF4,16,Puglia,Puglia,4029053,5342309,132.59,0.57
3967,2021-07-31,PUG,20001,10626,9375,7889,11632,480,ITF,ITF4,16,Puglia,Puglia,4029053,5362310,133.09,0.5
3968,2021-02-12,PUG,4216,1673,2543,3098,1094,24,ITF,ITF4,16,Puglia,Puglia,4029053,5366526,133.2,0.1
3969,2021-01-29,PUG,6216,2671,3545,220,5996,0,ITF,ITF4,16,Puglia,Puglia,4029053,5372742,133.35,0.15
3970,2021-03-20,PUG,8441,3891,4550,3769,4626,46,ITF,ITF4,16,Puglia,Puglia,4029053,5381183,133.56,0.21
3971,2021-03-03,PUG,16830,6828,10002,14737,1940,153,ITF,ITF4,16,Puglia,Puglia,4029053,5398013,133.98,0.42
3972,2021-06-11,PUG,48042,23500,24542,33016,14116,910,ITF,ITF4,16,Puglia,Puglia,4029053,5446055,135.17,1.19
3973,2021-04-03,PUG,10587,4661,5926,6817,3577,193,ITF,ITF4,16,Puglia,Puglia,4029053,5456642,135.43,0.26
3974,2021-01-22,ABR,118,57,61,118,0,0,ITF,ITF1,13,Abruzzo,Abruzzo,1304970,118,0.01,0.01
3975,2021-01-03,ABR,501,212,289,499,0,2,ITF,ITF1,13,Abruzzo,Abruzzo,1304970,619,0.05,0.04
3976,2021-05-30,ABR,8661,4110,4551,5327,3255,79,ITF,ITF1,13,Abruzzo,Abruzzo,1304970,9280,0.71,0.66
3977,2021-04-03,ABR,5162,2258,2904,3484,1598,80,ITF,ITF1,13,Abruzzo,Abruzzo,1304970,14442,1.11,0.4
3978,2021-07-26,ABR,14260,7460,6800,3871,10191,198,ITF,ITF1,13,Abruzzo,Abruzzo,1304970,28702,2.2,1.09
3979,2021-07-12,ABR,15078,7459,7619,2360,12601,117,ITF,ITF1,13,Abruzzo,Abruzzo,1304970,43780,3.35,1.16
3980,2021-01-10,ABR,1271,539,732,1267,0,4,ITF,ITF1,13,Abruzzo,Abruzzo,1304970,45051,3.45,0.1
3981,2021-04-29,ABR,12683,5854,6829,9273,3097,313,ITF,ITF1,13,Abruzzo,Abruzzo,1304970,57734,4.42,0.97
3982,2021-08-07,ABR,6490,3615,2875,1837,4558,95,ITF,ITF1,13,Abruzzo,Abruzzo,1304970,64224,4.92,0.5
3983,2021-06-25,ABR,11061,5479,5582,4905,6013,143,ITF,ITF1,13,Abruzzo,Abruzzo,1304970,75285,5.77,0.85
3984,2021-01-15,ABR,385,155,230,371,0,14,ITF,ITF1,13,Abruzzo,Abruzzo,1304970,75670,5.8,0.03
3985,2021-02-22,ABR,2642,1174,1468,2586,30,26,ITF,ITF1,13,Abruzzo,Abruzzo,1304970,78312,6.0,0.2
3986,2021-02-05,ABR,1535,521,1014,772,747,16,ITF,ITF1,13,Abruzzo,Abruzzo,1304970,79847,6.12,0.12
3987,2021-05-16,ABR,9580,4134,5446,5647,3812,121,ITF,ITF1,13,Abruzzo,Abruzzo,1304970,89427,6.85,0.73
3988,2021-06-04,ABR,15651,7397,8254,10757,4705,189,ITF,ITF1,13,Abruzzo,Abruzzo,1304970,105078,8.05,1.2
3989,2021-05-18,ABR,12111,5660,6451,7562,4379,170,ITF,ITF1,13,Abruzzo,Abruzzo,1304970,117189,8.98,0.93
3990,2021-02-24,ABR,3306,1442,1864,3112,177,17,ITF,ITF1,13,Abruzzo,Abruzzo,1304970,120495,9.23,0.25
3991,2021-08-09,ABR,10701,5546,5155,3095,7413,193,ITF,ITF1,13,Abruzzo,Abruzzo,1304970,131196,10.05,0.82
3992,2021-08-26,ABR,5769,3015,2754,2014,3604,151,ITF,ITF1,13,Abruzzo,Abruzzo,1304970,136965,10.5,0.44
3993,2020-12-27,ABR,47,24,23,47,0,0,ITF,ITF1,13,Abruzzo,Abruzzo,1304970,137012,10.5,0.0
3994,2021-03-20,ABR,4794,2200,2594,2563,2171,60,ITF,ITF1,13,Abruzzo,Abruzzo,1304970,141806,10.87,0.37
3995,2021-06-13,ABR,9844,4925,4919,7846,1833,165,ITF,ITF1,13,Abruzzo,Abruzzo,1304970,151650,11.62,0.75
3996,2021-03-03,ABR,4641,1899,2742,3716,906,19,ITF,ITF1,13,Abruzzo,Abruzzo,1304970,156291,11.98,0.36
3997,2021-07-14,ABR,13722,6798,6924,2436,11135,151,ITF,ITF1,13,Abruzzo,Abruzzo,1304970,170013,13.03,1.05
3998,2021-04-08,ABR,7394,3334,4060,4935,2331,128,ITF,ITF1,13,Abruzzo,Abruzzo,1304970,177407,13.59,0.57
3999,2021-04-22,ABR,6736,3251,3485,4827,1733,176,ITF,ITF1,13,Abruzzo,Abruzzo,1304970,184143,14.11,0.52
4000,2021-07-31,ABR,11741,6341,5400,3479,8059,203,ITF,ITF1,13,Abruzzo,Abruzzo,1304970,195884,15.01,0.9
4001,2021-08-21,ABR,3843,2098,1745,1729,1992,122,ITF,ITF1,13,Abruzzo,Abruzzo,1304970,199727,15.31,0.29
4002,2021-05-04,ABR,10854,5093,5761,7042,3625,187,ITF,ITF1,13,Abruzzo,Abruzzo,1304970,210581,16.14,0.83
4003,2021-03-08,ABR,5156,1695,3461,4085,976,95,ITF,ITF1,13,Abruzzo,Abruzzo,1304970,215737,16.53,0.4
4004,2021-01-24,ABR,50,22,28,6,44,0,ITF,ITF1,13,Abruzzo,Abruzzo,1304970,215787,16.54,0.0
4005,2021-02-10,ABR,946,311,635,492,444,10,ITF,ITF1,13,Abruzzo,Abruzzo,1304970,216733,16.61,0.07
4006,2021-02-12,ABR,1228,567,661,1026,189,13,ITF,ITF1,13,Abruzzo,Abruzzo,1304970,217961,16.7,0.09
4007,2021-07-19,ABR,11776,5982,5794,2664,8942,170,ITF,ITF1,13,Abruzzo,Abruzzo,1304970,229737,17.6,0.9
4008,2021-05-23,ABR,9880,4693,5187,7067,2692,121,ITF,ITF1,13,Abruzzo,Abruzzo,1304970,239617,18.36,0.76
4009,2021-06-06,ABR,11152,5310,5842,8777,2242,133,ITF,ITF1,13,Abruzzo,Abruzzo,1304970,250769,19.22,0.85
4010,2021-04-10,ABR,8778,4060,4718,6123,2510,145,ITF,ITF1,13,Abruzzo,Abruzzo,1304970,259547,19.89,0.67
4011,2021-03-27,ABR,6124,2622,3502,3560,2492,72,ITF,ITF1,13,Abruzzo,Abruzzo,1304970,265671,20.36,0.47
4012,2021-01-05,ABR,1735,721,1014,1730,0,5,ITF,ITF1,13,Abruzzo,Abruzzo,1304970,267406,20.49,0.13
4013,2021-04-15,ABR,7829,3686,4143,5825,1843,161,ITF,ITF1,13,Abruzzo,Abruzzo,1304970,275235,21.09,0.6
4014,2021-07-07,ABR,12068,5908,6160,4032,7794,242,ITF,ITF1,13,Abruzzo,Abruzzo,1304970,287303,22.02,0.92
4015,2021-03-22,ABR,4348,1912,2436,2311,1971,66,ITF,ITF1,13,Abruzzo,Abruzzo,1304970,291651,22.35,0.33
4016,2021-06-30,ABR,11171,5431,5740,4496,6509,166,ITF,ITF1,13,Abruzzo,Abruzzo,1304970,302822,23.21,0.86
4017,2021-02-17,ABR,2071,948,1123,1780,282,9,ITF,ITF1,13,Abruzzo,Abruzzo,1304970,304893,23.36,0.16
4018,2021-09-02,ABR,6123,3203,2920,1864,4129,130,ITF,ITF1,13,Abruzzo,Abruzzo,1304970,311016,23.83,0.47
4019,2021-06-11,ABR,11783,5855,5928,8832,2765,186,ITF,ITF1,13,Abruzzo,Abruzzo,1304970,322799,24.74,0.9
4020,2021-08-19,ABR,6724,3611,3113,3256,3277,191,ITF,ITF1,13,Abruzzo,Abruzzo,1304970,329523,25.25,0.52
4021,2021-08-28,ABR,2306,1332,974,702,1555,49,ITF,ITF1,13,Abruzzo,Abruzzo,1304970,331829,25.43,0.18
4022,2021-04-27,ABR,9083,4366,4717,6504,2466,113,ITF,ITF1,13,Abruzzo,Abruzzo,1304970,340912,26.12,0.7
4023,2021-07-02,ABR,11834,5946,5888,4830,6820,184,ITF,ITF1,13,Abruzzo,Abruzzo,1304970,352746,27.03,0.91
4024,2021-03-15,ABR,3680,1445,2235,1840,1808,32,ITF,ITF1,13,Abruzzo,Abruzzo,1304970,356426,27.31,0.28
4025,2021-01-17,ABR,193,64,129,185,7,1,ITF,ITF1,13,Abruzzo,Abruzzo,1304970,356619,27.33,0.01
4026,2021-06-23,ABR,11016,5284,5732,5579,5291,146,ITF,ITF1,13,Abruzzo,Abruzzo,1304970,367635,28.17,0.84
4027,2021-01-29,ABR,1387,449,938,71,1315,1,ITF,ITF1,13,Abruzzo,Abruzzo,1304970,369022,28.28,0.11
4028,2021-08-02,ABR,13855,7155,6700,3545,10051,259,ITF,ITF1,13,Abruzzo,Abruzzo,1304970,382877,29.34,1.06
4029,2021-03-01,ABR,3477,1384,2093,2702,751,24,ITF,ITF1,13,Abruzzo,Abruzzo,1304970,386354,29.61,0.27
4030,2021-08-14,ABR,128,69,59,101,25,2,ITF,ITF1,13,Abruzzo,Abruzzo,1304970,386482,29.62,0.01
4031,2021-06-18,ABR,10194,5005,5189,6552,3494,148,ITF,ITF1,13,Abruzzo,Abruzzo,1304970,396676,30.4,0.78
4032,2021-02-02,ABR,1764,668,1096,218,1542,4,ITF,ITF1,13,Abruzzo,Abruzzo,1304970,398440,30.53,0.14
4033,2021-05-13,ABR,11151,5044,6107,6957,3962,232,ITF,ITF1,13,Abruzzo,Abruzzo,1304970,409591,31.39,0.85
4034,2021-07-21,ABR,11077,5717,5360,2425,8517,135,ITF,ITF1,13,Abruzzo,Abruzzo,1304970,420668,32.24,0.85
4035,2021-02-03,ABR,2062,717,1345,411,1643,8,ITF,ITF1,13,Abruzzo,Abruzzo,1304970,422730,32.39,0.16
4036,2021-04-17,ABR,7358,3402,3956,4210,3051,97,ITF,ITF1,13,Abruzzo,Abruzzo,1304970,430088,32.96,0.56
4037,2021-02-19,ABR,3300,1552,1748,3161,100,39,ITF,ITF1,13,Abruzzo,Abruzzo,1304970,433388,33.21,0.25
4038,2021-07-09,ABR,13611,6794,6817,2888,10584,139,ITF,ITF1,13,Abruzzo,Abruzzo,1304970,446999,34.25,1.04
4039,2021-06-22,ABR,10412,4878,5534,5386,4847,179,ITF,ITF1,13,Abruzzo,Abruzzo,1304970,457411,35.05,0.8
4040,2021-05-11,ABR,10763,5120,5643,5731,4856,176,ITF,ITF1,13,Abruzzo,Abruzzo,1304970,468174,35.88,0.82
4041,2021-08-18,ABR,7376,3915,3461,3088,4098,190,ITF,ITF1,13,Abruzzo,Abruzzo,1304970,475550,36.44,0.57
4042,2021-04-05,ABR,2692,1147,1545,1729,880,83,ITF,ITF1,13,Abruzzo,Abruzzo,1304970,478242,36.65,0.21
4043,2021-01-19,ABR,112,56,56,90,21,1,ITF,ITF1,13,Abruzzo,Abruzzo,1304970,478354,36.66,0.01
4044,2021-02-07,ABR,780,308,472,200,579,1,ITF,ITF1,13,Abruzzo,Abruzzo,1304970,479134,36.72,0.06
4045,2021-07-23,ABR,12573,6463,6110,2851,9562,160,ITF,ITF1,13,Abruzzo,Abruzzo,1304970,491707,37.68,0.96
4046,2021-01-21,ABR,157,47,110,157,0,0,ITF,ITF1,13,Abruzzo,Abruzzo,1304970,491864,37.69,0.01
4047,2021-05-01,ABR,10748,5049,5699,5630,4982,136,ITF,ITF1,13,Abruzzo,Abruzzo,1304970,502612,38.52,0.82
4048,2021-05-20,ABR,12809,5926,6883,7413,5268,128,ITF,ITF1,13,Abruzzo,Abruzzo,1304970,515421,39.5,0.98
4049,2021-03-17,ABR,4541,1873,2668,2778,1740,23,ITF,ITF1,13,Abruzzo,Abruzzo,1304970,519962,39.84,0.35
4050,2021-03-24,ABR,6388,2786,3602,3993,2252,143,ITF,ITF1,13,Abruzzo,Abruzzo,1304970,526350,40.33,0.49
4051,2021-03-31,ABR,6722,2946,3776,4559,2069,94,ITF,ITF1,13,Abruzzo,Abruzzo,1304970,533072,40.85,0.52
4052,2021-05-15,ABR,11445,5184,6261,5941,5326,178,ITF,ITF1,13,Abruzzo,Abruzzo,1304970,544517,41.73,0.88
4053,2021-08-23,ABR,5919,3108,2811,1662,4113,144,ITF,ITF1,13,Abruzzo,Abruzzo,1304970,550436,42.18,0.45
4054,2021-07-11,ABR,9887,4976,4911,2365,7387,135,ITF,ITF1,13,Abruzzo,Abruzzo,1304970,560323,42.94,0.76
4055,2021-03-10,ABR,5051,1686,3365,4027,957,67,ITF,ITF1,13,Abruzzo,Abruzzo,1304970,565374,43.32,0.39
4056,2021-01-26,ABR,1549,568,981,31,1518,0,ITF,ITF1,13,Abruzzo,Abruzzo,1304970,566923,43.44,0.12
4057,2021-05-06,ABR,13004,6087,6917,7797,5048,159,ITF,ITF1,13,Abruzzo,Abruzzo,1304970,579927,44.44,1.0
4058,2021-01-12,ABR,1900,761,1139,1886,0,14,ITF,ITF1,13,Abruzzo,Abruzzo,1304970,581827,44.59,0.15
4059,2021-05-25,ABR,11421,5325,6096,8084,3139,198,ITF,ITF1,13,Abruzzo,Abruzzo,1304970,593248,45.46,0.88
4060,2021-01-31,ABR,1523,494,1029,286,1236,1,ITF,ITF1,13,Abruzzo,Abruzzo,1304970,594771,45.58,0.12
4061,2021-05-10,ABR,10108,4783,5325,5350,4650,108,ITF,ITF1,13,Abruzzo,Abruzzo,1304970,604879,46.35,0.77
4062,2021-02-28,ABR,1703,509,1194,1665,2,36,ITF,ITF1,13,Abruzzo,Abruzzo,1304970,606582,46.48,0.13
4063,2021-08-04,ABR,10883,5630,5253,4302,6337,244,ITF,ITF1,13,Abruzzo,Abruzzo,1304970,617465,47.32,0.83
4064,2021-01-02,ABR,559,226,333,558,0,1,ITF,ITF1,13,Abruzzo,Abruzzo,1304970,618024,47.36,0.04
4065,2021-06-08,ABR,12875,6626,6249,10438,2196,241,ITF,ITF1,13,Abruzzo,Abruzzo,1304970,630899,48.35,0.99
4066,2021-04-26,ABR,8562,4066,4496,7138,1213,211,ITF,ITF1,13,Abruzzo,Abruzzo,1304970,639461,49.0,0.66
4067,2021-06-01,ABR,10999,4877,6122,6511,4367,121,ITF,ITF1,13,Abruzzo,Abruzzo,1304970,650460,49.84,0.84
4068,2021-04-09,ABR,8996,4262,4734,6249,2603,144,ITF,ITF1,13,Abruzzo,Abruzzo,1304970,659456,50.53,0.69
4069,2021-07-18,ABR,12205,6310,5895,2003,10082,120,ITF,ITF1,13,Abruzzo,Abruzzo,1304970,671661,51.47,0.94
4070,2021-04-02,ABR,6696,3104,3592,5112,1489,95,ITF,ITF1,13,Abruzzo,Abruzzo,1304970,678357,51.98,0.51
4071,2021-02-04,ABR,1685,617,1068,601,1072,12,ITF,ITF1,13,Abruzzo,Abruzzo,1304970,680042,52.11,0.13
4072,2021-07-20,ABR,12585,6385,6200,3224,9176,185,ITF,ITF1,13,Abruzzo,Abruzzo,1304970,692627,53.08,0.96
4073,2021-08-11,ABR,8277,4416,3861,2614,5505,158,ITF,ITF1,13,Abruzzo,Abruzzo,1304970,700904,53.71,0.63
4074,2021-03-29,ABR,5710,2600,3110,3020,2640,50,ITF,ITF1,13,Abruzzo,Abruzzo,1304970,706614,54.15,0.44
4075,2021-06-03,ABR,13199,6286,6913,9245,3779,175,ITF,ITF1,13,Abruzzo,Abruzzo,1304970,719813,55.16,1.01
4076,2021-03-12,ABR,6043,1993,4050,4353,1611,79,ITF,ITF1,13,Abruzzo,Abruzzo,1304970,725856,55.62,0.46
4077,2021-06-20,ABR,8443,4237,4206,5409,2931,103,ITF,ITF1,13,Abruzzo,Abruzzo,1304970,734299,56.27,0.65
4078,2021-03-14,ABR,1886,732,1154,1204,669,13,ITF,ITF1,13,Abruzzo,Abruzzo,1304970,736185,56.41,0.14
4079,2021-02-25,ABR,3056,1344,1712,2507,530,19,ITF,ITF1,13,Abruzzo,Abruzzo,1304970,739241,56.65,0.23
4080,2021-06-05,ABR,14617,6865,7752,10365,4051,201,ITF,ITF1,13,Abruzzo,Abruzzo,1304970,753858,57.77,1.12
4081,2021-08-08,ABR,4453,2430,2023,1886,2477,90,ITF,ITF1,13,Abruzzo,Abruzzo,1304970,758311,58.11,0.34
4082,2021-05-17,ABR,11038,5040,5998,6019,4856,163,ITF,ITF1,13,Abruzzo,Abruzzo,1304970,769349,58.96,0.85
4083,2021-08-25,ABR,7123,3792,3331,2370,4584,169,ITF,ITF1,13,Abruzzo,Abruzzo,1304970,776472,59.5,0.55
4084,2021-01-07,ABR,1711,657,1054,1704,0,7,ITF,ITF1,13,Abruzzo,Abruzzo,1304970,778183,59.63,0.13
4085,2021-07-30,ABR,12088,6435,5653,3794,8070,224,ITF,ITF1,13,Abruzzo,Abruzzo,1304970,790271,60.56,0.93
4086,2021-02-26,ABR,3923,1679,2244,2928,969,26,ITF,ITF1,13,Abruzzo,Abruzzo,1304970,794194,60.86,0.3
4087,2021-02-09,ABR,920,322,598,510,409,1,ITF,ITF1,13,Abruzzo,Abruzzo,1304970,795114,60.93,0.07
4088,2021-07-04,ABR,8372,4216,4156,3332,4915,125,ITF,ITF1,13,Abruzzo,Abruzzo,1304970,803486,61.57,0.64
4089,2021-08-30,ABR,7420,4060,3360,1947,5344,129,ITF,ITF1,13,Abruzzo,Abruzzo,1304970,810906,62.14,0.57
4090,2021-09-01,ABR,6862,3652,3210,1581,5182,99,ITF,ITF1,13,Abruzzo,Abruzzo,1304970,817768,62.67,0.53
4091,2021-04-19,ABR,6233,2862,3371,3786,2374,73,ITF,ITF1,13,Abruzzo,Abruzzo,1304970,824001,63.14,0.48
4092,2021-02-21,ABR,1218,550,668,1193,1,24,ITF,ITF1,13,Abruzzo,Abruzzo,1304970,825219,63.24,0.09
4093,2021-07-28,ABR,13273,6954,6319,3435,9671,167,ITF,ITF1,13,Abruzzo,Abruzzo,1304970,838492,64.25,1.02
4094,2021-06-15,ABR,11331,5563,5768,8683,2439,209,ITF,ITF1,13,Abruzzo,Abruzzo,1304970,849823,65.12,0.87
4095,2021-04-12,ABR,6241,2959,3282,4985,1175,81,ITF,ITF1,13,Abruzzo,Abruzzo,1304970,856064,65.6,0.48
4096,2021-08-27,ABR,7952,4190,3762,2464,5328,160,ITF,ITF1,13,Abruzzo,Abruzzo,1304970,864016,66.21,0.61
4097,2021-02-23,ABR,2780,1273,1507,2754,11,15,ITF,ITF1,13,Abruzzo,Abruzzo,1304970,866796,66.42,0.21
4098,2021-02-06,ABR,1614,746,868,595,1012,7,ITF,ITF1,13,Abruzzo,Abruzzo,1304970,868410,66.55,0.12
4099,2021-02-08,ABR,1196,396,800,486,710,0,ITF,ITF1,13,Abruzzo,Abruzzo,1304970,869606,66.64,0.09
4100,2021-04-23,ABR,7402,3397,4005,4926,2307,169,ITF,ITF1,13,Abruzzo,Abruzzo,1304970,877008,67.21,0.57
4101,2021-01-30,ABR,1514,570,944,63,1450,1,ITF,ITF1,13,Abruzzo,Abruzzo,1304970,878522,67.32,0.12
4102,2021-08-01,ABR,7571,4056,3515,2005,5464,102,ITF,ITF1,13,Abruzzo,Abruzzo,1304970,886093,67.9,0.58
4103,2021-06-19,ABR,10559,5203,5356,6485,3901,173,ITF,ITF1,13,Abruzzo,Abruzzo,1304970,896652,68.71,0.81
4104,2021-03-28,ABR,2429,1018,1411,1994,385,50,ITF,ITF1,13,Abruzzo,Abruzzo,1304970,899081,68.9,0.19
4105,2021-07-06,ABR,10463,5199,5264,4300,5988,175,ITF,ITF1,13,Abruzzo,Abruzzo,1304970,909544,69.7,0.8
4106,2021-04-14,ABR,6598,2952,3646,4339,2123,136,ITF,ITF1,13,Abruzzo,Abruzzo,1304970,916142,70.2,0.51
4107,2021-01-04,ABR,1514,685,829,1508,0,6,ITF,ITF1,13,Abruzzo,Abruzzo,1304970,917656,70.32,0.12
4108,2021-01-23,ABR,265,116,149,51,208,6,ITF,ITF1,13,Abruzzo,Abruzzo,1304970,917921,70.34,0.02
4109,2021-05-03,ABR,11153,5260,5893,7130,3837,186,ITF,ITF1,13,Abruzzo,Abruzzo,1304970,929074,71.2,0.85
4110,2021-04-04,ABR,1632,768,864,1458,129,45,ITF,ITF1,13,Abruzzo,Abruzzo,1304970,930706,71.32,0.13
4111,2021-07-13,ABR,15524,7752,7772,2825,12522,177,ITF,ITF1,13,Abruzzo,Abruzzo,1304970,946230,72.51,1.19
4112,2021-08-12,ABR,8768,4626,4142,3181,5407,180,ITF,ITF1,13,Abruzzo,Abruzzo,1304970,954998,73.18,0.67
4113,2021-06-16,ABR,10896,5452,5444,7991,2688,217,ITF,ITF1,13,Abruzzo,Abruzzo,1304970,965894,74.02,0.83
4114,2021-02-27,ABR,2813,1339,1474,2513,267,33,ITF,ITF1,13,Abruzzo,Abruzzo,1304970,968707,74.23,0.22
4115,2021-06-07,ABR,11102,5290,5812,9072,1844,186,ITF,ITF1,13,Abruzzo,Abruzzo,1304970,979809,75.08,0.85
4116,2021-04-11,ABR,5380,2629,2751,4835,487,58,ITF,ITF1,13,Abruzzo,Abruzzo,1304970,985189,75.5,0.41
4117,2021-06-09,ABR,11575,6093,5482,9707,1686,182,ITF,ITF1,13,Abruzzo,Abruzzo,1304970,996764,76.38,0.89
4118,2021-01-18,ABR,154,71,83,53,101,0,ITF,ITF1,13,Abruzzo,Abruzzo,1304970,996918,76.39,0.01
4119,2021-06-24,ABR,10875,5412,5463,5726,4979,170,ITF,ITF1,13,Abruzzo,Abruzzo,1304970,1007793,77.23,0.83
4120,2021-04-28,ABR,9518,4591,4927,7309,2025,184,ITF,ITF1,13,Abruzzo,Abruzzo,1304970,1017311,77.96,0.73
4121,2021-05-12,ABR,9631,4602,5029,5871,3582,178,ITF,ITF1,13,Abruzzo,Abruzzo,1304970,1026942,78.69,0.74
4122,2021-03-16,ABR,3484,1452,2032,1802,1654,28,ITF,ITF1,13,Abruzzo,Abruzzo,1304970,1030426,78.96,0.27
4123,2021-08-20,ABR,6049,3167,2882,2034,3884,131,ITF,ITF1,13,Abruzzo,Abruzzo,1304970,1036475,79.43,0.46
4124,2021-08-06,ABR,10674,5706,4968,3687,6745,242,ITF,ITF1,13,Abruzzo,Abruzzo,1304970,1047149,80.24,0.82
4125,2021-05-05,ABR,11645,5574,6071,6275,5210,160,ITF,ITF1,13,Abruzzo,Abruzzo,1304970,1058794,81.14,0.89
4126,2021-03-09,ABR,5177,1805,3372,4148,938,91,ITF,ITF1,13,Abruzzo,Abruzzo,1304970,1063971,81.53,0.4
4127,2021-08-13,ABR,7119,3830,3289,2014,5000,105,ITF,ITF1,13,Abruzzo,Abruzzo,1304970,1071090,82.08,0.55
4128,2021-07-01,ABR,12763,6283,6480,5769,6769,225,ITF,ITF1,13,Abruzzo,Abruzzo,1304970,1083853,83.06,0.98
4129,2021-06-29,ABR,11430,5640,5790,5246,5997,187,ITF,ITF1,13,Abruzzo,Abruzzo,1304970,1095283,83.93,0.88
4130,2021-03-21,ABR,2135,914,1221,840,1291,4,ITF,ITF1,13,Abruzzo,Abruzzo,1304970,1097418,84.1,0.16
4131,2021-06-12,ABR,11425,5917,5508,9891,1352,182,ITF,ITF1,13,Abruzzo,Abruzzo,1304970,1108843,84.97,0.88
4132,2021-05-19,ABR,10732,5127,5605,7570,3037,125,ITF,ITF1,13,Abruzzo,Abruzzo,1304970,1119575,85.79,0.82
4133,2021-04-30,ABR,12510,5870,6640,6509,5728,273,ITF,ITF1,13,Abruzzo,Abruzzo,1304970,1132085,86.75,0.96
4134,2021-04-13,ABR,5895,2755,3140,4560,1238,97,ITF,ITF1,13,Abruzzo,Abruzzo,1304970,1137980,87.2,0.45
4135,2021-01-20,ABR,449,157,292,427,2,20,ITF,ITF1,13,Abruzzo,Abruzzo,1304970,1138429,87.24,0.03
4136,2021-07-05,ABR,10910,5349,5561,4044,6676,190,ITF,ITF1,13,Abruzzo,Abruzzo,1304970,1149339,88.07,0.84
4137,2021-07-22,ABR,14489,7414,7075,3518,10762,209,ITF,ITF1,13,Abruzzo,Abruzzo,1304970,1163828,89.18,1.11
4138,2021-07-24,ABR,12633,6841,5792,3812,8586,235,ITF,ITF1,13,Abruzzo,Abruzzo,1304970,1176461,90.15,0.97
4139,2021-05-02,ABR,10465,5116,5349,5087,5233,145,ITF,ITF1,13,Abruzzo,Abruzzo,1304970,1186926,90.95,0.8
4140,2021-08-10,ABR,9271,4964,4307,3398,5662,211,ITF,ITF1,13,Abruzzo,Abruzzo,1304970,1196197,91.66,0.71
4141,2021-02-11,ABR,815,262,553,770,43,2,ITF,ITF1,13,Abruzzo,Abruzzo,1304970,1197012,91.73,0.06
4142,2021-05-24,ABR,12222,5839,6383,8725,3341,156,ITF,ITF1,13,Abruzzo,Abruzzo,1304970,1209234,92.66,0.94
4143,2021-02-18,ABR,2292,934,1358,2142,133,17,ITF,ITF1,13,Abruzzo,Abruzzo,1304970,1211526,92.84,0.18
4144,2021-06-17,ABR,10916,5459,5457,7300,3453,163,ITF,ITF1,13,Abruzzo,Abruzzo,1304970,1222442,93.68,0.84
4145,2021-08-24,ABR,6357,3408,2949,1876,4329,152,ITF,ITF1,13,Abruzzo,Abruzzo,1304970,1228799,94.16,0.49
4146,2021-02-01,ABR,1633,574,1059,268,1364,1,ITF,ITF1,13,Abruzzo,Abruzzo,1304970,1230432,94.29,0.13
4147,2021-08-31,ABR,6407,3498,2909,1713,4583,111,ITF,ITF1,13,Abruzzo,Abruzzo,1304970,1236839,94.78,0.49
4148,2021-03-23,ABR,4835,2191,2644,2209,2567,59,ITF,ITF1,13,Abruzzo,Abruzzo,1304970,1241674,95.15,0.37
4149,2021-01-25,ABR,1606,634,972,13,1591,2,ITF,ITF1,13,Abruzzo,Abruzzo,1304970,1243280,95.27,0.12
4150,2021-05-29,ABR,10318,4430,5888,4456,5772,90,ITF,ITF1,13,Abruzzo,Abruzzo,1304970,1253598,96.06,0.79
4151,2021-05-22,ABR,13162,6393,6769,8133,4917,112,ITF,ITF1,13,Abruzzo,Abruzzo,1304970,1266760,97.07,1.01
4152,2021-03-26,ABR,5361,2314,3047,3176,2079,106,ITF,ITF1,13,Abruzzo,Abruzzo,1304970,1272121,97.48,0.41
4153,2021-07-27,ABR,15138,7905,7233,3340,11623,175,ITF,ITF1,13,Abruzzo,Abruzzo,1304970,1287259,98.64,1.16
4154,2021-05-31,ABR,11341,5116,6225,6770,4444,127,ITF,ITF1,13,Abruzzo,Abruzzo,1304970,1298600,99.51,0.87
4155,2021-04-20,ABR,5639,2713,2926,4105,1456,78,ITF,ITF1,13,Abruzzo,Abruzzo,1304970,1304239,99.94,0.43
4156,2021-07-29,ABR,15181,7972,7209,3931,11040,210,ITF,ITF1,13,Abruzzo,Abruzzo,1304970,1319420,101.11,1.16
4157,2021-03-06,ABR,4182,1361,2821,3570,571,41,ITF,ITF1,13,Abruzzo,Abruzzo,1304970,1323602,101.43,0.32
4158,2021-04-25,ABR,9071,4625,4446,8053,809,209,ITF,ITF1,13,Abruzzo,Abruzzo,1304970,1332673,102.12,0.7
4159,2021-08-05,ABR,13905,7164,6741,4718,8916,271,ITF,ITF1,13,Abruzzo,Abruzzo,1304970,1346578,103.19,1.07
4160,2021-01-08,ABR,1659,638,1021,1650,0,9,ITF,ITF1,13,Abruzzo,Abruzzo,1304970,1348237,103.32,0.13
4161,2021-04-18,ABR,5819,2729,3090,4727,944,148,ITF,ITF1,13,Abruzzo,Abruzzo,1304970,1354056,103.76,0.45
4162,2021-02-20,ABR,4781,1845,2936,4661,76,44,ITF,ITF1,13,Abruzzo,Abruzzo,1304970,1358837,104.13,0.37
4163,2021-01-13,ABR,1304,483,821,1296,0,8,ITF,ITF1,13,Abruzzo,Abruzzo,1304970,1360141,104.23,0.1
4164,2021-02-13,ABR,866,393,473,438,424,4,ITF,ITF1,13,Abruzzo,Abruzzo,1304970,1361007,104.29,0.07
4165,2021-07-17,ABR,14097,7387,6710,2657,11264,176,ITF,ITF1,13,Abruzzo,Abruzzo,1304970,1375104,105.37,1.08
4166,2021-07-25,ABR,9862,5217,4645,2170,7569,123,ITF,ITF1,13,Abruzzo,Abruzzo,1304970,1384966,106.13,0.76
4167,2021-07-08,ABR,13493,6681,6812,3410,9918,165,ITF,ITF1,13,Abruzzo,Abruzzo,1304970,1398459,107.16,1.03
4168,2021-04-16,ABR,7544,3492,4052,5500,1916,128,ITF,ITF1,13,Abruzzo,Abruzzo,1304970,1406003,107.74,0.58
4169,2021-03-04,ABR,5943,2360,3583,4973,928,42,ITF,ITF1,13,Abruzzo,Abruzzo,1304970,1411946,108.2,0.46
4170,2021-05-28,ABR,14024,6310,7714,7491,6364,169,ITF,ITF1,13,Abruzzo,Abruzzo,1304970,1425970,109.27,1.07
4171,2021-01-16,ABR,938,431,507,930,0,8,ITF,ITF1,13,Abruzzo,Abruzzo,1304970,1426908,109.34,0.07
4172,2021-03-07,ABR,2523,630,1893,2485,0,38,ITF,ITF1,13,Abruzzo,Abruzzo,1304970,1429431,109.54,0.19
4173,2021-01-09,ABR,1613,693,920,1601,0,12,ITF,ITF1,13,Abruzzo,Abruzzo,1304970,1431044,109.66,0.12
4174,2021-05-07,ABR,12213,5715,6498,7653,4424,136,ITF,ITF1,13,Abruzzo,Abruzzo,1304970,1443257,110.6,0.94
4175,2021-03-25,ABR,5800,2666,3134,3065,2622,113,ITF,ITF1,13,Abruzzo,Abruzzo,1304970,1449057,111.04,0.44
4176,2021-08-29,ABR,1468,878,590,522,932,14,ITF,ITF1,13,Abruzzo,Abruzzo,1304970,1450525,111.15,0.11
4177,2021-01-27,ABR,1368,515,853,34,1334,0,ITF,ITF1,13,Abruzzo,Abruzzo,1304970,1451893,111.26,0.1
4178,2021-07-03,ABR,10197,5152,5045,3504,6545,148,ITF,ITF1,13,Abruzzo,Abruzzo,1304970,1462090,112.04,0.78
4179,2021-05-21,ABR,13019,6329,6690,7865,4978,176,ITF,ITF1,13,Abruzzo,Abruzzo,1304970,1475109,113.04,1.0
4180,2021-03-18,ABR,3900,1652,2248,2038,1835,27,ITF,ITF1,13,Abruzzo,Abruzzo,1304970,1479009,113.34,0.3
4181,2021-08-22,ABR,1832,948,884,537,1243,52,ITF,ITF1,13,Abruzzo,Abruzzo,1304970,1480841,113.48,0.14
4182,2021-06-26,ABR,10053,5019,5034,5691,4200,162,ITF,ITF1,13,Abruzzo,Abruzzo,1304970,1490894,114.25,0.77
4183,2021-07-10,ABR,13120,6632,6488,3009,9946,165,ITF,ITF1,13,Abruzzo,Abruzzo,1304970,1504014,115.25,1.01
4184,2021-05-14,ABR,10596,5071,5525,5284,5151,161,ITF,ITF1,13,Abruzzo,Abruzzo,1304970,1514610,116.06,0.81
4185,2021-04-01,ABR,5627,2519,3108,3428,2121,78,ITF,ITF1,13,Abruzzo,Abruzzo,1304970,1520237,116.5,0.43
4186,2021-03-11,ABR,5491,2216,3275,4265,1139,87,ITF,ITF1,13,Abruzzo,Abruzzo,1304970,1525728,116.92,0.42
4187,2021-06-02,ABR,9772,4749,5023,6836,2818,118,ITF,ITF1,13,Abruzzo,Abruzzo,1304970,1535500,117.67,0.75
4188,2021-03-13,ABR,4123,1420,2703,3018,1043,62,ITF,ITF1,13,Abruzzo,Abruzzo,1304970,1539623,117.98,0.32
4189,2021-06-21,ABR,11057,5389,5668,4939,5990,128,ITF,ITF1,13,Abruzzo,Abruzzo,1304970,1550680,118.83,0.85
4190,2021-03-30,ABR,5130,2262,2868,3144,1824,162,ITF,ITF1,13,Abruzzo,Abruzzo,1304970,1555810,119.22,0.39
4191,2021-01-06,ABR,1991,819,1172,1981,0,10,ITF,ITF1,13,Abruzzo,Abruzzo,1304970,1557801,119.37,0.15
4192,2021-05-27,ABR,13325,6106,7219,8318,4831,176,ITF,ITF1,13,Abruzzo,Abruzzo,1304970,1571126,120.4,1.02
4193,2021-03-19,ABR,5797,2585,3212,2731,3024,42,ITF,ITF1,13,Abruzzo,Abruzzo,1304970,1576923,120.84,0.44
4194,2021-03-05,ABR,5346,1957,3389,4590,697,59,ITF,ITF1,13,Abruzzo,Abruzzo,1304970,1582269,121.25,0.41
4195,2021-06-27,ABR,8371,4303,4068,5021,3210,140,ITF,ITF1,13,Abruzzo,Abruzzo,1304970,1590640,121.89,0.64
4196,2021-04-07,ABR,7543,3484,4059,4515,2894,134,ITF,ITF1,13,Abruzzo,Abruzzo,1304970,1598183,122.47,0.58
4197,2021-07-16,ABR,16147,8237,7910,2468,13562,117,ITF,ITF1,13,Abruzzo,Abruzzo,1304970,1614330,123.71,1.24
4198,2021-05-08,ABR,10291,4870,5421,6310,3836,145,ITF,ITF1,13,Abruzzo,Abruzzo,1304970,1624621,124.49,0.79
4199,2021-04-24,ABR,8731,3975,4756,6938,1532,261,ITF,ITF1,13,Abruzzo,Abruzzo,1304970,1633352,125.16,0.67
4200,2021-08-16,ABR,6097,3208,2889,2257,3694,146,ITF,ITF1,13,Abruzzo,Abruzzo,1304970,1639449,125.63,0.47
4201,2021-01-14,ABR,568,227,341,566,0,2,ITF,ITF1,13,Abruzzo,Abruzzo,1304970,1640017,125.67,0.04
4202,2021-02-16,ABR,1916,842,1074,1891,12,13,ITF,ITF1,13,Abruzzo,Abruzzo,1304970,1641933,125.82,0.15
4203,2021-03-02,ABR,3967,1676,2291,3264,686,17,ITF,ITF1,13,Abruzzo,Abruzzo,1304970,1645900,126.13,0.3
4204,2021-06-10,ABR,12709,6319,6390,10307,2163,239,ITF,ITF1,13,Abruzzo,Abruzzo,1304970,1658609,127.1,0.97
4205,2021-09-03,ABR,4864,2593,2271,1447,3313,104,ITF,ITF1,13,Abruzzo,Abruzzo,1304970,1663473,127.47,0.37
4206,2021-01-28,ABR,1434,495,939,11,1423,0,ITF,ITF1,13,Abruzzo,Abruzzo,1304970,1664907,127.58,0.11
4207,2021-01-11,ABR,1688,690,998,1684,0,4,ITF,ITF1,13,Abruzzo,Abruzzo,1304970,1666595,127.71,0.13
4208,2021-04-21,ABR,6392,3102,3290,4634,1673,85,ITF,ITF1,13,Abruzzo,Abruzzo,1304970,1672987,128.2,0.49
4209,2021-07-15,ABR,15944,8088,7856,3129,12639,176,ITF,ITF1,13,Abruzzo,Abruzzo,1304970,1688931,129.42,1.22
4210,2021-06-28,ABR,10053,4837,5216,5310,4574,169,ITF,ITF1,13,Abruzzo,Abruzzo,1304970,1698984,130.19,0.77
4211,2021-04-06,ABR,7677,3578,4099,5227,2320,130,ITF,ITF1,13,Abruzzo,Abruzzo,1304970,1706661,130.78,0.59
4212,2021-08-03,ABR,12722,6574,6148,3646,8907,169,ITF,ITF1,13,Abruzzo,Abruzzo,1304970,1719383,131.76,0.97
4213,2021-08-17,ABR,6583,3468,3115,2825,3541,217,ITF,ITF1,13,Abruzzo,Abruzzo,1304970,1725966,132.26,0.5
4214,2021-05-09,ABR,9159,4091,5068,4174,4872,113,ITF,ITF1,13,Abruzzo,Abruzzo,1304970,1735125,132.96,0.7
4215,2021-02-15,ABR,1794,832,962,1735,42,17,ITF,ITF1,13,Abruzzo,Abruzzo,1304970,1736919,133.1,0.14
4216,2021-05-26,ABR,13551,6044,7507,8397,4995,159,ITF,ITF1,13,Abruzzo,Abruzzo,1304970,1750470,134.14,1.04
4217,2021-06-14,ABR,10979,5431,5548,7426,3379,174,ITF,ITF1,13,Abruzzo,Abruzzo,1304970,1761449,134.98,0.84
4218,2021-03-28,CAM,15567,7511,8056,13581,1625,361,ITF,ITF3,15,Campania,Campania,5801692,15567,0.27,0.27
4219,2021-01-04,CAM,5828,2962,2866,5728,0,100,ITF,ITF3,15,Campania,Campania,5801692,21395,0.37,0.1
4220,2021-06-19,CAM,62407,29712,32695,24183,37768,456,ITF,ITF3,15,Campania,Campania,5801692,83802,1.44,1.08
4221,2021-06-24,CAM,66111,31861,34250,13411,52301,399,ITF,ITF3,15,Campania,Campania,5801692,149913,2.58,1.14
4222,2021-03-16,CAM,8090,3519,4571,3700,4317,73,ITF,ITF3,15,Campania,Campania,5801692,158003,2.72,0.14
4223,2021-08-20,CAM,17413,9328,8085,7463,9418,532,ITF,ITF3,15,Campania,Campania,5801692,175416,3.02,0.3
4224,2021-01-25,CAM,5760,2929,2831,174,5586,0,ITF,ITF3,15,Campania,Campania,5801692,181176,3.12,0.1
4225,2021-07-01,CAM,61523,29855,31668,19759,41019,745,ITF,ITF3,15,Campania,Campania,5801692,242699,4.18,1.06
4226,2021-03-23,CAM,15745,7447,8298,12860,2515,370,ITF,ITF3,15,Campania,Campania,5801692,258444,4.45,0.27
4227,2021-08-27,CAM,24402,13015,11387,7842,15884,676,ITF,ITF3,15,Campania,Campania,5801692,282846,4.88,0.42
4228,2021-06-07,CAM,57602,27730,29872,52737,4050,815,ITF,ITF3,15,Campania,Campania,5801692,340448,5.87,0.99
4229,2021-02-25,CAM,12444,4487,7957,10942,1208,294,ITF,ITF3,15,Campania,Campania,5801692,352892,6.08,0.21
4230,2021-04-09,CAM,29953,14085,15868,23179,6139,635,ITF,ITF3,15,Campania,Campania,5801692,382845,6.6,0.52
4231,2021-06-05,CAM,77650,37594,40056,70750,6039,861,ITF,ITF3,15,Campania,Campania,5801692,460495,7.94,1.34
4232,2021-04-11,CAM,17529,8610,8919,15040,2088,401,ITF,ITF3,15,Campania,Campania,5801692,478024,8.24,0.3
4233,2021-04-28,CAM,36425,17631,18794,25849,9761,815,ITF,ITF3,15,Campania,Campania,5801692,514449,8.87,0.63
4234,2021-01-18,CAM,959,399,560,683,244,32,ITF,ITF3,15,Campania,Campania,5801692,515408,8.88,0.02
4235,2021-07-20,CAM,40104,19783,20321,6289,33333,482,ITF,ITF3,15,Campania,Campania,5801692,555512,9.57,0.69
4236,2021-03-02,CAM,12763,4560,8203,8189,4345,229,ITF,ITF3,15,Campania,Campania,5801692,568275,9.79,0.22
4237,2021-07-15,CAM,66733,32055,34678,9256,57078,399,ITF,ITF3,15,Campania,Campania,5801692,635008,10.95,1.15
4238,2021-05-24,CAM,31360,15156,16204,15852,15157,351,ITF,ITF3,15,Campania,Campania,5801692,666368,11.49,0.54
4239,2021-02-13,CAM,5509,2550,2959,5107,217,185,ITF,ITF3,15,Campania,Campania,5801692,671877,11.58,0.09
4240,2021-08-01,CAM,16085,8415,7670,7003,8834,248,ITF,ITF3,15,Campania,Campania,5801692,687962,11.86,0.28
4241,2021-04-23,CAM,32360,15537,16823,22449,9159,752,ITF,ITF3,15,Campania,Campania,5801692,720322,12.42,0.56
4242,2021-08-15,CAM,1120,637,483,216,897,7,ITF,ITF3,15,Campania,Campania,5801692,721442,12.44,0.02
4243,2021-08-03,CAM,31994,16221,15773,14535,16653,806,ITF,ITF3,15,Campania,Campania,5801692,753436,12.99,0.55
4244,2021-02-11,CAM,6294,2716,3578,5919,77,298,ITF,ITF3,15,Campania,Campania,5801692,759730,13.09,0.11
4245,2021-07-27,CAM,49160,24447,24713,12770,35718,672,ITF,ITF3,15,Campania,Campania,5801692,808890,13.94,0.85
4246,2021-01-30,CAM,10732,5083,5649,43,10687,2,ITF,ITF3,15,Campania,Campania,5801692,819622,14.13,0.18
4247,2021-07-03,CAM,67285,32499,34786,8163,58711,411,ITF,ITF3,15,Campania,Campania,5801692,886907,15.29,1.16
4248,2021-08-29,CAM,10256,5573,4683,3710,6277,269,ITF,ITF3,15,Campania,Campania,5801692,897163,15.46,0.18
4249,2021-01-16,CAM,3372,1677,1695,3261,0,111,ITF,ITF3,15,Campania,Campania,5801692,900535,15.52,0.06
4250,2021-05-19,CAM,51307,22660,28647,33813,16757,737,ITF,ITF3,15,Campania,Campania,5801692,951842,16.41,0.88
4251,2021-05-05,CAM,51190,24868,26322,43199,6398,1593,ITF,ITF3,15,Campania,Campania,5801692,1003032,17.29,0.88
4252,2021-03-09,CAM,14144,6875,7269,9912,3799,433,ITF,ITF3,15,Campania,Campania,5801692,1017176,17.53,0.24
4253,2021-05-31,CAM,40800,20696,20104,29844,10384,572,ITF,ITF3,15,Campania,Campania,5801692,1057976,18.24,0.7
4254,2021-08-26,CAM,24535,12758,11777,8201,15527,807,ITF,ITF3,15,Campania,Campania,5801692,1082511,18.66,0.42
4255,2021-06-26,CAM,62951,30695,32256,14625,47861,465,ITF,ITF3,15,Campania,Campania,5801692,1145462,19.74,1.09
4256,2021-07-13,CAM,53692,25794,27898,4876,48503,313,ITF,ITF3,15,Campania,Campania,5801692,1199154,20.67,0.93
4257,2021-04-04,CAM,7966,4017,3949,6683,1047,236,ITF,ITF3,15,Campania,Campania,5801692,1207120,20.81,0.14
4258,2021-06-12,CAM,64001,31546,32455,55792,7216,993,ITF,ITF3,15,Campania,Campania,5801692,1271121,21.91,1.1
4259,2021-03-04,CAM,14711,5397,9314,8533,5897,281,ITF,ITF3,15,Campania,Campania,5801692,1285832,22.16,0.25
4260,2021-05-17,CAM,49508,21756,27752,23654,25393,461,ITF,ITF3,15,Campania,Campania,5801692,1335340,23.02,0.85
4261,2021-02-06,CAM,5343,2666,2677,2003,3241,99,ITF,ITF3,15,Campania,Campania,5801692,1340683,23.11,0.09
4262,2021-07-22,CAM,61853,30553,31300,6533,54790,530,ITF,ITF3,15,Campania,Campania,5801692,1402536,24.17,1.07
4263,2021-08-08,CAM,7572,4040,3532,4650,2666,256,ITF,ITF3,15,Campania,Campania,5801692,1410108,24.31,0.13
4264,2021-04-30,CAM,42331,20199,22132,24965,16509,857,ITF,ITF3,15,Campania,Campania,5801692,1452439,25.03,0.73
4265,2021-02-04,CAM,7945,3429,4516,1250,6636,59,ITF,ITF3,15,Campania,Campania,5801692,1460384,25.17,0.14
4266,2021-01-01,CAM,919,506,413,899,0,20,ITF,ITF3,15,Campania,Campania,5801692,1461303,25.19,0.02
4267,2021-06-14,CAM,37132,17921,19211,18745,18023,364,ITF,ITF3,15,Campania,Campania,5801692,1498435,25.83,0.64
4268,2021-08-10,CAM,21640,11192,10448,13647,6948,1045,ITF,ITF3,15,Campania,Campania,5801692,1520075,26.2,0.37
4269,2021-01-11,CAM,4081,1879,2202,3971,0,110,ITF,ITF3,15,Campania,Campania,5801692,1524156,26.27,0.07
4270,2021-09-03,CAM,19989,10199,9790,7757,11539,693,ITF,ITF3,15,Campania,Campania,5801692,1544145,26.62,0.34
4271,2021-05-26,CAM,52739,25875,26864,21110,31156,473,ITF,ITF3,15,Campania,Campania,5801692,1596884,27.52,0.91
4272,2021-04-16,CAM,34450,16638,17812,23083,10668,699,ITF,ITF3,15,Campania,Campania,5801692,1631334,28.12,0.59
4273,2021-01-06,CAM,7652,3751,3901,7508,0,144,ITF,ITF3,15,Campania,Campania,5801692,1638986,28.25,0.13
4274,2021-02-18,CAM,9111,3833,5278,8152,727,232,ITF,ITF3,15,Campania,Campania,5801692,1648097,28.41,0.16
4275,2021-08-22,CAM,6808,3875,2933,2538,4125,145,ITF,ITF3,15,Campania,Campania,5801692,1654905,28.52,0.12
4276,2021-01-23,CAM,3843,2032,1811,267,3570,6,ITF,ITF3,15,Campania,Campania,5801692,1658748,28.59,0.07
4277,2021-03-21,CAM,10075,4677,5398,7491,2391,193,ITF,ITF3,15,Campania,Campania,5801692,1668823,28.76,0.17
4278,2021-02-10,CAM,6939,3439,3500,6483,206,250,ITF,ITF3,15,Campania,Campania,5801692,1675762,28.88,0.12
4279,2021-07-17,CAM,55272,27563,27709,3487,51547,238,ITF,ITF3,15,Campania,Campania,5801692,1731034,29.84,0.95
4280,2021-04-08,CAM,28500,13823,14677,22037,5848,615,ITF,ITF3,15,Campania,Campania,5801692,1759534,30.33,0.49
4281,2021-06-04,CAM,74588,35845,38743,64658,9134,796,ITF,ITF3,15,Campania,Campania,5801692,1834122,31.61,1.29
4282,2021-05-12,CAM,40937,19981,20956,30598,9171,1168,ITF,ITF3,15,Campania,Campania,5801692,1875059,32.32,0.71
4283,2021-07-08,CAM,61120,29417,31703,5632,55149,339,ITF,ITF3,15,Campania,Campania,5801692,1936179,33.37,1.05
4284,2021-06-02,CAM,42942,20183,22759,37715,4730,497,ITF,ITF3,15,Campania,Campania,5801692,1979121,34.11,0.74
4285,2021-02-22,CAM,10701,3299,7402,10157,279,265,ITF,ITF3,15,Campania,Campania,5801692,1989822,34.3,0.18
4286,2021-03-11,CAM,18016,9067,8949,10280,7293,443,ITF,ITF3,15,Campania,Campania,5801692,2007838,34.61,0.31
4287,2021-08-24,CAM,22602,11701,10901,8679,13185,738,ITF,ITF3,15,Campania,Campania,5801692,2030440,35.0,0.39
4288,2021-05-16,CAM,51162,23229,27933,32854,17587,721,ITF,ITF3,15,Campania,Campania,5801692,2081602,35.88,0.88
4289,2021-02-20,CAM,8573,3080,5493,8091,303,179,ITF,ITF3,15,Campania,Campania,5801692,2090175,36.03,0.15
4290,2021-07-31,CAM,30724,16215,14509,10570,19597,557,ITF,ITF3,15,Campania,Campania,5801692,2120899,36.56,0.53
4291,2021-05-07,CAM,59788,29214,30574,42478,15967,1343,ITF,ITF3,15,Campania,Campania,5801692,2180687,37.59,1.03
4292,2021-01-27,CAM,7755,3824,3931,168,7582,5,ITF,ITF3,15,Campania,Campania,5801692,2188442,37.72,0.13
4293,2021-03-25,CAM,20329,9657,10672,16335,3507,487,ITF,ITF3,15,Campania,Campania,5801692,2208771,38.07,0.35
4294,2021-02-27,CAM,13958,4472,9486,11967,1653,338,ITF,ITF3,15,Campania,Campania,5801692,2222729,38.31,0.24
4295,2021-06-16,CAM,31653,15012,16641,20522,10774,357,ITF,ITF3,15,Campania,Campania,5801692,2254382,38.86,0.55
4296,2021-08-12,CAM,18919,9994,8925,12415,5711,793,ITF,ITF3,15,Campania,Campania,5801692,2273301,39.18,0.33
4297,2021-05-02,CAM,43494,21551,21943,31197,11377,920,ITF,ITF3,15,Campania,Campania,5801692,2316795,39.93,0.75
4298,2021-01-22,CAM,1534,783,751,666,854,14,ITF,ITF3,15,Campania,Campania,5801692,2318329,39.96,0.03
4299,2021-04-25,CAM,30744,15178,15566,24548,5408,788,ITF,ITF3,15,Campania,Campania,5801692,2349073,40.49,0.53
4300,2021-01-13,CAM,8032,3676,4356,7787,0,245,ITF,ITF3,15,Campania,Campania,5801692,2357105,40.63,0.14
4301,2021-04-18,CAM,27221,13286,13935,17784,8903,534,ITF,ITF3,15,Campania,Campania,5801692,2384326,41.1,0.47
4302,2021-01-08,CAM,10458,4970,5488,10197,0,261,ITF,ITF3,15,Campania,Campania,5801692,2394784,41.28,0.18
4303,2021-04-27,CAM,32169,15632,16537,23436,7930,803,ITF,ITF3,15,Campania,Campania,5801692,2426953,41.83,0.55
4304,2021-06-23,CAM,46773,22094,24679,10705,35800,268,ITF,ITF3,15,Campania,Campania,5801692,2473726,42.64,0.81
4305,2021-08-05,CAM,35171,18027,17144,17302,16830,1039,ITF,ITF3,15,Campania,Campania,5801692,2508897,43.24,0.61
4306,2021-01-15,CAM,5001,2395,2606,4843,0,158,ITF,ITF3,15,Campania,Campania,5801692,2513898,43.33,0.09
4307,2021-06-21,CAM,46916,22682,24234,11277,35287,352,ITF,ITF3,15,Campania,Campania,5801692,2560814,44.14,0.81
4308,2021-03-13,CAM,14525,7043,7482,8955,5283,287,ITF,ITF3,15,Campania,Campania,5801692,2575339,44.39,0.25
4309,2021-03-22,CAM,13188,6351,6837,10826,2044,318,ITF,ITF3,15,Campania,Campania,5801692,2588527,44.62,0.23
4310,2021-02-07,CAM,2929,1382,1547,2066,771,92,ITF,ITF3,15,Campania,Campania,5801692,2591456,44.67,0.05
4311,2021-03-18,CAM,12181,5384,6797,5793,6193,195,ITF,ITF3,15,Campania,Campania,5801692,2603637,44.88,0.21
4312,2021-05-21,CAM,63872,29652,34220,42154,20701,1017,ITF,ITF3,15,Campania,Campania,5801692,2667509,45.98,1.1
4313,2021-04-01,CAM,24692,12019,12673,20045,4135,512,ITF,ITF3,15,Campania,Campania,5801692,2692201,46.4,0.43
4314,2021-05-28,CAM,73072,35324,37748,26264,46182,626,ITF,ITF3,15,Campania,Campania,5801692,2765273,47.66,1.26
4315,2021-06-30,CAM,47668,22775,24893,18334,28652,682,ITF,ITF3,15,Campania,Campania,5801692,2812941,48.48,0.82
4316,2021-07-24,CAM,47996,24873,23123,6732,40888,376,ITF,ITF3,15,Campania,Campania,5801692,2860937,49.31,0.83
4317,2021-01-20,CAM,1264,654,610,1233,0,31,ITF,ITF3,15,Campania,Campania,5801692,2862201,49.33,0.02
4318,2021-04-13,CAM,26616,12690,13926,20542,5538,536,ITF,ITF3,15,Campania,Campania,5801692,2888817,49.79,0.46
4319,2021-01-03,CAM,3836,2009,1827,3787,0,49,ITF,ITF3,15,Campania,Campania,5801692,2892653,49.86,0.07
4320,2021-07-05,CAM,63309,30516,32793,12700,49882,727,ITF,ITF3,15,Campania,Campania,5801692,2955962,50.95,1.09
4321,2021-02-03,CAM,8908,4006,4902,843,8029,36,ITF,ITF3,15,Campania,Campania,5801692,2964870,51.1,0.15
4322,2021-05-18,CAM,52273,23280,28993,31879,19728,666,ITF,ITF3,15,Campania,Campania,5801692,3017143,52.0,0.9
4323,2021-08-09,CAM,25086,13085,12001,13691,10464,931,ITF,ITF3,15,Campania,Campania,5801692,3042229,52.44,0.43
4324,2021-02-05,CAM,7268,3464,3804,2023,5130,115,ITF,ITF3,15,Campania,Campania,5801692,3049497,52.56,0.13
4325,2021-08-07,CAM,17197,9179,8018,11209,5288,700,ITF,ITF3,15,Campania,Campania,5801692,3066694,52.86,0.3
4326,2021-04-29,CAM,41563,20183,21380,23999,16748,816,ITF,ITF3,15,Campania,Campania,5801692,3108257,53.58,0.72
4327,2021-01-19,CAM,1110,485,625,1055,5,50,ITF,ITF3,15,Campania,Campania,5801692,3109367,53.59,0.02
4328,2021-07-21,CAM,50181,24429,25752,8564,40888,729,ITF,ITF3,15,Campania,Campania,5801692,3159548,54.46,0.86
4329,2021-02-08,CAM,5129,2460,2669,4166,815,148,ITF,ITF3,15,Campania,Campania,5801692,3164677,54.55,0.09
4330,2021-02-01,CAM,3988,1814,2174,104,3876,8,ITF,ITF3,15,Campania,Campania,5801692,3168665,54.62,0.07
4331,2021-03-30,CAM,22058,10581,11477,18567,2959,532,ITF,ITF3,15,Campania,Campania,5801692,3190723,55.0,0.38
4332,2021-03-06,CAM,16376,6818,9558,10376,5672,328,ITF,ITF3,15,Campania,Campania,5801692,3207099,55.28,0.28
4333,2021-08-19,CAM,22018,11637,10381,9591,11774,653,ITF,ITF3,15,Campania,Campania,5801692,3229117,55.66,0.38
4334,2021-05-14,CAM,61047,27584,33463,34797,24737,1513,ITF,ITF3,15,Campania,Campania,5801692,3290164,56.71,1.05
4335,2021-07-10,CAM,66914,32669,34245,2722,63963,229,ITF,ITF3,15,Campania,Campania,5801692,3357078,57.86,1.15
4336,2021-01-21,CAM,2106,1125,981,678,1421,7,ITF,ITF3,15,Campania,Campania,5801692,3359184,57.9,0.04
4337,2021-07-14,CAM,51115,24581,26534,4290,46499,326,ITF,ITF3,15,Campania,Campania,5801692,3410299,58.78,0.88
4338,2021-04-05,CAM,11640,5541,6099,8909,2424,307,ITF,ITF3,15,Campania,Campania,5801692,3421939,58.98,0.2
4339,2021-03-17,CAM,11598,5102,6496,4848,6591,159,ITF,ITF3,15,Campania,Campania,5801692,3433537,59.18,0.2
4340,2021-06-11,CAM,70829,34411,36418,63728,6058,1043,ITF,ITF3,15,Campania,Campania,5801692,3504366,60.4,1.22
4341,2021-03-03,CAM,13924,5496,8428,7074,6632,218,ITF,ITF3,15,Campania,Campania,5801692,3518290,60.64,0.24
4342,2021-07-07,CAM,52310,24822,27488,7214,44642,454,ITF,ITF3,15,Campania,Campania,5801692,3570600,61.54,0.9
4343,2021-03-29,CAM,19410,9579,9831,17441,1550,419,ITF,ITF3,15,Campania,Campania,5801692,3590010,61.88,0.33
4344,2021-01-17,CAM,1155,551,604,682,453,20,ITF,ITF3,15,Campania,Campania,5801692,3591165,61.9,0.02
4345,2021-03-15,CAM,13350,6495,6855,8314,4747,289,ITF,ITF3,15,Campania,Campania,5801692,3604515,62.13,0.23
4346,2021-07-02,CAM,55884,27003,28881,14396,40954,534,ITF,ITF3,15,Campania,Campania,5801692,3660399,63.09,0.96
4347,2021-08-28,CAM,17707,9616,8091,5366,11841,500,ITF,ITF3,15,Campania,Campania,5801692,3678106,63.4,0.31
4348,2021-05-27,CAM,73032,35384,37648,25808,46656,568,ITF,ITF3,15,Campania,Campania,5801692,3751138,64.66,1.26
4349,2021-02-16,CAM,5471,2431,3040,4508,787,176,ITF,ITF3,15,Campania,Campania,5801692,3756609,64.75,0.09
4350,2021-05-22,CAM,68131,32557,35574,45613,21658,860,ITF,ITF3,15,Campania,Campania,5801692,3824740,65.92,1.17
4351,2021-08-30,CAM,29098,15012,14086,9748,18542,808,ITF,ITF3,15,Campania,Campania,5801692,3853838,66.43,0.5
4352,2021-04-17,CAM,36203,17518,18685,23949,11518,736,ITF,ITF3,15,Campania,Campania,5801692,3890041,67.05,0.62
4353,2021-06-13,CAM,43430,21245,22185,37984,4731,715,ITF,ITF3,15,Campania,Campania,5801692,3933471,67.8,0.75
4354,2021-05-30,CAM,52172,25455,26717,37961,13327,884,ITF,ITF3,15,Campania,Campania,5801692,3985643,68.7,0.9
4355,2021-02-19,CAM,9588,3569,6019,8690,662,236,ITF,ITF3,15,Campania,Campania,5801692,3995231,68.86,0.17
4356,2021-07-26,CAM,48860,24318,24542,10385,37936,539,ITF,ITF3,15,Campania,Campania,5801692,4044091,69.71,0.84
4357,2020-12-31,CAM,1490,811,679,1470,0,20,ITF,ITF3,15,Campania,Campania,5801692,4045581,69.73,0.03
4358,2021-06-06,CAM,63235,31451,31784,61785,651,799,ITF,ITF3,15,Campania,Campania,5801692,4108816,70.82,1.09
4359,2021-02-26,CAM,13367,4237,9130,11692,1366,309,ITF,ITF3,15,Campania,Campania,5801692,4122183,71.05,0.23
4360,2021-08-02,CAM,41769,21213,20556,13156,28018,595,ITF,ITF3,15,Campania,Campania,5801692,4163952,71.77,0.72
4361,2021-04-24,CAM,36383,17535,18848,24325,11250,808,ITF,ITF3,15,Campania,Campania,5801692,4200335,72.4,0.63
4362,2021-07-19,CAM,43996,21545,22451,5174,38373,449,ITF,ITF3,15,Campania,Campania,5801692,4244331,73.16,0.76
4363,2021-04-10,CAM,28363,13497,14866,22785,4917,661,ITF,ITF3,15,Campania,Campania,5801692,4272694,73.65,0.49
4364,2021-06-25,CAM,65519,31805,33714,13727,51347,445,ITF,ITF3,15,Campania,Campania,5801692,4338213,74.77,1.13
4365,2021-09-02,CAM,25560,13228,12332,10220,14450,890,ITF,ITF3,15,Campania,Campania,5801692,4363773,75.22,0.44
4366,2021-05-25,CAM,46552,22408,24144,22540,23456,556,ITF,ITF3,15,Campania,Campania,5801692,4410325,76.02,0.8
4367,2021-04-22,CAM,34121,16637,17484,20907,12546,668,ITF,ITF3,15,Campania,Campania,5801692,4444446,76.61,0.59
4368,2021-01-12,CAM,5221,2569,2652,5082,0,139,ITF,ITF3,15,Campania,Campania,5801692,4449667,76.7,0.09
4369,2021-07-23,CAM,61835,30809,31026,8458,52865,512,ITF,ITF3,15,Campania,Campania,5801692,4511502,77.76,1.07
4370,2021-04-14,CAM,27665,13338,14327,18640,8590,435,ITF,ITF3,15,Campania,Campania,5801692,4539167,78.24,0.48
4371,2021-05-01,CAM,46353,22666,23687,29267,16112,974,ITF,ITF3,15,Campania,Campania,5801692,4585520,79.04,0.8
4372,2021-07-06,CAM,56700,27070,29630,15981,40098,621,ITF,ITF3,15,Campania,Campania,5801692,4642220,80.01,0.98
4373,2021-04-12,CAM,23310,10921,12389,19745,3037,528,ITF,ITF3,15,Campania,Campania,5801692,4665530,80.42,0.4
4374,2021-01-02,CAM,3673,1963,1710,3615,0,58,ITF,ITF3,15,Campania,Campania,5801692,4669203,80.48,0.06
4375,2021-06-17,CAM,60217,28868,31349,32814,26800,603,ITF,ITF3,15,Campania,Campania,5801692,4729420,81.52,1.04
4376,2021-07-04,CAM,48823,23766,25057,6290,42319,214,ITF,ITF3,15,Campania,Campania,5801692,4778243,82.36,0.84
4377,2021-03-26,CAM,19870,9326,10544,15604,3818,448,ITF,ITF3,15,Campania,Campania,5801692,4798113,82.7,0.34
4378,2021-03-08,CAM,14693,6851,7842,9450,4781,462,ITF,ITF3,15,Campania,Campania,5801692,4812806,82.96,0.25
4379,2021-05-04,CAM,48479,23343,25136,38251,8906,1322,ITF,ITF3,15,Campania,Campania,5801692,4861285,83.79,0.84
4380,2021-01-24,CAM,4123,2120,2003,361,3745,17,ITF,ITF3,15,Campania,Campania,5801692,4865408,83.86,0.07
4381,2021-08-21,CAM,9796,5396,4400,4082,5338,376,ITF,ITF3,15,Campania,Campania,5801692,4875204,84.03,0.17
4382,2021-05-13,CAM,55456,24833,30623,37838,16024,1594,ITF,ITF3,15,Campania,Campania,5801692,4930660,84.99,0.96
4383,2021-07-09,CAM,61493,29768,31725,4329,56829,335,ITF,ITF3,15,Campania,Campania,5801692,4992153,86.05,1.06
4384,2021-01-31,CAM,8070,3712,4358,22,8047,1,ITF,ITF3,15,Campania,Campania,5801692,5000223,86.19,0.14
4385,2021-01-07,CAM,8910,4168,4742,8736,0,174,ITF,ITF3,15,Campania,Campania,5801692,5009133,86.34,0.15
4386,2021-03-05,CAM,16826,6670,10156,9835,6672,319,ITF,ITF3,15,Campania,Campania,5801692,5025959,86.63,0.29
4387,2021-08-13,CAM,16866,9152,7714,9731,6601,534,ITF,ITF3,15,Campania,Campania,5801692,5042825,86.92,0.29
4388,2021-01-14,CAM,7080,2982,4098,6815,0,265,ITF,ITF3,15,Campania,Campania,5801692,5049905,87.04,0.12
4389,2021-05-11,CAM,39890,19252,20638,29537,9407,946,ITF,ITF3,15,Campania,Campania,5801692,5089795,87.73,0.69
4390,2021-07-11,CAM,40868,19670,21198,1005,39775,88,ITF,ITF3,15,Campania,Campania,5801692,5130663,88.43,0.7
4391,2021-03-24,CAM,17923,8370,9553,14583,2958,382,ITF,ITF3,15,Campania,Campania,5801692,5148586,88.74,0.31
4392,2021-05-20,CAM,61035,28266,32769,42267,17795,973,ITF,ITF3,15,Campania,Campania,5801692,5209621,89.79,1.05
4393,2021-02-09,CAM,4654,2209,2445,4231,263,160,ITF,ITF3,15,Campania,Campania,5801692,5214275,89.88,0.08
4394,2021-05-29,CAM,67878,32281,35597,43066,23962,850,ITF,ITF3,15,Campania,Campania,5801692,5282153,91.05,1.17
4395,2021-07-25,CAM,23223,11802,11421,4335,18738,150,ITF,ITF3,15,Campania,Campania,5801692,5305376,91.45,0.4
4396,2021-02-02,CAM,5733,2811,2922,415,5287,31,ITF,ITF3,15,Campania,Campania,5801692,5311109,91.54,0.1
4397,2021-03-31,CAM,23203,11378,11825,19326,3442,435,ITF,ITF3,15,Campania,Campania,5801692,5334312,91.94,0.4
4398,2021-07-18,CAM,31385,15806,15579,3869,27166,350,ITF,ITF3,15,Campania,Campania,5801692,5365697,92.49,0.54
4399,2021-04-07,CAM,24976,11989,12987,19668,4726,582,ITF,ITF3,15,Campania,Campania,5801692,5390673,92.92,0.43
4400,2021-07-16,CAM,61056,29868,31188,6702,53909,445,ITF,ITF3,15,Campania,Campania,5801692,5451729,93.97,1.05
4401,2021-04-02,CAM,21867,10525,11342,19058,2324,485,ITF,ITF3,15,Campania,Campania,5801692,5473596,94.34,0.38
4402,2021-08-14,CAM,4918,2804,2114,2052,2706,160,ITF,ITF3,15,Campania,Campania,5801692,5478514,94.43,0.08
4403,2021-05-06,CAM,57622,28140,29482,41221,14777,1624,ITF,ITF3,15,Campania,Campania,5801692,5536136,95.42,0.99
4404,2021-09-01,CAM,27241,13737,13504,10263,16122,856,ITF,ITF3,15,Campania,Campania,5801692,5563377,95.89,0.47
4405,2021-08-18,CAM,19591,10344,9247,7749,11289,553,ITF,ITF3,15,Campania,Campania,5801692,5582968,96.23,0.34
4406,2021-02-28,CAM,10414,3208,7206,8280,1901,233,ITF,ITF3,15,Campania,Campania,5801692,5593382,96.41,0.18
4407,2021-06-20,CAM,47613,22748,24865,14289,32994,330,ITF,ITF3,15,Campania,Campania,5801692,5640995,97.23,0.82
4408,2021-03-27,CAM,21517,10242,11275,17220,3869,428,ITF,ITF3,15,Campania,Campania,5801692,5662512,97.6,0.37
4409,2021-06-01,CAM,42282,20970,21312,31475,10547,260,ITF,ITF3,15,Campania,Campania,5801692,5704794,98.33,0.73
4410,2021-06-18,CAM,65900,31407,34493,34984,30307,609,ITF,ITF3,15,Campania,Campania,5801692,5770694,99.47,1.14
4411,2021-03-10,CAM,15634,7734,7900,8429,6852,353,ITF,ITF3,15,Campania,Campania,5801692,5786328,99.74,0.27
4412,2021-08-06,CAM,31219,16254,14965,17553,12637,1029,ITF,ITF3,15,Campania,Campania,5801692,5817547,100.27,0.54
4413,2021-08-23,CAM,23699,12347,11352,9523,13337,839,ITF,ITF3,15,Campania,Campania,5801692,5841246,100.68,0.41
4414,2021-02-14,CAM,3929,1923,2006,3842,34,53,ITF,ITF3,15,Campania,Campania,5801692,5845175,100.75,0.07
4415,2021-01-26,CAM,7350,3733,3617,335,6994,21,ITF,ITF3,15,Campania,Campania,5801692,5852525,100.88,0.13
4416,2021-04-19,CAM,30774,14828,15946,18658,11578,538,ITF,ITF3,15,Campania,Campania,5801692,5883299,101.41,0.53
4417,2021-01-09,CAM,10563,5022,5541,10301,0,262,ITF,ITF3,15,Campania,Campania,5801692,5893862,101.59,0.18
4418,2021-02-24,CAM,11810,4158,7652,10818,715,277,ITF,ITF3,15,Campania,Campania,5801692,5905672,101.79,0.2
4419,2021-01-05,CAM,7237,3637,3600,7072,0,165,ITF,ITF3,15,Campania,Campania,5801692,5912909,101.92,0.12
4420,2021-02-17,CAM,7418,3229,4189,6215,1073,130,ITF,ITF3,15,Campania,Campania,5801692,5920327,102.04,0.13
4421,2021-04-15,CAM,34349,16666,17683,23780,9905,664,ITF,ITF3,15,Campania,Campania,5801692,5954676,102.64,0.59
4422,2021-07-28,CAM,49453,24548,24905,13896,34777,780,ITF,ITF3,15,Campania,Campania,5801692,6004129,103.49,0.85
4423,2021-06-22,CAM,52455,25015,27440,13167,39004,284,ITF,ITF3,15,Campania,Campania,5801692,6056584,104.39,0.9
4424,2021-03-14,CAM,8618,3827,4791,4360,4142,116,ITF,ITF3,15,Campania,Campania,5801692,6065202,104.54,0.15
4425,2021-05-10,CAM,35480,16393,19087,24873,9932,675,ITF,ITF3,15,Campania,Campania,5801692,6100682,105.15,0.61
4426,2021-06-08,CAM,53115,25876,27239,45361,7077,677,ITF,ITF3,15,Campania,Campania,5801692,6153797,106.07,0.92
4427,2021-08-04,CAM,29837,15308,14529,15849,13099,889,ITF,ITF3,15,Campania,Campania,5801692,6183634,106.58,0.51
4428,2021-04-26,CAM,34059,16654,17405,27539,5630,890,ITF,ITF3,15,Campania,Campania,5801692,6217693,107.17,0.59
4429,2021-03-07,CAM,11976,5406,6570,7780,3844,352,ITF,ITF3,15,Campania,Campania,5801692,6229669,107.38,0.21
4430,2021-08-11,CAM,21050,11094,9956,12094,8143,813,ITF,ITF3,15,Campania,Campania,5801692,6250719,107.74,0.36
4431,2021-05-03,CAM,40761,19895,20866,27856,11871,1034,ITF,ITF3,15,Campania,Campania,5801692,6291480,108.44,0.7
4432,2021-06-29,CAM,49339,23996,25343,19712,29119,508,ITF,ITF3,15,Campania,Campania,5801692,6340819,109.29,0.85
4433,2021-06-15,CAM,18686,9095,9591,10998,7420,268,ITF,ITF3,15,Campania,Campania,5801692,6359505,109.61,0.32
4434,2021-05-15,CAM,62817,29083,33734,42099,18872,1846,ITF,ITF3,15,Campania,Campania,5801692,6422322,110.7,1.08
4435,2021-03-12,CAM,14582,7413,7169,8149,6088,345,ITF,ITF3,15,Campania,Campania,5801692,6436904,110.95,0.25
4436,2021-06-03,CAM,72649,35235,37414,61030,10681,938,ITF,ITF3,15,Campania,Campania,5801692,6509553,112.2,1.25
4437,2021-02-23,CAM,11017,3396,7621,10159,542,316,ITF,ITF3,15,Campania,Campania,5801692,6520570,112.39,0.19
4438,2021-08-25,CAM,22833,12019,10814,8711,13418,704,ITF,ITF3,15,Campania,Campania,5801692,6543403,112.78,0.39
4439,2021-02-21,CAM,5840,2242,3598,5489,228,123,ITF,ITF3,15,Campania,Campania,5801692,6549243,112.89,0.1
4440,2021-04-06,CAM,24526,11568,12958,19481,4525,520,ITF,ITF3,15,Campania,Campania,5801692,6573769,113.31,0.42
4441,2021-07-12,CAM,56700,27374,29326,3731,52605,364,ITF,ITF3,15,Campania,Campania,5801692,6630469,114.29,0.98
4442,2020-12-27,CAM,720,422,298,716,0,4,ITF,ITF3,15,Campania,Campania,5801692,6631189,114.3,0.01
4443,2021-07-29,CAM,48527,24357,24170,13587,34139,801,ITF,ITF3,15,Campania,Campania,5801692,6679716,115.13,0.84
4444,2021-04-20,CAM,32167,15551,16616,20242,11324,601,ITF,ITF3,15,Campania,Campania,5801692,6711883,115.69,0.55
4445,2021-06-28,CAM,46534,22742,23792,20512,25411,611,ITF,ITF3,15,Campania,Campania,5801692,6758417,116.49,0.8
4446,2021-03-20,CAM,13989,6530,7459,9980,3739,270,ITF,ITF3,15,Campania,Campania,5801692,6772406,116.73,0.24
4447,2021-08-31,CAM,27770,13965,13805,10837,15972,961,ITF,ITF3,15,Campania,Campania,5801692,6800176,117.21,0.48
4448,2021-02-15,CAM,5472,2516,2956,5151,175,146,ITF,ITF3,15,Campania,Campania,5801692,6805648,117.3,0.09
4449,2021-06-09,CAM,53065,26053,27012,41582,10916,567,ITF,ITF3,15,Campania,Campania,5801692,6858713,118.22,0.91
4450,2021-03-01,CAM,12135,4248,7887,7750,4113,272,ITF,ITF3,15,Campania,Campania,5801692,6870848,118.43,0.21
4451,2021-08-17,CAM,22281,12044,10237,7301,14443,537,ITF,ITF3,15,Campania,Campania,5801692,6893129,118.81,0.38
4452,2021-05-09,CAM,43213,20293,22920,30891,11106,1216,ITF,ITF3,15,Campania,Campania,5801692,6936342,119.56,0.74
4453,2021-01-10,CAM,8165,3736,4429,7963,0,202,ITF,ITF3,15,Campania,Campania,5801692,6944507,119.7,0.14
4454,2021-04-03,CAM,21119,10316,10803,18249,2383,487,ITF,ITF3,15,Campania,Campania,5801692,6965626,120.06,0.36
4455,2021-08-16,CAM,12466,6693,5773,6228,5723,515,ITF,ITF3,15,Campania,Campania,5801692,6978092,120.28,0.21
4456,2021-05-23,CAM,58766,28649,30117,37213,20905,648,ITF,ITF3,15,Campania,Campania,5801692,7036858,121.29,1.01
4457,2021-02-12,CAM,6563,2876,3687,6086,218,259,ITF,ITF3,15,Campania,Campania,5801692,7043421,121.4,0.11
4458,2021-01-29,CAM,10084,4821,5263,65,10015,4,ITF,ITF3,15,Campania,Campania,5801692,7053505,121.58,0.17
4459,2021-06-27,CAM,43559,21452,22107,14064,29072,423,ITF,ITF3,15,Campania,Campania,5801692,7097064,122.33,0.75
4460,2021-03-19,CAM,11152,4978,6174,7083,3877,192,ITF,ITF3,15,Campania,Campania,5801692,7108216,122.52,0.19
4461,2021-06-10,CAM,76013,36710,39303,67852,7108,1053,ITF,ITF3,15,Campania,Campania,5801692,7184229,123.83,1.31
4462,2021-05-08,CAM,56449,27149,29300,39048,15846,1555,ITF,ITF3,15,Campania,Campania,5801692,7240678,124.8,0.97
4463,2021-01-28,CAM,8851,4130,4721,140,8703,8,ITF,ITF3,15,Campania,Campania,5801692,7249529,124.96,0.15
4464,2021-07-30,CAM,44831,22823,22008,14473,29500,858,ITF,ITF3,15,Campania,Campania,5801692,7294360,125.73,0.77
4465,2021-04-21,CAM,30345,14770,15575,17550,12232,563,ITF,ITF3,15,Campania,Campania,5801692,7324705,126.25,0.52
4466,2021-08-12,BAS,3918,2000,1918,1677,2159,82,ITF,ITF5,17,Basilicata,Basilicata,559084,3918,0.7,0.7
4467,2021-07-26,BAS,5419,2723,2696,1993,3388,38,ITF,ITF5,17,Basilicata,Basilicata,559084,9337,1.67,0.97
4468,2021-01-22,BAS,67,24,43,67,0,0,ITF,ITF5,17,Basilicata,Basilicata,559084,9404,1.68,0.01
4469,2021-07-24,BAS,5749,2944,2805,1776,3923,50,ITF,ITF5,17,Basilicata,Basilicata,559084,15153,2.71,1.03
4470,2021-05-30,BAS,2778,1421,1357,920,1853,5,ITF,ITF5,17,Basilicata,Basilicata,559084,17931,3.21,0.5
4471,2021-04-03,BAS,1815,754,1061,1465,337,13,ITF,ITF5,17,Basilicata,Basilicata,559084,19746,3.53,0.32
4472,2021-08-24,BAS,3269,1768,1501,1479,1713,77,ITF,ITF5,17,Basilicata,Basilicata,559084,23015,4.12,0.58
4473,2021-01-10,BAS,77,24,53,77,0,0,ITF,ITF5,17,Basilicata,Basilicata,559084,23092,4.13,0.01
4474,2021-04-20,BAS,4147,1982,2165,2180,1940,27,ITF,ITF5,17,Basilicata,Basilicata,559084,27239,4.87,0.74
4475,2021-08-07,BAS,4515,2376,2139,1361,3095,59,ITF,ITF5,17,Basilicata,Basilicata,559084,31754,5.68,0.81
4476,2021-01-08,BAS,555,219,336,555,0,0,ITF,ITF5,17,Basilicata,Basilicata,559084,32309,5.78,0.1
4477,2021-06-04,BAS,4832,2289,2543,3749,1046,37,ITF,ITF5,17,Basilicata,Basilicata,559084,37141,6.64,0.86
4478,2021-02-24,BAS,1815,744,1071,1729,75,11,ITF,ITF5,17,Basilicata,Basilicata,559084,38956,6.97,0.32
4479,2021-08-26,BAS,2523,1278,1245,1120,1339,64,ITF,ITF5,17,Basilicata,Basilicata,559084,41479,7.42,0.45
4480,2021-02-22,BAS,1796,777,1019,1735,53,8,ITF,ITF5,17,Basilicata,Basilicata,559084,43275,7.74,0.32
4481,2021-01-15,BAS,819,353,466,819,0,0,ITF,ITF5,17,Basilicata,Basilicata,559084,44094,7.89,0.15
4482,2020-12-27,BAS,106,41,65,106,0,0,ITF,ITF5,17,Basilicata,Basilicata,559084,44200,7.91,0.02
4483,2021-03-20,BAS,1306,577,729,276,1023,7,ITF,ITF5,17,Basilicata,Basilicata,559084,45506,8.14,0.23
4484,2021-06-28,BAS,3641,1747,1894,2113,1509,19,ITF,ITF5,17,Basilicata,Basilicata,559084,49147,8.79,0.65
4485,2021-04-08,BAS,788,361,427,760,10,18,ITF,ITF5,17,Basilicata,Basilicata,559084,49935,8.93,0.14
4486,2021-04-22,BAS,5050,2352,2698,3382,1613,55,ITF,ITF5,17,Basilicata,Basilicata,559084,54985,9.83,0.9
4487,2021-07-31,BAS,5470,2878,2592,1826,3590,54,ITF,ITF5,17,Basilicata,Basilicata,559084,60455,10.81,0.98
4488,2021-07-17,BAS,5856,2916,2940,1710,4107,39,ITF,ITF5,17,Basilicata,Basilicata,559084,66311,11.86,1.05
4489,2021-06-30,BAS,3453,1669,1784,2316,1111,26,ITF,ITF5,17,Basilicata,Basilicata,559084,69764,12.48,0.62
4490,2021-05-04,BAS,4142,1994,2148,3568,524,50,ITF,ITF5,17,Basilicata,Basilicata,559084,73906,13.22,0.74
4491,2021-03-08,BAS,1475,724,751,822,621,32,ITF,ITF5,17,Basilicata,Basilicata,559084,75381,13.48,0.26
4492,2021-06-16,BAS,4606,2086,2520,2126,2460,20,ITF,ITF5,17,Basilicata,Basilicata,559084,79987,14.31,0.82
4493,2021-03-25,BAS,1884,605,1279,1513,347,24,ITF,ITF5,17,Basilicata,Basilicata,559084,81871,14.64,0.34
4494,2021-01-27,BAS,421,179,242,113,308,0,ITF,ITF5,17,Basilicata,Basilicata,559084,82292,14.72,0.08
4495,2021-02-10,BAS,552,241,311,497,53,2,ITF,ITF5,17,Basilicata,Basilicata,559084,82844,14.82,0.1
4496,2021-05-21,BAS,4578,2321,2257,1480,3086,12,ITF,ITF5,17,Basilicata,Basilicata,559084,87422,15.64,0.82
4497,2021-09-02,BAS,3031,1624,1407,881,2072,78,ITF,ITF5,17,Basilicata,Basilicata,559084,90453,16.18,0.54
4498,2021-02-05,BAS,996,447,549,63,931,2,ITF,ITF5,17,Basilicata,Basilicata,559084,91449,16.36,0.18
4499,2021-07-12,BAS,5442,2593,2849,1607,3809,26,ITF,ITF5,17,Basilicata,Basilicata,559084,96891,17.33,0.97
4500,2021-05-16,BAS,4974,2468,2506,2812,2113,49,ITF,ITF5,17,Basilicata,Basilicata,559084,101865,18.22,0.89
4501,2021-07-19,BAS,5928,2890,3038,2000,3886,42,ITF,ITF5,17,Basilicata,Basilicata,559084,107793,19.28,1.06
4502,2021-05-23,BAS,4518,2302,2216,1527,2984,7,ITF,ITF5,17,Basilicata,Basilicata,559084,112311,20.09,0.81
4503,2021-05-02,BAS,4181,2001,2180,3490,629,62,ITF,ITF5,17,Basilicata,Basilicata,559084,116492,20.84,0.75
4504,2021-04-15,BAS,3431,1679,1752,2586,799,46,ITF,ITF5,17,Basilicata,Basilicata,559084,119923,21.45,0.61
4505,2021-07-07,BAS,5204,2470,2734,2020,3169,15,ITF,ITF5,17,Basilicata,Basilicata,559084,125127,22.38,0.93
4506,2021-01-03,BAS,910,347,563,910,0,0,ITF,ITF5,17,Basilicata,Basilicata,559084,126037,22.54,0.16
4507,2021-02-17,BAS,1137,493,644,1058,77,2,ITF,ITF5,17,Basilicata,Basilicata,559084,127174,22.75,0.2
4508,2021-05-28,BAS,3617,1811,1806,918,2666,33,ITF,ITF5,17,Basilicata,Basilicata,559084,130791,23.39,0.65
4509,2021-06-11,BAS,4237,1983,2254,3167,1028,42,ITF,ITF5,17,Basilicata,Basilicata,559084,135028,24.15,0.76
4510,2021-08-19,BAS,3595,1871,1724,1671,1836,88,ITF,ITF5,17,Basilicata,Basilicata,559084,138623,24.79,0.64
4511,2021-05-11,BAS,2654,1353,1301,1597,1033,24,ITF,ITF5,17,Basilicata,Basilicata,559084,141277,25.27,0.47
4512,2021-06-23,BAS,3242,1522,1720,2334,876,32,ITF,ITF5,17,Basilicata,Basilicata,559084,144519,25.85,0.58
4513,2021-03-13,BAS,1808,894,914,739,1049,20,ITF,ITF5,17,Basilicata,Basilicata,559084,146327,26.17,0.32
4514,2021-02-07,BAS,382,161,221,49,333,0,ITF,ITF5,17,Basilicata,Basilicata,559084,146709,26.24,0.07
4515,2021-05-18,BAS,5895,2855,3040,3379,2492,24,ITF,ITF5,17,Basilicata,Basilicata,559084,152604,27.3,1.05
4516,2021-03-15,BAS,2376,994,1382,508,1850,18,ITF,ITF5,17,Basilicata,Basilicata,559084,154980,27.72,0.42
4517,2021-01-17,BAS,330,133,197,329,1,0,ITF,ITF5,17,Basilicata,Basilicata,559084,155310,27.78,0.06
4518,2021-04-27,BAS,4729,2243,2486,4348,327,54,ITF,ITF5,17,Basilicata,Basilicata,559084,160039,28.63,0.85
4519,2021-08-05,BAS,4556,2319,2237,1283,3232,41,ITF,ITF5,17,Basilicata,Basilicata,559084,164595,29.44,0.81
4520,2021-03-06,BAS,1375,543,832,752,610,13,ITF,ITF5,17,Basilicata,Basilicata,559084,165970,29.69,0.25
4521,2021-05-09,BAS,4685,2339,2346,2942,1694,49,ITF,ITF5,17,Basilicata,Basilicata,559084,170655,30.52,0.84
4522,2021-02-15,BAS,634,239,395,574,44,16,ITF,ITF5,17,Basilicata,Basilicata,559084,171289,30.64,0.11
4523,2021-01-29,BAS,619,233,386,63,556,0,ITF,ITF5,17,Basilicata,Basilicata,559084,171908,30.75,0.11
4524,2021-06-09,BAS,4423,2072,2351,3967,423,33,ITF,ITF5,17,Basilicata,Basilicata,559084,176331,31.54,0.79
4525,2021-04-13,BAS,2118,1053,1065,1282,818,18,ITF,ITF5,17,Basilicata,Basilicata,559084,178449,31.92,0.38
4526,2021-03-01,BAS,553,286,267,384,169,0,ITF,ITF5,17,Basilicata,Basilicata,559084,179002,32.02,0.1
4527,2021-08-14,BAS,3480,1906,1574,1422,1998,60,ITF,ITF5,17,Basilicata,Basilicata,559084,182482,32.64,0.62
4528,2021-06-18,BAS,4465,2066,2399,2179,2259,27,ITF,ITF5,17,Basilicata,Basilicata,559084,186947,33.44,0.8
4529,2021-08-23,BAS,3315,1736,1579,1369,1864,82,ITF,ITF5,17,Basilicata,Basilicata,559084,190262,34.03,0.59
4530,2021-04-01,BAS,2736,1119,1617,1969,736,31,ITF,ITF5,17,Basilicata,Basilicata,559084,192998,34.52,0.49
4531,2021-02-03,BAS,675,305,370,32,643,0,ITF,ITF5,17,Basilicata,Basilicata,559084,193673,34.64,0.12
4532,2021-06-01,BAS,6138,2928,3210,3035,3076,27,ITF,ITF5,17,Basilicata,Basilicata,559084,199811,35.74,1.1
4533,2021-03-27,BAS,2257,866,1391,1809,434,14,ITF,ITF5,17,Basilicata,Basilicata,559084,202068,36.14,0.4
4534,2021-08-31,BAS,3098,1592,1506,1677,1276,145,ITF,ITF5,17,Basilicata,Basilicata,559084,205166,36.7,0.55
4535,2021-07-05,BAS,3270,1615,1655,2214,1022,34,ITF,ITF5,17,Basilicata,Basilicata,559084,208436,37.28,0.58
4536,2021-01-07,BAS,644,321,323,644,0,0,ITF,ITF5,17,Basilicata,Basilicata,559084,209080,37.4,0.12
4537,2021-02-19,BAS,1627,739,888,1559,63,5,ITF,ITF5,17,Basilicata,Basilicata,559084,210707,37.69,0.29
4538,2021-07-09,BAS,5339,2608,2731,1697,3633,9,ITF,ITF5,17,Basilicata,Basilicata,559084,216046,38.64,0.95
4539,2021-04-17,BAS,3461,1655,1806,2170,1262,29,ITF,ITF5,17,Basilicata,Basilicata,559084,219507,39.26,0.62
4540,2021-03-29,BAS,2482,898,1584,2141,288,53,ITF,ITF5,17,Basilicata,Basilicata,559084,221989,39.71,0.44
4541,2021-01-05,BAS,952,410,542,952,0,0,ITF,ITF5,17,Basilicata,Basilicata,559084,222941,39.88,0.17
4542,2021-07-14,BAS,5644,2721,2923,1630,3989,25,ITF,ITF5,17,Basilicata,Basilicata,559084,228585,40.89,1.01
4543,2021-04-05,BAS,726,235,491,412,304,10,ITF,ITF5,17,Basilicata,Basilicata,559084,229311,41.02,0.13
4544,2021-03-22,BAS,1222,549,673,641,573,8,ITF,ITF5,17,Basilicata,Basilicata,559084,230533,41.23,0.22
4545,2021-03-03,BAS,1794,836,958,1209,563,22,ITF,ITF5,17,Basilicata,Basilicata,559084,232327,41.55,0.32
4546,2021-08-09,BAS,4010,2065,1945,1569,2395,46,ITF,ITF5,17,Basilicata,Basilicata,559084,236337,42.27,0.72
4547,2021-07-23,BAS,5562,2786,2776,1896,3616,50,ITF,ITF5,17,Basilicata,Basilicata,559084,241899,43.27,0.99
4548,2021-05-01,BAS,4708,2139,2569,3883,755,70,ITF,ITF5,17,Basilicata,Basilicata,559084,246607,44.11,0.84
4549,2021-06-27,BAS,3007,1477,1530,2378,615,14,ITF,ITF5,17,Basilicata,Basilicata,559084,249614,44.65,0.54
4550,2021-04-29,BAS,4858,2398,2460,4342,441,75,ITF,ITF5,17,Basilicata,Basilicata,559084,254472,45.52,0.87
4551,2021-03-17,BAS,1470,615,855,24,1442,4,ITF,ITF5,17,Basilicata,Basilicata,559084,255942,45.78,0.26
4552,2021-01-19,BAS,199,84,115,199,0,0,ITF,ITF5,17,Basilicata,Basilicata,559084,256141,45.81,0.04
4553,2021-06-25,BAS,3317,1571,1746,2444,839,34,ITF,ITF5,17,Basilicata,Basilicata,559084,259458,46.41,0.59
4554,2021-07-04,BAS,3112,1563,1549,2164,922,26,ITF,ITF5,17,Basilicata,Basilicata,559084,262570,46.96,0.56
4555,2021-01-24,BAS,867,316,551,58,808,1,ITF,ITF5,17,Basilicata,Basilicata,559084,263437,47.12,0.16
4556,2021-05-13,BAS,5985,2969,3016,3298,2597,90,ITF,ITF5,17,Basilicata,Basilicata,559084,269422,48.19,1.07
4557,2021-08-21,BAS,3268,1778,1490,1711,1461,96,ITF,ITF5,17,Basilicata,Basilicata,559084,272690,48.77,0.58
4558,2021-05-08,BAS,4846,2407,2439,3382,1412,52,ITF,ITF5,17,Basilicata,Basilicata,559084,277536,49.64,0.87
4559,2021-08-16,BAS,3566,1866,1700,1484,1998,84,ITF,ITF5,17,Basilicata,Basilicata,559084,281102,50.28,0.64
4560,2021-03-10,BAS,1687,846,841,837,839,11,ITF,ITF5,17,Basilicata,Basilicata,559084,282789,50.58,0.3
4561,2021-01-26,BAS,813,358,455,101,712,0,ITF,ITF5,17,Basilicata,Basilicata,559084,283602,50.73,0.15
4562,2021-05-06,BAS,5068,2440,2628,3431,1586,51,ITF,ITF5,17,Basilicata,Basilicata,559084,288670,51.63,0.91
4563,2021-05-15,BAS,6533,3344,3189,3875,2575,83,ITF,ITF5,17,Basilicata,Basilicata,559084,295203,52.8,1.17
4564,2021-04-02,BAS,2343,1057,1286,1713,605,25,ITF,ITF5,17,Basilicata,Basilicata,559084,297546,53.22,0.42
4565,2021-05-25,BAS,4200,2114,2086,868,3322,10,ITF,ITF5,17,Basilicata,Basilicata,559084,301746,53.97,0.75
4566,2021-02-14,BAS,151,48,103,105,0,46,ITF,ITF5,17,Basilicata,Basilicata,559084,301897,54.0,0.03
4567,2021-01-31,BAS,78,24,54,0,78,0,ITF,ITF5,17,Basilicata,Basilicata,559084,301975,54.01,0.01
4568,2021-01-12,BAS,217,88,129,217,0,0,ITF,ITF5,17,Basilicata,Basilicata,559084,302192,54.05,0.04
4569,2021-08-04,BAS,4500,2232,2268,1424,3035,41,ITF,ITF5,17,Basilicata,Basilicata,559084,306692,54.86,0.8
4570,2021-06-08,BAS,4587,2195,2392,4191,358,38,ITF,ITF5,17,Basilicata,Basilicata,559084,311279,55.68,0.82
4571,2021-02-04,BAS,1108,446,662,64,1044,0,ITF,ITF5,17,Basilicata,Basilicata,559084,312387,55.87,0.2
4572,2021-07-11,BAS,5032,2405,2627,1509,3498,25,ITF,ITF5,17,Basilicata,Basilicata,559084,317419,56.77,0.9
4573,2021-02-02,BAS,370,145,225,175,194,1,ITF,ITF5,17,Basilicata,Basilicata,559084,317789,56.84,0.07
4574,2021-04-09,BAS,1153,350,803,1062,63,28,ITF,ITF5,17,Basilicata,Basilicata,559084,318942,57.05,0.21
4575,2021-02-26,BAS,2159,906,1253,2072,81,6,ITF,ITF5,17,Basilicata,Basilicata,559084,321101,57.43,0.39
4576,2021-05-20,BAS,5885,2981,2904,2886,2971,28,ITF,ITF5,17,Basilicata,Basilicata,559084,326986,58.49,1.05
4577,2021-08-28,BAS,2275,1287,988,1110,1105,60,ITF,ITF5,17,Basilicata,Basilicata,559084,329261,58.89,0.41
4578,2021-06-06,BAS,4512,2074,2438,3695,779,38,ITF,ITF5,17,Basilicata,Basilicata,559084,333773,59.7,0.81
4579,2021-08-11,BAS,3711,1922,1789,1430,2223,58,ITF,ITF5,17,Basilicata,Basilicata,559084,337484,60.36,0.66
4580,2021-06-20,BAS,4010,1883,2127,1940,2036,34,ITF,ITF5,17,Basilicata,Basilicata,559084,341494,61.08,0.72
4581,2021-03-14,BAS,1013,479,534,530,471,12,ITF,ITF5,17,Basilicata,Basilicata,559084,342507,61.26,0.18
4582,2021-03-31,BAS,3116,1268,1848,2301,785,30,ITF,ITF5,17,Basilicata,Basilicata,559084,345623,61.82,0.56
4583,2021-06-22,BAS,4355,2061,2294,2223,2100,32,ITF,ITF5,17,Basilicata,Basilicata,559084,349978,62.6,0.78
4584,2021-06-05,BAS,4800,2210,2590,3823,941,36,ITF,ITF5,17,Basilicata,Basilicata,559084,354778,63.46,0.86
4585,2021-08-27,BAS,2480,1313,1167,1000,1410,70,ITF,ITF5,17,Basilicata,Basilicata,559084,357258,63.9,0.44
4586,2021-02-23,BAS,1910,772,1138,1751,141,18,ITF,ITF5,17,Basilicata,Basilicata,559084,359168,64.24,0.34
4587,2021-02-12,BAS,782,334,448,749,32,1,ITF,ITF5,17,Basilicata,Basilicata,559084,359950,64.38,0.14
4588,2021-04-10,BAS,1037,380,657,925,84,28,ITF,ITF5,17,Basilicata,Basilicata,559084,360987,64.57,0.19
4589,2021-08-30,BAS,3200,1712,1488,1550,1546,104,ITF,ITF5,17,Basilicata,Basilicata,559084,364187,65.14,0.57
4590,2021-03-24,BAS,2000,770,1230,1482,493,25,ITF,ITF5,17,Basilicata,Basilicata,559084,366187,65.5,0.36
4591,2021-07-02,BAS,3690,1839,1851,2485,1176,29,ITF,ITF5,17,Basilicata,Basilicata,559084,369877,66.16,0.66
4592,2021-04-12,BAS,2175,1054,1121,1651,494,30,ITF,ITF5,17,Basilicata,Basilicata,559084,372052,66.55,0.39
4593,2021-07-21,BAS,5846,2943,2903,1612,4201,33,ITF,ITF5,17,Basilicata,Basilicata,559084,377898,67.59,1.05
4594,2021-04-19,BAS,4182,1920,2262,2395,1653,134,ITF,ITF5,17,Basilicata,Basilicata,559084,382080,68.34,0.75
4595,2021-07-28,BAS,5036,2576,2460,1930,3047,59,ITF,ITF5,17,Basilicata,Basilicata,559084,387116,69.24,0.9
4596,2021-06-15,BAS,3222,1417,1805,2225,976,21,ITF,ITF5,17,Basilicata,Basilicata,559084,390338,69.82,0.58
4597,2021-06-03,BAS,4924,2260,2664,3704,1181,39,ITF,ITF5,17,Basilicata,Basilicata,559084,395262,70.7,0.88
4598,2021-03-12,BAS,1921,986,935,786,1107,28,ITF,ITF5,17,Basilicata,Basilicata,559084,397183,71.04,0.34
4599,2021-05-17,BAS,5549,2735,2814,3363,2136,50,ITF,ITF5,17,Basilicata,Basilicata,559084,402732,72.03,0.99
4600,2021-08-25,BAS,2682,1407,1275,1259,1339,84,ITF,ITF5,17,Basilicata,Basilicata,559084,405414,72.51,0.48
4601,2021-05-10,BAS,4803,2382,2421,2708,2042,53,ITF,ITF5,17,Basilicata,Basilicata,559084,410217,73.37,0.86
4602,2021-08-18,BAS,3571,1975,1596,1499,1976,96,ITF,ITF5,17,Basilicata,Basilicata,559084,413788,74.01,0.64
4603,2021-07-18,BAS,4392,2165,2227,1579,2785,28,ITF,ITF5,17,Basilicata,Basilicata,559084,418180,74.8,0.79
4604,2021-04-14,BAS,2046,1001,1045,1354,676,16,ITF,ITF5,17,Basilicata,Basilicata,559084,420226,75.16,0.37
4605,2021-01-21,BAS,31,10,21,30,1,0,ITF,ITF5,17,Basilicata,Basilicata,559084,420257,75.17,0.01
4606,2021-01-04,BAS,615,276,339,615,0,0,ITF,ITF5,17,Basilicata,Basilicata,559084,420872,75.28,0.11
4607,2021-07-06,BAS,4211,2009,2202,2115,2060,36,ITF,ITF5,17,Basilicata,Basilicata,559084,425083,76.03,0.75
4608,2021-07-13,BAS,5853,2825,3028,1772,4033,48,ITF,ITF5,17,Basilicata,Basilicata,559084,430936,77.08,1.05
4609,2021-02-27,BAS,2002,863,1139,1820,165,17,ITF,ITF5,17,Basilicata,Basilicata,559084,432938,77.44,0.36
4610,2021-07-20,BAS,5698,2795,2903,1690,3965,43,ITF,ITF5,17,Basilicata,Basilicata,559084,438636,78.46,1.02
4611,2021-06-07,BAS,4239,1921,2318,3885,316,38,ITF,ITF5,17,Basilicata,Basilicata,559084,442875,79.21,0.76
4612,2021-04-11,BAS,966,393,573,760,176,30,ITF,ITF5,17,Basilicata,Basilicata,559084,443841,79.39,0.17
4613,2021-06-24,BAS,4091,1940,2151,2152,1902,37,ITF,ITF5,17,Basilicata,Basilicata,559084,447932,80.12,0.73
4614,2021-04-28,BAS,4709,2159,2550,4207,441,61,ITF,ITF5,17,Basilicata,Basilicata,559084,452641,80.96,0.84
4615,2021-03-02,BAS,802,387,415,659,138,5,ITF,ITF5,17,Basilicata,Basilicata,559084,453443,81.1,0.14
4616,2021-08-06,BAS,4215,2158,2057,1316,2846,53,ITF,ITF5,17,Basilicata,Basilicata,559084,457658,81.86,0.75
4617,2021-06-10,BAS,4346,2101,2245,3867,442,37,ITF,ITF5,17,Basilicata,Basilicata,559084,462004,82.64,0.78
4618,2021-08-13,BAS,3661,1904,1757,1423,2147,91,ITF,ITF5,17,Basilicata,Basilicata,559084,465665,83.29,0.65
4619,2021-07-30,BAS,4766,2436,2330,1915,2802,49,ITF,ITF5,17,Basilicata,Basilicata,559084,470431,84.14,0.85
4620,2021-06-17,BAS,4442,2045,2397,2087,2330,25,ITF,ITF5,17,Basilicata,Basilicata,559084,474873,84.94,0.79
4621,2021-04-21,BAS,3953,1845,2108,2243,1680,30,ITF,ITF5,17,Basilicata,Basilicata,559084,478826,85.64,0.71
4622,2021-08-01,BAS,4209,2114,2095,1632,2537,40,ITF,ITF5,17,Basilicata,Basilicata,559084,483035,86.4,0.75
4623,2021-06-29,BAS,3856,1880,1976,2785,1043,28,ITF,ITF5,17,Basilicata,Basilicata,559084,486891,87.09,0.69
4624,2021-03-21,BAS,1177,547,630,474,700,3,ITF,ITF5,17,Basilicata,Basilicata,559084,488068,87.3,0.21
4625,2021-05-29,BAS,3060,1534,1526,824,2225,11,ITF,ITF5,17,Basilicata,Basilicata,559084,491128,87.85,0.55
4626,2021-02-08,BAS,564,194,370,153,411,0,ITF,ITF5,17,Basilicata,Basilicata,559084,491692,87.95,0.1
4627,2021-05-19,BAS,2872,1499,1373,1183,1676,13,ITF,ITF5,17,Basilicata,Basilicata,559084,494564,88.46,0.51
4628,2021-02-25,BAS,1795,740,1055,1737,47,11,ITF,ITF5,17,Basilicata,Basilicata,559084,496359,88.78,0.32
4629,2021-08-10,BAS,4415,2325,2090,1513,2831,71,ITF,ITF5,17,Basilicata,Basilicata,559084,500774,89.57,0.79
4630,2021-02-06,BAS,927,381,546,146,781,0,ITF,ITF5,17,Basilicata,Basilicata,559084,501701,89.74,0.17
4631,2021-04-30,BAS,5287,2377,2910,4065,1163,59,ITF,ITF5,17,Basilicata,Basilicata,559084,506988,90.68,0.95
4632,2021-01-20,BAS,85,22,63,84,1,0,ITF,ITF5,17,Basilicata,Basilicata,559084,507073,90.7,0.02
4633,2021-09-01,BAS,3251,1684,1567,1046,2106,99,ITF,ITF5,17,Basilicata,Basilicata,559084,510324,91.28,0.58
4634,2021-02-11,BAS,957,406,551,872,83,2,ITF,ITF5,17,Basilicata,Basilicata,559084,511281,91.45,0.17
4635,2021-05-22,BAS,5493,2725,2768,1929,3553,11,ITF,ITF5,17,Basilicata,Basilicata,559084,516774,92.43,0.98
4636,2021-03-26,BAS,1956,703,1253,1667,261,28,ITF,ITF5,17,Basilicata,Basilicata,559084,518730,92.78,0.35
4637,2021-01-18,BAS,465,158,307,366,99,0,ITF,ITF5,17,Basilicata,Basilicata,559084,519195,92.87,0.08
4638,2021-03-16,BAS,1924,808,1116,226,1695,3,ITF,ITF5,17,Basilicata,Basilicata,559084,521119,93.21,0.34
4639,2021-05-05,BAS,4338,2050,2288,3376,891,71,ITF,ITF5,17,Basilicata,Basilicata,559084,525457,93.99,0.78
4640,2021-03-09,BAS,1413,723,690,780,612,21,ITF,ITF5,17,Basilicata,Basilicata,559084,526870,94.24,0.25
4641,2021-01-25,BAS,1044,438,606,73,970,1,ITF,ITF5,17,Basilicata,Basilicata,559084,527914,94.42,0.19
4642,2021-01-11,BAS,186,67,119,186,0,0,ITF,ITF5,17,Basilicata,Basilicata,559084,528100,94.46,0.03
4643,2021-02-13,BAS,801,314,487,702,61,38,ITF,ITF5,17,Basilicata,Basilicata,559084,528901,94.6,0.14
4644,2021-04-04,BAS,612,227,385,188,418,6,ITF,ITF5,17,Basilicata,Basilicata,559084,529513,94.71,0.11
4645,2021-07-22,BAS,5805,2891,2914,1794,3949,62,ITF,ITF5,17,Basilicata,Basilicata,559084,535318,95.75,1.04
4646,2021-05-24,BAS,4833,2344,2489,1087,3733,13,ITF,ITF5,17,Basilicata,Basilicata,559084,540151,96.61,0.86
4647,2021-07-29,BAS,4860,2526,2334,1910,2903,47,ITF,ITF5,17,Basilicata,Basilicata,559084,545011,97.48,0.87
4648,2021-06-02,BAS,5962,2806,3156,4375,1544,43,ITF,ITF5,17,Basilicata,Basilicata,559084,550973,98.55,1.07
4649,2021-04-18,BAS,3720,1843,1877,2327,1370,23,ITF,ITF5,17,Basilicata,Basilicata,559084,554693,99.21,0.67
4650,2021-02-20,BAS,1169,536,633,1050,119,0,ITF,ITF5,17,Basilicata,Basilicata,559084,555862,99.42,0.21
4651,2021-07-27,BAS,4715,2372,2343,1814,2855,46,ITF,ITF5,17,Basilicata,Basilicata,559084,560577,100.27,0.84
4652,2021-05-31,BAS,4230,2010,2220,1713,2509,8,ITF,ITF5,17,Basilicata,Basilicata,559084,564807,101.02,0.76
4653,2021-02-18,BAS,1074,403,671,855,216,3,ITF,ITF5,17,Basilicata,Basilicata,559084,565881,101.22,0.19
4654,2021-01-13,BAS,917,387,530,917,0,0,ITF,ITF5,17,Basilicata,Basilicata,559084,566798,101.38,0.16
4655,2021-04-23,BAS,4550,2191,2359,3478,1011,61,ITF,ITF5,17,Basilicata,Basilicata,559084,571348,102.19,0.81
4656,2021-01-30,BAS,713,230,483,129,584,0,ITF,ITF5,17,Basilicata,Basilicata,559084,572061,102.32,0.13
4657,2021-01-23,BAS,756,319,437,33,723,0,ITF,ITF5,17,Basilicata,Basilicata,559084,572817,102.46,0.14
4658,2021-05-03,BAS,4511,2043,2468,3621,827,63,ITF,ITF5,17,Basilicata,Basilicata,559084,577328,103.26,0.81
4659,2021-02-09,BAS,494,215,279,317,177,0,ITF,ITF5,17,Basilicata,Basilicata,559084,577822,103.35,0.09
4660,2021-07-25,BAS,4480,2255,2225,1607,2848,25,ITF,ITF5,17,Basilicata,Basilicata,559084,582302,104.15,0.8
4661,2021-03-04,BAS,1899,901,998,1068,807,24,ITF,ITF5,17,Basilicata,Basilicata,559084,584201,104.49,0.34
4662,2021-06-12,BAS,3686,1694,1992,2959,689,38,ITF,ITF5,17,Basilicata,Basilicata,559084,587887,105.15,0.66
4663,2021-02-28,BAS,813,347,466,772,37,4,ITF,ITF5,17,Basilicata,Basilicata,559084,588700,105.3,0.15
4664,2021-01-02,BAS,957,383,574,956,0,1,ITF,ITF5,17,Basilicata,Basilicata,559084,589657,105.47,0.17
4665,2021-01-16,BAS,725,305,420,725,0,0,ITF,ITF5,17,Basilicata,Basilicata,559084,590382,105.6,0.13
4666,2021-04-26,BAS,4466,2164,2302,4197,221,48,ITF,ITF5,17,Basilicata,Basilicata,559084,594848,106.4,0.8
4667,2021-08-08,BAS,3664,1873,1791,1115,2520,29,ITF,ITF5,17,Basilicata,Basilicata,559084,598512,107.05,0.66
4668,2021-02-21,BAS,284,113,171,284,0,0,ITF,ITF5,17,Basilicata,Basilicata,559084,598796,107.1,0.05
4669,2021-03-07,BAS,896,313,583,847,39,10,ITF,ITF5,17,Basilicata,Basilicata,559084,599692,107.26,0.16
4670,2021-01-09,BAS,560,161,399,560,0,0,ITF,ITF5,17,Basilicata,Basilicata,559084,600252,107.36,0.1
4671,2021-08-29,BAS,2331,1249,1082,1255,979,97,ITF,ITF5,17,Basilicata,Basilicata,559084,602583,107.78,0.42
4672,2021-07-03,BAS,3946,2103,1843,2756,1144,46,ITF,ITF5,17,Basilicata,Basilicata,559084,606529,108.49,0.71
4673,2021-05-07,BAS,4639,2280,2359,3269,1340,30,ITF,ITF5,17,Basilicata,Basilicata,559084,611168,109.32,0.83
4674,2021-08-15,BAS,2706,1432,1274,1137,1528,41,ITF,ITF5,17,Basilicata,Basilicata,559084,613874,109.8,0.48
4675,2021-07-10,BAS,5530,2669,2861,1596,3925,9,ITF,ITF5,17,Basilicata,Basilicata,559084,619404,110.79,0.99
4676,2021-05-14,BAS,5907,2798,3109,3274,2530,103,ITF,ITF5,17,Basilicata,Basilicata,559084,625311,111.85,1.06
4677,2021-03-18,BAS,1362,569,793,17,1336,9,ITF,ITF5,17,Basilicata,Basilicata,559084,626673,112.09,0.24
4678,2021-08-22,BAS,2443,1282,1161,1023,1371,49,ITF,ITF5,17,Basilicata,Basilicata,559084,629116,112.53,0.44
4679,2021-06-26,BAS,3338,1615,1723,2751,558,29,ITF,ITF5,17,Basilicata,Basilicata,559084,632454,113.12,0.6
4680,2021-06-21,BAS,4258,2045,2213,2142,2095,21,ITF,ITF5,17,Basilicata,Basilicata,559084,636712,113.88,0.76
4681,2021-06-19,BAS,4466,2178,2288,2370,2074,22,ITF,ITF5,17,Basilicata,Basilicata,559084,641178,114.68,0.8
4682,2021-03-28,BAS,2147,746,1401,2111,19,17,ITF,ITF5,17,Basilicata,Basilicata,559084,643325,115.07,0.38
4683,2021-03-11,BAS,1800,931,869,819,963,18,ITF,ITF5,17,Basilicata,Basilicata,559084,645125,115.39,0.32
4684,2021-03-30,BAS,2856,1214,1642,2494,346,16,ITF,ITF5,17,Basilicata,Basilicata,559084,647981,115.9,0.51
4685,2021-07-08,BAS,5137,2429,2708,1853,3259,25,ITF,ITF5,17,Basilicata,Basilicata,559084,653118,116.82,0.92
4686,2021-01-06,BAS,296,130,166,296,0,0,ITF,ITF5,17,Basilicata,Basilicata,559084,653414,116.87,0.05
4687,2021-04-16,BAS,3324,1635,1689,2398,901,25,ITF,ITF5,17,Basilicata,Basilicata,559084,656738,117.47,0.59
4688,2021-03-05,BAS,1870,864,1006,1097,758,15,ITF,ITF5,17,Basilicata,Basilicata,559084,658608,117.8,0.33
4689,2021-06-13,BAS,3014,1440,1574,2678,308,28,ITF,ITF5,17,Basilicata,Basilicata,559084,661622,118.34,0.54
4690,2021-05-27,BAS,3623,1863,1760,1073,2536,14,ITF,ITF5,17,Basilicata,Basilicata,559084,665245,118.99,0.65
4691,2021-04-24,BAS,4583,2221,2362,3476,1051,56,ITF,ITF5,17,Basilicata,Basilicata,559084,669828,119.81,0.82
4692,2021-08-02,BAS,4609,2334,2275,1779,2790,40,ITF,ITF5,17,Basilicata,Basilicata,559084,674437,120.63,0.82
4693,2021-07-16,BAS,5932,2899,3033,1803,4095,34,ITF,ITF5,17,Basilicata,Basilicata,559084,680369,121.69,1.06
4694,2021-03-19,BAS,2312,1002,1310,260,2045,7,ITF,ITF5,17,Basilicata,Basilicata,559084,682681,122.11,0.41
4695,2021-08-20,BAS,3123,1679,1444,1452,1593,78,ITF,ITF5,17,Basilicata,Basilicata,559084,685804,122.67,0.56
4696,2021-02-16,BAS,908,377,531,791,98,19,ITF,ITF5,17,Basilicata,Basilicata,559084,686712,122.83,0.16
4697,2021-01-28,BAS,919,407,512,119,800,0,ITF,ITF5,17,Basilicata,Basilicata,559084,687631,122.99,0.16
4698,2021-01-14,BAS,973,413,560,973,0,0,ITF,ITF5,17,Basilicata,Basilicata,559084,688604,123.17,0.17
4699,2021-04-07,BAS,1212,552,660,1156,36,20,ITF,ITF5,17,Basilicata,Basilicata,559084,689816,123.38,0.22
4700,2021-04-25,BAS,2992,1459,1533,2908,52,32,ITF,ITF5,17,Basilicata,Basilicata,559084,692808,123.92,0.54
4701,2021-08-03,BAS,5058,2572,2486,1826,3183,49,ITF,ITF5,17,Basilicata,Basilicata,559084,697866,124.82,0.9
4702,2021-08-17,BAS,3508,1763,1745,1398,2044,66,ITF,ITF5,17,Basilicata,Basilicata,559084,701374,125.45,0.63
4703,2021-05-12,BAS,4730,2330,2400,2801,1881,48,ITF,ITF5,17,Basilicata,Basilicata,559084,706104,126.3,0.85
4704,2021-07-15,BAS,6480,3212,3268,1669,4785,26,ITF,ITF5,17,Basilicata,Basilicata,559084,712584,127.46,1.16
4705,2021-04-06,BAS,1275,465,810,1073,184,18,ITF,ITF5,17,Basilicata,Basilicata,559084,713859,127.68,0.23
4706,2021-06-14,BAS,4825,2156,2669,2090,2711,24,ITF,ITF5,17,Basilicata,Basilicata,559084,718684,128.55,0.86
4707,2021-03-23,BAS,1640,632,1008,1451,169,20,ITF,ITF5,17,Basilicata,Basilicata,559084,720324,128.84,0.29
4708,2021-07-01,BAS,3712,1856,1856,2567,1112,33,ITF,ITF5,17,Basilicata,Basilicata,559084,724036,129.5,0.66
4709,2021-09-03,BAS,2281,1213,1068,584,1656,41,ITF,ITF5,17,Basilicata,Basilicata,559084,726317,129.91,0.41
4710,2021-02-01,BAS,248,94,154,46,202,0,ITF,ITF5,17,Basilicata,Basilicata,559084,726565,129.96,0.04
4711,2021-05-26,BAS,4489,2260,2229,1676,2784,29,ITF,ITF5,17,Basilicata,Basilicata,559084,731054,130.76,0.8
4712,2021-01-30,EMR,10093,3528,6565,136,9956,1,ITH,ITH5,8,Emilia-Romagna,Emilia-Romagna,4459477,10093,0.23,0.23
4713,2021-01-23,EMR,2448,871,1577,439,2009,0,ITH,ITH5,8,Emilia-Romagna,Emilia-Romagna,4459477,12541,0.28,0.05
4714,2021-05-07,EMR,35335,16985,18350,22698,11892,745,ITH,ITH5,8,Emilia-Romagna,Emilia-Romagna,4459477,47876,1.07,0.79
4715,2021-07-03,EMR,32124,15936,16188,11437,20021,666,ITH,ITH5,8,Emilia-Romagna,Emilia-Romagna,4459477,80000,1.79,0.72
4716,2021-08-29,EMR,20571,11378,9193,8473,11251,847,ITH,ITH5,8,Emilia-Romagna,Emilia-Romagna,4459477,100571,2.26,0.46
4717,2021-07-20,EMR,43132,22546,20586,6675,35778,679,ITH,ITH5,8,Emilia-Romagna,Emilia-Romagna,4459477,143703,3.22,0.97
4718,2021-04-11,EMR,15285,6940,8345,11982,3049,254,ITH,ITH5,8,Emilia-Romagna,Emilia-Romagna,4459477,158988,3.57,0.34
4719,2021-02-11,EMR,4256,1414,2842,3396,843,17,ITH,ITH5,8,Emilia-Romagna,Emilia-Romagna,4459477,163244,3.66,0.1
4720,2021-08-17,EMR,22351,12282,10069,14478,6856,1017,ITH,ITH5,8,Emilia-Romagna,Emilia-Romagna,4459477,185595,4.16,0.5
4721,2021-09-03,EMR,14488,7738,6750,3942,10179,367,ITH,ITH5,8,Emilia-Romagna,Emilia-Romagna,4459477,200083,4.49,0.32
4722,2021-05-26,EMR,33347,14756,18591,9929,23033,385,ITH,ITH5,8,Emilia-Romagna,Emilia-Romagna,4459477,233430,5.23,0.75
4723,2021-06-12,EMR,41389,21886,19503,35488,4919,982,ITH,ITH5,8,Emilia-Romagna,Emilia-Romagna,4459477,274819,6.16,0.93
4724,2021-03-04,EMR,16459,5351,11108,13345,3025,89,ITH,ITH5,8,Emilia-Romagna,Emilia-Romagna,4459477,291278,6.53,0.37
4725,2021-05-24,EMR,30011,13740,16271,17968,11528,515,ITH,ITH5,8,Emilia-Romagna,Emilia-Romagna,4459477,321289,7.2,0.67
4726,2021-02-13,EMR,3630,1086,2544,3017,599,14,ITH,ITH5,8,Emilia-Romagna,Emilia-Romagna,4459477,324919,7.29,0.08
4727,2021-04-16,EMR,29242,13765,15477,20015,8841,386,ITH,ITH5,8,Emilia-Romagna,Emilia-Romagna,4459477,354161,7.94,0.66
4728,2021-01-06,EMR,8286,2954,5332,8285,0,1,ITH,ITH5,8,Emilia-Romagna,Emilia-Romagna,4459477,362447,8.13,0.19
4729,2021-08-08,EMR,21609,11711,9898,10573,10496,540,ITH,ITH5,8,Emilia-Romagna,Emilia-Romagna,4459477,384056,8.61,0.48
4730,2021-04-30,EMR,36655,16807,19848,21236,14809,610,ITH,ITH5,8,Emilia-Romagna,Emilia-Romagna,4459477,420711,9.43,0.82
4731,2021-03-28,EMR,13550,6059,7491,9543,3885,122,ITH,ITH5,8,Emilia-Romagna,Emilia-Romagna,4459477,434261,9.74,0.3
4732,2021-06-21,EMR,37598,19007,18591,16095,20894,609,ITH,ITH5,8,Emilia-Romagna,Emilia-Romagna,4459477,471859,10.58,0.84
4733,2021-07-08,EMR,41351,20600,20751,4737,36203,411,ITH,ITH5,8,Emilia-Romagna,Emilia-Romagna,4459477,513210,11.51,0.93
4734,2021-03-30,EMR,23351,10341,13010,17994,5042,315,ITH,ITH5,8,Emilia-Romagna,Emilia-Romagna,4459477,536561,12.03,0.52
4735,2021-07-22,EMR,40371,21550,18821,15287,24192,892,ITH,ITH5,8,Emilia-Romagna,Emilia-Romagna,4459477,576932,12.94,0.91
4736,2021-01-04,EMR,7307,2526,4781,7304,0,3,ITH,ITH5,8,Emilia-Romagna,Emilia-Romagna,4459477,584239,13.1,0.16
4737,2021-02-18,EMR,7044,2892,4152,6440,588,16,ITH,ITH5,8,Emilia-Romagna,Emilia-Romagna,4459477,591283,13.26,0.16
4738,2021-06-07,EMR,40571,20825,19746,33474,6263,834,ITH,ITH5,8,Emilia-Romagna,Emilia-Romagna,4459477,631854,14.17,0.91
4739,2021-08-03,EMR,38497,20264,18233,15565,22287,645,ITH,ITH5,8,Emilia-Romagna,Emilia-Romagna,4459477,670351,15.03,0.86
4740,2021-05-12,EMR,38964,18311,20653,28473,9698,793,ITH,ITH5,8,Emilia-Romagna,Emilia-Romagna,4459477,709315,15.91,0.87
4741,2021-02-01,EMR,10329,3618,6711,355,9972,2,ITH,ITH5,8,Emilia-Romagna,Emilia-Romagna,4459477,719644,16.14,0.23
4742,2021-01-18,EMR,3131,881,2250,2448,680,3,ITH,ITH5,8,Emilia-Romagna,Emilia-Romagna,4459477,722775,16.21,0.07
4743,2021-03-16,EMR,12254,5028,7226,4875,7314,65,ITH,ITH5,8,Emilia-Romagna,Emilia-Romagna,4459477,735029,16.48,0.27
4744,2021-01-25,EMR,6465,2148,4317,206,6258,1,ITH,ITH5,8,Emilia-Romagna,Emilia-Romagna,4459477,741494,16.63,0.14
4745,2021-07-01,EMR,34539,16881,17658,14833,18849,857,ITH,ITH5,8,Emilia-Romagna,Emilia-Romagna,4459477,776033,17.4,0.77
4746,2021-03-23,EMR,18801,8147,10654,11947,6689,165,ITH,ITH5,8,Emilia-Romagna,Emilia-Romagna,4459477,794834,17.82,0.42
4747,2021-08-15,EMR,6648,3690,2958,3281,3199,168,ITH,ITH5,8,Emilia-Romagna,Emilia-Romagna,4459477,801482,17.97,0.15
4748,2021-06-26,EMR,37482,18995,18487,21029,15537,916,ITH,ITH5,8,Emilia-Romagna,Emilia-Romagna,4459477,838964,18.81,0.84
4749,2021-08-22,EMR,16455,9034,7421,6729,9099,627,ITH,ITH5,8,Emilia-Romagna,Emilia-Romagna,4459477,855419,19.18,0.37
4750,2021-07-10,EMR,42098,21435,20663,6806,34644,648,ITH,ITH5,8,Emilia-Romagna,Emilia-Romagna,4459477,897517,20.13,0.94
4751,2021-07-15,EMR,50389,26245,24144,7911,41785,693,ITH,ITH5,8,Emilia-Romagna,Emilia-Romagna,4459477,947906,21.26,1.13
4752,2021-04-23,EMR,29579,13816,15763,14306,14894,379,ITH,ITH5,8,Emilia-Romagna,Emilia-Romagna,4459477,977485,21.92,0.66
4753,2021-01-13,EMR,9078,2943,6135,9073,0,5,ITH,ITH5,8,Emilia-Romagna,Emilia-Romagna,4459477,986563,22.12,0.2
4754,2021-04-04,EMR,9883,4719,5164,7529,2271,83,ITH,ITH5,8,Emilia-Romagna,Emilia-Romagna,4459477,996446,22.34,0.22
4755,2021-01-11,EMR,9351,3278,6073,9342,0,9,ITH,ITH5,8,Emilia-Romagna,Emilia-Romagna,4459477,1005797,22.55,0.21
4756,2021-08-27,EMR,27843,14976,12867,6928,20185,730,ITH,ITH5,8,Emilia-Romagna,Emilia-Romagna,4459477,1033640,23.18,0.62
4757,2021-05-19,EMR,33841,14997,18844,18043,15268,530,ITH,ITH5,8,Emilia-Romagna,Emilia-Romagna,4459477,1067481,23.94,0.76
4758,2021-06-02,EMR,24123,12071,12052,18702,4979,442,ITH,ITH5,8,Emilia-Romagna,Emilia-Romagna,4459477,1091604,24.48,0.54
4759,2021-07-29,EMR,40782,21523,19259,14527,25546,709,ITH,ITH5,8,Emilia-Romagna,Emilia-Romagna,4459477,1132386,25.39,0.91
4760,2021-07-27,EMR,41122,21847,19275,17018,23321,783,ITH,ITH5,8,Emilia-Romagna,Emilia-Romagna,4459477,1173508,26.31,0.92
4761,2021-04-18,EMR,17527,8406,9121,12364,4934,229,ITH,ITH5,8,Emilia-Romagna,Emilia-Romagna,4459477,1191035,26.71,0.39
4762,2021-06-14,EMR,41344,21374,19970,27478,13088,778,ITH,ITH5,8,Emilia-Romagna,Emilia-Romagna,4459477,1232379,27.64,0.93
4763,2021-02-25,EMR,9249,3498,5751,8271,955,23,ITH,ITH5,8,Emilia-Romagna,Emilia-Romagna,4459477,1241628,27.84,0.21
4764,2021-06-19,EMR,36691,18364,18327,16756,19403,532,ITH,ITH5,8,Emilia-Romagna,Emilia-Romagna,4459477,1278319,28.67,0.82
4765,2021-03-11,EMR,17499,7331,10168,11456,5856,187,ITH,ITH5,8,Emilia-Romagna,Emilia-Romagna,4459477,1295818,29.06,0.39
4766,2021-02-06,EMR,7601,2407,5194,2108,5489,4,ITH,ITH5,8,Emilia-Romagna,Emilia-Romagna,4459477,1303419,29.23,0.17
4767,2021-05-31,EMR,29813,13776,16037,17729,11532,552,ITH,ITH5,8,Emilia-Romagna,Emilia-Romagna,4459477,1333232,29.9,0.67
4768,2021-02-20,EMR,5318,2094,3224,5048,263,7,ITH,ITH5,8,Emilia-Romagna,Emilia-Romagna,4459477,1338550,30.02,0.12
4769,2021-01-15,EMR,7754,2406,5348,7746,0,8,ITH,ITH5,8,Emilia-Romagna,Emilia-Romagna,4459477,1346304,30.19,0.17
4770,2021-03-09,EMR,14804,6035,8769,10754,3954,96,ITH,ITH5,8,Emilia-Romagna,Emilia-Romagna,4459477,1361108,30.52,0.33
4771,2021-05-05,EMR,30143,14003,16140,18306,11273,564,ITH,ITH5,8,Emilia-Romagna,Emilia-Romagna,4459477,1391251,31.2,0.68
4772,2021-03-25,EMR,21488,9421,12067,14238,6992,258,ITH,ITH5,8,Emilia-Romagna,Emilia-Romagna,4459477,1412739,31.68,0.48
4773,2021-05-21,EMR,39384,17560,21824,21635,17130,619,ITH,ITH5,8,Emilia-Romagna,Emilia-Romagna,4459477,1452123,32.56,0.88
4774,2021-06-30,EMR,34257,17288,16969,17706,15665,886,ITH,ITH5,8,Emilia-Romagna,Emilia-Romagna,4459477,1486380,33.33,0.77
4775,2021-07-17,EMR,43660,23050,20610,7179,35744,737,ITH,ITH5,8,Emilia-Romagna,Emilia-Romagna,4459477,1530040,34.31,0.98
4776,2021-06-11,EMR,45985,23869,22116,38345,6556,1084,ITH,ITH5,8,Emilia-Romagna,Emilia-Romagna,4459477,1576025,35.34,1.03
4777,2021-06-28,EMR,40073,19664,20409,19651,19578,844,ITH,ITH5,8,Emilia-Romagna,Emilia-Romagna,4459477,1616098,36.24,0.9
4778,2021-03-20,EMR,16091,6829,9262,8956,6966,169,ITH,ITH5,8,Emilia-Romagna,Emilia-Romagna,4459477,1632189,36.6,0.36
4779,2021-08-10,EMR,31314,16750,14564,15381,14911,1022,ITH,ITH5,8,Emilia-Romagna,Emilia-Romagna,4459477,1663503,37.3,0.7
4780,2021-03-13,EMR,16147,6365,9782,10594,5314,239,ITH,ITH5,8,Emilia-Romagna,Emilia-Romagna,4459477,1679650,37.66,0.36
4781,2021-07-05,EMR,33235,16205,17030,11227,21377,631,ITH,ITH5,8,Emilia-Romagna,Emilia-Romagna,4459477,1712885,38.41,0.75
4782,2021-03-27,EMR,21681,9072,12609,14523,6911,247,ITH,ITH5,8,Emilia-Romagna,Emilia-Romagna,4459477,1734566,38.9,0.49
4783,2021-04-13,EMR,23725,11131,12594,19033,4344,348,ITH,ITH5,8,Emilia-Romagna,Emilia-Romagna,4459477,1758291,39.43,0.53
4784,2021-01-03,EMR,2764,945,1819,2764,0,0,ITH,ITH5,8,Emilia-Romagna,Emilia-Romagna,4459477,1761055,39.49,0.06
4785,2021-05-09,EMR,25644,12269,13375,18279,6973,392,ITH,ITH5,8,Emilia-Romagna,Emilia-Romagna,4459477,1786699,40.07,0.58
4786,2021-01-29,EMR,10426,3500,6926,290,10136,0,ITH,ITH5,8,Emilia-Romagna,Emilia-Romagna,4459477,1797125,40.3,0.23
4787,2021-02-15,EMR,2903,850,2053,2710,125,68,ITH,ITH5,8,Emilia-Romagna,Emilia-Romagna,4459477,1800028,40.36,0.07
4788,2021-01-27,EMR,8371,2951,5420,461,7910,0,ITH,ITH5,8,Emilia-Romagna,Emilia-Romagna,4459477,1808399,40.55,0.19
4789,2021-07-31,EMR,36210,19226,16984,12141,23375,694,ITH,ITH5,8,Emilia-Romagna,Emilia-Romagna,4459477,1844609,41.36,0.81
4790,2021-01-10,EMR,7172,2686,4486,7171,0,1,ITH,ITH5,8,Emilia-Romagna,Emilia-Romagna,4459477,1851781,41.52,0.16
4791,2021-06-16,EMR,45961,23539,22422,25262,19962,737,ITH,ITH5,8,Emilia-Romagna,Emilia-Romagna,4459477,1897742,42.56,1.03
4792,2021-03-08,EMR,12219,5100,7119,9470,2664,85,ITH,ITH5,8,Emilia-Romagna,Emilia-Romagna,4459477,1909961,42.83,0.27
4793,2021-06-09,EMR,43157,21920,21237,35719,6429,1009,ITH,ITH5,8,Emilia-Romagna,Emilia-Romagna,4459477,1953118,43.8,0.97
4794,2021-03-01,EMR,10103,3584,6519,7816,2262,25,ITH,ITH5,8,Emilia-Romagna,Emilia-Romagna,4459477,1963221,44.02,0.23
4795,2021-08-05,EMR,36751,19448,17303,18370,17408,973,ITH,ITH5,8,Emilia-Romagna,Emilia-Romagna,4459477,1999972,44.85,0.82
4796,2021-08-12,EMR,27684,15040,12644,19265,6877,1542,ITH,ITH5,8,Emilia-Romagna,Emilia-Romagna,4459477,2027656,45.47,0.62
4797,2021-05-04,EMR,29312,13727,15585,15166,13670,476,ITH,ITH5,8,Emilia-Romagna,Emilia-Romagna,4459477,2056968,46.13,0.66
4798,2021-02-27,EMR,10970,3999,6971,9195,1742,33,ITH,ITH5,8,Emilia-Romagna,Emilia-Romagna,4459477,2067938,46.37,0.25
4799,2021-04-25,EMR,22360,10244,12116,14403,7515,442,ITH,ITH5,8,Emilia-Romagna,Emilia-Romagna,4459477,2090298,46.87,0.5
4800,2021-08-07,EMR,30947,17020,13927,17678,12206,1063,ITH,ITH5,8,Emilia-Romagna,Emilia-Romagna,4459477,2121245,47.57,0.69
4801,2021-04-27,EMR,32133,14874,17259,19233,12470,430,ITH,ITH5,8,Emilia-Romagna,Emilia-Romagna,4459477,2153378,48.29,0.72
4802,2021-05-02,EMR,25595,11656,13939,13191,12000,404,ITH,ITH5,8,Emilia-Romagna,Emilia-Romagna,4459477,2178973,48.86,0.57
4803,2021-01-22,EMR,1830,476,1354,1087,741,2,ITH,ITH5,8,Emilia-Romagna,Emilia-Romagna,4459477,2180803,48.9,0.04
4804,2021-08-24,EMR,23304,12662,10642,10471,11752,1081,ITH,ITH5,8,Emilia-Romagna,Emilia-Romagna,4459477,2204107,49.43,0.52
4805,2021-02-08,EMR,5239,1537,3702,2318,2918,3,ITH,ITH5,8,Emilia-Romagna,Emilia-Romagna,4459477,2209346,49.54,0.12
4806,2021-05-16,EMR,25887,12179,13708,18363,7144,380,ITH,ITH5,8,Emilia-Romagna,Emilia-Romagna,4459477,2235233,50.12,0.58
4807,2021-02-22,EMR,7486,3093,4393,7200,273,13,ITH,ITH5,8,Emilia-Romagna,Emilia-Romagna,4459477,2242719,50.29,0.17
4808,2021-08-31,EMR,27913,14842,13071,8300,18564,1049,ITH,ITH5,8,Emilia-Romagna,Emilia-Romagna,4459477,2270632,50.92,0.63
4809,2021-05-23,EMR,25505,11868,13637,13579,11609,317,ITH,ITH5,8,Emilia-Romagna,Emilia-Romagna,4459477,2296137,51.49,0.57
4810,2021-07-19,EMR,41994,22119,19875,6633,34765,596,ITH,ITH5,8,Emilia-Romagna,Emilia-Romagna,4459477,2338131,52.43,0.94
4811,2021-08-14,EMR,15785,8902,6883,8321,7021,443,ITH,ITH5,8,Emilia-Romagna,Emilia-Romagna,4459477,2353916,52.78,0.35
4812,2021-05-06,EMR,35981,16626,19355,22152,13099,730,ITH,ITH5,8,Emilia-Romagna,Emilia-Romagna,4459477,2389897,53.59,0.81
4813,2021-01-26,EMR,8339,3002,5337,209,8129,1,ITH,ITH5,8,Emilia-Romagna,Emilia-Romagna,4459477,2398236,53.78,0.19
4814,2021-07-02,EMR,34759,17093,17666,12403,21723,633,ITH,ITH5,8,Emilia-Romagna,Emilia-Romagna,4459477,2432995,54.56,0.78
4815,2021-03-24,EMR,21239,9413,11826,13629,7387,223,ITH,ITH5,8,Emilia-Romagna,Emilia-Romagna,4459477,2454234,55.03,0.48
4816,2021-01-24,EMR,2446,887,1559,298,2148,0,ITH,ITH5,8,Emilia-Romagna,Emilia-Romagna,4459477,2456680,55.09,0.05
4817,2021-08-19,EMR,21520,11557,9963,11921,8723,876,ITH,ITH5,8,Emilia-Romagna,Emilia-Romagna,4459477,2478200,55.57,0.48
4818,2021-05-28,EMR,41298,18965,22333,17270,23430,598,ITH,ITH5,8,Emilia-Romagna,Emilia-Romagna,4459477,2519498,56.5,0.93
4819,2021-04-22,EMR,29060,13455,15605,14616,14080,364,ITH,ITH5,8,Emilia-Romagna,Emilia-Romagna,4459477,2548558,57.15,0.65
4820,2021-04-06,EMR,24771,11181,13590,19727,4751,293,ITH,ITH5,8,Emilia-Romagna,Emilia-Romagna,4459477,2573329,57.7,0.56
4821,2020-12-27,EMR,970,374,596,970,0,0,ITH,ITH5,8,Emilia-Romagna,Emilia-Romagna,4459477,2574299,57.73,0.02
4822,2021-06-13,EMR,28771,15010,13761,23827,4286,658,ITH,ITH5,8,Emilia-Romagna,Emilia-Romagna,4459477,2603070,58.37,0.65
4823,2021-03-05,EMR,17920,5862,12058,14292,3503,125,ITH,ITH5,8,Emilia-Romagna,Emilia-Romagna,4459477,2620990,58.77,0.4
4824,2021-03-22,EMR,17658,7820,9838,10615,6871,172,ITH,ITH5,8,Emilia-Romagna,Emilia-Romagna,4459477,2638648,59.17,0.4
4825,2021-03-03,EMR,15896,5268,10628,13356,2487,53,ITH,ITH5,8,Emilia-Romagna,Emilia-Romagna,4459477,2654544,59.53,0.36
4826,2021-02-10,EMR,4022,1383,2639,2755,1261,6,ITH,ITH5,8,Emilia-Romagna,Emilia-Romagna,4459477,2658566,59.62,0.09
4827,2021-04-08,EMR,31395,14416,16979,25326,5331,738,ITH,ITH5,8,Emilia-Romagna,Emilia-Romagna,4459477,2689961,60.32,0.7
4828,2021-03-18,EMR,13776,5850,7926,5680,8005,91,ITH,ITH5,8,Emilia-Romagna,Emilia-Romagna,4459477,2703737,60.63,0.31
4829,2021-05-14,EMR,37352,17201,20151,26798,9655,899,ITH,ITH5,8,Emilia-Romagna,Emilia-Romagna,4459477,2741089,61.47,0.84
4830,2021-02-03,EMR,9348,2991,6357,961,8386,1,ITH,ITH5,8,Emilia-Romagna,Emilia-Romagna,4459477,2750437,61.68,0.21
4831,2021-04-01,EMR,23975,10783,13192,19073,4556,346,ITH,ITH5,8,Emilia-Romagna,Emilia-Romagna,4459477,2774412,62.21,0.54
4832,2021-02-17,EMR,6543,2766,3777,5757,773,13,ITH,ITH5,8,Emilia-Romagna,Emilia-Romagna,4459477,2780955,62.36,0.15
4833,2021-04-20,EMR,22653,10418,12235,13886,8367,400,ITH,ITH5,8,Emilia-Romagna,Emilia-Romagna,4459477,2803608,62.87,0.51
4834,2021-06-23,EMR,38076,19096,18980,18488,18883,705,ITH,ITH5,8,Emilia-Romagna,Emilia-Romagna,4459477,2841684,63.72,0.85
4835,2021-01-08,EMR,10873,3584,7289,10870,0,3,ITH,ITH5,8,Emilia-Romagna,Emilia-Romagna,4459477,2852557,63.97,0.24
4836,2021-03-06,EMR,21034,5970,15064,18167,2743,124,ITH,ITH5,8,Emilia-Romagna,Emilia-Romagna,4459477,2873591,64.44,0.47
4837,2021-07-12,EMR,44069,22330,21739,5428,38132,509,ITH,ITH5,8,Emilia-Romagna,Emilia-Romagna,4459477,2917660,65.43,0.99
4838,2021-08-16,EMR,20209,10865,9344,12638,6574,997,ITH,ITH5,8,Emilia-Romagna,Emilia-Romagna,4459477,2937869,65.88,0.45
4839,2021-09-02,EMR,24857,13201,11656,6449,17731,677,ITH,ITH5,8,Emilia-Romagna,Emilia-Romagna,4459477,2962726,66.44,0.56
4840,2021-05-25,EMR,25242,11239,14003,11301,13512,429,ITH,ITH5,8,Emilia-Romagna,Emilia-Romagna,4459477,2987968,67.0,0.57
4841,2021-02-14,EMR,1403,378,1025,1275,120,8,ITH,ITH5,8,Emilia-Romagna,Emilia-Romagna,4459477,2989371,67.03,0.03
4842,2021-08-09,EMR,30215,16120,14095,16630,12556,1029,ITH,ITH5,8,Emilia-Romagna,Emilia-Romagna,4459477,3019586,67.71,0.68
4843,2021-05-01,EMR,28432,12782,15650,15278,12795,359,ITH,ITH5,8,Emilia-Romagna,Emilia-Romagna,4459477,3048018,68.35,0.64
4844,2021-01-12,EMR,9482,3126,6356,9473,0,9,ITH,ITH5,8,Emilia-Romagna,Emilia-Romagna,4459477,3057500,68.56,0.21
4845,2021-07-16,EMR,49789,26281,23508,7053,42080,656,ITH,ITH5,8,Emilia-Romagna,Emilia-Romagna,4459477,3107289,69.68,1.12
4846,2021-06-27,EMR,29596,14893,14703,16214,12733,649,ITH,ITH5,8,Emilia-Romagna,Emilia-Romagna,4459477,3136885,70.34,0.66
4847,2021-07-14,EMR,47970,24541,23429,5592,41845,533,ITH,ITH5,8,Emilia-Romagna,Emilia-Romagna,4459477,3184855,71.42,1.08
4848,2021-04-05,EMR,14862,6812,8050,11789,2894,179,ITH,ITH5,8,Emilia-Romagna,Emilia-Romagna,4459477,3199717,71.75,0.33
4849,2021-07-09,EMR,44921,22953,21968,5420,39081,420,ITH,ITH5,8,Emilia-Romagna,Emilia-Romagna,4459477,3244638,72.76,1.01
4850,2021-01-17,EMR,2895,890,2005,2645,249,1,ITH,ITH5,8,Emilia-Romagna,Emilia-Romagna,4459477,3247533,72.82,0.06
4851,2021-04-02,EMR,23411,10559,12852,18557,4488,366,ITH,ITH5,8,Emilia-Romagna,Emilia-Romagna,4459477,3270944,73.35,0.52
4852,2021-05-29,EMR,37951,16522,21429,16663,20764,524,ITH,ITH5,8,Emilia-Romagna,Emilia-Romagna,4459477,3308895,74.2,0.85
4853,2021-07-11,EMR,30398,15242,15156,2763,27370,265,ITH,ITH5,8,Emilia-Romagna,Emilia-Romagna,4459477,3339293,74.88,0.68
4854,2021-06-01,EMR,27196,13114,14082,16845,9929,422,ITH,ITH5,8,Emilia-Romagna,Emilia-Romagna,4459477,3366489,75.49,0.61
4855,2021-07-28,EMR,38699,20750,17949,14020,24045,634,ITH,ITH5,8,Emilia-Romagna,Emilia-Romagna,4459477,3405188,76.36,0.87
4856,2021-04-12,EMR,19258,9015,10243,14447,4452,359,ITH,ITH5,8,Emilia-Romagna,Emilia-Romagna,4459477,3424446,76.79,0.43
4857,2021-06-08,EMR,45106,23084,22022,36818,7508,780,ITH,ITH5,8,Emilia-Romagna,Emilia-Romagna,4459477,3469552,77.8,1.01
4858,2021-08-04,EMR,35328,18834,16494,13062,21682,584,ITH,ITH5,8,Emilia-Romagna,Emilia-Romagna,4459477,3504880,78.59,0.79
4859,2021-02-05,EMR,9310,2963,6347,1617,7689,4,ITH,ITH5,8,Emilia-Romagna,Emilia-Romagna,4459477,3514190,78.8,0.21
4860,2021-06-20,EMR,30748,15598,15150,15608,14670,470,ITH,ITH5,8,Emilia-Romagna,Emilia-Romagna,4459477,3544938,79.49,0.69
4861,2021-05-27,EMR,42347,18770,23577,13563,28284,500,ITH,ITH5,8,Emilia-Romagna,Emilia-Romagna,4459477,3587285,80.44,0.95
4862,2021-02-16,EMR,5773,2447,3326,5228,531,14,ITH,ITH5,8,Emilia-Romagna,Emilia-Romagna,4459477,3593058,80.57,0.13
4863,2021-08-01,EMR,30024,16152,13872,10236,19355,433,ITH,ITH5,8,Emilia-Romagna,Emilia-Romagna,4459477,3623082,81.24,0.67
4864,2021-08-18,EMR,22241,12180,10061,14541,6642,1058,ITH,ITH5,8,Emilia-Romagna,Emilia-Romagna,4459477,3645323,81.74,0.5
4865,2021-05-10,EMR,33895,16151,17744,26013,7263,619,ITH,ITH5,8,Emilia-Romagna,Emilia-Romagna,4459477,3679218,82.5,0.76
4866,2021-07-30,EMR,39848,21409,18439,15669,23462,717,ITH,ITH5,8,Emilia-Romagna,Emilia-Romagna,4459477,3719066,83.4,0.89
4867,2021-04-21,EMR,23975,10972,13003,13869,9743,363,ITH,ITH5,8,Emilia-Romagna,Emilia-Romagna,4459477,3743041,83.93,0.54
4868,2021-05-08,EMR,32379,15112,17267,20401,11438,540,ITH,ITH5,8,Emilia-Romagna,Emilia-Romagna,4459477,3775420,84.66,0.73
4869,2021-01-28,EMR,10263,3343,6920,348,9915,0,ITH,ITH5,8,Emilia-Romagna,Emilia-Romagna,4459477,3785683,84.89,0.23
4870,2021-08-28,EMR,26252,14517,11735,8613,16828,811,ITH,ITH5,8,Emilia-Romagna,Emilia-Romagna,4459477,3811935,85.48,0.59
4871,2021-05-20,EMR,40412,18344,22068,18396,21502,514,ITH,ITH5,8,Emilia-Romagna,Emilia-Romagna,4459477,3852347,86.39,0.91
4872,2021-08-23,EMR,22567,11749,10818,11822,9468,1277,ITH,ITH5,8,Emilia-Romagna,Emilia-Romagna,4459477,3874914,86.89,0.51
4873,2021-06-25,EMR,42864,21812,21052,19770,22317,777,ITH,ITH5,8,Emilia-Romagna,Emilia-Romagna,4459477,3917778,87.85,0.96
4874,2021-03-17,EMR,13731,5699,8032,5818,7855,58,ITH,ITH5,8,Emilia-Romagna,Emilia-Romagna,4459477,3931509,88.16,0.31
4875,2021-08-21,EMR,19070,10670,8400,10425,7761,884,ITH,ITH5,8,Emilia-Romagna,Emilia-Romagna,4459477,3950579,88.59,0.43
4876,2021-07-21,EMR,43685,23301,20384,10785,32277,623,ITH,ITH5,8,Emilia-Romagna,Emilia-Romagna,4459477,3994264,89.57,0.98
4877,2021-04-19,EMR,20920,9804,11116,14336,6284,300,ITH,ITH5,8,Emilia-Romagna,Emilia-Romagna,4459477,4015184,90.04,0.47
4878,2021-01-09,EMR,9993,3458,6535,9989,0,4,ITH,ITH5,8,Emilia-Romagna,Emilia-Romagna,4459477,4025177,90.26,0.22
4879,2021-06-15,EMR,43874,22641,21233,27917,15073,884,ITH,ITH5,8,Emilia-Romagna,Emilia-Romagna,4459477,4069051,91.25,0.98
4880,2021-03-07,EMR,7850,2962,4888,6289,1525,36,ITH,ITH5,8,Emilia-Romagna,Emilia-Romagna,4459477,4076901,91.42,0.18
4881,2021-05-03,EMR,28738,13569,15169,17395,10887,456,ITH,ITH5,8,Emilia-Romagna,Emilia-Romagna,4459477,4105639,92.07,0.64
4882,2021-02-28,EMR,6829,2528,4301,4958,1852,19,ITH,ITH5,8,Emilia-Romagna,Emilia-Romagna,4459477,4112468,92.22,0.15
4883,2021-04-26,EMR,27915,12940,14975,18039,9324,552,ITH,ITH5,8,Emilia-Romagna,Emilia-Romagna,4459477,4140383,92.84,0.63
4884,2021-01-16,EMR,5630,1717,3913,5629,0,1,ITH,ITH5,8,Emilia-Romagna,Emilia-Romagna,4459477,4146013,92.97,0.13
4885,2021-03-14,EMR,8808,3841,4967,4945,3799,64,ITH,ITH5,8,Emilia-Romagna,Emilia-Romagna,4459477,4154821,93.17,0.2
4886,2021-05-13,EMR,35859,16517,19342,27290,7851,718,ITH,ITH5,8,Emilia-Romagna,Emilia-Romagna,4459477,4190680,93.97,0.8
4887,2021-03-15,EMR,13464,6254,7210,6853,6507,104,ITH,ITH5,8,Emilia-Romagna,Emilia-Romagna,4459477,4204144,94.27,0.3
4888,2021-03-31,EMR,25297,11061,14236,19502,5473,322,ITH,ITH5,8,Emilia-Romagna,Emilia-Romagna,4459477,4229441,94.84,0.57
4889,2021-07-13,EMR,48489,24837,23652,6472,41334,683,ITH,ITH5,8,Emilia-Romagna,Emilia-Romagna,4459477,4277930,95.93,1.09
4890,2021-07-04,EMR,24271,12069,12202,10199,13607,465,ITH,ITH5,8,Emilia-Romagna,Emilia-Romagna,4459477,4302201,96.47,0.54
4891,2021-03-26,EMR,23738,10125,13613,17020,6443,275,ITH,ITH5,8,Emilia-Romagna,Emilia-Romagna,4459477,4325939,97.01,0.53
4892,2021-02-09,EMR,4161,1253,2908,2307,1853,1,ITH,ITH5,8,Emilia-Romagna,Emilia-Romagna,4459477,4330100,97.1,0.09
4893,2021-09-01,EMR,22573,12030,10543,7178,14661,734,ITH,ITH5,8,Emilia-Romagna,Emilia-Romagna,4459477,4352673,97.61,0.51
4894,2021-05-15,EMR,33295,14998,18297,22218,10437,640,ITH,ITH5,8,Emilia-Romagna,Emilia-Romagna,4459477,4385968,98.35,0.75
4895,2021-02-04,EMR,9934,3207,6727,1236,8697,1,ITH,ITH5,8,Emilia-Romagna,Emilia-Romagna,4459477,4395902,98.57,0.22
4896,2021-05-22,EMR,33164,14158,19006,16475,16233,456,ITH,ITH5,8,Emilia-Romagna,Emilia-Romagna,4459477,4429066,99.32,0.74
4897,2021-07-18,EMR,34579,17915,16664,8201,25821,557,ITH,ITH5,8,Emilia-Romagna,Emilia-Romagna,4459477,4463645,100.09,0.78
4898,2021-04-09,EMR,25802,11695,14107,19530,5760,512,ITH,ITH5,8,Emilia-Romagna,Emilia-Romagna,4459477,4489447,100.67,0.58
4899,2021-02-02,EMR,9491,3052,6439,526,8964,1,ITH,ITH5,8,Emilia-Romagna,Emilia-Romagna,4459477,4498938,100.88,0.21
4900,2021-08-30,EMR,26977,14162,12815,7620,18342,1015,ITH,ITH5,8,Emilia-Romagna,Emilia-Romagna,4459477,4525915,101.49,0.6
4901,2021-07-23,EMR,40425,21902,18523,19864,19483,1078,ITH,ITH5,8,Emilia-Romagna,Emilia-Romagna,4459477,4566340,102.4,0.91
4902,2021-04-14,EMR,27062,12851,14211,20520,6114,428,ITH,ITH5,8,Emilia-Romagna,Emilia-Romagna,4459477,4593402,103.0,0.61
4903,2021-01-21,EMR,2167,730,1437,819,1348,0,ITH,ITH5,8,Emilia-Romagna,Emilia-Romagna,4459477,4595569,103.05,0.05
4904,2021-08-02,EMR,38518,20352,18166,14752,23090,676,ITH,ITH5,8,Emilia-Romagna,Emilia-Romagna,4459477,4634087,103.92,0.86
4905,2021-04-24,EMR,28655,13251,15404,14065,14242,348,ITH,ITH5,8,Emilia-Romagna,Emilia-Romagna,4459477,4662742,104.56,0.64
4906,2021-05-11,EMR,35818,16805,19013,27866,7262,690,ITH,ITH5,8,Emilia-Romagna,Emilia-Romagna,4459477,4698560,105.36,0.8
4907,2021-01-31,EMR,7709,2771,4938,240,7469,0,ITH,ITH5,8,Emilia-Romagna,Emilia-Romagna,4459477,4706269,105.53,0.17
4908,2021-06-03,EMR,37934,18443,19491,29703,7559,672,ITH,ITH5,8,Emilia-Romagna,Emilia-Romagna,4459477,4744203,106.38,0.85
4909,2021-02-23,EMR,8217,3219,4998,7819,386,12,ITH,ITH5,8,Emilia-Romagna,Emilia-Romagna,4459477,4752420,106.57,0.18
4910,2021-03-12,EMR,18324,7709,10615,11310,6720,294,ITH,ITH5,8,Emilia-Romagna,Emilia-Romagna,4459477,4770744,106.98,0.41
4911,2021-02-12,EMR,5329,1678,3651,3899,1407,23,ITH,ITH5,8,Emilia-Romagna,Emilia-Romagna,4459477,4776073,107.1,0.12
4912,2021-04-10,EMR,20937,9304,11633,16455,4148,334,ITH,ITH5,8,Emilia-Romagna,Emilia-Romagna,4459477,4797010,107.57,0.47
4913,2021-04-17,EMR,27320,13084,14236,17575,9354,391,ITH,ITH5,8,Emilia-Romagna,Emilia-Romagna,4459477,4824330,108.18,0.61
4914,2021-01-07,EMR,10289,3406,6883,10285,0,4,ITH,ITH5,8,Emilia-Romagna,Emilia-Romagna,4459477,4834619,108.41,0.23
4915,2021-04-03,EMR,20001,8786,11215,15957,3800,244,ITH,ITH5,8,Emilia-Romagna,Emilia-Romagna,4459477,4854620,108.86,0.45
4916,2021-05-30,EMR,27101,12807,14294,12984,13712,405,ITH,ITH5,8,Emilia-Romagna,Emilia-Romagna,4459477,4881721,109.47,0.61
4917,2021-02-19,EMR,7328,3010,4318,6800,514,14,ITH,ITH5,8,Emilia-Romagna,Emilia-Romagna,4459477,4889049,109.63,0.16
4918,2021-07-26,EMR,39557,21093,18464,15906,22877,774,ITH,ITH5,8,Emilia-Romagna,Emilia-Romagna,4459477,4928606,110.52,0.89
4919,2020-12-31,EMR,2212,778,1434,2211,0,1,ITH,ITH5,8,Emilia-Romagna,Emilia-Romagna,4459477,4930818,110.57,0.05
4920,2021-06-06,EMR,36602,19001,17601,31558,4415,629,ITH,ITH5,8,Emilia-Romagna,Emilia-Romagna,4459477,4967420,111.39,0.82
4921,2021-02-26,EMR,9643,3677,5966,8564,1054,25,ITH,ITH5,8,Emilia-Romagna,Emilia-Romagna,4459477,4977063,111.61,0.22
4922,2021-08-06,EMR,34649,18583,16066,18775,14986,888,ITH,ITH5,8,Emilia-Romagna,Emilia-Romagna,4459477,5011712,112.38,0.78
4923,2021-04-28,EMR,33752,15604,18148,20263,12899,590,ITH,ITH5,8,Emilia-Romagna,Emilia-Romagna,4459477,5045464,113.14,0.76
4924,2021-06-24,EMR,40649,20415,20234,20315,19569,765,ITH,ITH5,8,Emilia-Romagna,Emilia-Romagna,4459477,5086113,114.05,0.91
4925,2021-08-20,EMR,19689,10723,8966,10238,8505,946,ITH,ITH5,8,Emilia-Romagna,Emilia-Romagna,4459477,5105802,114.49,0.44
4926,2021-06-17,EMR,46707,23666,23041,21816,24225,666,ITH,ITH5,8,Emilia-Romagna,Emilia-Romagna,4459477,5152509,115.54,1.05
4927,2021-08-13,EMR,21246,11793,9453,14262,6083,901,ITH,ITH5,8,Emilia-Romagna,Emilia-Romagna,4459477,5173755,116.02,0.48
4928,2021-06-29,EMR,37729,18607,19122,18149,18796,784,ITH,ITH5,8,Emilia-Romagna,Emilia-Romagna,4459477,5211484,116.86,0.85
4929,2021-03-21,EMR,11959,5296,6663,7260,4606,93,ITH,ITH5,8,Emilia-Romagna,Emilia-Romagna,4459477,5223443,117.13,0.27
4930,2021-06-10,EMR,45101,23168,21933,38703,5386,1012,ITH,ITH5,8,Emilia-Romagna,Emilia-Romagna,4459477,5268544,118.14,1.01
4931,2021-03-02,EMR,12663,4273,8390,10513,2092,58,ITH,ITH5,8,Emilia-Romagna,Emilia-Romagna,4459477,5281207,118.43,0.28
4932,2021-03-19,EMR,15923,6970,8953,7791,7971,161,ITH,ITH5,8,Emilia-Romagna,Emilia-Romagna,4459477,5297130,118.78,0.36
4933,2021-04-07,EMR,26890,12306,14584,20464,6079,347,ITH,ITH5,8,Emilia-Romagna,Emilia-Romagna,4459477,5324020,119.39,0.6
4934,2021-01-14,EMR,8129,2595,5534,8120,0,9,ITH,ITH5,8,Emilia-Romagna,Emilia-Romagna,4459477,5332149,119.57,0.18
4935,2021-08-26,EMR,27574,14715,12859,9361,17281,932,ITH,ITH5,8,Emilia-Romagna,Emilia-Romagna,4459477,5359723,120.19,0.62
4936,2021-06-04,EMR,45760,23027,22733,36846,8201,713,ITH,ITH5,8,Emilia-Romagna,Emilia-Romagna,4459477,5405483,121.21,1.03
4937,2021-01-20,EMR,1331,269,1062,1329,1,1,ITH,ITH5,8,Emilia-Romagna,Emilia-Romagna,4459477,5406814,121.24,0.03
4938,2021-07-24,EMR,38869,20962,17907,17334,20629,906,ITH,ITH5,8,Emilia-Romagna,Emilia-Romagna,4459477,5445683,122.11,0.87
4939,2021-04-15,EMR,29367,13986,15381,19243,9682,442,ITH,ITH5,8,Emilia-Romagna,Emilia-Romagna,4459477,5475050,122.77,0.66
4940,2021-06-18,EMR,42788,21454,21334,16300,25928,560,ITH,ITH5,8,Emilia-Romagna,Emilia-Romagna,4459477,5517838,123.73,0.96
4941,2021-03-10,EMR,18811,7742,11069,12982,5647,182,ITH,ITH5,8,Emilia-Romagna,Emilia-Romagna,4459477,5536649,124.15,0.42
4942,2021-05-18,EMR,29235,13281,15954,18100,10646,489,ITH,ITH5,8,Emilia-Romagna,Emilia-Romagna,4459477,5565884,124.81,0.66
4943,2021-02-07,EMR,4791,1537,3254,1724,3065,2,ITH,ITH5,8,Emilia-Romagna,Emilia-Romagna,4459477,5570675,124.92,0.11
4944,2021-02-24,EMR,9360,3568,5792,8454,890,16,ITH,ITH5,8,Emilia-Romagna,Emilia-Romagna,4459477,5580035,125.13,0.21
4945,2021-01-05,EMR,9365,3171,6194,9361,0,4,ITH,ITH5,8,Emilia-Romagna,Emilia-Romagna,4459477,5589400,125.34,0.21
4946,2021-04-29,EMR,44991,21152,23839,26608,17564,819,ITH,ITH5,8,Emilia-Romagna,Emilia-Romagna,4459477,5634391,126.35,1.01
4947,2021-01-19,EMR,2050,507,1543,2032,17,1,ITH,ITH5,8,Emilia-Romagna,Emilia-Romagna,4459477,5636441,126.39,0.05
4948,2021-07-07,EMR,37912,19146,18766,13407,23711,794,ITH,ITH5,8,Emilia-Romagna,Emilia-Romagna,4459477,5674353,127.24,0.85
4949,2021-03-29,EMR,21446,9627,11819,16541,4663,242,ITH,ITH5,8,Emilia-Romagna,Emilia-Romagna,4459477,5695799,127.72,0.48
4950,2021-02-21,EMR,4447,1705,2742,3997,440,10,ITH,ITH5,8,Emilia-Romagna,Emilia-Romagna,4459477,5700246,127.82,0.1
4951,2021-07-25,EMR,28472,15177,13295,10567,17439,466,ITH,ITH5,8,Emilia-Romagna,Emilia-Romagna,4459477,5728718,128.46,0.64
4952,2021-08-11,EMR,27738,14868,12870,12065,14872,801,ITH,ITH5,8,Emilia-Romagna,Emilia-Romagna,4459477,5756456,129.08,0.62
4953,2021-08-25,EMR,25105,13527,11578,9569,14592,944,ITH,ITH5,8,Emilia-Romagna,Emilia-Romagna,4459477,5781561,129.65,0.56
4954,2021-01-02,EMR,2379,917,1462,2379,0,0,ITH,ITH5,8,Emilia-Romagna,Emilia-Romagna,4459477,5783940,129.7,0.05
4955,2021-06-05,EMR,44319,22381,21938,36635,6923,761,ITH,ITH5,8,Emilia-Romagna,Emilia-Romagna,4459477,5828259,130.69,0.99
4956,2021-06-22,EMR,36542,18199,18343,16295,19637,610,ITH,ITH5,8,Emilia-Romagna,Emilia-Romagna,4459477,5864801,131.51,0.82
4957,2021-07-06,EMR,36813,18509,18304,12941,23197,675,ITH,ITH5,8,Emilia-Romagna,Emilia-Romagna,4459477,5901614,132.34,0.83
4958,2021-05-17,EMR,32480,15416,17064,22335,9562,583,ITH,ITH5,8,Emilia-Romagna,Emilia-Romagna,4459477,5934094,133.07,0.73
4959,2021-03-24,MOL,1635,658,977,1213,402,20,ITF,ITF2,14,Molise,Molise,305617,1635,0.53,0.53
4960,2021-07-02,MOL,2695,1307,1388,137,2549,9,ITF,ITF2,14,Molise,Molise,305617,4330,1.42,0.88
4961,2021-07-04,MOL,2156,1089,1067,581,1552,23,ITF,ITF2,14,Molise,Molise,305617,6486,2.12,0.71
4962,2021-08-11,MOL,2022,1057,965,1149,815,58,ITF,ITF2,14,Molise,Molise,305617,8508,2.78,0.66
4963,2021-01-12,MOL,336,114,222,336,0,0,ITF,ITF2,14,Molise,Molise,305617,8844,2.89,0.11
4964,2021-07-14,MOL,3418,1673,1745,204,3197,17,ITF,ITF2,14,Molise,Molise,305617,12262,4.01,1.12
4965,2021-04-05,MOL,391,189,202,292,99,0,ITF,ITF2,14,Molise,Molise,305617,12653,4.14,0.13
4966,2021-03-29,MOL,2039,836,1203,1518,489,32,ITF,ITF2,14,Molise,Molise,305617,14692,4.81,0.67
4967,2021-01-31,MOL,268,70,198,6,262,0,ITF,ITF2,14,Molise,Molise,305617,14960,4.9,0.09
4968,2021-08-23,MOL,1721,932,789,270,1438,13,ITF,ITF2,14,Molise,Molise,305617,16681,5.46,0.56
4969,2021-02-19,MOL,171,95,76,169,2,0,ITF,ITF2,14,Molise,Molise,305617,16852,5.51,0.06
4970,2021-03-10,MOL,1745,722,1023,1673,50,22,ITF,ITF2,14,Molise,Molise,305617,18597,6.09,0.57
4971,2021-06-01,MOL,2618,1331,1287,2469,110,39,ITF,ITF2,14,Molise,Molise,305617,21215,6.94,0.86
4972,2021-01-26,MOL,450,184,266,8,442,0,ITF,ITF2,14,Molise,Molise,305617,21665,7.09,0.15
4973,2021-05-06,MOL,2702,1222,1480,2050,607,45,ITF,ITF2,14,Molise,Molise,305617,24367,7.97,0.88
4974,2021-07-28,MOL,2444,1295,1149,1145,1267,32,ITF,ITF2,14,Molise,Molise,305617,26811,8.77,0.8
4975,2021-06-27,MOL,2379,1127,1252,1136,1232,11,ITF,ITF2,14,Molise,Molise,305617,29190,9.55,0.78
4976,2021-01-07,MOL,600,209,391,600,0,0,ITF,ITF2,14,Molise,Molise,305617,29790,9.75,0.2
4977,2021-02-12,MOL,337,152,185,212,124,1,ITF,ITF2,14,Molise,Molise,305617,30127,9.86,0.11
4978,2021-02-07,MOL,67,32,35,20,47,0,ITF,ITF2,14,Molise,Molise,305617,30194,9.88,0.02
4979,2021-05-18,MOL,1663,887,776,998,658,7,ITF,ITF2,14,Molise,Molise,305617,31857,10.42,0.54
4980,2021-03-22,MOL,1154,443,711,892,245,17,ITF,ITF2,14,Molise,Molise,305617,33011,10.8,0.38
4981,2021-07-23,MOL,2920,1520,1400,874,1992,54,ITF,ITF2,14,Molise,Molise,305617,35931,11.76,0.96
4982,2021-08-28,MOL,1723,959,764,643,1064,16,ITF,ITF2,14,Molise,Molise,305617,37654,12.32,0.56
4983,2021-05-01,MOL,2654,1272,1382,407,2228,19,ITF,ITF2,14,Molise,Molise,305617,40308,13.19,0.87
4984,2021-03-05,MOL,1229,654,575,1007,209,13,ITF,ITF2,14,Molise,Molise,305617,41537,13.59,0.4
4985,2021-08-09,MOL,3440,1779,1661,1632,1759,49,ITF,ITF2,14,Molise,Molise,305617,44977,14.72,1.13
4986,2021-06-13,MOL,2916,1554,1362,2549,328,39,ITF,ITF2,14,Molise,Molise,305617,47893,15.67,0.95
4987,2021-04-17,MOL,3065,1507,1558,1544,1493,28,ITF,ITF2,14,Molise,Molise,305617,50958,16.67,1.0
4988,2021-02-24,MOL,671,281,390,326,337,8,ITF,ITF2,14,Molise,Molise,305617,51629,16.89,0.22
4989,2021-01-17,MOL,78,38,40,48,30,0,ITF,ITF2,14,Molise,Molise,305617,51707,16.92,0.03
4990,2021-04-10,MOL,2647,1264,1383,2456,152,39,ITF,ITF2,14,Molise,Molise,305617,54354,17.79,0.87
4991,2021-02-05,MOL,596,270,326,55,541,0,ITF,ITF2,14,Molise,Molise,305617,54950,17.98,0.2
4992,2021-01-19,MOL,174,63,111,163,11,0,ITF,ITF2,14,Molise,Molise,305617,55124,18.04,0.06
4993,2021-04-29,MOL,2244,1148,1096,878,1351,15,ITF,ITF2,14,Molise,Molise,305617,57368,18.77,0.73
4994,2021-04-12,MOL,1300,557,743,1038,251,11,ITF,ITF2,14,Molise,Molise,305617,58668,19.2,0.43
4995,2021-07-21,MOL,2087,1047,1040,789,1255,43,ITF,ITF2,14,Molise,Molise,305617,60755,19.88,0.68
4996,2021-08-16,MOL,1783,924,859,826,941,16,ITF,ITF2,14,Molise,Molise,305617,62538,20.46,0.58
4997,2021-03-15,MOL,834,340,494,570,245,19,ITF,ITF2,14,Molise,Molise,305617,63372,20.74,0.27
4998,2021-05-13,MOL,3052,1418,1634,2538,460,54,ITF,ITF2,14,Molise,Molise,305617,66424,21.73,1.0
4999,2021-08-21,MOL,2135,1203,932,1080,1014,41,ITF,ITF2,14,Molise,Molise,305617,68559,22.43,0.7
5000,2021-08-04,MOL,2518,1305,1213,959,1541,18,ITF,ITF2,14,Molise,Molise,305617,71077,23.26,0.82
5001,2021-04-28,MOL,1700,927,773,473,1220,7,ITF,ITF2,14,Molise,Molise,305617,72777,23.81,0.56
5002,2021-07-16,MOL,3075,1558,1517,386,2661,28,ITF,ITF2,14,Molise,Molise,305617,75852,24.82,1.01
5003,2021-07-09,MOL,3445,1655,1790,167,3260,18,ITF,ITF2,14,Molise,Molise,305617,79297,25.95,1.13
5004,2021-03-17,MOL,914,386,528,521,333,60,ITF,ITF2,14,Molise,Molise,305617,80211,26.25,0.3
5005,2021-06-25,MOL,3449,1696,1753,1474,1917,58,ITF,ITF2,14,Molise,Molise,305617,83660,27.37,1.13
5006,2021-06-08,MOL,2900,1601,1299,2201,696,3,ITF,ITF2,14,Molise,Molise,305617,86560,28.32,0.95
5007,2021-05-20,MOL,2680,1382,1298,2407,189,84,ITF,ITF2,14,Molise,Molise,305617,89240,29.2,0.88
5008,2021-05-25,MOL,1973,890,1083,1305,632,36,ITF,ITF2,14,Molise,Molise,305617,91213,29.85,0.65
5009,2021-01-04,MOL,314,131,183,314,0,0,ITF,ITF2,14,Molise,Molise,305617,91527,29.95,0.1
5010,2021-06-20,MOL,423,174,249,48,371,4,ITF,ITF2,14,Molise,Molise,305617,91950,30.09,0.14
5011,2021-04-24,MOL,2561,1208,1353,699,1847,15,ITF,ITF2,14,Molise,Molise,305617,94511,30.92,0.84
5012,2021-02-26,MOL,564,261,303,490,73,1,ITF,ITF2,14,Molise,Molise,305617,95075,31.11,0.18
5013,2021-08-02,MOL,2705,1411,1294,1194,1467,44,ITF,ITF2,14,Molise,Molise,305617,97780,31.99,0.89
5014,2021-06-06,MOL,2095,1079,1016,1751,325,19,ITF,ITF2,14,Molise,Molise,305617,99875,32.68,0.69
5015,2021-03-19,MOL,1188,484,704,743,428,17,ITF,ITF2,14,Molise,Molise,305617,101063,33.07,0.39
5016,2021-01-21,MOL,6,2,4,6,0,0,ITF,ITF2,14,Molise,Molise,305617,101069,33.07,0.0
5017,2021-03-03,MOL,675,319,356,588,82,5,ITF,ITF2,14,Molise,Molise,305617,101744,33.29,0.22
5018,2021-01-05,MOL,449,180,269,449,0,0,ITF,ITF2,14,Molise,Molise,305617,102193,33.44,0.15
5019,2021-07-06,MOL,3069,1431,1638,38,3027,4,ITF,ITF2,14,Molise,Molise,305617,105262,34.44,1.0
5020,2021-05-10,MOL,2910,1294,1616,2501,373,36,ITF,ITF2,14,Molise,Molise,305617,108172,35.39,0.95
5021,2021-06-29,MOL,2502,1164,1338,382,2089,31,ITF,ITF2,14,Molise,Molise,305617,110674,36.21,0.82
5022,2021-05-03,MOL,2507,1180,1327,2303,163,41,ITF,ITF2,14,Molise,Molise,305617,113181,37.03,0.82
5023,2021-03-07,MOL,1133,501,632,1128,2,3,ITF,ITF2,14,Molise,Molise,305617,114314,37.4,0.37
5024,2021-06-15,MOL,2240,1053,1187,766,1457,17,ITF,ITF2,14,Molise,Molise,305617,116554,38.14,0.73
5025,2021-06-17,MOL,2315,1022,1293,916,1371,28,ITF,ITF2,14,Molise,Molise,305617,118869,38.89,0.76
5026,2021-08-30,MOL,1693,911,782,229,1446,18,ITF,ITF2,14,Molise,Molise,305617,120562,39.45,0.55
5027,2021-06-24,MOL,3346,1557,1789,440,2868,38,ITF,ITF2,14,Molise,Molise,305617,123908,40.54,1.09
5028,2021-03-02,MOL,671,385,286,507,158,6,ITF,ITF2,14,Molise,Molise,305617,124579,40.76,0.22
5029,2021-06-10,MOL,2604,1196,1408,1259,1301,44,ITF,ITF2,14,Molise,Molise,305617,127183,41.62,0.85
5030,2021-04-02,MOL,1465,714,751,663,781,21,ITF,ITF2,14,Molise,Molise,305617,128648,42.09,0.48
5031,2021-07-11,MOL,2461,1199,1262,181,2276,4,ITF,ITF2,14,Molise,Molise,305617,131109,42.9,0.81
5032,2021-08-06,MOL,2327,1229,1098,1081,1204,42,ITF,ITF2,14,Molise,Molise,305617,133436,43.66,0.76
5033,2021-02-21,MOL,576,227,349,574,2,0,ITF,ITF2,14,Molise,Molise,305617,134012,43.85,0.19
5034,2021-02-04,MOL,762,296,466,78,684,0,ITF,ITF2,14,Molise,Molise,305617,134774,44.1,0.25
5035,2021-05-15,MOL,2992,1406,1586,2551,387,54,ITF,ITF2,14,Molise,Molise,305617,137766,45.08,0.98
5036,2021-03-31,MOL,2200,920,1280,1309,820,71,ITF,ITF2,14,Molise,Molise,305617,139966,45.8,0.72
5037,2021-04-14,MOL,1812,769,1043,1136,665,11,ITF,ITF2,14,Molise,Molise,305617,141778,46.39,0.59
5038,2021-02-16,MOL,158,72,86,151,6,1,ITF,ITF2,14,Molise,Molise,305617,141936,46.44,0.05
5039,2021-05-27,MOL,2848,1354,1494,1971,841,36,ITF,ITF2,14,Molise,Molise,305617,144784,47.37,0.93
5040,2021-07-25,MOL,2015,1064,951,356,1644,15,ITF,ITF2,14,Molise,Molise,305617,146799,48.03,0.66
5041,2021-05-29,MOL,2372,1235,1137,1938,393,41,ITF,ITF2,14,Molise,Molise,305617,149171,48.81,0.78
5042,2021-02-09,MOL,360,170,190,197,163,0,ITF,ITF2,14,Molise,Molise,305617,149531,48.93,0.12
5043,2021-08-01,MOL,962,527,435,756,175,31,ITF,ITF2,14,Molise,Molise,305617,150493,49.24,0.31
5044,2021-08-03,MOL,2204,1145,1059,1218,952,34,ITF,ITF2,14,Molise,Molise,305617,152697,49.96,0.72
5045,2021-08-13,MOL,1536,799,737,1123,384,29,ITF,ITF2,14,Molise,Molise,305617,154233,50.47,0.5
5046,2021-05-08,MOL,2993,1460,1533,1706,1249,38,ITF,ITF2,14,Molise,Molise,305617,157226,51.45,0.98
5047,2021-04-21,MOL,1880,796,1084,970,903,7,ITF,ITF2,14,Molise,Molise,305617,159106,52.06,0.62
5048,2021-07-30,MOL,2687,1392,1295,1439,1192,56,ITF,ITF2,14,Molise,Molise,305617,161793,52.94,0.88
5049,2021-02-11,MOL,295,133,162,258,37,0,ITF,ITF2,14,Molise,Molise,305617,162088,53.04,0.1
5050,2021-05-22,MOL,2291,1187,1104,2183,88,20,ITF,ITF2,14,Molise,Molise,305617,164379,53.79,0.75
5051,2021-08-20,MOL,2457,1293,1164,504,1935,18,ITF,ITF2,14,Molise,Molise,305617,166836,54.59,0.8
5052,2021-01-28,MOL,615,217,398,17,598,0,ITF,ITF2,14,Molise,Molise,305617,167451,54.79,0.2
5053,2021-03-11,MOL,1472,641,831,1451,6,15,ITF,ITF2,14,Molise,Molise,305617,168923,55.27,0.48
5054,2021-01-06,MOL,690,260,430,690,0,0,ITF,ITF2,14,Molise,Molise,305617,169613,55.5,0.23
5055,2021-04-16,MOL,2435,1035,1400,1178,1234,23,ITF,ITF2,14,Molise,Molise,305617,172048,56.3,0.8
5056,2021-06-21,MOL,2927,1362,1565,1643,1237,47,ITF,ITF2,14,Molise,Molise,305617,174975,57.25,0.96
5057,2021-04-25,MOL,794,397,397,557,233,4,ITF,ITF2,14,Molise,Molise,305617,175769,57.51,0.26
5058,2021-02-02,MOL,540,176,364,216,323,1,ITF,ITF2,14,Molise,Molise,305617,176309,57.69,0.18
5059,2021-01-16,MOL,422,166,256,422,0,0,ITF,ITF2,14,Molise,Molise,305617,176731,57.83,0.14
5060,2021-04-26,MOL,1160,522,638,811,331,18,ITF,ITF2,14,Molise,Molise,305617,177891,58.21,0.38
5061,2021-04-09,MOL,2331,1254,1077,2108,191,32,ITF,ITF2,14,Molise,Molise,305617,180222,58.97,0.76
5062,2021-01-18,MOL,115,48,67,115,0,0,ITF,ITF2,14,Molise,Molise,305617,180337,59.01,0.04
5063,2021-03-26,MOL,2586,1046,1540,1893,645,48,ITF,ITF2,14,Molise,Molise,305617,182923,59.85,0.85
5064,2021-02-18,MOL,321,74,247,304,13,4,ITF,ITF2,14,Molise,Molise,305617,183244,59.96,0.11
5065,2021-03-09,MOL,1334,582,752,1152,154,28,ITF,ITF2,14,Molise,Molise,305617,184578,60.4,0.44
5066,2021-02-20,MOL,1020,443,577,1000,20,0,ITF,ITF2,14,Molise,Molise,305617,185598,60.73,0.33
5067,2021-05-31,MOL,2378,1156,1222,1907,427,44,ITF,ITF2,14,Molise,Molise,305617,187976,61.51,0.78
5068,2021-05-17,MOL,2232,1094,1138,1708,496,28,ITF,ITF2,14,Molise,Molise,305617,190208,62.24,0.73
5069,2021-03-21,MOL,1251,544,707,480,769,2,ITF,ITF2,14,Molise,Molise,305617,191459,62.65,0.41
5070,2021-08-25,MOL,734,370,364,186,543,5,ITF,ITF2,14,Molise,Molise,305617,192193,62.89,0.24
5071,2021-03-14,MOL,600,241,359,18,582,0,ITF,ITF2,14,Molise,Molise,305617,192793,63.08,0.2
5072,2021-08-18,MOL,1346,706,640,343,981,22,ITF,ITF2,14,Molise,Molise,305617,194139,63.52,0.44
5073,2021-06-22,MOL,2972,1372,1600,672,2280,20,ITF,ITF2,14,Molise,Molise,305617,197111,64.5,0.97
5074,2021-02-23,MOL,585,223,362,362,221,2,ITF,ITF2,14,Molise,Molise,305617,197696,64.69,0.19
5075,2021-06-03,MOL,3313,1578,1735,2713,560,40,ITF,ITF2,14,Molise,Molise,305617,201009,65.77,1.08
5076,2021-04-07,MOL,1692,849,843,1371,275,46,ITF,ITF2,14,Molise,Molise,305617,202701,66.33,0.55
5077,2021-06-05,MOL,3021,1527,1494,2816,175,30,ITF,ITF2,14,Molise,Molise,305617,205722,67.31,0.99
5078,2021-07-18,MOL,1769,890,879,126,1634,9,ITF,ITF2,14,Molise,Molise,305617,207491,67.89,0.58
5079,2021-03-12,MOL,1467,640,827,1407,36,24,ITF,ITF2,14,Molise,Molise,305617,208958,68.37,0.48
5080,2021-01-14,MOL,649,240,409,649,0,0,ITF,ITF2,14,Molise,Molise,305617,209607,68.58,0.21
5081,2021-05-14,MOL,2653,1220,1433,1894,722,37,ITF,ITF2,14,Molise,Molise,305617,212260,69.45,0.87
5082,2021-08-22,MOL,389,202,187,3,386,0,ITF,ITF2,14,Molise,Molise,305617,212649,69.58,0.13
5083,2021-06-02,MOL,2825,1366,1459,2698,100,27,ITF,ITF2,14,Molise,Molise,305617,215474,70.5,0.92
5084,2021-04-11,MOL,1200,594,606,1167,14,19,ITF,ITF2,14,Molise,Molise,305617,216674,70.9,0.39
5085,2021-07-20,MOL,2178,1101,1077,1017,1114,47,ITF,ITF2,14,Molise,Molise,305617,218852,71.61,0.71
5086,2021-07-03,MOL,2748,1383,1365,571,2157,20,ITF,ITF2,14,Molise,Molise,305617,221600,72.51,0.9
5087,2021-08-08,MOL,890,466,424,648,227,15,ITF,ITF2,14,Molise,Molise,305617,222490,72.8,0.29
5088,2021-07-22,MOL,2222,1099,1123,842,1325,55,ITF,ITF2,14,Molise,Molise,305617,224712,73.53,0.73
5089,2021-01-13,MOL,480,163,317,480,0,0,ITF,ITF2,14,Molise,Molise,305617,225192,73.68,0.16
5090,2021-06-19,MOL,2361,1175,1186,1292,1023,46,ITF,ITF2,14,Molise,Molise,305617,227553,74.46,0.77
5091,2021-04-23,MOL,2061,888,1173,1379,663,19,ITF,ITF2,14,Molise,Molise,305617,229614,75.13,0.67
5092,2021-08-26,MOL,1723,934,789,307,1410,6,ITF,ITF2,14,Molise,Molise,305617,231337,75.7,0.56
5093,2021-06-30,MOL,2974,1414,1560,878,2012,84,ITF,ITF2,14,Molise,Molise,305617,234311,76.67,0.97
5094,2021-03-13,MOL,1192,597,595,184,990,18,ITF,ITF2,14,Molise,Molise,305617,235503,77.06,0.39
5095,2021-01-15,MOL,541,243,298,541,0,0,ITF,ITF2,14,Molise,Molise,305617,236044,77.24,0.18
5096,2021-03-28,MOL,1629,749,880,519,1103,7,ITF,ITF2,14,Molise,Molise,305617,237673,77.77,0.53
5097,2021-01-30,MOL,465,161,304,12,453,0,ITF,ITF2,14,Molise,Molise,305617,238138,77.92,0.15
5098,2021-02-06,MOL,431,179,252,30,401,0,ITF,ITF2,14,Molise,Molise,305617,238569,78.06,0.14
5099,2021-03-16,MOL,615,230,385,265,348,2,ITF,ITF2,14,Molise,Molise,305617,239184,78.26,0.2
5100,2021-01-11,MOL,558,194,364,558,0,0,ITF,ITF2,14,Molise,Molise,305617,239742,78.45,0.18
5101,2021-07-29,MOL,2459,1260,1199,1593,820,46,ITF,ITF2,14,Molise,Molise,305617,242201,79.25,0.8
5102,2021-01-25,MOL,319,130,189,3,316,0,ITF,ITF2,14,Molise,Molise,305617,242520,79.35,0.1
5103,2021-07-19,MOL,2782,1358,1424,507,2248,27,ITF,ITF2,14,Molise,Molise,305617,245302,80.26,0.91
5104,2021-02-03,MOL,745,254,491,344,401,0,ITF,ITF2,14,Molise,Molise,305617,246047,80.51,0.24
5105,2021-04-27,MOL,1601,771,830,445,1131,25,ITF,ITF2,14,Molise,Molise,305617,247648,81.03,0.52
5106,2021-08-05,MOL,2286,1157,1129,1614,623,49,ITF,ITF2,14,Molise,Molise,305617,249934,81.78,0.75
5107,2021-05-16,MOL,1259,577,682,1053,184,22,ITF,ITF2,14,Molise,Molise,305617,251193,82.19,0.41
5108,2021-08-24,MOL,1651,892,759,230,1399,22,ITF,ITF2,14,Molise,Molise,305617,252844,82.73,0.54
5109,2021-08-07,MOL,1926,1064,862,1050,848,28,ITF,ITF2,14,Molise,Molise,305617,254770,83.36,0.63
5110,2021-03-04,MOL,852,417,435,515,325,12,ITF,ITF2,14,Molise,Molise,305617,255622,83.64,0.28
5111,2021-06-12,MOL,5948,3058,2890,5661,203,84,ITF,ITF2,14,Molise,Molise,305617,261570,85.59,1.95
5112,2021-08-17,MOL,1666,878,788,341,1310,15,ITF,ITF2,14,Molise,Molise,305617,263236,86.13,0.55
5113,2021-06-14,MOL,1647,818,829,547,1083,17,ITF,ITF2,14,Molise,Molise,305617,264883,86.67,0.54
5114,2021-06-04,MOL,3083,1516,1567,2591,458,34,ITF,ITF2,14,Molise,Molise,305617,267966,87.68,1.01
5115,2021-04-08,MOL,1775,908,867,1545,203,27,ITF,ITF2,14,Molise,Molise,305617,269741,88.26,0.58
5116,2021-07-17,MOL,2858,1525,1333,293,2543,22,ITF,ITF2,14,Molise,Molise,305617,272599,89.2,0.94
5117,2021-04-22,MOL,1850,867,983,1061,779,10,ITF,ITF2,14,Molise,Molise,305617,274449,89.8,0.61
5118,2021-07-31,MOL,1997,1115,882,760,1196,41,ITF,ITF2,14,Molise,Molise,305617,276446,90.46,0.65
5119,2021-02-17,MOL,72,32,40,50,15,7,ITF,ITF2,14,Molise,Molise,305617,276518,90.48,0.02
5120,2021-07-24,MOL,3140,1688,1452,731,2379,30,ITF,ITF2,14,Molise,Molise,305617,279658,91.51,1.03
5121,2021-05-28,MOL,2664,1371,1293,2046,547,71,ITF,ITF2,14,Molise,Molise,305617,282322,92.38,0.87
5122,2021-06-11,MOL,3466,1666,1800,1986,1433,47,ITF,ITF2,14,Molise,Molise,305617,285788,93.51,1.13
5123,2021-04-15,MOL,1941,801,1140,1086,849,6,ITF,ITF2,14,Molise,Molise,305617,287729,94.15,0.64
5124,2021-01-20,MOL,18,8,10,18,0,0,ITF,ITF2,14,Molise,Molise,305617,287747,94.15,0.01
5125,2021-04-30,MOL,2952,1564,1388,821,2116,15,ITF,ITF2,14,Molise,Molise,305617,290699,95.12,0.97
5126,2021-02-25,MOL,543,239,304,471,69,3,ITF,ITF2,14,Molise,Molise,305617,291242,95.3,0.18
5127,2021-08-10,MOL,1926,1046,880,687,1207,32,ITF,ITF2,14,Molise,Molise,305617,293168,95.93,0.63
5128,2021-06-23,MOL,2801,1290,1511,222,2569,10,ITF,ITF2,14,Molise,Molise,305617,295969,96.84,0.92
5129,2021-03-20,MOL,2332,975,1357,998,1323,11,ITF,ITF2,14,Molise,Molise,305617,298301,97.61,0.76
5130,2021-06-28,MOL,2923,1362,1561,1009,1891,23,ITF,ITF2,14,Molise,Molise,305617,301224,98.56,0.96
5131,2021-08-12,MOL,1465,761,704,1027,400,38,ITF,ITF2,14,Molise,Molise,305617,302689,99.04,0.48
5132,2021-01-29,MOL,424,137,287,6,418,0,ITF,ITF2,14,Molise,Molise,305617,303113,99.18,0.14
5133,2021-05-09,MOL,2066,941,1125,1932,98,36,ITF,ITF2,14,Molise,Molise,305617,305179,99.86,0.68
5134,2021-07-07,MOL,2962,1370,1592,57,2901,4,ITF,ITF2,14,Molise,Molise,305617,308141,100.83,0.97
5135,2021-05-11,MOL,3231,1424,1807,2915,254,62,ITF,ITF2,14,Molise,Molise,305617,311372,101.88,1.06
5136,2021-08-19,MOL,2281,1145,1136,606,1648,27,ITF,ITF2,14,Molise,Molise,305617,313653,102.63,0.75
5137,2021-01-22,MOL,128,36,92,128,0,0,ITF,ITF2,14,Molise,Molise,305617,313781,102.67,0.04
5138,2021-05-02,MOL,1901,935,966,580,1308,13,ITF,ITF2,14,Molise,Molise,305617,315682,103.29,0.62
5139,2021-03-06,MOL,1728,807,921,1559,159,10,ITF,ITF2,14,Molise,Molise,305617,317410,103.86,0.57
5140,2021-05-05,MOL,2471,1060,1411,2295,144,32,ITF,ITF2,14,Molise,Molise,305617,319881,104.67,0.81
5141,2021-05-04,MOL,2717,1184,1533,2552,128,37,ITF,ITF2,14,Molise,Molise,305617,322598,105.56,0.89
5142,2021-01-10,MOL,270,72,198,270,0,0,ITF,ITF2,14,Molise,Molise,305617,322868,105.64,0.09
5143,2021-04-20,MOL,2331,1033,1298,1213,1109,9,ITF,ITF2,14,Molise,Molise,305617,325199,106.41,0.76
5144,2021-06-09,MOL,1816,912,904,859,928,29,ITF,ITF2,14,Molise,Molise,305617,327015,107.0,0.59
5145,2021-05-23,MOL,1786,898,888,1745,9,32,ITF,ITF2,14,Molise,Molise,305617,328801,107.59,0.58
5146,2021-08-31,MOL,1545,835,710,266,1269,10,ITF,ITF2,14,Molise,Molise,305617,330346,108.09,0.51
5147,2021-03-01,MOL,663,274,389,431,215,17,ITF,ITF2,14,Molise,Molise,305617,331009,108.31,0.22
5148,2021-04-03,MOL,1779,856,923,1722,36,21,ITF,ITF2,14,Molise,Molise,305617,332788,108.89,0.58
5149,2021-07-12,MOL,2682,1324,1358,358,2303,21,ITF,ITF2,14,Molise,Molise,305617,335470,109.77,0.88
5150,2021-05-26,MOL,1613,729,884,819,757,37,ITF,ITF2,14,Molise,Molise,305617,337083,110.3,0.53
5151,2021-03-30,MOL,2008,860,1148,1475,513,20,ITF,ITF2,14,Molise,Molise,305617,339091,110.95,0.66
5152,2021-09-03,MOL,1179,609,570,276,884,19,ITF,ITF2,14,Molise,Molise,305617,340270,111.34,0.39
5153,2021-02-01,MOL,563,201,362,14,549,0,ITF,ITF2,14,Molise,Molise,305617,340833,111.52,0.18
5154,2021-07-08,MOL,3439,1658,1781,108,3308,23,ITF,ITF2,14,Molise,Molise,305617,344272,112.65,1.13
5155,2021-05-12,MOL,2866,1301,1565,2699,98,69,ITF,ITF2,14,Molise,Molise,305617,347138,113.59,0.94
5156,2021-04-06,MOL,1501,703,798,1133,345,23,ITF,ITF2,14,Molise,Molise,305617,348639,114.08,0.49
5157,2021-02-08,MOL,335,141,194,216,119,0,ITF,ITF2,14,Molise,Molise,305617,348974,114.19,0.11
5158,2021-07-15,MOL,3216,1618,1598,210,2991,15,ITF,ITF2,14,Molise,Molise,305617,352190,115.24,1.05
5159,2021-05-19,MOL,2355,1211,1144,1887,430,38,ITF,ITF2,14,Molise,Molise,305617,354545,116.01,0.77
5160,2021-03-23,MOL,1652,698,954,1417,210,25,ITF,ITF2,14,Molise,Molise,305617,356197,116.55,0.54
5161,2021-08-27,MOL,2118,1090,1028,414,1682,22,ITF,ITF2,14,Molise,Molise,305617,358315,117.24,0.69
5162,2021-07-01,MOL,2675,1303,1372,275,2385,15,ITF,ITF2,14,Molise,Molise,305617,360990,118.12,0.88
5163,2021-07-26,MOL,2432,1254,1178,1253,1119,60,ITF,ITF2,14,Molise,Molise,305617,363422,118.91,0.8
5164,2021-02-15,MOL,144,70,74,141,3,0,ITF,ITF2,14,Molise,Molise,305617,363566,118.96,0.05
5165,2021-02-22,MOL,265,129,136,248,15,2,ITF,ITF2,14,Molise,Molise,305617,363831,119.05,0.09
5166,2020-12-27,MOL,50,20,30,50,0,0,ITF,ITF2,14,Molise,Molise,305617,363881,119.06,0.02
5167,2021-03-25,MOL,1812,732,1080,1286,498,28,ITF,ITF2,14,Molise,Molise,305617,365693,119.66,0.59
5168,2021-03-08,MOL,1391,525,866,1213,140,38,ITF,ITF2,14,Molise,Molise,305617,367084,120.11,0.46
5169,2021-06-16,MOL,2112,1043,1069,1157,940,15,ITF,ITF2,14,Molise,Molise,305617,369196,120.8,0.69
5170,2021-04-13,MOL,1633,718,915,1037,588,8,ITF,ITF2,14,Molise,Molise,305617,370829,121.34,0.53
5171,2021-03-27,MOL,2747,1275,1472,1296,1434,17,ITF,ITF2,14,Molise,Molise,305617,373576,122.24,0.9
5172,2021-07-05,MOL,2744,1285,1459,40,2702,2,ITF,ITF2,14,Molise,Molise,305617,376320,123.13,0.9
5173,2021-06-18,MOL,2781,1259,1522,1292,1461,28,ITF,ITF2,14,Molise,Molise,305617,379101,124.04,0.91
5174,2021-05-30,MOL,1875,936,939,1561,286,28,ITF,ITF2,14,Molise,Molise,305617,380976,124.66,0.61
5175,2021-09-01,MOL,1680,885,795,379,1281,20,ITF,ITF2,14,Molise,Molise,305617,382656,125.21,0.55
5176,2021-01-09,MOL,453,154,299,453,0,0,ITF,ITF2,14,Molise,Molise,305617,383109,125.36,0.15
5177,2021-04-19,MOL,1832,844,988,989,780,63,ITF,ITF2,14,Molise,Molise,305617,384941,125.96,0.6
5178,2021-07-13,MOL,2817,1431,1386,321,2479,17,ITF,ITF2,14,Molise,Molise,305617,387758,126.88,0.92
5179,2021-02-28,MOL,837,336,501,792,43,2,ITF,ITF2,14,Molise,Molise,305617,388595,127.15,0.27
5180,2021-02-27,MOL,1371,570,801,1346,20,5,ITF,ITF2,14,Molise,Molise,305617,389966,127.6,0.45
5181,2021-06-07,MOL,1970,864,1106,1125,820,25,ITF,ITF2,14,Molise,Molise,305617,391936,128.24,0.64
5182,2021-02-13,MOL,132,80,52,132,0,0,ITF,ITF2,14,Molise,Molise,305617,392068,128.29,0.04
5183,2021-08-29,MOL,1429,778,651,110,1311,8,ITF,ITF2,14,Molise,Molise,305617,393497,128.75,0.47
5184,2021-05-24,MOL,1975,858,1117,1275,672,28,ITF,ITF2,14,Molise,Molise,305617,395472,129.4,0.65
5185,2021-05-07,MOL,2657,1236,1421,2021,599,37,ITF,ITF2,14,Molise,Molise,305617,398129,130.27,0.87
5186,2021-04-18,MOL,1087,484,603,143,937,7,ITF,ITF2,14,Molise,Molise,305617,399216,130.63,0.36
5187,2021-07-27,MOL,1930,1065,865,1316,551,63,ITF,ITF2,14,Molise,Molise,305617,401146,131.26,0.63
5188,2021-07-10,MOL,3733,1784,1949,324,3395,14,ITF,ITF2,14,Molise,Molise,305617,404879,132.48,1.22
5189,2021-04-04,MOL,253,141,112,231,15,7,ITF,ITF2,14,Molise,Molise,305617,405132,132.56,0.08
5190,2021-03-18,MOL,1159,477,682,635,465,59,ITF,ITF2,14,Molise,Molise,305617,406291,132.94,0.38
5191,2021-06-26,MOL,3134,1540,1594,530,2589,15,ITF,ITF2,14,Molise,Molise,305617,409425,133.97,1.03
5192,2021-02-10,MOL,151,79,72,131,20,0,ITF,ITF2,14,Molise,Molise,305617,409576,134.02,0.05
5193,2021-05-21,MOL,2204,1106,1098,1793,326,85,ITF,ITF2,14,Molise,Molise,305617,411780,134.74,0.72
5194,2021-01-27,MOL,675,251,424,8,667,0,ITF,ITF2,14,Molise,Molise,305617,412455,134.96,0.22
5195,2021-08-14,MOL,1621,875,746,707,895,19,ITF,ITF2,14,Molise,Molise,305617,414076,135.49,0.53
5196,2021-01-08,MOL,432,142,290,432,0,0,ITF,ITF2,14,Molise,Molise,305617,414508,135.63,0.14
5197,2021-09-02,MOL,1395,724,671,242,1131,22,ITF,ITF2,14,Molise,Molise,305617,415903,136.09,0.46
5198,2021-04-01,MOL,1479,670,809,734,730,15,ITF,ITF2,14,Molise,Molise,305617,417382,136.57,0.48
