,data,area,Vaccinazioni giornaliere,sesso_maschile,sesso_femminile,prima_dose,seconda_dose,pregressa_infezione,codice_NUTS1,codice_NUTS2,codice_regione_ISTAT,nome_area,Regione,popolazione,Totale vaccinazioni,Totale vaccinazioni ogni cento ab,Vaccinazioni giornaliere ogni cento ab
0,2021-04-11,CAM,17527,8608,8919,15053,2086,388,ITF,ITF3,15,Campania,Campania,5801692,17527,0.3,0.3
1,2021-04-28,CAM,36400,17627,18773,25857,9759,784,ITF,ITF3,15,Campania,Campania,5801692,53927,0.93,0.63
2,2021-01-18,CAM,958,399,559,682,244,32,ITF,ITF3,15,Campania,Campania,5801692,54885,0.95,0.02
3,2021-07-20,CAM,40112,19795,20317,6360,33321,431,ITF,ITF3,15,Campania,Campania,5801692,94997,1.64,0.69
4,2021-06-24,CAM,66081,31836,34245,13462,52274,345,ITF,ITF3,15,Campania,Campania,5801692,161078,2.78,1.14
5,2021-03-16,CAM,8088,3519,4569,3700,4316,72,ITF,ITF3,15,Campania,Campania,5801692,169166,2.92,0.14
6,2021-01-25,CAM,5750,2927,2823,167,5583,0,ITF,ITF3,15,Campania,Campania,5801692,174916,3.01,0.1
7,2021-07-01,CAM,61510,29850,31660,19806,41013,691,ITF,ITF3,15,Campania,Campania,5801692,236426,4.08,1.06
8,2021-03-23,CAM,15743,7446,8297,12899,2513,331,ITF,ITF3,15,Campania,Campania,5801692,252169,4.35,0.27
9,2021-05-19,CAM,51217,22625,28592,33818,16671,728,ITF,ITF3,15,Campania,Campania,5801692,303386,5.23,0.88
10,2021-03-28,CAM,15566,7511,8055,13602,1625,339,ITF,ITF3,15,Campania,Campania,5801692,318952,5.5,0.27
11,2021-01-04,CAM,5826,2962,2864,5726,0,100,ITF,ITF3,15,Campania,Campania,5801692,324778,5.6,0.1
12,2021-06-19,CAM,62402,29708,32694,24239,37764,399,ITF,ITF3,15,Campania,Campania,5801692,387180,6.67,1.08
13,2021-03-09,CAM,14131,6871,7260,9942,3789,400,ITF,ITF3,15,Campania,Campania,5801692,401311,6.92,0.24
14,2021-06-07,CAM,57587,27721,29866,52837,4038,712,ITF,ITF3,15,Campania,Campania,5801692,458898,7.91,0.99
15,2021-02-25,CAM,12430,4481,7949,10957,1193,280,ITF,ITF3,15,Campania,Campania,5801692,471328,8.12,0.21
16,2021-04-09,CAM,29949,14084,15865,23203,6134,612,ITF,ITF3,15,Campania,Campania,5801692,501277,8.64,0.52
17,2021-06-05,CAM,77634,37584,40050,70880,6025,729,ITF,ITF3,15,Campania,Campania,5801692,578911,9.98,1.34
18,2021-08-03,CAM,32001,16213,15788,14635,16649,717,ITF,ITF3,15,Campania,Campania,5801692,610912,10.53,0.55
19,2021-02-11,CAM,6283,2706,3577,5922,67,294,ITF,ITF3,15,Campania,Campania,5801692,617195,10.64,0.11
20,2021-07-27,CAM,49088,24391,24697,12757,35707,624,ITF,ITF3,15,Campania,Campania,5801692,666283,11.48,0.85
21,2021-01-30,CAM,10732,5083,5649,43,10687,2,ITF,ITF3,15,Campania,Campania,5801692,677015,11.67,0.18
22,2021-07-03,CAM,67281,32496,34785,8188,58703,390,ITF,ITF3,15,Campania,Campania,5801692,744296,12.83,1.16
23,2021-01-16,CAM,3372,1677,1695,3262,0,110,ITF,ITF3,15,Campania,Campania,5801692,747668,12.89,0.06
24,2021-05-24,CAM,31355,15151,16204,15856,15152,347,ITF,ITF3,15,Campania,Campania,5801692,779023,13.43,0.54
25,2021-02-13,CAM,5507,2550,2957,5107,217,183,ITF,ITF3,15,Campania,Campania,5801692,784530,13.52,0.09
26,2021-08-01,CAM,16062,8394,7668,7021,8830,211,ITF,ITF3,15,Campania,Campania,5801692,800592,13.8,0.28
27,2021-04-23,CAM,32338,15528,16810,22463,9155,720,ITF,ITF3,15,Campania,Campania,5801692,832930,14.36,0.56
28,2021-03-02,CAM,12763,4560,8203,8209,4345,209,ITF,ITF3,15,Campania,Campania,5801692,845693,14.58,0.22
29,2021-07-15,CAM,66711,32047,34664,9361,57056,294,ITF,ITF3,15,Campania,Campania,5801692,912404,15.73,1.15
30,2021-01-11,CAM,4071,1871,2200,3962,0,109,ITF,ITF3,15,Campania,Campania,5801692,916475,15.8,0.07
31,2021-05-05,CAM,51179,24862,26317,43255,6391,1533,ITF,ITF3,15,Campania,Campania,5801692,967654,16.68,0.88
32,2021-05-12,CAM,40917,19966,20951,30603,9169,1145,ITF,ITF3,15,Campania,Campania,5801692,1008571,17.38,0.71
33,2021-07-08,CAM,61108,29412,31696,5649,55138,321,ITF,ITF3,15,Campania,Campania,5801692,1069679,18.44,1.05
34,2021-05-17,CAM,49475,21745,27730,23661,25361,453,ITF,ITF3,15,Campania,Campania,5801692,1119154,19.29,0.85
35,2021-02-06,CAM,5341,2666,2675,2004,3239,98,ITF,ITF3,15,Campania,Campania,5801692,1124495,19.38,0.09
36,2021-07-22,CAM,61779,30496,31283,6547,54735,497,ITF,ITF3,15,Campania,Campania,5801692,1186274,20.45,1.06
37,2021-08-08,CAM,7570,4039,3531,4652,2664,254,ITF,ITF3,15,Campania,Campania,5801692,1193844,20.58,0.13
38,2021-04-30,CAM,42326,20196,22130,25000,16505,821,ITF,ITF3,15,Campania,Campania,5801692,1236170,21.31,0.73
39,2021-02-04,CAM,7943,3429,4514,1249,6635,59,ITF,ITF3,15,Campania,Campania,5801692,1244113,21.44,0.14
40,2021-01-01,CAM,919,506,413,900,0,19,ITF,ITF3,15,Campania,Campania,5801692,1245032,21.46,0.02
41,2021-03-25,CAM,20325,9656,10669,16373,3505,447,ITF,ITF3,15,Campania,Campania,5801692,1265357,21.81,0.35
42,2021-05-31,CAM,40768,20686,20082,29848,10354,566,ITF,ITF3,15,Campania,Campania,5801692,1306125,22.51,0.7
43,2021-06-14,CAM,37126,17919,19207,18782,18017,327,ITF,ITF3,15,Campania,Campania,5801692,1343251,23.15,0.64
44,2021-08-10,CAM,21614,11170,10444,13700,6936,978,ITF,ITF3,15,Campania,Campania,5801692,1364865,23.53,0.37
45,2021-02-27,CAM,13953,4472,9481,11986,1650,317,ITF,ITF3,15,Campania,Campania,5801692,1378818,23.77,0.24
46,2021-04-16,CAM,34438,16634,17804,23101,10667,670,ITF,ITF3,15,Campania,Campania,5801692,1413256,24.36,0.59
47,2021-01-06,CAM,7649,3749,3900,7505,0,144,ITF,ITF3,15,Campania,Campania,5801692,1420905,24.49,0.13
48,2021-02-18,CAM,9081,3812,5269,8150,707,224,ITF,ITF3,15,Campania,Campania,5801692,1429986,24.65,0.16
49,2021-04-25,CAM,30745,15179,15566,24577,5407,761,ITF,ITF3,15,Campania,Campania,5801692,1460731,25.18,0.53
50,2021-01-23,CAM,3843,2032,1811,267,3570,6,ITF,ITF3,15,Campania,Campania,5801692,1464574,25.24,0.07
51,2021-03-21,CAM,10075,4677,5398,7505,2391,179,ITF,ITF3,15,Campania,Campania,5801692,1474649,25.42,0.17
52,2021-02-10,CAM,6908,3414,3494,6483,177,248,ITF,ITF3,15,Campania,Campania,5801692,1481557,25.54,0.12
53,2021-07-17,CAM,55258,27558,27700,3520,51539,199,ITF,ITF3,15,Campania,Campania,5801692,1536815,26.49,0.95
54,2021-04-08,CAM,28500,13822,14678,22073,5848,579,ITF,ITF3,15,Campania,Campania,5801692,1565315,26.98,0.49
55,2021-06-04,CAM,74562,35832,38730,64758,9130,674,ITF,ITF3,15,Campania,Campania,5801692,1639877,28.27,1.29
56,2021-05-21,CAM,63790,29628,34162,42166,20617,1007,ITF,ITF3,15,Campania,Campania,5801692,1703667,29.37,1.1
57,2021-06-26,CAM,62945,30693,32252,14658,47858,429,ITF,ITF3,15,Campania,Campania,5801692,1766612,30.45,1.08
58,2021-07-13,CAM,53683,25791,27892,4908,48497,278,ITF,ITF3,15,Campania,Campania,5801692,1820295,31.38,0.93
59,2021-04-04,CAM,7967,4018,3949,6694,1047,226,ITF,ITF3,15,Campania,Campania,5801692,1828262,31.51,0.14
60,2021-06-12,CAM,64004,31549,32455,55902,7218,884,ITF,ITF3,15,Campania,Campania,5801692,1892266,32.62,1.1
61,2021-03-04,CAM,14708,5396,9312,8547,5895,266,ITF,ITF3,15,Campania,Campania,5801692,1906974,32.87,0.25
62,2021-05-26,CAM,52701,25850,26851,21112,31119,470,ITF,ITF3,15,Campania,Campania,5801692,1959675,33.78,0.91
63,2021-02-08,CAM,5117,2451,2666,4166,804,147,ITF,ITF3,15,Campania,Campania,5801692,1964792,33.87,0.09
64,2021-07-24,CAM,47981,24867,23114,6761,40881,339,ITF,ITF3,15,Campania,Campania,5801692,2012773,34.69,0.83
65,2021-01-20,CAM,1258,650,608,1227,0,31,ITF,ITF3,15,Campania,Campania,5801692,2014031,34.71,0.02
66,2021-06-02,CAM,42886,20163,22723,37752,4685,449,ITF,ITF3,15,Campania,Campania,5801692,2056917,35.45,0.74
67,2021-02-22,CAM,10687,3296,7391,10182,268,237,ITF,ITF3,15,Campania,Campania,5801692,2067604,35.64,0.18
68,2021-03-11,CAM,18002,9059,8943,10310,7283,409,ITF,ITF3,15,Campania,Campania,5801692,2085606,35.95,0.31
69,2021-05-16,CAM,51152,23228,27924,32865,17577,710,ITF,ITF3,15,Campania,Campania,5801692,2136758,36.83,0.88
70,2021-02-20,CAM,8574,3080,5494,8102,303,169,ITF,ITF3,15,Campania,Campania,5801692,2145332,36.98,0.15
71,2021-06-16,CAM,31647,15009,16638,20570,10770,307,ITF,ITF3,15,Campania,Campania,5801692,2176979,37.52,0.55
72,2021-05-02,CAM,43497,21542,21955,31257,11361,879,ITF,ITF3,15,Campania,Campania,5801692,2220476,38.27,0.75
73,2021-01-22,CAM,1525,776,749,659,852,14,ITF,ITF3,15,Campania,Campania,5801692,2222001,38.3,0.03
74,2021-03-06,CAM,16374,6816,9558,10394,5670,310,ITF,ITF3,15,Campania,Campania,5801692,2238375,38.58,0.28
75,2021-01-13,CAM,8021,3667,4354,7777,0,244,ITF,ITF3,15,Campania,Campania,5801692,2246396,38.72,0.14
76,2021-04-18,CAM,27221,13286,13935,17801,8902,518,ITF,ITF3,15,Campania,Campania,5801692,2273617,39.19,0.47
77,2021-01-08,CAM,10453,4967,5486,10193,0,260,ITF,ITF3,15,Campania,Campania,5801692,2284070,39.37,0.18
78,2021-04-27,CAM,32166,15630,16536,23479,7927,760,ITF,ITF3,15,Campania,Campania,5801692,2316236,39.92,0.55
79,2021-06-23,CAM,46764,22090,24674,10752,35799,213,ITF,ITF3,15,Campania,Campania,5801692,2363000,40.73,0.81
80,2021-04-06,CAM,24518,11564,12954,19498,4524,496,ITF,ITF3,15,Campania,Campania,5801692,2387518,41.15,0.42
81,2021-07-12,CAM,56688,27366,29322,3754,52602,332,ITF,ITF3,15,Campania,Campania,5801692,2444206,42.13,0.98
82,2020-12-27,CAM,720,422,298,716,0,4,ITF,ITF3,15,Campania,Campania,5801692,2444926,42.14,0.01
83,2021-07-29,CAM,48580,24395,24185,13736,34126,718,ITF,ITF3,15,Campania,Campania,5801692,2493506,42.98,0.84
84,2021-04-20,CAM,32108,15527,16581,20217,11313,578,ITF,ITF3,15,Campania,Campania,5801692,2525614,43.53,0.55
85,2021-06-28,CAM,46523,22739,23784,20577,25407,539,ITF,ITF3,15,Campania,Campania,5801692,2572137,44.33,0.8
86,2021-03-20,CAM,13989,6530,7459,10002,3739,248,ITF,ITF3,15,Campania,Campania,5801692,2586126,44.58,0.24
87,2021-04-13,CAM,26610,12686,13924,20566,5534,510,ITF,ITF3,15,Campania,Campania,5801692,2612736,45.03,0.46
88,2021-01-03,CAM,3836,2009,1827,3787,0,49,ITF,ITF3,15,Campania,Campania,5801692,2616572,45.1,0.07
89,2021-07-05,CAM,63304,30514,32790,12731,49880,693,ITF,ITF3,15,Campania,Campania,5801692,2679876,46.19,1.09
90,2021-02-01,CAM,3987,1813,2174,103,3876,8,ITF,ITF3,15,Campania,Campania,5801692,2683863,46.26,0.07
91,2021-03-30,CAM,22054,10579,11475,18591,2957,506,ITF,ITF3,15,Campania,Campania,5801692,2705917,46.64,0.38
92,2021-04-17,CAM,36197,17515,18682,23980,11515,702,ITF,ITF3,15,Campania,Campania,5801692,2742114,47.26,0.62
93,2021-06-13,CAM,43430,21245,22185,38056,4730,644,ITF,ITF3,15,Campania,Campania,5801692,2785544,48.01,0.75
94,2021-02-03,CAM,8903,4003,4900,842,8025,36,ITF,ITF3,15,Campania,Campania,5801692,2794447,48.17,0.15
95,2021-05-18,CAM,52212,23239,28973,31868,19689,655,ITF,ITF3,15,Campania,Campania,5801692,2846659,49.07,0.9
96,2021-08-09,CAM,25067,13080,11987,13752,10456,859,ITF,ITF3,15,Campania,Campania,5801692,2871726,49.5,0.43
97,2021-02-05,CAM,7265,3463,3802,2022,5128,115,ITF,ITF3,15,Campania,Campania,5801692,2878991,49.62,0.13
98,2021-08-05,CAM,35225,18072,17153,17413,16825,987,ITF,ITF3,15,Campania,Campania,5801692,2914216,50.23,0.61
99,2021-01-15,CAM,4978,2380,2598,4822,0,156,ITF,ITF3,15,Campania,Campania,5801692,2919194,50.32,0.09
100,2021-06-21,CAM,46876,22642,24234,11323,35245,308,ITF,ITF3,15,Campania,Campania,5801692,2966070,51.12,0.81
101,2021-03-13,CAM,14524,7042,7482,8975,5283,266,ITF,ITF3,15,Campania,Campania,5801692,2980594,51.37,0.25
102,2021-03-22,CAM,13184,6347,6837,10853,2043,288,ITF,ITF3,15,Campania,Campania,5801692,2993778,51.6,0.23
103,2021-02-07,CAM,2929,1382,1547,2067,771,91,ITF,ITF3,15,Campania,Campania,5801692,2996707,51.65,0.05
104,2021-06-30,CAM,47640,22756,24884,18365,28643,632,ITF,ITF3,15,Campania,Campania,5801692,3044347,52.47,0.82
105,2021-03-08,CAM,14692,6850,7842,9488,4780,424,ITF,ITF3,15,Campania,Campania,5801692,3059039,52.73,0.25
106,2021-05-04,CAM,48486,23349,25137,38311,8906,1269,ITF,ITF3,15,Campania,Campania,5801692,3107525,53.56,0.84
107,2021-07-31,CAM,30703,16204,14499,10604,19578,521,ITF,ITF3,15,Campania,Campania,5801692,3138228,54.09,0.53
108,2021-05-07,CAM,59783,29212,30571,42657,15961,1165,ITF,ITF3,15,Campania,Campania,5801692,3198011,55.12,1.03
109,2021-01-27,CAM,7738,3820,3918,157,7576,5,ITF,ITF3,15,Campania,Campania,5801692,3205749,55.26,0.13
110,2021-07-07,CAM,52297,24817,27480,7254,44634,409,ITF,ITF3,15,Campania,Campania,5801692,3258046,56.16,0.9
111,2021-03-29,CAM,19405,9576,9829,17464,1548,393,ITF,ITF3,15,Campania,Campania,5801692,3277451,56.49,0.33
112,2021-06-20,CAM,47606,22745,24861,14326,32987,293,ITF,ITF3,15,Campania,Campania,5801692,3325057,57.31,0.82
113,2021-03-27,CAM,21514,10240,11274,17240,3868,406,ITF,ITF3,15,Campania,Campania,5801692,3346571,57.68,0.37
114,2021-02-15,CAM,5472,2516,2956,5153,175,144,ITF,ITF3,15,Campania,Campania,5801692,3352043,57.78,0.09
115,2021-06-09,CAM,53062,26053,27009,41685,10909,468,ITF,ITF3,15,Campania,Campania,5801692,3405105,58.69,0.91
116,2021-03-01,CAM,12132,4248,7884,7770,4113,249,ITF,ITF3,15,Campania,Campania,5801692,3417237,58.9,0.21
117,2021-05-09,CAM,43207,20289,22918,30939,11101,1167,ITF,ITF3,15,Campania,Campania,5801692,3460444,59.65,0.74
118,2021-01-10,CAM,8165,3736,4429,7963,0,202,ITF,ITF3,15,Campania,Campania,5801692,3468609,59.79,0.14
119,2021-04-03,CAM,21119,10316,10803,18270,2383,466,ITF,ITF3,15,Campania,Campania,5801692,3489728,60.15,0.36
120,2021-05-30,CAM,52163,25449,26714,37960,13321,882,ITF,ITF3,15,Campania,Campania,5801692,3541891,61.05,0.9
121,2021-02-19,CAM,9574,3561,6013,8703,650,221,ITF,ITF3,15,Campania,Campania,5801692,3551465,61.21,0.17
122,2021-07-26,CAM,48873,24334,24539,10448,37931,494,ITF,ITF3,15,Campania,Campania,5801692,3600338,62.06,0.84
123,2020-12-31,CAM,1490,811,679,1470,0,20,ITF,ITF3,15,Campania,Campania,5801692,3601828,62.08,0.03
124,2021-06-06,CAM,63231,31447,31784,61898,648,685,ITF,ITF3,15,Campania,Campania,5801692,3665059,63.17,1.09
125,2021-02-26,CAM,13341,4229,9112,11719,1341,281,ITF,ITF3,15,Campania,Campania,5801692,3678400,63.4,0.23
126,2021-08-02,CAM,41770,21227,20543,13255,27994,521,ITF,ITF3,15,Campania,Campania,5801692,3720170,64.12,0.72
127,2021-04-24,CAM,36374,17532,18842,24351,11248,775,ITF,ITF3,15,Campania,Campania,5801692,3756544,64.75,0.63
128,2021-08-07,CAM,17207,9194,8013,11238,5277,692,ITF,ITF3,15,Campania,Campania,5801692,3773751,65.05,0.3
129,2021-04-29,CAM,41576,20185,21391,24053,16745,778,ITF,ITF3,15,Campania,Campania,5801692,3815327,65.76,0.72
130,2021-01-19,CAM,1095,474,621,1042,3,50,ITF,ITF3,15,Campania,Campania,5801692,3816422,65.78,0.02
131,2021-07-21,CAM,50198,24452,25746,8669,40878,651,ITF,ITF3,15,Campania,Campania,5801692,3866620,66.65,0.87
132,2021-01-24,CAM,4122,2119,2003,360,3745,17,ITF,ITF3,15,Campania,Campania,5801692,3870742,66.72,0.07
133,2021-05-13,CAM,55454,24832,30622,37863,16019,1572,ITF,ITF3,15,Campania,Campania,5801692,3926196,67.67,0.96
134,2021-07-09,CAM,61479,29762,31717,4354,56815,310,ITF,ITF3,15,Campania,Campania,5801692,3987675,68.73,1.06
135,2021-01-31,CAM,8070,3712,4358,22,8047,1,ITF,ITF3,15,Campania,Campania,5801692,3995745,68.87,0.14
136,2021-05-11,CAM,39883,19247,20636,29558,9404,921,ITF,ITF3,15,Campania,Campania,5801692,4035628,69.56,0.69
137,2021-01-17,CAM,1155,551,604,682,453,20,ITF,ITF3,15,Campania,Campania,5801692,4036783,69.58,0.02
138,2021-03-15,CAM,13346,6491,6855,8332,4746,268,ITF,ITF3,15,Campania,Campania,5801692,4050129,69.81,0.23
139,2021-06-01,CAM,42254,20955,21299,31483,10541,230,ITF,ITF3,15,Campania,Campania,5801692,4092383,70.54,0.73
140,2021-06-18,CAM,65893,31405,34488,35067,30302,524,ITF,ITF3,15,Campania,Campania,5801692,4158276,71.67,1.14
141,2021-03-10,CAM,15624,7728,7896,8446,6844,334,ITF,ITF3,15,Campania,Campania,5801692,4173900,71.94,0.27
142,2021-08-06,CAM,31204,16248,14956,17582,12632,990,ITF,ITF3,15,Campania,Campania,5801692,4205104,72.48,0.54
143,2021-05-15,CAM,62714,29055,33659,42140,18773,1801,ITF,ITF3,15,Campania,Campania,5801692,4267818,73.56,1.08
144,2021-03-18,CAM,12178,5382,6796,5796,6190,192,ITF,ITF3,15,Campania,Campania,5801692,4279996,73.77,0.21
145,2021-07-14,CAM,51102,24574,26528,4311,46490,301,ITF,ITF3,15,Campania,Campania,5801692,4331098,74.65,0.88
146,2021-04-05,CAM,11640,5542,6098,8931,2424,285,ITF,ITF3,15,Campania,Campania,5801692,4342738,74.85,0.2
147,2021-03-17,CAM,11596,5102,6494,4855,6587,154,ITF,ITF3,15,Campania,Campania,5801692,4354334,75.05,0.2
148,2021-05-23,CAM,58755,28643,30112,37211,20902,642,ITF,ITF3,15,Campania,Campania,5801692,4413089,76.07,1.01
149,2021-02-12,CAM,6531,2861,3670,6087,188,256,ITF,ITF3,15,Campania,Campania,5801692,4419620,76.18,0.11
150,2021-01-29,CAM,10061,4814,5247,49,10008,4,ITF,ITF3,15,Campania,Campania,5801692,4429681,76.35,0.17
151,2021-07-19,CAM,43972,21530,22442,5205,38356,411,ITF,ITF3,15,Campania,Campania,5801692,4473653,77.11,0.76
152,2021-04-10,CAM,28357,13493,14864,22808,4914,635,ITF,ITF3,15,Campania,Campania,5801692,4502010,77.6,0.49
153,2021-01-07,CAM,8909,4167,4742,8735,0,174,ITF,ITF3,15,Campania,Campania,5801692,4510919,77.75,0.15
154,2021-03-05,CAM,16818,6668,10150,9859,6667,292,ITF,ITF3,15,Campania,Campania,5801692,4527737,78.04,0.29
155,2021-01-21,CAM,2093,1116,977,670,1417,6,ITF,ITF3,15,Campania,Campania,5801692,4529830,78.08,0.04
156,2021-07-23,CAM,61789,30785,31004,8470,52854,465,ITF,ITF3,15,Campania,Campania,5801692,4591619,79.14,1.07
157,2021-04-14,CAM,27660,13337,14323,18662,8584,414,ITF,ITF3,15,Campania,Campania,5801692,4619279,79.62,0.48
158,2021-05-01,CAM,46348,22661,23687,29302,16108,938,ITF,ITF3,15,Campania,Campania,5801692,4665627,80.42,0.8
159,2021-07-06,CAM,56702,27069,29633,16150,40079,473,ITF,ITF3,15,Campania,Campania,5801692,4722329,81.4,0.98
160,2021-04-12,CAM,23308,10920,12388,19763,3035,510,ITF,ITF3,15,Campania,Campania,5801692,4745637,81.8,0.4
161,2021-01-02,CAM,3671,1962,1709,3613,0,58,ITF,ITF3,15,Campania,Campania,5801692,4749308,81.86,0.06
162,2021-07-11,CAM,40867,19669,21198,1008,39774,85,ITF,ITF3,15,Campania,Campania,5801692,4790175,82.57,0.7
163,2021-02-02,CAM,5723,2805,2918,412,5280,31,ITF,ITF3,15,Campania,Campania,5801692,4795898,82.66,0.1
164,2021-03-31,CAM,23194,11373,11821,19344,3440,410,ITF,ITF3,15,Campania,Campania,5801692,4819092,83.06,0.4
165,2021-07-02,CAM,55876,27000,28876,14425,40950,501,ITF,ITF3,15,Campania,Campania,5801692,4874968,84.03,0.96
166,2021-05-27,CAM,72963,35366,37597,25813,46590,560,ITF,ITF3,15,Campania,Campania,5801692,4947931,85.28,1.26
167,2021-02-16,CAM,5445,2414,3031,4498,771,176,ITF,ITF3,15,Campania,Campania,5801692,4953376,85.38,0.09
168,2021-05-22,CAM,68045,32533,35512,45622,21571,852,ITF,ITF3,15,Campania,Campania,5801692,5021421,86.55,1.17
169,2021-06-11,CAM,70808,34398,36410,63869,6038,901,ITF,ITF3,15,Campania,Campania,5801692,5092229,87.77,1.22
170,2021-03-03,CAM,13923,5494,8429,7088,6631,204,ITF,ITF3,15,Campania,Campania,5801692,5106152,88.01,0.24
171,2021-06-25,CAM,65515,31804,33711,13765,51342,408,ITF,ITF3,15,Campania,Campania,5801692,5171667,89.14,1.13
172,2021-05-25,CAM,46531,22396,24135,22542,23436,553,ITF,ITF3,15,Campania,Campania,5801692,5218198,89.94,0.8
173,2021-03-12,CAM,14577,7412,7165,8185,6085,307,ITF,ITF3,15,Campania,Campania,5801692,5232775,90.19,0.25
174,2021-06-03,CAM,72645,35234,37411,61116,10679,850,ITF,ITF3,15,Campania,Campania,5801692,5305420,91.45,1.25
175,2021-02-23,CAM,11001,3388,7613,10192,526,283,ITF,ITF3,15,Campania,Campania,5801692,5316421,91.64,0.19
176,2021-02-21,CAM,5837,2241,3596,5495,225,117,ITF,ITF3,15,Campania,Campania,5801692,5322258,91.74,0.1
177,2021-06-27,CAM,43556,21451,22105,14092,29070,394,ITF,ITF3,15,Campania,Campania,5801692,5365814,92.49,0.75
178,2021-03-19,CAM,11145,4973,6172,7087,3874,184,ITF,ITF3,15,Campania,Campania,5801692,5376959,92.68,0.19
179,2021-06-10,CAM,75966,36692,39274,67973,7076,917,ITF,ITF3,15,Campania,Campania,5801692,5452925,93.99,1.31
180,2021-01-14,CAM,7074,2977,4097,6809,0,265,ITF,ITF3,15,Campania,Campania,5801692,5459999,94.11,0.12
181,2021-06-17,CAM,60214,28868,31346,32866,26797,551,ITF,ITF3,15,Campania,Campania,5801692,5520213,95.15,1.04
182,2021-07-04,CAM,48821,23765,25056,6318,42316,187,ITF,ITF3,15,Campania,Campania,5801692,5569034,95.99,0.84
183,2021-03-26,CAM,19868,9324,10544,15635,3817,416,ITF,ITF3,15,Campania,Campania,5801692,5588902,96.33,0.34
184,2021-07-18,CAM,31338,15761,15577,3842,27162,334,ITF,ITF3,15,Campania,Campania,5801692,5620240,96.87,0.54
185,2021-04-07,CAM,24974,11988,12986,19702,4725,547,ITF,ITF3,15,Campania,Campania,5801692,5645214,97.3,0.43
186,2021-07-16,CAM,61042,29857,31185,6750,53895,397,ITF,ITF3,15,Campania,Campania,5801692,5706256,98.36,1.05
187,2021-04-02,CAM,21867,10525,11342,19081,2324,462,ITF,ITF3,15,Campania,Campania,5801692,5728123,98.73,0.38
188,2021-04-22,CAM,34114,16635,17479,20930,12543,641,ITF,ITF3,15,Campania,Campania,5801692,5762237,99.32,0.59
189,2021-01-12,CAM,5215,2564,2651,5076,0,139,ITF,ITF3,15,Campania,Campania,5801692,5767452,99.41,0.09
190,2021-05-06,CAM,57610,28137,29473,41275,14772,1563,ITF,ITF3,15,Campania,Campania,5801692,5825062,100.4,0.99
191,2021-03-24,CAM,17922,8369,9553,14605,2958,359,ITF,ITF3,15,Campania,Campania,5801692,5842984,100.71,0.31
192,2021-05-20,CAM,60974,28235,32739,42245,17761,968,ITF,ITF3,15,Campania,Campania,5801692,5903958,101.76,1.05
193,2021-02-09,CAM,4643,2202,2441,4232,252,159,ITF,ITF3,15,Campania,Campania,5801692,5908601,101.84,0.08
194,2021-05-29,CAM,67840,32270,35570,43098,23899,843,ITF,ITF3,15,Campania,Campania,5801692,5976441,103.01,1.17
195,2021-07-25,CAM,23168,11750,11418,4292,18739,137,ITF,ITF3,15,Campania,Campania,5801692,5999609,103.41,0.4
196,2021-05-08,CAM,56440,27144,29296,39106,15838,1496,ITF,ITF3,15,Campania,Campania,5801692,6056049,104.38,0.97
197,2021-01-28,CAM,8839,4126,4713,130,8701,8,ITF,ITF3,15,Campania,Campania,5801692,6064888,104.54,0.15
198,2021-07-30,CAM,44731,22759,21972,14465,29481,785,ITF,ITF3,15,Campania,Campania,5801692,6109619,105.31,0.77
199,2021-04-21,CAM,30282,14747,15535,17510,12229,543,ITF,ITF3,15,Campania,Campania,5801692,6139901,105.83,0.52
200,2021-02-28,CAM,10413,3207,7206,8296,1900,217,ITF,ITF3,15,Campania,Campania,5801692,6150314,106.01,0.18
201,2021-02-14,CAM,3929,1923,2006,3842,34,53,ITF,ITF3,15,Campania,Campania,5801692,6154243,106.08,0.07
202,2021-01-26,CAM,7343,3728,3615,331,6991,21,ITF,ITF3,15,Campania,Campania,5801692,6161586,106.2,0.13
203,2021-04-19,CAM,30766,14822,15944,18676,11576,514,ITF,ITF3,15,Campania,Campania,5801692,6192352,106.73,0.53
204,2021-01-09,CAM,10565,5023,5542,10303,0,262,ITF,ITF3,15,Campania,Campania,5801692,6202917,106.92,0.18
205,2021-04-01,CAM,24682,12012,12670,20074,4133,475,ITF,ITF3,15,Campania,Campania,5801692,6227599,107.34,0.43
206,2021-05-28,CAM,73062,35318,37744,26274,46171,617,ITF,ITF3,15,Campania,Campania,5801692,6300661,108.6,1.26
207,2021-05-14,CAM,61041,27581,33460,34828,24726,1487,ITF,ITF3,15,Campania,Campania,5801692,6361702,109.65,1.05
208,2021-07-10,CAM,66898,32665,34233,2740,63949,209,ITF,ITF3,15,Campania,Campania,5801692,6428600,110.81,1.15
209,2021-02-24,CAM,11785,4150,7635,10841,688,256,ITF,ITF3,15,Campania,Campania,5801692,6440385,111.01,0.2
210,2021-01-05,CAM,7237,3637,3600,7074,0,163,ITF,ITF3,15,Campania,Campania,5801692,6447622,111.13,0.12
211,2021-02-17,CAM,7403,3218,4185,6212,1063,128,ITF,ITF3,15,Campania,Campania,5801692,6455025,111.26,0.13
212,2021-04-15,CAM,34347,16663,17684,23798,9905,644,ITF,ITF3,15,Campania,Campania,5801692,6489372,111.85,0.59
213,2021-07-28,CAM,49378,24534,24844,13896,34763,719,ITF,ITF3,15,Campania,Campania,5801692,6538750,112.7,0.85
214,2021-06-22,CAM,52456,25015,27441,13195,39006,255,ITF,ITF3,15,Campania,Campania,5801692,6591206,113.61,0.9
215,2021-03-14,CAM,8618,3828,4790,4372,4142,104,ITF,ITF3,15,Campania,Campania,5801692,6599824,113.76,0.15
216,2021-05-10,CAM,35476,16392,19084,24959,9929,588,ITF,ITF3,15,Campania,Campania,5801692,6635300,114.37,0.61
217,2021-06-08,CAM,53048,25854,27194,45443,7010,595,ITF,ITF3,15,Campania,Campania,5801692,6688348,115.28,0.91
218,2021-08-04,CAM,29844,15308,14536,16006,13082,756,ITF,ITF3,15,Campania,Campania,5801692,6718192,115.8,0.51
219,2021-04-26,CAM,34047,16652,17395,27565,5623,859,ITF,ITF3,15,Campania,Campania,5801692,6752239,116.38,0.59
220,2021-03-07,CAM,11973,5404,6569,7804,3843,326,ITF,ITF3,15,Campania,Campania,5801692,6764212,116.59,0.21
221,2021-08-11,CAM,16808,8719,8089,9146,7080,582,ITF,ITF3,15,Campania,Campania,5801692,6781020,116.88,0.29
222,2021-05-03,CAM,40780,19900,20880,27921,11865,994,ITF,ITF3,15,Campania,Campania,5801692,6821800,117.58,0.7
223,2021-06-29,CAM,49331,23992,25339,19750,29108,473,ITF,ITF3,15,Campania,Campania,5801692,6871131,118.43,0.85
224,2021-06-15,CAM,18674,9087,9587,11021,7414,239,ITF,ITF3,15,Campania,Campania,5801692,6889805,118.76,0.32
225,2021-05-24,FVG,11449,5540,5909,7525,3625,299,ITH,ITH4,6,Friuli-Venezia Giulia,Friuli Venezia Giulia,1215220,11449,0.94,0.94
226,2021-02-13,FVG,566,179,387,558,6,2,ITH,ITH4,6,Friuli-Venezia Giulia,Friuli Venezia Giulia,1215220,12015,0.99,0.05
227,2021-03-02,FVG,4222,1519,2703,2701,1500,21,ITH,ITH4,6,Friuli-Venezia Giulia,Friuli Venezia Giulia,1215220,16237,1.34,0.35
228,2021-03-04,FVG,3454,1599,1855,2764,661,29,ITH,ITH4,6,Friuli-Venezia Giulia,Friuli Venezia Giulia,1215220,19691,1.62,0.28
229,2021-06-12,FVG,8218,4710,3508,6804,1160,254,ITH,ITH4,6,Friuli-Venezia Giulia,Friuli Venezia Giulia,1215220,27909,2.3,0.68
230,2021-02-18,FVG,3221,1495,1726,2795,408,18,ITH,ITH4,6,Friuli-Venezia Giulia,Friuli Venezia Giulia,1215220,31130,2.56,0.27
231,2021-04-02,FVG,6597,2928,3669,4633,1839,125,ITH,ITH4,6,Friuli-Venezia Giulia,Friuli Venezia Giulia,1215220,37727,3.1,0.54
232,2021-04-16,FVG,6970,3029,3941,4908,1927,135,ITH,ITH4,6,Friuli-Venezia Giulia,Friuli Venezia Giulia,1215220,44697,3.68,0.57
233,2021-01-30,FVG,2280,745,1535,270,2010,0,ITH,ITH4,6,Friuli-Venezia Giulia,Friuli Venezia Giulia,1215220,46977,3.87,0.19
234,2021-07-13,FVG,10995,5669,5326,1103,9741,151,ITH,ITH4,6,Friuli-Venezia Giulia,Friuli Venezia Giulia,1215220,57972,4.77,0.9
235,2021-04-28,FVG,7323,3236,4087,3683,3505,135,ITH,ITH4,6,Friuli-Venezia Giulia,Friuli Venezia Giulia,1215220,65295,5.37,0.6
236,2021-01-23,FVG,815,323,492,4,811,0,ITH,ITH4,6,Friuli-Venezia Giulia,Friuli Venezia Giulia,1215220,66110,5.44,0.07
237,2021-06-24,FVG,11094,5658,5436,1896,9093,105,ITH,ITH4,6,Friuli-Venezia Giulia,Friuli Venezia Giulia,1215220,77204,6.35,0.91
238,2021-03-16,FVG,3188,1300,1888,1023,2083,82,ITH,ITH4,6,Friuli-Venezia Giulia,Friuli Venezia Giulia,1215220,80392,6.62,0.26
239,2021-05-12,FVG,11131,5154,5977,9316,1419,396,ITH,ITH4,6,Friuli-Venezia Giulia,Friuli Venezia Giulia,1215220,91523,7.53,0.92
240,2021-07-20,FVG,9266,4858,4408,2323,6639,304,ITH,ITH4,6,Friuli-Venezia Giulia,Friuli Venezia Giulia,1215220,100789,8.29,0.76
241,2021-08-03,FVG,9761,5109,4652,4880,4516,365,ITH,ITH4,6,Friuli-Venezia Giulia,Friuli Venezia Giulia,1215220,110550,9.1,0.8
242,2021-04-11,FVG,3432,1518,1914,2414,906,112,ITH,ITH4,6,Friuli-Venezia Giulia,Friuli Venezia Giulia,1215220,113982,9.38,0.28
243,2021-06-07,FVG,9208,4772,4436,7846,994,368,ITH,ITH4,6,Friuli-Venezia Giulia,Friuli Venezia Giulia,1215220,123190,10.14,0.76
244,2021-03-28,FVG,4942,2355,2587,4690,158,94,ITH,ITH4,6,Friuli-Venezia Giulia,Friuli Venezia Giulia,1215220,128132,10.54,0.41
245,2021-01-18,FVG,1962,606,1356,1868,94,0,ITH,ITH4,6,Friuli-Venezia Giulia,Friuli Venezia Giulia,1215220,130094,10.71,0.16
246,2021-01-04,FVG,1507,558,949,1507,0,0,ITH,ITH4,6,Friuli-Venezia Giulia,Friuli Venezia Giulia,1215220,131601,10.83,0.12
247,2021-02-06,FVG,1154,338,816,21,1132,1,ITH,ITH4,6,Friuli-Venezia Giulia,Friuli Venezia Giulia,1215220,132755,10.92,0.09
248,2021-07-08,FVG,13034,7050,5984,1295,11547,192,ITH,ITH4,6,Friuli-Venezia Giulia,Friuli Venezia Giulia,1215220,145789,12.0,1.07
249,2021-02-04,FVG,2726,808,1918,35,2691,0,ITH,ITH4,6,Friuli-Venezia Giulia,Friuli Venezia Giulia,1215220,148515,12.22,0.22
250,2021-08-08,FVG,4212,2289,1923,1809,2308,95,ITH,ITH4,6,Friuli-Venezia Giulia,Friuli Venezia Giulia,1215220,152727,12.57,0.35
251,2021-04-30,FVG,7403,3267,4136,3572,3659,172,ITH,ITH4,6,Friuli-Venezia Giulia,Friuli Venezia Giulia,1215220,160130,13.18,0.61
252,2021-01-06,FVG,716,265,451,716,0,0,ITH,ITH4,6,Friuli-Venezia Giulia,Friuli Venezia Giulia,1215220,160846,13.24,0.06
253,2021-02-11,FVG,1932,664,1268,1736,193,3,ITH,ITH4,6,Friuli-Venezia Giulia,Friuli Venezia Giulia,1215220,162778,13.39,0.16
254,2021-04-09,FVG,7927,3665,4262,6502,1253,172,ITH,ITH4,6,Friuli-Venezia Giulia,Friuli Venezia Giulia,1215220,170705,14.05,0.65
255,2020-12-30,FVG,626,244,382,626,0,0,ITH,ITH4,6,Friuli-Venezia Giulia,Friuli Venezia Giulia,1215220,171331,14.1,0.05
256,2021-03-21,FVG,2674,1002,1672,2215,409,50,ITH,ITH4,6,Friuli-Venezia Giulia,Friuli Venezia Giulia,1215220,174005,14.32,0.22
257,2021-01-27,FVG,1272,426,846,449,821,2,ITH,ITH4,6,Friuli-Venezia Giulia,Friuli Venezia Giulia,1215220,175277,14.42,0.1
258,2021-05-07,FVG,10899,4990,5909,7180,3532,187,ITH,ITH4,6,Friuli-Venezia Giulia,Friuli Venezia Giulia,1215220,186176,15.32,0.9
259,2021-05-09,FVG,7379,3316,4063,3376,3873,130,ITH,ITH4,6,Friuli-Venezia Giulia,Friuli Venezia Giulia,1215220,193555,15.93,0.61
260,2021-06-26,FVG,10348,5272,5076,4166,6162,20,ITH,ITH4,6,Friuli-Venezia Giulia,Friuli Venezia Giulia,1215220,203903,16.78,0.85
261,2021-04-21,FVG,7778,3469,4309,4015,3682,81,ITH,ITH4,6,Friuli-Venezia Giulia,Friuli Venezia Giulia,1215220,211681,17.42,0.64
262,2021-01-11,FVG,1883,608,1275,1882,0,1,ITH,ITH4,6,Friuli-Venezia Giulia,Friuli Venezia Giulia,1215220,213564,17.57,0.15
263,2021-07-15,FVG,10061,5125,4936,932,8883,246,ITH,ITH4,6,Friuli-Venezia Giulia,Friuli Venezia Giulia,1215220,223625,18.4,0.83
264,2021-04-23,FVG,7485,3384,4101,3477,3871,137,ITH,ITH4,6,Friuli-Venezia Giulia,Friuli Venezia Giulia,1215220,231110,19.02,0.62
265,2021-08-01,FVG,3467,1862,1605,1346,1868,253,ITH,ITH4,6,Friuli-Venezia Giulia,Friuli Venezia Giulia,1215220,234577,19.3,0.29
266,2021-05-05,FVG,9792,4277,5515,6077,3474,241,ITH,ITH4,6,Friuli-Venezia Giulia,Friuli Venezia Giulia,1215220,244369,20.11,0.81
267,2021-01-25,FVG,1584,568,1016,194,1390,0,ITH,ITH4,6,Friuli-Venezia Giulia,Friuli Venezia Giulia,1215220,245953,20.24,0.13
268,2021-07-01,FVG,12361,6431,5930,2632,9476,253,ITH,ITH4,6,Friuli-Venezia Giulia,Friuli Venezia Giulia,1215220,258314,21.26,1.02
269,2021-03-23,FVG,3897,1689,2208,1736,2143,18,ITH,ITH4,6,Friuli-Venezia Giulia,Friuli Venezia Giulia,1215220,262211,21.58,0.32
270,2021-01-16,FVG,1230,360,870,1230,0,0,ITH,ITH4,6,Friuli-Venezia Giulia,Friuli Venezia Giulia,1215220,263441,21.68,0.1
271,2021-07-03,FVG,11405,6083,5322,1092,10165,148,ITH,ITH4,6,Friuli-Venezia Giulia,Friuli Venezia Giulia,1215220,274846,22.62,0.94
272,2021-03-25,FVG,5537,2428,3109,3328,2139,70,ITH,ITH4,6,Friuli-Venezia Giulia,Friuli Venezia Giulia,1215220,280383,23.07,0.46
273,2021-05-19,FVG,12096,5966,6130,9307,2351,438,ITH,ITH4,6,Friuli-Venezia Giulia,Friuli Venezia Giulia,1215220,292479,24.07,1.0
274,2021-03-14,FVG,1400,552,848,1122,252,26,ITH,ITH4,6,Friuli-Venezia Giulia,Friuli Venezia Giulia,1215220,293879,24.18,0.12
275,2021-04-08,FVG,7468,3234,4234,5406,1930,132,ITH,ITH4,6,Friuli-Venezia Giulia,Friuli Venezia Giulia,1215220,301347,24.8,0.61
276,2021-05-21,FVG,11230,5024,6206,7906,2982,342,ITH,ITH4,6,Friuli-Venezia Giulia,Friuli Venezia Giulia,1215220,312577,25.72,0.92
277,2021-02-10,FVG,1350,496,854,1264,86,0,ITH,ITH4,6,Friuli-Venezia Giulia,Friuli Venezia Giulia,1215220,313927,25.83,0.11
278,2021-05-31,FVG,8945,4439,4506,6476,2221,248,ITH,ITH4,6,Friuli-Venezia Giulia,Friuli Venezia Giulia,1215220,322872,26.57,0.74
279,2021-07-27,FVG,9331,4686,4645,2482,6610,239,ITH,ITH4,6,Friuli-Venezia Giulia,Friuli Venezia Giulia,1215220,332203,27.34,0.77
280,2021-02-27,FVG,3534,1202,2332,3516,1,17,ITH,ITH4,6,Friuli-Venezia Giulia,Friuli Venezia Giulia,1215220,335737,27.63,0.29
281,2021-04-25,FVG,2375,991,1384,2184,11,180,ITH,ITH4,6,Friuli-Venezia Giulia,Friuli Venezia Giulia,1215220,338112,27.82,0.2
282,2021-02-23,FVG,2644,1277,1367,2456,181,7,ITH,ITH4,6,Friuli-Venezia Giulia,Friuli Venezia Giulia,1215220,340756,28.04,0.22
283,2021-05-17,FVG,8837,4105,4732,6082,2492,263,ITH,ITH4,6,Friuli-Venezia Giulia,Friuli Venezia Giulia,1215220,349593,28.77,0.73
284,2021-03-09,FVG,4016,1725,2291,1238,2753,25,ITH,ITH4,6,Friuli-Venezia Giulia,Friuli Venezia Giulia,1215220,353609,29.1,0.33
285,2021-06-19,FVG,8550,4453,4097,1343,7142,65,ITH,ITH4,6,Friuli-Venezia Giulia,Friuli Venezia Giulia,1215220,362159,29.8,0.7
286,2021-03-11,FVG,3481,1518,1963,1713,1753,15,ITH,ITH4,6,Friuli-Venezia Giulia,Friuli Venezia Giulia,1215220,365640,30.09,0.29
287,2021-06-05,FVG,10330,5339,4991,8413,1551,366,ITH,ITH4,6,Friuli-Venezia Giulia,Friuli Venezia Giulia,1215220,375970,30.94,0.85
288,2021-02-25,FVG,3173,1655,1518,3113,29,31,ITH,ITH4,6,Friuli-Venezia Giulia,Friuli Venezia Giulia,1215220,379143,31.2,0.26
289,2021-06-16,FVG,12184,5912,6272,3897,8026,261,ITH,ITH4,6,Friuli-Venezia Giulia,Friuli Venezia Giulia,1215220,391327,32.2,1.0
290,2021-06-23,FVG,12079,5843,6236,1999,9943,137,ITH,ITH4,6,Friuli-Venezia Giulia,Friuli Venezia Giulia,1215220,403406,33.2,0.99
291,2021-08-05,FVG,6881,3539,3342,2998,3668,215,ITH,ITH4,6,Friuli-Venezia Giulia,Friuli Venezia Giulia,1215220,410287,33.76,0.57
292,2021-04-27,FVG,8137,3737,4400,3548,4489,100,ITH,ITH4,6,Friuli-Venezia Giulia,Friuli Venezia Giulia,1215220,418424,34.43,0.67
293,2021-07-31,FVG,7326,3759,3567,1253,5982,91,ITH,ITH4,6,Friuli-Venezia Giulia,Friuli Venezia Giulia,1215220,425750,35.03,0.6
294,2021-05-26,FVG,13438,6710,6728,9649,3442,347,ITH,ITH4,6,Friuli-Venezia Giulia,Friuli Venezia Giulia,1215220,439188,36.14,1.11
295,2021-02-15,FVG,2455,911,1544,2195,254,6,ITH,ITH4,6,Friuli-Venezia Giulia,Friuli Venezia Giulia,1215220,441643,36.34,0.2
296,2021-06-09,FVG,11338,5967,5371,9493,1395,450,ITH,ITH4,6,Friuli-Venezia Giulia,Friuli Venezia Giulia,1215220,452981,37.28,0.93
297,2021-03-01,FVG,2964,1044,1920,2888,53,23,ITH,ITH4,6,Friuli-Venezia Giulia,Friuli Venezia Giulia,1215220,455945,37.52,0.24
298,2021-03-18,FVG,3376,1423,1953,1683,1685,8,ITH,ITH4,6,Friuli-Venezia Giulia,Friuli Venezia Giulia,1215220,459321,37.8,0.28
299,2021-03-30,FVG,7294,3285,4009,6176,988,130,ITH,ITH4,6,Friuli-Venezia Giulia,Friuli Venezia Giulia,1215220,466615,38.4,0.6
300,2021-07-10,FVG,8782,4529,4253,138,8617,27,ITH,ITH4,6,Friuli-Venezia Giulia,Friuli Venezia Giulia,1215220,475397,39.12,0.72
301,2021-07-17,FVG,7307,3920,3387,556,6664,87,ITH,ITH4,6,Friuli-Venezia Giulia,Friuli Venezia Giulia,1215220,482704,39.72,0.6
302,2021-02-01,FVG,2104,690,1414,17,2087,0,ITH,ITH4,6,Friuli-Venezia Giulia,Friuli Venezia Giulia,1215220,484808,39.89,0.17
303,2021-05-14,FVG,10818,5381,5437,7921,2602,295,ITH,ITH4,6,Friuli-Venezia Giulia,Friuli Venezia Giulia,1215220,495626,40.78,0.89
304,2021-02-03,FVG,2649,792,1857,22,2626,1,ITH,ITH4,6,Friuli-Venezia Giulia,Friuli Venezia Giulia,1215220,498275,41.0,0.22
305,2021-04-13,FVG,7381,3294,4087,5651,1605,125,ITH,ITH4,6,Friuli-Venezia Giulia,Friuli Venezia Giulia,1215220,505656,41.61,0.61
306,2021-01-03,FVG,313,123,190,313,0,0,ITH,ITH4,6,Friuli-Venezia Giulia,Friuli Venezia Giulia,1215220,505969,41.64,0.03
307,2021-07-22,FVG,7631,4036,3595,3170,4136,325,ITH,ITH4,6,Friuli-Venezia Giulia,Friuli Venezia Giulia,1215220,513600,42.26,0.63
308,2021-01-20,FVG,748,320,428,13,735,0,ITH,ITH4,6,Friuli-Venezia Giulia,Friuli Venezia Giulia,1215220,514348,42.33,0.06
309,2021-07-29,FVG,9404,4786,4618,3048,6050,306,ITH,ITH4,6,Friuli-Venezia Giulia,Friuli Venezia Giulia,1215220,523752,43.1,0.77
310,2021-04-20,FVG,7136,3074,4062,3095,3914,127,ITH,ITH4,6,Friuli-Venezia Giulia,Friuli Venezia Giulia,1215220,530888,43.69,0.59
311,2021-01-10,FVG,2942,919,2023,2942,0,0,ITH,ITH4,6,Friuli-Venezia Giulia,Friuli Venezia Giulia,1215220,533830,43.93,0.24
312,2021-07-14,FVG,10847,5547,5300,1210,9438,199,ITH,ITH4,6,Friuli-Venezia Giulia,Friuli Venezia Giulia,1215220,544677,44.82,0.89
313,2021-04-05,FVG,2897,1440,1457,2822,15,60,ITH,ITH4,6,Friuli-Venezia Giulia,Friuli Venezia Giulia,1215220,547574,45.06,0.24
314,2021-01-12,FVG,2257,713,1544,2257,0,0,ITH,ITH4,6,Friuli-Venezia Giulia,Friuli Venezia Giulia,1215220,549831,45.25,0.19
315,2021-01-29,FVG,2414,814,1600,265,2149,0,ITH,ITH4,6,Friuli-Venezia Giulia,Friuli Venezia Giulia,1215220,552245,45.44,0.2
316,2021-05-04,FVG,9599,4329,5270,5992,3383,224,ITH,ITH4,6,Friuli-Venezia Giulia,Friuli Venezia Giulia,1215220,561844,46.23,0.79
317,2021-01-24,FVG,306,120,186,1,305,0,ITH,ITH4,6,Friuli-Venezia Giulia,Friuli Venezia Giulia,1215220,562150,46.26,0.03
318,2021-06-30,FVG,13178,6708,6470,1379,11625,174,ITH,ITH4,6,Friuli-Venezia Giulia,Friuli Venezia Giulia,1215220,575328,47.34,1.08
319,2021-03-08,FVG,4125,1643,2482,2022,2088,15,ITH,ITH4,6,Friuli-Venezia Giulia,Friuli Venezia Giulia,1215220,579453,47.68,0.34
320,2021-03-22,FVG,3666,1453,2213,1671,1956,39,ITH,ITH4,6,Friuli-Venezia Giulia,Friuli Venezia Giulia,1215220,583119,47.98,0.3
321,2021-06-28,FVG,9905,4992,4913,2177,7701,27,ITH,ITH4,6,Friuli-Venezia Giulia,Friuli Venezia Giulia,1215220,593024,48.8,0.82
322,2021-03-20,FVG,3405,1412,1993,1300,2091,14,ITH,ITH4,6,Friuli-Venezia Giulia,Friuli Venezia Giulia,1215220,596429,49.08,0.28
323,2021-01-13,FVG,2651,835,1816,2650,0,1,ITH,ITH4,6,Friuli-Venezia Giulia,Friuli Venezia Giulia,1215220,599080,49.3,0.22
324,2021-04-06,FVG,6683,3137,3546,5425,1153,105,ITH,ITH4,6,Friuli-Venezia Giulia,Friuli Venezia Giulia,1215220,605763,49.85,0.55
325,2020-12-27,FVG,262,149,113,261,0,1,ITH,ITH4,6,Friuli-Venezia Giulia,Friuli Venezia Giulia,1215220,606025,49.87,0.02
326,2021-02-08,FVG,2358,694,1664,90,2267,1,ITH,ITH4,6,Friuli-Venezia Giulia,Friuli Venezia Giulia,1215220,608383,50.06,0.19
327,2021-06-13,FVG,8694,4525,4169,5201,3326,167,ITH,ITH4,6,Friuli-Venezia Giulia,Friuli Venezia Giulia,1215220,617077,50.78,0.72
328,2021-07-26,FVG,8446,4199,4247,1695,6535,216,ITH,ITH4,6,Friuli-Venezia Giulia,Friuli Venezia Giulia,1215220,625523,51.47,0.7
329,2021-04-17,FVG,7463,3239,4224,5816,1484,163,ITH,ITH4,6,Friuli-Venezia Giulia,Friuli Venezia Giulia,1215220,632986,52.09,0.61
330,2021-04-01,FVG,6424,3069,3355,5321,1015,88,ITH,ITH4,6,Friuli-Venezia Giulia,Friuli Venezia Giulia,1215220,639410,52.62,0.53
331,2021-05-28,FVG,10638,5095,5543,6230,4130,278,ITH,ITH4,6,Friuli-Venezia Giulia,Friuli Venezia Giulia,1215220,650048,53.49,0.88
332,2021-07-12,FVG,9978,5123,4855,1072,8748,158,ITH,ITH4,6,Friuli-Venezia Giulia,Friuli Venezia Giulia,1215220,660026,54.31,0.82
333,2021-02-19,FVG,3260,1294,1966,2818,427,15,ITH,ITH4,6,Friuli-Venezia Giulia,Friuli Venezia Giulia,1215220,663286,54.58,0.27
334,2021-06-04,FVG,12133,6220,5913,10302,1445,386,ITH,ITH4,6,Friuli-Venezia Giulia,Friuli Venezia Giulia,1215220,675419,55.58,1.0
335,2021-07-05,FVG,9534,4840,4694,1306,8084,144,ITH,ITH4,6,Friuli-Venezia Giulia,Friuli Venezia Giulia,1215220,684953,56.36,0.78
336,2021-06-21,FVG,9205,4496,4709,1820,7248,137,ITH,ITH4,6,Friuli-Venezia Giulia,Friuli Venezia Giulia,1215220,694158,57.12,0.76
337,2021-03-13,FVG,2944,1125,1819,1657,1274,13,ITH,ITH4,6,Friuli-Venezia Giulia,Friuli Venezia Giulia,1215220,697102,57.36,0.24
338,2021-04-22,FVG,6794,3090,3704,3034,3690,70,ITH,ITH4,6,Friuli-Venezia Giulia,Friuli Venezia Giulia,1215220,703896,57.92,0.56
339,2021-08-02,FVG,8858,4530,4328,2708,5879,271,ITH,ITH4,6,Friuli-Venezia Giulia,Friuli Venezia Giulia,1215220,712754,58.65,0.73
340,2021-02-22,FVG,2486,1194,1292,2063,418,5,ITH,ITH4,6,Friuli-Venezia Giulia,Friuli Venezia Giulia,1215220,715240,58.86,0.2
341,2021-06-02,FVG,9424,4957,4467,8839,282,303,ITH,ITH4,6,Friuli-Venezia Giulia,Friuli Venezia Giulia,1215220,724664,59.63,0.78
342,2021-08-09,FVG,7734,4137,3597,2306,5246,182,ITH,ITH4,6,Friuli-Venezia Giulia,Friuli Venezia Giulia,1215220,732398,60.27,0.64
343,2021-02-07,FVG,1565,482,1083,384,1180,1,ITH,ITH4,6,Friuli-Venezia Giulia,Friuli Venezia Giulia,1215220,733963,60.4,0.13
344,2021-05-18,FVG,10845,5423,5422,8395,2091,359,ITH,ITH4,6,Friuli-Venezia Giulia,Friuli Venezia Giulia,1215220,744808,61.29,0.89
345,2021-06-01,FVG,10126,5124,5002,7711,2125,290,ITH,ITH4,6,Friuli-Venezia Giulia,Friuli Venezia Giulia,1215220,754934,62.12,0.83
346,2021-01-17,FVG,1715,522,1193,1713,0,2,ITH,ITH4,6,Friuli-Venezia Giulia,Friuli Venezia Giulia,1215220,756649,62.26,0.14
347,2021-03-15,FVG,3954,1811,2143,1607,2324,23,ITH,ITH4,6,Friuli-Venezia Giulia,Friuli Venezia Giulia,1215220,760603,62.59,0.33
348,2021-02-12,FVG,1195,428,767,1142,49,4,ITH,ITH4,6,Friuli-Venezia Giulia,Friuli Venezia Giulia,1215220,761798,62.69,0.1
349,2021-05-25,FVG,12937,6396,6541,9281,3315,341,ITH,ITH4,6,Friuli-Venezia Giulia,Friuli Venezia Giulia,1215220,774735,63.75,1.06
350,2021-06-11,FVG,10910,5950,4960,9632,836,442,ITH,ITH4,6,Friuli-Venezia Giulia,Friuli Venezia Giulia,1215220,785645,64.65,0.9
351,2021-03-03,FVG,3647,1635,2012,2343,1276,28,ITH,ITH4,6,Friuli-Venezia Giulia,Friuli Venezia Giulia,1215220,789292,64.95,0.3
352,2021-04-24,FVG,6687,2951,3736,5207,1245,235,ITH,ITH4,6,Friuli-Venezia Giulia,Friuli Venezia Giulia,1215220,795979,65.5,0.55
353,2021-06-06,FVG,9492,4630,4862,7653,1566,273,ITH,ITH4,6,Friuli-Venezia Giulia,Friuli Venezia Giulia,1215220,805471,66.28,0.78
354,2021-02-26,FVG,3743,2100,1643,3561,148,34,ITH,ITH4,6,Friuli-Venezia Giulia,Friuli Venezia Giulia,1215220,809214,66.59,0.31
355,2021-02-17,FVG,2361,1003,1358,1874,485,2,ITH,ITH4,6,Friuli-Venezia Giulia,Friuli Venezia Giulia,1215220,811575,66.78,0.19
356,2021-07-28,FVG,10188,5188,5000,3707,6007,474,ITH,ITH4,6,Friuli-Venezia Giulia,Friuli Venezia Giulia,1215220,821763,67.62,0.84
357,2021-07-19,FVG,9416,4921,4495,840,8420,156,ITH,ITH4,6,Friuli-Venezia Giulia,Friuli Venezia Giulia,1215220,831179,68.4,0.77
358,2021-04-10,FVG,5053,2212,2841,3749,1228,76,ITH,ITH4,6,Friuli-Venezia Giulia,Friuli Venezia Giulia,1215220,836232,68.81,0.42
359,2021-05-23,FVG,10281,4860,5421,5917,4153,211,ITH,ITH4,6,Friuli-Venezia Giulia,Friuli Venezia Giulia,1215220,846513,69.66,0.85
360,2021-04-03,FVG,4020,1992,2028,2625,1337,58,ITH,ITH4,6,Friuli-Venezia Giulia,Friuli Venezia Giulia,1215220,850533,69.99,0.33
361,2021-06-10,FVG,11516,6000,5516,9714,1425,377,ITH,ITH4,6,Friuli-Venezia Giulia,Friuli Venezia Giulia,1215220,862049,70.94,0.95
362,2021-03-19,FVG,3252,1350,1902,1300,1936,16,ITH,ITH4,6,Friuli-Venezia Giulia,Friuli Venezia Giulia,1215220,865301,71.21,0.27
363,2021-06-27,FVG,7618,3806,3812,3774,3827,17,ITH,ITH4,6,Friuli-Venezia Giulia,Friuli Venezia Giulia,1215220,872919,71.83,0.63
364,2021-07-24,FVG,5981,3217,2764,2813,3014,154,ITH,ITH4,6,Friuli-Venezia Giulia,Friuli Venezia Giulia,1215220,878900,72.32,0.49
365,2021-08-10,FVG,7043,3923,3120,5045,1630,368,ITH,ITH4,6,Friuli-Venezia Giulia,Friuli Venezia Giulia,1215220,885943,72.9,0.58
366,2021-05-02,FVG,6901,3249,3652,3802,2959,140,ITH,ITH4,6,Friuli-Venezia Giulia,Friuli Venezia Giulia,1215220,892844,73.47,0.57
367,2021-05-16,FVG,10015,4792,5223,8371,1402,242,ITH,ITH4,6,Friuli-Venezia Giulia,Friuli Venezia Giulia,1215220,902859,74.3,0.82
368,2021-06-20,FVG,6516,3230,3286,1489,4936,91,ITH,ITH4,6,Friuli-Venezia Giulia,Friuli Venezia Giulia,1215220,909375,74.83,0.54
369,2021-03-29,FVG,7026,3128,3898,5368,1583,75,ITH,ITH4,6,Friuli-Venezia Giulia,Friuli Venezia Giulia,1215220,916401,75.41,0.58
370,2021-07-07,FVG,11282,5777,5505,1424,9729,129,ITH,ITH4,6,Friuli-Venezia Giulia,Friuli Venezia Giulia,1215220,927683,76.34,0.93
371,2021-07-21,FVG,8380,4255,4125,1997,6116,267,ITH,ITH4,6,Friuli-Venezia Giulia,Friuli Venezia Giulia,1215220,936063,77.03,0.69
372,2021-05-11,FVG,9143,4396,4747,7121,1808,214,ITH,ITH4,6,Friuli-Venezia Giulia,Friuli Venezia Giulia,1215220,945206,77.78,0.75
373,2021-01-31,FVG,2722,840,1882,385,2337,0,ITH,ITH4,6,Friuli-Venezia Giulia,Friuli Venezia Giulia,1215220,947928,78.0,0.22
374,2021-05-29,FVG,12032,5852,6180,6787,4988,257,ITH,ITH4,6,Friuli-Venezia Giulia,Friuli Venezia Giulia,1215220,959960,78.99,0.99
375,2021-07-25,FVG,3843,2000,1843,1893,1845,105,ITH,ITH4,6,Friuli-Venezia Giulia,Friuli Venezia Giulia,1215220,963803,79.31,0.32
376,2021-07-11,FVG,6829,3570,3259,2355,4171,303,ITH,ITH4,6,Friuli-Venezia Giulia,Friuli Venezia Giulia,1215220,970632,79.87,0.56
377,2021-05-27,FVG,12842,6151,6691,7389,5233,220,ITH,ITH4,6,Friuli-Venezia Giulia,Friuli Venezia Giulia,1215220,983474,80.93,1.06
378,2021-05-30,FVG,11067,4994,6073,7233,3588,246,ITH,ITH4,6,Friuli-Venezia Giulia,Friuli Venezia Giulia,1215220,994541,81.84,0.91
379,2021-08-06,FVG,6365,3336,3029,2265,3918,182,ITH,ITH4,6,Friuli-Venezia Giulia,Friuli Venezia Giulia,1215220,1000906,82.36,0.52
380,2021-01-07,FVG,2099,722,1377,2099,0,0,ITH,ITH4,6,Friuli-Venezia Giulia,Friuli Venezia Giulia,1215220,1003005,82.54,0.17
381,2021-03-05,FVG,3807,1531,2276,2661,1078,68,ITH,ITH4,6,Friuli-Venezia Giulia,Friuli Venezia Giulia,1215220,1006812,82.85,0.31
382,2021-04-19,FVG,6724,3138,3586,3213,3420,91,ITH,ITH4,6,Friuli-Venezia Giulia,Friuli Venezia Giulia,1215220,1013536,83.4,0.55
383,2021-01-09,FVG,2514,841,1673,2513,0,1,ITH,ITH4,6,Friuli-Venezia Giulia,Friuli Venezia Giulia,1215220,1016050,83.61,0.21
384,2021-06-15,FVG,12145,6180,5965,5349,6532,264,ITH,ITH4,6,Friuli-Venezia Giulia,Friuli Venezia Giulia,1215220,1028195,84.61,1.0
385,2021-03-07,FVG,2547,933,1614,2488,1,58,ITH,ITH4,6,Friuli-Venezia Giulia,Friuli Venezia Giulia,1215220,1030742,84.82,0.21
386,2021-06-18,FVG,10952,5407,5545,3399,7299,254,ITH,ITH4,6,Friuli-Venezia Giulia,Friuli Venezia Giulia,1215220,1041694,85.72,0.9
387,2021-03-10,FVG,3595,1705,1890,1744,1795,56,ITH,ITH4,6,Friuli-Venezia Giulia,Friuli Venezia Giulia,1215220,1045289,86.02,0.3
388,2021-02-24,FVG,2531,1093,1438,2502,18,11,ITH,ITH4,6,Friuli-Venezia Giulia,Friuli Venezia Giulia,1215220,1047820,86.22,0.21
389,2021-03-27,FVG,5380,2920,2460,3921,1411,48,ITH,ITH4,6,Friuli-Venezia Giulia,Friuli Venezia Giulia,1215220,1053200,86.67,0.44
390,2021-04-15,FVG,6517,2879,3638,5092,1272,153,ITH,ITH4,6,Friuli-Venezia Giulia,Friuli Venezia Giulia,1215220,1059717,87.2,0.54
391,2021-06-29,FVG,11364,5795,5569,1225,10032,107,ITH,ITH4,6,Friuli-Venezia Giulia,Friuli Venezia Giulia,1215220,1071081,88.14,0.94
392,2021-07-16,FVG,9760,5218,4542,1673,7925,162,ITH,ITH4,6,Friuli-Venezia Giulia,Friuli Venezia Giulia,1215220,1080841,88.94,0.8
393,2021-04-07,FVG,7848,3638,4210,6946,783,119,ITH,ITH4,6,Friuli-Venezia Giulia,Friuli Venezia Giulia,1215220,1088689,89.59,0.65
394,2021-05-15,FVG,12686,6118,6568,7689,4702,295,ITH,ITH4,6,Friuli-Venezia Giulia,Friuli Venezia Giulia,1215220,1101375,90.63,1.04
395,2021-05-01,FVG,7205,3247,3958,5909,1045,251,ITH,ITH4,6,Friuli-Venezia Giulia,Friuli Venezia Giulia,1215220,1108580,91.22,0.59
396,2021-01-21,FVG,897,345,552,1,896,0,ITH,ITH4,6,Friuli-Venezia Giulia,Friuli Venezia Giulia,1215220,1109477,91.3,0.07
397,2021-02-21,FVG,801,281,520,421,378,2,ITH,ITH4,6,Friuli-Venezia Giulia,Friuli Venezia Giulia,1215220,1110278,91.36,0.07
398,2021-05-22,FVG,11593,5205,6388,7087,4241,265,ITH,ITH4,6,Friuli-Venezia Giulia,Friuli Venezia Giulia,1215220,1121871,92.32,0.95
399,2021-07-18,FVG,5414,2927,2487,397,4992,25,ITH,ITH4,6,Friuli-Venezia Giulia,Friuli Venezia Giulia,1215220,1127285,92.76,0.45
400,2021-07-30,FVG,8912,4633,4279,2637,6002,273,ITH,ITH4,6,Friuli-Venezia Giulia,Friuli Venezia Giulia,1215220,1136197,93.5,0.73
401,2021-01-28,FVG,2242,795,1447,355,1887,0,ITH,ITH4,6,Friuli-Venezia Giulia,Friuli Venezia Giulia,1215220,1138439,93.68,0.18
402,2021-05-08,FVG,10329,4670,5659,5361,4787,181,ITH,ITH4,6,Friuli-Venezia Giulia,Friuli Venezia Giulia,1215220,1148768,94.53,0.85
403,2021-02-14,FVG,1,0,1,0,1,0,ITH,ITH4,6,Friuli-Venezia Giulia,Friuli Venezia Giulia,1215220,1148769,94.53,0.0
404,2021-05-10,FVG,8001,3554,4447,6222,1543,236,ITH,ITH4,6,Friuli-Venezia Giulia,Friuli Venezia Giulia,1215220,1156770,95.19,0.66
405,2021-08-11,FVG,3824,2026,1798,2335,1315,174,ITH,ITH4,6,Friuli-Venezia Giulia,Friuli Venezia Giulia,1215220,1160594,95.5,0.31
406,2021-05-03,FVG,7245,3296,3949,3343,3787,115,ITH,ITH4,6,Friuli-Venezia Giulia,Friuli Venezia Giulia,1215220,1167839,96.1,0.6
407,2021-01-14,FVG,2584,789,1795,2581,0,3,ITH,ITH4,6,Friuli-Venezia Giulia,Friuli Venezia Giulia,1215220,1170423,96.31,0.21
408,2021-06-08,FVG,10511,5499,5012,9646,463,402,ITH,ITH4,6,Friuli-Venezia Giulia,Friuli Venezia Giulia,1215220,1180934,97.18,0.86
409,2021-02-28,FVG,2689,1004,1685,2266,394,29,ITH,ITH4,6,Friuli-Venezia Giulia,Friuli Venezia Giulia,1215220,1183623,97.4,0.22
410,2021-08-04,FVG,9004,4647,4357,4353,4340,311,ITH,ITH4,6,Friuli-Venezia Giulia,Friuli Venezia Giulia,1215220,1192627,98.14,0.74
411,2021-04-26,FVG,5473,2455,3018,3703,1651,119,ITH,ITH4,6,Friuli-Venezia Giulia,Friuli Venezia Giulia,1215220,1198100,98.59,0.45
412,2021-04-29,FVG,6791,2989,3802,4011,2595,185,ITH,ITH4,6,Friuli-Venezia Giulia,Friuli Venezia Giulia,1215220,1204891,99.15,0.56
413,2021-01-05,FVG,1678,551,1127,1676,0,2,ITH,ITH4,6,Friuli-Venezia Giulia,Friuli Venezia Giulia,1215220,1206569,99.29,0.14
414,2021-08-07,FVG,4622,2485,2137,2565,1926,131,ITH,ITH4,6,Friuli-Venezia Giulia,Friuli Venezia Giulia,1215220,1211191,99.67,0.38
415,2021-02-05,FVG,2612,784,1828,89,2523,0,ITH,ITH4,6,Friuli-Venezia Giulia,Friuli Venezia Giulia,1215220,1213803,99.88,0.21
416,2021-04-14,FVG,7249,3134,4115,5408,1716,125,ITH,ITH4,6,Friuli-Venezia Giulia,Friuli Venezia Giulia,1215220,1221052,100.48,0.6
417,2021-07-06,FVG,11206,5851,5355,1351,9744,111,ITH,ITH4,6,Friuli-Venezia Giulia,Friuli Venezia Giulia,1215220,1232258,101.4,0.92
418,2021-07-23,FVG,8886,4545,4341,2867,5566,453,ITH,ITH4,6,Friuli-Venezia Giulia,Friuli Venezia Giulia,1215220,1241144,102.13,0.73
419,2020-12-31,FVG,1048,381,667,1047,0,1,ITH,ITH4,6,Friuli-Venezia Giulia,Friuli Venezia Giulia,1215220,1242192,102.22,0.09
420,2021-06-17,FVG,11422,5775,5647,2286,9032,104,ITH,ITH4,6,Friuli-Venezia Giulia,Friuli Venezia Giulia,1215220,1253614,103.16,0.94
421,2021-06-22,FVG,11592,5972,5620,2368,9096,128,ITH,ITH4,6,Friuli-Venezia Giulia,Friuli Venezia Giulia,1215220,1265206,104.11,0.95
422,2021-07-04,FVG,9328,4787,4541,2883,6190,255,ITH,ITH4,6,Friuli-Venezia Giulia,Friuli Venezia Giulia,1215220,1274534,104.88,0.77
423,2021-03-26,FVG,6018,2610,3408,3826,2019,173,ITH,ITH4,6,Friuli-Venezia Giulia,Friuli Venezia Giulia,1215220,1280552,105.38,0.5
424,2021-03-12,FVG,4105,1698,2407,2698,1381,26,ITH,ITH4,6,Friuli-Venezia Giulia,Friuli Venezia Giulia,1215220,1284657,105.71,0.34
425,2021-01-02,FVG,1217,470,747,1217,0,0,ITH,ITH4,6,Friuli-Venezia Giulia,Friuli Venezia Giulia,1215220,1285874,105.81,0.1
426,2021-04-12,FVG,7283,3192,4091,5997,1134,152,ITH,ITH4,6,Friuli-Venezia Giulia,Friuli Venezia Giulia,1215220,1293157,106.41,0.6
427,2021-06-03,FVG,12442,6746,5696,9923,2118,401,ITH,ITH4,6,Friuli-Venezia Giulia,Friuli Venezia Giulia,1215220,1305599,107.44,1.02
428,2021-01-19,FVG,6,2,4,6,0,0,ITH,ITH4,6,Friuli-Venezia Giulia,Friuli Venezia Giulia,1215220,1305605,107.44,0.0
429,2021-01-15,FVG,2020,605,1415,2019,0,1,ITH,ITH4,6,Friuli-Venezia Giulia,Friuli Venezia Giulia,1215220,1307625,107.6,0.17
430,2021-04-18,FVG,6051,2809,3242,5418,407,226,ITH,ITH4,6,Friuli-Venezia Giulia,Friuli Venezia Giulia,1215220,1313676,108.1,0.5
431,2021-01-08,FVG,2321,746,1575,2321,0,0,ITH,ITH4,6,Friuli-Venezia Giulia,Friuli Venezia Giulia,1215220,1315997,108.29,0.19
432,2021-06-14,FVG,10292,4993,5299,5181,4827,284,ITH,ITH4,6,Friuli-Venezia Giulia,Friuli Venezia Giulia,1215220,1326289,109.14,0.85
433,2021-02-20,FVG,2073,937,1136,1926,144,3,ITH,ITH4,6,Friuli-Venezia Giulia,Friuli Venezia Giulia,1215220,1328362,109.31,0.17
434,2021-01-22,FVG,89,29,60,0,89,0,ITH,ITH4,6,Friuli-Venezia Giulia,Friuli Venezia Giulia,1215220,1328451,109.32,0.01
435,2021-03-06,FVG,3500,1196,2304,3143,325,32,ITH,ITH4,6,Friuli-Venezia Giulia,Friuli Venezia Giulia,1215220,1331951,109.61,0.29
436,2021-05-06,FVG,11951,5549,6402,7705,3972,274,ITH,ITH4,6,Friuli-Venezia Giulia,Friuli Venezia Giulia,1215220,1343902,110.59,0.98
437,2021-07-02,FVG,11098,5737,5361,2109,8797,192,ITH,ITH4,6,Friuli-Venezia Giulia,Friuli Venezia Giulia,1215220,1355000,111.5,0.91
438,2021-06-25,FVG,10975,5520,5455,2410,8550,15,ITH,ITH4,6,Friuli-Venezia Giulia,Friuli Venezia Giulia,1215220,1365975,112.41,0.9
439,2021-07-09,FVG,11867,6299,5568,2052,9525,290,ITH,ITH4,6,Friuli-Venezia Giulia,Friuli Venezia Giulia,1215220,1377842,113.38,0.98
440,2021-03-17,FVG,3239,1269,1970,736,2493,10,ITH,ITH4,6,Friuli-Venezia Giulia,Friuli Venezia Giulia,1215220,1381081,113.65,0.27
441,2021-05-13,FVG,11197,5409,5788,8738,2070,389,ITH,ITH4,6,Friuli-Venezia Giulia,Friuli Venezia Giulia,1215220,1392278,114.57,0.92
442,2021-02-16,FVG,2517,1135,1382,2397,116,4,ITH,ITH4,6,Friuli-Venezia Giulia,Friuli Venezia Giulia,1215220,1394795,114.78,0.21
443,2021-03-24,FVG,3980,1721,2259,2460,1483,37,ITH,ITH4,6,Friuli-Venezia Giulia,Friuli Venezia Giulia,1215220,1398775,115.1,0.33
444,2021-05-20,FVG,12715,6323,6392,9791,2522,402,ITH,ITH4,6,Friuli-Venezia Giulia,Friuli Venezia Giulia,1215220,1411490,116.15,1.05
445,2021-01-26,FVG,1977,647,1330,216,1760,1,ITH,ITH4,6,Friuli-Venezia Giulia,Friuli Venezia Giulia,1215220,1413467,116.31,0.16
446,2021-02-09,FVG,1842,555,1287,1555,286,1,ITH,ITH4,6,Friuli-Venezia Giulia,Friuli Venezia Giulia,1215220,1415309,116.47,0.15
447,2021-02-02,FVG,2469,806,1663,218,2251,0,ITH,ITH4,6,Friuli-Venezia Giulia,Friuli Venezia Giulia,1215220,1417778,116.67,0.2
448,2021-03-31,FVG,8141,3571,4570,7170,847,124,ITH,ITH4,6,Friuli-Venezia Giulia,Friuli Venezia Giulia,1215220,1425919,117.34,0.67
449,2021-06-04,BAS,4831,2288,2543,3748,1046,37,ITF,ITF5,17,Basilicata,Basilicata,559084,4831,0.86,0.86
450,2021-02-24,BAS,1810,743,1067,1725,74,11,ITF,ITF5,17,Basilicata,Basilicata,559084,6641,1.19,0.32
451,2021-02-22,BAS,1793,775,1018,1732,53,8,ITF,ITF5,17,Basilicata,Basilicata,559084,8434,1.51,0.32
452,2021-05-30,BAS,2778,1421,1357,920,1853,5,ITF,ITF5,17,Basilicata,Basilicata,559084,11212,2.01,0.5
453,2021-04-03,BAS,1813,754,1059,1464,337,12,ITF,ITF5,17,Basilicata,Basilicata,559084,13025,2.33,0.32
454,2021-02-05,BAS,995,447,548,63,930,2,ITF,ITF5,17,Basilicata,Basilicata,559084,14020,2.51,0.18
455,2021-07-12,BAS,5443,2593,2850,1607,3810,26,ITF,ITF5,17,Basilicata,Basilicata,559084,19463,3.48,0.97
456,2021-07-26,BAS,5415,2720,2695,1989,3388,38,ITF,ITF5,17,Basilicata,Basilicata,559084,24878,4.45,0.97
457,2021-01-22,BAS,67,24,43,67,0,0,ITF,ITF5,17,Basilicata,Basilicata,559084,24945,4.46,0.01
458,2021-07-24,BAS,5744,2942,2802,1773,3921,50,ITF,ITF5,17,Basilicata,Basilicata,559084,30689,5.49,1.03
459,2021-05-02,BAS,4181,2001,2180,3491,629,61,ITF,ITF5,17,Basilicata,Basilicata,559084,34870,6.24,0.75
460,2021-01-10,BAS,77,24,53,77,0,0,ITF,ITF5,17,Basilicata,Basilicata,559084,34947,6.25,0.01
461,2021-04-20,BAS,4144,1982,2162,2183,1936,25,ITF,ITF5,17,Basilicata,Basilicata,559084,39091,6.99,0.74
462,2021-08-07,BAS,4510,2374,2136,1359,3092,59,ITF,ITF5,17,Basilicata,Basilicata,559084,43601,7.8,0.81
463,2021-01-08,BAS,555,219,336,555,0,0,ITF,ITF5,17,Basilicata,Basilicata,559084,44156,7.9,0.1
464,2021-05-04,BAS,4144,1995,2149,3572,523,49,ITF,ITF5,17,Basilicata,Basilicata,559084,48300,8.64,0.74
465,2021-03-08,BAS,1470,721,749,820,618,32,ITF,ITF5,17,Basilicata,Basilicata,559084,49770,8.9,0.26
466,2021-06-16,BAS,4606,2086,2520,2127,2459,20,ITF,ITF5,17,Basilicata,Basilicata,559084,54376,9.73,0.82
467,2021-03-25,BAS,1883,603,1280,1515,345,23,ITF,ITF5,17,Basilicata,Basilicata,559084,56259,10.06,0.34
468,2021-01-27,BAS,419,177,242,113,306,0,ITF,ITF5,17,Basilicata,Basilicata,559084,56678,10.14,0.07
469,2021-02-10,BAS,551,240,311,496,53,2,ITF,ITF5,17,Basilicata,Basilicata,559084,57229,10.24,0.1
470,2021-05-21,BAS,4578,2321,2257,1480,3086,12,ITF,ITF5,17,Basilicata,Basilicata,559084,61807,11.06,0.82
471,2021-04-08,BAS,789,362,427,763,10,16,ITF,ITF5,17,Basilicata,Basilicata,559084,62596,11.2,0.14
472,2021-04-22,BAS,5050,2351,2699,3381,1614,55,ITF,ITF5,17,Basilicata,Basilicata,559084,67646,12.1,0.9
473,2021-07-31,BAS,5468,2877,2591,1827,3587,54,ITF,ITF5,17,Basilicata,Basilicata,559084,73114,13.08,0.98
474,2021-07-17,BAS,5855,2914,2941,1709,4107,39,ITF,ITF5,17,Basilicata,Basilicata,559084,78969,14.12,1.05
475,2021-06-30,BAS,3454,1669,1785,2317,1111,26,ITF,ITF5,17,Basilicata,Basilicata,559084,82423,14.74,0.62
476,2021-01-15,BAS,819,353,466,819,0,0,ITF,ITF5,17,Basilicata,Basilicata,559084,83242,14.89,0.15
477,2020-12-27,BAS,106,41,65,106,0,0,ITF,ITF5,17,Basilicata,Basilicata,559084,83348,14.91,0.02
478,2021-03-20,BAS,1301,576,725,276,1018,7,ITF,ITF5,17,Basilicata,Basilicata,559084,84649,15.14,0.23
479,2021-06-28,BAS,3641,1747,1894,2114,1509,18,ITF,ITF5,17,Basilicata,Basilicata,559084,88290,15.79,0.65
480,2021-03-06,BAS,1371,541,830,752,606,13,ITF,ITF5,17,Basilicata,Basilicata,559084,89661,16.04,0.25
481,2021-05-16,BAS,4973,2468,2505,2812,2113,48,ITF,ITF5,17,Basilicata,Basilicata,559084,94634,16.93,0.89
482,2021-07-19,BAS,5924,2888,3036,1997,3886,41,ITF,ITF5,17,Basilicata,Basilicata,559084,100558,17.99,1.06
483,2021-05-23,BAS,4518,2302,2216,1527,2984,7,ITF,ITF5,17,Basilicata,Basilicata,559084,105076,18.79,0.81
484,2021-03-27,BAS,2256,866,1390,1809,433,14,ITF,ITF5,17,Basilicata,Basilicata,559084,107332,19.2,0.4
485,2021-06-23,BAS,3241,1522,1719,2333,876,32,ITF,ITF5,17,Basilicata,Basilicata,559084,110573,19.78,0.58
486,2021-03-13,BAS,1804,893,911,736,1048,20,ITF,ITF5,17,Basilicata,Basilicata,559084,112377,20.1,0.32
487,2021-02-07,BAS,381,161,220,49,332,0,ITF,ITF5,17,Basilicata,Basilicata,559084,112758,20.17,0.07
488,2021-05-18,BAS,5897,2857,3040,3383,2492,22,ITF,ITF5,17,Basilicata,Basilicata,559084,118655,21.22,1.05
489,2021-08-09,BAS,4015,2066,1949,1573,2396,46,ITF,ITF5,17,Basilicata,Basilicata,559084,122670,21.94,0.72
490,2021-07-23,BAS,5550,2782,2768,1889,3616,45,ITF,ITF5,17,Basilicata,Basilicata,559084,128220,22.93,0.99
491,2021-05-01,BAS,4708,2139,2569,3886,754,68,ITF,ITF5,17,Basilicata,Basilicata,559084,132928,23.78,0.84
492,2021-04-15,BAS,3430,1679,1751,2589,798,43,ITF,ITF5,17,Basilicata,Basilicata,559084,136358,24.39,0.61
493,2021-07-07,BAS,5209,2475,2734,2025,3171,13,ITF,ITF5,17,Basilicata,Basilicata,559084,141567,25.32,0.93
494,2021-01-03,BAS,906,346,560,906,0,0,ITF,ITF5,17,Basilicata,Basilicata,559084,142473,25.48,0.16
495,2021-03-15,BAS,2366,990,1376,508,1842,16,ITF,ITF5,17,Basilicata,Basilicata,559084,144839,25.91,0.42
496,2021-01-17,BAS,329,133,196,328,1,0,ITF,ITF5,17,Basilicata,Basilicata,559084,145168,25.97,0.06
497,2021-04-27,BAS,4730,2243,2487,4351,327,52,ITF,ITF5,17,Basilicata,Basilicata,559084,149898,26.81,0.85
498,2021-08-05,BAS,4556,2320,2236,1283,3232,41,ITF,ITF5,17,Basilicata,Basilicata,559084,154454,27.63,0.81
499,2021-06-09,BAS,4424,2072,2352,3967,424,33,ITF,ITF5,17,Basilicata,Basilicata,559084,158878,28.42,0.79
500,2021-04-13,BAS,2117,1052,1065,1282,818,17,ITF,ITF5,17,Basilicata,Basilicata,559084,160995,28.8,0.38
501,2021-03-01,BAS,553,286,267,384,169,0,ITF,ITF5,17,Basilicata,Basilicata,559084,161548,28.9,0.1
502,2021-06-18,BAS,4465,2065,2400,2180,2259,26,ITF,ITF5,17,Basilicata,Basilicata,559084,166013,29.69,0.8
503,2021-01-24,BAS,860,314,546,58,801,1,ITF,ITF5,17,Basilicata,Basilicata,559084,166873,29.85,0.15
504,2021-04-01,BAS,2726,1116,1610,1969,729,28,ITF,ITF5,17,Basilicata,Basilicata,559084,169599,30.34,0.49
505,2021-02-03,BAS,674,304,370,32,642,0,ITF,ITF5,17,Basilicata,Basilicata,559084,170273,30.46,0.12
506,2021-06-01,BAS,6137,2927,3210,3034,3076,27,ITF,ITF5,17,Basilicata,Basilicata,559084,176410,31.55,1.1
507,2021-02-17,BAS,1137,493,644,1058,77,2,ITF,ITF5,17,Basilicata,Basilicata,559084,177547,31.76,0.2
508,2021-05-28,BAS,3615,1810,1805,919,2663,33,ITF,ITF5,17,Basilicata,Basilicata,559084,181162,32.4,0.65
509,2021-06-11,BAS,4236,1982,2254,3167,1028,41,ITF,ITF5,17,Basilicata,Basilicata,559084,185398,33.16,0.76
510,2021-05-11,BAS,2654,1353,1301,1597,1033,24,ITF,ITF5,17,Basilicata,Basilicata,559084,188052,33.64,0.47
511,2021-07-14,BAS,5640,2719,2921,1626,3989,25,ITF,ITF5,17,Basilicata,Basilicata,559084,193692,34.64,1.01
512,2021-05-09,BAS,4683,2339,2344,2940,1694,49,ITF,ITF5,17,Basilicata,Basilicata,559084,198375,35.48,0.84
513,2021-02-15,BAS,629,237,392,569,44,16,ITF,ITF5,17,Basilicata,Basilicata,559084,199004,35.59,0.11
514,2021-01-29,BAS,617,231,386,63,554,0,ITF,ITF5,17,Basilicata,Basilicata,559084,199621,35.71,0.11
515,2021-03-05,BAS,1865,862,1003,1097,754,14,ITF,ITF5,17,Basilicata,Basilicata,559084,201486,36.04,0.33
516,2021-06-13,BAS,3014,1440,1574,2678,308,28,ITF,ITF5,17,Basilicata,Basilicata,559084,204500,36.58,0.54
517,2021-07-05,BAS,3277,1619,1658,2219,1022,36,ITF,ITF5,17,Basilicata,Basilicata,559084,207777,37.16,0.59
518,2021-01-07,BAS,644,321,323,644,0,0,ITF,ITF5,17,Basilicata,Basilicata,559084,208421,37.28,0.12
519,2021-02-19,BAS,1625,739,886,1557,63,5,ITF,ITF5,17,Basilicata,Basilicata,559084,210046,37.57,0.29
520,2021-02-26,BAS,2155,904,1251,2068,81,6,ITF,ITF5,17,Basilicata,Basilicata,559084,212201,37.96,0.39
521,2021-07-09,BAS,5339,2609,2730,1697,3633,9,ITF,ITF5,17,Basilicata,Basilicata,559084,217540,38.91,0.95
522,2021-04-17,BAS,3461,1655,1806,2171,1262,28,ITF,ITF5,17,Basilicata,Basilicata,559084,221001,39.53,0.62
523,2021-03-29,BAS,2482,898,1584,2143,288,51,ITF,ITF5,17,Basilicata,Basilicata,559084,223483,39.97,0.44
524,2021-01-05,BAS,950,410,540,950,0,0,ITF,ITF5,17,Basilicata,Basilicata,559084,224433,40.14,0.17
525,2021-06-27,BAS,3007,1477,1530,2378,615,14,ITF,ITF5,17,Basilicata,Basilicata,559084,227440,40.68,0.54
526,2021-04-29,BAS,4857,2397,2460,4342,440,75,ITF,ITF5,17,Basilicata,Basilicata,559084,232297,41.55,0.87
527,2021-03-17,BAS,1466,614,852,24,1438,4,ITF,ITF5,17,Basilicata,Basilicata,559084,233763,41.81,0.26
528,2021-01-19,BAS,199,84,115,199,0,0,ITF,ITF5,17,Basilicata,Basilicata,559084,233962,41.85,0.04
529,2021-06-25,BAS,3317,1571,1746,2444,839,34,ITF,ITF5,17,Basilicata,Basilicata,559084,237279,42.44,0.59
530,2021-07-04,BAS,3114,1565,1549,2166,922,26,ITF,ITF5,17,Basilicata,Basilicata,559084,240393,43.0,0.56
531,2021-05-13,BAS,5983,2967,3016,3298,2595,90,ITF,ITF5,17,Basilicata,Basilicata,559084,246376,44.07,1.07
532,2021-05-08,BAS,4844,2406,2438,3387,1412,45,ITF,ITF5,17,Basilicata,Basilicata,559084,251220,44.93,0.87
533,2021-05-27,BAS,3623,1863,1760,1075,2534,14,ITF,ITF5,17,Basilicata,Basilicata,559084,254843,45.58,0.65
534,2021-04-24,BAS,4558,2206,2352,3477,1025,56,ITF,ITF5,17,Basilicata,Basilicata,559084,259401,46.4,0.82
535,2021-08-02,BAS,4608,2333,2275,1779,2789,40,ITF,ITF5,17,Basilicata,Basilicata,559084,264009,47.22,0.82
536,2021-05-20,BAS,5882,2980,2902,2885,2969,28,ITF,ITF5,17,Basilicata,Basilicata,559084,269891,48.27,1.05
537,2021-06-06,BAS,4512,2074,2438,3695,779,38,ITF,ITF5,17,Basilicata,Basilicata,559084,274403,49.08,0.81
538,2021-08-11,BAS,3005,1570,1435,1154,1802,49,ITF,ITF5,17,Basilicata,Basilicata,559084,277408,49.62,0.54
539,2021-04-14,BAS,2045,1001,1044,1354,675,16,ITF,ITF5,17,Basilicata,Basilicata,559084,279453,49.98,0.37
540,2021-01-21,BAS,31,10,21,30,1,0,ITF,ITF5,17,Basilicata,Basilicata,559084,279484,49.99,0.01
541,2021-01-04,BAS,612,274,338,612,0,0,ITF,ITF5,17,Basilicata,Basilicata,559084,280096,50.1,0.11
542,2021-02-12,BAS,780,333,447,747,32,1,ITF,ITF5,17,Basilicata,Basilicata,559084,280876,50.24,0.14
543,2021-04-10,BAS,1034,379,655,924,84,26,ITF,ITF5,17,Basilicata,Basilicata,559084,281910,50.42,0.18
544,2021-06-24,BAS,4092,1940,2152,2152,1903,37,ITF,ITF5,17,Basilicata,Basilicata,559084,286002,51.16,0.73
545,2021-04-28,BAS,4709,2159,2550,4207,441,61,ITF,ITF5,17,Basilicata,Basilicata,559084,290711,52.0,0.84
546,2021-03-02,BAS,802,387,415,659,138,5,ITF,ITF5,17,Basilicata,Basilicata,559084,291513,52.14,0.14
547,2021-08-06,BAS,4254,2177,2077,1316,2884,54,ITF,ITF5,17,Basilicata,Basilicata,559084,295767,52.9,0.76
548,2021-06-20,BAS,4011,1884,2127,1941,2036,34,ITF,ITF5,17,Basilicata,Basilicata,559084,299778,53.62,0.72
549,2021-03-10,BAS,1685,845,840,835,839,11,ITF,ITF5,17,Basilicata,Basilicata,559084,301463,53.92,0.3
550,2021-01-26,BAS,810,357,453,101,709,0,ITF,ITF5,17,Basilicata,Basilicata,559084,302273,54.07,0.14
551,2021-05-06,BAS,5069,2440,2629,3433,1585,51,ITF,ITF5,17,Basilicata,Basilicata,559084,307342,54.97,0.91
552,2021-05-15,BAS,6531,3343,3188,3874,2574,83,ITF,ITF5,17,Basilicata,Basilicata,559084,313873,56.14,1.17
553,2021-04-02,BAS,2343,1057,1286,1714,605,24,ITF,ITF5,17,Basilicata,Basilicata,559084,316216,56.56,0.42
554,2021-02-04,BAS,1105,445,660,64,1041,0,ITF,ITF5,17,Basilicata,Basilicata,559084,317321,56.76,0.2
555,2021-07-11,BAS,5031,2405,2626,1509,3497,25,ITF,ITF5,17,Basilicata,Basilicata,559084,322352,57.66,0.9
556,2021-03-24,BAS,1904,725,1179,1481,398,25,ITF,ITF5,17,Basilicata,Basilicata,559084,324256,58.0,0.34
557,2021-07-02,BAS,3694,1842,1852,2489,1176,29,ITF,ITF5,17,Basilicata,Basilicata,559084,327950,58.66,0.66
558,2021-04-05,BAS,726,235,491,412,304,10,ITF,ITF5,17,Basilicata,Basilicata,559084,328676,58.79,0.13
559,2021-03-22,BAS,1194,538,656,637,549,8,ITF,ITF5,17,Basilicata,Basilicata,559084,329870,59.0,0.21
560,2021-03-03,BAS,1751,821,930,1167,562,22,ITF,ITF5,17,Basilicata,Basilicata,559084,331621,59.32,0.31
561,2021-05-25,BAS,4200,2114,2086,867,3323,10,ITF,ITF5,17,Basilicata,Basilicata,559084,335821,60.07,0.75
562,2021-02-14,BAS,151,48,103,105,0,46,ITF,ITF5,17,Basilicata,Basilicata,559084,335972,60.09,0.03
563,2021-07-06,BAS,4216,2013,2203,2120,2059,37,ITF,ITF5,17,Basilicata,Basilicata,559084,340188,60.85,0.75
564,2021-01-23,BAS,747,316,431,33,714,0,ITF,ITF5,17,Basilicata,Basilicata,559084,340935,60.98,0.13
565,2021-05-03,BAS,4511,2043,2468,3621,827,63,ITF,ITF5,17,Basilicata,Basilicata,559084,345446,61.79,0.81
566,2021-07-16,BAS,5934,2900,3034,1803,4097,34,ITF,ITF5,17,Basilicata,Basilicata,559084,351380,62.85,1.06
567,2021-03-19,BAS,2300,996,1304,259,2034,7,ITF,ITF5,17,Basilicata,Basilicata,559084,353680,63.26,0.41
568,2021-02-16,BAS,907,377,530,790,98,19,ITF,ITF5,17,Basilicata,Basilicata,559084,354587,63.42,0.16
569,2021-06-10,BAS,4346,2101,2245,3868,441,37,ITF,ITF5,17,Basilicata,Basilicata,559084,358933,64.2,0.78
570,2021-07-30,BAS,4766,2436,2330,1914,2803,49,ITF,ITF5,17,Basilicata,Basilicata,559084,363699,65.05,0.85
571,2021-06-17,BAS,4442,2045,2397,2087,2330,25,ITF,ITF5,17,Basilicata,Basilicata,559084,368141,65.85,0.79
572,2021-03-14,BAS,1010,477,533,529,469,12,ITF,ITF5,17,Basilicata,Basilicata,559084,369151,66.03,0.18
573,2021-03-31,BAS,3114,1267,1847,2301,783,30,ITF,ITF5,17,Basilicata,Basilicata,559084,372265,66.58,0.56
574,2021-06-22,BAS,4355,2061,2294,2223,2100,32,ITF,ITF5,17,Basilicata,Basilicata,559084,376620,67.36,0.78
575,2021-06-05,BAS,4800,2210,2590,3823,941,36,ITF,ITF5,17,Basilicata,Basilicata,559084,381420,68.22,0.86
576,2021-02-23,BAS,1905,772,1133,1748,139,18,ITF,ITF5,17,Basilicata,Basilicata,559084,383325,68.56,0.34
577,2021-06-03,BAS,4921,2258,2663,3703,1180,38,ITF,ITF5,17,Basilicata,Basilicata,559084,388246,69.44,0.88
578,2021-03-12,BAS,1918,986,932,786,1104,28,ITF,ITF5,17,Basilicata,Basilicata,559084,390164,69.79,0.34
579,2021-05-17,BAS,5548,2735,2813,3363,2136,49,ITF,ITF5,17,Basilicata,Basilicata,559084,395712,70.78,0.99
580,2021-02-11,BAS,956,405,551,871,83,2,ITF,ITF5,17,Basilicata,Basilicata,559084,396668,70.95,0.17
581,2021-05-22,BAS,5490,2724,2766,1928,3551,11,ITF,ITF5,17,Basilicata,Basilicata,559084,402158,71.93,0.98
582,2021-03-26,BAS,1955,703,1252,1667,261,27,ITF,ITF5,17,Basilicata,Basilicata,559084,404113,72.28,0.35
583,2021-02-02,BAS,369,145,224,174,194,1,ITF,ITF5,17,Basilicata,Basilicata,559084,404482,72.35,0.07
584,2021-04-09,BAS,1153,350,803,1064,63,26,ITF,ITF5,17,Basilicata,Basilicata,559084,405635,72.55,0.21
585,2021-07-13,BAS,5855,2825,3030,1773,4035,47,ITF,ITF5,17,Basilicata,Basilicata,559084,411490,73.6,1.05
586,2021-02-09,BAS,494,215,279,317,177,0,ITF,ITF5,17,Basilicata,Basilicata,559084,411984,73.69,0.09
587,2021-07-25,BAS,4478,2254,2224,1606,2848,24,ITF,ITF5,17,Basilicata,Basilicata,559084,416462,74.49,0.8
588,2021-06-21,BAS,4257,2045,2212,2145,2093,19,ITF,ITF5,17,Basilicata,Basilicata,559084,420719,75.25,0.76
589,2021-06-19,BAS,4466,2178,2288,2370,2074,22,ITF,ITF5,17,Basilicata,Basilicata,559084,425185,76.05,0.8
590,2021-03-28,BAS,2144,743,1401,2110,17,17,ITF,ITF5,17,Basilicata,Basilicata,559084,427329,76.43,0.38
591,2021-03-11,BAS,1799,930,869,819,962,18,ITF,ITF5,17,Basilicata,Basilicata,559084,429128,76.76,0.32
592,2021-01-31,BAS,77,24,53,0,77,0,ITF,ITF5,17,Basilicata,Basilicata,559084,429205,76.77,0.01
593,2021-01-12,BAS,217,88,129,217,0,0,ITF,ITF5,17,Basilicata,Basilicata,559084,429422,76.81,0.04
594,2021-05-10,BAS,4808,2386,2422,2719,2042,47,ITF,ITF5,17,Basilicata,Basilicata,559084,434230,77.67,0.86
595,2021-01-28,BAS,917,407,510,119,798,0,ITF,ITF5,17,Basilicata,Basilicata,559084,435147,77.83,0.16
596,2021-01-14,BAS,971,413,558,971,0,0,ITF,ITF5,17,Basilicata,Basilicata,559084,436118,78.01,0.17
597,2021-04-07,BAS,1211,551,660,1155,36,20,ITF,ITF5,17,Basilicata,Basilicata,559084,437329,78.22,0.22
598,2021-04-21,BAS,3949,1843,2106,2244,1675,30,ITF,ITF5,17,Basilicata,Basilicata,559084,441278,78.93,0.71
599,2021-01-18,BAS,464,158,306,365,99,0,ITF,ITF5,17,Basilicata,Basilicata,559084,441742,79.01,0.08
600,2021-03-16,BAS,1917,807,1110,226,1688,3,ITF,ITF5,17,Basilicata,Basilicata,559084,443659,79.35,0.34
601,2021-02-08,BAS,563,194,369,153,410,0,ITF,ITF5,17,Basilicata,Basilicata,559084,444222,79.46,0.1
602,2021-05-19,BAS,2872,1499,1373,1183,1676,13,ITF,ITF5,17,Basilicata,Basilicata,559084,447094,79.97,0.51
603,2021-02-13,BAS,800,314,486,701,61,38,ITF,ITF5,17,Basilicata,Basilicata,559084,447894,80.11,0.14
604,2021-05-24,BAS,4834,2344,2490,1090,3731,13,ITF,ITF5,17,Basilicata,Basilicata,559084,452728,80.98,0.86
605,2021-07-29,BAS,4860,2527,2333,1910,2903,47,ITF,ITF5,17,Basilicata,Basilicata,559084,457588,81.85,0.87
606,2021-02-27,BAS,1995,862,1133,1814,164,17,ITF,ITF5,17,Basilicata,Basilicata,559084,459583,82.2,0.36
607,2021-07-20,BAS,5694,2794,2900,1688,3966,40,ITF,ITF5,17,Basilicata,Basilicata,559084,465277,83.22,1.02
608,2021-06-07,BAS,4238,1921,2317,3885,315,38,ITF,ITF5,17,Basilicata,Basilicata,559084,469515,83.98,0.76
609,2021-04-11,BAS,961,389,572,761,171,29,ITF,ITF5,17,Basilicata,Basilicata,559084,470476,84.15,0.17
610,2021-07-18,BAS,4386,2162,2224,1575,2784,27,ITF,ITF5,17,Basilicata,Basilicata,559084,474862,84.94,0.78
611,2021-08-01,BAS,4208,2114,2094,1634,2535,39,ITF,ITF5,17,Basilicata,Basilicata,559084,479070,85.69,0.75
612,2021-03-30,BAS,2852,1213,1639,2491,346,15,ITF,ITF5,17,Basilicata,Basilicata,559084,481922,86.2,0.51
613,2021-04-25,BAS,2989,1458,1531,2905,52,32,ITF,ITF5,17,Basilicata,Basilicata,559084,484911,86.73,0.53
614,2021-08-03,BAS,5123,2600,2523,1830,3244,49,ITF,ITF5,17,Basilicata,Basilicata,559084,490034,87.65,0.92
615,2021-05-12,BAS,4729,2330,2399,2800,1881,48,ITF,ITF5,17,Basilicata,Basilicata,559084,494763,88.5,0.85
616,2021-07-15,BAS,6478,3211,3267,1669,4784,25,ITF,ITF5,17,Basilicata,Basilicata,559084,501241,89.65,1.16
617,2021-04-06,BAS,1274,465,809,1074,184,16,ITF,ITF5,17,Basilicata,Basilicata,559084,502515,89.88,0.23
618,2021-05-05,BAS,4339,2050,2289,3380,890,69,ITF,ITF5,17,Basilicata,Basilicata,559084,506854,90.66,0.78
619,2021-03-09,BAS,1409,720,689,780,611,18,ITF,ITF5,17,Basilicata,Basilicata,559084,508263,90.91,0.25
620,2021-01-25,BAS,1039,435,604,73,965,1,ITF,ITF5,17,Basilicata,Basilicata,559084,509302,91.1,0.19
621,2021-01-11,BAS,184,67,117,184,0,0,ITF,ITF5,17,Basilicata,Basilicata,559084,509486,91.13,0.03
622,2021-02-25,BAS,1792,739,1053,1734,47,11,ITF,ITF5,17,Basilicata,Basilicata,559084,511278,91.45,0.32
623,2021-08-10,BAS,4379,2296,2083,1514,2797,68,ITF,ITF5,17,Basilicata,Basilicata,559084,515657,92.23,0.78
624,2021-02-06,BAS,926,380,546,146,780,0,ITF,ITF5,17,Basilicata,Basilicata,559084,516583,92.4,0.17
625,2021-04-30,BAS,5286,2376,2910,4066,1163,57,ITF,ITF5,17,Basilicata,Basilicata,559084,521869,93.34,0.95
626,2021-01-20,BAS,85,22,63,84,1,0,ITF,ITF5,17,Basilicata,Basilicata,559084,521954,93.36,0.02
627,2021-07-08,BAS,5138,2429,2709,1855,3259,24,ITF,ITF5,17,Basilicata,Basilicata,559084,527092,94.28,0.92
628,2021-01-06,BAS,296,130,166,296,0,0,ITF,ITF5,17,Basilicata,Basilicata,559084,527388,94.33,0.05
629,2021-04-16,BAS,3325,1635,1690,2400,900,25,ITF,ITF5,17,Basilicata,Basilicata,559084,530713,94.93,0.59
630,2021-06-02,BAS,5961,2805,3156,4376,1544,41,ITF,ITF5,17,Basilicata,Basilicata,559084,536674,95.99,1.07
631,2021-04-18,BAS,3722,1844,1878,2330,1369,23,ITF,ITF5,17,Basilicata,Basilicata,559084,540396,96.66,0.67
632,2021-02-20,BAS,1168,535,633,1049,119,0,ITF,ITF5,17,Basilicata,Basilicata,559084,541564,96.87,0.21
633,2021-07-27,BAS,4714,2371,2343,1815,2854,45,ITF,ITF5,17,Basilicata,Basilicata,559084,546278,97.71,0.84
634,2021-05-31,BAS,4230,2010,2220,1713,2509,8,ITF,ITF5,17,Basilicata,Basilicata,559084,550508,98.47,0.76
635,2021-02-18,BAS,1072,401,671,853,216,3,ITF,ITF5,17,Basilicata,Basilicata,559084,551580,98.66,0.19
636,2021-06-29,BAS,3858,1881,1977,2788,1043,27,ITF,ITF5,17,Basilicata,Basilicata,559084,555438,99.35,0.69
637,2021-03-21,BAS,1172,544,628,470,699,3,ITF,ITF5,17,Basilicata,Basilicata,559084,556610,99.56,0.21
638,2021-05-29,BAS,3059,1533,1526,824,2224,11,ITF,ITF5,17,Basilicata,Basilicata,559084,559669,100.1,0.55
639,2021-04-04,BAS,612,226,386,190,416,6,ITF,ITF5,17,Basilicata,Basilicata,559084,560281,100.21,0.11
640,2021-07-22,BAS,5797,2889,2908,1786,3950,61,ITF,ITF5,17,Basilicata,Basilicata,559084,566078,101.25,1.04
641,2021-06-14,BAS,4825,2156,2669,2091,2710,24,ITF,ITF5,17,Basilicata,Basilicata,559084,570903,102.11,0.86
642,2021-03-23,BAS,1639,632,1007,1450,169,20,ITF,ITF5,17,Basilicata,Basilicata,559084,572542,102.41,0.29
643,2021-07-01,BAS,3711,1857,1854,2567,1111,33,ITF,ITF5,17,Basilicata,Basilicata,559084,576253,103.07,0.66
644,2021-02-01,BAS,246,94,152,46,200,0,ITF,ITF5,17,Basilicata,Basilicata,559084,576499,103.11,0.04
645,2021-01-13,BAS,917,387,530,917,0,0,ITF,ITF5,17,Basilicata,Basilicata,559084,577416,103.28,0.16
646,2021-04-23,BAS,4550,2190,2360,3480,1010,60,ITF,ITF5,17,Basilicata,Basilicata,559084,581966,104.09,0.81
647,2021-01-30,BAS,712,230,482,129,583,0,ITF,ITF5,17,Basilicata,Basilicata,559084,582678,104.22,0.13
648,2021-03-04,BAS,1894,898,996,1065,806,23,ITF,ITF5,17,Basilicata,Basilicata,559084,584572,104.56,0.34
649,2021-06-12,BAS,3687,1694,1993,2959,690,38,ITF,ITF5,17,Basilicata,Basilicata,559084,588259,105.22,0.66
650,2021-05-26,BAS,4489,2260,2229,1676,2784,29,ITF,ITF5,17,Basilicata,Basilicata,559084,592748,106.02,0.8
651,2021-08-04,BAS,4500,2232,2268,1424,3035,41,ITF,ITF5,17,Basilicata,Basilicata,559084,597248,106.83,0.8
652,2021-06-08,BAS,4585,2194,2391,4190,357,38,ITF,ITF5,17,Basilicata,Basilicata,559084,601833,107.65,0.82
653,2021-04-12,BAS,2174,1052,1122,1653,492,29,ITF,ITF5,17,Basilicata,Basilicata,559084,604007,108.04,0.39
654,2021-07-21,BAS,5845,2942,2903,1611,4201,33,ITF,ITF5,17,Basilicata,Basilicata,559084,609852,109.08,1.05
655,2021-04-19,BAS,4179,1919,2260,2397,1651,131,ITF,ITF5,17,Basilicata,Basilicata,559084,614031,109.83,0.75
656,2021-07-28,BAS,5037,2577,2460,1931,3047,59,ITF,ITF5,17,Basilicata,Basilicata,559084,619068,110.73,0.9
657,2021-06-15,BAS,3221,1416,1805,2226,975,20,ITF,ITF5,17,Basilicata,Basilicata,559084,622289,111.31,0.58
658,2021-02-28,BAS,812,347,465,771,37,4,ITF,ITF5,17,Basilicata,Basilicata,559084,623101,111.45,0.15
659,2021-01-02,BAS,952,381,571,951,0,1,ITF,ITF5,17,Basilicata,Basilicata,559084,624053,111.62,0.17
660,2021-01-16,BAS,725,305,420,725,0,0,ITF,ITF5,17,Basilicata,Basilicata,559084,624778,111.75,0.13
661,2021-04-26,BAS,4466,2164,2302,4197,221,48,ITF,ITF5,17,Basilicata,Basilicata,559084,629244,112.55,0.8
662,2021-08-08,BAS,3669,1876,1793,1120,2520,29,ITF,ITF5,17,Basilicata,Basilicata,559084,632913,113.21,0.66
663,2021-02-21,BAS,284,113,171,284,0,0,ITF,ITF5,17,Basilicata,Basilicata,559084,633197,113.26,0.05
664,2021-03-07,BAS,895,312,583,846,39,10,ITF,ITF5,17,Basilicata,Basilicata,559084,634092,113.42,0.16
665,2021-01-09,BAS,560,161,399,560,0,0,ITF,ITF5,17,Basilicata,Basilicata,559084,634652,113.52,0.1
666,2021-07-03,BAS,3949,2102,1847,2759,1145,45,ITF,ITF5,17,Basilicata,Basilicata,559084,638601,114.22,0.71
667,2021-05-07,BAS,4638,2280,2358,3271,1340,27,ITF,ITF5,17,Basilicata,Basilicata,559084,643239,115.05,0.83
668,2021-07-10,BAS,5529,2668,2861,1596,3924,9,ITF,ITF5,17,Basilicata,Basilicata,559084,648768,116.04,0.99
669,2021-05-14,BAS,5907,2799,3108,3273,2531,103,ITF,ITF5,17,Basilicata,Basilicata,559084,654675,117.1,1.06
670,2021-03-18,BAS,1355,566,789,17,1329,9,ITF,ITF5,17,Basilicata,Basilicata,559084,656030,117.34,0.24
671,2021-06-26,BAS,3336,1614,1722,2751,557,28,ITF,ITF5,17,Basilicata,Basilicata,559084,659366,117.94,0.6
672,2021-02-22,ABR,2644,1174,1470,2589,30,25,ITF,ITF1,13,Abruzzo,Abruzzo,1304970,2644,0.2,0.2
673,2021-02-05,ABR,1534,521,1013,772,746,16,ITF,ITF1,13,Abruzzo,Abruzzo,1304970,4178,0.32,0.12
674,2021-05-16,ABR,9577,4136,5441,5647,3811,119,ITF,ITF1,13,Abruzzo,Abruzzo,1304970,13755,1.05,0.73
675,2021-06-04,ABR,15640,7393,8247,10759,4694,187,ITF,ITF1,13,Abruzzo,Abruzzo,1304970,29395,2.25,1.2
676,2021-05-18,ABR,12109,5660,6449,7561,4379,169,ITF,ITF1,13,Abruzzo,Abruzzo,1304970,41504,3.18,0.93
677,2021-02-24,ABR,3306,1442,1864,3112,177,17,ITF,ITF1,13,Abruzzo,Abruzzo,1304970,44810,3.43,0.25
678,2021-08-09,ABR,10698,5547,5151,3102,7404,192,ITF,ITF1,13,Abruzzo,Abruzzo,1304970,55508,4.25,0.82
679,2021-05-30,ABR,8660,4110,4550,5326,3255,79,ITF,ITF1,13,Abruzzo,Abruzzo,1304970,64168,4.92,0.66
680,2021-04-03,ABR,5163,2258,2905,3485,1598,80,ITF,ITF1,13,Abruzzo,Abruzzo,1304970,69331,5.31,0.4
681,2021-07-26,ABR,14241,7449,6792,3855,10188,198,ITF,ITF1,13,Abruzzo,Abruzzo,1304970,83572,6.4,1.09
682,2021-07-12,ABR,15074,7456,7618,2360,12598,116,ITF,ITF1,13,Abruzzo,Abruzzo,1304970,98646,7.56,1.16
683,2021-01-22,ABR,118,57,61,118,0,0,ITF,ITF1,13,Abruzzo,Abruzzo,1304970,98764,7.57,0.01
684,2021-01-03,ABR,499,212,287,497,0,2,ITF,ITF1,13,Abruzzo,Abruzzo,1304970,99263,7.61,0.04
685,2021-01-10,ABR,1270,538,732,1266,0,4,ITF,ITF1,13,Abruzzo,Abruzzo,1304970,100533,7.7,0.1
686,2021-04-29,ABR,12680,5853,6827,9280,3095,305,ITF,ITF1,13,Abruzzo,Abruzzo,1304970,113213,8.68,0.97
687,2021-08-07,ABR,6506,3627,2879,1841,4570,95,ITF,ITF1,13,Abruzzo,Abruzzo,1304970,119719,9.17,0.5
688,2021-06-25,ABR,11062,5481,5581,4907,6012,143,ITF,ITF1,13,Abruzzo,Abruzzo,1304970,130781,10.02,0.85
689,2021-01-15,ABR,385,155,230,371,0,14,ITF,ITF1,13,Abruzzo,Abruzzo,1304970,131166,10.05,0.03
690,2021-04-27,ABR,9084,4366,4718,6505,2466,113,ITF,ITF1,13,Abruzzo,Abruzzo,1304970,140250,10.75,0.7
691,2021-05-04,ABR,10860,5099,5761,7054,3620,186,ITF,ITF1,13,Abruzzo,Abruzzo,1304970,151110,11.58,0.83
692,2021-03-08,ABR,5155,1693,3462,4090,973,92,ITF,ITF1,13,Abruzzo,Abruzzo,1304970,156265,11.97,0.4
693,2021-01-24,ABR,50,22,28,6,44,0,ITF,ITF1,13,Abruzzo,Abruzzo,1304970,156315,11.98,0.0
694,2021-03-01,ABR,3478,1385,2093,2703,751,24,ITF,ITF1,13,Abruzzo,Abruzzo,1304970,159793,12.24,0.27
695,2021-02-10,ABR,946,311,635,492,444,10,ITF,ITF1,13,Abruzzo,Abruzzo,1304970,160739,12.32,0.07
696,2021-03-03,ABR,4641,1899,2742,3712,906,23,ITF,ITF1,13,Abruzzo,Abruzzo,1304970,165380,12.67,0.36
697,2021-07-14,ABR,13725,6800,6925,2440,11134,151,ITF,ITF1,13,Abruzzo,Abruzzo,1304970,179105,13.72,1.05
698,2021-04-08,ABR,7394,3336,4058,4935,2331,128,ITF,ITF1,13,Abruzzo,Abruzzo,1304970,186499,14.29,0.57
699,2021-04-22,ABR,6734,3250,3484,4830,1730,174,ITF,ITF1,13,Abruzzo,Abruzzo,1304970,193233,14.81,0.52
700,2021-07-31,ABR,11742,6341,5401,3482,8058,202,ITF,ITF1,13,Abruzzo,Abruzzo,1304970,204975,15.71,0.9
701,2021-03-22,ABR,4347,1910,2437,2310,1971,66,ITF,ITF1,13,Abruzzo,Abruzzo,1304970,209322,16.04,0.33
702,2021-06-30,ABR,11171,5430,5741,4496,6509,166,ITF,ITF1,13,Abruzzo,Abruzzo,1304970,220493,16.9,0.86
703,2020-12-27,ABR,46,24,22,46,0,0,ITF,ITF1,13,Abruzzo,Abruzzo,1304970,220539,16.9,0.0
704,2021-03-20,ABR,4794,2200,2594,2561,2171,62,ITF,ITF1,13,Abruzzo,Abruzzo,1304970,225333,17.27,0.37
705,2021-06-13,ABR,9844,4925,4919,7846,1833,165,ITF,ITF1,13,Abruzzo,Abruzzo,1304970,235177,18.02,0.75
706,2021-02-12,ABR,1228,567,661,1026,189,13,ITF,ITF1,13,Abruzzo,Abruzzo,1304970,236405,18.12,0.09
707,2021-07-19,ABR,11776,5982,5794,2665,8941,170,ITF,ITF1,13,Abruzzo,Abruzzo,1304970,248181,19.02,0.9
708,2021-05-23,ABR,9881,4694,5187,7068,2692,121,ITF,ITF1,13,Abruzzo,Abruzzo,1304970,258062,19.78,0.76
709,2021-06-06,ABR,11151,5308,5843,8779,2242,130,ITF,ITF1,13,Abruzzo,Abruzzo,1304970,269213,20.63,0.85
710,2021-04-10,ABR,8777,4059,4718,6129,2509,139,ITF,ITF1,13,Abruzzo,Abruzzo,1304970,277990,21.3,0.67
711,2021-01-19,ABR,111,55,56,90,20,1,ITF,ITF1,13,Abruzzo,Abruzzo,1304970,278101,21.31,0.01
712,2021-03-27,ABR,6131,2626,3505,3564,2495,72,ITF,ITF1,13,Abruzzo,Abruzzo,1304970,284232,21.78,0.47
713,2021-01-05,ABR,1733,721,1012,1728,0,5,ITF,ITF1,13,Abruzzo,Abruzzo,1304970,285965,21.91,0.13
714,2021-04-15,ABR,7827,3685,4142,5829,1843,155,ITF,ITF1,13,Abruzzo,Abruzzo,1304970,293792,22.51,0.6
715,2021-07-07,ABR,12073,5911,6162,4040,7793,240,ITF,ITF1,13,Abruzzo,Abruzzo,1304970,305865,23.44,0.93
716,2021-07-09,ABR,13608,6793,6815,2893,10579,136,ITF,ITF1,13,Abruzzo,Abruzzo,1304970,319473,24.48,1.04
717,2021-07-02,ABR,11836,5948,5888,4833,6819,184,ITF,ITF1,13,Abruzzo,Abruzzo,1304970,331309,25.39,0.91
718,2021-03-15,ABR,3685,1448,2237,1843,1810,32,ITF,ITF1,13,Abruzzo,Abruzzo,1304970,334994,25.67,0.28
719,2021-01-17,ABR,191,62,129,183,7,1,ITF,ITF1,13,Abruzzo,Abruzzo,1304970,335185,25.69,0.01
720,2021-06-23,ABR,11015,5283,5732,5583,5287,145,ITF,ITF1,13,Abruzzo,Abruzzo,1304970,346200,26.53,0.84
721,2021-06-18,ABR,10186,5002,5184,6550,3489,147,ITF,ITF1,13,Abruzzo,Abruzzo,1304970,356386,27.31,0.78
722,2021-02-02,ABR,1763,668,1095,218,1541,4,ITF,ITF1,13,Abruzzo,Abruzzo,1304970,358149,27.44,0.14
723,2021-05-13,ABR,11149,5042,6107,6959,3961,229,ITF,ITF1,13,Abruzzo,Abruzzo,1304970,369298,28.3,0.85
724,2021-03-31,ABR,6719,2942,3777,4557,2069,93,ITF,ITF1,13,Abruzzo,Abruzzo,1304970,376017,28.81,0.51
725,2021-07-21,ABR,11078,5719,5359,2426,8517,135,ITF,ITF1,13,Abruzzo,Abruzzo,1304970,387095,29.66,0.85
726,2021-02-03,ABR,2062,717,1345,411,1643,8,ITF,ITF1,13,Abruzzo,Abruzzo,1304970,389157,29.82,0.16
727,2021-02-28,ABR,1703,509,1194,1665,2,36,ITF,ITF1,13,Abruzzo,Abruzzo,1304970,390860,29.95,0.13
728,2021-08-04,ABR,10881,5628,5253,4305,6335,241,ITF,ITF1,13,Abruzzo,Abruzzo,1304970,401741,30.79,0.83
729,2021-01-02,ABR,559,226,333,558,0,1,ITF,ITF1,13,Abruzzo,Abruzzo,1304970,402300,30.83,0.04
730,2021-06-08,ABR,12870,6624,6246,10435,2196,239,ITF,ITF1,13,Abruzzo,Abruzzo,1304970,415170,31.81,0.99
731,2021-04-26,ABR,8563,4066,4497,7142,1213,208,ITF,ITF1,13,Abruzzo,Abruzzo,1304970,423733,32.47,0.66
732,2021-02-17,ABR,2071,948,1123,1780,282,9,ITF,ITF1,13,Abruzzo,Abruzzo,1304970,425804,32.63,0.16
733,2021-06-11,ABR,11776,5851,5925,8830,2761,185,ITF,ITF1,13,Abruzzo,Abruzzo,1304970,437580,33.53,0.9
734,2021-05-11,ABR,10761,5119,5642,5732,4853,176,ITF,ITF1,13,Abruzzo,Abruzzo,1304970,448341,34.36,0.82
735,2021-01-29,ABR,1387,449,938,72,1314,1,ITF,ITF1,13,Abruzzo,Abruzzo,1304970,449728,34.46,0.11
736,2021-08-02,ABR,13853,7154,6699,3548,10047,258,ITF,ITF1,13,Abruzzo,Abruzzo,1304970,463581,35.52,1.06
737,2021-05-27,ABR,13320,6104,7216,8316,4829,175,ITF,ITF1,13,Abruzzo,Abruzzo,1304970,476901,36.54,1.02
738,2021-04-17,ABR,7358,3403,3955,4212,3052,94,ITF,ITF1,13,Abruzzo,Abruzzo,1304970,484259,37.11,0.56
739,2021-02-19,ABR,3301,1552,1749,3162,100,39,ITF,ITF1,13,Abruzzo,Abruzzo,1304970,487560,37.36,0.25
740,2021-01-07,ABR,1710,657,1053,1703,0,7,ITF,ITF1,13,Abruzzo,Abruzzo,1304970,489270,37.49,0.13
741,2021-02-07,ABR,778,307,471,200,577,1,ITF,ITF1,13,Abruzzo,Abruzzo,1304970,490048,37.55,0.06
742,2021-07-23,ABR,12572,6464,6108,2853,9561,158,ITF,ITF1,13,Abruzzo,Abruzzo,1304970,502620,38.52,0.96
743,2021-01-21,ABR,157,47,110,157,0,0,ITF,ITF1,13,Abruzzo,Abruzzo,1304970,502777,38.53,0.01
744,2021-05-01,ABR,10743,5047,5696,5630,4979,134,ITF,ITF1,13,Abruzzo,Abruzzo,1304970,513520,39.35,0.82
745,2021-05-20,ABR,12805,5926,6879,7413,5266,126,ITF,ITF1,13,Abruzzo,Abruzzo,1304970,526325,40.33,0.98
746,2021-08-11,ABR,6432,3413,3019,1830,4484,118,ITF,ITF1,13,Abruzzo,Abruzzo,1304970,532757,40.83,0.49
747,2021-06-22,ABR,10412,4878,5534,5386,4847,179,ITF,ITF1,13,Abruzzo,Abruzzo,1304970,543169,41.62,0.8
748,2021-03-17,ABR,4540,1873,2667,2777,1740,23,ITF,ITF1,13,Abruzzo,Abruzzo,1304970,547709,41.97,0.35
749,2021-03-24,ABR,6386,2785,3601,3994,2251,141,ITF,ITF1,13,Abruzzo,Abruzzo,1304970,554095,42.46,0.49
750,2021-02-09,ABR,914,316,598,504,409,1,ITF,ITF1,13,Abruzzo,Abruzzo,1304970,555009,42.53,0.07
751,2021-05-15,ABR,11431,5181,6250,5945,5310,176,ITF,ITF1,13,Abruzzo,Abruzzo,1304970,566440,43.41,0.88
752,2021-07-11,ABR,9885,4974,4911,2365,7385,135,ITF,ITF1,13,Abruzzo,Abruzzo,1304970,576325,44.16,0.76
753,2021-03-10,ABR,5050,1685,3365,4025,957,68,ITF,ITF1,13,Abruzzo,Abruzzo,1304970,581375,44.55,0.39
754,2021-01-26,ABR,1548,568,980,34,1514,0,ITF,ITF1,13,Abruzzo,Abruzzo,1304970,582923,44.67,0.12
755,2021-03-19,ABR,5796,2584,3212,2732,3023,41,ITF,ITF1,13,Abruzzo,Abruzzo,1304970,588719,45.11,0.44
756,2021-03-05,ABR,5348,1958,3390,4591,697,60,ITF,ITF1,13,Abruzzo,Abruzzo,1304970,594067,45.52,0.41
757,2021-06-27,ABR,8370,4302,4068,5021,3209,140,ITF,ITF1,13,Abruzzo,Abruzzo,1304970,602437,46.16,0.64
758,2021-04-07,ABR,7532,3478,4054,4514,2888,130,ITF,ITF1,13,Abruzzo,Abruzzo,1304970,609969,46.74,0.58
759,2021-07-16,ABR,16146,8236,7910,2468,13561,117,ITF,ITF1,13,Abruzzo,Abruzzo,1304970,626115,47.98,1.24
760,2021-06-19,ABR,10558,5202,5356,6485,3900,173,ITF,ITF1,13,Abruzzo,Abruzzo,1304970,636673,48.79,0.81
761,2021-03-28,ABR,2425,1018,1407,1994,381,50,ITF,ITF1,13,Abruzzo,Abruzzo,1304970,639098,48.97,0.19
762,2021-07-06,ABR,10471,5203,5268,4304,5992,175,ITF,ITF1,13,Abruzzo,Abruzzo,1304970,649569,49.78,0.8
763,2021-07-30,ABR,12082,6433,5649,3798,8063,221,ITF,ITF1,13,Abruzzo,Abruzzo,1304970,661651,50.7,0.93
764,2021-02-26,ABR,3924,1679,2245,2929,969,26,ITF,ITF1,13,Abruzzo,Abruzzo,1304970,665575,51.0,0.3
765,2021-03-29,ABR,5710,2599,3111,3020,2641,49,ITF,ITF1,13,Abruzzo,Abruzzo,1304970,671285,51.44,0.44
766,2021-06-03,ABR,13197,6284,6913,9247,3776,174,ITF,ITF1,13,Abruzzo,Abruzzo,1304970,684482,52.45,1.01
767,2021-03-12,ABR,6044,1994,4050,4351,1611,82,ITF,ITF1,13,Abruzzo,Abruzzo,1304970,690526,52.92,0.46
768,2021-06-20,ABR,8441,4236,4205,5409,2929,103,ITF,ITF1,13,Abruzzo,Abruzzo,1304970,698967,53.56,0.65
769,2021-03-14,ABR,1884,731,1153,1200,667,17,ITF,ITF1,13,Abruzzo,Abruzzo,1304970,700851,53.71,0.14
770,2021-02-25,ABR,3054,1343,1711,2505,530,19,ITF,ITF1,13,Abruzzo,Abruzzo,1304970,703905,53.94,0.23
771,2021-06-05,ABR,14618,6866,7752,10372,4046,200,ITF,ITF1,13,Abruzzo,Abruzzo,1304970,718523,55.06,1.12
772,2021-05-06,ABR,13003,6087,6916,7802,5044,157,ITF,ITF1,13,Abruzzo,Abruzzo,1304970,731526,56.06,1.0
773,2021-04-09,ABR,8992,4260,4732,6247,2603,142,ITF,ITF1,13,Abruzzo,Abruzzo,1304970,740518,56.75,0.69
774,2021-07-18,ABR,12203,6309,5894,2003,10081,119,ITF,ITF1,13,Abruzzo,Abruzzo,1304970,752721,57.68,0.94
775,2021-07-04,ABR,8371,4215,4156,3333,4912,126,ITF,ITF1,13,Abruzzo,Abruzzo,1304970,761092,58.32,0.64
776,2021-02-11,ABR,816,262,554,771,43,2,ITF,ITF1,13,Abruzzo,Abruzzo,1304970,761908,58.39,0.06
777,2021-04-05,ABR,2692,1147,1545,1730,880,82,ITF,ITF1,13,Abruzzo,Abruzzo,1304970,764600,58.59,0.21
778,2021-04-14,ABR,6597,2951,3646,4342,2122,133,ITF,ITF1,13,Abruzzo,Abruzzo,1304970,771197,59.1,0.51
779,2021-01-04,ABR,1511,684,827,1505,0,6,ITF,ITF1,13,Abruzzo,Abruzzo,1304970,772708,59.21,0.12
780,2021-01-23,ABR,264,115,149,51,207,6,ITF,ITF1,13,Abruzzo,Abruzzo,1304970,772972,59.23,0.02
781,2021-05-03,ABR,11151,5260,5891,7134,3834,183,ITF,ITF1,13,Abruzzo,Abruzzo,1304970,784123,60.09,0.85
782,2021-07-25,ABR,9861,5217,4644,2173,7565,123,ITF,ITF1,13,Abruzzo,Abruzzo,1304970,793984,60.84,0.76
783,2021-07-08,ABR,13490,6681,6809,3417,9908,165,ITF,ITF1,13,Abruzzo,Abruzzo,1304970,807474,61.88,1.03
784,2021-04-16,ABR,7540,3489,4051,5497,1916,127,ITF,ITF1,13,Abruzzo,Abruzzo,1304970,815014,62.45,0.58
785,2021-05-08,ABR,10291,4870,5421,6329,3834,128,ITF,ITF1,13,Abruzzo,Abruzzo,1304970,825305,63.24,0.79
786,2021-04-24,ABR,8734,3978,4756,6944,1531,259,ITF,ITF1,13,Abruzzo,Abruzzo,1304970,834039,63.91,0.67
787,2021-01-14,ABR,568,227,341,566,0,2,ITF,ITF1,13,Abruzzo,Abruzzo,1304970,834607,63.96,0.04
788,2021-01-18,ABR,151,70,81,53,98,0,ITF,ITF1,13,Abruzzo,Abruzzo,1304970,834758,63.97,0.01
789,2021-06-24,ABR,10863,5410,5453,5722,4972,169,ITF,ITF1,13,Abruzzo,Abruzzo,1304970,845621,64.8,0.83
790,2021-04-28,ABR,9513,4588,4925,7315,2022,176,ITF,ITF1,13,Abruzzo,Abruzzo,1304970,855134,65.53,0.73
791,2021-05-12,ABR,9629,4601,5028,5873,3582,174,ITF,ITF1,13,Abruzzo,Abruzzo,1304970,864763,66.27,0.74
792,2021-03-16,ABR,3484,1452,2032,1802,1654,28,ITF,ITF1,13,Abruzzo,Abruzzo,1304970,868247,66.53,0.27
793,2021-08-06,ABR,10671,5705,4966,3691,6740,240,ITF,ITF1,13,Abruzzo,Abruzzo,1304970,878918,67.35,0.82
794,2021-08-08,ABR,4453,2429,2024,1889,2474,90,ITF,ITF1,13,Abruzzo,Abruzzo,1304970,883371,67.69,0.34
795,2021-05-17,ABR,11037,5040,5997,6023,4854,160,ITF,ITF1,13,Abruzzo,Abruzzo,1304970,894408,68.54,0.85
796,2021-02-23,ABR,2780,1273,1507,2754,11,15,ITF,ITF1,13,Abruzzo,Abruzzo,1304970,897188,68.75,0.21
797,2021-05-24,ABR,12220,5838,6382,8724,3340,156,ITF,ITF1,13,Abruzzo,Abruzzo,1304970,909408,69.69,0.94
798,2021-02-18,ABR,2292,933,1359,2142,133,17,ITF,ITF1,13,Abruzzo,Abruzzo,1304970,911700,69.86,0.18
799,2021-05-29,ABR,10318,4430,5888,4458,5771,89,ITF,ITF1,13,Abruzzo,Abruzzo,1304970,922018,70.65,0.79
800,2021-05-22,ABR,13165,6396,6769,8135,4917,113,ITF,ITF1,13,Abruzzo,Abruzzo,1304970,935183,71.66,1.01
801,2021-04-02,ABR,6695,3104,3591,5115,1488,92,ITF,ITF1,13,Abruzzo,Abruzzo,1304970,941878,72.18,0.51
802,2021-02-04,ABR,1683,617,1066,599,1072,12,ITF,ITF1,13,Abruzzo,Abruzzo,1304970,943561,72.31,0.13
803,2021-07-20,ABR,12587,6387,6200,3227,9175,185,ITF,ITF1,13,Abruzzo,Abruzzo,1304970,956148,73.27,0.96
804,2021-03-11,ABR,5491,2216,3275,4267,1138,86,ITF,ITF1,13,Abruzzo,Abruzzo,1304970,961639,73.69,0.42
805,2021-06-02,ABR,9768,4747,5021,6837,2814,117,ITF,ITF1,13,Abruzzo,Abruzzo,1304970,971407,74.44,0.75
806,2021-03-13,ABR,4124,1420,2704,3012,1043,69,ITF,ITF1,13,Abruzzo,Abruzzo,1304970,975531,74.76,0.32
807,2021-06-21,ABR,11055,5388,5667,4940,5987,128,ITF,ITF1,13,Abruzzo,Abruzzo,1304970,986586,75.6,0.85
808,2021-01-12,ABR,1899,761,1138,1885,0,14,ITF,ITF1,13,Abruzzo,Abruzzo,1304970,988485,75.75,0.15
809,2021-05-25,ABR,11421,5325,6096,8084,3139,198,ITF,ITF1,13,Abruzzo,Abruzzo,1304970,999906,76.62,0.88
810,2021-01-31,ABR,1523,494,1029,287,1235,1,ITF,ITF1,13,Abruzzo,Abruzzo,1304970,1001429,76.74,0.12
811,2021-05-10,ABR,10107,4782,5325,5365,4648,94,ITF,ITF1,13,Abruzzo,Abruzzo,1304970,1011536,77.51,0.77
812,2021-04-23,ABR,7395,3395,4000,4925,2305,165,ITF,ITF1,13,Abruzzo,Abruzzo,1304970,1018931,78.08,0.57
813,2021-01-30,ABR,1513,569,944,66,1446,1,ITF,ITF1,13,Abruzzo,Abruzzo,1304970,1020444,78.2,0.12
814,2021-08-01,ABR,7569,4056,3513,2004,5463,102,ITF,ITF1,13,Abruzzo,Abruzzo,1304970,1028013,78.78,0.58
815,2021-02-16,ABR,1916,841,1075,1891,12,13,ITF,ITF1,13,Abruzzo,Abruzzo,1304970,1029929,78.92,0.15
816,2021-03-02,ABR,3966,1675,2291,3260,686,20,ITF,ITF1,13,Abruzzo,Abruzzo,1304970,1033895,79.23,0.3
817,2021-06-10,ABR,12706,6318,6388,10308,2161,237,ITF,ITF1,13,Abruzzo,Abruzzo,1304970,1046601,80.2,0.97
818,2021-01-28,ABR,1432,495,937,11,1421,0,ITF,ITF1,13,Abruzzo,Abruzzo,1304970,1048033,80.31,0.11
819,2021-01-11,ABR,1686,690,996,1682,0,4,ITF,ITF1,13,Abruzzo,Abruzzo,1304970,1049719,80.44,0.13
820,2021-04-21,ABR,6389,3102,3287,4639,1672,78,ITF,ITF1,13,Abruzzo,Abruzzo,1304970,1056108,80.93,0.49
821,2021-05-05,ABR,11639,5573,6066,6272,5208,159,ITF,ITF1,13,Abruzzo,Abruzzo,1304970,1067747,81.82,0.89
822,2021-03-09,ABR,5180,1806,3374,4153,938,89,ITF,ITF1,13,Abruzzo,Abruzzo,1304970,1072927,82.22,0.4
823,2021-07-01,ABR,12769,6285,6484,5776,6768,225,ITF,ITF1,13,Abruzzo,Abruzzo,1304970,1085696,83.2,0.98
824,2021-06-17,ABR,10916,5459,5457,7303,3452,161,ITF,ITF1,13,Abruzzo,Abruzzo,1304970,1096612,84.03,0.84
825,2021-02-06,ABR,1611,743,868,595,1009,7,ITF,ITF1,13,Abruzzo,Abruzzo,1304970,1098223,84.16,0.12
826,2021-02-08,ABR,1196,395,801,486,710,0,ITF,ITF1,13,Abruzzo,Abruzzo,1304970,1099419,84.25,0.09
827,2021-05-19,ABR,10733,5129,5604,7570,3037,126,ITF,ITF1,13,Abruzzo,Abruzzo,1304970,1110152,85.07,0.82
828,2021-03-26,ABR,5357,2313,3044,3178,2077,102,ITF,ITF1,13,Abruzzo,Abruzzo,1304970,1115509,85.48,0.41
829,2021-07-27,ABR,15113,7890,7223,3347,11592,174,ITF,ITF1,13,Abruzzo,Abruzzo,1304970,1130622,86.64,1.16
830,2021-05-31,ABR,11341,5116,6225,6769,4445,127,ITF,ITF1,13,Abruzzo,Abruzzo,1304970,1141963,87.51,0.87
831,2021-04-20,ABR,5639,2714,2925,4107,1456,76,ITF,ITF1,13,Abruzzo,Abruzzo,1304970,1147602,87.94,0.43
832,2021-07-29,ABR,15182,7974,7208,3931,11042,209,ITF,ITF1,13,Abruzzo,Abruzzo,1304970,1162784,89.1,1.16
833,2021-04-25,ABR,9073,4627,4446,8057,809,207,ITF,ITF1,13,Abruzzo,Abruzzo,1304970,1171857,89.8,0.7
834,2021-04-04,ABR,1632,768,864,1460,129,43,ITF,ITF1,13,Abruzzo,Abruzzo,1304970,1173489,89.92,0.13
835,2021-07-13,ABR,15525,7752,7773,2829,12519,177,ITF,ITF1,13,Abruzzo,Abruzzo,1304970,1189014,91.11,1.19
836,2021-06-16,ABR,10893,5451,5442,7991,2686,216,ITF,ITF1,13,Abruzzo,Abruzzo,1304970,1199907,91.95,0.83
837,2021-02-27,ABR,2813,1339,1474,2512,267,34,ITF,ITF1,13,Abruzzo,Abruzzo,1304970,1202720,92.16,0.22
838,2021-06-07,ABR,11100,5290,5810,9071,1844,185,ITF,ITF1,13,Abruzzo,Abruzzo,1304970,1213820,93.02,0.85
839,2021-06-29,ABR,11432,5643,5789,5248,5997,187,ITF,ITF1,13,Abruzzo,Abruzzo,1304970,1225252,93.89,0.88
840,2021-03-21,ABR,2133,913,1220,839,1290,4,ITF,ITF1,13,Abruzzo,Abruzzo,1304970,1227385,94.05,0.16
841,2021-06-12,ABR,11420,5916,5504,9891,1350,179,ITF,ITF1,13,Abruzzo,Abruzzo,1304970,1238805,94.93,0.88
842,2021-03-30,ABR,5129,2261,2868,3148,1822,159,ITF,ITF1,13,Abruzzo,Abruzzo,1304970,1243934,95.32,0.39
843,2021-01-06,ABR,1989,819,1170,1979,0,10,ITF,ITF1,13,Abruzzo,Abruzzo,1304970,1245923,95.48,0.15
844,2021-07-15,ABR,15947,8089,7858,3135,12637,175,ITF,ITF1,13,Abruzzo,Abruzzo,1304970,1261870,96.7,1.22
845,2021-06-28,ABR,10055,4839,5216,5313,4573,169,ITF,ITF1,13,Abruzzo,Abruzzo,1304970,1271925,97.47,0.77
846,2021-04-06,ABR,7677,3578,4099,5232,2319,126,ITF,ITF1,13,Abruzzo,Abruzzo,1304970,1279602,98.06,0.59
847,2021-08-03,ABR,12724,6575,6149,3652,8906,166,ITF,ITF1,13,Abruzzo,Abruzzo,1304970,1292326,99.03,0.98
848,2021-02-01,ABR,1633,574,1059,269,1363,1,ITF,ITF1,13,Abruzzo,Abruzzo,1304970,1293959,99.16,0.13
849,2021-03-23,ABR,4837,2192,2645,2213,2567,57,ITF,ITF1,13,Abruzzo,Abruzzo,1304970,1298796,99.53,0.37
850,2021-01-25,ABR,1605,633,972,15,1588,2,ITF,ITF1,13,Abruzzo,Abruzzo,1304970,1300401,99.65,0.12
851,2021-04-30,ABR,12510,5869,6641,6516,5725,269,ITF,ITF1,13,Abruzzo,Abruzzo,1304970,1312911,100.61,0.96
852,2021-04-13,ABR,5895,2755,3140,4562,1238,95,ITF,ITF1,13,Abruzzo,Abruzzo,1304970,1318806,101.06,0.45
853,2021-01-20,ABR,449,157,292,427,2,20,ITF,ITF1,13,Abruzzo,Abruzzo,1304970,1319255,101.09,0.03
854,2021-07-05,ABR,10908,5346,5562,4049,6669,190,ITF,ITF1,13,Abruzzo,Abruzzo,1304970,1330163,101.93,0.84
855,2021-07-22,ABR,14483,7412,7071,3514,10760,209,ITF,ITF1,13,Abruzzo,Abruzzo,1304970,1344646,103.04,1.11
856,2021-07-24,ABR,12582,6798,5784,3762,8586,234,ITF,ITF1,13,Abruzzo,Abruzzo,1304970,1357228,104.0,0.96
857,2021-05-02,ABR,10463,5115,5348,5090,5231,142,ITF,ITF1,13,Abruzzo,Abruzzo,1304970,1367691,104.81,0.8
858,2021-08-10,ABR,9275,4968,4307,3402,5664,209,ITF,ITF1,13,Abruzzo,Abruzzo,1304970,1376966,105.52,0.71
859,2021-08-05,ABR,13913,7174,6739,4733,8911,269,ITF,ITF1,13,Abruzzo,Abruzzo,1304970,1390879,106.58,1.07
860,2021-01-08,ABR,1660,638,1022,1651,0,9,ITF,ITF1,13,Abruzzo,Abruzzo,1304970,1392539,106.71,0.13
861,2021-04-18,ABR,5815,2728,3087,4725,943,147,ITF,ITF1,13,Abruzzo,Abruzzo,1304970,1398354,107.16,0.45
862,2021-02-20,ABR,4781,1845,2936,4662,76,43,ITF,ITF1,13,Abruzzo,Abruzzo,1304970,1403135,107.52,0.37
863,2021-01-13,ABR,1302,483,819,1294,0,8,ITF,ITF1,13,Abruzzo,Abruzzo,1304970,1404437,107.62,0.1
864,2021-04-11,ABR,5380,2628,2752,4838,487,55,ITF,ITF1,13,Abruzzo,Abruzzo,1304970,1409817,108.03,0.41
865,2021-06-09,ABR,11573,6093,5480,9707,1685,181,ITF,ITF1,13,Abruzzo,Abruzzo,1304970,1421390,108.92,0.89
866,2021-03-06,ABR,4181,1362,2819,3570,570,41,ITF,ITF1,13,Abruzzo,Abruzzo,1304970,1425571,109.24,0.32
867,2021-05-09,ABR,9156,4090,5066,4175,4870,111,ITF,ITF1,13,Abruzzo,Abruzzo,1304970,1434727,109.94,0.7
868,2021-02-15,ABR,1795,832,963,1736,42,17,ITF,ITF1,13,Abruzzo,Abruzzo,1304970,1436522,110.08,0.14
869,2021-05-26,ABR,13547,6042,7505,8394,4993,160,ITF,ITF1,13,Abruzzo,Abruzzo,1304970,1450069,111.12,1.04
870,2021-06-14,ABR,10975,5430,5545,7425,3378,172,ITF,ITF1,13,Abruzzo,Abruzzo,1304970,1461044,111.96,0.84
871,2021-02-13,ABR,863,391,472,437,422,4,ITF,ITF1,13,Abruzzo,Abruzzo,1304970,1461907,112.03,0.07
872,2021-07-17,ABR,14097,7387,6710,2662,11259,176,ITF,ITF1,13,Abruzzo,Abruzzo,1304970,1476004,113.11,1.08
873,2021-03-04,ABR,5935,2360,3575,4972,922,41,ITF,ITF1,13,Abruzzo,Abruzzo,1304970,1481939,113.56,0.45
874,2021-05-28,ABR,14021,6310,7711,7491,6362,168,ITF,ITF1,13,Abruzzo,Abruzzo,1304970,1495960,114.64,1.07
875,2021-06-01,ABR,11000,4878,6122,6511,4368,121,ITF,ITF1,13,Abruzzo,Abruzzo,1304970,1506960,115.48,0.84
876,2021-04-19,ABR,6234,2862,3372,3787,2374,73,ITF,ITF1,13,Abruzzo,Abruzzo,1304970,1513194,115.96,0.48
877,2021-02-21,ABR,1218,550,668,1193,1,24,ITF,ITF1,13,Abruzzo,Abruzzo,1304970,1514412,116.05,0.09
878,2021-07-28,ABR,13254,6940,6314,3435,9653,166,ITF,ITF1,13,Abruzzo,Abruzzo,1304970,1527666,117.07,1.02
879,2021-06-15,ABR,11329,5562,5767,8682,2438,209,ITF,ITF1,13,Abruzzo,Abruzzo,1304970,1538995,117.93,0.87
880,2021-04-12,ABR,6239,2958,3281,4985,1174,80,ITF,ITF1,13,Abruzzo,Abruzzo,1304970,1545234,118.41,0.48
881,2021-01-16,ABR,937,430,507,929,0,8,ITF,ITF1,13,Abruzzo,Abruzzo,1304970,1546171,118.48,0.07
882,2021-03-07,ABR,2519,630,1889,2478,0,41,ITF,ITF1,13,Abruzzo,Abruzzo,1304970,1548690,118.68,0.19
883,2021-01-09,ABR,1609,691,918,1597,0,12,ITF,ITF1,13,Abruzzo,Abruzzo,1304970,1550299,118.8,0.12
884,2021-05-07,ABR,12203,5713,6490,7663,4414,126,ITF,ITF1,13,Abruzzo,Abruzzo,1304970,1562502,119.73,0.94
885,2021-03-25,ABR,5798,2665,3133,3067,2619,112,ITF,ITF1,13,Abruzzo,Abruzzo,1304970,1568300,120.18,0.44
886,2021-01-27,ABR,1365,515,850,37,1328,0,ITF,ITF1,13,Abruzzo,Abruzzo,1304970,1569665,120.28,0.1
887,2021-07-03,ABR,10191,5146,5045,3501,6542,148,ITF,ITF1,13,Abruzzo,Abruzzo,1304970,1579856,121.06,0.78
888,2021-05-21,ABR,13019,6328,6691,7865,4979,175,ITF,ITF1,13,Abruzzo,Abruzzo,1304970,1592875,122.06,1.0
889,2021-03-18,ABR,3898,1652,2246,2039,1832,27,ITF,ITF1,13,Abruzzo,Abruzzo,1304970,1596773,122.36,0.3
890,2021-06-26,ABR,10048,5018,5030,5690,4196,162,ITF,ITF1,13,Abruzzo,Abruzzo,1304970,1606821,123.13,0.77
891,2021-07-10,ABR,13122,6633,6489,3013,9945,164,ITF,ITF1,13,Abruzzo,Abruzzo,1304970,1619943,124.14,1.01
892,2021-05-14,ABR,10596,5071,5525,5284,5151,161,ITF,ITF1,13,Abruzzo,Abruzzo,1304970,1630539,124.95,0.81
893,2021-04-01,ABR,5595,2508,3087,3432,2088,75,ITF,ITF1,13,Abruzzo,Abruzzo,1304970,1636134,125.38,0.43
894,2021-06-02,UMB,3918,1884,2034,3870,42,6,ITI,ITI2,10,Umbria,Umbria,882015,3918,0.44,0.44
895,2021-02-20,UMB,283,101,182,259,24,0,ITI,ITI2,10,Umbria,Umbria,882015,4201,0.48,0.03
896,2021-03-09,UMB,4088,2000,2088,2791,1288,9,ITI,ITI2,10,Umbria,Umbria,882015,8289,0.94,0.46
897,2021-08-10,UMB,7361,3917,3444,3983,3235,143,ITI,ITI2,10,Umbria,Umbria,882015,15650,1.77,0.83
898,2021-06-14,UMB,5377,2744,2633,3355,2010,12,ITI,ITI2,10,Umbria,Umbria,882015,21027,2.38,0.61
899,2021-07-03,UMB,6471,3245,3226,2917,3495,59,ITI,ITI2,10,Umbria,Umbria,882015,27498,3.12,0.73
900,2021-07-20,UMB,8262,4106,4156,1146,7082,34,ITI,ITI2,10,Umbria,Umbria,882015,35760,4.05,0.94
901,2021-07-22,UMB,10040,4897,5143,1697,8286,57,ITI,ITI2,10,Umbria,Umbria,882015,45800,5.19,1.14
902,2021-04-06,UMB,5291,2167,3124,2864,2390,37,ITI,ITI2,10,Umbria,Umbria,882015,51091,5.79,0.6
903,2021-03-28,UMB,1095,441,654,1040,24,31,ITI,ITI2,10,Umbria,Umbria,882015,52186,5.92,0.12
904,2021-01-30,UMB,1575,486,1089,43,1532,0,ITI,ITI2,10,Umbria,Umbria,882015,53761,6.1,0.18
905,2021-07-15,UMB,10562,5175,5387,606,9902,54,ITI,ITI2,10,Umbria,Umbria,882015,64323,7.29,1.2
906,2021-03-23,UMB,3825,1713,2112,2158,1630,37,ITI,ITI2,10,Umbria,Umbria,882015,68148,7.73,0.43
907,2021-07-01,UMB,9681,4792,4889,3356,6282,43,ITI,ITI2,10,Umbria,Umbria,882015,77829,8.82,1.1
908,2021-02-08,UMB,635,203,432,88,547,0,ITI,ITI2,10,Umbria,Umbria,882015,78464,8.9,0.07
909,2021-05-19,UMB,9419,4217,5202,5591,3744,84,ITI,ITI2,10,Umbria,Umbria,882015,87883,9.96,1.07
910,2021-02-06,UMB,404,139,265,34,370,0,ITI,ITI2,10,Umbria,Umbria,882015,88287,10.01,0.05
911,2021-04-23,UMB,6652,2818,3834,3301,3155,196,ITI,ITI2,10,Umbria,Umbria,882015,94939,10.76,0.75
912,2021-02-25,UMB,1333,495,838,1273,52,8,ITI,ITI2,10,Umbria,Umbria,882015,96272,10.92,0.15
913,2021-03-11,UMB,3583,1723,1860,2564,1006,13,ITI,ITI2,10,Umbria,Umbria,882015,99855,11.32,0.41
914,2021-01-13,UMB,449,139,310,449,0,0,ITI,ITI2,10,Umbria,Umbria,882015,100304,11.37,0.05
915,2021-06-19,UMB,4569,2199,2370,2527,2031,11,ITI,ITI2,10,Umbria,Umbria,882015,104873,11.89,0.52
916,2021-01-06,UMB,847,326,521,847,0,0,ITI,ITI2,10,Umbria,Umbria,882015,105720,11.99,0.1
917,2021-06-12,UMB,7715,3686,4029,6111,1579,25,ITI,ITI2,10,Umbria,Umbria,882015,113435,12.86,0.87
918,2021-04-16,UMB,8098,3742,4356,6081,1838,179,ITI,ITI2,10,Umbria,Umbria,882015,121533,13.78,0.92
919,2021-04-30,UMB,6253,2971,3282,2735,3397,121,ITI,ITI2,10,Umbria,Umbria,882015,127786,14.49,0.71
920,2021-03-04,UMB,4485,1855,2630,3644,827,14,ITI,ITI2,10,Umbria,Umbria,882015,132271,15.0,0.51
921,2021-08-08,UMB,5058,2708,2350,3554,1412,92,ITI,ITI2,10,Umbria,Umbria,882015,137329,15.57,0.57
922,2021-01-20,UMB,602,221,381,602,0,0,ITI,ITI2,10,Umbria,Umbria,882015,137931,15.64,0.07
923,2021-07-29,UMB,8190,4219,3971,2189,5925,76,ITI,ITI2,10,Umbria,Umbria,882015,146121,16.57,0.93
924,2021-05-07,UMB,10118,4711,5407,6696,3190,232,ITI,ITI2,10,Umbria,Umbria,882015,156239,17.71,1.15
925,2021-02-13,UMB,114,27,87,111,3,0,ITI,ITI2,10,Umbria,Umbria,882015,156353,17.73,0.01
926,2021-05-24,UMB,9064,4514,4550,8019,880,165,ITI,ITI2,10,Umbria,Umbria,882015,165417,18.75,1.03
927,2021-04-18,UMB,1531,681,850,578,930,23,ITI,ITI2,10,Umbria,Umbria,882015,166948,18.93,0.17
928,2021-01-11,UMB,1304,341,963,1304,0,0,ITI,ITI2,10,Umbria,Umbria,882015,168252,19.08,0.15
929,2021-07-27,UMB,8131,4084,4047,2749,5325,57,ITI,ITI2,10,Umbria,Umbria,882015,176383,20.0,0.92
930,2021-05-05,UMB,7222,3305,3917,3834,3306,82,ITI,ITI2,10,Umbria,Umbria,882015,183605,20.82,0.82
931,2021-01-25,UMB,648,323,325,5,643,0,ITI,ITI2,10,Umbria,Umbria,882015,184253,20.89,0.07
932,2021-04-25,UMB,4358,1685,2673,3866,83,409,ITI,ITI2,10,Umbria,Umbria,882015,188611,21.38,0.49
933,2021-08-03,UMB,9179,4749,4430,3510,5505,164,ITI,ITI2,10,Umbria,Umbria,882015,197790,22.42,1.04
934,2021-06-21,UMB,7501,3933,3568,5153,2338,10,ITI,ITI2,10,Umbria,Umbria,882015,205291,23.28,0.85
935,2021-05-31,UMB,5817,2845,2972,4853,885,79,ITI,ITI2,10,Umbria,Umbria,882015,211108,23.93,0.66
936,2021-05-14,UMB,5331,2512,2819,3355,1819,157,ITI,ITI2,10,Umbria,Umbria,882015,216439,24.54,0.6
937,2021-02-01,UMB,1284,341,943,48,1236,0,ITI,ITI2,10,Umbria,Umbria,882015,217723,24.68,0.15
938,2021-02-18,UMB,1496,582,914,1029,466,1,ITI,ITI2,10,Umbria,Umbria,882015,219219,24.85,0.17
939,2021-01-01,UMB,273,104,169,273,0,0,ITI,ITI2,10,Umbria,Umbria,882015,219492,24.89,0.03
940,2021-04-11,UMB,3099,1505,1594,3033,49,17,ITI,ITI2,10,Umbria,Umbria,882015,222591,25.24,0.35
941,2021-01-18,UMB,615,219,396,529,86,0,ITI,ITI2,10,Umbria,Umbria,882015,223206,25.31,0.07
942,2021-07-08,UMB,9567,4629,4938,180,9342,45,ITI,ITI2,10,Umbria,Umbria,882015,232773,26.39,1.08
943,2021-05-12,UMB,6493,3026,3467,4199,2147,147,ITI,ITI2,10,Umbria,Umbria,882015,239266,27.13,0.74
944,2021-03-30,UMB,3977,1731,2246,2400,1541,36,ITI,ITI2,10,Umbria,Umbria,882015,243243,27.58,0.45
945,2020-12-27,UMB,86,45,41,86,0,0,ITI,ITI2,10,Umbria,Umbria,882015,243329,27.59,0.01
946,2021-05-26,UMB,9653,4567,5086,8207,1251,195,ITI,ITI2,10,Umbria,Umbria,882015,252982,28.68,1.09
947,2021-07-26,UMB,9074,4794,4280,3936,5075,63,ITI,ITI2,10,Umbria,Umbria,882015,262056,29.71,1.03
948,2021-06-30,UMB,10482,5298,5184,3754,6715,13,ITI,ITI2,10,Umbria,Umbria,882015,272538,30.9,1.19
949,2021-03-18,UMB,2967,1171,1796,1699,1263,5,ITI,ITI2,10,Umbria,Umbria,882015,275505,31.24,0.34
950,2021-06-26,UMB,9324,4736,4588,5682,3632,10,ITI,ITI2,10,Umbria,Umbria,882015,284829,32.29,1.06
951,2021-07-10,UMB,7685,3809,3876,72,7605,8,ITI,ITI2,10,Umbria,Umbria,882015,292514,33.16,0.87
952,2021-04-04,UMB,57,20,37,22,35,0,ITI,ITI2,10,Umbria,Umbria,882015,292571,33.17,0.01
953,2021-06-07,UMB,6945,3427,3518,6231,695,19,ITI,ITI2,10,Umbria,Umbria,882015,299516,33.96,0.79
954,2021-03-16,UMB,3538,1454,2084,1909,1627,2,ITI,ITI2,10,Umbria,Umbria,882015,303054,34.36,0.4
955,2021-02-27,UMB,1658,354,1304,1642,16,0,ITI,ITI2,10,Umbria,Umbria,882015,304712,34.55,0.19
956,2021-04-03,UMB,2098,712,1386,1034,1053,11,ITI,ITI2,10,Umbria,Umbria,882015,306810,34.79,0.24
957,2021-07-12,UMB,4620,2235,2385,107,4504,9,ITI,ITI2,10,Umbria,Umbria,882015,311430,35.31,0.52
958,2021-03-06,UMB,4304,1146,3158,4133,138,33,ITI,ITI2,10,Umbria,Umbria,882015,315734,35.8,0.49
959,2021-01-22,UMB,276,105,171,32,244,0,ITI,ITI2,10,Umbria,Umbria,882015,316010,35.83,0.03
960,2021-06-28,UMB,9762,4813,4949,3782,5976,4,ITI,ITI2,10,Umbria,Umbria,882015,325772,36.93,1.11
961,2021-05-02,UMB,3781,1867,1914,1298,2454,29,ITI,ITI2,10,Umbria,Umbria,882015,329553,37.36,0.43
962,2021-03-20,UMB,2319,845,1474,2289,25,5,ITI,ITI2,10,Umbria,Umbria,882015,331872,37.63,0.26
963,2021-08-07,UMB,7220,3796,3424,2537,4611,72,ITI,ITI2,10,Umbria,Umbria,882015,339092,38.45,0.82
964,2021-05-16,UMB,5219,2493,2726,5087,50,82,ITI,ITI2,10,Umbria,Umbria,882015,344311,39.04,0.59
965,2021-08-05,UMB,9653,5059,4594,3834,5664,155,ITI,ITI2,10,Umbria,Umbria,882015,353964,40.13,1.09
966,2021-07-19,UMB,7620,3803,3817,1542,6028,50,ITI,ITI2,10,Umbria,Umbria,882015,361584,41.0,0.86
967,2021-04-27,UMB,5666,2401,3265,3054,2579,33,ITI,ITI2,10,Umbria,Umbria,882015,367250,41.64,0.64
968,2021-02-03,UMB,724,174,550,67,657,0,ITI,ITI2,10,Umbria,Umbria,882015,367974,41.72,0.08
969,2021-05-30,UMB,5982,2999,2983,5664,202,116,ITI,ITI2,10,Umbria,Umbria,882015,373956,42.4,0.68
970,2021-03-08,UMB,3698,1824,1874,2324,1361,13,ITI,ITI2,10,Umbria,Umbria,882015,377654,42.82,0.42
971,2021-06-16,UMB,6319,3093,3226,3217,3096,6,ITI,ITI2,10,Umbria,Umbria,882015,383973,43.53,0.72
972,2021-03-25,UMB,3931,1724,2207,2822,1064,45,ITI,ITI2,10,Umbria,Umbria,882015,387904,43.98,0.45
973,2021-03-27,UMB,4251,1513,2738,3855,340,56,ITI,ITI2,10,Umbria,Umbria,882015,392155,44.46,0.48
974,2021-02-22,UMB,1889,807,1082,1803,86,0,ITI,ITI2,10,Umbria,Umbria,882015,394044,44.68,0.21
975,2021-06-11,UMB,6994,3515,3479,6202,770,22,ITI,ITI2,10,Umbria,Umbria,882015,401038,45.47,0.79
976,2021-05-28,UMB,9593,4439,5154,7112,2299,182,ITI,ITI2,10,Umbria,Umbria,882015,410631,46.56,1.09
977,2021-04-15,UMB,7657,3502,4155,5699,1887,71,ITI,ITI2,10,Umbria,Umbria,882015,418288,47.42,0.87
978,2021-02-17,UMB,1618,748,870,1266,351,1,ITI,ITI2,10,Umbria,Umbria,882015,419906,47.61,0.18
979,2021-07-24,UMB,8696,4369,4327,1383,7282,31,ITI,ITI2,10,Umbria,Umbria,882015,428602,48.59,0.99
980,2021-04-13,UMB,7679,3399,4280,5921,1669,89,ITI,ITI2,10,Umbria,Umbria,882015,436281,49.46,0.87
981,2021-02-15,UMB,1367,692,675,1364,1,2,ITI,ITI2,10,Umbria,Umbria,882015,437648,49.62,0.15
982,2021-01-03,UMB,270,112,158,270,0,0,ITI,ITI2,10,Umbria,Umbria,882015,437918,49.65,0.03
983,2021-01-08,UMB,1187,344,843,1187,0,0,ITI,ITI2,10,Umbria,Umbria,882015,439105,49.78,0.13
984,2021-05-23,UMB,5069,1855,3214,636,4417,16,ITI,ITI2,10,Umbria,Umbria,882015,444174,50.36,0.57
985,2021-02-05,UMB,780,234,546,18,762,0,ITI,ITI2,10,Umbria,Umbria,882015,444954,50.45,0.09
986,2021-07-21,UMB,9840,4911,4929,1261,8528,51,ITI,ITI2,10,Umbria,Umbria,882015,454794,51.56,1.12
987,2021-03-13,UMB,1735,524,1211,1486,249,0,ITI,ITI2,10,Umbria,Umbria,882015,456529,51.76,0.2
988,2021-01-15,UMB,695,213,482,695,0,0,ITI,ITI2,10,Umbria,Umbria,882015,457224,51.84,0.08
989,2021-01-29,UMB,1232,350,882,79,1153,0,ITI,ITI2,10,Umbria,Umbria,882015,458456,51.98,0.14
990,2021-05-09,UMB,5755,2753,3002,5244,391,120,ITI,ITI2,10,Umbria,Umbria,882015,464211,52.63,0.65
991,2021-07-09,UMB,9559,4629,4930,139,9406,14,ITI,ITI2,10,Umbria,Umbria,882015,473770,53.71,1.08
992,2021-07-23,UMB,10641,5443,5198,1373,9211,57,ITI,ITI2,10,Umbria,Umbria,882015,484411,54.92,1.21
993,2021-06-18,UMB,4774,2355,2419,1611,3158,5,ITI,ITI2,10,Umbria,Umbria,882015,489185,55.46,0.54
994,2021-07-05,UMB,8413,4079,4334,161,8245,7,ITI,ITI2,10,Umbria,Umbria,882015,497598,56.42,0.95
995,2021-05-13,UMB,5921,2660,3261,3707,2085,129,ITI,ITI2,10,Umbria,Umbria,882015,503519,57.09,0.67
996,2021-02-19,UMB,743,293,450,525,217,1,ITI,ITI2,10,Umbria,Umbria,882015,504262,57.17,0.08
997,2021-07-31,UMB,4325,2258,2067,1492,2803,30,ITI,ITI2,10,Umbria,Umbria,882015,508587,57.66,0.49
998,2021-04-22,UMB,5454,2250,3204,2702,2670,82,ITI,ITI2,10,Umbria,Umbria,882015,514041,58.28,0.62
999,2021-04-17,UMB,6690,3072,3618,5182,1341,167,ITI,ITI2,10,Umbria,Umbria,882015,520731,59.04,0.76
1000,2021-04-08,UMB,5866,2509,3357,4005,1791,70,ITI,ITI2,10,Umbria,Umbria,882015,526597,59.7,0.67
1001,2021-07-17,UMB,7664,3855,3809,1365,6231,68,ITI,ITI2,10,Umbria,Umbria,882015,534261,60.57,0.87
1002,2021-06-04,UMB,8917,4407,4510,7694,1201,22,ITI,ITI2,10,Umbria,Umbria,882015,543178,61.58,1.01
1003,2021-06-13,UMB,6763,3556,3207,6524,230,9,ITI,ITI2,10,Umbria,Umbria,882015,549941,62.35,0.77
1004,2021-05-01,UMB,5370,2638,2732,2096,3230,44,ITI,ITI2,10,Umbria,Umbria,882015,555311,62.96,0.61
1005,2021-04-20,UMB,5450,2364,3086,3430,1947,73,ITI,ITI2,10,Umbria,Umbria,882015,560761,63.58,0.62
1006,2021-01-27,UMB,841,330,511,13,828,0,ITI,ITI2,10,Umbria,Umbria,882015,561602,63.67,0.1
1007,2021-01-10,UMB,1065,274,791,1065,0,0,ITI,ITI2,10,Umbria,Umbria,882015,562667,63.79,0.12
1008,2021-05-21,UMB,8977,3671,5306,4063,4829,85,ITI,ITI2,10,Umbria,Umbria,882015,571644,64.81,1.02
1009,2021-05-04,UMB,5539,2545,2994,2353,3125,61,ITI,ITI2,10,Umbria,Umbria,882015,577183,65.44,0.63
1010,2021-04-01,UMB,4373,1837,2536,2326,2010,37,ITI,ITI2,10,Umbria,Umbria,882015,581556,65.93,0.5
1011,2021-03-01,UMB,1505,775,730,1385,114,6,ITI,ITI2,10,Umbria,Umbria,882015,583061,66.11,0.17
1012,2021-06-09,UMB,8151,3948,4203,7395,723,33,ITI,ITI2,10,Umbria,Umbria,882015,591212,67.03,0.92
1013,2021-06-23,UMB,11210,5731,5479,7783,3406,21,ITI,ITI2,10,Umbria,Umbria,882015,602422,68.3,1.27
1014,2021-07-04,UMB,3406,1740,1666,2406,968,32,ITI,ITI2,10,Umbria,Umbria,882015,605828,68.69,0.39
1015,2021-04-12,UMB,7085,3081,4004,5311,1717,57,ITI,ITI2,10,Umbria,Umbria,882015,612913,69.49,0.8
1016,2021-01-19,UMB,102,23,79,102,0,0,ITI,ITI2,10,Umbria,Umbria,882015,613015,69.5,0.01
1017,2021-04-29,UMB,5215,2250,2965,2807,2320,88,ITI,ITI2,10,Umbria,Umbria,882015,618230,70.09,0.59
1018,2021-03-24,UMB,4104,1792,2312,2744,1323,37,ITI,ITI2,10,Umbria,Umbria,882015,622334,70.56,0.47
1019,2021-07-02,UMB,8738,4324,4414,3046,5601,91,ITI,ITI2,10,Umbria,Umbria,882015,631072,71.55,0.99
1020,2021-04-10,UMB,7394,3479,3915,7177,84,133,ITI,ITI2,10,Umbria,Umbria,882015,638466,72.39,0.84
1021,2021-01-17,UMB,54,17,37,54,0,0,ITI,ITI2,10,Umbria,Umbria,882015,638520,72.39,0.01
1022,2020-12-31,UMB,322,127,195,322,0,0,ITI,ITI2,10,Umbria,Umbria,882015,638842,72.43,0.04
1023,2021-03-17,UMB,3329,1313,2016,1855,1472,2,ITI,ITI2,10,Umbria,Umbria,882015,642171,72.81,0.38
1024,2021-01-07,UMB,1301,388,913,1301,0,0,ITI,ITI2,10,Umbria,Umbria,882015,643472,72.95,0.15
1025,2021-07-16,UMB,9620,4895,4725,702,8877,41,ITI,ITI2,10,Umbria,Umbria,882015,653092,74.05,1.09
1026,2021-05-20,UMB,9853,4600,5253,6105,3658,90,ITI,ITI2,10,Umbria,Umbria,882015,662945,75.16,1.12
1027,2021-08-04,UMB,10615,5520,5095,3303,7160,152,ITI,ITI2,10,Umbria,Umbria,882015,673560,76.37,1.2
1028,2021-03-05,UMB,4618,1402,3216,3947,656,15,ITI,ITI2,10,Umbria,Umbria,882015,678178,76.89,0.52
1029,2021-08-09,UMB,6667,3537,3130,3497,3012,158,ITI,ITI2,10,Umbria,Umbria,882015,684845,77.65,0.76
1030,2021-03-03,UMB,4432,1772,2660,3718,711,3,ITI,ITI2,10,Umbria,Umbria,882015,689277,78.15,0.5
1031,2021-08-11,UMB,5954,3162,2792,3030,2786,138,ITI,ITI2,10,Umbria,Umbria,882015,695231,78.82,0.68
1032,2021-06-06,UMB,7609,3905,3704,6901,694,14,ITI,ITI2,10,Umbria,Umbria,882015,702840,79.69,0.86
1033,2021-02-24,UMB,1518,563,955,1503,15,0,ITI,ITI2,10,Umbria,Umbria,882015,704358,79.86,0.17
1034,2021-01-05,UMB,854,429,425,854,0,0,ITI,ITI2,10,Umbria,Umbria,882015,705212,79.95,0.1
1035,2021-08-02,UMB,5525,2892,2633,262,5247,16,ITI,ITI2,10,Umbria,Umbria,882015,710737,80.58,0.63
1036,2021-06-20,UMB,6218,3006,3212,1613,4603,2,ITI,ITI2,10,Umbria,Umbria,882015,716955,81.29,0.7
1037,2021-04-24,UMB,4562,1961,2601,3274,1183,105,ITI,ITI2,10,Umbria,Umbria,882015,721517,81.8,0.52
1038,2021-06-15,UMB,5979,3013,2966,3891,2069,19,ITI,ITI2,10,Umbria,Umbria,882015,727496,82.48,0.68
1039,2021-06-17,UMB,6968,3542,3426,4860,2079,29,ITI,ITI2,10,Umbria,Umbria,882015,734464,83.27,0.79
1040,2021-03-26,UMB,4594,1716,2878,4346,172,76,ITI,ITI2,10,Umbria,Umbria,882015,739058,83.79,0.52
1041,2021-03-15,UMB,4597,1941,2656,2827,1767,3,ITI,ITI2,10,Umbria,Umbria,882015,743655,84.31,0.52
1042,2021-02-10,UMB,715,350,365,700,15,0,ITI,ITI2,10,Umbria,Umbria,882015,744370,84.39,0.08
1043,2021-01-24,UMB,258,106,152,1,257,0,ITI,ITI2,10,Umbria,Umbria,882015,744628,84.42,0.03
1044,2021-06-25,UMB,10181,5290,4891,5387,4774,20,ITI,ITI2,10,Umbria,Umbria,882015,754809,85.58,1.15
1045,2021-01-26,UMB,815,389,426,17,798,0,ITI,ITI2,10,Umbria,Umbria,882015,755624,85.67,0.09
1046,2021-02-12,UMB,671,224,447,665,6,0,ITI,ITI2,10,Umbria,Umbria,882015,756295,85.75,0.08
1047,2021-02-26,UMB,660,253,407,650,8,2,ITI,ITI2,10,Umbria,Umbria,882015,756955,85.82,0.07
1048,2021-05-06,UMB,9457,4317,5140,6022,3314,121,ITI,ITI2,10,Umbria,Umbria,882015,766412,86.89,1.07
1049,2021-03-31,UMB,3896,1727,2169,2179,1685,32,ITI,ITI2,10,Umbria,Umbria,882015,770308,87.34,0.44
1050,2021-02-16,UMB,1308,655,653,1299,9,0,ITI,ITI2,10,Umbria,Umbria,882015,771616,87.48,0.15
1051,2021-05-27,UMB,9972,4865,5107,8473,1318,181,ITI,ITI2,10,Umbria,Umbria,882015,781588,88.61,1.13
1052,2021-01-04,UMB,809,398,411,809,0,0,ITI,ITI2,10,Umbria,Umbria,882015,782397,88.71,0.09
1053,2021-04-14,UMB,8154,3681,4473,6098,1979,77,ITI,ITI2,10,Umbria,Umbria,882015,790551,89.63,0.92
1054,2021-06-01,UMB,4383,2089,2294,4221,156,6,ITI,ITI2,10,Umbria,Umbria,882015,794934,90.13,0.5
1055,2021-03-10,UMB,4031,1943,2088,2759,1257,15,ITI,ITI2,10,Umbria,Umbria,882015,798965,90.58,0.46
1056,2021-01-16,UMB,217,71,146,216,0,1,ITI,ITI2,10,Umbria,Umbria,882015,799182,90.61,0.02
1057,2021-02-02,UMB,943,272,671,32,911,0,ITI,ITI2,10,Umbria,Umbria,882015,800125,90.72,0.11
1058,2021-04-26,UMB,5398,2341,3057,3103,2255,40,ITI,ITI2,10,Umbria,Umbria,882015,805523,91.33,0.61
1059,2021-07-06,UMB,8593,4093,4500,152,8420,21,ITI,ITI2,10,Umbria,Umbria,882015,814116,92.3,0.97
1060,2021-05-10,UMB,5996,2802,3194,3760,2151,85,ITI,ITI2,10,Umbria,Umbria,882015,820112,92.98,0.68
1061,2021-05-08,UMB,8142,3743,4399,4799,3241,102,ITI,ITI2,10,Umbria,Umbria,882015,828254,93.9,0.92
1062,2021-01-28,UMB,1248,394,854,18,1230,0,ITI,ITI2,10,Umbria,Umbria,882015,829502,94.05,0.14
1063,2021-01-12,UMB,835,247,588,835,0,0,ITI,ITI2,10,Umbria,Umbria,882015,830337,94.14,0.09
1064,2021-03-14,UMB,66,48,18,66,0,0,ITI,ITI2,10,Umbria,Umbria,882015,830403,94.15,0.01
1065,2021-06-22,UMB,8038,4081,3957,5232,2793,13,ITI,ITI2,10,Umbria,Umbria,882015,838441,95.06,0.91
1066,2021-03-12,UMB,2695,1082,1613,2191,496,8,ITI,ITI2,10,Umbria,Umbria,882015,841136,95.37,0.31
1067,2021-06-08,UMB,7378,3641,3737,6799,547,32,ITI,ITI2,10,Umbria,Umbria,882015,848514,96.2,0.84
1068,2021-01-02,UMB,304,111,193,304,0,0,ITI,ITI2,10,Umbria,Umbria,882015,848818,96.24,0.03
1069,2021-03-07,UMB,845,180,665,837,7,1,ITI,ITI2,10,Umbria,Umbria,882015,849663,96.33,0.1
1070,2021-05-29,UMB,7858,3612,4246,6177,1567,114,ITI,ITI2,10,Umbria,Umbria,882015,857521,97.22,0.89
1071,2021-06-10,UMB,7553,3762,3791,6732,784,37,ITI,ITI2,10,Umbria,Umbria,882015,865074,98.08,0.86
1072,2021-06-03,UMB,9042,4470,4572,8728,289,25,ITI,ITI2,10,Umbria,Umbria,882015,874116,99.1,1.03
1073,2021-04-07,UMB,5597,2297,3300,3506,2006,85,ITI,ITI2,10,Umbria,Umbria,882015,879713,99.74,0.63
1074,2021-02-23,UMB,1691,657,1034,1649,42,0,ITI,ITI2,10,Umbria,Umbria,882015,881404,99.93,0.19
1075,2021-04-09,UMB,6740,3127,3613,6407,215,118,ITI,ITI2,10,Umbria,Umbria,882015,888144,100.69,0.76
1076,2021-04-28,UMB,5390,2330,3060,2950,2396,44,ITI,ITI2,10,Umbria,Umbria,882015,893534,101.31,0.61
1077,2021-08-06,UMB,8148,4239,3909,3290,4774,84,ITI,ITI2,10,Umbria,Umbria,882015,901682,102.23,0.92
1078,2021-02-04,UMB,734,226,508,26,708,0,ITI,ITI2,10,Umbria,Umbria,882015,902416,102.31,0.08
1079,2021-05-15,UMB,4992,1883,3109,1765,3164,63,ITI,ITI2,10,Umbria,Umbria,882015,907408,102.88,0.57
1080,2021-02-21,UMB,1,0,1,1,0,0,ITI,ITI2,10,Umbria,Umbria,882015,907409,102.88,0.0
1081,2021-05-03,UMB,5087,2271,2816,2096,2887,104,ITI,ITI2,10,Umbria,Umbria,882015,912496,103.46,0.58
1082,2021-01-23,UMB,280,100,180,2,278,0,ITI,ITI2,10,Umbria,Umbria,882015,912776,103.49,0.03
1083,2021-01-21,UMB,608,202,406,338,269,1,ITI,ITI2,10,Umbria,Umbria,882015,913384,103.56,0.07
1084,2021-06-27,UMB,7459,3732,3727,1784,5671,4,ITI,ITI2,10,Umbria,Umbria,882015,920843,104.4,0.85
1085,2021-07-28,UMB,8233,4331,3902,3023,5151,59,ITI,ITI2,10,Umbria,Umbria,882015,929076,105.34,0.93
1086,2021-03-21,UMB,675,338,337,672,0,3,ITI,ITI2,10,Umbria,Umbria,882015,929751,105.41,0.08
1087,2021-06-29,UMB,9889,5035,4854,4184,5691,14,ITI,ITI2,10,Umbria,Umbria,882015,939640,106.53,1.12
1088,2021-05-17,UMB,6371,3062,3309,4134,2179,58,ITI,ITI2,10,Umbria,Umbria,882015,946011,107.26,0.72
1089,2021-01-14,UMB,723,192,531,723,0,0,ITI,ITI2,10,Umbria,Umbria,882015,946734,107.34,0.08
1090,2021-03-19,UMB,1743,565,1178,1082,656,5,ITI,ITI2,10,Umbria,Umbria,882015,948477,107.54,0.2
1091,2021-07-13,UMB,4230,2006,2224,81,4143,6,ITI,ITI2,10,Umbria,Umbria,882015,952707,108.01,0.48
1092,2021-04-21,UMB,5326,2319,3007,3058,2230,38,ITI,ITI2,10,Umbria,Umbria,882015,958033,108.62,0.6
1093,2021-07-30,UMB,6192,3228,2964,3236,2894,62,ITI,ITI2,10,Umbria,Umbria,882015,964225,109.32,0.7
1094,2021-03-02,UMB,3642,1346,2296,3635,4,3,ITI,ITI2,10,Umbria,Umbria,882015,967867,109.73,0.41
1095,2021-06-24,UMB,10153,5116,5037,6124,4007,22,ITI,ITI2,10,Umbria,Umbria,882015,978020,110.88,1.15
1096,2021-02-11,UMB,839,348,491,834,5,0,ITI,ITI2,10,Umbria,Umbria,882015,978859,110.98,0.1
1097,2021-05-22,UMB,6973,2755,4218,2601,4326,46,ITI,ITI2,10,Umbria,Umbria,882015,985832,111.77,0.79
1098,2021-07-11,UMB,5874,2966,2908,89,5784,1,ITI,ITI2,10,Umbria,Umbria,882015,991706,112.44,0.67
1099,2021-04-02,UMB,4343,1778,2565,3544,755,44,ITI,ITI2,10,Umbria,Umbria,882015,996049,112.93,0.49
1100,2021-01-09,UMB,1717,495,1222,1717,0,0,ITI,ITI2,10,Umbria,Umbria,882015,997766,113.12,0.19
1101,2021-04-19,UMB,5036,2227,2809,2933,2048,55,ITI,ITI2,10,Umbria,Umbria,882015,1002802,113.69,0.57
1102,2021-07-07,UMB,9490,4498,4992,92,9371,27,ITI,ITI2,10,Umbria,Umbria,882015,1012292,114.77,1.08
1103,2021-05-11,UMB,6239,2837,3402,3905,2193,141,ITI,ITI2,10,Umbria,Umbria,882015,1018531,115.48,0.71
1104,2021-03-29,UMB,3632,1602,2030,2152,1422,58,ITI,ITI2,10,Umbria,Umbria,882015,1022163,115.89,0.41
1105,2021-01-31,UMB,1058,276,782,25,1033,0,ITI,ITI2,10,Umbria,Umbria,882015,1023221,116.01,0.12
1106,2021-05-25,UMB,8816,4301,4515,7585,1063,168,ITI,ITI2,10,Umbria,Umbria,882015,1032037,117.01,1.0
1107,2021-05-18,UMB,7751,3357,4394,3828,3841,82,ITI,ITI2,10,Umbria,Umbria,882015,1039788,117.89,0.88
1108,2021-03-22,UMB,3561,1656,1905,2305,1246,10,ITI,ITI2,10,Umbria,Umbria,882015,1043349,118.29,0.4
1109,2021-04-05,UMB,4249,1729,2520,2182,2055,12,ITI,ITI2,10,Umbria,Umbria,882015,1047598,118.77,0.48
1110,2021-02-07,UMB,54,17,37,1,53,0,ITI,ITI2,10,Umbria,Umbria,882015,1047652,118.78,0.01
1111,2021-07-14,UMB,6196,3007,3189,1747,4261,188,ITI,ITI2,10,Umbria,Umbria,882015,1053848,119.48,0.7
1112,2021-08-01,UMB,3018,1529,1489,1339,1650,29,ITI,ITI2,10,Umbria,Umbria,882015,1056866,119.82,0.34
1113,2021-07-18,UMB,7853,4063,3790,296,7553,4,ITI,ITI2,10,Umbria,Umbria,882015,1064719,120.71,0.89
1114,2021-06-05,UMB,8225,3775,4450,5553,2655,17,ITI,ITI2,10,Umbria,Umbria,882015,1072944,121.65,0.93
1115,2021-07-25,UMB,7305,3849,3456,1193,6095,17,ITI,ITI2,10,Umbria,Umbria,882015,1080249,122.48,0.83
1116,2021-02-18,LAZ,10026,4979,5047,9102,819,105,ITI,ITI4,12,Lazio,Lazio,5879082,10026,0.17,0.17
1117,2021-05-12,LAZ,47600,21608,25992,30285,16677,638,ITI,ITI4,12,Lazio,Lazio,5879082,57626,0.98,0.81
1118,2021-02-01,LAZ,5683,2184,3499,353,5329,1,ITI,ITI4,12,Lazio,Lazio,5879082,63309,1.08,0.1
1119,2021-07-15,LAZ,44941,22003,22938,6705,37826,410,ITI,ITI4,12,Lazio,Lazio,5879082,108250,1.84,0.76
1120,2021-01-13,LAZ,5805,2191,3614,5643,0,162,ITI,ITI4,12,Lazio,Lazio,5879082,114055,1.94,0.1
1121,2021-03-16,LAZ,13596,5765,7831,7048,6468,80,ITI,ITI4,12,Lazio,Lazio,5879082,127651,2.17,0.23
1122,2021-03-09,LAZ,22020,9945,12075,16445,5221,354,ITI,ITI4,12,Lazio,Lazio,5879082,149671,2.55,0.37
1123,2021-01-11,LAZ,5661,2147,3514,5515,0,146,ITI,ITI4,12,Lazio,Lazio,5879082,155332,2.64,0.1
1124,2021-05-26,LAZ,47630,21902,25728,34854,12126,650,ITI,ITI4,12,Lazio,Lazio,5879082,202962,3.45,0.81
1125,2021-03-04,LAZ,19458,8741,10717,14190,5033,235,ITI,ITI4,12,Lazio,Lazio,5879082,222420,3.78,0.33
1126,2021-06-12,LAZ,69913,32109,37804,39883,29400,630,ITI,ITI4,12,Lazio,Lazio,5879082,292333,4.97,1.19
1127,2021-06-14,LAZ,63057,29544,33513,32324,30179,554,ITI,ITI4,12,Lazio,Lazio,5879082,355390,6.04,1.07
1128,2021-03-21,LAZ,18288,7201,11087,13026,5071,191,ITI,ITI4,12,Lazio,Lazio,5879082,373678,6.36,0.31
1129,2020-12-30,LAZ,1654,638,1016,1643,0,11,ITI,ITI4,12,Lazio,Lazio,5879082,375332,6.38,0.03
1130,2021-02-20,LAZ,9212,4274,4938,8366,775,71,ITI,ITI4,12,Lazio,Lazio,5879082,384544,6.54,0.16
1131,2021-05-31,LAZ,51776,23054,28722,30865,19887,1024,ITI,ITI4,12,Lazio,Lazio,5879082,436320,7.42,0.88
1132,2021-04-04,LAZ,17665,8199,9466,12262,5291,112,ITI,ITI4,12,Lazio,Lazio,5879082,453985,7.72,0.3
1133,2021-07-22,LAZ,61098,30519,30579,28506,31100,1492,ITI,ITI4,12,Lazio,Lazio,5879082,515083,8.76,1.04
1134,2021-05-17,LAZ,44622,20432,24190,35614,8604,404,ITI,ITI4,12,Lazio,Lazio,5879082,559705,9.52,0.76
1135,2021-02-06,LAZ,6223,2538,3685,895,5324,4,ITI,ITI4,12,Lazio,Lazio,5879082,565928,9.63,0.11
1136,2021-08-08,LAZ,49845,25752,24093,17702,31332,811,ITI,ITI4,12,Lazio,Lazio,5879082,615773,10.47,0.85
1137,2021-06-26,LAZ,56199,26484,29715,24706,30903,590,ITI,ITI4,12,Lazio,Lazio,5879082,671972,11.43,0.96
1138,2021-04-30,LAZ,41691,18473,23218,26677,14359,655,ITI,ITI4,12,Lazio,Lazio,5879082,713663,12.14,0.71
1139,2021-06-19,LAZ,66528,31388,35140,35280,30440,808,ITI,ITI4,12,Lazio,Lazio,5879082,780191,13.27,1.13
1140,2021-04-16,LAZ,34545,15753,18792,21966,12197,382,ITI,ITI4,12,Lazio,Lazio,5879082,814736,13.86,0.59
1141,2021-01-23,LAZ,7214,2869,4345,585,6629,0,ITI,ITI4,12,Lazio,Lazio,5879082,821950,13.98,0.12
1142,2021-01-06,LAZ,5195,1989,3206,5075,0,120,ITI,ITI4,12,Lazio,Lazio,5879082,827145,14.07,0.09
1143,2021-03-30,LAZ,27098,13175,13923,19539,7206,353,ITI,ITI4,12,Lazio,Lazio,5879082,854243,14.53,0.46
1144,2021-07-08,LAZ,64251,31541,32710,28171,35418,662,ITI,ITI4,12,Lazio,Lazio,5879082,918494,15.62,1.09
1145,2021-07-27,LAZ,56284,27311,28973,8035,47926,323,ITI,ITI4,12,Lazio,Lazio,5879082,974778,16.58,0.96
1146,2021-04-18,LAZ,23863,10604,13259,15893,7697,273,ITI,ITI4,12,Lazio,Lazio,5879082,998641,16.99,0.41
1147,2021-01-25,LAZ,8120,3251,4869,775,7345,0,ITI,ITI4,12,Lazio,Lazio,5879082,1006761,17.12,0.14
1148,2021-05-05,LAZ,46837,21492,25345,30419,15859,559,ITI,ITI4,12,Lazio,Lazio,5879082,1053598,17.92,0.8
1149,2021-03-02,LAZ,17232,7629,9603,13112,3955,165,ITI,ITI4,12,Lazio,Lazio,5879082,1070830,18.21,0.29
1150,2021-01-18,LAZ,6386,2603,3783,5279,981,126,ITI,ITI4,12,Lazio,Lazio,5879082,1077216,18.32,0.11
1151,2021-04-28,LAZ,33027,15069,17958,20978,11658,391,ITI,ITI4,12,Lazio,Lazio,5879082,1110243,18.88,0.56
1152,2021-04-23,LAZ,37966,18286,19680,22117,15395,454,ITI,ITI4,12,Lazio,Lazio,5879082,1148209,19.53,0.65
1153,2021-08-03,LAZ,26274,13131,13143,3393,22753,128,ITI,ITI4,12,Lazio,Lazio,5879082,1174483,19.98,0.45
1154,2021-01-30,LAZ,7020,2897,4123,813,6206,1,ITI,ITI4,12,Lazio,Lazio,5879082,1181503,20.1,0.12
1155,2021-07-19,LAZ,63115,31029,32086,28320,33686,1109,ITI,ITI4,12,Lazio,Lazio,5879082,1244618,21.17,1.07
1156,2021-01-15,LAZ,6706,2757,3949,6536,0,170,ITI,ITI4,12,Lazio,Lazio,5879082,1251324,21.28,0.11
1157,2021-04-25,LAZ,24580,11280,13300,16422,7874,284,ITI,ITI4,12,Lazio,Lazio,5879082,1275904,21.7,0.42
1158,2021-07-01,LAZ,48479,23183,25296,7186,41084,209,ITI,ITI4,12,Lazio,Lazio,5879082,1324383,22.53,0.82
1159,2021-04-09,LAZ,27705,12612,15093,19144,8272,289,ITI,ITI4,12,Lazio,Lazio,5879082,1352088,23.0,0.47
1160,2021-03-23,LAZ,25462,11953,13509,18476,6635,351,ITI,ITI4,12,Lazio,Lazio,5879082,1377550,23.43,0.43
1161,2021-02-15,LAZ,8037,3547,4490,7310,643,84,ITI,ITI4,12,Lazio,Lazio,5879082,1385587,23.57,0.14
1162,2021-01-29,LAZ,8065,3091,4974,817,7246,2,ITI,ITI4,12,Lazio,Lazio,5879082,1393652,23.71,0.14
1163,2021-03-28,LAZ,19190,7832,11358,13541,5313,336,ITI,ITI4,12,Lazio,Lazio,5879082,1412842,24.03,0.33
1164,2021-02-11,LAZ,7000,3011,3989,6442,533,25,ITI,ITI4,12,Lazio,Lazio,5879082,1419842,24.15,0.12
1165,2021-04-11,LAZ,19233,8527,10706,13144,5925,164,ITI,ITI4,12,Lazio,Lazio,5879082,1439075,24.48,0.33
1166,2021-02-13,LAZ,6611,2626,3985,6146,419,46,ITI,ITI4,12,Lazio,Lazio,5879082,1445686,24.59,0.11
1167,2021-07-20,LAZ,63312,31596,31716,28437,33681,1194,ITI,ITI4,12,Lazio,Lazio,5879082,1508998,25.67,1.08
1168,2021-05-24,LAZ,44017,20190,23827,33567,9799,651,ITI,ITI4,12,Lazio,Lazio,5879082,1553015,26.42,0.75
1169,2021-01-03,LAZ,5337,2011,3326,5278,0,59,ITI,ITI4,12,Lazio,Lazio,5879082,1558352,26.51,0.09
1170,2021-04-13,LAZ,25825,11975,13850,17686,7746,393,ITI,ITI4,12,Lazio,Lazio,5879082,1584177,26.95,0.44
1171,2021-07-31,LAZ,55923,29404,26519,5491,50134,298,ITI,ITI4,12,Lazio,Lazio,5879082,1640100,27.9,0.95
1172,2021-05-07,LAZ,48298,22641,25657,30093,17796,409,ITI,ITI4,12,Lazio,Lazio,5879082,1688398,28.72,0.82
1173,2021-03-11,LAZ,25500,12027,13473,18870,6282,348,ITI,ITI4,12,Lazio,Lazio,5879082,1713898,29.15,0.43
1174,2021-07-03,LAZ,53209,25052,28157,4638,48429,142,ITI,ITI4,12,Lazio,Lazio,5879082,1767107,30.06,0.91
1175,2021-02-03,LAZ,6493,2491,4002,960,5526,7,ITI,ITI4,12,Lazio,Lazio,5879082,1773600,30.17,0.11
1176,2021-02-25,LAZ,12776,5595,7181,11409,1180,187,ITI,ITI4,12,Lazio,Lazio,5879082,1786376,30.39,0.22
1177,2021-06-05,LAZ,66324,32677,33647,42893,22766,665,ITI,ITI4,12,Lazio,Lazio,5879082,1852700,31.51,1.13
1178,2021-08-10,LAZ,49851,25716,24135,20892,28031,928,ITI,ITI4,12,Lazio,Lazio,5879082,1902551,32.36,0.85
1179,2021-05-19,LAZ,47284,21720,25564,36536,10145,603,ITI,ITI4,12,Lazio,Lazio,5879082,1949835,33.17,0.8
1180,2021-01-04,LAZ,7573,2940,4633,7469,0,104,ITI,ITI4,12,Lazio,Lazio,5879082,1957408,33.29,0.13
1181,2021-06-24,LAZ,63986,30521,33465,28610,34725,651,ITI,ITI4,12,Lazio,Lazio,5879082,2021394,34.38,1.09
1182,2021-06-07,LAZ,62615,29304,33311,32701,29323,591,ITI,ITI4,12,Lazio,Lazio,5879082,2084009,35.45,1.07
1183,2021-06-21,LAZ,61985,28797,33188,28490,32889,606,ITI,ITI4,12,Lazio,Lazio,5879082,2145994,36.5,1.05
1184,2021-03-27,LAZ,26542,10798,15744,19482,6516,544,ITI,ITI4,12,Lazio,Lazio,5879082,2172536,36.95,0.45
1185,2021-07-05,LAZ,61671,29687,31984,25602,35009,1060,ITI,ITI4,12,Lazio,Lazio,5879082,2234207,38.0,1.05
1186,2021-05-23,LAZ,47165,22885,24280,39122,7400,643,ITI,ITI4,12,Lazio,Lazio,5879082,2281372,38.8,0.8
1187,2021-05-09,LAZ,37563,17268,20295,25831,11284,448,ITI,ITI4,12,Lazio,Lazio,5879082,2318935,39.44,0.64
1188,2021-07-12,LAZ,41388,20704,20684,5858,35304,226,ITI,ITI4,12,Lazio,Lazio,5879082,2360323,40.15,0.7
1189,2021-05-16,LAZ,51008,24567,26441,36961,13510,537,ITI,ITI4,12,Lazio,Lazio,5879082,2411331,41.02,0.87
1190,2021-04-06,LAZ,24635,11276,13359,17145,7172,318,ITI,ITI4,12,Lazio,Lazio,5879082,2435966,41.43,0.42
1191,2020-12-27,LAZ,274,132,142,274,0,0,ITI,ITI4,12,Lazio,Lazio,5879082,2436240,41.44,0.0
1192,2021-03-20,LAZ,19275,7673,11602,13090,5923,262,ITI,ITI4,12,Lazio,Lazio,5879082,2455515,41.77,0.33
1193,2021-02-17,LAZ,9194,4606,4588,8240,885,69,ITI,ITI4,12,Lazio,Lazio,5879082,2464709,41.92,0.16
1194,2021-05-28,LAZ,57240,26620,30620,43128,13325,787,ITI,ITI4,12,Lazio,Lazio,5879082,2521949,42.9,0.97
1195,2021-03-06,LAZ,18393,7095,11298,13901,4273,219,ITI,ITI4,12,Lazio,Lazio,5879082,2540342,43.21,0.31
1196,2021-06-09,LAZ,70432,33329,37103,35977,33822,633,ITI,ITI4,12,Lazio,Lazio,5879082,2610774,44.41,1.2
1197,2021-04-27,LAZ,30828,13921,16907,19471,10954,403,ITI,ITI4,12,Lazio,Lazio,5879082,2641602,44.93,0.52
1198,2021-03-01,LAZ,17126,7371,9755,13004,3886,236,ITI,ITI4,12,Lazio,Lazio,5879082,2658728,45.22,0.29
1199,2021-08-05,LAZ,28859,14720,14139,18715,9258,886,ITI,ITI4,12,Lazio,Lazio,5879082,2687587,45.71,0.49
1200,2021-02-22,LAZ,11465,4994,6471,10808,503,154,ITI,ITI4,12,Lazio,Lazio,5879082,2699052,45.91,0.2
1201,2021-06-02,LAZ,43509,21593,21916,31434,11527,548,ITI,ITI4,12,Lazio,Lazio,5879082,2742561,46.65,0.74
1202,2021-01-08,LAZ,7905,2965,4940,7708,0,197,ITI,ITI4,12,Lazio,Lazio,5879082,2750466,46.78,0.13
1203,2021-07-29,LAZ,55835,28422,27413,7580,47890,365,ITI,ITI4,12,Lazio,Lazio,5879082,2806301,47.73,0.95
1204,2021-03-13,LAZ,21850,8754,13096,15702,5914,234,ITI,ITI4,12,Lazio,Lazio,5879082,2828151,48.11,0.37
1205,2021-02-08,LAZ,9748,4159,5589,4507,5239,2,ITI,ITI4,12,Lazio,Lazio,5879082,2837899,48.27,0.17
1206,2021-05-02,LAZ,32919,14454,18465,23001,9455,463,ITI,ITI4,12,Lazio,Lazio,5879082,2870818,48.83,0.56
1207,2021-01-22,LAZ,4012,1639,2373,496,3516,0,ITI,ITI4,12,Lazio,Lazio,5879082,2874830,48.9,0.07
1208,2021-07-17,LAZ,43862,22124,21738,2171,41587,104,ITI,ITI4,12,Lazio,Lazio,5879082,2918692,49.65,0.75
1209,2021-06-30,LAZ,62988,29641,33347,29753,32695,540,ITI,ITI4,12,Lazio,Lazio,5879082,2981680,50.72,1.07
1210,2021-04-08,LAZ,26862,12319,14543,18813,7701,348,ITI,ITI4,12,Lazio,Lazio,5879082,3008542,51.17,0.46
1211,2021-07-02,LAZ,48505,23245,25260,6620,41705,180,ITI,ITI4,12,Lazio,Lazio,5879082,3057047,52.0,0.83
1212,2021-06-28,LAZ,58950,28183,30767,27520,30995,435,ITI,ITI4,12,Lazio,Lazio,5879082,3115997,53.0,1.0
1213,2021-02-12,LAZ,6856,2856,4000,6355,421,80,ITI,ITI4,12,Lazio,Lazio,5879082,3122853,53.12,0.12
1214,2021-01-31,LAZ,4464,1857,2607,479,3985,0,ITI,ITI4,12,Lazio,Lazio,5879082,3127317,53.19,0.08
1215,2021-01-01,LAZ,3596,1396,2200,3556,0,40,ITI,ITI4,12,Lazio,Lazio,5879082,3130913,53.26,0.06
1216,2021-01-10,LAZ,4134,1738,2396,4067,0,67,ITI,ITI4,12,Lazio,Lazio,5879082,3135047,53.33,0.07
1217,2021-06-16,LAZ,64676,31047,33629,32080,31977,619,ITI,ITI4,12,Lazio,Lazio,5879082,3199723,54.43,1.1
1218,2021-04-20,LAZ,31148,14296,16852,19407,11363,378,ITI,ITI4,12,Lazio,Lazio,5879082,3230871,54.96,0.53
1219,2021-03-08,LAZ,20944,9093,11851,15345,5305,294,ITI,ITI4,12,Lazio,Lazio,5879082,3251815,55.31,0.36
1220,2021-04-22,LAZ,39200,19498,19702,23898,14712,590,ITI,ITI4,12,Lazio,Lazio,5879082,3291015,55.98,0.67
1221,2021-03-10,LAZ,23360,10671,12689,17360,5659,341,ITI,ITI4,12,Lazio,Lazio,5879082,3314375,56.38,0.4
1222,2021-01-12,LAZ,5513,2022,3491,5370,0,143,ITI,ITI4,12,Lazio,Lazio,5879082,3319888,56.47,0.09
1223,2021-06-11,LAZ,69749,32818,36931,36681,32431,637,ITI,ITI4,12,Lazio,Lazio,5879082,3389637,57.66,1.19
1224,2021-08-07,LAZ,33231,17801,15430,20828,11345,1058,ITI,ITI4,12,Lazio,Lazio,5879082,3422868,58.22,0.57
1225,2021-05-06,LAZ,48861,22769,26092,30615,17590,656,ITI,ITI4,12,Lazio,Lazio,5879082,3471729,59.05,0.83
1226,2021-04-01,LAZ,29780,14127,15653,22232,7171,377,ITI,ITI4,12,Lazio,Lazio,5879082,3501509,59.56,0.51
1227,2021-07-10,LAZ,71016,35637,35379,25026,45339,651,ITI,ITI4,12,Lazio,Lazio,5879082,3572525,60.77,1.21
1228,2021-07-24,LAZ,30682,15471,15211,3214,27329,139,ITI,ITI4,12,Lazio,Lazio,5879082,3603207,61.29,0.52
1229,2021-06-23,LAZ,62324,29354,32970,28440,33385,499,ITI,ITI4,12,Lazio,Lazio,5879082,3665531,62.35,1.06
1230,2021-03-22,LAZ,23411,10561,12850,16351,6730,330,ITI,ITI4,12,Lazio,Lazio,5879082,3688942,62.75,0.4
1231,2021-02-27,LAZ,11530,4334,7196,10348,1044,138,ITI,ITI4,12,Lazio,Lazio,5879082,3700472,62.94,0.2
1232,2021-05-20,LAZ,51835,25016,26819,37151,13958,726,ITI,ITI4,12,Lazio,Lazio,5879082,3752307,63.82,0.88
1233,2021-06-20,LAZ,55316,25439,29877,29613,24947,756,ITI,ITI4,12,Lazio,Lazio,5879082,3807623,64.77,0.94
1234,2021-06-06,LAZ,58224,28061,30163,35115,22522,587,ITI,ITI4,12,Lazio,Lazio,5879082,3865847,65.76,0.99
1235,2020-12-31,LAZ,5370,2149,3221,5310,0,60,ITI,ITI4,12,Lazio,Lazio,5879082,3871217,65.85,0.09
1236,2021-04-10,LAZ,23943,10416,13527,16496,7198,249,ITI,ITI4,12,Lazio,Lazio,5879082,3895160,66.25,0.41
1237,2021-02-05,LAZ,7331,2994,4337,1218,6110,3,ITI,ITI4,12,Lazio,Lazio,5879082,3902491,66.38,0.12
1238,2021-04-03,LAZ,24848,11218,13630,17895,6734,219,ITI,ITI4,12,Lazio,Lazio,5879082,3927339,66.8,0.42
1239,2021-05-11,LAZ,48368,22215,26153,31195,16576,597,ITI,ITI4,12,Lazio,Lazio,5879082,3975707,67.62,0.82
1240,2021-07-16,LAZ,43907,20954,22953,2912,40820,175,ITI,ITI4,12,Lazio,Lazio,5879082,4019614,68.37,0.75
1241,2021-04-24,LAZ,33561,15146,18415,20184,12884,493,ITI,ITI4,12,Lazio,Lazio,5879082,4053175,68.94,0.57
1242,2021-08-02,LAZ,28419,14778,13641,4242,24043,134,ITI,ITI4,12,Lazio,Lazio,5879082,4081594,69.43,0.48
1243,2021-05-30,LAZ,41266,17651,23615,33226,7370,670,ITI,ITI4,12,Lazio,Lazio,5879082,4122860,70.13,0.7
1244,2021-05-13,LAZ,50246,22580,27666,31719,17853,674,ITI,ITI4,12,Lazio,Lazio,5879082,4173106,70.98,0.85
1245,2021-08-04,LAZ,37921,18869,19052,15883,21571,467,ITI,ITI4,12,Lazio,Lazio,5879082,4211027,71.63,0.65
1246,2021-01-17,LAZ,4954,2047,2907,4678,212,64,ITI,ITI4,12,Lazio,Lazio,5879082,4215981,71.71,0.08
1247,2021-01-19,LAZ,4782,1965,2817,4325,454,3,ITI,ITI4,12,Lazio,Lazio,5879082,4220763,71.79,0.08
1248,2021-04-29,LAZ,38837,17342,21495,24875,13355,607,ITI,ITI4,12,Lazio,Lazio,5879082,4259600,72.45,0.66
1249,2021-03-03,LAZ,17898,7886,10012,13352,4311,235,ITI,ITI4,12,Lazio,Lazio,5879082,4277498,72.76,0.3
1250,2021-06-18,LAZ,64365,31009,33356,30309,33319,737,ITI,ITI4,12,Lazio,Lazio,5879082,4341863,73.85,1.09
1251,2021-03-17,LAZ,13876,5948,7928,7475,6289,112,ITI,ITI4,12,Lazio,Lazio,5879082,4355739,74.09,0.24
1252,2021-06-25,LAZ,63317,30571,32746,28092,34642,583,ITI,ITI4,12,Lazio,Lazio,5879082,4419056,75.17,1.08
1253,2020-12-29,LAZ,496,182,314,492,0,4,ITI,ITI4,12,Lazio,Lazio,5879082,4419552,75.17,0.01
1254,2021-06-13,LAZ,58436,26221,32215,33085,24853,498,ITI,ITI4,12,Lazio,Lazio,5879082,4477988,76.17,0.99
1255,2021-03-07,LAZ,14161,5479,8682,10349,3603,209,ITI,ITI4,12,Lazio,Lazio,5879082,4492149,76.41,0.24
1256,2021-06-15,LAZ,66145,31963,34182,33368,32216,561,ITI,ITI4,12,Lazio,Lazio,5879082,4558294,77.53,1.13
1257,2021-03-24,LAZ,27981,13144,14837,21318,6273,390,ITI,ITI4,12,Lazio,Lazio,5879082,4586275,78.01,0.48
1258,2021-05-29,LAZ,52086,23429,28657,40176,11043,867,ITI,ITI4,12,Lazio,Lazio,5879082,4638361,78.9,0.89
1259,2021-04-15,LAZ,32025,14346,17679,20703,10875,447,ITI,ITI4,12,Lazio,Lazio,5879082,4670386,79.44,0.54
1260,2021-02-10,LAZ,8208,3414,4794,4848,3355,5,ITI,ITI4,12,Lazio,Lazio,5879082,4678594,79.58,0.14
1261,2021-05-21,LAZ,52068,25043,27025,37286,14088,694,ITI,ITI4,12,Lazio,Lazio,5879082,4730662,80.47,0.89
1262,2021-06-04,LAZ,61986,30238,31748,43525,17834,627,ITI,ITI4,12,Lazio,Lazio,5879082,4792648,81.52,1.05
1263,2021-05-04,LAZ,40266,18527,21739,26114,13684,468,ITI,ITI4,12,Lazio,Lazio,5879082,4832914,82.21,0.68
1264,2021-02-24,LAZ,12058,5213,6845,10937,997,124,ITI,ITI4,12,Lazio,Lazio,5879082,4844972,82.41,0.21
1265,2021-02-26,LAZ,13132,5738,7394,11552,1404,176,ITI,ITI4,12,Lazio,Lazio,5879082,4858104,82.63,0.22
1266,2021-07-09,LAZ,64930,31339,33591,27590,36599,741,ITI,ITI4,12,Lazio,Lazio,5879082,4923034,83.74,1.1
1267,2021-05-01,LAZ,38261,17205,21056,25751,12074,436,ITI,ITI4,12,Lazio,Lazio,5879082,4961295,84.39,0.65
1268,2021-04-17,LAZ,32478,14246,18232,20018,12061,399,ITI,ITI4,12,Lazio,Lazio,5879082,4993773,84.94,0.55
1269,2021-07-26,LAZ,50802,25037,25765,6651,43845,306,ITI,ITI4,12,Lazio,Lazio,5879082,5044575,85.81,0.86
1270,2021-02-19,LAZ,10057,5083,4974,9072,838,147,ITI,ITI4,12,Lazio,Lazio,5879082,5054632,85.98,0.17
1271,2021-06-17,LAZ,66987,32228,34759,31805,34465,717,ITI,ITI4,12,Lazio,Lazio,5879082,5121619,87.12,1.14
1272,2021-04-21,LAZ,33149,15064,18085,20310,12478,361,ITI,ITI4,12,Lazio,Lazio,5879082,5154768,87.68,0.56
1273,2021-06-29,LAZ,59472,28264,31208,27730,31168,574,ITI,ITI4,12,Lazio,Lazio,5879082,5214240,88.69,1.01
1274,2021-01-14,LAZ,5592,2176,3416,5418,0,174,ITI,ITI4,12,Lazio,Lazio,5879082,5219832,88.79,0.1
1275,2021-04-07,LAZ,26027,12180,13847,18366,7323,338,ITI,ITI4,12,Lazio,Lazio,5879082,5245859,89.23,0.44
1276,2021-08-09,LAZ,51755,26207,25548,21449,29284,1022,ITI,ITI4,12,Lazio,Lazio,5879082,5297614,90.11,0.88
1277,2021-01-26,LAZ,7975,3130,4845,731,7244,0,ITI,ITI4,12,Lazio,Lazio,5879082,5305589,90.25,0.14
1278,2021-04-02,LAZ,29538,14163,15375,21760,7393,385,ITI,ITI4,12,Lazio,Lazio,5879082,5335127,90.75,0.5
1279,2021-07-11,LAZ,44115,22235,21880,3763,40204,148,ITI,ITI4,12,Lazio,Lazio,5879082,5379242,91.5,0.75
1280,2021-01-28,LAZ,8284,3168,5116,786,7497,1,ITI,ITI4,12,Lazio,Lazio,5879082,5387526,91.64,0.14
1281,2021-07-04,LAZ,46581,21684,24897,4118,42379,84,ITI,ITI4,12,Lazio,Lazio,5879082,5434107,92.43,0.79
1282,2021-05-08,LAZ,45496,20771,24725,29402,15444,650,ITI,ITI4,12,Lazio,Lazio,5879082,5479603,93.21,0.77
1283,2021-06-27,LAZ,47253,21611,25642,20599,26180,474,ITI,ITI4,12,Lazio,Lazio,5879082,5526856,94.01,0.8
1284,2021-02-04,LAZ,6443,2567,3876,1123,5319,1,ITI,ITI4,12,Lazio,Lazio,5879082,5533299,94.12,0.11
1285,2021-07-07,LAZ,62619,31020,31599,28381,33654,584,ITI,ITI4,12,Lazio,Lazio,5879082,5595918,95.18,1.07
1286,2021-03-29,LAZ,25579,12151,13428,18193,7082,304,ITI,ITI4,12,Lazio,Lazio,5879082,5621497,95.62,0.44
1287,2021-03-15,LAZ,21025,9874,11151,14003,6769,253,ITI,ITI4,12,Lazio,Lazio,5879082,5642522,95.98,0.36
1288,2021-01-05,LAZ,7453,2831,4622,7350,0,103,ITI,ITI4,12,Lazio,Lazio,5879082,5649975,96.1,0.13
1289,2021-08-01,LAZ,31028,16392,14636,4734,26107,187,ITI,ITI4,12,Lazio,Lazio,5879082,5681003,96.63,0.53
1290,2021-05-10,LAZ,44500,20349,24151,30601,13443,456,ITI,ITI4,12,Lazio,Lazio,5879082,5725503,97.39,0.76
1291,2021-05-27,LAZ,58484,27202,31282,43896,13792,796,ITI,ITI4,12,Lazio,Lazio,5879082,5783987,98.38,0.99
1292,2021-03-12,LAZ,24100,11141,12959,17392,6356,352,ITI,ITI4,12,Lazio,Lazio,5879082,5808087,98.79,0.41
1293,2021-02-09,LAZ,8820,3782,5038,4578,4236,6,ITI,ITI4,12,Lazio,Lazio,5879082,5816907,98.94,0.15
1294,2021-02-23,LAZ,11101,4789,6312,10204,769,128,ITI,ITI4,12,Lazio,Lazio,5879082,5828008,99.13,0.19
1295,2021-07-30,LAZ,55582,28751,26831,7255,47988,339,ITI,ITI4,12,Lazio,Lazio,5879082,5883590,100.08,0.95
1296,2021-06-03,LAZ,56802,28695,28107,38263,17834,705,ITI,ITI4,12,Lazio,Lazio,5879082,5940392,101.04,0.97
1297,2021-08-06,LAZ,30815,15880,14935,20348,9495,972,ITI,ITI4,12,Lazio,Lazio,5879082,5971207,101.57,0.52
1298,2021-06-10,LAZ,72099,34063,38036,37289,33986,824,ITI,ITI4,12,Lazio,Lazio,5879082,6043306,102.79,1.23
1299,2021-04-14,LAZ,29394,13325,16069,18881,10194,319,ITI,ITI4,12,Lazio,Lazio,5879082,6072700,103.29,0.5
1300,2021-07-23,LAZ,58326,29244,29082,26758,29827,1741,ITI,ITI4,12,Lazio,Lazio,5879082,6131026,104.29,0.99
1301,2020-12-28,LAZ,960,413,547,955,0,5,ITI,ITI4,12,Lazio,Lazio,5879082,6131986,104.3,0.02
1302,2021-01-16,LAZ,5768,2334,3434,5620,0,148,ITI,ITI4,12,Lazio,Lazio,5879082,6137754,104.4,0.1
1303,2021-04-26,LAZ,29328,13497,15831,19612,9285,431,ITI,ITI4,12,Lazio,Lazio,5879082,6167082,104.9,0.5
1304,2021-02-02,LAZ,5918,2219,3699,639,5276,3,ITI,ITI4,12,Lazio,Lazio,5879082,6173000,105.0,0.1
1305,2021-07-18,LAZ,58341,29706,28635,22798,34756,787,ITI,ITI4,12,Lazio,Lazio,5879082,6231341,105.99,0.99
1306,2021-03-05,LAZ,19602,8686,10916,14623,4751,228,ITI,ITI4,12,Lazio,Lazio,5879082,6250943,106.33,0.33
1307,2021-02-16,LAZ,8360,4034,4326,7705,612,43,ITI,ITI4,12,Lazio,Lazio,5879082,6259303,106.47,0.14
1308,2021-07-13,LAZ,42666,20909,21757,5475,36854,337,ITI,ITI4,12,Lazio,Lazio,5879082,6301969,107.19,0.73
1309,2021-03-26,LAZ,30357,14062,16295,23014,6898,445,ITI,ITI4,12,Lazio,Lazio,5879082,6332326,107.71,0.52
1310,2021-07-06,LAZ,62569,30362,32207,28567,33515,487,ITI,ITI4,12,Lazio,Lazio,5879082,6394895,108.77,1.06
1311,2021-01-24,LAZ,5699,2229,3470,615,5084,0,ITI,ITI4,12,Lazio,Lazio,5879082,6400594,108.87,0.1
1312,2021-02-07,LAZ,4969,2046,2923,410,4558,1,ITI,ITI4,12,Lazio,Lazio,5879082,6405563,108.96,0.08
1313,2021-05-18,LAZ,45066,20616,24450,34936,9577,553,ITI,ITI4,12,Lazio,Lazio,5879082,6450629,109.72,0.77
1314,2021-08-11,LAZ,36589,18989,17600,15502,20447,640,ITI,ITI4,12,Lazio,Lazio,5879082,6487218,110.34,0.62
1315,2021-05-03,LAZ,39619,17888,21731,26273,12767,579,ITI,ITI4,12,Lazio,Lazio,5879082,6526837,111.02,0.67
1316,2021-07-25,LAZ,24574,12066,12508,2032,22492,50,ITI,ITI4,12,Lazio,Lazio,5879082,6551411,111.44,0.42
1317,2021-05-22,LAZ,55191,27038,28153,43643,10699,849,ITI,ITI4,12,Lazio,Lazio,5879082,6606602,112.37,0.94
1318,2021-05-15,LAZ,57464,27453,30011,40103,16564,797,ITI,ITI4,12,Lazio,Lazio,5879082,6664066,113.35,0.98
1319,2021-03-19,LAZ,17505,7596,9909,11003,6350,152,ITI,ITI4,12,Lazio,Lazio,5879082,6681571,113.65,0.3
1320,2021-01-21,LAZ,5607,2350,3257,552,5055,0,ITI,ITI4,12,Lazio,Lazio,5879082,6687178,113.75,0.1
1321,2021-03-31,LAZ,27875,13477,14398,20393,7145,337,ITI,ITI4,12,Lazio,Lazio,5879082,6715053,114.22,0.47
1322,2021-06-22,LAZ,62818,29058,33760,28600,33513,705,ITI,ITI4,12,Lazio,Lazio,5879082,6777871,115.29,1.07
1323,2021-03-14,LAZ,17295,6777,10518,11857,5179,259,ITI,ITI4,12,Lazio,Lazio,5879082,6795166,115.58,0.29
1324,2021-01-07,LAZ,7933,2975,4958,7776,0,157,ITI,ITI4,12,Lazio,Lazio,5879082,6803099,115.72,0.13
1325,2021-01-20,LAZ,4817,1951,2866,3269,1544,4,ITI,ITI4,12,Lazio,Lazio,5879082,6807916,115.8,0.08
1326,2021-05-14,LAZ,51610,23586,28024,32566,18383,661,ITI,ITI4,12,Lazio,Lazio,5879082,6859526,116.68,0.88
1327,2021-03-18,LAZ,14287,6105,8182,7773,6430,84,ITI,ITI4,12,Lazio,Lazio,5879082,6873813,116.92,0.24
1328,2021-03-25,LAZ,29511,13704,15807,22368,6675,468,ITI,ITI4,12,Lazio,Lazio,5879082,6903324,117.42,0.5
1329,2021-01-27,LAZ,6122,2390,3732,1005,5117,0,ITI,ITI4,12,Lazio,Lazio,5879082,6909446,117.53,0.1
1330,2021-06-01,LAZ,49131,23710,25421,30088,18576,467,ITI,ITI4,12,Lazio,Lazio,5879082,6958577,118.36,0.84
1331,2021-04-05,LAZ,19982,9152,10830,13615,6214,153,ITI,ITI4,12,Lazio,Lazio,5879082,6978559,118.7,0.34
1332,2021-07-28,LAZ,57582,29130,28452,8048,49196,338,ITI,ITI4,12,Lazio,Lazio,5879082,7036141,119.68,0.98
1333,2021-05-25,LAZ,47593,22338,25255,35300,11703,590,ITI,ITI4,12,Lazio,Lazio,5879082,7083734,120.49,0.81
1334,2021-04-12,LAZ,23935,10793,13142,16690,6962,283,ITI,ITI4,12,Lazio,Lazio,5879082,7107669,120.9,0.41
1335,2021-07-21,LAZ,62761,31693,31068,28662,32768,1331,ITI,ITI4,12,Lazio,Lazio,5879082,7170430,121.97,1.07
1336,2021-06-08,LAZ,66789,31880,34909,36160,29990,639,ITI,ITI4,12,Lazio,Lazio,5879082,7237219,123.1,1.14
1337,2021-07-14,LAZ,42140,20535,21605,6189,35594,357,ITI,ITI4,12,Lazio,Lazio,5879082,7279359,123.82,0.72
1338,2021-01-09,LAZ,6416,2609,3807,6303,0,113,ITI,ITI4,12,Lazio,Lazio,5879082,7285775,123.93,0.11
1339,2021-04-19,LAZ,30150,13708,16442,19006,10723,421,ITI,ITI4,12,Lazio,Lazio,5879082,7315925,124.44,0.51
1340,2021-02-21,LAZ,6995,3182,3813,6486,465,44,ITI,ITI4,12,Lazio,Lazio,5879082,7322920,124.56,0.12
1341,2021-02-14,LAZ,5779,2372,3407,5277,472,30,ITI,ITI4,12,Lazio,Lazio,5879082,7328699,124.66,0.1
1342,2021-02-28,LAZ,10284,4038,6246,9648,539,97,ITI,ITI4,12,Lazio,Lazio,5879082,7338983,124.83,0.17
1343,2021-01-02,LAZ,6837,2680,4157,6757,0,80,ITI,ITI4,12,Lazio,Lazio,5879082,7345820,124.95,0.12
1344,2021-02-21,PUG,2178,475,1703,2066,63,49,ITF,ITF4,16,Puglia,Puglia,4029053,2178,0.05,0.05
1345,2021-06-01,PUG,35004,17532,17472,21636,12978,390,ITF,ITF4,16,Puglia,Puglia,4029053,37182,0.92,0.87
1346,2021-05-15,PUG,43676,19019,24657,22821,20145,710,ITF,ITF4,16,Puglia,Puglia,4029053,80858,2.01,1.08
1347,2021-06-03,PUG,50638,24560,26078,30513,19402,723,ITF,ITF4,16,Puglia,Puglia,4029053,131496,3.26,1.26
1348,2021-03-10,PUG,14837,6634,8203,11549,3133,155,ITF,ITF4,16,Puglia,Puglia,4029053,146333,3.63,0.37
1349,2021-02-09,PUG,3847,1571,2276,2152,1676,19,ITF,ITF4,16,Puglia,Puglia,4029053,150180,3.73,0.1
1350,2021-05-20,PUG,33689,15295,18394,20756,12416,517,ITF,ITF4,16,Puglia,Puglia,4029053,183869,4.56,0.84
1351,2021-03-24,PUG,13607,6534,7073,6043,7446,118,ITF,ITF4,16,Puglia,Puglia,4029053,197476,4.9,0.34
1352,2021-01-26,PUG,5375,2402,2973,563,4811,1,ITF,ITF4,16,Puglia,Puglia,4029053,202851,5.03,0.13
1353,2021-07-02,PUG,47284,22468,24816,17312,29047,925,ITF,ITF4,16,Puglia,Puglia,4029053,250135,6.21,1.17
1354,2021-05-06,PUG,39725,17380,22345,19307,19861,557,ITF,ITF4,16,Puglia,Puglia,4029053,289860,7.19,0.99
1355,2021-02-07,PUG,1582,669,913,253,1329,0,ITF,ITF4,16,Puglia,Puglia,4029053,291442,7.23,0.04
1356,2021-01-21,PUG,2132,905,1227,1268,862,2,ITF,ITF4,16,Puglia,Puglia,4029053,293574,7.29,0.05
1357,2021-05-01,PUG,27684,12686,14998,16713,10695,276,ITF,ITF4,16,Puglia,Puglia,4029053,321258,7.97,0.69
1358,2021-08-09,PUG,25720,13121,12599,10813,14082,825,ITF,ITF4,16,Puglia,Puglia,4029053,346978,8.61,0.64
1359,2021-01-02,PUG,2956,1304,1652,2956,0,0,ITF,ITF4,16,Puglia,Puglia,4029053,349934,8.69,0.07
1360,2021-04-12,PUG,29466,13861,15605,26130,3021,315,ITF,ITF4,16,Puglia,Puglia,4029053,379400,9.42,0.73
1361,2021-04-19,PUG,27748,12892,14856,24364,3044,340,ITF,ITF4,16,Puglia,Puglia,4029053,407148,10.11,0.69
1362,2021-07-28,PUG,44310,22370,21940,14220,29190,900,ITF,ITF4,16,Puglia,Puglia,4029053,451458,11.21,1.1
1363,2021-04-24,PUG,29446,13412,16034,25163,3951,332,ITF,ITF4,16,Puglia,Puglia,4029053,480904,11.94,0.73
1364,2021-03-05,PUG,17721,7191,10530,15185,2316,220,ITF,ITF4,16,Puglia,Puglia,4029053,498625,12.38,0.44
1365,2021-02-26,PUG,13785,5062,8723,12515,1075,195,ITF,ITF4,16,Puglia,Puglia,4029053,512410,12.72,0.34
1366,2020-12-31,PUG,1637,784,853,1637,0,0,ITF,ITF4,16,Puglia,Puglia,4029053,514047,12.76,0.04
1367,2021-08-11,PUG,14115,7172,6943,6932,6663,520,ITF,ITF4,16,Puglia,Puglia,4029053,528162,13.11,0.35
1368,2021-06-15,PUG,42693,20870,21823,22393,19706,594,ITF,ITF4,16,Puglia,Puglia,4029053,570855,14.17,1.06
1369,2021-06-08,PUG,39351,19160,20191,20945,17846,560,ITF,ITF4,16,Puglia,Puglia,4029053,610206,15.15,0.98
1370,2021-07-11,PUG,12167,5752,6415,2587,9480,100,ITF,ITF4,16,Puglia,Puglia,4029053,622373,15.45,0.3
1371,2021-01-31,PUG,1819,832,987,73,1746,0,ITF,ITF4,16,Puglia,Puglia,4029053,624192,15.49,0.05
1372,2021-04-05,PUG,12768,6199,6569,12093,534,141,ITF,ITF4,16,Puglia,Puglia,4029053,636960,15.81,0.32
1373,2021-03-19,PUG,7979,3660,4319,3368,4575,36,ITF,ITF4,16,Puglia,Puglia,4029053,644939,16.01,0.2
1374,2021-06-27,PUG,18546,9212,9334,9956,8327,263,ITF,ITF4,16,Puglia,Puglia,4029053,663485,16.47,0.46
1375,2021-01-12,PUG,4219,1772,2447,4218,0,1,ITF,ITF4,16,Puglia,Puglia,4029053,667704,16.57,0.1
1376,2021-04-07,PUG,15724,7137,8587,8830,6695,199,ITF,ITF4,16,Puglia,Puglia,4029053,683428,16.96,0.39
1377,2021-07-16,PUG,46392,22501,23891,12909,32643,840,ITF,ITF4,16,Puglia,Puglia,4029053,729820,18.11,1.15
1378,2021-03-31,PUG,14574,6832,7742,8838,5586,150,ITF,ITF4,16,Puglia,Puglia,4029053,744394,18.48,0.36
1379,2021-02-02,PUG,4358,1855,2503,574,3783,1,ITF,ITF4,16,Puglia,Puglia,4029053,748752,18.58,0.11
1380,2021-07-09,PUG,37054,17839,19215,6418,29958,678,ITF,ITF4,16,Puglia,Puglia,4029053,785806,19.5,0.92
1381,2021-05-13,PUG,38825,17313,21512,20989,17272,564,ITF,ITF4,16,Puglia,Puglia,4029053,824631,20.47,0.96
1382,2021-03-17,PUG,10356,4706,5650,4107,6187,62,ITF,ITF4,16,Puglia,Puglia,4029053,834987,20.72,0.26
1383,2021-03-29,PUG,13562,6615,6947,6606,6760,196,ITF,ITF4,16,Puglia,Puglia,4029053,848549,21.06,0.34
1384,2021-03-12,PUG,14308,6452,7856,10229,3942,137,ITF,ITF4,16,Puglia,Puglia,4029053,862857,21.42,0.36
1385,2021-06-20,PUG,21592,10852,10740,14056,7210,326,ITF,ITF4,16,Puglia,Puglia,4029053,884449,21.95,0.54
1386,2021-02-04,PUG,5934,2366,3568,1133,4798,3,ITF,ITF4,16,Puglia,Puglia,4029053,890383,22.1,0.15
1387,2021-07-21,PUG,44269,21842,22427,11817,31581,871,ITF,ITF4,16,Puglia,Puglia,4029053,934652,23.2,1.1
1388,2021-07-04,PUG,19886,9677,10209,7918,11681,287,ITF,ITF4,16,Puglia,Puglia,4029053,954538,23.69,0.49
1389,2021-07-23,PUG,42828,21654,21174,13614,28224,990,ITF,ITF4,16,Puglia,Puglia,4029053,997366,24.75,1.06
1390,2021-01-19,PUG,1222,453,769,1211,10,1,ITF,ITF4,16,Puglia,Puglia,4029053,998588,24.78,0.03
1391,2021-07-08,PUG,41463,19222,22241,5433,35566,464,ITF,ITF4,16,Puglia,Puglia,4029053,1040051,25.81,1.03
1392,2021-01-14,PUG,4079,1593,2486,4078,0,1,ITF,ITF4,16,Puglia,Puglia,4029053,1044130,25.92,0.1
1393,2021-01-07,PUG,5727,2466,3261,5727,0,0,ITF,ITF4,16,Puglia,Puglia,4029053,1049857,26.06,0.14
1394,2021-04-17,PUG,40066,18987,21079,36060,3583,423,ITF,ITF4,16,Puglia,Puglia,4029053,1089923,27.05,0.99
1395,2021-02-19,PUG,4747,2018,2729,4300,392,55,ITF,ITF4,16,Puglia,Puglia,4029053,1094670,27.17,0.12
1396,2021-06-22,PUG,42483,20600,21883,19048,22864,571,ITF,ITF4,16,Puglia,Puglia,4029053,1137153,28.22,1.05
1397,2021-04-26,PUG,26327,12065,14262,22702,3237,388,ITF,ITF4,16,Puglia,Puglia,4029053,1163480,28.88,0.65
1398,2021-08-04,PUG,34489,17559,16930,12147,21283,1059,ITF,ITF4,16,Puglia,Puglia,4029053,1197969,29.73,0.86
1399,2021-06-13,PUG,21844,10936,10908,16346,5212,286,ITF,ITF4,16,Puglia,Puglia,4029053,1219813,30.28,0.54
1400,2021-02-28,PUG,6067,1807,4260,5801,191,75,ITF,ITF4,16,Puglia,Puglia,4029053,1225880,30.43,0.15
1401,2021-05-12,PUG,36635,16340,20295,23518,12534,583,ITF,ITF4,16,Puglia,Puglia,4029053,1262515,31.34,0.91
1402,2021-05-29,PUG,30661,14453,16208,20586,9529,546,ITF,ITF4,16,Puglia,Puglia,4029053,1293176,32.1,0.76
1403,2021-04-02,PUG,12855,6004,6851,8178,4526,151,ITF,ITF4,16,Puglia,Puglia,4029053,1306031,32.42,0.32
1404,2021-02-14,PUG,789,347,442,658,126,5,ITF,ITF4,16,Puglia,Puglia,4029053,1306820,32.43,0.02
1405,2021-05-25,PUG,34792,16244,18548,20571,13635,586,ITF,ITF4,16,Puglia,Puglia,4029053,1341612,33.3,0.86
1406,2021-05-08,PUG,54412,23032,31380,23975,29893,544,ITF,ITF4,16,Puglia,Puglia,4029053,1396024,34.65,1.35
1407,2021-07-30,PUG,35891,18431,17460,12929,22088,874,ITF,ITF4,16,Puglia,Puglia,4029053,1431915,35.54,0.89
1408,2021-05-27,PUG,40959,19357,21602,22888,17395,676,ITF,ITF4,16,Puglia,Puglia,4029053,1472874,36.56,1.02
1409,2021-03-02,PUG,16408,6098,10310,14860,1306,242,ITF,ITF4,16,Puglia,Puglia,4029053,1489282,36.96,0.41
1410,2021-07-20,PUG,46919,23013,23906,8234,38161,524,ITF,ITF4,16,Puglia,Puglia,4029053,1536201,38.13,1.16
1411,2021-05-17,PUG,32926,15261,17665,20447,11980,499,ITF,ITF4,16,Puglia,Puglia,4029053,1569127,38.95,0.82
1412,2021-08-08,PUG,5102,2596,2506,1676,3377,49,ITF,ITF4,16,Puglia,Puglia,4029053,1574229,39.07,0.13
1413,2021-01-04,PUG,4511,2015,2496,4509,0,2,ITF,ITF4,16,Puglia,Puglia,4029053,1578740,39.18,0.11
1414,2021-03-26,PUG,12025,5854,6171,7220,4673,132,ITF,ITF4,16,Puglia,Puglia,4029053,1590765,39.48,0.3
1415,2021-03-09,PUG,13686,6118,7568,11490,2017,179,ITF,ITF4,16,Puglia,Puglia,4029053,1604451,39.82,0.34
1416,2021-03-16,PUG,9883,4692,5191,3450,6376,57,ITF,ITF4,16,Puglia,Puglia,4029053,1614334,40.07,0.25
1417,2021-06-24,PUG,52889,25588,27301,23571,28532,786,ITF,ITF4,16,Puglia,Puglia,4029053,1667223,41.38,1.31
1418,2021-04-28,PUG,19860,8908,10952,14811,4785,264,ITF,ITF4,16,Puglia,Puglia,4029053,1687083,41.87,0.49
1419,2021-08-06,PUG,28784,14923,13861,8497,19566,721,ITF,ITF4,16,Puglia,Puglia,4029053,1715867,42.59,0.71
1420,2021-01-09,PUG,4893,2251,2642,4889,0,4,ITF,ITF4,16,Puglia,Puglia,4029053,1720760,42.71,0.12
1421,2021-07-01,PUG,48358,22644,25714,11437,36289,632,ITF,ITF4,16,Puglia,Puglia,4029053,1769118,43.91,1.2
1422,2021-01-23,PUG,3043,1294,1749,882,2160,1,ITF,ITF4,16,Puglia,Puglia,4029053,1772161,43.98,0.08
1423,2021-05-03,PUG,33396,14930,18466,22153,10679,564,ITF,ITF4,16,Puglia,Puglia,4029053,1805557,44.81,0.83
1424,2021-03-07,PUG,4991,2005,2986,4372,577,42,ITF,ITF4,16,Puglia,Puglia,4029053,1810548,44.94,0.12
1425,2021-05-05,PUG,39312,17256,22056,24492,14235,585,ITF,ITF4,16,Puglia,Puglia,4029053,1849860,45.91,0.98
1426,2021-06-17,PUG,42885,20959,21926,21403,20921,561,ITF,ITF4,16,Puglia,Puglia,4029053,1892745,46.98,1.06
1427,2021-06-10,PUG,47199,23206,23993,29380,17101,718,ITF,ITF4,16,Puglia,Puglia,4029053,1939944,48.15,1.17
1428,2021-04-04,PUG,5989,2974,3015,5902,6,81,ITF,ITF4,16,Puglia,Puglia,4029053,1945933,48.3,0.15
1429,2021-07-13,PUG,48737,22978,25759,7805,40338,594,ITF,ITF4,16,Puglia,Puglia,4029053,1994670,49.51,1.21
1430,2021-03-21,PUG,2697,1228,1469,578,2107,12,ITF,ITF4,16,Puglia,Puglia,4029053,1997367,49.57,0.07
1431,2021-06-29,PUG,46635,22353,24282,15362,30583,690,ITF,ITF4,16,Puglia,Puglia,4029053,2044002,50.73,1.16
1432,2021-01-11,PUG,3756,1590,2166,3755,0,1,ITF,ITF4,16,Puglia,Puglia,4029053,2047758,50.82,0.09
1433,2021-04-21,PUG,23157,10695,12462,19112,3743,302,ITF,ITF4,16,Puglia,Puglia,4029053,2070915,51.4,0.57
1434,2021-02-23,PUG,9388,4431,4957,8801,496,91,ITF,ITF4,16,Puglia,Puglia,4029053,2080303,51.63,0.23
1435,2021-01-18,PUG,1847,772,1075,1495,351,1,ITF,ITF4,16,Puglia,Puglia,4029053,2082150,51.68,0.05
1436,2021-02-06,PUG,4555,1935,2620,1577,2963,15,ITF,ITF4,16,Puglia,Puglia,4029053,2086705,51.79,0.11
1437,2021-01-20,PUG,1547,541,1006,1537,8,2,ITF,ITF4,16,Puglia,Puglia,4029053,2088252,51.83,0.04
1438,2021-07-27,PUG,48298,24015,24283,13220,34261,817,ITF,ITF4,16,Puglia,Puglia,4029053,2136550,53.03,1.2
1439,2021-05-31,PUG,37931,18288,19643,23139,14238,554,ITF,ITF4,16,Puglia,Puglia,4029053,2174481,53.97,0.94
1440,2021-04-25,PUG,11322,5242,6080,10048,1142,132,ITF,ITF4,16,Puglia,Puglia,4029053,2185803,54.25,0.28
1441,2021-02-27,PUG,14243,4822,9421,12828,1233,182,ITF,ITF4,16,Puglia,Puglia,4029053,2200046,54.6,0.35
1442,2021-08-03,PUG,36146,18336,17810,9154,26227,765,ITF,ITF4,16,Puglia,Puglia,4029053,2236192,55.5,0.9
1443,2021-01-01,PUG,150,61,89,150,0,0,ITF,ITF4,16,Puglia,Puglia,4029053,2236342,55.51,0.0
1444,2021-06-07,PUG,44421,21690,22731,30369,13288,764,ITF,ITF4,16,Puglia,Puglia,4029053,2280763,56.61,1.1
1445,2021-04-11,PUG,16484,7265,9219,14655,1648,181,ITF,ITF4,16,Puglia,Puglia,4029053,2297247,57.02,0.41
1446,2021-04-14,PUG,32031,15116,16915,28426,3299,306,ITF,ITF4,16,Puglia,Puglia,4029053,2329278,57.81,0.8
1447,2021-03-28,PUG,3548,1659,1889,1178,2335,35,ITF,ITF4,16,Puglia,Puglia,4029053,2332826,57.9,0.09
1448,2021-07-06,PUG,42371,19513,22858,6125,35827,419,ITF,ITF4,16,Puglia,Puglia,4029053,2375197,58.95,1.05
1449,2021-06-19,PUG,34790,17454,17336,22215,11921,654,ITF,ITF4,16,Puglia,Puglia,4029053,2409987,59.82,0.86
1450,2021-06-21,PUG,41868,20418,21450,21436,19798,634,ITF,ITF4,16,Puglia,Puglia,4029053,2451855,60.85,1.04
1451,2021-03-30,PUG,12434,5960,6474,6187,6094,153,ITF,ITF4,16,Puglia,Puglia,4029053,2464289,61.16,0.31
1452,2021-02-01,PUG,3973,1664,2309,354,3618,1,ITF,ITF4,16,Puglia,Puglia,4029053,2468262,61.26,0.1
1453,2021-07-17,PUG,30722,15422,15300,9501,20584,637,ITF,ITF4,16,Puglia,Puglia,4029053,2498984,62.02,0.76
1454,2021-03-14,PUG,3377,1462,1915,2474,866,37,ITF,ITF4,16,Puglia,Puglia,4029053,2502361,62.11,0.08
1455,2021-01-16,PUG,2508,1036,1472,2507,0,1,ITF,ITF4,16,Puglia,Puglia,4029053,2504869,62.17,0.06
1456,2021-06-12,PUG,34615,17250,17365,25057,8965,593,ITF,ITF4,16,Puglia,Puglia,4029053,2539484,63.03,0.86
1457,2021-04-30,PUG,35020,15692,19328,22463,11992,565,ITF,ITF4,16,Puglia,Puglia,4029053,2574504,63.9,0.87
1458,2021-04-13,PUG,28768,13643,15125,24922,3534,312,ITF,ITF4,16,Puglia,Puglia,4029053,2603272,64.61,0.71
1459,2021-07-22,PUG,47398,23502,23896,8479,38220,699,ITF,ITF4,16,Puglia,Puglia,4029053,2650670,65.79,1.18
1460,2021-07-05,PUG,38852,18234,20618,7246,31052,554,ITF,ITF4,16,Puglia,Puglia,4029053,2689522,66.75,0.96
1461,2021-05-02,PUG,21351,9675,11676,13897,7277,177,ITF,ITF4,16,Puglia,Puglia,4029053,2710873,67.28,0.53
1462,2021-08-10,PUG,24658,12786,11872,12787,10882,989,ITF,ITF4,16,Puglia,Puglia,4029053,2735531,67.9,0.61
1463,2021-07-24,PUG,26652,13821,12831,7995,18177,480,ITF,ITF4,16,Puglia,Puglia,4029053,2762183,68.56,0.66
1464,2021-05-24,PUG,36184,17074,19110,24495,11076,613,ITF,ITF4,16,Puglia,Puglia,4029053,2798367,69.45,0.9
1465,2021-02-16,PUG,3389,1455,1934,2711,648,30,ITF,ITF4,16,Puglia,Puglia,4029053,2801756,69.54,0.08
1466,2021-01-30,PUG,5537,2515,3022,383,5153,1,ITF,ITF4,16,Puglia,Puglia,4029053,2807293,69.68,0.14
1467,2021-05-10,PUG,37886,16747,21139,19326,18076,484,ITF,ITF4,16,Puglia,Puglia,4029053,2845179,70.62,0.94
1468,2021-02-13,PUG,3733,1461,2272,3021,696,16,ITF,ITF4,16,Puglia,Puglia,4029053,2848912,70.71,0.09
1469,2021-03-06,PUG,16176,6137,10039,13887,2122,167,ITF,ITF4,16,Puglia,Puglia,4029053,2865088,71.11,0.4
1470,2021-01-08,PUG,5682,2387,3295,5680,0,2,ITF,ITF4,16,Puglia,Puglia,4029053,2870770,71.25,0.14
1471,2021-06-14,PUG,42070,20588,21482,28854,12431,785,ITF,ITF4,16,Puglia,Puglia,4029053,2912840,72.3,1.04
1472,2021-04-18,PUG,22669,10847,11822,21417,1056,196,ITF,ITF4,16,Puglia,Puglia,4029053,2935509,72.86,0.56
1473,2021-02-20,PUG,2976,1081,1895,2688,257,31,ITF,ITF4,16,Puglia,Puglia,4029053,2938485,72.93,0.07
1474,2021-03-11,PUG,14846,6596,8250,11452,3190,204,ITF,ITF4,16,Puglia,Puglia,4029053,2953331,73.3,0.37
1475,2021-05-21,PUG,39210,18621,20589,28258,10158,794,ITF,ITF4,16,Puglia,Puglia,4029053,2992541,74.27,0.97
1476,2021-05-19,PUG,26458,12792,13666,19546,6480,432,ITF,ITF4,16,Puglia,Puglia,4029053,3018999,74.93,0.66
1477,2021-03-23,PUG,11143,5658,5485,4533,6516,94,ITF,ITF4,16,Puglia,Puglia,4029053,3030142,75.21,0.28
1478,2021-03-25,PUG,11755,6024,5731,5252,6404,99,ITF,ITF4,16,Puglia,Puglia,4029053,3041897,75.5,0.29
1479,2021-07-03,PUG,33214,16651,16563,13463,19250,501,ITF,ITF4,16,Puglia,Puglia,4029053,3075111,76.32,0.82
1480,2021-05-14,PUG,45053,20595,24458,27996,16203,854,ITF,ITF4,16,Puglia,Puglia,4029053,3120164,77.44,1.12
1481,2021-01-25,PUG,3832,1682,2150,422,3409,1,ITF,ITF4,16,Puglia,Puglia,4029053,3123996,77.54,0.1
1482,2021-07-10,PUG,22362,11011,11351,4450,17613,299,ITF,ITF4,16,Puglia,Puglia,4029053,3146358,78.09,0.56
1483,2021-06-18,PUG,47828,23550,24278,28865,18038,925,ITF,ITF4,16,Puglia,Puglia,4029053,3194186,79.28,1.19
1484,2021-01-28,PUG,5483,2283,3200,445,5038,0,ITF,ITF4,16,Puglia,Puglia,4029053,3199669,79.41,0.14
1485,2021-04-23,PUG,29597,13754,15843,23904,5277,416,ITF,ITF4,16,Puglia,Puglia,4029053,3229266,80.15,0.73
1486,2021-08-01,PUG,12387,6489,5898,4317,7949,121,ITF,ITF4,16,Puglia,Puglia,4029053,3241653,80.46,0.31
1487,2021-06-28,PUG,48606,23578,25028,21636,26171,799,ITF,ITF4,16,Puglia,Puglia,4029053,3290259,81.66,1.21
1488,2021-01-15,PUG,4556,1866,2690,4551,0,5,ITF,ITF4,16,Puglia,Puglia,4029053,3294815,81.78,0.11
1489,2021-06-02,PUG,27073,13236,13837,21876,4838,359,ITF,ITF4,16,Puglia,Puglia,4029053,3321888,82.45,0.67
1490,2021-03-13,PUG,10476,4137,6339,8563,1816,97,ITF,ITF4,16,Puglia,Puglia,4029053,3332364,82.71,0.26
1491,2021-02-24,PUG,10061,4714,5347,9369,596,96,ITF,ITF4,16,Puglia,Puglia,4029053,3342425,82.96,0.25
1492,2021-06-04,PUG,52806,25549,27257,34169,17810,827,ITF,ITF4,16,Puglia,Puglia,4029053,3395231,84.27,1.31
1493,2021-05-18,PUG,28954,13469,15485,15804,12876,274,ITF,ITF4,16,Puglia,Puglia,4029053,3424185,84.99,0.72
1494,2021-02-08,PUG,4005,1620,2385,1582,2408,15,ITF,ITF4,16,Puglia,Puglia,4029053,3428190,85.09,0.1
1495,2021-02-10,PUG,3655,1441,2214,2122,1513,20,ITF,ITF4,16,Puglia,Puglia,4029053,3431845,85.18,0.09
1496,2021-05-23,PUG,17950,8394,9556,13862,3827,261,ITF,ITF4,16,Puglia,Puglia,4029053,3449795,85.62,0.45
1497,2021-04-08,PUG,17505,7597,9908,11101,6190,214,ITF,ITF4,16,Puglia,Puglia,4029053,3467300,86.06,0.43
1498,2021-06-06,PUG,30733,15475,15258,25350,5061,322,ITF,ITF4,16,Puglia,Puglia,4029053,3498033,86.82,0.76
1499,2021-04-10,PUG,30946,13128,17818,26108,4458,380,ITF,ITF4,16,Puglia,Puglia,4029053,3528979,87.59,0.77
1500,2021-07-19,PUG,49305,24232,25073,10950,37580,775,ITF,ITF4,16,Puglia,Puglia,4029053,3578284,88.81,1.22
1501,2021-03-18,PUG,9608,4364,5244,3337,6205,66,ITF,ITF4,16,Puglia,Puglia,4029053,3587892,89.05,0.24
1502,2021-06-26,PUG,32408,16315,16093,15879,15961,568,ITF,ITF4,16,Puglia,Puglia,4029053,3620300,89.85,0.8
1503,2021-03-04,PUG,15374,6108,9266,13713,1435,226,ITF,ITF4,16,Puglia,Puglia,4029053,3635674,90.24,0.38
1504,2021-06-09,PUG,41935,20766,21169,29929,11301,705,ITF,ITF4,16,Puglia,Puglia,4029053,3677609,91.28,1.04
1505,2021-02-15,PUG,3263,1271,1992,2597,622,44,ITF,ITF4,16,Puglia,Puglia,4029053,3680872,91.36,0.08
1506,2021-05-26,PUG,38675,18582,20093,26218,11804,653,ITF,ITF4,16,Puglia,Puglia,4029053,3719547,92.32,0.96
1507,2021-01-03,PUG,2009,945,1064,2008,0,1,ITF,ITF4,16,Puglia,Puglia,4029053,3721556,92.37,0.05
1508,2021-03-27,PUG,12170,5720,6450,6880,5179,111,ITF,ITF4,16,Puglia,Puglia,4029053,3733726,92.67,0.3
1509,2021-01-05,PUG,5112,2252,2860,5109,0,3,ITF,ITF4,16,Puglia,Puglia,4029053,3738838,92.8,0.13
1510,2021-04-15,PUG,32753,15280,17473,28581,3770,402,ITF,ITF4,16,Puglia,Puglia,4029053,3771591,93.61,0.81
1511,2021-07-07,PUG,38673,18515,20158,6092,32069,512,ITF,ITF4,16,Puglia,Puglia,4029053,3810264,94.57,0.96
1512,2021-05-09,PUG,30822,12653,18169,14793,15662,367,ITF,ITF4,16,Puglia,Puglia,4029053,3841086,95.33,0.76
1513,2021-04-22,PUG,23059,10553,12506,17739,4937,383,ITF,ITF4,16,Puglia,Puglia,4029053,3864145,95.91,0.57
1514,2021-07-31,PUG,19884,10564,9320,7849,11557,478,ITF,ITF4,16,Puglia,Puglia,4029053,3884029,96.4,0.49
1515,2021-02-12,PUG,4217,1674,2543,3099,1094,24,ITF,ITF4,16,Puglia,Puglia,4029053,3888246,96.51,0.1
1516,2021-01-29,PUG,6209,2665,3544,228,5981,0,ITF,ITF4,16,Puglia,Puglia,4029053,3894455,96.66,0.15
1517,2021-01-22,PUG,1413,579,834,991,421,1,ITF,ITF4,16,Puglia,Puglia,4029053,3895868,96.69,0.04
1518,2021-06-25,PUG,50844,25050,25794,23836,26109,899,ITF,ITF4,16,Puglia,Puglia,4029053,3946712,97.96,1.26
1519,2021-04-29,PUG,26299,12159,14140,19175,6700,424,ITF,ITF4,16,Puglia,Puglia,4029053,3973011,98.61,0.65
1520,2021-08-07,PUG,9839,5185,4654,3484,6064,291,ITF,ITF4,16,Puglia,Puglia,4029053,3982850,98.85,0.24
1521,2021-02-22,PUG,9650,4539,5111,9225,336,89,ITF,ITF4,16,Puglia,Puglia,4029053,3992500,99.09,0.24
1522,2021-02-05,PUG,5643,2274,3369,1311,4327,5,ITF,ITF4,16,Puglia,Puglia,4029053,3998143,99.23,0.14
1523,2021-02-17,PUG,4294,1752,2542,3616,639,39,ITF,ITF4,16,Puglia,Puglia,4029053,4002437,99.34,0.11
1524,2021-05-28,PUG,44088,20874,23214,27426,15861,801,ITF,ITF4,16,Puglia,Puglia,4029053,4046525,100.43,1.09
1525,2021-07-26,PUG,47408,23665,23743,16827,29630,951,ITF,ITF4,16,Puglia,Puglia,4029053,4093933,101.61,1.18
1526,2021-05-30,PUG,21037,10068,10969,15713,5068,256,ITF,ITF4,16,Puglia,Puglia,4029053,4114970,102.13,0.52
1527,2021-01-27,PUG,4604,1943,2661,618,3986,0,ITF,ITF4,16,Puglia,Puglia,4029053,4119574,102.25,0.11
1528,2021-05-07,PUG,50197,22402,27795,25986,23637,574,ITF,ITF4,16,Puglia,Puglia,4029053,4169771,103.49,1.25
1529,2021-07-29,PUG,42812,21616,21196,12261,29748,803,ITF,ITF4,16,Puglia,Puglia,4029053,4212583,104.56,1.06
1530,2021-01-13,PUG,4550,1732,2818,4549,0,1,ITF,ITF4,16,Puglia,Puglia,4029053,4217133,104.67,0.11
1531,2021-04-06,PUG,13860,6261,7599,6925,6766,169,ITF,ITF4,16,Puglia,Puglia,4029053,4230993,105.01,0.34
1532,2021-07-15,PUG,44728,21635,23093,8844,35188,696,ITF,ITF4,16,Puglia,Puglia,4029053,4275721,106.12,1.11
1533,2021-07-14,PUG,46100,22108,23992,13363,31884,853,ITF,ITF4,16,Puglia,Puglia,4029053,4321821,107.27,1.14
1534,2021-04-01,PUG,13968,6563,7405,7375,6378,215,ITF,ITF4,16,Puglia,Puglia,4029053,4335789,107.61,0.35
1535,2021-02-03,PUG,5050,2007,3043,705,4344,1,ITF,ITF4,16,Puglia,Puglia,4029053,4340839,107.74,0.13
1536,2021-07-12,PUG,45687,21568,24119,12746,32178,763,ITF,ITF4,16,Puglia,Puglia,4029053,4386526,108.87,1.13
1537,2021-03-20,PUG,8430,3888,4542,3768,4618,44,ITF,ITF4,16,Puglia,Puglia,4029053,4394956,109.08,0.21
1538,2021-03-03,PUG,16809,6819,9990,14726,1935,148,ITF,ITF4,16,Puglia,Puglia,4029053,4411765,109.5,0.42
1539,2021-06-11,PUG,47965,23466,24499,32984,14072,909,ITF,ITF4,16,Puglia,Puglia,4029053,4459730,110.69,1.19
1540,2021-04-03,PUG,10578,4658,5920,6818,3567,193,ITF,ITF4,16,Puglia,Puglia,4029053,4470308,110.95,0.26
1541,2021-05-16,PUG,24623,11107,13516,12461,11937,225,ITF,ITF4,16,Puglia,Puglia,4029053,4494931,111.56,0.61
1542,2021-08-02,PUG,38975,19764,19211,14010,23740,1225,ITF,ITF4,16,Puglia,Puglia,4029053,4533906,112.53,0.97
1543,2021-03-01,PUG,15125,5877,9248,13588,1385,152,ITF,ITF4,16,Puglia,Puglia,4029053,4549031,112.91,0.38
1544,2021-01-10,PUG,2350,1062,1288,2350,0,0,ITF,ITF4,16,Puglia,Puglia,4029053,4551381,112.96,0.06
1545,2021-04-20,PUG,21210,9852,11358,17465,3479,266,ITF,ITF4,16,Puglia,Puglia,4029053,4572591,113.49,0.53
1546,2020-12-27,PUG,510,252,258,510,0,0,ITF,ITF4,16,Puglia,Puglia,4029053,4573101,113.5,0.01
1547,2021-04-16,PUG,36113,16976,19137,32400,3283,430,ITF,ITF4,16,Puglia,Puglia,4029053,4609214,114.4,0.9
1548,2021-02-18,PUG,4384,1848,2536,3714,610,60,ITF,ITF4,16,Puglia,Puglia,4029053,4613598,114.51,0.11
1549,2021-07-25,PUG,14281,7387,6894,4274,9800,207,ITF,ITF4,16,Puglia,Puglia,4029053,4627879,114.86,0.35
1550,2021-04-09,PUG,22084,9518,12566,17062,4637,385,ITF,ITF4,16,Puglia,Puglia,4029053,4649963,115.41,0.55
1551,2021-02-11,PUG,3697,1401,2296,2391,1279,27,ITF,ITF4,16,Puglia,Puglia,4029053,4653660,115.5,0.09
1552,2021-07-18,PUG,18795,9623,9172,6214,12239,342,ITF,ITF4,16,Puglia,Puglia,4029053,4672455,115.97,0.47
1553,2021-05-22,PUG,34748,15912,18836,23642,10561,545,ITF,ITF4,16,Puglia,Puglia,4029053,4707203,116.83,0.86
1554,2021-02-25,PUG,11985,5066,6919,10669,1181,135,ITF,ITF4,16,Puglia,Puglia,4029053,4719188,117.13,0.3
1555,2021-06-05,PUG,42620,20876,21744,29173,12726,721,ITF,ITF4,16,Puglia,Puglia,4029053,4761808,118.19,1.06
1556,2021-08-05,PUG,33211,16698,16513,9071,23280,860,ITF,ITF4,16,Puglia,Puglia,4029053,4795019,119.01,0.82
1557,2021-01-06,PUG,3956,1677,2279,3955,0,1,ITF,ITF4,16,Puglia,Puglia,4029053,4798975,119.11,0.1
1558,2021-06-16,PUG,42103,20721,21382,26885,14491,727,ITF,ITF4,16,Puglia,Puglia,4029053,4841078,120.15,1.04
1559,2020-12-30,PUG,1,0,1,1,0,0,ITF,ITF4,16,Puglia,Puglia,4029053,4841079,120.15,0.0
1560,2021-03-22,PUG,9980,5136,4844,4244,5666,70,ITF,ITF4,16,Puglia,Puglia,4029053,4851059,120.4,0.25
1561,2021-01-24,PUG,1673,754,919,151,1522,0,ITF,ITF4,16,Puglia,Puglia,4029053,4852732,120.44,0.04
1562,2021-06-30,PUG,47770,23176,24594,18794,28118,858,ITF,ITF4,16,Puglia,Puglia,4029053,4900502,121.63,1.19
1563,2021-03-15,PUG,12350,6155,6195,5735,6511,104,ITF,ITF4,16,Puglia,Puglia,4029053,4912852,121.94,0.31
1564,2021-01-17,PUG,1311,592,719,1241,70,0,ITF,ITF4,16,Puglia,Puglia,4029053,4914163,121.97,0.03
1565,2021-06-23,PUG,29412,14369,15043,16944,11855,613,ITF,ITF4,16,Puglia,Puglia,4029053,4943575,122.7,0.73
1566,2021-04-27,PUG,26713,12085,14628,20774,5618,321,ITF,ITF4,16,Puglia,Puglia,4029053,4970288,123.36,0.66
1567,2021-05-11,PUG,32693,14445,18248,13690,18519,484,ITF,ITF4,16,Puglia,Puglia,4029053,5002981,124.17,0.81
1568,2021-05-04,PUG,35191,14884,20307,18233,16545,413,ITF,ITF4,16,Puglia,Puglia,4029053,5038172,125.05,0.87
1569,2021-03-08,PUG,15007,6441,8566,12440,2412,155,ITF,ITF4,16,Puglia,Puglia,4029053,5053179,125.42,0.37
1570,2021-08-03,SIC,32054,15726,16328,13871,17763,420,ITG,ITG1,19,Sicilia,Sicilia,4999891,32054,0.64,0.64
1571,2021-05-31,SIC,38096,17152,20944,21274,16525,297,ITG,ITG1,19,Sicilia,Sicilia,4999891,70150,1.4,0.76
1572,2021-03-02,SIC,14763,6372,8391,11870,2779,114,ITG,ITG1,19,Sicilia,Sicilia,4999891,84913,1.7,0.3
1573,2021-01-04,SIC,8501,4244,4257,8454,0,47,ITG,ITG1,19,Sicilia,Sicilia,4999891,93414,1.87,0.17
1574,2021-01-18,SIC,1621,674,947,1453,157,11,ITG,ITG1,19,Sicilia,Sicilia,4999891,95035,1.9,0.03
1575,2021-04-28,SIC,29280,13718,15562,19726,9160,394,ITG,ITG1,19,Sicilia,Sicilia,4999891,124315,2.49,0.59
1576,2021-08-10,SIC,21964,10929,11035,10756,10951,257,ITG,ITG1,19,Sicilia,Sicilia,4999891,146279,2.93,0.44
1577,2021-04-11,SIC,15383,7599,7784,8235,7037,111,ITG,ITG1,19,Sicilia,Sicilia,4999891,161662,3.23,0.31
1578,2021-07-20,SIC,48425,23586,24839,12781,35294,350,ITG,ITG1,19,Sicilia,Sicilia,4999891,210087,4.2,0.97
1579,2020-12-30,SIC,185,109,76,184,0,1,ITG,ITG1,19,Sicilia,Sicilia,4999891,210272,4.21,0.0
1580,2021-01-16,SIC,2736,1220,1516,2715,0,21,ITG,ITG1,19,Sicilia,Sicilia,4999891,213008,4.26,0.05
1581,2021-07-01,SIC,30964,14067,16897,10726,19981,257,ITG,ITG1,19,Sicilia,Sicilia,4999891,243972,4.88,0.62
1582,2021-04-09,SIC,20234,9845,10389,10937,9038,259,ITG,ITG1,19,Sicilia,Sicilia,4999891,264206,5.28,0.4
1583,2021-03-23,SIC,20958,10082,10876,15233,5565,160,ITG,ITG1,19,Sicilia,Sicilia,4999891,285164,5.7,0.42
1584,2021-01-30,SIC,7727,3550,4177,155,7569,3,ITG,ITG1,19,Sicilia,Sicilia,4999891,292891,5.86,0.15
1585,2021-03-28,SIC,10979,5146,5833,6901,4011,67,ITG,ITG1,19,Sicilia,Sicilia,4999891,303870,6.08,0.22
1586,2021-07-15,SIC,48338,22441,25897,7984,40093,261,ITG,ITG1,19,Sicilia,Sicilia,4999891,352208,7.04,0.97
1587,2021-02-13,SIC,2978,1123,1855,2686,255,37,ITG,ITG1,19,Sicilia,Sicilia,4999891,355186,7.1,0.06
1588,2021-05-24,SIC,35875,17441,18434,15591,20051,233,ITG,ITG1,19,Sicilia,Sicilia,4999891,391061,7.82,0.72
1589,2021-05-17,SIC,31922,15405,16517,18997,12637,288,ITG,ITG1,19,Sicilia,Sicilia,4999891,422983,8.46,0.64
1590,2021-08-01,SIC,19956,10423,9533,7851,11958,147,ITG,ITG1,19,Sicilia,Sicilia,4999891,442939,8.86,0.4
1591,2021-06-19,SIC,44270,21050,23220,18752,25199,319,ITG,ITG1,19,Sicilia,Sicilia,4999891,487209,9.74,0.89
1592,2021-04-23,SIC,28629,13722,14907,22418,5839,372,ITG,ITG1,19,Sicilia,Sicilia,4999891,515838,10.32,0.57
1593,2021-06-26,SIC,37260,17777,19483,16352,20602,306,ITG,ITG1,19,Sicilia,Sicilia,4999891,553098,11.06,0.75
1594,2021-04-30,SIC,35025,16347,18678,23534,11031,460,ITG,ITG1,19,Sicilia,Sicilia,4999891,588123,11.76,0.7
1595,2021-02-25,SIC,9942,5206,4736,8688,1164,90,ITG,ITG1,19,Sicilia,Sicilia,4999891,598065,11.96,0.2
1596,2021-06-05,SIC,59947,28515,31432,48736,10590,621,ITG,ITG1,19,Sicilia,Sicilia,4999891,658012,13.16,1.2
1597,2021-03-14,SIC,8774,3927,4847,4885,3836,53,ITG,ITG1,19,Sicilia,Sicilia,4999891,666786,13.34,0.18
1598,2021-02-11,SIC,5240,2061,3179,4656,466,118,ITG,ITG1,19,Sicilia,Sicilia,4999891,672026,13.44,0.1
1599,2021-06-24,SIC,42291,19635,22656,17584,24349,358,ITG,ITG1,19,Sicilia,Sicilia,4999891,714317,14.29,0.85
1600,2021-06-07,SIC,49683,23413,26270,41116,8035,532,ITG,ITG1,19,Sicilia,Sicilia,4999891,764000,15.28,0.99
1601,2021-01-25,SIC,7444,3687,3757,275,7162,7,ITG,ITG1,19,Sicilia,Sicilia,4999891,771444,15.43,0.15
1602,2021-05-05,SIC,26383,12218,14165,16269,9678,436,ITG,ITG1,19,Sicilia,Sicilia,4999891,797827,15.96,0.53
1603,2021-05-19,SIC,42874,20762,22112,28183,14321,370,ITG,ITG1,19,Sicilia,Sicilia,4999891,840701,16.81,0.86
1604,2021-07-27,SIC,43259,21436,21823,19247,23550,462,ITG,ITG1,19,Sicilia,Sicilia,4999891,883960,17.68,0.87
1605,2021-02-23,SIC,8785,4667,4118,8230,468,87,ITG,ITG1,19,Sicilia,Sicilia,4999891,892745,17.86,0.18
1606,2021-03-09,SIC,13161,5766,7395,10833,2200,128,ITG,ITG1,19,Sicilia,Sicilia,4999891,905906,18.12,0.26
1607,2021-01-11,SIC,5912,2610,3302,5854,0,58,ITG,ITG1,19,Sicilia,Sicilia,4999891,911818,18.24,0.12
1608,2021-02-18,SIC,5332,3139,2193,4836,430,66,ITG,ITG1,19,Sicilia,Sicilia,4999891,917150,18.34,0.11
1609,2021-05-12,SIC,36852,17377,19475,21407,14920,525,ITG,ITG1,19,Sicilia,Sicilia,4999891,954002,19.08,0.74
1610,2021-07-17,SIC,49312,24292,25020,9317,39697,298,ITG,ITG1,19,Sicilia,Sicilia,4999891,1003314,20.07,0.99
1611,2021-04-08,SIC,19005,9343,9662,9274,9543,188,ITG,ITG1,19,Sicilia,Sicilia,4999891,1022319,20.45,0.38
1612,2020-12-28,SIC,222,135,87,221,0,1,ITG,ITG1,19,Sicilia,Sicilia,4999891,1022541,20.45,0.0
1613,2021-04-04,SIC,6811,3324,3487,5454,1293,64,ITG,ITG1,19,Sicilia,Sicilia,4999891,1029352,20.59,0.14
1614,2021-07-13,SIC,46065,21149,24916,6896,38954,215,ITG,ITG1,19,Sicilia,Sicilia,4999891,1075417,21.51,0.92
1615,2021-03-21,SIC,15223,7340,7883,11185,3969,69,ITG,ITG1,19,Sicilia,Sicilia,4999891,1090640,21.81,0.3
1616,2021-02-06,SIC,4735,2118,2617,1448,3266,21,ITG,ITG1,19,Sicilia,Sicilia,4999891,1095375,21.91,0.09
1617,2021-02-04,SIC,6757,3079,3678,1423,5305,29,ITG,ITG1,19,Sicilia,Sicilia,4999891,1102132,22.04,0.14
1618,2021-01-01,SIC,823,441,382,819,0,4,ITG,ITG1,19,Sicilia,Sicilia,4999891,1102955,22.06,0.02
1619,2021-04-20,SIC,19000,9005,9995,13455,5248,297,ITG,ITG1,19,Sicilia,Sicilia,4999891,1121955,22.44,0.38
1620,2021-03-04,SIC,15241,6697,8544,10994,4121,126,ITG,ITG1,19,Sicilia,Sicilia,4999891,1137196,22.74,0.3
1621,2021-08-08,SIC,15367,8152,7215,7463,7716,188,ITG,ITG1,19,Sicilia,Sicilia,4999891,1152563,23.05,0.31
1622,2021-06-12,SIC,45787,22398,23389,39367,5893,527,ITG,ITG1,19,Sicilia,Sicilia,4999891,1198350,23.97,0.92
1623,2021-05-07,SIC,36570,17263,19307,24596,11617,357,ITG,ITG1,19,Sicilia,Sicilia,4999891,1234920,24.7,0.73
1624,2021-03-11,SIC,15441,6705,8736,12874,2418,149,ITG,ITG1,19,Sicilia,Sicilia,4999891,1250361,25.01,0.31
1625,2021-01-27,SIC,7293,3712,3581,173,7119,1,ITG,ITG1,19,Sicilia,Sicilia,4999891,1257654,25.15,0.15
1626,2021-04-16,SIC,28872,14505,14367,20257,8296,319,ITG,ITG1,19,Sicilia,Sicilia,4999891,1286526,25.73,0.58
1627,2021-01-23,SIC,4486,2308,2178,213,4263,10,ITG,ITG1,19,Sicilia,Sicilia,4999891,1291012,25.82,0.09
1628,2021-01-06,SIC,6257,3292,2965,6197,0,60,ITG,ITG1,19,Sicilia,Sicilia,4999891,1297269,25.95,0.13
1629,2021-04-02,SIC,13895,6554,7341,9048,4735,112,ITG,ITG1,19,Sicilia,Sicilia,4999891,1311164,26.22,0.28
1630,2021-02-10,SIC,4354,1775,2579,3888,381,85,ITG,ITG1,19,Sicilia,Sicilia,4999891,1315518,26.31,0.09
1631,2021-05-21,SIC,48698,23073,25625,26659,21617,422,ITG,ITG1,19,Sicilia,Sicilia,4999891,1364216,27.28,0.97
1632,2021-03-16,SIC,9624,4324,5300,3556,5999,69,ITG,ITG1,19,Sicilia,Sicilia,4999891,1373840,27.48,0.19
1633,2021-07-08,SIC,38356,17474,20882,6530,31607,219,ITG,ITG1,19,Sicilia,Sicilia,4999891,1412196,28.24,0.77
1634,2021-02-27,SIC,12239,5506,6733,10936,1204,99,ITG,ITG1,19,Sicilia,Sicilia,4999891,1424435,28.49,0.24
1635,2021-05-16,SIC,33702,16440,17262,21891,11517,294,ITG,ITG1,19,Sicilia,Sicilia,4999891,1458137,29.16,0.67
1636,2021-05-02,SIC,24606,11428,13178,17700,6603,303,ITG,ITG1,19,Sicilia,Sicilia,4999891,1482743,29.66,0.49
1637,2021-03-20,SIC,18592,8981,9611,13362,5138,92,ITG,ITG1,19,Sicilia,Sicilia,4999891,1501335,30.03,0.37
1638,2021-06-28,SIC,31911,14861,17050,14884,16733,294,ITG,ITG1,19,Sicilia,Sicilia,4999891,1533246,30.67,0.64
1639,2021-02-20,SIC,7171,3708,3463,6802,272,97,ITG,ITG1,19,Sicilia,Sicilia,4999891,1540417,30.81,0.14
1640,2021-02-03,SIC,5942,2793,3149,712,5222,8,ITG,ITG1,19,Sicilia,Sicilia,4999891,1546359,30.93,0.12
1641,2021-04-27,SIC,26457,12688,13769,15170,10954,333,ITG,ITG1,19,Sicilia,Sicilia,4999891,1572816,31.46,0.53
1642,2021-08-05,SIC,23965,11907,12058,11604,12060,301,ITG,ITG1,19,Sicilia,Sicilia,4999891,1596781,31.94,0.48
1643,2021-05-14,SIC,52196,24474,27722,35758,15672,766,ITG,ITG1,19,Sicilia,Sicilia,4999891,1648977,32.98,1.04
1644,2021-06-16,SIC,40404,18788,21616,21240,18808,356,ITG,ITG1,19,Sicilia,Sicilia,4999891,1689381,33.79,0.81
1645,2021-03-25,SIC,20467,9530,10937,14750,5545,172,ITG,ITG1,19,Sicilia,Sicilia,4999891,1709848,34.2,0.41
1646,2021-07-03,SIC,33912,16295,17617,9045,24625,242,ITG,ITG1,19,Sicilia,Sicilia,4999891,1743760,34.88,0.68
1647,2021-03-06,SIC,12643,5061,7582,9761,2782,100,ITG,ITG1,19,Sicilia,Sicilia,4999891,1756403,35.13,0.25
1648,2021-06-14,SIC,43477,20651,22826,28158,14893,426,ITG,ITG1,19,Sicilia,Sicilia,4999891,1799880,36.0,0.87
1649,2021-05-28,SIC,51252,22979,28273,24309,26527,416,ITG,ITG1,19,Sicilia,Sicilia,4999891,1851132,37.02,1.03
1650,2021-06-04,SIC,57862,26766,31096,45407,11952,503,ITG,ITG1,19,Sicilia,Sicilia,4999891,1908994,38.18,1.16
1651,2021-04-06,SIC,17761,8486,9275,13259,4293,209,ITG,ITG1,19,Sicilia,Sicilia,4999891,1926755,38.54,0.36
1652,2021-02-22,SIC,7947,4132,3815,7374,493,80,ITG,ITG1,19,Sicilia,Sicilia,4999891,1934702,38.69,0.16
1653,2020-12-27,SIC,92,55,37,91,0,1,ITG,ITG1,19,Sicilia,Sicilia,4999891,1934794,38.7,0.0
1654,2021-06-02,SIC,35281,16298,18983,27106,7780,395,ITG,ITG1,19,Sicilia,Sicilia,4999891,1970075,39.4,0.71
1655,2021-07-29,SIC,36151,17871,18280,14313,21499,339,ITG,ITG1,19,Sicilia,Sicilia,4999891,2006226,40.13,0.72
1656,2021-07-24,SIC,40730,21207,19523,16799,23627,304,ITG,ITG1,19,Sicilia,Sicilia,4999891,2046956,40.94,0.81
1657,2021-07-12,SIC,48994,22612,26382,6449,42349,196,ITG,ITG1,19,Sicilia,Sicilia,4999891,2095950,41.92,0.98
1658,2021-02-08,SIC,3887,1680,2207,2080,1758,49,ITG,ITG1,19,Sicilia,Sicilia,4999891,2099837,42.0,0.08
1659,2021-01-22,SIC,1290,642,648,261,1027,2,ITG,ITG1,19,Sicilia,Sicilia,4999891,2101127,42.02,0.03
1660,2021-01-08,SIC,8143,3792,4351,8051,0,92,ITG,ITG1,19,Sicilia,Sicilia,4999891,2109270,42.19,0.16
1661,2021-04-18,SIC,19837,9918,9919,15289,4362,186,ITG,ITG1,19,Sicilia,Sicilia,4999891,2129107,42.58,0.4
1662,2021-01-15,SIC,5320,2332,2988,5253,0,67,ITG,ITG1,19,Sicilia,Sicilia,4999891,2134427,42.69,0.11
1663,2021-04-25,SIC,21402,10207,11195,16149,5019,234,ITG,ITG1,19,Sicilia,Sicilia,4999891,2155829,43.12,0.43
1664,2021-02-01,SIC,5951,2641,3310,300,5638,13,ITG,ITG1,19,Sicilia,Sicilia,4999891,2161780,43.24,0.12
1665,2021-03-22,SIC,16680,7915,8765,11161,5425,94,ITG,ITG1,19,Sicilia,Sicilia,4999891,2178460,43.57,0.33
1666,2021-06-30,SIC,32552,15011,17541,11394,20837,321,ITG,ITG1,19,Sicilia,Sicilia,4999891,2211012,44.22,0.65
1667,2020-12-29,SIC,244,152,92,244,0,0,ITG,ITG1,19,Sicilia,Sicilia,4999891,2211256,44.23,0.0
1668,2021-06-13,SIC,34547,17165,17382,30607,3508,432,ITG,ITG1,19,Sicilia,Sicilia,4999891,2245803,44.92,0.69
1669,2021-07-05,SIC,37523,17613,19910,8924,28360,239,ITG,ITG1,19,Sicilia,Sicilia,4999891,2283326,45.67,0.75
1670,2021-06-21,SIC,40250,18634,21616,18425,21497,328,ITG,ITG1,19,Sicilia,Sicilia,4999891,2323576,46.47,0.81
1671,2021-05-09,SIC,28418,13312,15106,19771,8290,357,ITG,ITG1,19,Sicilia,Sicilia,4999891,2351994,47.04,0.57
1672,2021-02-19,SIC,4981,2697,2284,4331,564,86,ITG,ITG1,19,Sicilia,Sicilia,4999891,2356975,47.14,0.1
1673,2021-03-08,SIC,13501,5955,7546,10767,2613,121,ITG,ITG1,19,Sicilia,Sicilia,4999891,2370476,47.41,0.27
1674,2021-02-15,SIC,3773,1768,2005,3135,564,74,ITG,ITG1,19,Sicilia,Sicilia,4999891,2374249,47.49,0.08
1675,2021-07-22,SIC,40598,19939,20659,11214,29091,293,ITG,ITG1,19,Sicilia,Sicilia,4999891,2414847,48.3,0.81
1676,2021-05-26,SIC,44696,21017,23679,23896,20455,345,ITG,ITG1,19,Sicilia,Sicilia,4999891,2459543,49.19,0.89
1677,2021-01-03,SIC,4800,2507,2293,4769,0,31,ITG,ITG1,19,Sicilia,Sicilia,4999891,2464343,49.29,0.1
1678,2021-04-13,SIC,20250,9869,10381,11238,8839,173,ITG,ITG1,19,Sicilia,Sicilia,4999891,2484593,49.69,0.41
1679,2021-07-31,SIC,28732,14926,13806,10445,18022,265,ITG,ITG1,19,Sicilia,Sicilia,4999891,2513325,50.27,0.57
1680,2021-01-10,SIC,3565,1598,1967,3544,0,21,ITG,ITG1,19,Sicilia,Sicilia,4999891,2516890,50.34,0.07
1681,2021-03-01,SIC,12764,6072,6692,10980,1657,127,ITG,ITG1,19,Sicilia,Sicilia,4999891,2529654,50.59,0.26
1682,2021-06-09,SIC,49781,23677,26104,41912,7260,609,ITG,ITG1,19,Sicilia,Sicilia,4999891,2579435,51.59,1.0
1683,2021-08-09,SIC,25353,12947,12406,12589,12388,376,ITG,ITG1,19,Sicilia,Sicilia,4999891,2604788,52.1,0.51
1684,2021-04-01,SIC,14316,6627,7689,9511,4667,138,ITG,ITG1,19,Sicilia,Sicilia,4999891,2619104,52.38,0.29
1685,2021-07-10,SIC,46901,22349,24552,6058,40639,204,ITG,ITG1,19,Sicilia,Sicilia,4999891,2666005,53.32,0.94
1686,2021-04-10,SIC,20440,9973,10467,11313,8965,162,ITG,ITG1,19,Sicilia,Sicilia,4999891,2686445,53.73,0.41
1687,2021-01-17,SIC,1311,596,715,1238,64,9,ITG,ITG1,19,Sicilia,Sicilia,4999891,2687756,53.76,0.03
1688,2021-07-02,SIC,30556,14230,16326,9928,20342,286,ITG,ITG1,19,Sicilia,Sicilia,4999891,2718312,54.37,0.61
1689,2021-03-30,SIC,14578,6769,7809,9713,4766,99,ITG,ITG1,19,Sicilia,Sicilia,4999891,2732890,54.66,0.29
1690,2021-03-13,SIC,12215,5389,6826,7628,4494,93,ITG,ITG1,19,Sicilia,Sicilia,4999891,2745105,54.9,0.24
1691,2021-04-17,SIC,26012,13154,12858,18676,7065,271,ITG,ITG1,19,Sicilia,Sicilia,4999891,2771117,55.42,0.52
1692,2021-07-26,SIC,44488,22161,22327,16689,27429,370,ITG,ITG1,19,Sicilia,Sicilia,4999891,2815605,56.31,0.89
1693,2021-03-17,SIC,15051,7442,7609,9078,5847,126,ITG,ITG1,19,Sicilia,Sicilia,4999891,2830656,56.61,0.3
1694,2021-06-25,SIC,39784,18669,21115,17374,22073,337,ITG,ITG1,19,Sicilia,Sicilia,4999891,2870440,57.41,0.8
1695,2021-07-09,SIC,44811,20674,24137,6412,38223,176,ITG,ITG1,19,Sicilia,Sicilia,4999891,2915251,58.31,0.9
1696,2021-02-05,SIC,6785,3003,3782,2088,4659,38,ITG,ITG1,19,Sicilia,Sicilia,4999891,2922036,58.44,0.14
1697,2021-04-03,SIC,16419,7817,8602,13425,2835,159,ITG,ITG1,19,Sicilia,Sicilia,4999891,2938455,58.77,0.33
1698,2021-05-30,SIC,35771,16174,19597,17423,18052,296,ITG,ITG1,19,Sicilia,Sicilia,4999891,2974226,59.49,0.72
1699,2021-05-13,SIC,47461,22254,25207,30294,16541,626,ITG,ITG1,19,Sicilia,Sicilia,4999891,3021687,60.44,0.95
1700,2021-01-31,SIC,4061,1944,2117,107,3952,2,ITG,ITG1,19,Sicilia,Sicilia,4999891,3025748,60.52,0.08
1701,2021-05-11,SIC,32680,15501,17179,19690,12490,500,ITG,ITG1,19,Sicilia,Sicilia,4999891,3058428,61.17,0.65
1702,2021-02-17,SIC,5219,3204,2015,4500,671,48,ITG,ITG1,19,Sicilia,Sicilia,4999891,3063647,61.27,0.1
1703,2021-04-24,SIC,31191,14716,16475,23153,7637,401,ITG,ITG1,19,Sicilia,Sicilia,4999891,3094838,61.9,0.62
1704,2021-08-02,SIC,32950,16378,16572,12844,19762,344,ITG,ITG1,19,Sicilia,Sicilia,4999891,3127788,62.56,0.66
1705,2021-01-19,SIC,1517,672,845,1265,238,14,ITG,ITG1,19,Sicilia,Sicilia,4999891,3129305,62.59,0.03
1706,2021-06-11,SIC,49965,23842,26123,41605,7702,658,ITG,ITG1,19,Sicilia,Sicilia,4999891,3179270,63.59,1.0
1707,2021-04-29,SIC,31806,14836,16970,21798,9559,449,ITG,ITG1,19,Sicilia,Sicilia,4999891,3211076,64.22,0.64
1708,2021-03-03,SIC,14573,6547,8026,11373,3073,127,ITG,ITG1,19,Sicilia,Sicilia,4999891,3225649,64.51,0.29
1709,2021-08-07,SIC,20148,10444,9704,10894,8916,338,ITG,ITG1,19,Sicilia,Sicilia,4999891,3245797,64.92,0.4
1710,2021-01-05,SIC,10396,5108,5288,10320,0,76,ITG,ITG1,19,Sicilia,Sicilia,4999891,3256193,65.13,0.21
1711,2021-04-15,SIC,21570,10488,11082,12008,9349,213,ITG,ITG1,19,Sicilia,Sicilia,4999891,3277763,65.56,0.43
1712,2021-06-20,SIC,33421,15817,17604,15118,18043,260,ITG,ITG1,19,Sicilia,Sicilia,4999891,3311184,66.23,0.67
1713,2021-07-19,SIC,48928,23577,25351,11654,36919,355,ITG,ITG1,19,Sicilia,Sicilia,4999891,3360112,67.2,0.98
1714,2021-03-05,SIC,15766,6837,8929,11378,4238,150,ITG,ITG1,19,Sicilia,Sicilia,4999891,3375878,67.52,0.32
1715,2021-02-16,SIC,4200,2207,1993,3664,465,71,ITG,ITG1,19,Sicilia,Sicilia,4999891,3380078,67.6,0.08
1716,2021-06-23,SIC,44472,20695,23777,17901,26238,333,ITG,ITG1,19,Sicilia,Sicilia,4999891,3424550,68.49,0.89
1717,2021-01-24,SIC,4328,2264,2064,129,4197,2,ITG,ITG1,19,Sicilia,Sicilia,4999891,3428878,68.58,0.09
1718,2021-05-04,SIC,26848,12473,14375,17151,9293,404,ITG,ITG1,19,Sicilia,Sicilia,4999891,3455726,69.12,0.54
1719,2021-06-06,SIC,49524,23918,25606,41143,7825,556,ITG,ITG1,19,Sicilia,Sicilia,4999891,3505250,70.11,0.99
1720,2021-02-26,SIC,11978,5874,6104,10181,1681,116,ITG,ITG1,19,Sicilia,Sicilia,4999891,3517228,70.35,0.24
1721,2021-05-06,SIC,29474,14008,15466,18161,10834,479,ITG,ITG1,19,Sicilia,Sicilia,4999891,3546702,70.94,0.59
1722,2021-03-27,SIC,15690,7403,8287,10684,4885,121,ITG,ITG1,19,Sicilia,Sicilia,4999891,3562392,71.25,0.31
1723,2021-01-29,SIC,9187,4258,4929,411,8764,12,ITG,ITG1,19,Sicilia,Sicilia,4999891,3571579,71.43,0.18
1724,2021-02-12,SIC,4606,1829,2777,4241,286,79,ITG,ITG1,19,Sicilia,Sicilia,4999891,3576185,71.53,0.09
1725,2021-05-23,SIC,34093,16598,17495,19846,14016,231,ITG,ITG1,19,Sicilia,Sicilia,4999891,3610278,72.21,0.68
1726,2021-06-10,SIC,53040,24899,28141,45149,7242,649,ITG,ITG1,19,Sicilia,Sicilia,4999891,3663318,73.27,1.06
1727,2021-05-27,SIC,47587,21915,25672,24456,22715,416,ITG,ITG1,19,Sicilia,Sicilia,4999891,3710905,74.22,0.95
1728,2021-04-14,SIC,20581,9941,10640,11626,8766,189,ITG,ITG1,19,Sicilia,Sicilia,4999891,3731486,74.63,0.41
1729,2021-07-23,SIC,41429,20811,20618,14344,26763,322,ITG,ITG1,19,Sicilia,Sicilia,4999891,3772915,75.46,0.83
1730,2021-08-06,SIC,24872,12635,12237,13533,10934,405,ITG,ITG1,19,Sicilia,Sicilia,4999891,3797787,75.96,0.5
1731,2021-04-26,SIC,21699,10275,11424,13304,8082,313,ITG,ITG1,19,Sicilia,Sicilia,4999891,3819486,76.39,0.43
1732,2021-02-02,SIC,5319,2493,2826,615,4694,10,ITG,ITG1,19,Sicilia,Sicilia,4999891,3824805,76.5,0.11
1733,2021-02-24,SIC,9377,4805,4572,8707,565,105,ITG,ITG1,19,Sicilia,Sicilia,4999891,3834182,76.69,0.19
1734,2021-01-21,SIC,1452,714,738,490,951,11,ITG,ITG1,19,Sicilia,Sicilia,4999891,3835634,76.71,0.03
1735,2021-05-01,SIC,24445,11314,13131,18996,5167,282,ITG,ITG1,19,Sicilia,Sicilia,4999891,3860079,77.2,0.49
1736,2021-07-06,SIC,37128,17167,19961,10315,26502,311,ITG,ITG1,19,Sicilia,Sicilia,4999891,3897207,77.95,0.74
1737,2021-05-10,SIC,28730,13789,14941,16210,12212,308,ITG,ITG1,19,Sicilia,Sicilia,4999891,3925937,78.52,0.57
1738,2021-04-22,SIC,26769,12640,14129,19896,6459,414,ITG,ITG1,19,Sicilia,Sicilia,4999891,3952706,79.06,0.54
1739,2021-03-10,SIC,13932,6123,7809,11612,2183,137,ITG,ITG1,19,Sicilia,Sicilia,4999891,3966638,79.33,0.28
1740,2021-01-12,SIC,4364,2136,2228,4319,0,45,ITG,ITG1,19,Sicilia,Sicilia,4999891,3971002,79.42,0.09
1741,2021-06-18,SIC,43589,20146,23443,18852,24367,370,ITG,ITG1,19,Sicilia,Sicilia,4999891,4014591,80.29,0.87
1742,2021-06-27,SIC,25310,12204,13106,12101,12978,231,ITG,ITG1,19,Sicilia,Sicilia,4999891,4039901,80.8,0.51
1743,2021-05-15,SIC,56491,26393,30098,40345,15241,905,ITG,ITG1,19,Sicilia,Sicilia,4999891,4096392,81.93,1.13
1744,2021-03-19,SIC,16316,8056,8260,10650,5575,91,ITG,ITG1,19,Sicilia,Sicilia,4999891,4112708,82.26,0.33
1745,2021-03-15,SIC,10673,4726,5947,5645,4949,79,ITG,ITG1,19,Sicilia,Sicilia,4999891,4123381,82.47,0.21
1746,2021-06-17,SIC,41827,19477,22350,20319,21141,367,ITG,ITG1,19,Sicilia,Sicilia,4999891,4165208,83.31,0.84
1747,2020-12-31,SIC,893,475,418,885,0,8,ITG,ITG1,19,Sicilia,Sicilia,4999891,4166101,83.32,0.02
1748,2021-03-07,SIC,9261,3454,5807,8118,1083,60,ITG,ITG1,19,Sicilia,Sicilia,4999891,4175362,83.51,0.19
1749,2021-06-15,SIC,46107,21724,24383,28157,17519,431,ITG,ITG1,19,Sicilia,Sicilia,4999891,4221469,84.43,0.92
1750,2021-03-24,SIC,20970,9872,11098,15042,5737,191,ITG,ITG1,19,Sicilia,Sicilia,4999891,4242439,84.85,0.42
1751,2021-03-31,SIC,14519,6706,7813,9444,4932,143,ITG,ITG1,19,Sicilia,Sicilia,4999891,4256958,85.14,0.29
1752,2021-01-07,SIC,8967,4146,4821,8886,0,81,ITG,ITG1,19,Sicilia,Sicilia,4999891,4265925,85.32,0.18
1753,2021-04-21,SIC,22400,10751,11649,16001,6122,277,ITG,ITG1,19,Sicilia,Sicilia,4999891,4288325,85.77,0.45
1754,2021-04-07,SIC,18447,9064,9383,9742,8514,191,ITG,ITG1,19,Sicilia,Sicilia,4999891,4306772,86.14,0.37
1755,2021-07-16,SIC,49310,23355,25955,8712,40317,281,ITG,ITG1,19,Sicilia,Sicilia,4999891,4356082,87.12,0.99
1756,2021-07-30,SIC,32439,16060,16379,12054,20100,285,ITG,ITG1,19,Sicilia,Sicilia,4999891,4388521,87.77,0.65
1757,2021-06-03,SIC,45997,21096,24901,33766,11715,516,ITG,ITG1,19,Sicilia,Sicilia,4999891,4434518,88.69,0.92
1758,2021-08-04,SIC,24302,11987,12315,10947,13034,321,ITG,ITG1,19,Sicilia,Sicilia,4999891,4458820,89.18,0.49
1759,2021-07-18,SIC,39275,19783,19492,8106,30939,230,ITG,ITG1,19,Sicilia,Sicilia,4999891,4498095,89.96,0.79
1760,2021-01-14,SIC,5261,2489,2772,5199,0,62,ITG,ITG1,19,Sicilia,Sicilia,4999891,4503356,90.07,0.11
1761,2021-05-29,SIC,47176,21465,25711,23529,23200,447,ITG,ITG1,19,Sicilia,Sicilia,4999891,4550532,91.01,0.94
1762,2021-03-26,SIC,17994,8359,9635,12350,5500,144,ITG,ITG1,19,Sicilia,Sicilia,4999891,4568526,91.37,0.36
1763,2021-01-28,SIC,9035,4274,4761,374,8660,1,ITG,ITG1,19,Sicilia,Sicilia,4999891,4577561,91.55,0.18
1764,2021-07-04,SIC,26510,12802,13708,7621,18718,171,ITG,ITG1,19,Sicilia,Sicilia,4999891,4604071,92.08,0.53
1765,2021-05-08,SIC,35646,17034,18612,24950,10306,390,ITG,ITG1,19,Sicilia,Sicilia,4999891,4639717,92.8,0.71
1766,2021-01-26,SIC,9576,4742,4834,231,9344,1,ITG,ITG1,19,Sicilia,Sicilia,4999891,4649293,92.99,0.19
1767,2021-07-28,SIC,37650,18860,18790,14684,22645,321,ITG,ITG1,19,Sicilia,Sicilia,4999891,4686943,93.74,0.75
1768,2021-06-22,SIC,39982,18375,21607,18298,21309,375,ITG,ITG1,19,Sicilia,Sicilia,4999891,4726925,94.54,0.8
1769,2021-03-12,SIC,12866,5560,7306,10645,2067,154,ITG,ITG1,19,Sicilia,Sicilia,4999891,4739791,94.8,0.26
1770,2021-06-29,SIC,31380,14696,16684,15663,15315,402,ITG,ITG1,19,Sicilia,Sicilia,4999891,4771171,95.43,0.63
1771,2021-02-09,SIC,4349,1800,2549,3249,1035,65,ITG,ITG1,19,Sicilia,Sicilia,4999891,4775520,95.51,0.09
1772,2021-05-20,SIC,44073,21117,22956,27737,15921,415,ITG,ITG1,19,Sicilia,Sicilia,4999891,4819593,96.39,0.88
1773,2021-05-22,SIC,48014,22808,25206,28305,19312,397,ITG,ITG1,19,Sicilia,Sicilia,4999891,4867607,97.35,0.96
1774,2021-02-28,SIC,7130,3032,4098,6454,630,46,ITG,ITG1,19,Sicilia,Sicilia,4999891,4874737,97.5,0.14
1775,2021-06-08,SIC,47695,22401,25294,40453,6708,534,ITG,ITG1,19,Sicilia,Sicilia,4999891,4922432,98.45,0.95
1776,2021-08-11,SIC,12385,6290,6095,6422,5759,204,ITG,ITG1,19,Sicilia,Sicilia,4999891,4934817,98.7,0.25
1777,2021-01-09,SIC,7238,3413,3825,7177,0,61,ITG,ITG1,19,Sicilia,Sicilia,4999891,4942055,98.84,0.14
1778,2021-05-03,SIC,23316,10800,12516,13266,9789,261,ITG,ITG1,19,Sicilia,Sicilia,4999891,4965371,99.31,0.47
1779,2021-07-11,SIC,36033,16869,19164,3663,32275,95,ITG,ITG1,19,Sicilia,Sicilia,4999891,5001404,100.03,0.72
1780,2021-07-25,SIC,31802,16760,15042,11846,19698,258,ITG,ITG1,19,Sicilia,Sicilia,4999891,5033206,100.67,0.64
1781,2021-04-19,SIC,18294,8669,9625,12480,5585,229,ITG,ITG1,19,Sicilia,Sicilia,4999891,5051500,101.03,0.37
1782,2021-01-13,SIC,5183,2443,2740,5149,0,34,ITG,ITG1,19,Sicilia,Sicilia,4999891,5056683,101.14,0.1
1783,2021-01-20,SIC,966,513,453,690,273,3,ITG,ITG1,19,Sicilia,Sicilia,4999891,5057649,101.16,0.02
1784,2021-03-18,SIC,15417,7760,7657,9744,5619,54,ITG,ITG1,19,Sicilia,Sicilia,4999891,5073066,101.46,0.31
1785,2021-02-07,SIC,2321,982,1339,664,1648,9,ITG,ITG1,19,Sicilia,Sicilia,4999891,5075387,101.51,0.05
1786,2021-07-14,SIC,47487,21997,25490,7928,39303,256,ITG,ITG1,19,Sicilia,Sicilia,4999891,5122874,102.46,0.95
1787,2021-05-18,SIC,36125,17391,18734,23242,12484,399,ITG,ITG1,19,Sicilia,Sicilia,4999891,5158999,103.18,0.72
1788,2021-07-21,SIC,42922,20948,21974,10629,31984,309,ITG,ITG1,19,Sicilia,Sicilia,4999891,5201921,104.04,0.86
1789,2021-07-07,SIC,35463,16223,19240,6085,29137,241,ITG,ITG1,19,Sicilia,Sicilia,4999891,5237384,104.75,0.71
1790,2021-05-25,SIC,33548,15424,18124,13939,19350,259,ITG,ITG1,19,Sicilia,Sicilia,4999891,5270932,105.42,0.67
1791,2021-03-29,SIC,15038,7080,7958,10398,4498,142,ITG,ITG1,19,Sicilia,Sicilia,4999891,5285970,105.72,0.3
1792,2021-06-01,SIC,38991,17722,21269,24595,14044,352,ITG,ITG1,19,Sicilia,Sicilia,4999891,5324961,106.5,0.78
1793,2021-04-05,SIC,8022,3957,4065,6515,1440,67,ITG,ITG1,19,Sicilia,Sicilia,4999891,5332983,106.66,0.16
1794,2021-04-12,SIC,19016,9219,9797,11494,7276,246,ITG,ITG1,19,Sicilia,Sicilia,4999891,5351999,107.04,0.38
1795,2021-02-14,SIC,1055,402,653,905,140,10,ITG,ITG1,19,Sicilia,Sicilia,4999891,5353054,107.06,0.02
1796,2021-01-02,SIC,4876,2542,2334,4843,0,33,ITG,ITG1,19,Sicilia,Sicilia,4999891,5357930,107.16,0.1
1797,2021-02-21,SIC,5168,2501,2667,5047,106,15,ITG,ITG1,19,Sicilia,Sicilia,4999891,5363098,107.26,0.1
1798,2021-05-26,EMR,33330,14748,18582,9930,23016,384,ITH,ITH5,8,Emilia-Romagna,Emilia-Romagna,4459477,33330,0.75,0.75
1799,2021-06-12,EMR,41371,21874,19497,35560,4917,894,ITH,ITH5,8,Emilia-Romagna,Emilia-Romagna,4459477,74701,1.68,0.93
1800,2021-03-04,EMR,16452,5348,11104,13339,3023,90,ITH,ITH5,8,Emilia-Romagna,Emilia-Romagna,4459477,91153,2.04,0.37
1801,2021-05-24,EMR,29993,13730,16263,17960,11519,514,ITH,ITH5,8,Emilia-Romagna,Emilia-Romagna,4459477,121146,2.72,0.67
1802,2021-02-13,EMR,3628,1084,2544,3016,598,14,ITH,ITH5,8,Emilia-Romagna,Emilia-Romagna,4459477,124774,2.8,0.08
1803,2021-01-23,EMR,2448,871,1577,440,2008,0,ITH,ITH5,8,Emilia-Romagna,Emilia-Romagna,4459477,127222,2.85,0.05
1804,2021-05-07,EMR,35313,16978,18335,22739,11879,695,ITH,ITH5,8,Emilia-Romagna,Emilia-Romagna,4459477,162535,3.64,0.79
1805,2021-07-03,EMR,32097,15924,16173,11463,19999,635,ITH,ITH5,8,Emilia-Romagna,Emilia-Romagna,4459477,194632,4.36,0.72
1806,2021-01-30,EMR,10091,3526,6565,137,9953,1,ITH,ITH5,8,Emilia-Romagna,Emilia-Romagna,4459477,204723,4.59,0.23
1807,2021-07-20,EMR,43021,22503,20518,6652,35715,654,ITH,ITH5,8,Emilia-Romagna,Emilia-Romagna,4459477,247744,5.56,0.96
1808,2021-04-11,EMR,15281,6936,8345,11984,3048,249,ITH,ITH5,8,Emilia-Romagna,Emilia-Romagna,4459477,263025,5.9,0.34
1809,2021-02-11,EMR,4255,1413,2842,3395,843,17,ITH,ITH5,8,Emilia-Romagna,Emilia-Romagna,4459477,267280,5.99,0.1
1810,2021-02-18,EMR,7043,2891,4152,6439,588,16,ITH,ITH5,8,Emilia-Romagna,Emilia-Romagna,4459477,274323,6.15,0.16
1811,2021-06-07,EMR,40514,20793,19721,33502,6262,750,ITH,ITH5,8,Emilia-Romagna,Emilia-Romagna,4459477,314837,7.06,0.91
1812,2021-08-03,EMR,37619,19774,17845,14823,22235,561,ITH,ITH5,8,Emilia-Romagna,Emilia-Romagna,4459477,352456,7.9,0.84
1813,2021-05-12,EMR,38938,18299,20639,28456,9693,789,ITH,ITH5,8,Emilia-Romagna,Emilia-Romagna,4459477,391394,8.78,0.87
1814,2021-02-01,EMR,10320,3611,6709,357,9961,2,ITH,ITH5,8,Emilia-Romagna,Emilia-Romagna,4459477,401714,9.01,0.23
1815,2021-01-18,EMR,3131,880,2251,2449,679,3,ITH,ITH5,8,Emilia-Romagna,Emilia-Romagna,4459477,404845,9.08,0.07
1816,2021-03-16,EMR,12248,5028,7220,4873,7310,65,ITH,ITH5,8,Emilia-Romagna,Emilia-Romagna,4459477,417093,9.35,0.27
1817,2021-01-25,EMR,6464,2148,4316,206,6257,1,ITH,ITH5,8,Emilia-Romagna,Emilia-Romagna,4459477,423557,9.5,0.14
1818,2021-07-01,EMR,34518,16872,17646,14857,18839,822,ITH,ITH5,8,Emilia-Romagna,Emilia-Romagna,4459477,458075,10.27,0.77
1819,2021-03-23,EMR,18800,8146,10654,11951,6688,161,ITH,ITH5,8,Emilia-Romagna,Emilia-Romagna,4459477,476875,10.69,0.42
1820,2021-06-21,EMR,37572,18996,18576,16106,20879,587,ITH,ITH5,8,Emilia-Romagna,Emilia-Romagna,4459477,514447,11.54,0.84
1821,2021-07-08,EMR,41323,20586,20737,4733,36179,411,ITH,ITH5,8,Emilia-Romagna,Emilia-Romagna,4459477,555770,12.46,0.93
1822,2021-03-30,EMR,23327,10328,12999,18012,5041,274,ITH,ITH5,8,Emilia-Romagna,Emilia-Romagna,4459477,579097,12.99,0.52
1823,2021-07-22,EMR,40258,21486,18772,15262,24118,878,ITH,ITH5,8,Emilia-Romagna,Emilia-Romagna,4459477,619355,13.89,0.9
1824,2021-01-04,EMR,7310,2527,4783,7307,0,3,ITH,ITH5,8,Emilia-Romagna,Emilia-Romagna,4459477,626665,14.05,0.16
1825,2021-04-16,EMR,29236,13764,15472,20017,8840,379,ITH,ITH5,8,Emilia-Romagna,Emilia-Romagna,4459477,655901,14.71,0.66
1826,2021-01-06,EMR,8286,2955,5331,8285,0,1,ITH,ITH5,8,Emilia-Romagna,Emilia-Romagna,4459477,664187,14.89,0.19
1827,2021-08-08,EMR,19631,10559,9072,8732,10443,456,ITH,ITH5,8,Emilia-Romagna,Emilia-Romagna,4459477,683818,15.33,0.44
1828,2021-04-30,EMR,36635,16798,19837,21225,14803,607,ITH,ITH5,8,Emilia-Romagna,Emilia-Romagna,4459477,720453,16.16,0.82
1829,2021-03-28,EMR,13525,6042,7483,9521,3883,121,ITH,ITH5,8,Emilia-Romagna,Emilia-Romagna,4459477,733978,16.46,0.3
1830,2021-06-26,EMR,37465,18985,18480,21058,15534,873,ITH,ITH5,8,Emilia-Romagna,Emilia-Romagna,4459477,771443,17.3,0.84
1831,2021-07-10,EMR,42062,21422,20640,6778,34621,663,ITH,ITH5,8,Emilia-Romagna,Emilia-Romagna,4459477,813505,18.24,0.94
1832,2021-05-09,EMR,25626,12259,13367,18264,6972,390,ITH,ITH5,8,Emilia-Romagna,Emilia-Romagna,4459477,839131,18.82,0.57
1833,2021-01-29,EMR,10421,3497,6924,290,10131,0,ITH,ITH5,8,Emilia-Romagna,Emilia-Romagna,4459477,849552,19.05,0.23
1834,2021-02-15,EMR,2903,851,2052,2711,125,67,ITH,ITH5,8,Emilia-Romagna,Emilia-Romagna,4459477,852455,19.12,0.07
1835,2021-07-15,EMR,50252,26171,24081,7879,41659,714,ITH,ITH5,8,Emilia-Romagna,Emilia-Romagna,4459477,902707,20.24,1.13
1836,2021-04-23,EMR,29574,13815,15759,14307,14892,375,ITH,ITH5,8,Emilia-Romagna,Emilia-Romagna,4459477,932281,20.91,0.66
1837,2021-01-13,EMR,9079,2942,6137,9074,0,5,ITH,ITH5,8,Emilia-Romagna,Emilia-Romagna,4459477,941360,21.11,0.2
1838,2021-04-04,EMR,9879,4718,5161,7526,2269,84,ITH,ITH5,8,Emilia-Romagna,Emilia-Romagna,4459477,951239,21.33,0.22
1839,2021-01-11,EMR,9347,3273,6074,9338,0,9,ITH,ITH5,8,Emilia-Romagna,Emilia-Romagna,4459477,960586,21.54,0.21
1840,2021-07-29,EMR,40678,21474,19204,14498,25499,681,ITH,ITH5,8,Emilia-Romagna,Emilia-Romagna,4459477,1001264,22.45,0.91
1841,2021-07-27,EMR,41016,21792,19224,16990,23291,735,ITH,ITH5,8,Emilia-Romagna,Emilia-Romagna,4459477,1042280,23.37,0.92
1842,2021-04-18,EMR,17511,8398,9113,12364,4922,225,ITH,ITH5,8,Emilia-Romagna,Emilia-Romagna,4459477,1059791,23.76,0.39
1843,2021-06-14,EMR,41320,21364,19956,27525,13080,715,ITH,ITH5,8,Emilia-Romagna,Emilia-Romagna,4459477,1101111,24.69,0.93
1844,2021-05-31,EMR,29784,13774,16010,17723,11511,550,ITH,ITH5,8,Emilia-Romagna,Emilia-Romagna,4459477,1130895,25.36,0.67
1845,2021-02-20,EMR,5318,2094,3224,5048,263,7,ITH,ITH5,8,Emilia-Romagna,Emilia-Romagna,4459477,1136213,25.48,0.12
1846,2021-01-15,EMR,7754,2405,5349,7746,0,8,ITH,ITH5,8,Emilia-Romagna,Emilia-Romagna,4459477,1143967,25.65,0.17
1847,2021-06-09,EMR,43098,21890,21208,35740,6394,964,ITH,ITH5,8,Emilia-Romagna,Emilia-Romagna,4459477,1187065,26.62,0.97
1848,2021-03-01,EMR,10100,3583,6517,7814,2261,25,ITH,ITH5,8,Emilia-Romagna,Emilia-Romagna,4459477,1197165,26.85,0.23
1849,2021-03-09,EMR,14799,6032,8767,10752,3952,95,ITH,ITH5,8,Emilia-Romagna,Emilia-Romagna,4459477,1211964,27.18,0.33
1850,2021-05-05,EMR,30133,13999,16134,18300,11270,563,ITH,ITH5,8,Emilia-Romagna,Emilia-Romagna,4459477,1242097,27.85,0.68
1851,2021-05-23,EMR,25495,11864,13631,13577,11603,315,ITH,ITH5,8,Emilia-Romagna,Emilia-Romagna,4459477,1267592,28.42,0.57
1852,2021-07-19,EMR,41929,22085,19844,6613,34716,600,ITH,ITH5,8,Emilia-Romagna,Emilia-Romagna,4459477,1309521,29.36,0.94
1853,2021-05-19,EMR,33822,14992,18830,18032,15259,531,ITH,ITH5,8,Emilia-Romagna,Emilia-Romagna,4459477,1343343,30.12,0.76
1854,2021-06-02,EMR,24108,12065,12043,18750,4974,384,ITH,ITH5,8,Emilia-Romagna,Emilia-Romagna,4459477,1367451,30.66,0.54
1855,2021-08-10,EMR,30273,16188,14085,14491,14828,954,ITH,ITH5,8,Emilia-Romagna,Emilia-Romagna,4459477,1397724,31.34,0.68
1856,2021-03-13,EMR,16138,6361,9777,10589,5312,237,ITH,ITH5,8,Emilia-Romagna,Emilia-Romagna,4459477,1413862,31.7,0.36
1857,2021-02-25,EMR,9249,3499,5750,8272,954,23,ITH,ITH5,8,Emilia-Romagna,Emilia-Romagna,4459477,1423111,31.91,0.21
1858,2021-06-19,EMR,36668,18355,18313,16780,19396,492,ITH,ITH5,8,Emilia-Romagna,Emilia-Romagna,4459477,1459779,32.73,0.82
1859,2021-03-11,EMR,17477,7324,10153,11440,5853,184,ITH,ITH5,8,Emilia-Romagna,Emilia-Romagna,4459477,1477256,33.13,0.39
1860,2021-02-06,EMR,7600,2407,5193,2107,5489,4,ITH,ITH5,8,Emilia-Romagna,Emilia-Romagna,4459477,1484856,33.3,0.17
1861,2021-03-25,EMR,21484,9417,12067,14234,6991,259,ITH,ITH5,8,Emilia-Romagna,Emilia-Romagna,4459477,1506340,33.78,0.48
1862,2021-05-21,EMR,39367,17553,21814,21641,17114,612,ITH,ITH5,8,Emilia-Romagna,Emilia-Romagna,4459477,1545707,34.66,0.88
1863,2021-02-10,EMR,4024,1384,2640,2759,1259,6,ITH,ITH5,8,Emilia-Romagna,Emilia-Romagna,4459477,1549731,34.75,0.09
1864,2021-04-08,EMR,31365,14403,16962,25332,5317,716,ITH,ITH5,8,Emilia-Romagna,Emilia-Romagna,4459477,1581096,35.45,0.7
1865,2021-01-27,EMR,8365,2950,5415,461,7904,0,ITH,ITH5,8,Emilia-Romagna,Emilia-Romagna,4459477,1589461,35.64,0.19
1866,2021-07-31,EMR,36108,19164,16944,12157,23306,645,ITH,ITH5,8,Emilia-Romagna,Emilia-Romagna,4459477,1625569,36.45,0.81
1867,2021-06-30,EMR,34247,17283,16964,17743,15656,848,ITH,ITH5,8,Emilia-Romagna,Emilia-Romagna,4459477,1659816,37.22,0.77
1868,2021-07-17,EMR,43619,23028,20591,7166,35716,737,ITH,ITH5,8,Emilia-Romagna,Emilia-Romagna,4459477,1703435,38.2,0.98
1869,2021-06-11,EMR,45938,23845,22093,38380,6541,1017,ITH,ITH5,8,Emilia-Romagna,Emilia-Romagna,4459477,1749373,39.23,1.03
1870,2021-06-28,EMR,40047,19651,20396,19658,19568,821,ITH,ITH5,8,Emilia-Romagna,Emilia-Romagna,4459477,1789420,40.13,0.9
1871,2021-03-20,EMR,16089,6830,9259,8955,6966,168,ITH,ITH5,8,Emilia-Romagna,Emilia-Romagna,4459477,1805509,40.49,0.36
1872,2021-04-06,EMR,24757,11176,13581,19722,4747,288,ITH,ITH5,8,Emilia-Romagna,Emilia-Romagna,4459477,1830266,41.04,0.56
1873,2020-12-27,EMR,973,374,599,973,0,0,ITH,ITH5,8,Emilia-Romagna,Emilia-Romagna,4459477,1831239,41.06,0.02
1874,2021-01-10,EMR,7169,2684,4485,7168,0,1,ITH,ITH5,8,Emilia-Romagna,Emilia-Romagna,4459477,1838408,41.22,0.16
1875,2021-06-16,EMR,45928,23523,22405,25267,19950,711,ITH,ITH5,8,Emilia-Romagna,Emilia-Romagna,4459477,1884336,42.25,1.03
1876,2021-03-08,EMR,12215,5100,7115,9470,2662,83,ITH,ITH5,8,Emilia-Romagna,Emilia-Romagna,4459477,1896551,42.53,0.27
1877,2021-08-05,EMR,36201,19139,17062,17917,17368,916,ITH,ITH5,8,Emilia-Romagna,Emilia-Romagna,4459477,1932752,43.34,0.81
1878,2021-05-04,EMR,29304,13722,15582,15164,13665,475,ITH,ITH5,8,Emilia-Romagna,Emilia-Romagna,4459477,1962056,44.0,0.66
1879,2021-02-27,EMR,10965,3998,6967,9192,1741,32,ITH,ITH5,8,Emilia-Romagna,Emilia-Romagna,4459477,1973021,44.24,0.25
1880,2021-04-25,EMR,22355,10242,12113,14403,7513,439,ITH,ITH5,8,Emilia-Romagna,Emilia-Romagna,4459477,1995376,44.74,0.5
1881,2021-08-07,EMR,29802,16360,13442,16674,12177,951,ITH,ITH5,8,Emilia-Romagna,Emilia-Romagna,4459477,2025178,45.41,0.67
1882,2021-06-04,EMR,45726,23011,22715,36866,8195,665,ITH,ITH5,8,Emilia-Romagna,Emilia-Romagna,4459477,2070904,46.44,1.03
1883,2021-05-28,EMR,41280,18956,22324,17270,23411,599,ITH,ITH5,8,Emilia-Romagna,Emilia-Romagna,4459477,2112184,47.36,0.93
1884,2021-04-22,EMR,29055,13453,15602,14616,14078,361,ITH,ITH5,8,Emilia-Romagna,Emilia-Romagna,4459477,2141239,48.02,0.65
1885,2021-01-12,EMR,9477,3124,6353,9468,0,9,ITH,ITH5,8,Emilia-Romagna,Emilia-Romagna,4459477,2150716,48.23,0.21
1886,2021-07-16,EMR,49744,26256,23488,7055,42039,650,ITH,ITH5,8,Emilia-Romagna,Emilia-Romagna,4459477,2200460,49.34,1.12
1887,2021-03-18,EMR,13680,5807,7873,5584,8004,92,ITH,ITH5,8,Emilia-Romagna,Emilia-Romagna,4459477,2214140,49.65,0.31
1888,2021-05-14,EMR,37336,17198,20138,26794,9648,894,ITH,ITH5,8,Emilia-Romagna,Emilia-Romagna,4459477,2251476,50.49,0.84
1889,2021-02-03,EMR,9344,2990,6354,960,8383,1,ITH,ITH5,8,Emilia-Romagna,Emilia-Romagna,4459477,2260820,50.7,0.21
1890,2021-04-01,EMR,23964,10777,13187,19075,4553,336,ITH,ITH5,8,Emilia-Romagna,Emilia-Romagna,4459477,2284784,51.23,0.54
1891,2021-02-17,EMR,6539,2764,3775,5755,772,12,ITH,ITH5,8,Emilia-Romagna,Emilia-Romagna,4459477,2291323,51.38,0.15
1892,2021-06-01,EMR,27182,13105,14077,16875,9922,385,ITH,ITH5,8,Emilia-Romagna,Emilia-Romagna,4459477,2318505,51.99,0.61
1893,2021-07-28,EMR,38542,20662,17880,13969,23957,616,ITH,ITH5,8,Emilia-Romagna,Emilia-Romagna,4459477,2357047,52.85,0.86
1894,2021-04-27,EMR,32120,14870,17250,19230,12466,424,ITH,ITH5,8,Emilia-Romagna,Emilia-Romagna,4459477,2389167,53.58,0.72
1895,2021-05-06,EMR,35962,16617,19345,22175,13082,705,ITH,ITH5,8,Emilia-Romagna,Emilia-Romagna,4459477,2425129,54.38,0.81
1896,2021-01-26,EMR,8336,3001,5335,209,8126,1,ITH,ITH5,8,Emilia-Romagna,Emilia-Romagna,4459477,2433465,54.57,0.19
1897,2021-07-02,EMR,34737,17083,17654,12415,21709,613,ITH,ITH5,8,Emilia-Romagna,Emilia-Romagna,4459477,2468202,55.35,0.78
1898,2021-03-24,EMR,21218,9403,11815,13618,7386,214,ITH,ITH5,8,Emilia-Romagna,Emilia-Romagna,4459477,2489420,55.82,0.48
1899,2021-04-20,EMR,22638,10410,12228,13893,8355,390,ITH,ITH5,8,Emilia-Romagna,Emilia-Romagna,4459477,2512058,56.33,0.51
1900,2021-06-23,EMR,37801,18915,18886,18295,18849,657,ITH,ITH5,8,Emilia-Romagna,Emilia-Romagna,4459477,2549859,57.18,0.85
1901,2021-01-08,EMR,10873,3582,7291,10870,0,3,ITH,ITH5,8,Emilia-Romagna,Emilia-Romagna,4459477,2560732,57.42,0.24
1902,2021-03-06,EMR,21027,5969,15058,18164,2740,123,ITH,ITH5,8,Emilia-Romagna,Emilia-Romagna,4459477,2581759,57.89,0.47
1903,2021-07-05,EMR,33216,16196,17020,11257,21366,593,ITH,ITH5,8,Emilia-Romagna,Emilia-Romagna,4459477,2614975,58.64,0.74
1904,2021-03-27,EMR,21675,9069,12606,14520,6911,244,ITH,ITH5,8,Emilia-Romagna,Emilia-Romagna,4459477,2636650,59.12,0.49
1905,2021-04-13,EMR,23721,11130,12591,19033,4342,346,ITH,ITH5,8,Emilia-Romagna,Emilia-Romagna,4459477,2660371,59.66,0.53
1906,2021-01-03,EMR,2764,945,1819,2764,0,0,ITH,ITH5,8,Emilia-Romagna,Emilia-Romagna,4459477,2663135,59.72,0.06
1907,2021-05-02,EMR,25585,11653,13932,13191,11994,400,ITH,ITH5,8,Emilia-Romagna,Emilia-Romagna,4459477,2688720,60.29,0.57
1908,2021-01-22,EMR,1830,476,1354,1086,742,2,ITH,ITH5,8,Emilia-Romagna,Emilia-Romagna,4459477,2690550,60.33,0.04
1909,2021-02-08,EMR,5235,1535,3700,2316,2916,3,ITH,ITH5,8,Emilia-Romagna,Emilia-Romagna,4459477,2695785,60.45,0.12
1910,2021-05-16,EMR,25862,12174,13688,18361,7125,376,ITH,ITH5,8,Emilia-Romagna,Emilia-Romagna,4459477,2721647,61.03,0.58
1911,2021-06-27,EMR,29559,14872,14687,16213,12726,620,ITH,ITH5,8,Emilia-Romagna,Emilia-Romagna,4459477,2751206,61.69,0.66
1912,2021-07-14,EMR,47921,24510,23411,5584,41795,542,ITH,ITH5,8,Emilia-Romagna,Emilia-Romagna,4459477,2799127,62.77,1.07
1913,2021-04-05,EMR,14857,6811,8046,11788,2893,176,ITH,ITH5,8,Emilia-Romagna,Emilia-Romagna,4459477,2813984,63.1,0.33
1914,2021-08-02,EMR,37664,19890,17774,14002,23058,604,ITH,ITH5,8,Emilia-Romagna,Emilia-Romagna,4459477,2851648,63.95,0.84
1915,2021-04-24,EMR,28642,13246,15396,14058,14238,346,ITH,ITH5,8,Emilia-Romagna,Emilia-Romagna,4459477,2880290,64.59,0.64
1916,2021-01-20,EMR,1329,269,1060,1327,1,1,ITH,ITH5,8,Emilia-Romagna,Emilia-Romagna,4459477,2881619,64.62,0.03
1917,2021-07-24,EMR,38775,20906,17869,17332,20593,850,ITH,ITH5,8,Emilia-Romagna,Emilia-Romagna,4459477,2920394,65.49,0.87
1918,2021-04-15,EMR,29358,13982,15376,19245,9680,433,ITH,ITH5,8,Emilia-Romagna,Emilia-Romagna,4459477,2949752,66.15,0.66
1919,2021-06-18,EMR,42613,21326,21287,16169,25907,537,ITH,ITH5,8,Emilia-Romagna,Emilia-Romagna,4459477,2992365,67.1,0.96
1920,2021-03-10,EMR,18805,7743,11062,12981,5644,180,ITH,ITH5,8,Emilia-Romagna,Emilia-Romagna,4459477,3011170,67.52,0.42
1921,2021-04-12,EMR,19252,9010,10242,14450,4448,354,ITH,ITH5,8,Emilia-Romagna,Emilia-Romagna,4459477,3030422,67.95,0.43
1922,2021-06-08,EMR,45074,23067,22007,36881,7497,696,ITH,ITH5,8,Emilia-Romagna,Emilia-Romagna,4459477,3075496,68.97,1.01
1923,2021-08-04,EMR,34301,18263,16038,12156,21645,500,ITH,ITH5,8,Emilia-Romagna,Emilia-Romagna,4459477,3109797,69.73,0.77
1924,2021-06-13,EMR,28754,14999,13755,23848,4281,625,ITH,ITH5,8,Emilia-Romagna,Emilia-Romagna,4459477,3138551,70.38,0.64
1925,2021-03-05,EMR,17916,5859,12057,14294,3501,121,ITH,ITH5,8,Emilia-Romagna,Emilia-Romagna,4459477,3156467,70.78,0.4
1926,2021-03-22,EMR,17628,7811,9817,10616,6865,147,ITH,ITH5,8,Emilia-Romagna,Emilia-Romagna,4459477,3174095,71.18,0.4
1927,2021-03-03,EMR,15890,5265,10625,13351,2487,52,ITH,ITH5,8,Emilia-Romagna,Emilia-Romagna,4459477,3189985,71.53,0.36
1928,2021-05-20,EMR,40402,18340,22062,18400,21488,514,ITH,ITH5,8,Emilia-Romagna,Emilia-Romagna,4459477,3230387,72.44,0.91
1929,2021-06-25,EMR,42608,21596,21012,19557,22306,745,ITH,ITH5,8,Emilia-Romagna,Emilia-Romagna,4459477,3272995,73.39,0.96
1930,2021-03-17,EMR,13725,5693,8032,5814,7852,59,ITH,ITH5,8,Emilia-Romagna,Emilia-Romagna,4459477,3286720,73.7,0.31
1931,2021-05-13,EMR,35842,16511,19331,27278,7845,719,ITH,ITH5,8,Emilia-Romagna,Emilia-Romagna,4459477,3322562,74.51,0.8
1932,2021-03-15,EMR,13450,6251,7199,6848,6500,102,ITH,ITH5,8,Emilia-Romagna,Emilia-Romagna,4459477,3336012,74.81,0.3
1933,2021-01-24,EMR,2446,887,1559,298,2148,0,ITH,ITH5,8,Emilia-Romagna,Emilia-Romagna,4459477,3338458,74.86,0.05
1934,2021-07-09,EMR,44886,22935,21951,5414,39051,421,ITH,ITH5,8,Emilia-Romagna,Emilia-Romagna,4459477,3383344,75.87,1.01
1935,2021-05-11,EMR,35807,16802,19005,27856,7262,689,ITH,ITH5,8,Emilia-Romagna,Emilia-Romagna,4459477,3419151,76.67,0.8
1936,2021-01-31,EMR,7702,2766,4936,239,7463,0,ITH,ITH5,8,Emilia-Romagna,Emilia-Romagna,4459477,3426853,76.84,0.17
1937,2021-06-29,EMR,37663,18576,19087,18166,18786,711,ITH,ITH5,8,Emilia-Romagna,Emilia-Romagna,4459477,3464516,77.69,0.84
1938,2021-03-21,EMR,11960,5297,6663,7263,4606,91,ITH,ITH5,8,Emilia-Romagna,Emilia-Romagna,4459477,3476476,77.96,0.27
1939,2021-06-10,EMR,45048,23131,21917,38732,5378,938,ITH,ITH5,8,Emilia-Romagna,Emilia-Romagna,4459477,3521524,78.97,1.01
1940,2021-02-22,EMR,7482,3091,4391,7197,272,13,ITH,ITH5,8,Emilia-Romagna,Emilia-Romagna,4459477,3529006,79.13,0.17
1941,2021-05-18,EMR,29227,13278,15949,18100,10642,485,ITH,ITH5,8,Emilia-Romagna,Emilia-Romagna,4459477,3558233,79.79,0.66
1942,2021-02-07,EMR,4787,1536,3251,1722,3063,2,ITH,ITH5,8,Emilia-Romagna,Emilia-Romagna,4459477,3563020,79.9,0.11
1943,2021-02-24,EMR,9358,3568,5790,8452,889,17,ITH,ITH5,8,Emilia-Romagna,Emilia-Romagna,4459477,3572378,80.11,0.21
1944,2021-01-05,EMR,9364,3171,6193,9360,0,4,ITH,ITH5,8,Emilia-Romagna,Emilia-Romagna,4459477,3581742,80.32,0.21
1945,2021-04-29,EMR,44969,21145,23824,26595,17557,817,ITH,ITH5,8,Emilia-Romagna,Emilia-Romagna,4459477,3626711,81.33,1.01
1946,2021-01-19,EMR,2047,506,1541,2029,17,1,ITH,ITH5,8,Emilia-Romagna,Emilia-Romagna,4459477,3628758,81.37,0.05
1947,2021-07-07,EMR,37888,19139,18749,13418,23691,779,ITH,ITH5,8,Emilia-Romagna,Emilia-Romagna,4459477,3666646,82.22,0.85
1948,2021-03-29,EMR,21438,9623,11815,16541,4658,239,ITH,ITH5,8,Emilia-Romagna,Emilia-Romagna,4459477,3688084,82.7,0.48
1949,2021-07-21,EMR,43590,23252,20338,10763,32235,592,ITH,ITH5,8,Emilia-Romagna,Emilia-Romagna,4459477,3731674,83.68,0.98
1950,2021-04-19,EMR,20916,9802,11114,14339,6283,294,ITH,ITH5,8,Emilia-Romagna,Emilia-Romagna,4459477,3752590,84.15,0.47
1951,2021-01-09,EMR,9992,3456,6536,9987,0,5,ITH,ITH5,8,Emilia-Romagna,Emilia-Romagna,4459477,3762582,84.37,0.22
1952,2021-06-15,EMR,43852,22633,21219,27962,15057,833,ITH,ITH5,8,Emilia-Romagna,Emilia-Romagna,4459477,3806434,85.36,0.98
1953,2021-03-07,EMR,7847,2960,4887,6291,1523,33,ITH,ITH5,8,Emilia-Romagna,Emilia-Romagna,4459477,3814281,85.53,0.18
1954,2021-05-03,EMR,28732,13568,15164,17399,10884,449,ITH,ITH5,8,Emilia-Romagna,Emilia-Romagna,4459477,3843013,86.18,0.64
1955,2021-05-25,EMR,25214,11229,13985,11299,13489,426,ITH,ITH5,8,Emilia-Romagna,Emilia-Romagna,4459477,3868227,86.74,0.57
1956,2021-02-14,EMR,1401,378,1023,1273,120,8,ITH,ITH5,8,Emilia-Romagna,Emilia-Romagna,4459477,3869628,86.77,0.03
1957,2021-05-27,EMR,42331,18765,23566,13577,28270,484,ITH,ITH5,8,Emilia-Romagna,Emilia-Romagna,4459477,3911959,87.72,0.95
1958,2021-02-16,EMR,5772,2446,3326,5227,531,14,ITH,ITH5,8,Emilia-Romagna,Emilia-Romagna,4459477,3917731,87.85,0.13
1959,2021-02-09,EMR,4157,1251,2906,2307,1849,1,ITH,ITH5,8,Emilia-Romagna,Emilia-Romagna,4459477,3921888,87.95,0.09
1960,2021-01-17,EMR,2890,887,2003,2642,247,1,ITH,ITH5,8,Emilia-Romagna,Emilia-Romagna,4459477,3924778,88.01,0.06
1961,2021-04-02,EMR,23398,10554,12844,18562,4483,353,ITH,ITH5,8,Emilia-Romagna,Emilia-Romagna,4459477,3948176,88.53,0.52
1962,2021-05-29,EMR,37927,16511,21416,16656,20757,514,ITH,ITH5,8,Emilia-Romagna,Emilia-Romagna,4459477,3986103,89.38,0.85
1963,2021-08-09,EMR,28338,15092,13246,15040,12347,951,ITH,ITH5,8,Emilia-Romagna,Emilia-Romagna,4459477,4014441,90.02,0.64
1964,2021-05-01,EMR,28428,12780,15648,15278,12793,357,ITH,ITH5,8,Emilia-Romagna,Emilia-Romagna,4459477,4042869,90.66,0.64
1965,2021-02-05,EMR,9305,2960,6345,1614,7687,4,ITH,ITH5,8,Emilia-Romagna,Emilia-Romagna,4459477,4052174,90.87,0.21
1966,2021-03-02,EMR,12662,4274,8388,10517,2088,57,ITH,ITH5,8,Emilia-Romagna,Emilia-Romagna,4459477,4064836,91.15,0.28
1967,2021-03-19,EMR,15926,6972,8954,7800,7969,157,ITH,ITH5,8,Emilia-Romagna,Emilia-Romagna,4459477,4080762,91.51,0.36
1968,2021-04-07,EMR,26873,12297,14576,20481,6069,323,ITH,ITH5,8,Emilia-Romagna,Emilia-Romagna,4459477,4107635,92.11,0.6
1969,2021-01-14,EMR,8130,2595,5535,8121,0,9,ITH,ITH5,8,Emilia-Romagna,Emilia-Romagna,4459477,4115765,92.29,0.18
1970,2021-02-21,EMR,4448,1707,2741,3998,440,10,ITH,ITH5,8,Emilia-Romagna,Emilia-Romagna,4459477,4120213,92.39,0.1
1971,2021-07-25,EMR,28398,15150,13248,10545,17408,445,ITH,ITH5,8,Emilia-Romagna,Emilia-Romagna,4459477,4148611,93.03,0.64
1972,2021-08-11,EMR,17274,9155,8119,7332,9458,484,ITH,ITH5,8,Emilia-Romagna,Emilia-Romagna,4459477,4165885,93.42,0.39
1973,2021-02-28,EMR,6822,2527,4295,4957,1846,19,ITH,ITH5,8,Emilia-Romagna,Emilia-Romagna,4459477,4172707,93.57,0.15
1974,2021-04-26,EMR,27912,12939,14973,18040,9323,549,ITH,ITH5,8,Emilia-Romagna,Emilia-Romagna,4459477,4200619,94.2,0.63
1975,2021-01-16,EMR,5630,1718,3912,5629,0,1,ITH,ITH5,8,Emilia-Romagna,Emilia-Romagna,4459477,4206249,94.32,0.13
1976,2021-03-14,EMR,8803,3840,4963,4942,3798,63,ITH,ITH5,8,Emilia-Romagna,Emilia-Romagna,4459477,4215052,94.52,0.2
1977,2021-08-01,EMR,28703,15397,13306,9254,19105,344,ITH,ITH5,8,Emilia-Romagna,Emilia-Romagna,4459477,4243755,95.16,0.64
1978,2021-05-10,EMR,33878,16147,17731,26069,7263,546,ITH,ITH5,8,Emilia-Romagna,Emilia-Romagna,4459477,4277633,95.92,0.76
1979,2021-07-30,EMR,39748,21350,18398,15652,23413,683,ITH,ITH5,8,Emilia-Romagna,Emilia-Romagna,4459477,4317381,96.81,0.89
1980,2021-04-21,EMR,23967,10968,12999,13865,9742,360,ITH,ITH5,8,Emilia-Romagna,Emilia-Romagna,4459477,4341348,97.35,0.54
1981,2021-05-08,EMR,32375,15108,17267,20405,11430,540,ITH,ITH5,8,Emilia-Romagna,Emilia-Romagna,4459477,4373723,98.08,0.73
1982,2021-01-28,EMR,10258,3341,6917,347,9911,0,ITH,ITH5,8,Emilia-Romagna,Emilia-Romagna,4459477,4383981,98.31,0.23
1983,2021-05-15,EMR,33286,14994,18292,22222,10427,637,ITH,ITH5,8,Emilia-Romagna,Emilia-Romagna,4459477,4417267,99.05,0.75
1984,2021-02-04,EMR,9930,3206,6724,1235,8694,1,ITH,ITH5,8,Emilia-Romagna,Emilia-Romagna,4459477,4427197,99.28,0.22
1985,2021-05-22,EMR,33124,14146,18978,16472,16196,456,ITH,ITH5,8,Emilia-Romagna,Emilia-Romagna,4459477,4460321,100.02,0.74
1986,2021-07-18,EMR,34526,17888,16638,8179,25792,555,ITH,ITH5,8,Emilia-Romagna,Emilia-Romagna,4459477,4494847,100.79,0.77
1987,2021-04-09,EMR,25799,11692,14107,19531,5760,508,ITH,ITH5,8,Emilia-Romagna,Emilia-Romagna,4459477,4520646,101.37,0.58
1988,2021-02-02,EMR,9485,3049,6436,525,8960,0,ITH,ITH5,8,Emilia-Romagna,Emilia-Romagna,4459477,4530131,101.58,0.21
1989,2021-06-20,EMR,30729,15591,15138,15627,14659,443,ITH,ITH5,8,Emilia-Romagna,Emilia-Romagna,4459477,4560860,102.27,0.69
1990,2021-07-11,EMR,30367,15226,15141,2758,27342,267,ITH,ITH5,8,Emilia-Romagna,Emilia-Romagna,4459477,4591227,102.95,0.68
1991,2021-03-31,EMR,25288,11057,14231,19497,5469,322,ITH,ITH5,8,Emilia-Romagna,Emilia-Romagna,4459477,4616515,103.52,0.57
1992,2021-07-13,EMR,48453,24818,23635,6464,41304,685,ITH,ITH5,8,Emilia-Romagna,Emilia-Romagna,4459477,4664968,104.61,1.09
1993,2021-07-04,EMR,24253,12058,12195,10201,13598,454,ITH,ITH5,8,Emilia-Romagna,Emilia-Romagna,4459477,4689221,105.15,0.54
1994,2021-03-26,EMR,23726,10118,13608,17014,6441,271,ITH,ITH5,8,Emilia-Romagna,Emilia-Romagna,4459477,4712947,105.68,0.53
1995,2021-01-02,EMR,2378,917,1461,2378,0,0,ITH,ITH5,8,Emilia-Romagna,Emilia-Romagna,4459477,4715325,105.74,0.05
1996,2021-06-05,EMR,44282,22369,21913,36687,6914,681,ITH,ITH5,8,Emilia-Romagna,Emilia-Romagna,4459477,4759607,106.73,0.99
1997,2021-06-22,EMR,36488,18171,18317,16288,19625,575,ITH,ITH5,8,Emilia-Romagna,Emilia-Romagna,4459477,4796095,107.55,0.82
1998,2021-07-06,EMR,36793,18498,18295,12970,23189,634,ITH,ITH5,8,Emilia-Romagna,Emilia-Romagna,4459477,4832888,108.37,0.83
1999,2021-05-17,EMR,32462,15407,17055,22368,9549,545,ITH,ITH5,8,Emilia-Romagna,Emilia-Romagna,4459477,4865350,109.1,0.73
2000,2021-07-23,EMR,39541,21425,18116,19419,19077,1045,ITH,ITH5,8,Emilia-Romagna,Emilia-Romagna,4459477,4904891,109.99,0.89
2001,2021-04-14,EMR,27047,12845,14202,20513,6106,428,ITH,ITH5,8,Emilia-Romagna,Emilia-Romagna,4459477,4931938,110.59,0.61
2002,2021-01-21,EMR,2165,729,1436,817,1348,0,ITH,ITH5,8,Emilia-Romagna,Emilia-Romagna,4459477,4934103,110.64,0.05
2003,2021-06-03,EMR,37920,18440,19480,29752,7555,613,ITH,ITH5,8,Emilia-Romagna,Emilia-Romagna,4459477,4972023,111.49,0.85
2004,2021-02-23,EMR,8216,3218,4998,7818,386,12,ITH,ITH5,8,Emilia-Romagna,Emilia-Romagna,4459477,4980239,111.68,0.18
2005,2021-03-12,EMR,18320,7708,10612,11309,6719,292,ITH,ITH5,8,Emilia-Romagna,Emilia-Romagna,4459477,4998559,112.09,0.41
2006,2021-07-12,EMR,44027,22306,21721,5412,38098,517,ITH,ITH5,8,Emilia-Romagna,Emilia-Romagna,4459477,5042586,113.08,0.99
2007,2021-02-12,EMR,5319,1671,3648,3890,1406,23,ITH,ITH5,8,Emilia-Romagna,Emilia-Romagna,4459477,5047905,113.2,0.12
2008,2021-04-10,EMR,20926,9302,11624,16450,4144,332,ITH,ITH5,8,Emilia-Romagna,Emilia-Romagna,4459477,5068831,113.66,0.47
2009,2021-04-17,EMR,27310,13079,14231,17571,9347,392,ITH,ITH5,8,Emilia-Romagna,Emilia-Romagna,4459477,5096141,114.28,0.61
2010,2021-01-07,EMR,10274,3405,6869,10270,0,4,ITH,ITH5,8,Emilia-Romagna,Emilia-Romagna,4459477,5106415,114.51,0.23
2011,2021-04-03,EMR,19990,8782,11208,15953,3798,239,ITH,ITH5,8,Emilia-Romagna,Emilia-Romagna,4459477,5126405,114.96,0.45
2012,2021-05-30,EMR,27088,12798,14290,12981,13703,404,ITH,ITH5,8,Emilia-Romagna,Emilia-Romagna,4459477,5153493,115.56,0.61
2013,2021-02-19,EMR,7327,3010,4317,6799,514,14,ITH,ITH5,8,Emilia-Romagna,Emilia-Romagna,4459477,5160820,115.73,0.16
2014,2021-07-26,EMR,39461,21048,18413,15888,22838,735,ITH,ITH5,8,Emilia-Romagna,Emilia-Romagna,4459477,5200281,116.61,0.88
2015,2020-12-31,EMR,2214,778,1436,2213,0,1,ITH,ITH5,8,Emilia-Romagna,Emilia-Romagna,4459477,5202495,116.66,0.05
2016,2021-06-06,EMR,36580,18989,17591,31594,4410,576,ITH,ITH5,8,Emilia-Romagna,Emilia-Romagna,4459477,5239075,117.48,0.82
2017,2021-02-26,EMR,9635,3673,5962,8563,1051,21,ITH,ITH5,8,Emilia-Romagna,Emilia-Romagna,4459477,5248710,117.7,0.22
2018,2021-08-06,EMR,33766,18096,15670,18020,14943,803,ITH,ITH5,8,Emilia-Romagna,Emilia-Romagna,4459477,5282476,118.46,0.76
2019,2021-04-28,EMR,33735,15596,18139,20260,12896,579,ITH,ITH5,8,Emilia-Romagna,Emilia-Romagna,4459477,5316211,119.21,0.76
2020,2021-06-24,EMR,40395,20224,20171,20120,19559,716,ITH,ITH5,8,Emilia-Romagna,Emilia-Romagna,4459477,5356606,120.12,0.91
2021,2021-06-17,EMR,46673,23650,23023,21828,24213,632,ITH,ITH5,8,Emilia-Romagna,Emilia-Romagna,4459477,5403279,121.16,1.05
2022,2021-04-26,LIG,10577,4987,5590,7852,2640,85,ITC,ITC3,7,Liguria,Liguria,1550640,10577,0.68,0.68
2023,2021-01-16,LIG,1279,558,721,1274,0,5,ITC,ITC3,7,Liguria,Liguria,1550640,11856,0.76,0.08
2024,2021-02-02,LIG,2674,1007,1667,127,2545,2,ITC,ITC3,7,Liguria,Liguria,1550640,14530,0.94,0.17
2025,2021-04-28,LIG,14462,6524,7938,6380,7991,91,ITC,ITC3,7,Liguria,Liguria,1550640,28992,1.87,0.93
2026,2021-08-06,LIG,12141,6164,5977,3968,8087,86,ITC,ITC3,7,Liguria,Liguria,1550640,41133,2.65,0.78
2027,2021-02-04,LIG,2818,988,1830,177,2641,0,ITC,ITC3,7,Liguria,Liguria,1550640,43951,2.83,0.18
2028,2021-05-15,LIG,7325,3275,4050,4288,2962,75,ITC,ITC3,7,Liguria,Liguria,1550640,51276,3.31,0.47
2029,2021-02-21,LIG,869,491,378,859,4,6,ITC,ITC3,7,Liguria,Liguria,1550640,52145,3.36,0.06
2030,2021-01-28,LIG,2849,972,1877,39,2810,0,ITC,ITC3,7,Liguria,Liguria,1550640,54994,3.55,0.18
2031,2021-03-26,LIG,9348,4036,5312,6078,3156,114,ITC,ITC3,7,Liguria,Liguria,1550640,64342,4.15,0.6
2032,2021-07-04,LIG,4858,2583,2275,3844,995,19,ITC,ITC3,7,Liguria,Liguria,1550640,69200,4.46,0.31
2033,2021-01-02,LIG,693,247,446,693,0,0,ITC,ITC3,7,Liguria,Liguria,1550640,69893,4.51,0.04
2034,2021-07-18,LIG,2383,1222,1161,390,1982,11,ITC,ITC3,7,Liguria,Liguria,1550640,72276,4.66,0.15
2035,2021-06-05,LIG,8094,4118,3976,4933,3152,9,ITC,ITC3,7,Liguria,Liguria,1550640,80370,5.18,0.52
2036,2021-04-09,LIG,12470,5563,6907,10553,1777,140,ITC,ITC3,7,Liguria,Liguria,1550640,92840,5.99,0.8
2037,2021-03-31,LIG,11942,5283,6659,9057,2776,109,ITC,ITC3,7,Liguria,Liguria,1550640,104782,6.76,0.77
2038,2021-08-01,LIG,1490,857,633,152,1338,0,ITC,ITC3,7,Liguria,Liguria,1550640,106272,6.85,0.1
2039,2021-02-16,LIG,2428,957,1471,1995,425,8,ITC,ITC3,7,Liguria,Liguria,1550640,108700,7.01,0.16
2040,2021-07-23,LIG,19972,10290,9682,5154,14742,76,ITC,ITC3,7,Liguria,Liguria,1550640,128672,8.3,1.29
2041,2021-05-27,LIG,16992,8715,8277,12654,4165,173,ITC,ITC3,7,Liguria,Liguria,1550640,145664,9.39,1.1
2042,2021-04-14,LIG,13078,5672,7406,10750,2204,124,ITC,ITC3,7,Liguria,Liguria,1550640,158742,10.24,0.84
2043,2021-05-29,LIG,6867,3251,3616,3975,2873,19,ITC,ITC3,7,Liguria,Liguria,1550640,165609,10.68,0.44
2044,2021-03-14,LIG,1660,753,907,1033,605,22,ITC,ITC3,7,Liguria,Liguria,1550640,167269,10.79,0.11
2045,2021-06-22,LIG,15806,7458,8348,7635,8128,43,ITC,ITC3,7,Liguria,Liguria,1550640,183075,11.81,1.02
2046,2021-07-06,LIG,12362,6068,6294,5687,6635,40,ITC,ITC3,7,Liguria,Liguria,1550640,195437,12.6,0.8
2047,2021-05-10,LIG,12657,5647,7010,6216,6378,63,ITC,ITC3,7,Liguria,Liguria,1550640,208094,13.42,0.82
2048,2021-02-28,LIG,1060,580,480,1043,10,7,ITC,ITC3,7,Liguria,Liguria,1550640,209154,13.49,0.07
2049,2021-02-11,LIG,1990,772,1218,1093,888,9,ITC,ITC3,7,Liguria,Liguria,1550640,211144,13.62,0.13
2050,2021-05-22,LIG,6652,3220,3432,4874,1685,93,ITC,ITC3,7,Liguria,Liguria,1550640,217796,14.05,0.43
2051,2021-06-10,LIG,18840,9713,9127,13164,5656,20,ITC,ITC3,7,Liguria,Liguria,1550640,236636,15.26,1.21
2052,2021-03-19,LIG,5300,2235,3065,2095,3150,55,ITC,ITC3,7,Liguria,Liguria,1550640,241936,15.6,0.34
2053,2021-03-02,LIG,4076,1691,2385,3755,310,11,ITC,ITC3,7,Liguria,Liguria,1550640,246012,15.87,0.26
2054,2021-07-11,LIG,2150,1193,957,1237,903,10,ITC,ITC3,7,Liguria,Liguria,1550640,248162,16.0,0.14
2055,2021-06-24,LIG,11152,5440,5712,6280,4851,21,ITC,ITC3,7,Liguria,Liguria,1550640,259314,16.72,0.72
2056,2021-01-21,LIG,1109,385,724,677,431,1,ITC,ITC3,7,Liguria,Liguria,1550640,260423,16.79,0.07
2057,2021-01-14,LIG,2983,1056,1927,2982,0,1,ITC,ITC3,7,Liguria,Liguria,1550640,263406,16.99,0.19
2058,2020-12-30,LIG,12,5,7,12,0,0,ITC,ITC3,7,Liguria,Liguria,1550640,263418,16.99,0.0
2059,2021-06-15,LIG,17416,8465,8951,9302,8086,28,ITC,ITC3,7,Liguria,Liguria,1550640,280834,18.11,1.12
2060,2021-03-07,LIG,1915,1138,777,1590,301,24,ITC,ITC3,7,Liguria,Liguria,1550640,282749,18.23,0.12
2061,2021-06-17,LIG,16700,7932,8768,9132,7531,37,ITC,ITC3,7,Liguria,Liguria,1550640,299449,19.31,1.08
2062,2020-12-28,LIG,80,30,50,80,0,0,ITC,ITC3,7,Liguria,Liguria,1550640,299529,19.32,0.01
2063,2021-06-03,LIG,15537,7701,7836,9136,6387,14,ITC,ITC3,7,Liguria,Liguria,1550640,315066,20.32,1.0
2064,2021-04-07,LIG,13688,6111,7577,11305,2291,92,ITC,ITC3,7,Liguria,Liguria,1550640,328754,21.2,0.88
2065,2021-02-23,LIG,3807,1559,2248,3658,109,40,ITC,ITC3,7,Liguria,Liguria,1550640,332561,21.45,0.25
2066,2021-08-10,LIG,13062,6527,6535,4291,8672,99,ITC,ITC3,7,Liguria,Liguria,1550640,345623,22.29,0.84
2067,2021-06-14,LIG,15147,7315,7832,8260,6868,19,ITC,ITC3,7,Liguria,Liguria,1550640,360770,23.27,0.98
2068,2021-07-25,LIG,6391,3261,3130,649,5733,9,ITC,ITC3,7,Liguria,Liguria,1550640,367161,23.68,0.41
2069,2021-02-09,LIG,1955,695,1260,264,1689,2,ITC,ITC3,7,Liguria,Liguria,1550640,369116,23.8,0.13
2070,2021-04-23,LIG,14693,6651,8042,8456,6127,110,ITC,ITC3,7,Liguria,Liguria,1550640,383809,24.75,0.95
2071,2021-05-03,LIG,13264,5922,7342,6339,6820,105,ITC,ITC3,7,Liguria,Liguria,1550640,397073,25.61,0.86
2072,2021-08-11,LIG,8466,4287,4179,3031,5382,53,ITC,ITC3,7,Liguria,Liguria,1550640,405539,26.15,0.55
2073,2021-03-21,LIG,551,220,331,69,482,0,ITC,ITC3,7,Liguria,Liguria,1550640,406090,26.19,0.04
2074,2021-01-23,LIG,813,298,515,156,657,0,ITC,ITC3,7,Liguria,Liguria,1550640,406903,26.24,0.05
2075,2021-06-29,LIG,15191,7232,7959,8695,6447,49,ITC,ITC3,7,Liguria,Liguria,1550640,422094,27.22,0.98
2076,2021-05-17,LIG,12044,5526,6518,8648,3342,54,ITC,ITC3,7,Liguria,Liguria,1550640,434138,28.0,0.78
2077,2021-01-30,LIG,1661,567,1094,23,1637,1,ITC,ITC3,7,Liguria,Liguria,1550640,435799,28.1,0.11
2078,2021-01-09,LIG,1335,481,854,1334,0,1,ITC,ITC3,7,Liguria,Liguria,1550640,437134,28.19,0.09
2079,2021-04-19,LIG,12839,5621,7218,8919,3832,88,ITC,ITC3,7,Liguria,Liguria,1550640,449973,29.02,0.83
2080,2021-07-13,LIG,13071,6427,6644,3490,9556,25,ITC,ITC3,7,Liguria,Liguria,1550640,463044,29.86,0.84
2081,2021-04-02,LIG,11792,5221,6571,9211,2487,94,ITC,ITC3,7,Liguria,Liguria,1550640,474836,30.62,0.76
2082,2021-04-21,LIG,14279,6452,7827,8848,5335,96,ITC,ITC3,7,Liguria,Liguria,1550640,489115,31.54,0.92
2083,2021-07-30,LIG,16038,8308,7730,4657,11314,67,ITC,ITC3,7,Liguria,Liguria,1550640,505153,32.58,1.03
2084,2021-05-08,LIG,7536,3335,4201,2274,5223,39,ITC,ITC3,7,Liguria,Liguria,1550640,512689,33.06,0.49
2085,2021-01-25,LIG,2730,891,1839,474,2255,1,ITC,ITC3,7,Liguria,Liguria,1550640,515419,33.24,0.18
2086,2021-05-05,LIG,13720,6139,7581,5173,8459,88,ITC,ITC3,7,Liguria,Liguria,1550640,529139,34.12,0.88
2087,2021-07-29,LIG,17937,9168,8769,4417,13460,60,ITC,ITC3,7,Liguria,Liguria,1550640,547076,35.28,1.16
2088,2021-03-12,LIG,6218,2873,3345,3688,2471,59,ITC,ITC3,7,Liguria,Liguria,1550640,553294,35.68,0.4
2089,2021-07-01,LIG,13548,6529,7019,7348,6153,47,ITC,ITC3,7,Liguria,Liguria,1550640,566842,36.56,0.87
2090,2021-05-19,LIG,13576,5962,7614,10312,3124,140,ITC,ITC3,7,Liguria,Liguria,1550640,580418,37.43,0.88
2091,2021-03-23,LIG,9285,4228,5057,5984,3212,89,ITC,ITC3,7,Liguria,Liguria,1550640,589703,38.03,0.6
2092,2021-07-15,LIG,14755,7462,7293,5187,9483,85,ITC,ITC3,7,Liguria,Liguria,1550640,604458,38.98,0.95
2093,2021-02-01,LIG,2582,935,1647,112,2470,0,ITC,ITC3,7,Liguria,Liguria,1550640,607040,39.15,0.17
2094,2021-07-08,LIG,13630,6705,6925,6193,7391,46,ITC,ITC3,7,Liguria,Liguria,1550640,620670,40.03,0.88
2095,2021-05-12,LIG,12117,5489,6628,6613,5405,99,ITC,ITC3,7,Liguria,Liguria,1550640,632787,40.81,0.78
2096,2021-05-26,LIG,16687,8427,8260,12153,4379,155,ITC,ITC3,7,Liguria,Liguria,1550640,649474,41.88,1.08
2097,2021-07-03,LIG,8808,4359,4449,5477,3316,15,ITC,ITC3,7,Liguria,Liguria,1550640,658282,42.45,0.57
2098,2021-04-11,LIG,4248,1929,2319,3944,249,55,ITC,ITC3,7,Liguria,Liguria,1550640,662530,42.73,0.27
2099,2021-07-20,LIG,13951,6870,7081,2743,11169,39,ITC,ITC3,7,Liguria,Liguria,1550640,676481,43.63,0.9
2100,2021-01-18,LIG,2144,747,1397,1985,157,2,ITC,ITC3,7,Liguria,Liguria,1550640,678625,43.76,0.14
2101,2021-08-08,LIG,1203,646,557,542,657,4,ITC,ITC3,7,Liguria,Liguria,1550640,679828,43.84,0.08
2102,2021-06-02,LIG,8535,4343,4192,5355,3174,6,ITC,ITC3,7,Liguria,Liguria,1550640,688363,44.39,0.55
2103,2021-06-19,LIG,7414,3777,3637,5717,1672,25,ITC,ITC3,7,Liguria,Liguria,1550640,695777,44.87,0.48
2104,2021-02-18,LIG,2771,1128,1643,2421,339,11,ITC,ITC3,7,Liguria,Liguria,1550640,698548,45.05,0.18
2105,2021-02-25,LIG,3458,1349,2109,3308,130,20,ITC,ITC3,7,Liguria,Liguria,1550640,702006,45.27,0.22
2106,2021-03-11,LIG,6404,3094,3310,4332,2013,59,ITC,ITC3,7,Liguria,Liguria,1550640,708410,45.69,0.41
2107,2021-01-13,LIG,2759,1014,1745,2758,0,1,ITC,ITC3,7,Liguria,Liguria,1550640,711169,45.86,0.18
2108,2021-01-04,LIG,2620,856,1764,2619,0,1,ITC,ITC3,7,Liguria,Liguria,1550640,713789,46.03,0.17
2109,2021-08-03,LIG,14089,7195,6894,3998,10025,66,ITC,ITC3,7,Liguria,Liguria,1550640,727878,46.94,0.91
2110,2021-06-21,LIG,14850,7041,7809,8565,6250,35,ITC,ITC3,7,Liguria,Liguria,1550640,742728,47.9,0.96
2111,2021-04-16,LIG,12003,5291,6712,10012,1829,162,ITC,ITC3,7,Liguria,Liguria,1550640,754731,48.67,0.77
2112,2021-03-16,LIG,6087,2732,3355,2313,3733,41,ITC,ITC3,7,Liguria,Liguria,1550640,760818,49.06,0.39
2113,2021-07-22,LIG,21359,10855,10504,4571,16717,71,ITC,ITC3,7,Liguria,Liguria,1550640,782177,50.44,1.38
2114,2021-06-16,LIG,16399,7924,8475,9250,7121,28,ITC,ITC3,7,Liguria,Liguria,1550640,798576,51.5,1.06
2115,2021-03-30,LIG,12219,5430,6789,8742,3389,88,ITC,ITC3,7,Liguria,Liguria,1550640,810795,52.29,0.79
2116,2021-04-06,LIG,13256,5904,7352,10885,2264,107,ITC,ITC3,7,Liguria,Liguria,1550640,824051,53.14,0.85
2117,2021-02-08,LIG,1981,742,1239,300,1681,0,ITC,ITC3,7,Liguria,Liguria,1550640,826032,53.27,0.13
2118,2020-12-27,LIG,135,56,79,134,0,1,ITC,ITC3,7,Liguria,Liguria,1550640,826167,53.28,0.01
2119,2021-05-14,LIG,13154,5869,7285,8640,4336,178,ITC,ITC3,7,Liguria,Liguria,1550640,839321,54.13,0.85
2120,2021-05-31,LIG,14720,7383,7337,9117,5520,83,ITC,ITC3,7,Liguria,Liguria,1550640,854041,55.08,0.95
2121,2021-03-09,LIG,5935,2756,3179,4441,1432,62,ITC,ITC3,7,Liguria,Liguria,1550640,859976,55.46,0.38
2122,2021-02-20,LIG,1336,638,698,1330,1,5,ITC,ITC3,7,Liguria,Liguria,1550640,861312,55.55,0.09
2123,2021-08-07,LIG,5186,2649,2537,1118,4058,10,ITC,ITC3,7,Liguria,Liguria,1550640,866498,55.88,0.33
2124,2021-05-16,LIG,3704,1861,1843,2116,1562,26,ITC,ITC3,7,Liguria,Liguria,1550640,870202,56.12,0.24
2125,2021-02-22,LIG,3343,1476,1867,3190,143,10,ITC,ITC3,7,Liguria,Liguria,1550640,873545,56.33,0.22
2126,2021-01-06,LIG,1663,618,1045,1660,0,3,ITC,ITC3,7,Liguria,Liguria,1550640,875208,56.44,0.11
2127,2021-06-28,LIG,11614,5617,5997,7252,4312,50,ITC,ITC3,7,Liguria,Liguria,1550640,886822,57.19,0.75
2128,2021-03-20,LIG,2316,995,1321,1124,1174,18,ITC,ITC3,7,Liguria,Liguria,1550640,889138,57.34,0.15
2129,2021-03-04,LIG,4740,2118,2622,3834,849,57,ITC,ITC3,7,Liguria,Liguria,1550640,893878,57.65,0.31
2130,2021-06-12,LIG,10245,4984,5261,7477,2758,10,ITC,ITC3,7,Liguria,Liguria,1550640,904123,58.31,0.66
2131,2021-04-30,LIG,14432,6445,7987,5757,8576,99,ITC,ITC3,7,Liguria,Liguria,1550640,918555,59.24,0.93
2132,2021-03-06,LIG,3307,1843,1464,2552,706,49,ITC,ITC3,7,Liguria,Liguria,1550640,921862,59.45,0.21
2133,2021-01-22,LIG,1823,605,1218,1333,487,3,ITC,ITC3,7,Liguria,Liguria,1550640,923685,59.57,0.12
2134,2021-05-02,LIG,3978,1836,2142,504,3468,6,ITC,ITC3,7,Liguria,Liguria,1550640,927663,59.82,0.26
2135,2021-05-24,LIG,11881,5592,6289,9269,2508,104,ITC,ITC3,7,Liguria,Liguria,1550640,939544,60.59,0.77
2136,2021-05-07,LIG,13612,6045,7567,5736,7807,69,ITC,ITC3,7,Liguria,Liguria,1550640,953156,61.47,0.88
2137,2021-02-13,LIG,1081,508,573,798,280,3,ITC,ITC3,7,Liguria,Liguria,1550640,954237,61.54,0.07
2138,2021-06-07,LIG,15691,7659,8032,8649,7028,14,ITC,ITC3,7,Liguria,Liguria,1550640,969928,62.55,1.01
2139,2021-03-08,LIG,5627,2462,3165,3896,1690,41,ITC,ITC3,7,Liguria,Liguria,1550640,975555,62.91,0.36
2140,2021-03-25,LIG,9772,4234,5538,6229,3392,151,ITC,ITC3,7,Liguria,Liguria,1550640,985327,63.54,0.63
2141,2021-01-01,LIG,145,55,90,145,0,0,ITC,ITC3,7,Liguria,Liguria,1550640,985472,63.55,0.01
2142,2021-03-27,LIG,3933,1548,2385,2484,1397,52,ITC,ITC3,7,Liguria,Liguria,1550640,989405,63.81,0.25
2143,2021-07-05,LIG,11897,5767,6130,5344,6510,43,ITC,ITC3,7,Liguria,Liguria,1550640,1001302,64.57,0.77
2144,2021-04-13,LIG,13083,5870,7213,10944,2025,114,ITC,ITC3,7,Liguria,Liguria,1550640,1014385,65.42,0.84
2145,2021-01-11,LIG,2657,993,1664,2655,0,2,ITC,ITC3,7,Liguria,Liguria,1550640,1017042,65.59,0.17
2146,2021-07-12,LIG,13407,6433,6974,4155,9219,33,ITC,ITC3,7,Liguria,Liguria,1550640,1030449,66.45,0.86
2147,2021-01-10,LIG,650,263,387,646,0,4,ITC,ITC3,7,Liguria,Liguria,1550640,1031099,66.5,0.04
2148,2021-04-20,LIG,14246,6523,7723,9734,4358,154,ITC,ITC3,7,Liguria,Liguria,1550640,1045345,67.41,0.92
2149,2021-07-19,LIG,12093,6028,6065,3372,8674,47,ITC,ITC3,7,Liguria,Liguria,1550640,1057438,68.19,0.78
2150,2021-08-05,LIG,14187,7337,6850,4130,10003,54,ITC,ITC3,7,Liguria,Liguria,1550640,1071625,69.11,0.91
2151,2021-04-27,LIG,14812,6696,8116,7147,7597,68,ITC,ITC3,7,Liguria,Liguria,1550640,1086437,70.06,0.96
2152,2021-02-03,LIG,2320,792,1528,51,2269,0,ITC,ITC3,7,Liguria,Liguria,1550640,1088757,70.21,0.15
2153,2021-05-04,LIG,13658,6089,7569,5359,8231,68,ITC,ITC3,7,Liguria,Liguria,1550640,1102415,71.09,0.88
2154,2021-05-09,LIG,2825,1244,1581,1085,1710,30,ITC,ITC3,7,Liguria,Liguria,1550640,1105240,71.28,0.18
2155,2021-01-29,LIG,3098,1068,2030,64,3034,0,ITC,ITC3,7,Liguria,Liguria,1550640,1108338,71.48,0.2
2156,2021-01-20,LIG,1559,557,1002,1546,12,1,ITC,ITC3,7,Liguria,Liguria,1550640,1109897,71.58,0.1
2157,2021-06-30,LIG,15082,7193,7889,8227,6804,51,ITC,ITC3,7,Liguria,Liguria,1550640,1124979,72.55,0.97
2158,2021-01-15,LIG,2263,756,1507,2258,0,5,ITC,ITC3,7,Liguria,Liguria,1550640,1127242,72.7,0.15
2159,2021-04-25,LIG,1935,920,1015,1506,415,14,ITC,ITC3,7,Liguria,Liguria,1550640,1129177,72.82,0.12
2160,2021-03-13,LIG,3850,1637,2213,2948,857,45,ITC,ITC3,7,Liguria,Liguria,1550640,1133027,73.07,0.25
2161,2021-05-13,LIG,13326,6093,7233,8901,4268,157,ITC,ITC3,7,Liguria,Liguria,1550640,1146353,73.93,0.86
2162,2021-02-19,LIG,3219,1306,1913,3023,176,20,ITC,ITC3,7,Liguria,Liguria,1550640,1149572,74.14,0.21
2163,2021-05-30,LIG,3299,1610,1689,1338,1944,17,ITC,ITC3,7,Liguria,Liguria,1550640,1152871,74.35,0.21
2164,2021-06-26,LIG,7223,3358,3865,4477,2713,33,ITC,ITC3,7,Liguria,Liguria,1550640,1160094,74.81,0.47
2165,2021-07-10,LIG,6899,3478,3421,2754,4129,16,ITC,ITC3,7,Liguria,Liguria,1550640,1166993,75.26,0.44
2166,2021-04-04,LIG,764,369,395,505,251,8,ITC,ITC3,7,Liguria,Liguria,1550640,1167757,75.31,0.05
2167,2021-04-18,LIG,2614,1164,1450,2072,469,73,ITC,ITC3,7,Liguria,Liguria,1550640,1170371,75.48,0.17
2168,2021-07-27,LIG,17429,8885,8544,4371,13000,58,ITC,ITC3,7,Liguria,Liguria,1550640,1187800,76.6,1.12
2169,2021-01-08,LIG,2937,1000,1937,2935,0,2,ITC,ITC3,7,Liguria,Liguria,1550640,1190737,76.79,0.19
2170,2021-05-23,LIG,2308,1121,1187,1171,1123,14,ITC,ITC3,7,Liguria,Liguria,1550640,1193045,76.94,0.15
2171,2021-03-01,LIG,3541,1448,2093,3384,136,21,ITC,ITC3,7,Liguria,Liguria,1550640,1196586,77.17,0.23
2172,2021-06-09,LIG,19064,9566,9498,12468,6565,31,ITC,ITC3,7,Liguria,Liguria,1550640,1215650,78.4,1.23
2173,2021-02-15,LIG,2263,839,1424,1854,399,10,ITC,ITC3,7,Liguria,Liguria,1550640,1217913,78.54,0.15
2174,2021-01-03,LIG,736,231,505,734,0,2,ITC,ITC3,7,Liguria,Liguria,1550640,1218649,78.59,0.05
2175,2021-07-26,LIG,17531,8944,8587,4714,12745,72,ITC,ITC3,7,Liguria,Liguria,1550640,1236180,79.72,1.13
2176,2021-01-07,LIG,3226,1096,2130,3223,0,3,ITC,ITC3,7,Liguria,Liguria,1550640,1239406,79.93,0.21
2177,2021-06-13,LIG,5625,2698,2927,5162,456,7,ITC,ITC3,7,Liguria,Liguria,1550640,1245031,80.29,0.36
2178,2021-04-17,LIG,7391,3219,4172,6567,753,71,ITC,ITC3,7,Liguria,Liguria,1550640,1252422,80.77,0.48
2179,2021-07-21,LIG,19184,9504,9680,3836,15297,51,ITC,ITC3,7,Liguria,Liguria,1550640,1271606,82.01,1.24
2180,2021-04-29,LIG,15589,6982,8607,6614,8846,129,ITC,ITC3,7,Liguria,Liguria,1550640,1287195,83.01,1.01
2181,2021-04-12,LIG,12392,5478,6914,10276,2020,96,ITC,ITC3,7,Liguria,Liguria,1550640,1299587,83.81,0.8
2182,2021-01-19,LIG,1375,440,935,1281,90,4,ITC,ITC3,7,Liguria,Liguria,1550640,1300962,83.9,0.09
2183,2021-02-05,LIG,2687,989,1698,300,2386,1,ITC,ITC3,7,Liguria,Liguria,1550640,1303649,84.07,0.17
2184,2021-07-09,LIG,12834,6324,6510,4227,8579,28,ITC,ITC3,7,Liguria,Liguria,1550640,1316483,84.9,0.83
2185,2021-06-23,LIG,14333,6857,7476,9106,5200,27,ITC,ITC3,7,Liguria,Liguria,1550640,1330816,85.82,0.92
2186,2021-02-14,LIG,233,122,111,233,0,0,ITC,ITC3,7,Liguria,Liguria,1550640,1331049,85.84,0.02
2187,2021-05-25,LIG,14268,6957,7311,10948,3188,132,ITC,ITC3,7,Liguria,Liguria,1550640,1345317,86.76,0.92
2188,2021-03-22,LIG,7754,3474,4280,4737,2943,74,ITC,ITC3,7,Liguria,Liguria,1550640,1353071,87.26,0.5
2189,2021-02-07,LIG,407,153,254,2,405,0,ITC,ITC3,7,Liguria,Liguria,1550640,1353478,87.29,0.03
2190,2021-01-27,LIG,1746,604,1142,139,1606,1,ITC,ITC3,7,Liguria,Liguria,1550640,1355224,87.4,0.11
2191,2021-05-21,LIG,12857,5962,6895,9580,3134,143,ITC,ITC3,7,Liguria,Liguria,1550640,1368081,88.23,0.83
2192,2021-02-27,LIG,1888,921,967,1750,129,9,ITC,ITC3,7,Liguria,Liguria,1550640,1369969,88.35,0.12
2193,2021-02-10,LIG,2322,838,1484,1014,1304,4,ITC,ITC3,7,Liguria,Liguria,1550640,1372291,88.5,0.15
2194,2021-06-01,LIG,16340,8227,8113,10946,5370,24,ITC,ITC3,7,Liguria,Liguria,1550640,1388631,89.55,1.05
2195,2021-06-18,LIG,15420,7506,7914,8178,7216,26,ITC,ITC3,7,Liguria,Liguria,1550640,1404051,90.55,0.99
2196,2021-03-10,LIG,5904,2864,3040,3929,1911,64,ITC,ITC3,7,Liguria,Liguria,1550640,1409955,90.93,0.38
2197,2021-04-03,LIG,5410,2500,2910,4432,943,35,ITC,ITC3,7,Liguria,Liguria,1550640,1415365,91.28,0.35
2198,2021-01-24,LIG,760,240,520,116,644,0,ITC,ITC3,7,Liguria,Liguria,1550640,1416125,91.33,0.05
2199,2021-06-27,LIG,1945,892,1053,688,1247,10,ITC,ITC3,7,Liguria,Liguria,1550640,1418070,91.45,0.13
2200,2021-05-01,LIG,7147,3258,3889,1306,5803,38,ITC,ITC3,7,Liguria,Liguria,1550640,1425217,91.91,0.46
2201,2021-03-05,LIG,4869,2150,2719,3674,1132,63,ITC,ITC3,7,Liguria,Liguria,1550640,1430086,92.23,0.31
2202,2021-08-09,LIG,11938,6068,5870,4359,7491,88,ITC,ITC3,7,Liguria,Liguria,1550640,1442024,93.0,0.77
2203,2021-06-06,LIG,3814,2033,1781,2945,862,7,ITC,ITC3,7,Liguria,Liguria,1550640,1445838,93.24,0.25
2204,2021-04-24,LIG,8220,3796,4424,4977,3154,89,ITC,ITC3,7,Liguria,Liguria,1550640,1454058,93.77,0.53
2205,2021-02-26,LIG,3769,1524,2245,3415,329,25,ITC,ITC3,7,Liguria,Liguria,1550640,1457827,94.01,0.24
2206,2021-08-02,LIG,13055,6489,6566,2973,10031,51,ITC,ITC3,7,Liguria,Liguria,1550640,1470882,94.86,0.84
2207,2021-06-20,LIG,1335,658,677,1053,275,7,ITC,ITC3,7,Liguria,Liguria,1550640,1472217,94.94,0.09
2208,2021-03-24,LIG,9180,4033,5147,5808,3287,85,ITC,ITC3,7,Liguria,Liguria,1550640,1481397,95.53,0.59
2209,2021-07-02,LIG,12967,6361,6606,6432,6496,39,ITC,ITC3,7,Liguria,Liguria,1550640,1494364,96.37,0.84
2210,2020-12-31,LIG,990,353,637,990,0,0,ITC,ITC3,7,Liguria,Liguria,1550640,1495354,96.43,0.06
2211,2021-04-10,LIG,7889,3561,4328,6891,914,84,ITC,ITC3,7,Liguria,Liguria,1550640,1503243,96.94,0.51
2212,2021-01-17,LIG,866,301,565,865,0,1,ITC,ITC3,7,Liguria,Liguria,1550640,1504109,97.0,0.06
2213,2021-04-05,LIG,3980,1755,2225,2305,1649,26,ITC,ITC3,7,Liguria,Liguria,1550640,1508089,97.26,0.26
2214,2021-07-16,LIG,12612,6214,6398,3140,9428,44,ITC,ITC3,7,Liguria,Liguria,1550640,1520701,98.07,0.81
2215,2021-05-11,LIG,13937,6401,7536,7205,6624,108,ITC,ITC3,7,Liguria,Liguria,1550640,1534638,98.97,0.9
2216,2021-03-29,LIG,10585,4624,5961,7347,3133,105,ITC,ITC3,7,Liguria,Liguria,1550640,1545223,99.65,0.68
2217,2021-01-31,LIG,623,269,354,4,619,0,ITC,ITC3,7,Liguria,Liguria,1550640,1545846,99.69,0.04
2218,2021-03-18,LIG,4988,2124,2864,1971,2981,36,ITC,ITC3,7,Liguria,Liguria,1550640,1550834,100.01,0.32
2219,2021-04-01,LIG,12431,5514,6917,9571,2770,90,ITC,ITC3,7,Liguria,Liguria,1550640,1563265,100.81,0.8
2220,2021-06-08,LIG,18108,9031,9077,11439,6646,23,ITC,ITC3,7,Liguria,Liguria,1550640,1581373,101.98,1.17
2221,2021-03-17,LIG,5556,2370,3186,2452,3082,22,ITC,ITC3,7,Liguria,Liguria,1550640,1586929,102.34,0.36
2222,2021-06-25,LIG,13845,6619,7226,6907,6915,23,ITC,ITC3,7,Liguria,Liguria,1550640,1600774,103.23,0.89
2223,2021-05-18,LIG,13493,6131,7362,10055,3311,127,ITC,ITC3,7,Liguria,Liguria,1550640,1614267,104.1,0.87
2224,2021-05-20,LIG,12941,6007,6934,8779,4036,126,ITC,ITC3,7,Liguria,Liguria,1550640,1627208,104.94,0.83
2225,2021-02-12,LIG,1940,690,1250,893,1045,2,ITC,ITC3,7,Liguria,Liguria,1550640,1629148,105.06,0.13
2226,2021-03-15,LIG,7358,3118,4240,4496,2813,49,ITC,ITC3,7,Liguria,Liguria,1550640,1636506,105.54,0.47
2227,2021-07-07,LIG,11767,5643,6124,4966,6768,33,ITC,ITC3,7,Liguria,Liguria,1550640,1648273,106.3,0.76
2228,2021-07-14,LIG,11481,5654,5827,3439,8012,30,ITC,ITC3,7,Liguria,Liguria,1550640,1659754,107.04,0.74
2229,2021-07-28,LIG,18434,9494,8940,5814,12521,99,ITC,ITC3,7,Liguria,Liguria,1550640,1678188,108.23,1.19
2230,2021-05-06,LIG,14534,6444,8090,6069,8334,131,ITC,ITC3,7,Liguria,Liguria,1550640,1692722,109.16,0.94
2231,2021-01-26,LIG,2489,808,1681,17,2472,0,ITC,ITC3,7,Liguria,Liguria,1550640,1695211,109.32,0.16
2232,2021-03-28,LIG,1142,511,631,378,752,12,ITC,ITC3,7,Liguria,Liguria,1550640,1696353,109.4,0.07
2233,2021-02-06,LIG,1892,768,1124,145,1747,0,ITC,ITC3,7,Liguria,Liguria,1550640,1698245,109.52,0.12
2234,2021-06-11,LIG,17845,9085,8760,11751,6076,18,ITC,ITC3,7,Liguria,Liguria,1550640,1716090,110.67,1.15
2235,2021-04-15,LIG,11846,5238,6608,9891,1851,104,ITC,ITC3,7,Liguria,Liguria,1550640,1727936,111.43,0.76
2236,2021-04-08,LIG,13789,6181,7608,11587,2047,155,ITC,ITC3,7,Liguria,Liguria,1550640,1741725,112.32,0.89
2237,2021-07-17,LIG,6512,3360,3152,1816,4689,7,ITC,ITC3,7,Liguria,Liguria,1550640,1748237,112.74,0.42
2238,2021-07-31,LIG,8248,4405,3843,1318,6916,14,ITC,ITC3,7,Liguria,Liguria,1550640,1756485,113.27,0.53
2239,2021-06-04,LIG,14793,7261,7532,9276,5495,22,ITC,ITC3,7,Liguria,Liguria,1550640,1771278,114.23,0.95
2240,2021-02-17,LIG,2695,1184,1511,2248,435,12,ITC,ITC3,7,Liguria,Liguria,1550640,1773973,114.4,0.17
2241,2021-07-24,LIG,11596,6035,5561,2332,9234,30,ITC,ITC3,7,Liguria,Liguria,1550640,1785569,115.15,0.75
2242,2021-05-28,LIG,16306,8145,8161,11604,4556,146,ITC,ITC3,7,Liguria,Liguria,1550640,1801875,116.2,1.05
2243,2021-01-05,LIG,2880,896,1984,2880,0,0,ITC,ITC3,7,Liguria,Liguria,1550640,1804755,116.39,0.19
2244,2021-03-03,LIG,4580,1846,2734,3443,1027,110,ITC,ITC3,7,Liguria,Liguria,1550640,1809335,116.68,0.3
2245,2021-08-04,LIG,13807,6958,6849,3286,10448,73,ITC,ITC3,7,Liguria,Liguria,1550640,1823142,117.57,0.89
2246,2021-02-24,LIG,3763,1560,2203,3448,258,57,ITC,ITC3,7,Liguria,Liguria,1550640,1826905,117.82,0.24
2247,2020-12-29,LIG,125,33,92,125,0,0,ITC,ITC3,7,Liguria,Liguria,1550640,1827030,117.82,0.01
2248,2021-01-12,LIG,2475,890,1585,2474,0,1,ITC,ITC3,7,Liguria,Liguria,1550640,1829505,117.98,0.16
2249,2021-04-22,LIG,13873,6216,7657,8647,5088,138,ITC,ITC3,7,Liguria,Liguria,1550640,1843378,118.88,0.89
2250,2021-06-17,VEN,51723,25920,25803,25550,25031,1142,ITH,ITH3,5,Veneto,Veneto,4905854,51723,1.05,1.05
2251,2021-03-09,VEN,16548,7450,9098,9829,6323,396,ITH,ITH3,5,Veneto,Veneto,4905854,68271,1.39,0.34
2252,2021-05-31,VEN,31644,16242,15402,20896,9929,819,ITH,ITH3,5,Veneto,Veneto,4905854,99915,2.04,0.65
2253,2021-03-26,VEN,29613,13159,16454,23289,5464,860,ITH,ITH3,5,Veneto,Veneto,4905854,129528,2.64,0.6
2254,2021-03-28,VEN,31313,13609,17704,26887,3614,812,ITH,ITH3,5,Veneto,Veneto,4905854,160841,3.28,0.64
2255,2021-06-19,VEN,49288,25076,24212,25688,22577,1023,ITH,ITH3,5,Veneto,Veneto,4905854,210129,4.28,1.0
2256,2021-01-23,VEN,4057,1250,2807,31,4026,0,ITH,ITH3,5,Veneto,Veneto,4905854,214186,4.37,0.08
2257,2021-06-29,VEN,45548,22721,22827,19044,25823,681,ITH,ITH3,5,Veneto,Veneto,4905854,259734,5.29,0.93
2258,2021-03-21,VEN,11991,4756,7235,8286,3465,240,ITH,ITH3,5,Veneto,Veneto,4905854,271725,5.54,0.24
2259,2021-01-16,VEN,4611,1542,3069,4611,0,0,ITH,ITH3,5,Veneto,Veneto,4905854,276336,5.63,0.09
2260,2021-03-14,VEN,15182,5944,9238,13851,894,437,ITH,ITH3,5,Veneto,Veneto,4905854,291518,5.94,0.31
2261,2021-05-17,VEN,26536,12997,13539,15663,10055,818,ITH,ITH3,5,Veneto,Veneto,4905854,318054,6.48,0.54
2262,2021-02-06,VEN,4097,1354,2743,708,3389,0,ITH,ITH3,5,Veneto,Veneto,4905854,322151,6.57,0.08
2263,2021-02-23,VEN,7383,3253,4130,7029,270,84,ITH,ITH3,5,Veneto,Veneto,4905854,329534,6.72,0.15
2264,2021-07-27,VEN,42166,22125,20041,11716,30016,434,ITH,ITH3,5,Veneto,Veneto,4905854,371700,7.58,0.86
2265,2021-08-01,VEN,27868,14912,12956,11007,16345,516,ITH,ITH3,5,Veneto,Veneto,4905854,399568,8.14,0.57
2266,2021-04-23,VEN,31284,13853,17431,21425,8707,1152,ITH,ITH3,5,Veneto,Veneto,4905854,430852,8.78,0.64
2267,2021-02-16,VEN,6644,2870,3774,6439,176,29,ITH,ITH3,5,Veneto,Veneto,4905854,437496,8.92,0.14
2268,2021-07-18,VEN,37705,19754,17951,3834,33620,251,ITH,ITH3,5,Veneto,Veneto,4905854,475201,9.69,0.77
2269,2021-02-25,VEN,7902,3343,4559,7158,607,137,ITH,ITH3,5,Veneto,Veneto,4905854,483103,9.85,0.16
2270,2021-04-09,VEN,31204,13768,17436,21918,8348,938,ITH,ITH3,5,Veneto,Veneto,4905854,514307,10.48,0.64
2271,2021-06-05,VEN,46870,24142,22728,37327,8097,1446,ITH,ITH3,5,Veneto,Veneto,4905854,561177,11.44,0.96
2272,2021-05-05,VEN,44410,21282,23128,36230,6566,1614,ITH,ITH3,5,Veneto,Veneto,4905854,605587,12.34,0.91
2273,2021-07-01,VEN,50951,26021,24930,20692,29260,999,ITH,ITH3,5,Veneto,Veneto,4905854,656538,13.38,1.04
2274,2021-01-11,VEN,7243,2102,5141,7242,0,1,ITH,ITH3,5,Veneto,Veneto,4905854,663781,13.53,0.15
2275,2021-04-21,VEN,32399,13201,19198,15561,16064,774,ITH,ITH3,5,Veneto,Veneto,4905854,696180,14.19,0.66
2276,2021-05-22,VEN,34827,16699,18128,12717,21441,669,ITH,ITH3,5,Veneto,Veneto,4905854,731007,14.9,0.71
2277,2021-02-11,VEN,4014,1238,2776,3348,628,38,ITH,ITH3,5,Veneto,Veneto,4905854,735021,14.98,0.08
2278,2021-01-28,VEN,9215,2666,6549,169,9044,2,ITH,ITH3,5,Veneto,Veneto,4905854,744236,15.17,0.19
2279,2021-07-13,VEN,43511,22582,20929,5375,37825,311,ITH,ITH3,5,Veneto,Veneto,4905854,787747,16.06,0.89
2280,2021-04-04,VEN,7790,3535,4255,6517,1148,125,ITH,ITH3,5,Veneto,Veneto,4905854,795537,16.22,0.16
2281,2021-05-24,VEN,33084,16433,16651,7630,25049,405,ITH,ITH3,5,Veneto,Veneto,4905854,828621,16.89,0.67
2282,2021-05-10,VEN,36510,17084,19426,25426,9852,1232,ITH,ITH3,5,Veneto,Veneto,4905854,865131,17.63,0.74
2283,2021-01-30,VEN,8758,2677,6081,691,8067,0,ITH,ITH3,5,Veneto,Veneto,4905854,873889,17.81,0.18
2284,2021-03-07,VEN,4496,1770,2726,3866,561,69,ITH,ITH3,5,Veneto,Veneto,4905854,878385,17.9,0.09
2285,2021-05-03,VEN,40707,19811,20896,32804,6440,1463,ITH,ITH3,5,Veneto,Veneto,4905854,919092,18.73,0.83
2286,2021-07-06,VEN,36055,18583,17472,13132,22295,628,ITH,ITH3,5,Veneto,Veneto,4905854,955147,19.47,0.73
2287,2021-04-14,VEN,15937,6912,9025,8764,6634,539,ITH,ITH3,5,Veneto,Veneto,4905854,971084,19.79,0.32
2288,2021-01-04,VEN,6738,2036,4702,6736,0,2,ITH,ITH3,5,Veneto,Veneto,4905854,977822,19.93,0.14
2289,2021-05-14,VEN,46805,22265,24540,24300,20933,1572,ITH,ITH3,5,Veneto,Veneto,4905854,1024627,20.89,0.95
2290,2021-02-20,VEN,6429,2018,4411,6276,72,81,ITH,ITH3,5,Veneto,Veneto,4905854,1031056,21.02,0.13
2291,2021-08-06,VEN,38154,20816,17338,19759,17521,874,ITH,ITH3,5,Veneto,Veneto,4905854,1069210,21.79,0.78
2292,2021-04-28,VEN,32457,15197,17260,22257,9022,1178,ITH,ITH3,5,Veneto,Veneto,4905854,1101667,22.46,0.66
2293,2021-07-20,VEN,44312,23662,20650,6841,36962,509,ITH,ITH3,5,Veneto,Veneto,4905854,1145979,23.36,0.9
2294,2021-01-18,VEN,2766,778,1988,2560,201,5,ITH,ITH3,5,Veneto,Veneto,4905854,1148745,23.42,0.06
2295,2021-02-04,VEN,7396,2028,5368,550,6845,1,ITH,ITH3,5,Veneto,Veneto,4905854,1156141,23.57,0.15
2296,2021-08-08,VEN,20475,11366,9109,10633,9533,309,ITH,ITH3,5,Veneto,Veneto,4905854,1176616,23.98,0.42
2297,2021-05-29,VEN,33046,16695,16351,24244,7686,1116,ITH,ITH3,5,Veneto,Veneto,4905854,1209662,24.66,0.67
2298,2021-02-18,VEN,5831,2456,3375,5728,64,39,ITH,ITH3,5,Veneto,Veneto,4905854,1215493,24.78,0.12
2299,2021-07-25,VEN,33140,17510,15630,10787,21886,467,ITH,ITH3,5,Veneto,Veneto,4905854,1248633,25.45,0.68
2300,2021-04-16,VEN,24460,10499,13961,11896,11888,676,ITH,ITH3,5,Veneto,Veneto,4905854,1273093,25.95,0.5
2301,2021-06-12,VEN,48688,24499,24189,36416,10812,1460,ITH,ITH3,5,Veneto,Veneto,4905854,1321781,26.94,0.99
2302,2021-05-12,VEN,36981,17902,19079,30237,5129,1615,ITH,ITH3,5,Veneto,Veneto,4905854,1358762,27.7,0.75
2303,2021-07-08,VEN,46679,24294,22385,4475,41906,298,ITH,ITH3,5,Veneto,Veneto,4905854,1405441,28.65,0.95
2304,2021-06-24,VEN,56174,28453,27721,17634,37858,682,ITH,ITH3,5,Veneto,Veneto,4905854,1461615,29.79,1.15
2305,2021-03-16,VEN,12532,5356,7176,6640,5623,269,ITH,ITH3,5,Veneto,Veneto,4905854,1474147,30.05,0.26
2306,2021-03-23,VEN,22222,10246,11976,16871,4716,635,ITH,ITH3,5,Veneto,Veneto,4905854,1496369,30.5,0.45
2307,2021-03-02,VEN,11494,4627,6867,7935,3312,247,ITH,ITH3,5,Veneto,Veneto,4905854,1507863,30.74,0.23
2308,2021-06-10,VEN,52363,27019,25344,41311,9359,1693,ITH,ITH3,5,Veneto,Veneto,4905854,1560226,31.8,1.07
2309,2021-04-02,VEN,24111,10630,13481,17136,6331,644,ITH,ITH3,5,Veneto,Veneto,4905854,1584337,32.29,0.49
2310,2021-01-09,VEN,7934,2539,5395,7929,0,5,ITH,ITH3,5,Veneto,Veneto,4905854,1592271,32.46,0.16
2311,2021-03-18,VEN,12621,5145,7476,7036,5232,353,ITH,ITH3,5,Veneto,Veneto,4905854,1604892,32.71,0.26
2312,2021-06-26,VEN,48076,24513,23563,13600,33989,487,ITH,ITH3,5,Veneto,Veneto,4905854,1652968,33.69,0.98
2313,2021-05-28,VEN,46883,22948,23935,23685,22001,1197,ITH,ITH3,5,Veneto,Veneto,4905854,1699851,34.65,0.96
2314,2021-07-24,VEN,41607,22311,19296,13215,27754,638,ITH,ITH3,5,Veneto,Veneto,4905854,1741458,35.5,0.85
2315,2021-07-10,VEN,43157,23193,19964,6259,36539,359,ITH,ITH3,5,Veneto,Veneto,4905854,1784615,36.38,0.88
2316,2021-07-17,VEN,40573,21460,19113,4275,35956,342,ITH,ITH3,5,Veneto,Veneto,4905854,1825188,37.2,0.83
2317,2021-06-02,VEN,20314,10237,10077,15352,4346,616,ITH,ITH3,5,Veneto,Veneto,4905854,1845502,37.62,0.41
2318,2021-03-11,VEN,19834,8892,10942,13793,5574,467,ITH,ITH3,5,Veneto,Veneto,4905854,1865336,38.02,0.4
2319,2021-04-30,VEN,50253,23614,26639,33176,15672,1405,ITH,ITH3,5,Veneto,Veneto,4905854,1915589,39.05,1.02
2320,2021-01-20,VEN,1038,368,670,386,652,0,ITH,ITH3,5,Veneto,Veneto,4905854,1916627,39.07,0.02
2321,2021-07-03,VEN,38697,20114,18583,11031,27096,570,ITH,ITH3,5,Veneto,Veneto,4905854,1955324,39.86,0.79
2322,2021-06-16,VEN,47772,23568,24204,25273,21412,1087,ITH,ITH3,5,Veneto,Veneto,4905854,2003096,40.83,0.97
2323,2021-01-01,VEN,1528,471,1057,1527,0,1,ITH,ITH3,5,Veneto,Veneto,4905854,2004624,40.86,0.03
2324,2021-03-25,VEN,25975,11062,14913,18976,6104,895,ITH,ITH3,5,Veneto,Veneto,4905854,2030599,41.39,0.53
2325,2021-08-05,VEN,38945,21282,17663,15518,22828,599,ITH,ITH3,5,Veneto,Veneto,4905854,2069544,42.19,0.79
2326,2021-04-18,VEN,17529,7262,10267,9510,7567,452,ITH,ITH3,5,Veneto,Veneto,4905854,2087073,42.54,0.36
2327,2021-01-08,VEN,9415,2838,6577,9401,0,14,ITH,ITH3,5,Veneto,Veneto,4905854,2096488,42.73,0.19
2328,2021-01-13,VEN,5988,1606,4382,5985,0,3,ITH,ITH3,5,Veneto,Veneto,4905854,2102476,42.86,0.12
2329,2021-05-02,VEN,37244,17265,19979,25619,10330,1295,ITH,ITH3,5,Veneto,Veneto,4905854,2139720,43.62,0.76
2330,2021-06-14,VEN,42619,21555,21064,26304,15311,1004,ITH,ITH3,5,Veneto,Veneto,4905854,2182339,44.48,0.87
2331,2021-03-06,VEN,10683,4357,6326,7218,3278,187,ITH,ITH3,5,Veneto,Veneto,4905854,2193022,44.7,0.22
2332,2021-08-10,VEN,28191,15445,12746,16269,11327,595,ITH,ITH3,5,Veneto,Veneto,4905854,2221213,45.28,0.57
2333,2020-12-30,VEN,699,245,454,699,0,0,ITH,ITH3,5,Veneto,Veneto,4905854,2221912,45.29,0.01
2334,2021-06-07,VEN,44693,23318,21375,36179,7038,1476,ITH,ITH3,5,Veneto,Veneto,4905854,2266605,46.2,0.91
2335,2021-02-27,VEN,8994,2693,6301,7964,849,181,ITH,ITH3,5,Veneto,Veneto,4905854,2275599,46.39,0.18
2336,2021-05-07,VEN,48613,23292,25321,37596,8671,2346,ITH,ITH3,5,Veneto,Veneto,4905854,2324212,47.38,0.99
2337,2021-01-27,VEN,7146,2067,5079,240,6905,1,ITH,ITH3,5,Veneto,Veneto,4905854,2331358,47.52,0.15
2338,2021-02-13,VEN,3266,1473,1793,3230,20,16,ITH,ITH3,5,Veneto,Veneto,4905854,2334624,47.59,0.07
2339,2021-04-27,VEN,28208,12797,15411,20139,6914,1155,ITH,ITH3,5,Veneto,Veneto,4905854,2362832,48.16,0.57
2340,2021-01-17,VEN,1933,781,1152,1584,349,0,ITH,ITH3,5,Veneto,Veneto,4905854,2364765,48.2,0.04
2341,2021-02-03,VEN,5953,1671,4282,474,5475,4,ITH,ITH3,5,Veneto,Veneto,4905854,2370718,48.32,0.12
2342,2021-08-07,VEN,28885,16259,12626,16291,12046,548,ITH,ITH3,5,Veneto,Veneto,4905854,2399603,48.91,0.59
2343,2021-04-29,VEN,50305,23402,26903,35398,13179,1728,ITH,ITH3,5,Veneto,Veneto,4905854,2449908,49.94,1.03
2344,2021-05-21,VEN,44835,22042,22793,19805,23929,1101,ITH,ITH3,5,Veneto,Veneto,4905854,2494743,50.85,0.91
2345,2021-02-17,VEN,6022,2772,3250,5900,94,28,ITH,ITH3,5,Veneto,Veneto,4905854,2500765,50.98,0.12
2346,2021-04-11,VEN,21011,8876,12135,14231,6295,485,ITH,ITH3,5,Veneto,Veneto,4905854,2521776,51.4,0.43
2347,2021-07-22,VEN,48285,25058,23227,13217,34420,648,ITH,ITH3,5,Veneto,Veneto,4905854,2570061,52.39,0.98
2348,2021-04-13,VEN,14037,6326,7711,8058,5479,500,ITH,ITH3,5,Veneto,Veneto,4905854,2584098,52.67,0.29
2349,2021-07-05,VEN,39127,20278,18849,14143,24193,791,ITH,ITH3,5,Veneto,Veneto,4905854,2623225,53.47,0.8
2350,2021-01-03,VEN,5158,1562,3596,5158,0,0,ITH,ITH3,5,Veneto,Veneto,4905854,2628383,53.58,0.11
2351,2021-03-04,VEN,12986,4888,8098,9121,3475,390,ITH,ITH3,5,Veneto,Veneto,4905854,2641369,53.84,0.26
2352,2021-07-07,VEN,40867,21257,19610,15560,24513,794,ITH,ITH3,5,Veneto,Veneto,4905854,2682236,54.67,0.83
2353,2021-05-11,VEN,33186,16509,16677,27154,4721,1311,ITH,ITH3,5,Veneto,Veneto,4905854,2715422,55.35,0.68
2354,2021-08-03,VEN,40624,21506,19118,17530,22383,711,ITH,ITH3,5,Veneto,Veneto,4905854,2756046,56.18,0.83
2355,2021-04-25,VEN,18336,8156,10180,12909,4835,592,ITH,ITH3,5,Veneto,Veneto,4905854,2774382,56.55,0.37
2356,2021-06-21,VEN,44321,22184,22137,20465,22956,900,ITH,ITH3,5,Veneto,Veneto,4905854,2818703,57.46,0.9
2357,2021-01-06,VEN,8140,2389,5751,8137,0,3,ITH,ITH3,5,Veneto,Veneto,4905854,2826843,57.62,0.17
2358,2021-06-23,VEN,49307,24431,24876,14567,33947,793,ITH,ITH3,5,Veneto,Veneto,4905854,2876150,58.63,1.01
2359,2021-03-15,VEN,16672,7331,9341,10958,5212,502,ITH,ITH3,5,Veneto,Veneto,4905854,2892822,58.97,0.34
2360,2021-06-09,VEN,42778,21945,20833,33792,7442,1544,ITH,ITH3,5,Veneto,Veneto,4905854,2935600,59.84,0.87
2361,2021-06-28,VEN,47650,24113,23537,18424,28532,694,ITH,ITH3,5,Veneto,Veneto,4905854,2983250,60.81,0.97
2362,2021-01-25,VEN,6471,2077,4394,157,6314,0,ITH,ITH3,5,Veneto,Veneto,4905854,2989721,60.94,0.13
2363,2021-07-29,VEN,47368,25042,22326,20018,26492,858,ITH,ITH3,5,Veneto,Veneto,4905854,3037089,61.91,0.97
2364,2021-07-15,VEN,51341,26868,24473,5989,44973,379,ITH,ITH3,5,Veneto,Veneto,4905854,3088430,62.95,1.05
2365,2021-04-20,VEN,22457,9500,12957,7880,14007,570,ITH,ITH3,5,Veneto,Veneto,4905854,3110887,63.41,0.46
2366,2021-07-21,VEN,43194,22296,20898,8659,34038,497,ITH,ITH3,5,Veneto,Veneto,4905854,3154081,64.29,0.88
2367,2021-02-05,VEN,8383,2540,5843,1409,6965,9,ITH,ITH3,5,Veneto,Veneto,4905854,3162464,64.46,0.17
2368,2021-02-22,VEN,7019,3044,3975,6581,391,47,ITH,ITH3,5,Veneto,Veneto,4905854,3169483,64.61,0.14
2369,2021-05-16,VEN,28423,14015,14408,20325,7080,1018,ITH,ITH3,5,Veneto,Veneto,4905854,3197906,65.19,0.58
2370,2021-08-09,VEN,34659,18574,16085,17053,16837,769,ITH,ITH3,5,Veneto,Veneto,4905854,3232565,65.89,0.71
2371,2021-03-03,VEN,12100,4648,7452,8388,3501,211,ITH,ITH3,5,Veneto,Veneto,4905854,3244665,66.14,0.25
2372,2021-06-11,VEN,47313,24613,22700,34719,11180,1414,ITH,ITH3,5,Veneto,Veneto,4905854,3291978,67.1,0.96
2373,2021-04-01,VEN,25389,11185,14204,18200,6414,775,ITH,ITH3,5,Veneto,Veneto,4905854,3317367,67.62,0.52
2374,2021-04-15,VEN,20929,8645,12284,9356,10829,744,ITH,ITH3,5,Veneto,Veneto,4905854,3338296,68.05,0.43
2375,2021-01-05,VEN,7336,2186,5150,7334,0,2,ITH,ITH3,5,Veneto,Veneto,4905854,3345632,68.2,0.15
2376,2021-02-10,VEN,4756,1591,3165,3691,1056,9,ITH,ITH3,5,Veneto,Veneto,4905854,3350388,68.29,0.1
2377,2021-04-08,VEN,32397,14382,18015,23341,7885,1171,ITH,ITH3,5,Veneto,Veneto,4905854,3382785,68.95,0.66
2378,2021-03-08,VEN,13637,6275,7362,9303,4071,263,ITH,ITH3,5,Veneto,Veneto,4905854,3396422,69.23,0.28
2379,2021-06-18,VEN,53629,26761,26868,23990,28610,1029,ITH,ITH3,5,Veneto,Veneto,4905854,3450051,70.33,1.09
2380,2021-05-18,VEN,27032,12550,14482,12641,13632,759,ITH,ITH3,5,Veneto,Veneto,4905854,3477083,70.88,0.55
2381,2021-06-30,VEN,45769,23079,22690,17856,27168,745,ITH,ITH3,5,Veneto,Veneto,4905854,3522852,71.81,0.93
2382,2021-03-22,VEN,18153,8182,9971,12587,5049,517,ITH,ITH3,5,Veneto,Veneto,4905854,3541005,72.18,0.37
2383,2021-03-13,VEN,17239,7311,9928,13734,3133,372,ITH,ITH3,5,Veneto,Veneto,4905854,3558244,72.53,0.35
2384,2021-01-22,VEN,1080,332,748,25,1055,0,ITH,ITH3,5,Veneto,Veneto,4905854,3559324,72.55,0.02
2385,2021-05-04,VEN,43025,20379,22646,33363,8035,1627,ITH,ITH3,5,Veneto,Veneto,4905854,3602349,73.43,0.88
2386,2021-01-24,VEN,4117,1219,2898,28,4089,0,ITH,ITH3,5,Veneto,Veneto,4905854,3606466,73.51,0.08
2387,2020-12-31,VEN,3219,1042,2177,3219,0,0,ITH,ITH3,5,Veneto,Veneto,4905854,3609685,73.58,0.07
2388,2021-07-04,VEN,33881,17579,16302,14995,18285,601,ITH,ITH3,5,Veneto,Veneto,4905854,3643566,74.27,0.69
2389,2021-04-12,VEN,14917,6343,8574,6400,8216,301,ITH,ITH3,5,Veneto,Veneto,4905854,3658483,74.57,0.3
2390,2021-01-02,VEN,5744,1767,3977,5743,0,1,ITH,ITH3,5,Veneto,Veneto,4905854,3664227,74.69,0.12
2391,2021-05-09,VEN,35087,16143,18944,23795,10055,1237,ITH,ITH3,5,Veneto,Veneto,4905854,3699314,75.41,0.72
2392,2021-05-26,VEN,31143,15223,15920,13980,16487,676,ITH,ITH3,5,Veneto,Veneto,4905854,3730457,76.04,0.63
2393,2021-03-01,VEN,9394,3716,5678,7409,1822,163,ITH,ITH3,5,Veneto,Veneto,4905854,3739851,76.23,0.19
2394,2021-06-25,VEN,51703,26158,25545,15075,35996,632,ITH,ITH3,5,Veneto,Veneto,4905854,3791554,77.29,1.05
2395,2021-07-14,VEN,43562,22392,21170,5253,37913,396,ITH,ITH3,5,Veneto,Veneto,4905854,3835116,78.17,0.89
2396,2021-04-22,VEN,32062,13942,18120,15476,15768,818,ITH,ITH3,5,Veneto,Veneto,4905854,3867178,78.83,0.65
2397,2021-07-31,VEN,35068,18845,16223,16957,17465,646,ITH,ITH3,5,Veneto,Veneto,4905854,3902246,79.54,0.71
2398,2021-06-04,VEN,49648,25841,23807,39835,8146,1667,ITH,ITH3,5,Veneto,Veneto,4905854,3951894,80.55,1.01
2399,2021-02-24,VEN,8621,3680,4941,7998,489,134,ITH,ITH3,5,Veneto,Veneto,4905854,3960515,80.73,0.18
2400,2021-03-27,VEN,32088,14015,18073,25379,5806,903,ITH,ITH3,5,Veneto,Veneto,4905854,3992603,81.38,0.65
2401,2021-06-03,VEN,54514,28031,26483,40884,11988,1642,ITH,ITH3,5,Veneto,Veneto,4905854,4047117,82.5,1.11
2402,2021-06-20,VEN,41201,20062,21139,18935,21532,734,ITH,ITH3,5,Veneto,Veneto,4905854,4088318,83.34,0.84
2403,2021-01-15,VEN,5873,1819,4054,5867,0,6,ITH,ITH3,5,Veneto,Veneto,4905854,4094191,83.46,0.12
2404,2021-05-20,VEN,44826,21252,23574,19367,24358,1101,ITH,ITH3,5,Veneto,Veneto,4905854,4139017,84.37,0.91
2405,2021-02-09,VEN,5250,1892,3358,3431,1806,13,ITH,ITH3,5,Veneto,Veneto,4905854,4144267,84.48,0.11
2406,2021-04-07,VEN,36049,16200,19849,27601,7338,1110,ITH,ITH3,5,Veneto,Veneto,4905854,4180316,85.21,0.73
2407,2021-07-16,VEN,44658,24014,20644,6894,37294,470,ITH,ITH3,5,Veneto,Veneto,4905854,4224974,86.12,0.91
2408,2021-01-31,VEN,4789,1566,3223,408,4381,0,ITH,ITH3,5,Veneto,Veneto,4905854,4229763,86.22,0.1
2409,2021-03-29,VEN,31467,13702,17765,26649,3824,994,ITH,ITH3,5,Veneto,Veneto,4905854,4261230,86.86,0.64
2410,2021-05-13,VEN,44320,21866,22454,32594,9903,1823,ITH,ITH3,5,Veneto,Veneto,4905854,4305550,87.76,0.9
2411,2021-02-02,VEN,6513,1881,4632,396,6117,0,ITH,ITH3,5,Veneto,Veneto,4905854,4312063,87.9,0.13
2412,2021-07-09,VEN,45023,23746,21277,4091,40646,286,ITH,ITH3,5,Veneto,Veneto,4905854,4357086,88.81,0.92
2413,2021-07-12,VEN,43217,22769,20448,3987,38903,327,ITH,ITH3,5,Veneto,Veneto,4905854,4400303,89.69,0.88
2414,2021-04-03,VEN,21981,9644,12337,13861,7716,404,ITH,ITH3,5,Veneto,Veneto,4905854,4422284,90.14,0.45
2415,2021-03-20,VEN,13033,5391,7642,10659,2082,292,ITH,ITH3,5,Veneto,Veneto,4905854,4435317,90.41,0.27
2416,2021-01-10,VEN,5036,1673,3363,5035,0,1,ITH,ITH3,5,Veneto,Veneto,4905854,4440353,90.51,0.1
2417,2021-01-19,VEN,1313,475,838,1163,149,1,ITH,ITH3,5,Veneto,Veneto,4905854,4441666,90.54,0.03
2418,2021-07-23,VEN,44236,23266,20970,14920,28735,581,ITH,ITH3,5,Veneto,Veneto,4905854,4485902,91.44,0.9
2419,2021-05-01,VEN,38869,18247,20622,28713,8930,1226,ITH,ITH3,5,Veneto,Veneto,4905854,4524771,92.23,0.79
2420,2021-06-08,VEN,43850,22671,21179,36196,6141,1513,ITH,ITH3,5,Veneto,Veneto,4905854,4568621,93.13,0.89
2421,2021-05-25,VEN,27844,13437,14407,11268,16079,497,ITH,ITH3,5,Veneto,Veneto,4905854,4596465,93.69,0.57
2422,2021-02-14,VEN,126,56,70,113,13,0,ITH,ITH3,5,Veneto,Veneto,4905854,4596591,93.7,0.0
2423,2021-02-28,VEN,4136,1389,2747,3225,837,74,ITH,ITH3,5,Veneto,Veneto,4905854,4600727,93.78,0.08
2424,2021-03-17,VEN,14646,5991,8655,7527,6796,323,ITH,ITH3,5,Veneto,Veneto,4905854,4615373,94.08,0.3
2425,2021-06-22,VEN,43736,21626,22110,18508,24378,850,ITH,ITH3,5,Veneto,Veneto,4905854,4659109,94.97,0.89
2426,2021-08-04,VEN,42301,22593,19708,22489,18719,1093,ITH,ITH3,5,Veneto,Veneto,4905854,4701410,95.83,0.86
2427,2021-04-26,VEN,20731,9461,11270,14917,5140,674,ITH,ITH3,5,Veneto,Veneto,4905854,4722141,96.26,0.42
2428,2021-06-15,VEN,47832,24299,23533,29157,17527,1148,ITH,ITH3,5,Veneto,Veneto,4905854,4769973,97.23,0.97
2429,2021-02-19,VEN,7323,3141,4182,6995,204,124,ITH,ITH3,5,Veneto,Veneto,4905854,4777296,97.38,0.15
2430,2021-02-21,VEN,4640,1212,3428,4516,5,119,ITH,ITH3,5,Veneto,Veneto,4905854,4781936,97.47,0.09
2431,2021-05-15,VEN,36260,17516,18744,24815,10017,1428,ITH,ITH3,5,Veneto,Veneto,4905854,4818196,98.21,0.74
2432,2021-06-01,VEN,26983,13566,13417,15786,10554,643,ITH,ITH3,5,Veneto,Veneto,4905854,4845179,98.76,0.55
2433,2021-03-10,VEN,19040,8726,10314,12964,5684,392,ITH,ITH3,5,Veneto,Veneto,4905854,4864219,99.15,0.39
2434,2021-05-27,VEN,46623,22906,23717,22352,23231,1040,ITH,ITH3,5,Veneto,Veneto,4905854,4910842,100.1,0.95
2435,2021-02-07,VEN,2316,863,1453,714,1601,1,ITH,ITH3,5,Veneto,Veneto,4905854,4913158,100.15,0.05
2436,2021-07-02,VEN,49523,25125,24398,16276,32470,777,ITH,ITH3,5,Veneto,Veneto,4905854,4962681,101.16,1.01
2437,2021-03-24,VEN,22123,9580,12543,14668,6805,650,ITH,ITH3,5,Veneto,Veneto,4905854,4984804,101.61,0.45
2438,2021-05-23,VEN,34489,16467,18022,10619,23400,470,ITH,ITH3,5,Veneto,Veneto,4905854,5019293,102.31,0.7
2439,2021-02-12,VEN,4314,1446,2868,3671,572,71,ITH,ITH3,5,Veneto,Veneto,4905854,5023607,102.4,0.09
2440,2021-01-29,VEN,9026,2789,6237,365,8661,0,ITH,ITH3,5,Veneto,Veneto,4905854,5032633,102.58,0.18
2441,2021-05-08,VEN,41508,18780,22728,28264,11827,1417,ITH,ITH3,5,Veneto,Veneto,4905854,5074141,103.43,0.85
2442,2021-07-30,VEN,45466,24183,21283,22554,22029,883,ITH,ITH3,5,Veneto,Veneto,4905854,5119607,104.36,0.93
2443,2021-03-31,VEN,38947,16442,22505,30401,7506,1040,ITH,ITH3,5,Veneto,Veneto,4905854,5158554,105.15,0.79
2444,2021-07-11,VEN,34225,17921,16304,3689,30280,256,ITH,ITH3,5,Veneto,Veneto,4905854,5192779,105.85,0.7
2445,2021-08-11,VEN,18765,10378,8387,10486,7884,395,ITH,ITH3,5,Veneto,Veneto,4905854,5211544,106.23,0.38
2446,2021-07-28,VEN,40178,20857,19321,11980,27738,460,ITH,ITH3,5,Veneto,Veneto,4905854,5251722,107.05,0.82
2447,2021-01-12,VEN,5231,1517,3714,5223,0,8,ITH,ITH3,5,Veneto,Veneto,4905854,5256953,107.16,0.11
2448,2021-04-19,VEN,21552,8929,12623,4710,16414,428,ITH,ITH3,5,Veneto,Veneto,4905854,5278505,107.6,0.44
2449,2021-04-05,VEN,19165,8376,10789,13426,5438,301,ITH,ITH3,5,Veneto,Veneto,4905854,5297670,107.99,0.39
2450,2021-01-26,VEN,6924,2092,4832,149,6775,0,ITH,ITH3,5,Veneto,Veneto,4905854,5304594,108.13,0.14
2451,2021-06-27,VEN,40239,20556,19683,15354,24310,575,ITH,ITH3,5,Veneto,Veneto,4905854,5344833,108.95,0.82
2452,2021-03-19,VEN,13801,5671,8130,7405,6104,292,ITH,ITH3,5,Veneto,Veneto,4905854,5358634,109.23,0.28
2453,2021-05-06,VEN,47033,22059,24974,36576,8487,1970,ITH,ITH3,5,Veneto,Veneto,4905854,5405667,110.19,0.96
2454,2021-05-19,VEN,33133,15173,17960,16220,15984,929,ITH,ITH3,5,Veneto,Veneto,4905854,5438800,110.86,0.68
2455,2021-02-08,VEN,5006,1559,3447,1923,3077,6,ITH,ITH3,5,Veneto,Veneto,4905854,5443806,110.97,0.1
2456,2021-04-06,VEN,29017,13361,15656,23246,5047,724,ITH,ITH3,5,Veneto,Veneto,4905854,5472823,111.56,0.59
2457,2021-02-01,VEN,8563,2502,6061,157,8406,0,ITH,ITH3,5,Veneto,Veneto,4905854,5481386,111.73,0.17
2458,2021-02-15,VEN,4391,1826,2565,4142,240,9,ITH,ITH3,5,Veneto,Veneto,4905854,5485777,111.82,0.09
2459,2021-03-30,VEN,35996,15313,20683,29739,5249,1008,ITH,ITH3,5,Veneto,Veneto,4905854,5521773,112.55,0.73
2460,2021-08-02,VEN,40023,20988,19035,16238,23141,644,ITH,ITH3,5,Veneto,Veneto,4905854,5561796,113.37,0.82
2461,2021-04-10,VEN,27478,11984,15494,18383,8471,624,ITH,ITH3,5,Veneto,Veneto,4905854,5589274,113.93,0.56
2462,2021-06-06,VEN,37444,19171,18273,31493,4730,1221,ITH,ITH3,5,Veneto,Veneto,4905854,5626718,114.69,0.76
2463,2020-12-27,VEN,880,395,485,880,0,0,ITH,ITH3,5,Veneto,Veneto,4905854,5627598,114.71,0.02
2464,2021-05-30,VEN,22548,11271,11277,15207,6691,650,ITH,ITH3,5,Veneto,Veneto,4905854,5650146,115.17,0.46
2465,2021-07-26,VEN,43576,22905,20671,16934,25994,648,ITH,ITH3,5,Veneto,Veneto,4905854,5693722,116.06,0.89
2466,2021-07-19,VEN,44706,23549,21157,7913,36389,404,ITH,ITH3,5,Veneto,Veneto,4905854,5738428,116.97,0.91
2467,2021-02-26,VEN,8298,3275,5023,6944,1259,95,ITH,ITH3,5,Veneto,Veneto,4905854,5746726,117.14,0.17
2468,2021-04-24,VEN,24767,10830,13937,14966,9079,722,ITH,ITH3,5,Veneto,Veneto,4905854,5771493,117.65,0.5
2469,2021-01-14,VEN,7067,1926,5141,7047,0,20,ITH,ITH3,5,Veneto,Veneto,4905854,5778560,117.79,0.14
2470,2021-03-12,VEN,18663,8196,10467,11331,6751,581,ITH,ITH3,5,Veneto,Veneto,4905854,5797223,118.17,0.38
2471,2021-04-17,VEN,22448,9098,13350,14373,7277,798,ITH,ITH3,5,Veneto,Veneto,4905854,5819671,118.63,0.46
2472,2021-01-07,VEN,8359,2317,6042,8358,0,1,ITH,ITH3,5,Veneto,Veneto,4905854,5828030,118.8,0.17
2473,2021-06-13,VEN,37336,19254,18082,29315,6956,1065,ITH,ITH3,5,Veneto,Veneto,4905854,5865366,119.56,0.76
2474,2021-01-21,VEN,2294,719,1575,21,2273,0,ITH,ITH3,5,Veneto,Veneto,4905854,5867660,119.61,0.05
2475,2021-03-05,VEN,13337,5019,8318,9222,3671,444,ITH,ITH3,5,Veneto,Veneto,4905854,5880997,119.88,0.27
2476,2021-06-29,PAT,6419,3236,3183,2800,3532,87,ITH,ITH2,4,Provincia Autonoma Trento,P.A. Trento,541380,6419,1.19,1.19
2477,2021-06-12,PAT,5425,2716,2709,436,4941,48,ITH,ITH2,4,Provincia Autonoma Trento,P.A. Trento,541380,11844,2.19,1.0
2478,2021-03-21,PAT,136,74,62,132,0,4,ITH,ITH2,4,Provincia Autonoma Trento,P.A. Trento,541380,11980,2.21,0.03
2479,2021-05-24,PAT,4487,2075,2412,1268,3105,114,ITH,ITH2,4,Provincia Autonoma Trento,P.A. Trento,541380,16467,3.04,0.83
2480,2021-04-09,PAT,2798,1190,1608,1521,1209,68,ITH,ITH2,4,Provincia Autonoma Trento,P.A. Trento,541380,19265,3.56,0.52
2481,2021-02-11,PAT,1171,377,794,803,367,1,ITH,ITH2,4,Provincia Autonoma Trento,P.A. Trento,541380,20436,3.77,0.22
2482,2021-07-18,PAT,463,242,221,119,339,5,ITH,ITH2,4,Provincia Autonoma Trento,P.A. Trento,541380,20899,3.86,0.09
2483,2021-02-25,PAT,1651,648,1003,1196,445,10,ITH,ITH2,4,Provincia Autonoma Trento,P.A. Trento,541380,22550,4.17,0.3
2484,2020-12-30,PAT,7,3,4,7,0,0,ITH,ITH2,4,Provincia Autonoma Trento,P.A. Trento,541380,22557,4.17,0.0
2485,2021-06-05,PAT,4126,1938,2188,688,3361,77,ITH,ITH2,4,Provincia Autonoma Trento,P.A. Trento,541380,26683,4.93,0.76
2486,2021-07-13,PAT,3831,1949,1882,1777,1930,124,ITH,ITH2,4,Provincia Autonoma Trento,P.A. Trento,541380,30514,5.64,0.71
2487,2021-04-21,PAT,2939,1370,1569,2734,51,154,ITH,ITH2,4,Provincia Autonoma Trento,P.A. Trento,541380,33453,6.18,0.54
2488,2021-01-28,PAT,553,156,397,51,502,0,ITH,ITH2,4,Provincia Autonoma Trento,P.A. Trento,541380,34006,6.28,0.1
2489,2021-01-11,PAT,764,234,530,764,0,0,ITH,ITH2,4,Provincia Autonoma Trento,P.A. Trento,541380,34770,6.42,0.14
2490,2021-02-16,PAT,675,248,427,659,5,11,ITH,ITH2,4,Provincia Autonoma Trento,P.A. Trento,541380,35445,6.55,0.12
2491,2021-01-23,PAT,584,338,246,389,194,1,ITH,ITH2,4,Provincia Autonoma Trento,P.A. Trento,541380,36029,6.66,0.11
2492,2021-05-03,PAT,4310,2223,2087,3850,157,303,ITH,ITH2,4,Provincia Autonoma Trento,P.A. Trento,541380,40339,7.45,0.8
2493,2021-07-01,PAT,7137,3731,3406,3594,3358,185,ITH,ITH2,4,Provincia Autonoma Trento,P.A. Trento,541380,47476,8.77,1.32
2494,2021-05-05,PAT,5044,2607,2437,4428,305,311,ITH,ITH2,4,Provincia Autonoma Trento,P.A. Trento,541380,52520,9.7,0.93
2495,2021-03-09,PAT,1615,605,1010,928,653,34,ITH,ITH2,4,Provincia Autonoma Trento,P.A. Trento,541380,54135,10.0,0.3
2496,2021-06-17,PAT,6740,3555,3185,2046,4530,164,ITH,ITH2,4,Provincia Autonoma Trento,P.A. Trento,541380,60875,11.24,1.24
2497,2021-03-14,PAT,109,66,43,19,88,2,ITH,ITH2,4,Provincia Autonoma Trento,P.A. Trento,541380,60984,11.26,0.02
2498,2021-07-27,PAT,4800,2539,2261,1754,2942,104,ITH,ITH2,4,Provincia Autonoma Trento,P.A. Trento,541380,65784,12.15,0.89
2499,2021-05-31,PAT,4802,2211,2591,1609,3084,109,ITH,ITH2,4,Provincia Autonoma Trento,P.A. Trento,541380,70586,13.04,0.89
2500,2021-07-20,PAT,4819,2605,2214,1750,2931,138,ITH,ITH2,4,Provincia Autonoma Trento,P.A. Trento,541380,75405,13.93,0.89
2501,2021-02-06,PAT,582,302,280,439,143,0,ITH,ITH2,4,Provincia Autonoma Trento,P.A. Trento,541380,75987,14.04,0.11
2502,2021-02-23,PAT,1127,403,724,888,217,22,ITH,ITH2,4,Provincia Autonoma Trento,P.A. Trento,541380,77114,14.24,0.21
2503,2021-05-17,PAT,4354,2156,2198,3753,362,239,ITH,ITH2,4,Provincia Autonoma Trento,P.A. Trento,541380,81468,15.05,0.8
2504,2021-08-08,PAT,632,336,296,240,384,8,ITH,ITH2,4,Provincia Autonoma Trento,P.A. Trento,541380,82100,15.16,0.12
2505,2021-03-26,PAT,3270,1278,1992,2515,611,144,ITH,ITH2,4,Provincia Autonoma Trento,P.A. Trento,541380,85370,15.77,0.6
2506,2021-05-22,PAT,3368,1662,1706,849,2428,91,ITH,ITH2,4,Provincia Autonoma Trento,P.A. Trento,541380,88738,16.39,0.62
2507,2021-05-29,PAT,2439,1327,1112,786,1565,88,ITH,ITH2,4,Provincia Autonoma Trento,P.A. Trento,541380,91177,16.84,0.45
2508,2021-04-02,PAT,2884,1177,1707,2036,684,164,ITH,ITH2,4,Provincia Autonoma Trento,P.A. Trento,541380,94061,17.37,0.53
2509,2021-04-16,PAT,2905,1377,1528,2597,149,159,ITH,ITH2,4,Provincia Autonoma Trento,P.A. Trento,541380,96966,17.91,0.54
2510,2021-02-18,PAT,1427,496,931,1343,69,15,ITH,ITH2,4,Provincia Autonoma Trento,P.A. Trento,541380,98393,18.17,0.26
2511,2021-07-25,PAT,363,203,160,136,218,9,ITH,ITH2,4,Provincia Autonoma Trento,P.A. Trento,541380,98756,18.24,0.07
2512,2021-03-02,PAT,1320,445,875,911,380,29,ITH,ITH2,4,Provincia Autonoma Trento,P.A. Trento,541380,100076,18.49,0.24
2513,2021-06-10,PAT,6204,3022,3182,1813,4259,132,ITH,ITH2,4,Provincia Autonoma Trento,P.A. Trento,541380,106280,19.63,1.15
2514,2021-03-04,PAT,2387,807,1580,1555,790,42,ITH,ITH2,4,Provincia Autonoma Trento,P.A. Trento,541380,108667,20.07,0.44
2515,2021-04-23,PAT,3668,1786,1882,3431,56,181,ITH,ITH2,4,Provincia Autonoma Trento,P.A. Trento,541380,112335,20.75,0.68
2516,2021-01-30,PAT,396,136,260,155,241,0,ITH,ITH2,4,Provincia Autonoma Trento,P.A. Trento,541380,112731,20.82,0.07
2517,2021-05-10,PAT,3267,1678,1589,2534,516,217,ITH,ITH2,4,Provincia Autonoma Trento,P.A. Trento,541380,115998,21.43,0.6
2518,2021-03-18,PAT,2335,964,1371,1222,1089,24,ITH,ITH2,4,Provincia Autonoma Trento,P.A. Trento,541380,118333,21.86,0.43
2519,2021-08-06,PAT,6443,3553,2890,2640,3686,117,ITH,ITH2,4,Provincia Autonoma Trento,P.A. Trento,541380,124776,23.05,1.19
2520,2021-01-16,PAT,322,148,174,322,0,0,ITH,ITH2,4,Provincia Autonoma Trento,P.A. Trento,541380,125098,23.11,0.06
2521,2021-04-28,PAT,4282,1989,2293,3893,139,250,ITH,ITH2,4,Provincia Autonoma Trento,P.A. Trento,541380,129380,23.9,0.79
2522,2021-04-01,PAT,2943,1250,1693,1745,1106,92,ITH,ITH2,4,Provincia Autonoma Trento,P.A. Trento,541380,132323,24.44,0.54
2523,2021-03-07,PAT,22,6,16,22,0,0,ITH,ITH2,4,Provincia Autonoma Trento,P.A. Trento,541380,132345,24.45,0.0
2524,2021-01-09,PAT,195,42,153,195,0,0,ITH,ITH2,4,Provincia Autonoma Trento,P.A. Trento,541380,132540,24.48,0.04
2525,2021-06-24,PAT,6048,3166,2882,3660,2204,184,ITH,ITH2,4,Provincia Autonoma Trento,P.A. Trento,541380,138588,25.6,1.12
2526,2021-05-12,PAT,3344,1511,1833,1963,1216,165,ITH,ITH2,4,Provincia Autonoma Trento,P.A. Trento,541380,141932,26.22,0.62
2527,2021-03-16,PAT,1405,514,891,580,792,33,ITH,ITH2,4,Provincia Autonoma Trento,P.A. Trento,541380,143337,26.48,0.26
2528,2021-05-14,PAT,5437,2611,2826,3713,1426,298,ITH,ITH2,4,Provincia Autonoma Trento,P.A. Trento,541380,148774,27.48,1.0
2529,2021-02-20,PAT,412,247,165,124,287,1,ITH,ITH2,4,Provincia Autonoma Trento,P.A. Trento,541380,149186,27.56,0.08
2530,2021-04-14,PAT,3144,1478,1666,2251,738,155,ITH,ITH2,4,Provincia Autonoma Trento,P.A. Trento,541380,152330,28.14,0.58
2531,2021-03-28,PAT,767,303,464,718,2,47,ITH,ITH2,4,Provincia Autonoma Trento,P.A. Trento,541380,153097,28.28,0.14
2532,2021-01-04,PAT,905,250,655,903,0,2,ITH,ITH2,4,Provincia Autonoma Trento,P.A. Trento,541380,154002,28.45,0.17
2533,2021-07-06,PAT,5227,2759,2468,3117,1925,185,ITH,ITH2,4,Provincia Autonoma Trento,P.A. Trento,541380,159229,29.41,0.97
2534,2021-01-18,PAT,690,168,522,631,59,0,ITH,ITH2,4,Provincia Autonoma Trento,P.A. Trento,541380,159919,29.54,0.13
2535,2021-06-19,PAT,3146,1722,1424,238,2878,30,ITH,ITH2,4,Provincia Autonoma Trento,P.A. Trento,541380,163065,30.12,0.58
2536,2021-07-08,PAT,4158,2209,1949,2512,1482,164,ITH,ITH2,4,Provincia Autonoma Trento,P.A. Trento,541380,167223,30.89,0.77
2537,2021-02-04,PAT,1012,321,691,428,583,1,ITH,ITH2,4,Provincia Autonoma Trento,P.A. Trento,541380,168235,31.08,0.19
2538,2021-04-13,PAT,2617,1089,1528,2028,509,80,ITH,ITH2,4,Provincia Autonoma Trento,P.A. Trento,541380,170852,31.56,0.48
2539,2021-01-20,PAT,308,77,231,296,12,0,ITH,ITH2,4,Provincia Autonoma Trento,P.A. Trento,541380,171160,31.62,0.06
2540,2021-01-06,PAT,43,13,30,43,0,0,ITH,ITH2,4,Provincia Autonoma Trento,P.A. Trento,541380,171203,31.62,0.01
2541,2021-08-05,PAT,6361,3479,2882,2907,3331,123,ITH,ITH2,4,Provincia Autonoma Trento,P.A. Trento,541380,177564,32.8,1.17
2542,2021-07-29,PAT,5462,2900,2562,2638,2710,114,ITH,ITH2,4,Provincia Autonoma Trento,P.A. Trento,541380,183026,33.81,1.01
2543,2021-01-27,PAT,872,310,562,114,756,2,ITH,ITH2,4,Provincia Autonoma Trento,P.A. Trento,541380,183898,33.97,0.16
2544,2021-02-13,PAT,540,335,205,172,368,0,ITH,ITH2,4,Provincia Autonoma Trento,P.A. Trento,541380,184438,34.07,0.1
2545,2021-05-07,PAT,6083,3129,2954,4857,851,375,ITH,ITH2,4,Provincia Autonoma Trento,P.A. Trento,541380,190521,35.19,1.12
2546,2021-06-09,PAT,6315,3116,3199,2117,4119,79,ITH,ITH2,4,Provincia Autonoma Trento,P.A. Trento,541380,196836,36.36,1.17
2547,2021-06-26,PAT,1433,751,682,688,725,20,ITH,ITH2,4,Provincia Autonoma Trento,P.A. Trento,541380,198269,36.62,0.26
2548,2021-06-28,PAT,6939,3592,3347,3003,3864,72,ITH,ITH2,4,Provincia Autonoma Trento,P.A. Trento,541380,205208,37.9,1.28
2549,2021-04-06,PAT,2288,969,1319,1459,770,59,ITH,ITH2,4,Provincia Autonoma Trento,P.A. Trento,541380,207496,38.33,0.42
2550,2021-07-15,PAT,4292,2295,1997,1796,2359,137,ITH,ITH2,4,Provincia Autonoma Trento,P.A. Trento,541380,211788,39.12,0.79
2551,2021-01-13,PAT,444,131,313,444,0,0,ITH,ITH2,4,Provincia Autonoma Trento,P.A. Trento,541380,212232,39.2,0.08
2552,2021-07-10,PAT,1096,563,533,150,919,27,ITH,ITH2,4,Provincia Autonoma Trento,P.A. Trento,541380,213328,39.4,0.2
2553,2021-03-23,PAT,2474,959,1515,1627,747,100,ITH,ITH2,4,Provincia Autonoma Trento,P.A. Trento,541380,215802,39.86,0.46
2554,2021-05-28,PAT,3803,1766,2037,1400,2263,140,ITH,ITH2,4,Provincia Autonoma Trento,P.A. Trento,541380,219605,40.56,0.7
2555,2021-01-25,PAT,849,231,618,25,824,0,ITH,ITH2,4,Provincia Autonoma Trento,P.A. Trento,541380,220454,40.72,0.16
2556,2021-03-25,PAT,2913,1127,1786,1746,1058,109,ITH,ITH2,4,Provincia Autonoma Trento,P.A. Trento,541380,223367,41.26,0.54
2557,2021-07-03,PAT,1267,680,587,77,1184,6,ITH,ITH2,4,Provincia Autonoma Trento,P.A. Trento,541380,224634,41.49,0.23
2558,2021-02-08,PAT,1193,333,860,346,847,0,ITH,ITH2,4,Provincia Autonoma Trento,P.A. Trento,541380,225827,41.71,0.22
2559,2021-07-17,PAT,1096,535,561,272,806,18,ITH,ITH2,4,Provincia Autonoma Trento,P.A. Trento,541380,226923,41.92,0.2
2560,2021-05-21,PAT,5204,2502,2702,3137,1796,271,ITH,ITH2,4,Provincia Autonoma Trento,P.A. Trento,541380,232127,42.88,0.96
2561,2021-04-30,PAT,4987,2432,2555,4446,162,379,ITH,ITH2,4,Provincia Autonoma Trento,P.A. Trento,541380,237114,43.8,0.92
2562,2021-05-19,PAT,5189,2512,2677,3666,1272,251,ITH,ITH2,4,Provincia Autonoma Trento,P.A. Trento,541380,242303,44.76,0.96
2563,2021-06-02,PAT,2877,1379,1498,899,1913,65,ITH,ITH2,4,Provincia Autonoma Trento,P.A. Trento,541380,245180,45.29,0.53
2564,2021-04-20,PAT,2908,1387,1521,2690,37,181,ITH,ITH2,4,Provincia Autonoma Trento,P.A. Trento,541380,248088,45.83,0.54
2565,2021-05-09,PAT,2354,1225,1129,1873,347,134,ITH,ITH2,4,Provincia Autonoma Trento,P.A. Trento,541380,250442,46.26,0.43
2566,2021-02-15,PAT,547,193,354,419,126,2,ITH,ITH2,4,Provincia Autonoma Trento,P.A. Trento,541380,250989,46.36,0.1
2567,2021-05-26,PAT,3956,1864,2092,1116,2718,122,ITH,ITH2,4,Provincia Autonoma Trento,P.A. Trento,541380,254945,47.09,0.73
2568,2021-08-02,PAT,5359,2843,2516,1602,3697,60,ITH,ITH2,4,Provincia Autonoma Trento,P.A. Trento,541380,260304,48.08,0.99
2569,2021-06-16,PAT,6309,3404,2905,1988,4198,123,ITH,ITH2,4,Provincia Autonoma Trento,P.A. Trento,541380,266613,49.25,1.17
2570,2021-03-15,PAT,1453,573,880,930,469,54,ITH,ITH2,4,Provincia Autonoma Trento,P.A. Trento,541380,268066,49.52,0.27
2571,2021-01-17,PAT,255,199,56,255,0,0,ITH,ITH2,4,Provincia Autonoma Trento,P.A. Trento,541380,268321,49.56,0.05
2572,2021-06-23,PAT,6683,3538,3145,4621,1869,193,ITH,ITH2,4,Provincia Autonoma Trento,P.A. Trento,541380,275004,50.8,1.23
2573,2021-05-11,PAT,3740,1767,1973,2643,862,235,ITH,ITH2,4,Provincia Autonoma Trento,P.A. Trento,541380,278744,51.49,0.69
2574,2021-04-27,PAT,3951,1900,2051,3600,70,281,ITH,ITH2,4,Provincia Autonoma Trento,P.A. Trento,541380,282695,52.22,0.73
2575,2021-02-12,PAT,1032,346,686,591,439,2,ITH,ITH2,4,Provincia Autonoma Trento,P.A. Trento,541380,283727,52.41,0.19
2576,2021-03-01,PAT,1251,460,791,927,300,24,ITH,ITH2,4,Provincia Autonoma Trento,P.A. Trento,541380,284978,52.64,0.23
2577,2021-03-20,PAT,888,409,479,663,211,14,ITH,ITH2,4,Provincia Autonoma Trento,P.A. Trento,541380,285866,52.8,0.16
2578,2021-02-01,PAT,1275,356,919,98,1177,0,ITH,ITH2,4,Provincia Autonoma Trento,P.A. Trento,541380,287141,53.04,0.24
2579,2021-02-03,PAT,874,325,549,416,458,0,ITH,ITH2,4,Provincia Autonoma Trento,P.A. Trento,541380,288015,53.2,0.16
2580,2021-07-19,PAT,4798,2523,2275,1455,3221,122,ITH,ITH2,4,Provincia Autonoma Trento,P.A. Trento,541380,292813,54.09,0.89
2581,2021-05-23,PAT,1995,1015,980,432,1535,28,ITH,ITH2,4,Provincia Autonoma Trento,P.A. Trento,541380,294808,54.45,0.37
2582,2021-04-10,PAT,2875,1351,1524,1993,803,79,ITH,ITH2,4,Provincia Autonoma Trento,P.A. Trento,541380,297683,54.99,0.53
2583,2021-03-30,PAT,2412,986,1426,1670,641,101,ITH,ITH2,4,Provincia Autonoma Trento,P.A. Trento,541380,300095,55.43,0.45
2584,2021-06-06,PAT,2267,1079,1188,431,1815,21,ITH,ITH2,4,Provincia Autonoma Trento,P.A. Trento,541380,302362,55.85,0.42
2585,2021-07-24,PAT,993,547,446,526,444,23,ITH,ITH2,4,Provincia Autonoma Trento,P.A. Trento,541380,303355,56.03,0.18
2586,2021-05-02,PAT,3558,1978,1580,3297,39,222,ITH,ITH2,4,Provincia Autonoma Trento,P.A. Trento,541380,306913,56.69,0.66
2587,2021-08-10,PAT,5876,3139,2737,2878,2823,175,ITH,ITH2,4,Provincia Autonoma Trento,P.A. Trento,541380,312789,57.78,1.09
2588,2021-01-10,PAT,87,20,67,87,0,0,ITH,ITH2,4,Provincia Autonoma Trento,P.A. Trento,541380,312876,57.79,0.02
2589,2021-03-11,PAT,2598,969,1629,1502,1037,59,ITH,ITH2,4,Provincia Autonoma Trento,P.A. Trento,541380,315474,58.27,0.48
2590,2021-07-22,PAT,4767,2581,2186,1901,2735,131,ITH,ITH2,4,Provincia Autonoma Trento,P.A. Trento,541380,320241,59.15,0.88
2591,2021-07-07,PAT,4520,2427,2093,2919,1403,198,ITH,ITH2,4,Provincia Autonoma Trento,P.A. Trento,541380,324761,59.99,0.83
2592,2021-01-03,PAT,502,166,336,502,0,0,ITH,ITH2,4,Provincia Autonoma Trento,P.A. Trento,541380,325263,60.08,0.09
2593,2021-05-04,PAT,4569,2489,2080,4168,97,304,ITH,ITH2,4,Provincia Autonoma Trento,P.A. Trento,541380,329832,60.92,0.84
2594,2021-03-08,PAT,1425,439,986,1041,354,30,ITH,ITH2,4,Provincia Autonoma Trento,P.A. Trento,541380,331257,61.19,0.26
2595,2021-03-22,PAT,2345,995,1350,1403,884,58,ITH,ITH2,4,Provincia Autonoma Trento,P.A. Trento,541380,333602,61.62,0.43
2596,2021-01-24,PAT,562,285,277,226,336,0,ITH,ITH2,4,Provincia Autonoma Trento,P.A. Trento,541380,334164,61.72,0.1
2597,2021-06-30,PAT,6850,3520,3330,2716,4049,85,ITH,ITH2,4,Provincia Autonoma Trento,P.A. Trento,541380,341014,62.99,1.27
2598,2021-03-03,PAT,1671,628,1043,1115,519,37,ITH,ITH2,4,Provincia Autonoma Trento,P.A. Trento,541380,342685,63.3,0.31
2599,2021-06-11,PAT,7295,3472,3823,1493,5700,102,ITH,ITH2,4,Provincia Autonoma Trento,P.A. Trento,541380,349980,64.65,1.35
2600,2021-06-13,PAT,3732,2059,1673,280,3429,23,ITH,ITH2,4,Provincia Autonoma Trento,P.A. Trento,541380,353712,65.34,0.69
2601,2020-12-27,PAT,107,43,64,107,0,0,ITH,ITH2,4,Provincia Autonoma Trento,P.A. Trento,541380,353819,65.36,0.02
2602,2021-07-12,PAT,4261,2147,2114,2045,2035,181,ITH,ITH2,4,Provincia Autonoma Trento,P.A. Trento,541380,358080,66.14,0.79
2603,2021-02-17,PAT,1166,448,718,1050,111,5,ITH,ITH2,4,Provincia Autonoma Trento,P.A. Trento,541380,359246,66.36,0.22
2604,2021-05-30,PAT,1777,876,901,865,843,69,ITH,ITH2,4,Provincia Autonoma Trento,P.A. Trento,541380,361023,66.69,0.33
2605,2021-04-03,PAT,1175,484,691,933,175,67,ITH,ITH2,4,Provincia Autonoma Trento,P.A. Trento,541380,362198,66.9,0.22
2606,2021-02-10,PAT,871,294,577,512,358,1,ITH,ITH2,4,Provincia Autonoma Trento,P.A. Trento,541380,363069,67.06,0.16
2607,2021-07-26,PAT,3885,2047,1838,837,2987,61,ITH,ITH2,4,Provincia Autonoma Trento,P.A. Trento,541380,366954,67.78,0.72
2608,2021-01-29,PAT,1409,358,1051,56,1353,0,ITH,ITH2,4,Provincia Autonoma Trento,P.A. Trento,541380,368363,68.04,0.26
2609,2021-07-14,PAT,4174,2169,2005,1714,2349,111,ITH,ITH2,4,Provincia Autonoma Trento,P.A. Trento,541380,372537,68.81,0.77
2610,2021-04-22,PAT,3173,1480,1693,2950,46,177,ITH,ITH2,4,Provincia Autonoma Trento,P.A. Trento,541380,375710,69.4,0.59
2611,2021-07-31,PAT,1486,854,632,1067,382,37,ITH,ITH2,4,Provincia Autonoma Trento,P.A. Trento,541380,377196,69.67,0.27
2612,2021-04-07,PAT,2648,1025,1623,1575,952,121,ITH,ITH2,4,Provincia Autonoma Trento,P.A. Trento,541380,379844,70.16,0.49
2613,2021-07-16,PAT,4592,2367,2225,1742,2700,150,ITH,ITH2,4,Provincia Autonoma Trento,P.A. Trento,541380,384436,71.01,0.85
2614,2021-03-13,PAT,965,496,469,846,48,71,ITH,ITH2,4,Provincia Autonoma Trento,P.A. Trento,541380,385401,71.19,0.18
2615,2021-07-05,PAT,5422,2846,2576,3788,1389,245,ITH,ITH2,4,Provincia Autonoma Trento,P.A. Trento,541380,390823,72.19,1.0
2616,2021-06-21,PAT,6255,3386,2869,3650,2424,181,ITH,ITH2,4,Provincia Autonoma Trento,P.A. Trento,541380,397078,73.35,1.16
2617,2021-04-29,PAT,4696,2263,2433,4172,214,310,ITH,ITH2,4,Provincia Autonoma Trento,P.A. Trento,541380,401774,74.21,0.87
2618,2021-07-21,PAT,4699,2516,2183,1527,3080,92,ITH,ITH2,4,Provincia Autonoma Trento,P.A. Trento,541380,406473,75.08,0.87
2619,2021-08-09,PAT,5321,2839,2482,2268,2919,134,ITH,ITH2,4,Provincia Autonoma Trento,P.A. Trento,541380,411794,76.06,0.98
2620,2021-02-22,PAT,755,262,493,663,86,6,ITH,ITH2,4,Provincia Autonoma Trento,P.A. Trento,541380,412549,76.2,0.14
2621,2021-05-18,PAT,4319,2046,2273,3170,867,282,ITH,ITH2,4,Provincia Autonoma Trento,P.A. Trento,541380,416868,77.0,0.8
2622,2021-01-31,PAT,77,16,61,1,76,0,ITH,ITH2,4,Provincia Autonoma Trento,P.A. Trento,541380,416945,77.02,0.01
2623,2021-07-30,PAT,5819,3087,2732,2285,3436,98,ITH,ITH2,4,Provincia Autonoma Trento,P.A. Trento,541380,422764,78.09,1.07
2624,2021-05-25,PAT,4863,2313,2550,1743,2972,148,ITH,ITH2,4,Provincia Autonoma Trento,P.A. Trento,541380,427627,78.99,0.9
2625,2021-05-08,PAT,3194,1742,1452,2572,426,196,ITH,ITH2,4,Provincia Autonoma Trento,P.A. Trento,541380,430821,79.58,0.59
2626,2021-04-24,PAT,3578,1713,1865,3356,16,206,ITH,ITH2,4,Provincia Autonoma Trento,P.A. Trento,541380,434399,80.24,0.66
2627,2021-02-26,PAT,1256,444,812,933,298,25,ITH,ITH2,4,Provincia Autonoma Trento,P.A. Trento,541380,435655,80.47,0.23
2628,2021-01-14,PAT,731,218,513,729,0,2,ITH,ITH2,4,Provincia Autonoma Trento,P.A. Trento,541380,436386,80.61,0.14
2629,2021-02-28,PAT,246,122,124,236,0,10,ITH,ITH2,4,Provincia Autonoma Trento,P.A. Trento,541380,436632,80.65,0.05
2630,2021-08-04,PAT,6189,3301,2888,2560,3496,133,ITH,ITH2,4,Provincia Autonoma Trento,P.A. Trento,541380,442821,81.79,1.14
2631,2021-06-08,PAT,6040,2916,3124,1791,4130,119,ITH,ITH2,4,Provincia Autonoma Trento,P.A. Trento,541380,448861,82.91,1.12
2632,2021-04-26,PAT,2676,1260,1416,2412,96,168,ITH,ITH2,4,Provincia Autonoma Trento,P.A. Trento,541380,451537,83.4,0.49
2633,2021-04-08,PAT,3168,1330,1838,1946,1129,93,ITH,ITH2,4,Provincia Autonoma Trento,P.A. Trento,541380,454705,83.99,0.59
2634,2020-12-31,PAT,1700,480,1220,1700,0,0,ITH,ITH2,4,Provincia Autonoma Trento,P.A. Trento,541380,456405,84.3,0.31
2635,2021-06-22,PAT,6381,3480,2901,3629,2567,185,ITH,ITH2,4,Provincia Autonoma Trento,P.A. Trento,541380,462786,85.48,1.18
2636,2021-08-07,PAT,1617,927,690,818,764,35,ITH,ITH2,4,Provincia Autonoma Trento,P.A. Trento,541380,464403,85.78,0.3
2637,2021-01-22,PAT,1748,459,1289,350,1396,2,ITH,ITH2,4,Provincia Autonoma Trento,P.A. Trento,541380,466151,86.1,0.32
2638,2021-02-05,PAT,833,286,547,284,549,0,ITH,ITH2,4,Provincia Autonoma Trento,P.A. Trento,541380,466984,86.26,0.15
2639,2021-05-16,PAT,1358,756,602,1042,248,68,ITH,ITH2,4,Provincia Autonoma Trento,P.A. Trento,541380,468342,86.51,0.25
2640,2021-01-05,PAT,759,262,497,759,0,0,ITH,ITH2,4,Provincia Autonoma Trento,P.A. Trento,541380,469101,86.65,0.14
2641,2021-04-15,PAT,3232,1457,1775,2831,155,246,ITH,ITH2,4,Provincia Autonoma Trento,P.A. Trento,541380,472333,87.25,0.6
2642,2021-06-27,PAT,1368,735,633,398,961,9,ITH,ITH2,4,Provincia Autonoma Trento,P.A. Trento,541380,473701,87.5,0.25
2643,2021-01-12,PAT,541,173,368,540,0,1,ITH,ITH2,4,Provincia Autonoma Trento,P.A. Trento,541380,474242,87.6,0.1
2644,2021-03-19,PAT,2467,925,1542,1503,881,83,ITH,ITH2,4,Provincia Autonoma Trento,P.A. Trento,541380,476709,88.05,0.46
2645,2021-03-12,PAT,2599,991,1608,1710,814,75,ITH,ITH2,4,Provincia Autonoma Trento,P.A. Trento,541380,479308,88.53,0.48
2646,2021-06-20,PAT,1899,1050,849,30,1864,5,ITH,ITH2,4,Provincia Autonoma Trento,P.A. Trento,541380,481207,88.89,0.35
2647,2021-01-02,PAT,522,149,373,522,0,0,ITH,ITH2,4,Provincia Autonoma Trento,P.A. Trento,541380,481729,88.98,0.1
2648,2021-03-29,PAT,2560,1008,1552,1691,742,127,ITH,ITH2,4,Provincia Autonoma Trento,P.A. Trento,541380,484289,89.45,0.47
2649,2021-04-12,PAT,3155,1455,1700,2527,503,125,ITH,ITH2,4,Provincia Autonoma Trento,P.A. Trento,541380,487444,90.04,0.58
2650,2021-07-04,PAT,225,125,100,66,157,2,ITH,ITH2,4,Provincia Autonoma Trento,P.A. Trento,541380,487669,90.08,0.04
2651,2021-07-11,PAT,1034,565,469,131,894,9,ITH,ITH2,4,Provincia Autonoma Trento,P.A. Trento,541380,488703,90.27,0.19
2652,2021-02-14,PAT,250,189,61,11,239,0,ITH,ITH2,4,Provincia Autonoma Trento,P.A. Trento,541380,488953,90.32,0.05
2653,2021-05-27,PAT,4374,2031,2343,1166,3077,131,ITH,ITH2,4,Provincia Autonoma Trento,P.A. Trento,541380,493327,91.12,0.81
2654,2021-04-05,PAT,35,17,18,30,2,3,ITH,ITH2,4,Provincia Autonoma Trento,P.A. Trento,541380,493362,91.13,0.01
2655,2021-02-19,PAT,943,366,577,846,64,33,ITH,ITH2,4,Provincia Autonoma Trento,P.A. Trento,541380,494305,91.3,0.17
2656,2021-08-11,PAT,4079,2176,1903,1691,2281,107,ITH,ITH2,4,Provincia Autonoma Trento,P.A. Trento,541380,498384,92.06,0.75
2657,2021-06-18,PAT,7059,3753,3306,1785,5185,89,ITH,ITH2,4,Provincia Autonoma Trento,P.A. Trento,541380,505443,93.36,1.3
2658,2021-03-27,PAT,1671,746,925,1324,263,84,ITH,ITH2,4,Provincia Autonoma Trento,P.A. Trento,541380,507114,93.67,0.31
2659,2021-06-04,PAT,5917,2647,3270,1734,4055,128,ITH,ITH2,4,Provincia Autonoma Trento,P.A. Trento,541380,513031,94.76,1.09
2660,2021-02-24,PAT,1369,539,830,942,404,23,ITH,ITH2,4,Provincia Autonoma Trento,P.A. Trento,541380,514400,95.02,0.25
2661,2021-06-03,PAT,4842,2278,2564,1237,3513,92,ITH,ITH2,4,Provincia Autonoma Trento,P.A. Trento,541380,519242,95.91,0.89
2662,2021-03-05,PAT,2302,735,1567,1640,568,94,ITH,ITH2,4,Provincia Autonoma Trento,P.A. Trento,541380,521544,96.34,0.43
2663,2021-01-07,PAT,1301,328,973,1298,0,3,ITH,ITH2,4,Provincia Autonoma Trento,P.A. Trento,541380,522845,96.58,0.24
2664,2021-04-17,PAT,2250,1146,1104,2087,57,106,ITH,ITH2,4,Provincia Autonoma Trento,P.A. Trento,541380,525095,96.99,0.42
2665,2021-04-19,PAT,2642,1244,1398,2433,23,186,ITH,ITH2,4,Provincia Autonoma Trento,P.A. Trento,541380,527737,97.48,0.49
2666,2021-07-28,PAT,4845,2654,2191,2160,2562,123,ITH,ITH2,4,Provincia Autonoma Trento,P.A. Trento,541380,532582,98.37,0.89
2667,2021-06-15,PAT,6325,3337,2988,1633,4561,131,ITH,ITH2,4,Provincia Autonoma Trento,P.A. Trento,541380,538907,99.54,1.17
2668,2021-01-21,PAT,376,104,272,247,129,0,ITH,ITH2,4,Provincia Autonoma Trento,P.A. Trento,541380,539283,99.61,0.07
2669,2021-05-01,PAT,4886,2484,2402,4553,37,296,ITH,ITH2,4,Provincia Autonoma Trento,P.A. Trento,541380,544169,100.52,0.9
2670,2021-02-21,PAT,158,95,63,44,114,0,ITH,ITH2,4,Provincia Autonoma Trento,P.A. Trento,541380,544327,100.54,0.03
2671,2021-05-15,PAT,1603,832,771,649,913,41,ITH,ITH2,4,Provincia Autonoma Trento,P.A. Trento,541380,545930,100.84,0.3
2672,2021-06-01,PAT,4101,1924,2177,1080,2909,112,ITH,ITH2,4,Provincia Autonoma Trento,P.A. Trento,541380,550031,101.6,0.76
2673,2021-01-19,PAT,434,89,345,434,0,0,ITH,ITH2,4,Provincia Autonoma Trento,P.A. Trento,541380,550465,101.68,0.08
2674,2021-07-23,PAT,4742,2431,2311,1669,2949,124,ITH,ITH2,4,Provincia Autonoma Trento,P.A. Trento,541380,555207,102.55,0.88
2675,2021-03-10,PAT,2476,971,1505,1472,941,63,ITH,ITH2,4,Provincia Autonoma Trento,P.A. Trento,541380,557683,103.01,0.46
2676,2021-01-08,PAT,1515,335,1180,1514,0,1,ITH,ITH2,4,Provincia Autonoma Trento,P.A. Trento,541380,559198,103.29,0.28
2677,2021-06-14,PAT,5805,3004,2801,2041,3653,111,ITH,ITH2,4,Provincia Autonoma Trento,P.A. Trento,541380,565003,104.36,1.07
2678,2021-04-18,PAT,1864,849,1015,1797,9,58,ITH,ITH2,4,Provincia Autonoma Trento,P.A. Trento,541380,566867,104.71,0.34
2679,2021-03-06,PAT,806,285,521,613,152,41,ITH,ITH2,4,Provincia Autonoma Trento,P.A. Trento,541380,567673,104.86,0.15
2680,2021-04-11,PAT,2387,1159,1228,2201,98,88,ITH,ITH2,4,Provincia Autonoma Trento,P.A. Trento,541380,570060,105.3,0.44
2681,2021-02-27,PAT,1052,467,585,605,427,20,ITH,ITH2,4,Provincia Autonoma Trento,P.A. Trento,541380,571112,105.49,0.19
2682,2021-08-03,PAT,6172,3333,2839,2472,3586,114,ITH,ITH2,4,Provincia Autonoma Trento,P.A. Trento,541380,577284,106.63,1.14
2683,2021-01-01,PAT,222,51,171,222,0,0,ITH,ITH2,4,Provincia Autonoma Trento,P.A. Trento,541380,577506,106.67,0.04
2684,2021-06-07,PAT,5873,2921,2952,2680,3020,173,ITH,ITH2,4,Provincia Autonoma Trento,P.A. Trento,541380,583379,107.76,1.08
2685,2021-04-25,PAT,2002,952,1050,1877,7,118,ITH,ITH2,4,Provincia Autonoma Trento,P.A. Trento,541380,585381,108.13,0.37
2686,2021-06-25,PAT,7769,4144,3625,4224,3438,107,ITH,ITH2,4,Provincia Autonoma Trento,P.A. Trento,541380,593150,109.56,1.44
2687,2021-07-02,PAT,7399,4022,3377,3581,3585,233,ITH,ITH2,4,Provincia Autonoma Trento,P.A. Trento,541380,600549,110.93,1.37
2688,2021-01-15,PAT,628,149,479,627,0,1,ITH,ITH2,4,Provincia Autonoma Trento,P.A. Trento,541380,601177,111.05,0.12
2689,2021-05-20,PAT,5113,2405,2708,3148,1683,282,ITH,ITH2,4,Provincia Autonoma Trento,P.A. Trento,541380,606290,111.99,0.94
2690,2021-03-24,PAT,2414,963,1451,1469,827,118,ITH,ITH2,4,Provincia Autonoma Trento,P.A. Trento,541380,608704,112.44,0.45
2691,2021-02-09,PAT,952,303,649,448,503,1,ITH,ITH2,4,Provincia Autonoma Trento,P.A. Trento,541380,609656,112.61,0.18
2692,2021-03-17,PAT,2130,812,1318,1131,906,93,ITH,ITH2,4,Provincia Autonoma Trento,P.A. Trento,541380,611786,113.0,0.39
2693,2021-02-02,PAT,941,253,688,192,749,0,ITH,ITH2,4,Provincia Autonoma Trento,P.A. Trento,541380,612727,113.18,0.17
2694,2021-07-09,PAT,5139,2726,2413,3043,1880,216,ITH,ITH2,4,Provincia Autonoma Trento,P.A. Trento,541380,617866,114.13,0.95
2695,2021-05-13,PAT,3453,1603,1850,2103,1125,225,ITH,ITH2,4,Provincia Autonoma Trento,P.A. Trento,541380,621319,114.77,0.64
2696,2021-03-31,PAT,2621,1001,1620,1655,868,98,ITH,ITH2,4,Provincia Autonoma Trento,P.A. Trento,541380,623940,115.25,0.48
2697,2021-01-26,PAT,576,173,403,27,549,0,ITH,ITH2,4,Provincia Autonoma Trento,P.A. Trento,541380,624516,115.36,0.11
2698,2021-05-06,PAT,5610,2790,2820,4442,792,376,ITH,ITH2,4,Provincia Autonoma Trento,P.A. Trento,541380,630126,116.39,1.04
2699,2021-04-05,MAR,5703,2367,3336,4358,1269,76,ITI,ITI3,11,Marche,Marche,1525271,5703,0.37,0.37
2700,2021-06-27,MAR,9948,4819,5129,4487,5290,171,ITI,ITI3,11,Marche,Marche,1525271,15651,1.03,0.65
2701,2021-03-19,MAR,3881,1621,2260,325,3544,12,ITI,ITI3,11,Marche,Marche,1525271,19532,1.28,0.25
2702,2021-03-17,MAR,3476,1525,1951,105,3369,2,ITI,ITI3,11,Marche,Marche,1525271,23008,1.51,0.23
2703,2021-01-21,MAR,920,262,658,575,328,17,ITI,ITI3,11,Marche,Marche,1525271,23928,1.57,0.06
2704,2021-05-01,MAR,9321,3924,5397,3500,5745,76,ITI,ITI3,11,Marche,Marche,1525271,33249,2.18,0.61
2705,2021-03-05,MAR,6228,2876,3352,4694,1469,65,ITI,ITI3,11,Marche,Marche,1525271,39477,2.59,0.41
2706,2021-01-26,MAR,2022,747,1275,77,1936,9,ITI,ITI3,11,Marche,Marche,1525271,41499,2.72,0.13
2707,2021-07-11,MAR,10398,5220,5178,1606,8656,136,ITI,ITI3,11,Marche,Marche,1525271,51897,3.4,0.68
2708,2021-04-19,MAR,9605,4500,5105,7901,1583,121,ITI,ITI3,11,Marche,Marche,1525271,61502,4.03,0.63
2709,2021-07-28,MAR,14196,7369,6827,3251,10714,231,ITI,ITI3,11,Marche,Marche,1525271,75698,4.96,0.93
2710,2021-05-20,MAR,12684,5961,6723,7537,4896,251,ITI,ITI3,11,Marche,Marche,1525271,88382,5.79,0.83
2711,2021-02-07,MAR,1873,736,1137,332,1529,12,ITI,ITI3,11,Marche,Marche,1525271,90255,5.92,0.12
2712,2021-07-23,MAR,15540,8279,7261,2530,12786,224,ITI,ITI3,11,Marche,Marche,1525271,105795,6.94,1.02
2713,2021-05-27,MAR,13734,6819,6915,9181,4301,252,ITI,ITI3,11,Marche,Marche,1525271,119529,7.84,0.9
2714,2021-03-31,MAR,7374,3087,4287,4267,3023,84,ITI,ITI3,11,Marche,Marche,1525271,126903,8.32,0.48
2715,2021-07-09,MAR,14900,7501,7399,2556,12130,214,ITI,ITI3,11,Marche,Marche,1525271,141803,9.3,0.98
2716,2021-08-11,MAR,6016,3292,2724,2430,3438,148,ITI,ITI3,11,Marche,Marche,1525271,147819,9.69,0.39
2717,2021-06-15,MAR,13192,6567,6625,9823,3052,317,ITI,ITI3,11,Marche,Marche,1525271,161011,10.56,0.86
2718,2021-01-12,MAR,1233,418,815,1220,0,13,ITI,ITI3,11,Marche,Marche,1525271,162244,10.64,0.08
2719,2021-06-22,MAR,13222,6484,6738,6478,6461,283,ITI,ITI3,11,Marche,Marche,1525271,175466,11.5,0.87
2720,2021-04-26,MAR,9170,4062,5108,6023,3022,125,ITI,ITI3,11,Marche,Marche,1525271,184636,12.11,0.6
2721,2021-03-24,MAR,7081,3009,4072,3297,3716,68,ITI,ITI3,11,Marche,Marche,1525271,191717,12.57,0.46
2722,2021-06-01,MAR,12056,6158,5898,9683,2089,284,ITI,ITI3,11,Marche,Marche,1525271,203773,13.36,0.79
2723,2021-03-10,MAR,5711,2441,3270,4480,1179,52,ITI,ITI3,11,Marche,Marche,1525271,209484,13.73,0.37
2724,2021-02-21,MAR,376,141,235,363,1,12,ITI,ITI3,11,Marche,Marche,1525271,209860,13.76,0.02
2725,2021-08-06,MAR,11706,6354,5352,4148,7277,281,ITI,ITI3,11,Marche,Marche,1525271,221566,14.53,0.77
2726,2021-05-15,MAR,14115,6439,7676,7831,6039,245,ITI,ITI3,11,Marche,Marche,1525271,235681,15.45,0.93
2727,2021-02-19,MAR,2003,739,1264,1827,135,41,ITI,ITI3,11,Marche,Marche,1525271,237684,15.58,0.13
2728,2021-01-07,MAR,1814,638,1176,1797,0,17,ITI,ITI3,11,Marche,Marche,1525271,239498,15.7,0.12
2729,2021-03-12,MAR,4682,2000,2682,3347,1280,55,ITI,ITI3,11,Marche,Marche,1525271,244180,16.01,0.31
2730,2021-01-14,MAR,2016,696,1320,1992,0,24,ITI,ITI3,11,Marche,Marche,1525271,246196,16.14,0.13
2731,2021-06-20,MAR,11159,5547,5612,5992,4985,182,ITI,ITI3,11,Marche,Marche,1525271,257355,16.87,0.73
2732,2021-02-28,MAR,2836,1251,1585,2822,6,8,ITI,ITI3,11,Marche,Marche,1525271,260191,17.06,0.19
2733,2021-06-08,MAR,14098,7095,7003,11198,2609,291,ITI,ITI3,11,Marche,Marche,1525271,274289,17.98,0.92
2734,2021-02-14,MAR,739,301,438,727,0,12,ITI,ITI3,11,Marche,Marche,1525271,275028,18.03,0.05
2735,2021-05-08,MAR,12282,5480,6802,4857,7253,172,ITI,ITI3,11,Marche,Marche,1525271,287310,18.84,0.81
2736,2021-07-30,MAR,14710,7863,6847,4864,9558,288,ITI,ITI3,11,Marche,Marche,1525271,302020,19.8,0.96
2737,2021-01-09,MAR,1717,606,1111,1697,0,20,ITI,ITI3,11,Marche,Marche,1525271,303737,19.91,0.11
2738,2021-07-18,MAR,12124,6310,5814,1334,10672,118,ITI,ITI3,11,Marche,Marche,1525271,315861,20.71,0.79
2739,2021-01-31,MAR,1921,772,1149,94,1823,4,ITI,ITI3,11,Marche,Marche,1525271,317782,20.83,0.13
2740,2021-04-07,MAR,8838,3920,4918,8346,368,124,ITI,ITI3,11,Marche,Marche,1525271,326620,21.41,0.58
2741,2021-02-09,MAR,125,42,83,46,79,0,ITI,ITI3,11,Marche,Marche,1525271,326745,21.42,0.01
2742,2021-07-16,MAR,15839,8239,7600,1845,13735,259,ITI,ITI3,11,Marche,Marche,1525271,342584,22.46,1.04
2743,2021-06-12,MAR,13775,7312,6463,12105,1339,331,ITI,ITI3,11,Marche,Marche,1525271,356359,23.36,0.9
2744,2021-04-16,MAR,10090,4706,5384,9363,525,202,ITI,ITI3,11,Marche,Marche,1525271,366449,24.03,0.66
2745,2021-03-29,MAR,5894,2581,3313,3391,2455,48,ITI,ITI3,11,Marche,Marche,1525271,372343,24.41,0.39
2746,2021-06-03,MAR,14638,7483,7155,12081,2252,305,ITI,ITI3,11,Marche,Marche,1525271,386981,25.37,0.96
2747,2021-02-18,MAR,2145,786,1359,1807,288,50,ITI,ITI3,11,Marche,Marche,1525271,389126,25.51,0.14
2748,2021-05-29,MAR,12867,6237,6630,8116,4533,218,ITI,ITI3,11,Marche,Marche,1525271,401993,26.36,0.84
2749,2021-08-04,MAR,12004,6381,5623,4060,7702,242,ITI,ITI3,11,Marche,Marche,1525271,413997,27.14,0.79
2750,2021-01-23,MAR,557,190,367,119,435,3,ITI,ITI3,11,Marche,Marche,1525271,414554,27.18,0.04
2751,2021-06-29,MAR,13373,6599,6774,4931,8215,227,ITI,ITI3,11,Marche,Marche,1525271,427927,28.06,0.88
2752,2021-05-03,MAR,10411,4691,5720,4862,5412,137,ITI,ITI3,11,Marche,Marche,1525271,438338,28.74,0.68
2753,2021-01-19,MAR,233,87,146,140,90,3,ITI,ITI3,11,Marche,Marche,1525271,438571,28.75,0.02
2754,2021-02-02,MAR,1193,398,795,70,1123,0,ITI,ITI3,11,Marche,Marche,1525271,439764,28.83,0.08
2755,2021-05-13,MAR,12608,5696,6912,6828,5503,277,ITI,ITI3,11,Marche,Marche,1525271,452372,29.66,0.83
2756,2021-04-12,MAR,8571,3774,4797,7937,482,152,ITI,ITI3,11,Marche,Marche,1525271,460943,30.22,0.56
2757,2021-01-02,MAR,457,142,315,455,0,2,ITI,ITI3,11,Marche,Marche,1525271,461400,30.25,0.03
2758,2021-03-07,MAR,5181,2107,3074,4379,754,48,ITI,ITI3,11,Marche,Marche,1525271,466581,30.59,0.34
2759,2021-07-04,MAR,10896,5445,5451,3204,7530,162,ITI,ITI3,11,Marche,Marche,1525271,477477,31.3,0.71
2760,2020-12-31,MAR,392,184,208,390,0,2,ITI,ITI3,11,Marche,Marche,1525271,477869,31.33,0.03
2761,2021-02-04,MAR,2387,844,1543,107,2275,5,ITI,ITI3,11,Marche,Marche,1525271,480256,31.49,0.16
2762,2021-04-24,MAR,12169,5365,6804,7560,4464,145,ITI,ITI3,11,Marche,Marche,1525271,492425,32.28,0.8
2763,2021-02-26,MAR,3677,1523,2154,3097,476,104,ITI,ITI3,11,Marche,Marche,1525271,496102,32.53,0.24
2764,2021-05-12,MAR,10429,4691,5738,4736,5503,190,ITI,ITI3,11,Marche,Marche,1525271,506531,33.21,0.68
2765,2021-07-08,MAR,15043,7541,7502,2790,12028,225,ITI,ITI3,11,Marche,Marche,1525271,521574,34.2,0.99
2766,2021-07-01,MAR,14692,7367,7325,4659,9755,278,ITI,ITI3,11,Marche,Marche,1525271,536266,35.16,0.96
2767,2021-03-02,MAR,5002,1967,3035,4371,566,65,ITI,ITI3,11,Marche,Marche,1525271,541268,35.49,0.33
2768,2021-06-10,MAR,14932,7696,7236,12577,2013,342,ITI,ITI3,11,Marche,Marche,1525271,556200,36.47,0.98
2769,2021-05-24,MAR,10997,5192,5805,7956,2864,177,ITI,ITI3,11,Marche,Marche,1525271,567197,37.19,0.72
2770,2021-05-22,MAR,11939,5720,6219,7320,4448,171,ITI,ITI3,11,Marche,Marche,1525271,579136,37.97,0.78
2771,2021-04-02,MAR,6887,2983,3904,6038,739,110,ITI,ITI3,11,Marche,Marche,1525271,586023,38.42,0.45
2772,2021-03-16,MAR,3520,1522,1998,285,3229,6,ITI,ITI3,11,Marche,Marche,1525271,589543,38.65,0.23
2773,2021-06-24,MAR,13833,6671,7162,6189,7373,271,ITI,ITI3,11,Marche,Marche,1525271,603376,39.56,0.91
2774,2021-07-25,MAR,9349,4931,4418,1005,8247,97,ITI,ITI3,11,Marche,Marche,1525271,612725,40.17,0.61
2775,2021-01-04,MAR,1525,575,950,1513,0,12,ITI,ITI3,11,Marche,Marche,1525271,614250,40.27,0.1
2776,2021-04-14,MAR,10223,4566,5657,9662,370,191,ITI,ITI3,11,Marche,Marche,1525271,624473,40.94,0.67
2777,2020-12-30,MAR,17,5,12,17,0,0,ITI,ITI3,11,Marche,Marche,1525271,624490,40.94,0.0
2778,2021-02-16,MAR,1287,475,812,1225,30,32,ITI,ITI3,11,Marche,Marche,1525271,625777,41.03,0.08
2779,2021-02-25,MAR,3560,1464,2096,3320,181,59,ITI,ITI3,11,Marche,Marche,1525271,629337,41.26,0.23
2780,2021-08-01,MAR,7493,4047,3446,1832,5576,85,ITI,ITI3,11,Marche,Marche,1525271,636830,41.75,0.49
2781,2021-06-05,MAR,13944,7011,6933,11519,2059,366,ITI,ITI3,11,Marche,Marche,1525271,650774,42.67,0.91
2782,2021-04-23,MAR,11307,5218,6089,8090,3055,162,ITI,ITI3,11,Marche,Marche,1525271,662081,43.41,0.74
2783,2021-01-18,MAR,696,237,459,536,149,11,ITI,ITI3,11,Marche,Marche,1525271,662777,43.45,0.05
2784,2021-04-28,MAR,10932,4981,5951,6025,4736,171,ITI,ITI3,11,Marche,Marche,1525271,673709,44.17,0.72
2785,2021-03-26,MAR,6389,2626,3763,3476,2856,57,ITI,ITI3,11,Marche,Marche,1525271,680098,44.59,0.42
2786,2021-02-11,MAR,1987,657,1330,1557,389,41,ITI,ITI3,11,Marche,Marche,1525271,682085,44.72,0.13
2787,2021-05-05,MAR,11693,5321,6372,5105,6430,158,ITI,ITI3,11,Marche,Marche,1525271,693778,45.49,0.77
2788,2021-02-15,MAR,967,412,555,939,13,15,ITI,ITI3,11,Marche,Marche,1525271,694745,45.55,0.06
2789,2021-05-26,MAR,11889,5952,5937,8449,3226,214,ITI,ITI3,11,Marche,Marche,1525271,706634,46.33,0.78
2790,2021-03-30,MAR,7484,3078,4406,4579,2832,73,ITI,ITI3,11,Marche,Marche,1525271,714118,46.82,0.49
2791,2021-01-11,MAR,1180,413,767,1162,0,18,ITI,ITI3,11,Marche,Marche,1525271,715298,46.9,0.08
2792,2021-04-21,MAR,10786,4970,5816,9435,1195,156,ITI,ITI3,11,Marche,Marche,1525271,726084,47.6,0.71
2793,2021-01-28,MAR,2089,726,1363,163,1925,1,ITI,ITI3,11,Marche,Marche,1525271,728173,47.74,0.14
2794,2021-04-04,MAR,3836,1798,2038,2616,1169,51,ITI,ITI3,11,Marche,Marche,1525271,732009,47.99,0.25
2795,2021-07-13,MAR,14853,7279,7574,1458,13266,129,ITI,ITI3,11,Marche,Marche,1525271,746862,48.97,0.97
2796,2021-06-09,MAR,14280,7418,6862,12109,1869,302,ITI,ITI3,11,Marche,Marche,1525271,761142,49.9,0.94
2797,2021-06-07,MAR,13322,6590,6732,10569,2450,303,ITI,ITI3,11,Marche,Marche,1525271,774464,50.78,0.87
2798,2021-02-23,MAR,3314,1432,1882,3243,56,15,ITI,ITI3,11,Marche,Marche,1525271,777778,50.99,0.22
2799,2021-01-15,MAR,1772,500,1272,1755,0,17,ITI,ITI3,11,Marche,Marche,1525271,779550,51.11,0.12
2800,2021-04-09,MAR,9573,4192,5381,9158,200,215,ITI,ITI3,11,Marche,Marche,1525271,789123,51.74,0.63
2801,2021-07-27,MAR,14363,7530,6833,3033,11104,226,ITI,ITI3,11,Marche,Marche,1525271,803486,52.68,0.94
2802,2021-01-06,MAR,2209,803,1406,2190,0,19,ITI,ITI3,11,Marche,Marche,1525271,805695,52.82,0.14
2803,2021-03-04,MAR,6539,2894,3645,5084,1395,60,ITI,ITI3,11,Marche,Marche,1525271,812234,53.25,0.43
2804,2021-03-13,MAR,5807,2681,3126,1765,4002,40,ITI,ITI3,11,Marche,Marche,1525271,818041,53.63,0.38
2805,2021-06-21,MAR,12605,6184,6421,5481,6878,246,ITI,ITI3,11,Marche,Marche,1525271,830646,54.46,0.83
2806,2021-08-08,MAR,5636,3020,2616,1680,3845,111,ITI,ITI3,11,Marche,Marche,1525271,836282,54.83,0.37
2807,2021-07-06,MAR,13963,6920,7043,3143,10597,223,ITI,ITI3,11,Marche,Marche,1525271,850245,55.74,0.92
2808,2021-07-20,MAR,14397,7436,6961,1770,12453,174,ITI,ITI3,11,Marche,Marche,1525271,864642,56.69,0.94
2809,2021-01-16,MAR,2038,734,1304,1988,0,50,ITI,ITI3,11,Marche,Marche,1525271,866680,56.82,0.13
2810,2021-06-19,MAR,14693,7403,7290,7750,6678,265,ITI,ITI3,11,Marche,Marche,1525271,881373,57.78,0.96
2811,2021-05-07,MAR,12832,5799,7033,3571,9180,81,ITI,ITI3,11,Marche,Marche,1525271,894205,58.63,0.84
2812,2021-02-13,MAR,1093,462,631,988,82,23,ITI,ITI3,11,Marche,Marche,1525271,895298,58.7,0.07
2813,2021-01-27,MAR,2120,779,1341,115,2003,2,ITI,ITI3,11,Marche,Marche,1525271,897418,58.84,0.14
2814,2021-04-20,MAR,10754,5029,5725,9153,1470,131,ITI,ITI3,11,Marche,Marche,1525271,908172,59.54,0.71
2815,2021-07-29,MAR,14841,7879,6962,4578,9952,311,ITI,ITI3,11,Marche,Marche,1525271,923013,60.51,0.97
2816,2021-01-25,MAR,1596,558,1038,90,1506,0,ITI,ITI3,11,Marche,Marche,1525271,924609,60.62,0.1
2817,2021-06-17,MAR,15196,7560,7636,8798,6102,296,ITI,ITI3,11,Marche,Marche,1525271,939805,61.62,1.0
2818,2021-03-09,MAR,5432,2294,3138,4464,881,87,ITI,ITI3,11,Marche,Marche,1525271,945237,61.97,0.36
2819,2021-07-22,MAR,15746,8047,7699,2019,13486,241,ITI,ITI3,11,Marche,Marche,1525271,960983,63.0,1.03
2820,2021-04-13,MAR,9845,4263,5582,9410,234,201,ITI,ITI3,11,Marche,Marche,1525271,970828,63.65,0.65
2821,2021-07-05,MAR,13167,6509,6658,2920,10075,172,ITI,ITI3,11,Marche,Marche,1525271,983995,64.51,0.86
2822,2021-02-01,MAR,1362,479,883,93,1266,3,ITI,ITI3,11,Marche,Marche,1525271,985357,64.6,0.09
2823,2021-04-06,MAR,8876,3693,5183,7931,810,135,ITI,ITI3,11,Marche,Marche,1525271,994233,65.18,0.58
2824,2021-03-23,MAR,5838,2556,3282,2226,3576,36,ITI,ITI3,11,Marche,Marche,1525271,1000071,65.57,0.38
2825,2021-02-08,MAR,834,259,575,366,463,5,ITI,ITI3,11,Marche,Marche,1525271,1000905,65.62,0.05
2826,2021-07-15,MAR,16008,8286,7722,1750,14030,228,ITI,ITI3,11,Marche,Marche,1525271,1016913,66.67,1.05
2827,2021-02-27,MAR,3401,1457,1944,3158,209,34,ITI,ITI3,11,Marche,Marche,1525271,1020314,66.89,0.22
2828,2021-03-18,MAR,3438,1505,1933,150,3276,12,ITI,ITI3,11,Marche,Marche,1525271,1023752,67.12,0.23
2829,2021-05-09,MAR,8866,4022,4844,3560,5228,78,ITI,ITI3,11,Marche,Marche,1525271,1032618,67.7,0.58
2830,2021-03-06,MAR,5738,2642,3096,4423,1267,48,ITI,ITI3,11,Marche,Marche,1525271,1038356,68.08,0.38
2831,2021-06-14,MAR,12837,6486,6351,9258,3309,270,ITI,ITI3,11,Marche,Marche,1525271,1051193,68.92,0.84
2832,2021-04-25,MAR,8599,3993,4606,6893,1575,131,ITI,ITI3,11,Marche,Marche,1525271,1059792,69.48,0.56
2833,2021-08-03,MAR,10878,5737,5141,4029,6583,266,ITI,ITI3,11,Marche,Marche,1525271,1070670,70.2,0.71
2834,2021-01-13,MAR,2113,746,1367,2072,0,41,ITI,ITI3,11,Marche,Marche,1525271,1072783,70.33,0.14
2835,2021-05-02,MAR,8903,3938,4965,3083,5740,80,ITI,ITI3,11,Marche,Marche,1525271,1081686,70.92,0.58
2836,2021-08-10,MAR,9203,4815,4388,3336,5591,276,ITI,ITI3,11,Marche,Marche,1525271,1090889,71.52,0.6
2837,2021-06-28,MAR,12360,6025,6335,4614,7508,238,ITI,ITI3,11,Marche,Marche,1525271,1103249,72.33,0.81
2838,2021-01-08,MAR,1582,592,990,1567,0,15,ITI,ITI3,11,Marche,Marche,1525271,1104831,72.44,0.1
2839,2021-04-18,MAR,8824,4132,4692,7733,921,170,ITI,ITI3,11,Marche,Marche,1525271,1113655,73.01,0.58
2840,2021-07-31,MAR,13200,7250,5950,5142,7728,330,ITI,ITI3,11,Marche,Marche,1525271,1126855,73.88,0.87
2841,2021-07-14,MAR,13849,6819,7030,1784,11874,191,ITI,ITI3,11,Marche,Marche,1525271,1140704,74.79,0.91
2842,2021-05-31,MAR,11780,5943,5837,8599,2929,252,ITI,ITI3,11,Marche,Marche,1525271,1152484,75.56,0.77
2843,2021-05-17,MAR,12046,5649,6397,7472,4354,220,ITI,ITI3,11,Marche,Marche,1525271,1164530,76.35,0.79
2844,2021-04-30,MAR,14155,6201,7954,5404,8564,187,ITI,ITI3,11,Marche,Marche,1525271,1178685,77.28,0.93
2845,2021-06-16,MAR,13756,6913,6843,9128,4365,263,ITI,ITI3,11,Marche,Marche,1525271,1192441,78.18,0.9
2846,2021-06-02,MAR,11901,5938,5963,11029,676,196,ITI,ITI3,11,Marche,Marche,1525271,1204342,78.96,0.78
2847,2021-02-22,MAR,3462,1533,1929,3352,75,35,ITI,ITI3,11,Marche,Marche,1525271,1207804,79.19,0.23
2848,2021-08-05,MAR,11911,6395,5516,4083,7561,267,ITI,ITI3,11,Marche,Marche,1525271,1219715,79.97,0.78
2849,2021-05-19,MAR,11662,5364,6298,8368,3098,196,ITI,ITI3,11,Marche,Marche,1525271,1231377,80.73,0.76
2850,2021-06-26,MAR,13576,6905,6671,5688,7671,217,ITI,ITI3,11,Marche,Marche,1525271,1244953,81.62,0.89
2851,2021-05-23,MAR,9210,4284,4926,7414,1672,124,ITI,ITI3,11,Marche,Marche,1525271,1254163,82.23,0.6
2852,2021-05-06,MAR,12657,5823,6834,5363,7073,221,ITI,ITI3,11,Marche,Marche,1525271,1266820,83.06,0.83
2853,2021-02-12,MAR,1581,618,963,1404,151,26,ITI,ITI3,11,Marche,Marche,1525271,1268401,83.16,0.1
2854,2021-02-10,MAR,1440,452,988,1039,359,42,ITI,ITI3,11,Marche,Marche,1525271,1269841,83.25,0.09
2855,2021-01-29,MAR,1994,731,1263,157,1832,5,ITI,ITI3,11,Marche,Marche,1525271,1271835,83.38,0.13
2856,2021-05-18,MAR,11272,5347,5925,7491,3602,179,ITI,ITI3,11,Marche,Marche,1525271,1283107,84.12,0.74
2857,2021-03-22,MAR,5701,2410,3291,2481,3176,44,ITI,ITI3,11,Marche,Marche,1525271,1288808,84.5,0.37
2858,2021-01-24,MAR,881,339,542,4,877,0,ITI,ITI3,11,Marche,Marche,1525271,1289689,84.55,0.06
2859,2021-06-30,MAR,13654,6666,6988,4455,8987,212,ITI,ITI3,11,Marche,Marche,1525271,1303343,85.45,0.9
2860,2021-04-11,MAR,7117,3116,4001,6692,287,138,ITI,ITI3,11,Marche,Marche,1525271,1310460,85.92,0.47
2861,2021-03-11,MAR,6635,2824,3811,5146,1411,78,ITI,ITI3,11,Marche,Marche,1525271,1317095,86.35,0.44
2862,2021-03-25,MAR,6704,2794,3910,3191,3456,57,ITI,ITI3,11,Marche,Marche,1525271,1323799,86.79,0.44
2863,2021-07-03,MAR,13846,6993,6853,4138,9395,313,ITI,ITI3,11,Marche,Marche,1525271,1337645,87.7,0.91
2864,2021-01-10,MAR,1746,702,1044,1732,0,14,ITI,ITI3,11,Marche,Marche,1525271,1339391,87.81,0.11
2865,2021-07-12,MAR,13722,6804,6918,1228,12376,118,ITI,ITI3,11,Marche,Marche,1525271,1353113,88.71,0.9
2866,2021-04-03,MAR,7574,3204,4370,6736,667,171,ITI,ITI3,11,Marche,Marche,1525271,1360687,89.21,0.5
2867,2021-06-25,MAR,14349,7172,7177,6422,7639,288,ITI,ITI3,11,Marche,Marche,1525271,1375036,90.15,0.94
2868,2021-03-27,MAR,7416,3092,4324,4950,2393,73,ITI,ITI3,11,Marche,Marche,1525271,1382452,90.64,0.49
2869,2021-04-10,MAR,10933,4627,6306,10380,314,239,ITI,ITI3,11,Marche,Marche,1525271,1393385,91.35,0.72
2870,2021-01-03,MAR,912,358,554,902,0,10,ITI,ITI3,11,Marche,Marche,1525271,1394297,91.41,0.06
2871,2021-07-19,MAR,14676,7531,7145,1927,12535,214,ITI,ITI3,11,Marche,Marche,1525271,1408973,92.38,0.96
2872,2021-03-08,MAR,6297,2759,3538,5186,1002,109,ITI,ITI3,11,Marche,Marche,1525271,1415270,92.79,0.41
2873,2021-04-17,MAR,11705,5317,6388,10400,1073,232,ITI,ITI3,11,Marche,Marche,1525271,1426975,93.56,0.77
2874,2021-07-26,MAR,11032,5738,5294,2110,8717,205,ITI,ITI3,11,Marche,Marche,1525271,1438007,94.28,0.72
2875,2021-08-09,MAR,9100,4833,4267,4056,4771,273,ITI,ITI3,11,Marche,Marche,1525271,1447107,94.88,0.6
2876,2021-06-13,MAR,10752,5565,5187,9205,1298,249,ITI,ITI3,11,Marche,Marche,1525271,1457859,95.58,0.7
2877,2020-12-27,MAR,209,100,109,207,0,2,ITI,ITI3,11,Marche,Marche,1525271,1458068,95.59,0.01
2878,2021-08-02,MAR,11723,6207,5516,4599,6866,258,ITI,ITI3,11,Marche,Marche,1525271,1469791,96.36,0.77
2879,2021-06-06,MAR,12452,6137,6315,10638,1578,236,ITI,ITI3,11,Marche,Marche,1525271,1482243,97.18,0.82
2880,2021-06-11,MAR,13998,7154,6844,11371,2322,305,ITI,ITI3,11,Marche,Marche,1525271,1496241,98.1,0.92
2881,2021-05-25,MAR,11767,5798,5969,8497,3050,220,ITI,ITI3,11,Marche,Marche,1525271,1508008,98.87,0.77
2882,2021-03-01,MAR,3772,1520,2252,3503,248,21,ITI,ITI3,11,Marche,Marche,1525271,1511780,99.12,0.25
2883,2021-05-11,MAR,10623,4832,5791,5490,4943,190,ITI,ITI3,11,Marche,Marche,1525271,1522403,99.81,0.7
2884,2021-03-15,MAR,4450,2060,2390,1291,3138,21,ITI,ITI3,11,Marche,Marche,1525271,1526853,100.1,0.29
2885,2021-06-23,MAR,13895,6819,7076,6629,7010,256,ITI,ITI3,11,Marche,Marche,1525271,1540748,101.01,0.91
2886,2021-02-20,MAR,4163,1733,2430,4042,111,10,ITI,ITI3,11,Marche,Marche,1525271,1544911,101.29,0.27
2887,2021-01-20,MAR,406,100,306,384,20,2,ITI,ITI3,11,Marche,Marche,1525271,1545317,101.31,0.03
2888,2021-02-03,MAR,2126,742,1384,97,2008,21,ITI,ITI3,11,Marche,Marche,1525271,1547443,101.45,0.14
2889,2021-05-14,MAR,13634,6292,7342,6508,6912,214,ITI,ITI3,11,Marche,Marche,1525271,1561077,102.35,0.89
2890,2021-07-02,MAR,14550,7175,7375,4675,9644,231,ITI,ITI3,11,Marche,Marche,1525271,1575627,103.3,0.95
2891,2021-06-18,MAR,15345,7647,7698,8294,6751,300,ITI,ITI3,11,Marche,Marche,1525271,1590972,104.31,1.01
2892,2021-05-04,MAR,10973,4840,6133,4927,5904,142,ITI,ITI3,11,Marche,Marche,1525271,1601945,105.03,0.72
2893,2021-03-20,MAR,4178,1759,2419,1035,3129,14,ITI,ITI3,11,Marche,Marche,1525271,1606123,105.3,0.27
2894,2021-01-22,MAR,489,168,321,193,294,2,ITI,ITI3,11,Marche,Marche,1525271,1606612,105.33,0.03
2895,2021-07-07,MAR,14259,7068,7191,2938,11080,241,ITI,ITI3,11,Marche,Marche,1525271,1620871,106.27,0.93
2896,2021-02-05,MAR,2157,655,1502,437,1719,1,ITI,ITI3,11,Marche,Marche,1525271,1623028,106.41,0.14
2897,2021-05-16,MAR,10900,4958,5942,6550,4230,120,ITI,ITI3,11,Marche,Marche,1525271,1633928,107.12,0.71
2898,2021-05-30,MAR,9732,4690,5042,6546,2989,197,ITI,ITI3,11,Marche,Marche,1525271,1643660,107.76,0.64
2899,2021-04-27,MAR,9592,4389,5203,5509,3988,95,ITI,ITI3,11,Marche,Marche,1525271,1653252,108.39,0.63
2900,2021-08-07,MAR,9460,5197,4263,3478,5745,237,ITI,ITI3,11,Marche,Marche,1525271,1662712,109.01,0.62
2901,2021-07-21,MAR,14919,7617,7302,2064,12642,213,ITI,ITI3,11,Marche,Marche,1525271,1677631,109.99,0.98
2902,2021-04-29,MAR,13446,6156,7290,7164,6104,178,ITI,ITI3,11,Marche,Marche,1525271,1691077,110.87,0.88
2903,2021-01-17,MAR,1623,695,928,1553,64,6,ITI,ITI3,11,Marche,Marche,1525271,1692700,110.98,0.11
2904,2021-03-28,MAR,4126,1740,2386,2397,1691,38,ITI,ITI3,11,Marche,Marche,1525271,1696826,111.25,0.27
2905,2021-01-30,MAR,1905,668,1237,25,1880,0,ITI,ITI3,11,Marche,Marche,1525271,1698731,111.37,0.12
2906,2021-05-10,MAR,9453,4338,5115,4769,4555,129,ITI,ITI3,11,Marche,Marche,1525271,1708184,111.99,0.62
2907,2021-03-14,MAR,2499,1032,1467,1897,592,10,ITI,ITI3,11,Marche,Marche,1525271,1710683,112.16,0.16
2908,2021-03-21,MAR,4505,1873,2632,1614,2876,15,ITI,ITI3,11,Marche,Marche,1525271,1715188,112.45,0.3
2909,2021-02-06,MAR,2462,901,1561,512,1941,9,ITI,ITI3,11,Marche,Marche,1525271,1717650,112.61,0.16
2910,2021-07-17,MAR,15136,7792,7344,1384,13541,211,ITI,ITI3,11,Marche,Marche,1525271,1732786,113.61,0.99
2911,2021-05-21,MAR,13907,6592,7315,7226,6470,211,ITI,ITI3,11,Marche,Marche,1525271,1746693,114.52,0.91
2912,2021-05-28,MAR,13960,6739,7221,8802,4860,298,ITI,ITI3,11,Marche,Marche,1525271,1760653,115.43,0.92
2913,2021-04-01,MAR,7576,3182,4394,4068,3416,92,ITI,ITI3,11,Marche,Marche,1525271,1768229,115.93,0.5
2914,2021-07-24,MAR,13273,7119,6154,2944,10072,257,ITI,ITI3,11,Marche,Marche,1525271,1781502,116.8,0.87
2915,2021-07-10,MAR,14159,7232,6927,1656,12300,203,ITI,ITI3,11,Marche,Marche,1525271,1795661,117.73,0.93
2916,2021-04-22,MAR,10799,4932,5867,9082,1579,138,ITI,ITI3,11,Marche,Marche,1525271,1806460,118.44,0.71
2917,2021-02-24,MAR,3534,1547,1987,3424,78,32,ITI,ITI3,11,Marche,Marche,1525271,1809994,118.67,0.23
2918,2021-06-04,MAR,14338,7290,7048,11590,2439,309,ITI,ITI3,11,Marche,Marche,1525271,1824332,119.61,0.94
2919,2021-04-08,MAR,9200,4031,5169,8681,368,151,ITI,ITI3,11,Marche,Marche,1525271,1833532,120.21,0.6
2920,2021-03-03,MAR,6701,3076,3625,5719,885,97,ITI,ITI3,11,Marche,Marche,1525271,1840233,120.65,0.44
2921,2021-01-05,MAR,1583,592,991,1564,0,19,ITI,ITI3,11,Marche,Marche,1525271,1841816,120.75,0.1
2922,2021-04-15,MAR,10377,4676,5701,9578,564,235,ITI,ITI3,11,Marche,Marche,1525271,1852193,121.43,0.68
2923,2021-02-17,MAR,1828,701,1127,1642,118,68,ITI,ITI3,11,Marche,Marche,1525271,1854021,121.55,0.12
2924,2021-02-19,MOL,170,94,76,168,2,0,ITF,ITF2,14,Molise,Molise,305617,170,0.06,0.06
2925,2021-03-10,MOL,1741,720,1021,1669,50,22,ITF,ITF2,14,Molise,Molise,305617,1911,0.63,0.57
2926,2021-06-01,MOL,2603,1323,1280,2459,108,36,ITF,ITF2,14,Molise,Molise,305617,4514,1.48,0.85
2927,2021-08-11,MOL,1566,804,762,986,525,55,ITF,ITF2,14,Molise,Molise,305617,6080,1.99,0.51
2928,2021-01-12,MOL,336,114,222,336,0,0,ITF,ITF2,14,Molise,Molise,305617,6416,2.1,0.11
2929,2021-03-24,MOL,1631,658,973,1212,402,17,ITF,ITF2,14,Molise,Molise,305617,8047,2.63,0.53
2930,2021-07-02,MOL,2658,1289,1369,129,2521,8,ITF,ITF2,14,Molise,Molise,305617,10705,3.5,0.87
2931,2021-07-04,MOL,2152,1085,1067,579,1550,23,ITF,ITF2,14,Molise,Molise,305617,12857,4.21,0.7
2932,2021-07-14,MOL,3404,1667,1737,194,3194,16,ITF,ITF2,14,Molise,Molise,305617,16261,5.32,1.11
2933,2021-04-05,MOL,391,189,202,292,99,0,ITF,ITF2,14,Molise,Molise,305617,16652,5.45,0.13
2934,2021-03-29,MOL,2036,835,1201,1518,487,31,ITF,ITF2,14,Molise,Molise,305617,18688,6.11,0.67
2935,2021-01-31,MOL,268,70,198,6,262,0,ITF,ITF2,14,Molise,Molise,305617,18956,6.2,0.09
2936,2021-02-07,MOL,66,32,34,19,47,0,ITF,ITF2,14,Molise,Molise,305617,19022,6.22,0.02
2937,2021-05-18,MOL,1658,884,774,996,656,6,ITF,ITF2,14,Molise,Molise,305617,20680,6.77,0.54
2938,2021-03-22,MOL,1150,441,709,890,244,16,ITF,ITF2,14,Molise,Molise,305617,21830,7.14,0.38
2939,2021-07-23,MOL,2913,1514,1399,871,1988,54,ITF,ITF2,14,Molise,Molise,305617,24743,8.1,0.95
2940,2021-05-01,MOL,2651,1271,1380,407,2225,19,ITF,ITF2,14,Molise,Molise,305617,27394,8.96,0.87
2941,2021-03-05,MOL,1221,650,571,1002,206,13,ITF,ITF2,14,Molise,Molise,305617,28615,9.36,0.4
2942,2021-08-09,MOL,3106,1598,1508,1591,1471,44,ITF,ITF2,14,Molise,Molise,305617,31721,10.38,1.02
2943,2021-06-13,MOL,2886,1538,1348,2524,327,35,ITF,ITF2,14,Molise,Molise,305617,34607,11.32,0.94
2944,2021-04-17,MOL,3060,1505,1555,1542,1491,27,ITF,ITF2,14,Molise,Molise,305617,37667,12.32,1.0
2945,2021-06-20,MOL,422,174,248,47,371,4,ITF,ITF2,14,Molise,Molise,305617,38089,12.46,0.14
2946,2021-04-24,MOL,2557,1206,1351,696,1846,15,ITF,ITF2,14,Molise,Molise,305617,40646,13.3,0.84
2947,2021-02-26,MOL,563,260,303,489,73,1,ITF,ITF2,14,Molise,Molise,305617,41209,13.48,0.18
2948,2021-08-02,MOL,2680,1400,1280,1179,1458,43,ITF,ITF2,14,Molise,Molise,305617,43889,14.36,0.88
2949,2021-06-27,MOL,2367,1122,1245,1128,1229,10,ITF,ITF2,14,Molise,Molise,305617,46256,15.14,0.77
2950,2021-01-07,MOL,598,209,389,598,0,0,ITF,ITF2,14,Molise,Molise,305617,46854,15.33,0.2
2951,2021-02-12,MOL,334,151,183,209,124,1,ITF,ITF2,14,Molise,Molise,305617,47188,15.44,0.11
2952,2021-01-26,MOL,450,184,266,8,442,0,ITF,ITF2,14,Molise,Molise,305617,47638,15.59,0.15
2953,2021-05-06,MOL,2687,1215,1472,2045,602,40,ITF,ITF2,14,Molise,Molise,305617,50325,16.47,0.88
2954,2021-07-28,MOL,2426,1285,1141,1130,1265,31,ITF,ITF2,14,Molise,Molise,305617,52751,17.26,0.79
2955,2021-02-24,MOL,669,281,388,325,336,8,ITF,ITF2,14,Molise,Molise,305617,53420,17.48,0.22
2956,2021-03-03,MOL,672,316,356,586,82,4,ITF,ITF2,14,Molise,Molise,305617,54092,17.7,0.22
2957,2021-01-05,MOL,449,180,269,449,0,0,ITF,ITF2,14,Molise,Molise,305617,54541,17.85,0.15
2958,2021-05-13,MOL,3048,1415,1633,2536,459,53,ITF,ITF2,14,Molise,Molise,305617,57589,18.84,1.0
2959,2021-08-04,MOL,2493,1288,1205,945,1530,18,ITF,ITF2,14,Molise,Molise,305617,60082,19.66,0.82
2960,2021-04-28,MOL,1697,925,772,471,1219,7,ITF,ITF2,14,Molise,Molise,305617,61779,20.21,0.56
2961,2021-08-06,MOL,2101,1107,994,952,1109,40,ITF,ITF2,14,Molise,Molise,305617,63880,20.9,0.69
2962,2021-01-17,MOL,78,38,40,48,30,0,ITF,ITF2,14,Molise,Molise,305617,63958,20.93,0.03
2963,2021-04-10,MOL,2643,1262,1381,2453,152,38,ITF,ITF2,14,Molise,Molise,305617,66601,21.79,0.86
2964,2021-02-05,MOL,593,269,324,55,538,0,ITF,ITF2,14,Molise,Molise,305617,67194,21.99,0.19
2965,2021-01-19,MOL,174,63,111,163,11,0,ITF,ITF2,14,Molise,Molise,305617,67368,22.04,0.06
2966,2021-04-29,MOL,2241,1148,1093,877,1349,15,ITF,ITF2,14,Molise,Molise,305617,69609,22.78,0.73
2967,2021-04-12,MOL,1299,557,742,1037,251,11,ITF,ITF2,14,Molise,Molise,305617,70908,23.2,0.43
2968,2021-07-21,MOL,1999,1006,993,776,1185,38,ITF,ITF2,14,Molise,Molise,305617,72907,23.86,0.65
2969,2021-07-16,MOL,3051,1548,1503,384,2639,28,ITF,ITF2,14,Molise,Molise,305617,75958,24.85,1.0
2970,2021-07-09,MOL,3438,1651,1787,166,3254,18,ITF,ITF2,14,Molise,Molise,305617,79396,25.98,1.12
2971,2021-05-20,MOL,2669,1375,1294,2399,189,81,ITF,ITF2,14,Molise,Molise,305617,82065,26.85,0.87
2972,2021-05-25,MOL,1966,889,1077,1301,631,34,ITF,ITF2,14,Molise,Molise,305617,84031,27.5,0.64
2973,2021-01-04,MOL,314,131,183,314,0,0,ITF,ITF2,14,Molise,Molise,305617,84345,27.6,0.1
2974,2021-04-14,MOL,1809,767,1042,1135,664,10,ITF,ITF2,14,Molise,Molise,305617,86154,28.19,0.59
2975,2021-02-16,MOL,156,70,86,149,6,1,ITF,ITF2,14,Molise,Molise,305617,86310,28.24,0.05
2976,2021-05-27,MOL,2841,1349,1492,1965,840,36,ITF,ITF2,14,Molise,Molise,305617,89151,29.17,0.93
2977,2021-06-06,MOL,2073,1065,1008,1733,323,17,ITF,ITF2,14,Molise,Molise,305617,91224,29.85,0.68
2978,2021-03-19,MOL,1184,482,702,740,427,17,ITF,ITF2,14,Molise,Molise,305617,92408,30.24,0.39
2979,2021-01-21,MOL,6,2,4,6,0,0,ITF,ITF2,14,Molise,Molise,305617,92414,30.24,0.0
2980,2021-03-15,MOL,834,340,494,570,245,19,ITF,ITF2,14,Molise,Molise,305617,93248,30.51,0.27
2981,2021-06-24,MOL,3336,1552,1784,435,2864,37,ITF,ITF2,14,Molise,Molise,305617,96584,31.6,1.09
2982,2021-03-02,MOL,669,385,284,505,158,6,ITF,ITF2,14,Molise,Molise,305617,97253,31.82,0.22
2983,2021-03-17,MOL,910,385,525,519,332,59,ITF,ITF2,14,Molise,Molise,305617,98163,32.12,0.3
2984,2021-06-25,MOL,3439,1691,1748,1470,1915,54,ITF,ITF2,14,Molise,Molise,305617,101602,33.24,1.13
2985,2021-06-08,MOL,2897,1600,1297,2198,696,3,ITF,ITF2,14,Molise,Molise,305617,104499,34.19,0.95
2986,2021-07-06,MOL,3063,1428,1635,37,3022,4,ITF,ITF2,14,Molise,Molise,305617,107562,35.2,1.0
2987,2021-05-10,MOL,2895,1287,1608,2491,373,31,ITF,ITF2,14,Molise,Molise,305617,110457,36.14,0.95
2988,2021-06-29,MOL,2492,1160,1332,378,2088,26,ITF,ITF2,14,Molise,Molise,305617,112949,36.96,0.82
2989,2021-05-03,MOL,2492,1170,1322,2293,163,36,ITF,ITF2,14,Molise,Molise,305617,115441,37.77,0.82
2990,2021-02-21,MOL,575,227,348,573,2,0,ITF,ITF2,14,Molise,Molise,305617,116016,37.96,0.19
2991,2021-02-04,MOL,759,295,464,77,682,0,ITF,ITF2,14,Molise,Molise,305617,116775,38.21,0.25
2992,2021-05-15,MOL,2982,1399,1583,2546,385,51,ITF,ITF2,14,Molise,Molise,305617,119757,39.19,0.98
2993,2021-03-07,MOL,1132,501,631,1127,2,3,ITF,ITF2,14,Molise,Molise,305617,120889,39.56,0.37
2994,2021-06-15,MOL,2218,1045,1173,749,1452,17,ITF,ITF2,14,Molise,Molise,305617,123107,40.28,0.73
2995,2021-06-17,MOL,2311,1019,1292,914,1370,27,ITF,ITF2,14,Molise,Molise,305617,125418,41.04,0.76
2996,2021-03-31,MOL,2196,919,1277,1308,820,68,ITF,ITF2,14,Molise,Molise,305617,127614,41.76,0.72
2997,2021-02-23,MOL,585,223,362,362,221,2,ITF,ITF2,14,Molise,Molise,305617,128199,41.95,0.19
2998,2021-07-25,MOL,2007,1059,948,353,1640,14,ITF,ITF2,14,Molise,Molise,305617,130206,42.6,0.66
2999,2021-05-29,MOL,2358,1228,1130,1928,390,40,ITF,ITF2,14,Molise,Molise,305617,132564,43.38,0.77
3000,2021-01-09,MOL,452,154,298,452,0,0,ITF,ITF2,14,Molise,Molise,305617,133016,43.52,0.15
3001,2021-04-19,MOL,1829,843,986,988,779,62,ITF,ITF2,14,Molise,Molise,305617,134845,44.12,0.6
3002,2021-07-13,MOL,2805,1425,1380,318,2470,17,ITF,ITF2,14,Molise,Molise,305617,137650,45.04,0.92
3003,2021-02-02,MOL,540,176,364,216,323,1,ITF,ITF2,14,Molise,Molise,305617,138190,45.22,0.18
3004,2021-01-16,MOL,422,166,256,422,0,0,ITF,ITF2,14,Molise,Molise,305617,138612,45.35,0.14
3005,2021-04-26,MOL,1159,521,638,810,331,18,ITF,ITF2,14,Molise,Molise,305617,139771,45.73,0.38
3006,2021-04-09,MOL,2327,1253,1074,2107,191,29,ITF,ITF2,14,Molise,Molise,305617,142098,46.5,0.76
3007,2021-01-18,MOL,115,48,67,115,0,0,ITF,ITF2,14,Molise,Molise,305617,142213,46.53,0.04
3008,2021-04-11,MOL,1196,591,605,1166,14,16,ITF,ITF2,14,Molise,Molise,305617,143409,46.92,0.39
3009,2021-07-20,MOL,2166,1094,1072,1009,1110,47,ITF,ITF2,14,Molise,Molise,305617,145575,47.63,0.71
3010,2021-07-03,MOL,2743,1382,1361,569,2154,20,ITF,ITF2,14,Molise,Molise,305617,148318,48.53,0.9
3011,2021-08-08,MOL,692,358,334,478,208,6,ITF,ITF2,14,Molise,Molise,305617,149010,48.76,0.23
3012,2021-05-17,MOL,2231,1093,1138,1707,496,28,ITF,ITF2,14,Molise,Molise,305617,151241,49.49,0.73
3013,2021-03-21,MOL,1248,543,705,478,768,2,ITF,ITF2,14,Molise,Molise,305617,152489,49.9,0.41
3014,2021-03-14,MOL,597,240,357,17,580,0,ITF,ITF2,14,Molise,Molise,305617,153086,50.09,0.2
3015,2021-06-22,MOL,2967,1369,1598,671,2279,17,ITF,ITF2,14,Molise,Molise,305617,156053,51.06,0.97
3016,2021-03-28,MOL,1628,749,879,519,1102,7,ITF,ITF2,14,Molise,Molise,305617,157681,51.59,0.53
3017,2021-01-30,MOL,464,161,303,12,452,0,ITF,ITF2,14,Molise,Molise,305617,158145,51.75,0.15
3018,2021-03-26,MOL,2578,1045,1533,1891,643,44,ITF,ITF2,14,Molise,Molise,305617,160723,52.59,0.84
3019,2021-02-09,MOL,360,170,190,197,163,0,ITF,ITF2,14,Molise,Molise,305617,161083,52.71,0.12
3020,2021-08-01,MOL,954,522,432,750,174,30,ITF,ITF2,14,Molise,Molise,305617,162037,53.02,0.31
3021,2021-08-03,MOL,2192,1137,1055,1213,945,34,ITF,ITF2,14,Molise,Molise,305617,164229,53.74,0.72
3022,2021-03-11,MOL,1467,638,829,1447,6,14,ITF,ITF2,14,Molise,Molise,305617,165696,54.22,0.48
3023,2021-06-03,MOL,3300,1571,1729,2708,559,33,ITF,ITF2,14,Molise,Molise,305617,168996,55.3,1.08
3024,2021-04-07,MOL,1689,848,841,1369,275,45,ITF,ITF2,14,Molise,Molise,305617,170685,55.85,0.55
3025,2021-06-05,MOL,3006,1521,1485,2805,173,28,ITF,ITF2,14,Molise,Molise,305617,173691,56.83,0.98
3026,2021-07-18,MOL,1752,881,871,125,1618,9,ITF,ITF2,14,Molise,Molise,305617,175443,57.41,0.57
3027,2021-06-10,MOL,2573,1184,1389,1235,1301,37,ITF,ITF2,14,Molise,Molise,305617,178016,58.25,0.84
3028,2021-04-02,MOL,1457,710,747,661,778,18,ITF,ITF2,14,Molise,Molise,305617,179473,58.72,0.48
3029,2021-07-11,MOL,2455,1196,1259,179,2273,3,ITF,ITF2,14,Molise,Molise,305617,181928,59.53,0.8
3030,2021-05-08,MOL,2982,1457,1525,1699,1247,36,ITF,ITF2,14,Molise,Molise,305617,184910,60.5,0.98
3031,2021-04-21,MOL,1875,793,1082,969,899,7,ITF,ITF2,14,Molise,Molise,305617,186785,61.12,0.61
3032,2021-07-30,MOL,2672,1380,1292,1429,1189,54,ITF,ITF2,14,Molise,Molise,305617,189457,61.99,0.87
3033,2021-07-22,MOL,2163,1072,1091,837,1271,55,ITF,ITF2,14,Molise,Molise,305617,191620,62.7,0.71
3034,2021-02-28,MOL,833,335,498,789,42,2,ITF,ITF2,14,Molise,Molise,305617,192453,62.97,0.27
3035,2021-02-27,MOL,1369,570,799,1345,19,5,ITF,ITF2,14,Molise,Molise,305617,193822,63.42,0.45
3036,2021-06-07,MOL,1956,860,1096,1115,819,22,ITF,ITF2,14,Molise,Molise,305617,195778,64.06,0.64
3037,2021-02-13,MOL,132,80,52,132,0,0,ITF,ITF2,14,Molise,Molise,305617,195910,64.1,0.04
3038,2021-05-24,MOL,1967,854,1113,1271,668,28,ITF,ITF2,14,Molise,Molise,305617,197877,64.75,0.64
3039,2021-05-07,MOL,2645,1229,1416,2017,599,29,ITF,ITF2,14,Molise,Molise,305617,200522,65.61,0.87
3040,2021-02-06,MOL,430,179,251,29,401,0,ITF,ITF2,14,Molise,Molise,305617,200952,65.75,0.14
3041,2021-02-18,MOL,319,74,245,302,13,4,ITF,ITF2,14,Molise,Molise,305617,201271,65.86,0.1
3042,2021-03-09,MOL,1329,579,750,1149,152,28,ITF,ITF2,14,Molise,Molise,305617,202600,66.29,0.43
3043,2021-02-20,MOL,1020,443,577,1000,20,0,ITF,ITF2,14,Molise,Molise,305617,203620,66.63,0.33
3044,2021-05-31,MOL,2372,1152,1220,1905,426,41,ITF,ITF2,14,Molise,Molise,305617,205992,67.4,0.78
3045,2021-05-14,MOL,2646,1215,1431,1891,719,36,ITF,ITF2,14,Molise,Molise,305617,208638,68.27,0.87
3046,2021-06-02,MOL,2812,1357,1455,2692,99,21,ITF,ITF2,14,Molise,Molise,305617,211450,69.19,0.92
3047,2021-03-04,MOL,852,417,435,515,325,12,ITF,ITF2,14,Molise,Molise,305617,212302,69.47,0.28
3048,2021-06-12,MOL,3465,1788,1677,3288,124,53,ITF,ITF2,14,Molise,Molise,305617,215767,70.6,1.13
3049,2021-06-14,MOL,1638,813,825,544,1077,17,ITF,ITF2,14,Molise,Molise,305617,217405,71.14,0.54
3050,2021-01-20,MOL,18,8,10,18,0,0,ITF,ITF2,14,Molise,Molise,305617,217423,71.14,0.01
3051,2021-04-30,MOL,2946,1561,1385,818,2113,15,ITF,ITF2,14,Molise,Molise,305617,220369,72.11,0.96
3052,2021-02-25,MOL,542,239,303,471,68,3,ITF,ITF2,14,Molise,Molise,305617,220911,72.28,0.18
3053,2021-01-06,MOL,690,260,430,690,0,0,ITF,ITF2,14,Molise,Molise,305617,221601,72.51,0.23
3054,2021-04-16,MOL,2432,1033,1399,1175,1234,23,ITF,ITF2,14,Molise,Molise,305617,224033,73.31,0.8
3055,2021-06-21,MOL,2910,1355,1555,1628,1236,46,ITF,ITF2,14,Molise,Molise,305617,226943,74.26,0.95
3056,2021-04-25,MOL,794,397,397,557,233,4,ITF,ITF2,14,Molise,Molise,305617,227737,74.52,0.26
3057,2021-01-13,MOL,477,162,315,477,0,0,ITF,ITF2,14,Molise,Molise,305617,228214,74.67,0.16
3058,2021-03-25,MOL,1807,730,1077,1283,498,26,ITF,ITF2,14,Molise,Molise,305617,230021,75.26,0.59
3059,2021-03-08,MOL,1382,523,859,1205,140,37,ITF,ITF2,14,Molise,Molise,305617,231403,75.72,0.45
3060,2021-06-16,MOL,2059,1029,1030,1141,904,14,ITF,ITF2,14,Molise,Molise,305617,233462,76.39,0.67
3061,2021-04-13,MOL,1632,718,914,1037,587,8,ITF,ITF2,14,Molise,Molise,305617,235094,76.92,0.53
3062,2021-03-27,MOL,2745,1273,1472,1295,1433,17,ITF,ITF2,14,Molise,Molise,305617,237839,77.82,0.9
3063,2021-07-05,MOL,2740,1282,1458,39,2699,2,ITF,ITF2,14,Molise,Molise,305617,240579,78.72,0.9
3064,2021-02-11,MOL,295,133,162,258,37,0,ITF,ITF2,14,Molise,Molise,305617,240874,78.82,0.1
3065,2021-05-22,MOL,2261,1175,1086,2156,88,17,ITF,ITF2,14,Molise,Molise,305617,243135,79.56,0.74
3066,2021-04-18,MOL,1084,484,600,143,935,6,ITF,ITF2,14,Molise,Molise,305617,244219,79.91,0.35
3067,2021-07-27,MOL,1920,1060,860,1310,550,60,ITF,ITF2,14,Molise,Molise,305617,246139,80.54,0.63
3068,2021-07-10,MOL,3722,1781,1941,321,3387,14,ITF,ITF2,14,Molise,Molise,305617,249861,81.76,1.22
3069,2021-04-04,MOL,253,141,112,231,15,7,ITF,ITF2,14,Molise,Molise,305617,250114,81.84,0.08
3070,2021-03-18,MOL,1158,476,682,634,465,59,ITF,ITF2,14,Molise,Molise,305617,251272,82.22,0.38
3071,2021-06-26,MOL,3122,1530,1592,525,2583,14,ITF,ITF2,14,Molise,Molise,305617,254394,83.24,1.02
3072,2021-06-04,MOL,3062,1502,1560,2577,457,28,ITF,ITF2,14,Molise,Molise,305617,257456,84.24,1.0
3073,2021-04-08,MOL,1769,906,863,1542,202,25,ITF,ITF2,14,Molise,Molise,305617,259225,84.82,0.58
3074,2021-07-17,MOL,2850,1522,1328,293,2535,22,ITF,ITF2,14,Molise,Molise,305617,262075,85.75,0.93
3075,2021-07-19,MOL,2765,1352,1413,505,2233,27,ITF,ITF2,14,Molise,Molise,305617,264840,86.66,0.9
3076,2021-08-10,MOL,1757,965,792,617,1109,31,ITF,ITF2,14,Molise,Molise,305617,266597,87.23,0.57
3077,2021-01-29,MOL,423,137,286,6,417,0,ITF,ITF2,14,Molise,Molise,305617,267020,87.37,0.14
3078,2021-05-09,MOL,2059,935,1124,1927,97,35,ITF,ITF2,14,Molise,Molise,305617,269079,88.04,0.67
3079,2021-06-19,MOL,2347,1168,1179,1282,1023,42,ITF,ITF2,14,Molise,Molise,305617,271426,88.81,0.77
3080,2021-04-23,MOL,2053,882,1171,1376,661,16,ITF,ITF2,14,Molise,Molise,305617,273479,89.48,0.67
3081,2021-06-30,MOL,2968,1410,1558,873,2011,84,ITF,ITF2,14,Molise,Molise,305617,276447,90.46,0.97
3082,2021-03-13,MOL,1190,595,595,183,990,17,ITF,ITF2,14,Molise,Molise,305617,277637,90.84,0.39
3083,2021-01-15,MOL,538,242,296,538,0,0,ITF,ITF2,14,Molise,Molise,305617,278175,91.02,0.18
3084,2021-03-16,MOL,615,230,385,265,348,2,ITF,ITF2,14,Molise,Molise,305617,278790,91.22,0.2
3085,2021-01-11,MOL,558,194,364,558,0,0,ITF,ITF2,14,Molise,Molise,305617,279348,91.4,0.18
3086,2021-06-18,MOL,2769,1250,1519,1284,1458,27,ITF,ITF2,14,Molise,Molise,305617,282117,92.31,0.91
3087,2021-05-30,MOL,1870,933,937,1556,286,28,ITF,ITF2,14,Molise,Molise,305617,283987,92.92,0.61
3088,2021-02-10,MOL,151,79,72,131,20,0,ITF,ITF2,14,Molise,Molise,305617,284138,92.97,0.05
3089,2021-05-21,MOL,2180,1092,1088,1777,323,80,ITF,ITF2,14,Molise,Molise,305617,286318,93.69,0.71
3090,2021-01-27,MOL,675,251,424,8,667,0,ITF,ITF2,14,Molise,Molise,305617,286993,93.91,0.22
3091,2021-01-08,MOL,431,142,289,431,0,0,ITF,ITF2,14,Molise,Molise,305617,287424,94.05,0.14
3092,2021-04-22,MOL,1847,864,983,1059,779,9,ITF,ITF2,14,Molise,Molise,305617,289271,94.65,0.6
3093,2021-07-31,MOL,1987,1109,878,754,1192,41,ITF,ITF2,14,Molise,Molise,305617,291258,95.3,0.65
3094,2021-02-17,MOL,72,32,40,50,15,7,ITF,ITF2,14,Molise,Molise,305617,291330,95.33,0.02
3095,2021-07-24,MOL,3132,1683,1449,730,2373,29,ITF,ITF2,14,Molise,Molise,305617,294462,96.35,1.02
3096,2021-05-28,MOL,2655,1366,1289,2040,547,68,ITF,ITF2,14,Molise,Molise,305617,297117,97.22,0.87
3097,2021-06-11,MOL,3450,1657,1793,1975,1432,43,ITF,ITF2,14,Molise,Molise,305617,300567,98.35,1.13
3098,2021-04-15,MOL,1932,794,1138,1080,847,5,ITF,ITF2,14,Molise,Molise,305617,302499,98.98,0.63
3099,2021-02-03,MOL,741,253,488,344,397,0,ITF,ITF2,14,Molise,Molise,305617,303240,99.22,0.24
3100,2021-04-27,MOL,1599,770,829,443,1131,25,ITF,ITF2,14,Molise,Molise,305617,304839,99.75,0.52
3101,2021-08-05,MOL,2220,1123,1097,1575,598,47,ITF,ITF2,14,Molise,Molise,305617,307059,100.47,0.73
3102,2021-05-16,MOL,1251,574,677,1048,183,20,ITF,ITF2,14,Molise,Molise,305617,308310,100.88,0.41
3103,2021-08-07,MOL,1692,933,759,926,748,18,ITF,ITF2,14,Molise,Molise,305617,310002,101.43,0.55
3104,2021-07-07,MOL,2959,1368,1591,57,2898,4,ITF,ITF2,14,Molise,Molise,305617,312961,102.4,0.97
3105,2021-05-11,MOL,3220,1420,1800,2913,252,55,ITF,ITF2,14,Molise,Molise,305617,316181,103.46,1.05
3106,2021-01-22,MOL,128,36,92,128,0,0,ITF,ITF2,14,Molise,Molise,305617,316309,103.5,0.04
3107,2021-05-02,MOL,1898,934,964,578,1307,13,ITF,ITF2,14,Molise,Molise,305617,318207,104.12,0.62
3108,2021-03-06,MOL,1728,807,921,1559,159,10,ITF,ITF2,14,Molise,Molise,305617,319935,104.68,0.57
3109,2021-07-29,MOL,2437,1248,1189,1578,814,45,ITF,ITF2,14,Molise,Molise,305617,322372,105.48,0.8
3110,2021-01-25,MOL,319,130,189,3,316,0,ITF,ITF2,14,Molise,Molise,305617,322691,105.59,0.1
3111,2021-05-05,MOL,2430,1046,1384,2261,143,26,ITF,ITF2,14,Molise,Molise,305617,325121,106.38,0.8
3112,2021-05-04,MOL,2707,1182,1525,2544,128,35,ITF,ITF2,14,Molise,Molise,305617,327828,107.27,0.89
3113,2021-01-10,MOL,270,72,198,270,0,0,ITF,ITF2,14,Molise,Molise,305617,328098,107.36,0.09
3114,2021-04-20,MOL,2329,1033,1296,1213,1107,9,ITF,ITF2,14,Molise,Molise,305617,330427,108.12,0.76
3115,2021-06-09,MOL,1788,898,890,832,928,28,ITF,ITF2,14,Molise,Molise,305617,332215,108.7,0.59
3116,2021-06-23,MOL,2795,1288,1507,221,2564,10,ITF,ITF2,14,Molise,Molise,305617,335010,109.62,0.91
3117,2021-03-20,MOL,2327,973,1354,995,1323,9,ITF,ITF2,14,Molise,Molise,305617,337337,110.38,0.76
3118,2021-06-28,MOL,2906,1356,1550,999,1886,21,ITF,ITF2,14,Molise,Molise,305617,340243,111.33,0.95
3119,2021-04-01,MOL,1475,668,807,731,730,14,ITF,ITF2,14,Molise,Molise,305617,341718,111.81,0.48
3120,2021-05-23,MOL,1783,896,887,1742,9,32,ITF,ITF2,14,Molise,Molise,305617,343501,112.4,0.58
3121,2021-03-01,MOL,662,274,388,430,215,17,ITF,ITF2,14,Molise,Molise,305617,344163,112.61,0.22
3122,2021-04-03,MOL,1775,853,922,1719,35,21,ITF,ITF2,14,Molise,Molise,305617,345938,113.19,0.58
3123,2021-07-12,MOL,2673,1319,1354,353,2299,21,ITF,ITF2,14,Molise,Molise,305617,348611,114.07,0.87
3124,2021-01-28,MOL,613,217,396,17,596,0,ITF,ITF2,14,Molise,Molise,305617,349224,114.27,0.2
3125,2021-03-12,MOL,1459,637,822,1403,36,20,ITF,ITF2,14,Molise,Molise,305617,350683,114.75,0.48
3126,2021-01-14,MOL,647,239,408,647,0,0,ITF,ITF2,14,Molise,Molise,305617,351330,114.96,0.21
3127,2021-05-26,MOL,1573,709,864,788,755,30,ITF,ITF2,14,Molise,Molise,305617,352903,115.47,0.51
3128,2021-03-30,MOL,2004,858,1146,1471,513,20,ITF,ITF2,14,Molise,Molise,305617,354907,116.13,0.66
3129,2021-02-01,MOL,563,201,362,14,549,0,ITF,ITF2,14,Molise,Molise,305617,355470,116.31,0.18
3130,2021-07-08,MOL,3427,1649,1778,107,3297,23,ITF,ITF2,14,Molise,Molise,305617,358897,117.43,1.12
3131,2021-05-12,MOL,2856,1295,1561,2694,97,65,ITF,ITF2,14,Molise,Molise,305617,361753,118.37,0.93
3132,2021-04-06,MOL,1497,702,795,1132,344,21,ITF,ITF2,14,Molise,Molise,305617,363250,118.86,0.49
3133,2021-02-08,MOL,335,141,194,216,119,0,ITF,ITF2,14,Molise,Molise,305617,363585,118.97,0.11
3134,2021-07-15,MOL,3212,1614,1598,209,2989,14,ITF,ITF2,14,Molise,Molise,305617,366797,120.02,1.05
3135,2021-05-19,MOL,2349,1207,1142,1883,429,37,ITF,ITF2,14,Molise,Molise,305617,369146,120.79,0.77
3136,2021-03-23,MOL,1646,697,949,1413,208,25,ITF,ITF2,14,Molise,Molise,305617,370792,121.33,0.54
3137,2021-07-01,MOL,2666,1297,1369,270,2381,15,ITF,ITF2,14,Molise,Molise,305617,373458,122.2,0.87
3138,2021-07-26,MOL,2423,1250,1173,1249,1114,60,ITF,ITF2,14,Molise,Molise,305617,375881,122.99,0.79
3139,2021-02-15,MOL,144,70,74,141,3,0,ITF,ITF2,14,Molise,Molise,305617,376025,123.04,0.05
3140,2021-02-22,MOL,265,129,136,248,15,2,ITF,ITF2,14,Molise,Molise,305617,376290,123.12,0.09
3141,2020-12-27,MOL,50,20,30,50,0,0,ITF,ITF2,14,Molise,Molise,305617,376340,123.14,0.02
3142,2021-08-08,CAL,4215,2145,2070,1492,2695,28,ITF,ITF6,18,Calabria,Calabria,1947131,4215,0.22,0.22
3143,2021-07-22,CAL,18304,9017,9287,3477,14738,89,ITF,ITF6,18,Calabria,Calabria,1947131,22519,1.16,0.94
3144,2021-04-30,CAL,15089,7400,7689,10543,4471,75,ITF,ITF6,18,Calabria,Calabria,1947131,37608,1.93,0.77
3145,2021-07-01,CAL,12384,5838,6546,5470,6830,84,ITF,ITF6,18,Calabria,Calabria,1947131,49992,2.57,0.64
3146,2021-02-01,CAL,2554,1213,1341,240,2311,3,ITF,ITF6,18,Calabria,Calabria,1947131,52546,2.7,0.13
3147,2021-07-08,CAL,12046,5617,6429,2690,9313,43,ITF,ITF6,18,Calabria,Calabria,1947131,64592,3.32,0.62
3148,2021-05-12,CAL,16468,8035,8433,10832,5541,95,ITF,ITF6,18,Calabria,Calabria,1947131,81060,4.16,0.85
3149,2021-03-09,CAL,6543,3416,3127,5485,991,67,ITF,ITF6,18,Calabria,Calabria,1947131,87603,4.5,0.34
3150,2021-02-20,CAL,1485,780,705,1145,326,14,ITF,ITF6,18,Calabria,Calabria,1947131,89088,4.58,0.08
3151,2021-05-31,CAL,15298,7345,7953,7312,7905,81,ITF,ITF6,18,Calabria,Calabria,1947131,104386,5.36,0.79
3152,2021-08-10,CAL,9776,4909,4867,3605,6072,99,ITF,ITF6,18,Calabria,Calabria,1947131,114162,5.86,0.5
3153,2021-06-14,CAL,14359,6509,7850,9631,4650,78,ITF,ITF6,18,Calabria,Calabria,1947131,128521,6.6,0.74
3154,2021-03-04,CAL,5488,3193,2295,4669,799,20,ITF,ITF6,18,Calabria,Calabria,1947131,134009,6.88,0.28
3155,2021-06-12,CAL,13247,6298,6949,10781,2399,67,ITF,ITF6,18,Calabria,Calabria,1947131,147256,7.56,0.68
3156,2021-07-27,CAL,17580,8987,8593,5016,12482,82,ITF,ITF6,18,Calabria,Calabria,1947131,164836,8.47,0.9
3157,2021-01-06,CAL,947,512,435,947,0,0,ITF,ITF6,18,Calabria,Calabria,1947131,165783,8.51,0.05
3158,2021-04-16,CAL,10301,5032,5269,8623,1625,53,ITF,ITF6,18,Calabria,Calabria,1947131,176084,9.04,0.53
3159,2021-02-18,CAL,1871,864,1007,1620,233,18,ITF,ITF6,18,Calabria,Calabria,1947131,177955,9.14,0.1
3160,2021-08-03,CAL,14075,7108,6967,3896,10108,71,ITF,ITF6,18,Calabria,Calabria,1947131,192030,9.86,0.72
3161,2021-06-21,CAL,15401,7093,8308,7997,7365,39,ITF,ITF6,18,Calabria,Calabria,1947131,207431,10.65,0.79
3162,2021-02-06,CAL,2925,1347,1578,441,2483,1,ITF,ITF6,18,Calabria,Calabria,1947131,210356,10.8,0.15
3163,2021-07-10,CAL,15938,7532,8406,3245,12650,43,ITF,ITF6,18,Calabria,Calabria,1947131,226294,11.62,0.82
3164,2021-01-23,CAL,402,187,215,359,43,0,ITF,ITF6,18,Calabria,Calabria,1947131,226696,11.64,0.02
3165,2021-03-28,CAL,2697,1237,1460,1565,1127,5,ITF,ITF6,18,Calabria,Calabria,1947131,229393,11.78,0.14
3166,2021-04-18,CAL,5867,2803,3064,4928,916,23,ITF,ITF6,18,Calabria,Calabria,1947131,235260,12.08,0.3
3167,2021-04-04,CAL,1574,789,785,1142,421,11,ITF,ITF6,18,Calabria,Calabria,1947131,236834,12.16,0.08
3168,2021-06-26,CAL,15575,7198,8377,7575,7931,69,ITF,ITF6,18,Calabria,Calabria,1947131,252409,12.96,0.8
3169,2021-01-11,CAL,2187,1060,1127,2185,0,2,ITF,ITF6,18,Calabria,Calabria,1947131,254596,13.08,0.11
3170,2021-01-25,CAL,1087,521,566,150,937,0,ITF,ITF6,18,Calabria,Calabria,1947131,255683,13.13,0.06
3171,2021-05-05,CAL,13573,6492,7081,8409,5091,73,ITF,ITF6,18,Calabria,Calabria,1947131,269256,13.83,0.7
3172,2021-03-02,CAL,4405,2498,1907,3615,781,9,ITF,ITF6,18,Calabria,Calabria,1947131,273661,14.05,0.23
3173,2021-03-16,CAL,3864,1895,1969,2183,1669,12,ITF,ITF6,18,Calabria,Calabria,1947131,277525,14.25,0.2
3174,2021-05-26,CAL,18729,9327,9402,10322,8314,93,ITF,ITF6,18,Calabria,Calabria,1947131,296254,15.21,0.96
3175,2021-03-30,CAL,6483,2826,3657,3650,2813,20,ITF,ITF6,18,Calabria,Calabria,1947131,302737,15.55,0.33
3176,2021-05-19,CAL,18315,9076,9239,11258,6984,73,ITF,ITF6,18,Calabria,Calabria,1947131,321052,16.49,0.94
3177,2021-03-23,CAL,5269,2471,2798,3425,1822,22,ITF,ITF6,18,Calabria,Calabria,1947131,326321,16.76,0.27
3178,2021-01-18,CAL,1304,592,712,1053,247,4,ITF,ITF6,18,Calabria,Calabria,1947131,327625,16.83,0.07
3179,2021-07-03,CAL,15168,7143,8025,5273,9818,77,ITF,ITF6,18,Calabria,Calabria,1947131,342793,17.61,0.78
3180,2021-04-11,CAL,4207,1912,2295,2242,1948,17,ITF,ITF6,18,Calabria,Calabria,1947131,347000,17.82,0.22
3181,2021-07-20,CAL,17487,8479,9008,3203,14215,69,ITF,ITF6,18,Calabria,Calabria,1947131,364487,18.72,0.9
3182,2021-03-11,CAL,7288,3467,3821,5951,1289,48,ITF,ITF6,18,Calabria,Calabria,1947131,371775,19.09,0.37
3183,2021-06-19,CAL,15846,7415,8431,8499,7279,68,ITF,ITF6,18,Calabria,Calabria,1947131,387621,19.91,0.81
3184,2021-02-25,CAL,2911,1569,1342,2272,599,40,ITF,ITF6,18,Calabria,Calabria,1947131,390532,20.06,0.15
3185,2021-01-04,CAL,1075,532,543,1072,0,3,ITF,ITF6,18,Calabria,Calabria,1947131,391607,20.11,0.06
3186,2021-04-23,CAL,13137,6452,6685,9437,3604,96,ITF,ITF6,18,Calabria,Calabria,1947131,404744,20.79,0.67
3187,2021-01-13,CAL,2091,1057,1034,2079,0,12,ITF,ITF6,18,Calabria,Calabria,1947131,406835,20.89,0.11
3188,2021-06-23,CAL,17233,7873,9360,8150,9002,81,ITF,ITF6,18,Calabria,Calabria,1947131,424068,21.78,0.89
3189,2021-01-30,CAL,2213,1170,1043,314,1896,3,ITF,ITF6,18,Calabria,Calabria,1947131,426281,21.89,0.11
3190,2021-02-17,CAL,1878,833,1045,1649,212,17,ITF,ITF6,18,Calabria,Calabria,1947131,428159,21.99,0.1
3191,2021-07-24,CAL,18001,9260,8741,4574,13333,94,ITF,ITF6,18,Calabria,Calabria,1947131,446160,22.91,0.92
3192,2021-05-28,CAL,21001,10206,10795,11427,9462,112,ITF,ITF6,18,Calabria,Calabria,1947131,467161,23.99,1.08
3193,2021-04-15,CAL,7772,3813,3959,5980,1746,46,ITF,ITF6,18,Calabria,Calabria,1947131,474933,24.39,0.4
3194,2021-04-01,CAL,8681,3952,4729,4153,4491,37,ITF,ITF6,18,Calabria,Calabria,1947131,483614,24.84,0.45
3195,2021-06-07,CAL,18010,8422,9588,14716,3214,80,ITF,ITF6,18,Calabria,Calabria,1947131,501624,25.76,0.92
3196,2021-05-24,CAL,17769,8901,8868,9935,7752,82,ITF,ITF6,18,Calabria,Calabria,1947131,519393,26.67,0.91
3197,2021-05-07,CAL,16229,7646,8583,9662,6489,78,ITF,ITF6,18,Calabria,Calabria,1947131,535622,27.51,0.83
3198,2021-02-13,CAL,1411,609,802,1041,367,3,ITF,ITF6,18,Calabria,Calabria,1947131,537033,27.58,0.07
3199,2021-07-29,CAL,17586,8764,8822,4717,12768,101,ITF,ITF6,18,Calabria,Calabria,1947131,554619,28.48,0.9
3200,2021-02-11,CAL,2351,1051,1300,1063,1266,22,ITF,ITF6,18,Calabria,Calabria,1947131,556970,28.6,0.12
3201,2021-07-15,CAL,18298,8816,9482,2529,15723,46,ITF,ITF6,18,Calabria,Calabria,1947131,575268,29.54,0.94
3202,2021-02-15,CAL,1176,565,611,1009,162,5,ITF,ITF6,18,Calabria,Calabria,1947131,576444,29.6,0.06
3203,2021-04-13,CAL,6947,3412,3535,5596,1328,23,ITF,ITF6,18,Calabria,Calabria,1947131,583391,29.96,0.36
3204,2021-01-20,CAL,1409,630,779,1405,1,3,ITF,ITF6,18,Calabria,Calabria,1947131,584800,30.03,0.07
3205,2021-01-03,CAL,6,3,3,6,0,0,ITF,ITF6,18,Calabria,Calabria,1947131,584806,30.03,0.0
3206,2021-03-27,CAL,8826,4018,4808,4661,4121,44,ITF,ITF6,18,Calabria,Calabria,1947131,593632,30.49,0.45
3207,2021-07-05,CAL,13395,6259,7136,4282,9055,58,ITF,ITF6,18,Calabria,Calabria,1947131,607027,31.18,0.69
3208,2021-03-08,CAL,5505,2981,2524,4395,1079,31,ITF,ITF6,18,Calabria,Calabria,1947131,612532,31.46,0.28
3209,2021-05-14,CAL,19931,9574,10357,12943,6878,110,ITF,ITF6,18,Calabria,Calabria,1947131,632463,32.48,1.02
3210,2021-04-27,CAL,9971,4904,5067,7962,1961,48,ITF,ITF6,18,Calabria,Calabria,1947131,642434,32.99,0.51
3211,2021-02-03,CAL,2878,1483,1395,542,2331,5,ITF,ITF6,18,Calabria,Calabria,1947131,645312,33.14,0.15
3212,2021-07-19,CAL,18993,9100,9893,3023,15922,48,ITF,ITF6,18,Calabria,Calabria,1947131,664305,34.12,0.98
3213,2021-08-05,CAL,12463,6285,6178,3879,8490,94,ITF,ITF6,18,Calabria,Calabria,1947131,676768,34.76,0.64
3214,2021-03-06,CAL,8518,4387,4131,7687,809,22,ITF,ITF6,18,Calabria,Calabria,1947131,685286,35.19,0.44
3215,2021-05-09,CAL,9663,4509,5154,6049,3571,43,ITF,ITF6,18,Calabria,Calabria,1947131,694949,35.69,0.5
3216,2021-01-29,CAL,2073,1000,1073,226,1846,1,ITF,ITF6,18,Calabria,Calabria,1947131,697022,35.8,0.11
3217,2021-03-13,CAL,6996,3035,3961,5939,1023,34,ITF,ITF6,18,Calabria,Calabria,1947131,704018,36.16,0.36
3218,2021-01-15,CAL,2816,1264,1552,2810,0,6,ITF,ITF6,18,Calabria,Calabria,1947131,706834,36.3,0.14
3219,2021-04-25,CAL,15900,8069,7831,14804,1028,68,ITF,ITF6,18,Calabria,Calabria,1947131,722734,37.12,0.82
3220,2021-05-23,CAL,11390,5552,5838,6997,4350,43,ITF,ITF6,18,Calabria,Calabria,1947131,734124,37.7,0.58
3221,2021-03-01,CAL,2742,1556,1186,2279,459,4,ITF,ITF6,18,Calabria,Calabria,1947131,736866,37.84,0.14
3222,2021-06-09,CAL,18245,8612,9633,15900,2261,84,ITF,ITF6,18,Calabria,Calabria,1947131,755111,38.78,0.94
3223,2021-03-25,CAL,7522,3550,3972,4578,2910,34,ITF,ITF6,18,Calabria,Calabria,1947131,762633,39.17,0.39
3224,2021-06-16,CAL,18333,8472,9861,12124,6119,90,ITF,ITF6,18,Calabria,Calabria,1947131,780966,40.11,0.94
3225,2020-12-27,CAL,316,169,147,316,0,0,ITF,ITF6,18,Calabria,Calabria,1947131,781282,40.12,0.02
3226,2021-04-06,CAL,8160,3717,4443,4463,3668,29,ITF,ITF6,18,Calabria,Calabria,1947131,789442,40.54,0.42
3227,2021-02-08,CAL,1876,746,1130,666,1207,3,ITF,ITF6,18,Calabria,Calabria,1947131,791318,40.64,0.1
3228,2021-04-24,CAL,19287,9597,9690,15756,3446,85,ITF,ITF6,18,Calabria,Calabria,1947131,810605,41.63,0.99
3229,2021-02-26,CAL,3130,1665,1465,2654,461,15,ITF,ITF6,18,Calabria,Calabria,1947131,813735,41.79,0.16
3230,2021-08-02,CAL,15065,7534,7531,3722,11287,56,ITF,ITF6,18,Calabria,Calabria,1947131,828800,42.57,0.77
3231,2021-02-22,CAL,2081,1059,1022,1511,561,9,ITF,ITF6,18,Calabria,Calabria,1947131,830881,42.67,0.11
3232,2021-06-02,CAL,12099,5800,6299,8786,3266,47,ITF,ITF6,18,Calabria,Calabria,1947131,842980,43.29,0.62
3233,2021-08-07,CAL,9466,4842,4624,3018,6384,64,ITF,ITF6,18,Calabria,Calabria,1947131,852446,43.78,0.49
3234,2021-05-16,CAL,13810,6738,7072,9919,3837,54,ITF,ITF6,18,Calabria,Calabria,1947131,866256,44.49,0.71
3235,2021-07-21,CAL,22066,10595,11471,4498,17457,111,ITF,ITF6,18,Calabria,Calabria,1947131,888322,45.62,1.13
3236,2021-01-17,CAL,906,436,470,801,99,6,ITF,ITF6,18,Calabria,Calabria,1947131,889228,45.67,0.05
3237,2021-06-30,CAL,16384,7504,8880,7020,9264,100,ITF,ITF6,18,Calabria,Calabria,1947131,905612,46.51,0.84
3238,2021-06-28,CAL,13304,6124,7180,5380,7857,67,ITF,ITF6,18,Calabria,Calabria,1947131,918916,47.19,0.68
3239,2021-03-20,CAL,6749,3091,3658,4180,2553,16,ITF,ITF6,18,Calabria,Calabria,1947131,925665,47.54,0.35
3240,2021-03-15,CAL,3638,1754,1884,2161,1467,10,ITF,ITF6,18,Calabria,Calabria,1947131,929303,47.73,0.19
3241,2021-05-04,CAL,16493,7607,8886,11642,4759,92,ITF,ITF6,18,Calabria,Calabria,1947131,945796,48.57,0.85
3242,2021-01-22,CAL,660,276,384,658,2,0,ITF,ITF6,18,Calabria,Calabria,1947131,946456,48.61,0.03
3243,2021-05-02,CAL,12546,5858,6688,10589,1896,61,ITF,ITF6,18,Calabria,Calabria,1947131,959002,49.25,0.64
3244,2021-03-29,CAL,5775,2495,3280,3982,1769,24,ITF,ITF6,18,Calabria,Calabria,1947131,964777,49.55,0.3
3245,2021-01-31,CAL,1123,560,563,150,973,0,ITF,ITF6,18,Calabria,Calabria,1947131,965900,49.61,0.06
3246,2021-07-07,CAL,13970,6582,7388,3909,9987,74,ITF,ITF6,18,Calabria,Calabria,1947131,979870,50.32,0.72
3247,2021-05-11,CAL,15112,7317,7795,10242,4800,70,ITF,ITF6,18,Calabria,Calabria,1947131,994982,51.1,0.78
3248,2021-06-11,CAL,17826,8759,9067,15128,2574,124,ITF,ITF6,18,Calabria,Calabria,1947131,1012808,52.02,0.92
3249,2021-01-08,CAL,2192,1046,1146,2185,0,7,ITF,ITF6,18,Calabria,Calabria,1947131,1015000,52.13,0.11
3250,2021-03-18,CAL,4470,2095,2375,2336,2111,23,ITF,ITF6,18,Calabria,Calabria,1947131,1019470,52.36,0.23
3251,2021-02-27,CAL,4035,2077,1958,3645,383,7,ITF,ITF6,18,Calabria,Calabria,1947131,1023505,52.56,0.21
3252,2021-07-31,CAL,13799,7056,6743,3642,10085,72,ITF,ITF6,18,Calabria,Calabria,1947131,1037304,53.27,0.71
3253,2021-06-18,CAL,18887,8797,10090,11267,7505,115,ITF,ITF6,18,Calabria,Calabria,1947131,1056191,54.24,0.97
3254,2021-03-10,CAL,6844,3477,3367,5459,1349,36,ITF,ITF6,18,Calabria,Calabria,1947131,1063035,54.59,0.35
3255,2021-06-01,CAL,12877,5973,6904,7887,4931,59,ITF,ITF6,18,Calabria,Calabria,1947131,1075912,55.26,0.66
3256,2021-05-13,CAL,15971,7686,8285,11180,4719,72,ITF,ITF6,18,Calabria,Calabria,1947131,1091883,56.08,0.82
3257,2021-07-12,CAL,17969,8533,9436,2676,15244,49,ITF,ITF6,18,Calabria,Calabria,1947131,1109852,57.0,0.92
3258,2021-01-10,CAL,948,535,413,948,0,0,ITF,ITF6,18,Calabria,Calabria,1947131,1110800,57.05,0.05
3259,2021-04-20,CAL,7875,3976,3899,6063,1739,73,ITF,ITF6,18,Calabria,Calabria,1947131,1118675,57.45,0.4
3260,2021-02-12,CAL,1721,679,1042,942,773,6,ITF,ITF6,18,Calabria,Calabria,1947131,1120396,57.54,0.09
3261,2021-06-20,CAL,6651,3150,3501,3815,2808,28,ITF,ITF6,18,Calabria,Calabria,1947131,1127047,57.88,0.34
3262,2021-06-06,CAL,13797,6634,7163,12014,1713,70,ITF,ITF6,18,Calabria,Calabria,1947131,1140844,58.59,0.71
3263,2021-01-07,CAL,2213,1084,1129,2209,0,4,ITF,ITF6,18,Calabria,Calabria,1947131,1143057,58.7,0.11
3264,2021-06-13,CAL,6843,3358,3485,5730,1058,55,ITF,ITF6,18,Calabria,Calabria,1947131,1149900,59.06,0.35
3265,2021-04-17,CAL,10846,5074,5772,9012,1785,49,ITF,ITF6,18,Calabria,Calabria,1947131,1160746,59.61,0.56
3266,2021-05-01,CAL,16741,7977,8764,12408,4246,87,ITF,ITF6,18,Calabria,Calabria,1947131,1177487,60.47,0.86
3267,2021-03-24,CAL,7881,3612,4269,4522,3336,23,ITF,ITF6,18,Calabria,Calabria,1947131,1185368,60.88,0.4
3268,2021-04-10,CAL,11711,5304,6407,6803,4862,46,ITF,ITF6,18,Calabria,Calabria,1947131,1197079,61.48,0.6
3269,2021-02-05,CAL,3858,1742,2116,473,3370,15,ITF,ITF6,18,Calabria,Calabria,1947131,1200937,61.68,0.2
3270,2021-04-29,CAL,12503,6080,6423,8660,3788,55,ITF,ITF6,18,Calabria,Calabria,1947131,1213440,62.32,0.64
3271,2021-07-16,CAL,21043,10027,11016,3383,17590,70,ITF,ITF6,18,Calabria,Calabria,1947131,1234483,63.4,1.08
3272,2021-01-24,CAL,46,19,27,40,6,0,ITF,ITF6,18,Calabria,Calabria,1947131,1234529,63.4,0.0
3273,2021-07-09,CAL,15670,7304,8366,3636,11965,69,ITF,ITF6,18,Calabria,Calabria,1947131,1250199,64.21,0.8
3274,2021-07-02,CAL,16266,7528,8738,6245,9939,82,ITF,ITF6,18,Calabria,Calabria,1947131,1266465,65.04,0.84
3275,2021-05-20,CAL,16985,8497,8488,11268,5650,67,ITF,ITF6,18,Calabria,Calabria,1947131,1283450,65.91,0.87
3276,2021-02-07,CAL,868,432,436,143,723,2,ITF,ITF6,18,Calabria,Calabria,1947131,1284318,65.96,0.04
3277,2021-05-18,CAL,15340,7674,7666,11851,3421,68,ITF,ITF6,18,Calabria,Calabria,1947131,1299658,66.75,0.79
3278,2021-03-22,CAL,4985,2343,2642,3181,1779,25,ITF,ITF6,18,Calabria,Calabria,1947131,1304643,67.0,0.26
3279,2021-02-19,CAL,1515,685,830,1242,264,9,ITF,ITF6,18,Calabria,Calabria,1947131,1306158,67.08,0.08
3280,2021-05-30,CAL,10994,5297,5697,6806,4153,35,ITF,ITF6,18,Calabria,Calabria,1947131,1317152,67.65,0.56
3281,2021-05-17,CAL,14914,7467,7447,10146,4716,52,ITF,ITF6,18,Calabria,Calabria,1947131,1332066,68.41,0.77
3282,2021-01-27,CAL,1483,750,733,388,1094,1,ITF,ITF6,18,Calabria,Calabria,1947131,1333549,68.49,0.08
3283,2021-02-14,CAL,487,225,262,451,35,1,ITF,ITF6,18,Calabria,Calabria,1947131,1334036,68.51,0.03
3284,2021-05-25,CAL,16418,8039,8379,10219,6112,87,ITF,ITF6,18,Calabria,Calabria,1947131,1350454,69.36,0.84
3285,2021-06-27,CAL,8422,3945,4477,4987,3395,40,ITF,ITF6,18,Calabria,Calabria,1947131,1358876,69.79,0.43
3286,2021-04-03,CAL,9434,4077,5357,4520,4853,61,ITF,ITF6,18,Calabria,Calabria,1947131,1368310,70.27,0.48
3287,2021-03-05,CAL,6243,3624,2619,5649,578,16,ITF,ITF6,18,Calabria,Calabria,1947131,1374553,70.59,0.32
3288,2021-08-09,CAL,13152,6704,6448,4632,8359,161,ITF,ITF6,18,Calabria,Calabria,1947131,1387705,71.27,0.68
3289,2021-07-26,CAL,18696,9294,9402,5170,13438,88,ITF,ITF6,18,Calabria,Calabria,1947131,1406401,72.23,0.96
3290,2021-03-12,CAL,5157,2469,2688,4075,1062,20,ITF,ITF6,18,Calabria,Calabria,1947131,1411558,72.49,0.26
3291,2021-01-14,CAL,2663,1264,1399,2657,0,6,ITF,ITF6,18,Calabria,Calabria,1947131,1414221,72.63,0.14
3292,2021-04-12,CAL,7031,3422,3609,5351,1656,24,ITF,ITF6,18,Calabria,Calabria,1947131,1421252,72.99,0.36
3293,2021-01-19,CAL,1131,499,632,1116,13,2,ITF,ITF6,18,Calabria,Calabria,1947131,1422383,73.05,0.06
3294,2021-07-04,CAL,5947,2818,3129,1989,3922,36,ITF,ITF6,18,Calabria,Calabria,1947131,1428330,73.36,0.31
3295,2021-06-17,CAL,15820,7228,8592,9597,6169,54,ITF,ITF6,18,Calabria,Calabria,1947131,1444150,74.17,0.81
3296,2021-03-26,CAL,8104,3846,4258,4944,3131,29,ITF,ITF6,18,Calabria,Calabria,1947131,1452254,74.58,0.42
3297,2020-12-28,CAL,6,2,4,6,0,0,ITF,ITF6,18,Calabria,Calabria,1947131,1452260,74.58,0.0
3298,2021-06-03,CAL,14249,6654,7595,9591,4603,55,ITF,ITF6,18,Calabria,Calabria,1947131,1466509,75.32,0.73
3299,2021-04-07,CAL,9163,4166,4997,5049,4063,51,ITF,ITF6,18,Calabria,Calabria,1947131,1475672,75.79,0.47
3300,2021-02-23,CAL,1608,760,848,1485,118,5,ITF,ITF6,18,Calabria,Calabria,1947131,1477280,75.87,0.08
3301,2021-02-09,CAL,2170,917,1253,950,1211,9,ITF,ITF6,18,Calabria,Calabria,1947131,1479450,75.98,0.11
3302,2021-05-29,CAL,19289,8957,10332,9352,9861,76,ITF,ITF6,18,Calabria,Calabria,1947131,1498739,76.97,0.99
3303,2021-01-26,CAL,1884,902,982,271,1612,1,ITF,ITF6,18,Calabria,Calabria,1947131,1500623,77.07,0.1
3304,2021-07-28,CAL,21373,10728,10645,5892,15372,109,ITF,ITF6,18,Calabria,Calabria,1947131,1521996,78.17,1.1
3305,2021-04-22,CAL,9824,4912,4912,6851,2922,51,ITF,ITF6,18,Calabria,Calabria,1947131,1531820,78.67,0.5
3306,2021-05-06,CAL,13318,6307,7011,8931,4315,72,ITF,ITF6,18,Calabria,Calabria,1947131,1545138,79.35,0.68
3307,2021-07-14,CAL,22619,10668,11951,4150,18392,77,ITF,ITF6,18,Calabria,Calabria,1947131,1567757,80.52,1.16
3308,2021-04-05,CAL,3644,1729,1915,2673,959,12,ITF,ITF6,18,Calabria,Calabria,1947131,1571401,80.7,0.19
3309,2021-02-21,CAL,647,300,347,567,79,1,ITF,ITF6,18,Calabria,Calabria,1947131,1572048,80.74,0.03
3310,2021-04-28,CAL,12575,6098,6477,9627,2876,72,ITF,ITF6,18,Calabria,Calabria,1947131,1584623,81.38,0.65
3311,2021-02-04,CAL,3667,1744,1923,646,3015,6,ITF,ITF6,18,Calabria,Calabria,1947131,1588290,81.57,0.19
3312,2021-05-15,CAL,27264,13045,14219,20264,6865,135,ITF,ITF6,18,Calabria,Calabria,1947131,1615554,82.97,1.4
3313,2021-08-06,CAL,15609,7926,7683,5082,10400,127,ITF,ITF6,18,Calabria,Calabria,1947131,1631163,83.77,0.8
3314,2021-02-02,CAL,2372,1169,1203,176,2196,0,ITF,ITF6,18,Calabria,Calabria,1947131,1633535,83.89,0.12
3315,2021-01-16,CAL,2415,1133,1282,2412,0,3,ITF,ITF6,18,Calabria,Calabria,1947131,1635950,84.02,0.12
3316,2021-01-28,CAL,2292,1138,1154,80,2212,0,ITF,ITF6,18,Calabria,Calabria,1947131,1638242,84.14,0.12
3317,2021-05-08,CAL,18524,8420,10104,10522,7933,69,ITF,ITF6,18,Calabria,Calabria,1947131,1656766,85.09,0.95
3318,2021-05-22,CAL,22198,10564,11634,14213,7894,91,ITF,ITF6,18,Calabria,Calabria,1947131,1678964,86.23,1.14
3319,2021-04-21,CAL,11594,5825,5769,8620,2917,57,ITF,ITF6,18,Calabria,Calabria,1947131,1690558,86.82,0.6
3320,2021-07-30,CAL,19721,10053,9668,5517,14083,121,ITF,ITF6,18,Calabria,Calabria,1947131,1710279,87.84,1.01
3321,2021-04-02,CAL,8535,3910,4625,4575,3927,33,ITF,ITF6,18,Calabria,Calabria,1947131,1718814,88.27,0.44
3322,2021-01-21,CAL,981,459,522,945,33,3,ITF,ITF6,18,Calabria,Calabria,1947131,1719795,88.32,0.05
3323,2021-07-06,CAL,12498,5757,6741,3834,8597,67,ITF,ITF6,18,Calabria,Calabria,1947131,1732293,88.97,0.64
3324,2021-01-02,CAL,166,94,72,166,0,0,ITF,ITF6,18,Calabria,Calabria,1947131,1732459,88.97,0.01
3325,2021-03-31,CAL,9151,4179,4972,5065,4052,34,ITF,ITF6,18,Calabria,Calabria,1947131,1741610,89.44,0.47
3326,2021-04-09,CAL,8005,3756,4249,5031,2892,82,ITF,ITF6,18,Calabria,Calabria,1947131,1749615,89.86,0.41
3327,2021-07-18,CAL,8784,4205,4579,1275,7477,32,ITF,ITF6,18,Calabria,Calabria,1947131,1758399,90.31,0.45
3328,2021-06-05,CAL,20738,9702,11036,17623,3036,79,ITF,ITF6,18,Calabria,Calabria,1947131,1779137,91.37,1.07
3329,2021-06-08,CAL,16686,7904,8782,14522,2041,123,ITF,ITF6,18,Calabria,Calabria,1947131,1795823,92.23,0.86
3330,2021-03-17,CAL,4169,1863,2306,2190,1969,10,ITF,ITF6,18,Calabria,Calabria,1947131,1799992,92.44,0.21
3331,2021-06-25,CAL,18833,8747,10086,8079,10671,83,ITF,ITF6,18,Calabria,Calabria,1947131,1818825,93.41,0.97
3332,2021-07-13,CAL,17429,8155,9274,2311,15050,68,ITF,ITF6,18,Calabria,Calabria,1947131,1836254,94.31,0.9
3333,2021-07-25,CAL,6949,3571,3378,1469,5448,32,ITF,ITF6,18,Calabria,Calabria,1947131,1843203,94.66,0.36
3334,2021-04-14,CAL,8084,3903,4181,6586,1451,47,ITF,ITF6,18,Calabria,Calabria,1947131,1851287,95.08,0.42
3335,2021-02-16,CAL,1750,744,1006,1463,282,5,ITF,ITF6,18,Calabria,Calabria,1947131,1853037,95.17,0.09
3336,2021-07-23,CAL,22680,11314,11366,5549,17036,95,ITF,ITF6,18,Calabria,Calabria,1947131,1875717,96.33,1.16
3337,2021-05-27,CAL,17662,8732,8930,9774,7805,83,ITF,ITF6,18,Calabria,Calabria,1947131,1893379,97.24,0.91
3338,2021-08-01,CAL,4894,2562,2332,1172,3698,24,ITF,ITF6,18,Calabria,Calabria,1947131,1898273,97.49,0.25
3339,2021-06-24,CAL,15401,7017,8384,6977,8343,81,ITF,ITF6,18,Calabria,Calabria,1947131,1913674,98.28,0.79
3340,2021-03-19,CAL,4229,1975,2254,1887,2335,7,ITF,ITF6,18,Calabria,Calabria,1947131,1917903,98.5,0.22
3341,2021-07-11,CAL,6427,2982,3445,844,5573,10,ITF,ITF6,18,Calabria,Calabria,1947131,1924330,98.83,0.33
3342,2021-06-10,CAL,15892,7330,8562,12986,2805,101,ITF,ITF6,18,Calabria,Calabria,1947131,1940222,99.65,0.82
3343,2021-04-19,CAL,7889,3809,4080,6160,1682,47,ITF,ITF6,18,Calabria,Calabria,1947131,1948111,100.05,0.41
3344,2021-01-09,CAL,2048,1101,947,2040,0,8,ITF,ITF6,18,Calabria,Calabria,1947131,1950159,100.16,0.11
3345,2021-02-28,CAL,2353,1072,1281,2196,154,3,ITF,ITF6,18,Calabria,Calabria,1947131,1952512,100.28,0.12
3346,2021-04-08,CAL,9337,4420,4917,5816,3475,46,ITF,ITF6,18,Calabria,Calabria,1947131,1961849,100.76,0.48
3347,2021-02-10,CAL,2522,1084,1438,873,1634,15,ITF,ITF6,18,Calabria,Calabria,1947131,1964371,100.89,0.13
3348,2021-07-17,CAL,18333,9044,9289,2713,15555,65,ITF,ITF6,18,Calabria,Calabria,1947131,1982704,101.83,0.94
3349,2021-06-04,CAL,17537,8156,9381,12957,4511,69,ITF,ITF6,18,Calabria,Calabria,1947131,2000241,102.73,0.9
3350,2021-05-21,CAL,21351,10873,10478,13854,7386,111,ITF,ITF6,18,Calabria,Calabria,1947131,2021592,103.82,1.1
3351,2021-01-05,CAL,1541,724,817,1539,0,2,ITF,ITF6,18,Calabria,Calabria,1947131,2023133,103.9,0.08
3352,2021-01-12,CAL,2087,1032,1055,2078,0,9,ITF,ITF6,18,Calabria,Calabria,1947131,2025220,104.01,0.11
3353,2021-02-24,CAL,1938,986,952,1452,480,6,ITF,ITF6,18,Calabria,Calabria,1947131,2027158,104.11,0.1
3354,2021-03-03,CAL,5089,2780,2309,3988,1088,13,ITF,ITF6,18,Calabria,Calabria,1947131,2032247,104.37,0.26
3355,2021-08-04,CAL,16003,8111,7892,4254,11649,100,ITF,ITF6,18,Calabria,Calabria,1947131,2048250,105.19,0.82
3356,2021-06-29,CAL,13070,6041,7029,5361,7658,51,ITF,ITF6,18,Calabria,Calabria,1947131,2061320,105.86,0.67
3357,2021-05-03,CAL,14837,6799,8038,10466,4283,88,ITF,ITF6,18,Calabria,Calabria,1947131,2076157,106.63,0.76
3358,2021-03-21,CAL,4458,1925,2533,2729,1718,11,ITF,ITF6,18,Calabria,Calabria,1947131,2080615,106.86,0.23
3359,2021-03-07,CAL,3405,1738,1667,3299,92,14,ITF,ITF6,18,Calabria,Calabria,1947131,2084020,107.03,0.17
3360,2021-08-11,CAL,7311,3760,3551,2112,5129,70,ITF,ITF6,18,Calabria,Calabria,1947131,2091331,107.41,0.38
3361,2021-06-15,CAL,15168,7056,8112,10238,4837,93,ITF,ITF6,18,Calabria,Calabria,1947131,2106499,108.18,0.78
3362,2021-03-14,CAL,2746,1065,1681,2281,458,7,ITF,ITF6,18,Calabria,Calabria,1947131,2109245,108.33,0.14
3363,2021-06-22,CAL,14623,6915,7708,7382,7145,96,ITF,ITF6,18,Calabria,Calabria,1947131,2123868,109.08,0.75
3364,2021-05-10,CAL,13169,6126,7043,7703,5409,57,ITF,ITF6,18,Calabria,Calabria,1947131,2137037,109.75,0.68
3365,2021-04-26,CAL,10192,5061,5131,7716,2429,47,ITF,ITF6,18,Calabria,Calabria,1947131,2147229,110.28,0.52
3366,2021-05-24,PIE,28986,13421,15565,16635,11970,381,ITC,ITC1,1,Piemonte,Piemonte,4356406,28986,0.67,0.67
3367,2021-03-02,PIE,11249,4550,6699,10247,813,189,ITC,ITC1,1,Piemonte,Piemonte,4356406,40235,0.92,0.26
3368,2021-02-11,PIE,6761,2105,4656,2982,3760,19,ITC,ITC1,1,Piemonte,Piemonte,4356406,46996,1.08,0.16
3369,2021-04-09,PIE,25874,11392,14482,20805,4503,566,ITC,ITC1,1,Piemonte,Piemonte,4356406,72870,1.67,0.59
3370,2020-12-30,PIE,732,322,410,732,0,0,ITC,ITC1,1,Piemonte,Piemonte,4356406,73602,1.69,0.02
3371,2021-06-05,PIE,36940,18922,18018,31857,4456,627,ITC,ITC1,1,Piemonte,Piemonte,4356406,110542,2.54,0.85
3372,2021-02-25,PIE,12211,5246,6965,11486,544,181,ITC,ITC1,1,Piemonte,Piemonte,4356406,122753,2.82,0.28
3373,2021-07-15,PIE,42477,21966,20511,4067,37952,458,ITC,ITC1,1,Piemonte,Piemonte,4356406,165230,3.79,0.98
3374,2021-08-01,PIE,27076,14341,12735,8402,18259,415,ITC,ITC1,1,Piemonte,Piemonte,4356406,192306,4.41,0.62
3375,2021-04-23,PIE,27435,12602,14833,19980,6765,690,ITC,ITC1,1,Piemonte,Piemonte,4356406,219741,5.04,0.63
3376,2021-03-23,PIE,13187,5558,7629,6628,6244,315,ITC,ITC1,1,Piemonte,Piemonte,4356406,232928,5.35,0.3
3377,2021-01-16,PIE,7762,2624,5138,7755,0,7,ITC,ITC1,1,Piemonte,Piemonte,4356406,240690,5.52,0.18
3378,2021-07-08,PIE,40957,20948,20009,7435,32960,562,ITC,ITC1,1,Piemonte,Piemonte,4356406,281647,6.47,0.94
3379,2021-05-19,PIE,33109,15281,17828,21398,11128,583,ITC,ITC1,1,Piemonte,Piemonte,4356406,314756,7.23,0.76
3380,2021-03-14,PIE,8204,3337,4867,5171,2897,136,ITC,ITC1,1,Piemonte,Piemonte,4356406,322960,7.41,0.19
3381,2021-05-10,PIE,29018,14002,15016,15277,13130,611,ITC,ITC1,1,Piemonte,Piemonte,4356406,351978,8.08,0.67
3382,2021-01-30,PIE,5985,2138,3847,216,5768,1,ITC,ITC1,1,Piemonte,Piemonte,4356406,357963,8.22,0.14
3383,2021-06-24,PIE,39198,19676,19522,18295,20314,589,ITC,ITC1,1,Piemonte,Piemonte,4356406,397161,9.12,0.9
3384,2021-03-16,PIE,10517,4271,6246,4368,6057,92,ITC,ITC1,1,Piemonte,Piemonte,4356406,407678,9.36,0.24
3385,2021-05-12,PIE,31894,15191,16703,18358,12916,620,ITC,ITC1,1,Piemonte,Piemonte,4356406,439572,10.09,0.73
3386,2021-06-07,PIE,34906,17867,17039,29496,4799,611,ITC,ITC1,1,Piemonte,Piemonte,4356406,474478,10.89,0.8
3387,2021-08-03,PIE,30063,15734,14329,9290,20350,423,ITC,ITC1,1,Piemonte,Piemonte,4356406,504541,11.58,0.69
3388,2021-07-06,PIE,38277,19385,18892,8643,29097,537,ITC,ITC1,1,Piemonte,Piemonte,4356406,542818,12.46,0.88
3389,2021-03-28,PIE,16060,6896,9164,8114,7618,328,ITC,ITC1,1,Piemonte,Piemonte,4356406,558878,12.83,0.37
3390,2021-07-20,PIE,38897,20453,18444,5721,32608,568,ITC,ITC1,1,Piemonte,Piemonte,4356406,597775,13.72,0.89
3391,2021-04-11,PIE,20829,9320,11509,18219,2150,460,ITC,ITC1,1,Piemonte,Piemonte,4356406,618604,14.2,0.48
3392,2021-01-04,PIE,5562,1678,3884,5561,0,1,ITC,ITC1,1,Piemonte,Piemonte,4356406,624166,14.33,0.13
3393,2021-04-28,PIE,26051,11742,14309,15463,10050,538,ITC,ITC1,1,Piemonte,Piemonte,4356406,650217,14.93,0.6
3394,2021-01-18,PIE,6166,2046,4120,5913,249,4,ITC,ITC1,1,Piemonte,Piemonte,4356406,656383,15.07,0.14
3395,2021-06-19,PIE,40063,20321,19742,22860,16660,543,ITC,ITC1,1,Piemonte,Piemonte,4356406,696446,15.99,0.92
3396,2021-02-04,PIE,10207,3342,6865,581,9624,2,ITC,ITC1,1,Piemonte,Piemonte,4356406,706653,16.22,0.23
3397,2021-04-02,PIE,20152,8322,11830,11329,8428,395,ITC,ITC1,1,Piemonte,Piemonte,4356406,726805,16.68,0.46
3398,2021-05-29,PIE,32806,15233,17573,20275,12173,358,ITC,ITC1,1,Piemonte,Piemonte,4356406,759611,17.44,0.75
3399,2021-02-18,PIE,4793,2097,2696,4278,429,86,ITC,ITC1,1,Piemonte,Piemonte,4356406,764404,17.55,0.11
3400,2021-07-25,PIE,28623,15192,13431,6566,21562,495,ITC,ITC1,1,Piemonte,Piemonte,4356406,793027,18.2,0.66
3401,2021-04-16,PIE,28407,13210,15197,22657,4995,755,ITC,ITC1,1,Piemonte,Piemonte,4356406,821434,18.86,0.65
3402,2021-06-12,PIE,42599,22458,20141,39195,2627,777,ITC,ITC1,1,Piemonte,Piemonte,4356406,864033,19.83,0.98
3403,2021-07-12,PIE,39170,20206,18964,4547,34156,467,ITC,ITC1,1,Piemonte,Piemonte,4356406,903203,20.73,0.9
3404,2021-07-29,PIE,36520,18978,17542,9306,26569,645,ITC,ITC1,1,Piemonte,Piemonte,4356406,939723,21.57,0.84
3405,2021-04-20,PIE,25488,11671,13817,18523,6347,618,ITC,ITC1,1,Piemonte,Piemonte,4356406,965211,22.16,0.59
3406,2021-06-26,PIE,41168,20948,20220,21923,18548,697,ITC,ITC1,1,Piemonte,Piemonte,4356406,1006379,23.1,0.94
3407,2021-07-13,PIE,38839,20041,18798,3652,34854,333,ITC,ITC1,1,Piemonte,Piemonte,4356406,1045218,23.99,0.89
3408,2021-04-04,PIE,9252,4057,5195,6391,2710,151,ITC,ITC1,1,Piemonte,Piemonte,4356406,1054470,24.21,0.21
3409,2021-04-21,PIE,25750,11836,13914,19737,5353,660,ITC,ITC1,1,Piemonte,Piemonte,4356406,1080220,24.8,0.59
3410,2021-01-11,PIE,8739,2978,5761,8733,0,6,ITC,ITC1,1,Piemonte,Piemonte,4356406,1088959,25.0,0.2
3411,2021-06-28,PIE,38408,19075,19333,15107,22724,577,ITC,ITC1,1,Piemonte,Piemonte,4356406,1127367,25.88,0.88
3412,2021-01-23,PIE,4257,1326,2931,878,3377,2,ITC,ITC1,1,Piemonte,Piemonte,4356406,1131624,25.98,0.1
3413,2021-03-21,PIE,10726,4740,5986,4022,6534,170,ITC,ITC1,1,Piemonte,Piemonte,4356406,1142350,26.22,0.25
3414,2021-05-05,PIE,32269,15171,17098,18588,13065,616,ITC,ITC1,1,Piemonte,Piemonte,4356406,1174619,26.96,0.74
3415,2021-07-01,PIE,41885,20968,20917,19765,21124,996,ITC,ITC1,1,Piemonte,Piemonte,4356406,1216504,27.92,0.96
3416,2021-02-08,PIE,6917,2354,4563,661,6252,4,ITC,ITC1,1,Piemonte,Piemonte,4356406,1223421,28.08,0.16
3417,2020-12-28,PIE,1,1,0,1,0,0,ITC,ITC1,1,Piemonte,Piemonte,4356406,1223422,28.08,0.0
3418,2021-07-27,PIE,33547,17530,16017,8212,24779,556,ITC,ITC1,1,Piemonte,Piemonte,4356406,1256969,28.85,0.77
3419,2021-05-02,PIE,25139,11287,13852,14003,10745,391,ITC,ITC1,1,Piemonte,Piemonte,4356406,1282108,29.43,0.58
3420,2021-05-17,PIE,30956,14622,16334,17366,13186,404,ITC,ITC1,1,Piemonte,Piemonte,4356406,1313064,30.14,0.71
3421,2021-02-06,PIE,7995,2665,5330,396,7597,2,ITC,ITC1,1,Piemonte,Piemonte,4356406,1321059,30.32,0.18
3422,2021-02-23,PIE,9239,3718,5521,8481,584,174,ITC,ITC1,1,Piemonte,Piemonte,4356406,1330298,30.54,0.21
3423,2021-05-31,PIE,29120,14065,15055,20131,8581,408,ITC,ITC1,1,Piemonte,Piemonte,4356406,1359418,31.21,0.67
3424,2021-06-17,PIE,41102,20637,20465,24157,16334,611,ITC,ITC1,1,Piemonte,Piemonte,4356406,1400520,32.15,0.94
3425,2021-03-09,PIE,14211,5653,8558,11640,2342,229,ITC,ITC1,1,Piemonte,Piemonte,4356406,1414731,32.47,0.33
3426,2021-08-08,PIE,20201,10801,9400,8993,10903,305,ITC,ITC1,1,Piemonte,Piemonte,4356406,1434932,32.94,0.46
3427,2021-04-30,PIE,31839,14324,17515,17830,13334,675,ITC,ITC1,1,Piemonte,Piemonte,4356406,1466771,33.67,0.73
3428,2021-06-02,PIE,26536,13002,13534,21625,4470,441,ITC,ITC1,1,Piemonte,Piemonte,4356406,1493307,34.28,0.61
3429,2021-02-22,PIE,8481,3470,5011,7790,589,102,ITC,ITC1,1,Piemonte,Piemonte,4356406,1501788,34.47,0.19
3430,2021-01-13,PIE,10077,3226,6851,10068,0,9,ITC,ITC1,1,Piemonte,Piemonte,4356406,1511865,34.7,0.23
3431,2021-06-16,PIE,40387,20243,20144,23515,16256,616,ITC,ITC1,1,Piemonte,Piemonte,4356406,1552252,35.63,0.93
3432,2021-01-06,PIE,3107,1103,2004,3106,0,1,ITC,ITC1,1,Piemonte,Piemonte,4356406,1555359,35.7,0.07
3433,2021-05-07,PIE,33099,15662,17437,18362,14131,606,ITC,ITC1,1,Piemonte,Piemonte,4356406,1588458,36.46,0.76
3434,2021-01-27,PIE,4194,1451,2743,994,3198,2,ITC,ITC1,1,Piemonte,Piemonte,4356406,1592652,36.56,0.1
3435,2021-02-13,PIE,4156,1338,2818,2917,1224,15,ITC,ITC1,1,Piemonte,Piemonte,4356406,1596808,36.65,0.1
3436,2021-07-31,PIE,35600,18930,16670,10729,24580,291,ITC,ITC1,1,Piemonte,Piemonte,4356406,1632408,37.47,0.82
3437,2021-05-09,PIE,27151,12931,14220,13148,13620,383,ITC,ITC1,1,Piemonte,Piemonte,4356406,1659559,38.09,0.62
3438,2021-05-26,PIE,32756,15106,17650,15315,17087,354,ITC,ITC1,1,Piemonte,Piemonte,4356406,1692315,38.85,0.75
3439,2021-02-15,PIE,4426,1597,2829,3198,1205,23,ITC,ITC1,1,Piemonte,Piemonte,4356406,1696741,38.95,0.1
3440,2021-03-04,PIE,14637,5860,8777,11475,2942,220,ITC,ITC1,1,Piemonte,Piemonte,4356406,1711378,39.28,0.34
3441,2021-04-06,PIE,20249,8814,11435,14600,5200,449,ITC,ITC1,1,Piemonte,Piemonte,4356406,1731627,39.75,0.46
3442,2020-12-27,PIE,913,369,544,913,0,0,ITC,ITC1,1,Piemonte,Piemonte,4356406,1732540,39.77,0.02
3443,2021-06-09,PIE,38592,20346,18246,35107,2715,770,ITC,ITC1,1,Piemonte,Piemonte,4356406,1771132,40.66,0.89
3444,2021-07-03,PIE,40053,20111,19942,15304,24029,720,ITC,ITC1,1,Piemonte,Piemonte,4356406,1811185,41.58,0.92
3445,2021-03-30,PIE,16983,7113,9870,8724,7871,388,ITC,ITC1,1,Piemonte,Piemonte,4356406,1828168,41.97,0.39
3446,2021-05-21,PIE,36171,16797,19374,20015,15641,515,ITC,ITC1,1,Piemonte,Piemonte,4356406,1864339,42.8,0.83
3447,2021-07-17,PIE,41913,22070,19843,4931,36494,488,ITC,ITC1,1,Piemonte,Piemonte,4356406,1906252,43.76,0.96
3448,2021-02-01,PIE,8655,3052,5603,575,8079,1,ITC,ITC1,1,Piemonte,Piemonte,4356406,1914907,43.96,0.2
3449,2021-03-11,PIE,13904,5207,8697,10561,3095,248,ITC,ITC1,1,Piemonte,Piemonte,4356406,1928811,44.28,0.32
3450,2021-03-25,PIE,17130,7268,9862,8058,8634,438,ITC,ITC1,1,Piemonte,Piemonte,4356406,1945941,44.67,0.39
3451,2021-07-22,PIE,41266,21718,19548,6965,33708,593,ITC,ITC1,1,Piemonte,Piemonte,4356406,1987207,45.62,0.95
3452,2021-04-13,PIE,25946,11618,14328,21831,3461,654,ITC,ITC1,1,Piemonte,Piemonte,4356406,2013153,46.21,0.6
3453,2021-01-20,PIE,6602,2084,4518,5882,713,7,ITC,ITC1,1,Piemonte,Piemonte,4356406,2019755,46.36,0.15
3454,2021-06-25,PIE,45502,22674,22828,20273,24540,689,ITC,ITC1,1,Piemonte,Piemonte,4356406,2065257,47.41,1.04
3455,2021-04-03,PIE,19458,8185,11273,10595,8556,307,ITC,ITC1,1,Piemonte,Piemonte,4356406,2084715,47.85,0.45
3456,2021-01-10,PIE,5206,2272,2934,5204,0,2,ITC,ITC1,1,Piemonte,Piemonte,4356406,2089921,47.97,0.12
3457,2021-08-05,PIE,30215,16035,14180,11217,18508,490,ITC,ITC1,1,Piemonte,Piemonte,4356406,2120136,48.67,0.69
3458,2021-06-23,PIE,39716,19726,19990,16385,22841,490,ITC,ITC1,1,Piemonte,Piemonte,4356406,2159852,49.58,0.91
3459,2021-03-18,PIE,11763,4806,6957,3836,7735,192,ITC,ITC1,1,Piemonte,Piemonte,4356406,2171615,49.85,0.27
3460,2021-03-03,PIE,12258,4772,7486,11249,819,190,ITC,ITC1,1,Piemonte,Piemonte,4356406,2183873,50.13,0.28
3461,2021-03-20,PIE,11919,4897,7022,5777,5898,244,ITC,ITC1,1,Piemonte,Piemonte,4356406,2195792,50.4,0.27
3462,2021-05-14,PIE,33428,16284,17144,17336,15431,661,ITC,ITC1,1,Piemonte,Piemonte,4356406,2229220,51.17,0.77
3463,2021-07-10,PIE,41148,20850,20298,6705,33911,532,ITC,ITC1,1,Piemonte,Piemonte,4356406,2270368,52.12,0.94
3464,2021-04-01,PIE,19379,8111,11268,10940,8126,313,ITC,ITC1,1,Piemonte,Piemonte,4356406,2289747,52.56,0.44
3465,2021-05-28,PIE,35062,16609,18453,18659,15993,410,ITC,ITC1,1,Piemonte,Piemonte,4356406,2324809,53.37,0.8
3466,2021-01-25,PIE,6211,1935,4276,973,5236,2,ITC,ITC1,1,Piemonte,Piemonte,4356406,2331020,53.51,0.14
3467,2021-01-01,PIE,1039,396,643,1038,0,1,ITC,ITC1,1,Piemonte,Piemonte,4356406,2332059,53.53,0.02
3468,2021-07-05,PIE,35573,17795,17778,11684,23217,672,ITC,ITC1,1,Piemonte,Piemonte,4356406,2367632,54.35,0.82
3469,2021-07-14,PIE,38964,20048,18916,3573,34967,424,ITC,ITC1,1,Piemonte,Piemonte,4356406,2406596,55.24,0.89
3470,2021-04-22,PIE,27667,12744,14923,20194,6691,782,ITC,ITC1,1,Piemonte,Piemonte,4356406,2434263,55.88,0.64
3471,2021-01-12,PIE,10078,3410,6668,10072,0,6,ITC,ITC1,1,Piemonte,Piemonte,4356406,2444341,56.11,0.23
3472,2021-01-29,PIE,5940,1885,4055,452,5488,0,ITC,ITC1,1,Piemonte,Piemonte,4356406,2450281,56.25,0.14
3473,2021-02-03,PIE,10205,3306,6899,607,9596,2,ITC,ITC1,1,Piemonte,Piemonte,4356406,2460486,56.48,0.23
3474,2021-08-09,PIE,24593,12838,11755,11995,11957,641,ITC,ITC1,1,Piemonte,Piemonte,4356406,2485079,57.04,0.56
3475,2021-05-18,PIE,32157,14846,17311,19045,12674,438,ITC,ITC1,1,Piemonte,Piemonte,4356406,2517236,57.78,0.74
3476,2021-03-08,PIE,14133,5464,8669,11190,2708,235,ITC,ITC1,1,Piemonte,Piemonte,4356406,2531369,58.11,0.32
3477,2021-05-04,PIE,28743,13239,15504,15899,12334,510,ITC,ITC1,1,Piemonte,Piemonte,4356406,2560112,58.77,0.66
3478,2021-01-24,PIE,3154,959,2195,432,2720,2,ITC,ITC1,1,Piemonte,Piemonte,4356406,2563266,58.84,0.07
3479,2021-06-30,PIE,41250,20172,21078,18438,21949,863,ITC,ITC1,1,Piemonte,Piemonte,4356406,2604516,59.79,0.95
3480,2021-03-22,PIE,11530,4894,6636,3716,7601,213,ITC,ITC1,1,Piemonte,Piemonte,4356406,2616046,60.05,0.26
3481,2021-05-06,PIE,33410,15778,17632,19282,13538,590,ITC,ITC1,1,Piemonte,Piemonte,4356406,2649456,60.82,0.77
3482,2021-05-23,PIE,28754,13153,15601,15465,12978,311,ITC,ITC1,1,Piemonte,Piemonte,4356406,2678210,61.48,0.66
3483,2021-02-12,PIE,6889,2215,4674,3908,2958,23,ITC,ITC1,1,Piemonte,Piemonte,4356406,2685099,61.64,0.16
3484,2021-03-01,PIE,12115,4916,7199,11133,809,173,ITC,ITC1,1,Piemonte,Piemonte,4356406,2697214,61.91,0.28
3485,2021-05-30,PIE,27727,13196,14531,18018,9335,374,ITC,ITC1,1,Piemonte,Piemonte,4356406,2724941,62.55,0.64
3486,2021-02-19,PIE,5535,2177,3358,4913,501,121,ITC,ITC1,1,Piemonte,Piemonte,4356406,2730476,62.68,0.13
3487,2021-06-04,PIE,37559,19639,17920,34007,2955,597,ITC,ITC1,1,Piemonte,Piemonte,4356406,2768035,63.54,0.86
3488,2021-02-24,PIE,11377,4602,6775,10727,503,147,ITC,ITC1,1,Piemonte,Piemonte,4356406,2779412,63.8,0.26
3489,2021-06-06,PIE,35086,18333,16753,32048,2488,550,ITC,ITC1,1,Piemonte,Piemonte,4356406,2814498,64.61,0.81
3490,2021-08-02,PIE,29812,15741,14071,9358,20019,435,ITC,ITC1,1,Piemonte,Piemonte,4356406,2844310,65.29,0.68
3491,2021-07-26,PIE,32692,17017,15675,8220,23838,634,ITC,ITC1,1,Piemonte,Piemonte,4356406,2877002,66.04,0.75
3492,2021-04-17,PIE,30450,14148,16302,26446,3307,697,ITC,ITC1,1,Piemonte,Piemonte,4356406,2907452,66.74,0.7
3493,2021-06-13,PIE,37980,20045,17935,33097,4126,757,ITC,ITC1,1,Piemonte,Piemonte,4356406,2945432,67.61,0.87
3494,2021-02-10,PIE,7536,2372,5164,1299,6222,15,ITC,ITC1,1,Piemonte,Piemonte,4356406,2952968,67.78,0.17
3495,2021-04-08,PIE,25296,11006,14290,20017,4722,557,ITC,ITC1,1,Piemonte,Piemonte,4356406,2978264,68.37,0.58
3496,2021-07-19,PIE,39536,20582,18954,4454,34664,418,ITC,ITC1,1,Piemonte,Piemonte,4356406,3017800,69.27,0.91
3497,2021-04-10,PIE,30145,13403,16742,25233,4265,647,ITC,ITC1,1,Piemonte,Piemonte,4356406,3047945,69.96,0.69
3498,2021-02-28,PIE,10810,4057,6753,10394,240,176,ITC,ITC1,1,Piemonte,Piemonte,4356406,3058755,70.21,0.25
3499,2021-03-17,PIE,12520,5057,7463,5037,7298,185,ITC,ITC1,1,Piemonte,Piemonte,4356406,3071275,70.5,0.29
3500,2021-06-10,PIE,40442,21144,19298,37016,2577,849,ITC,ITC1,1,Piemonte,Piemonte,4356406,3111717,71.43,0.93
3501,2021-02-20,PIE,3835,1256,2579,3562,173,100,ITC,ITC1,1,Piemonte,Piemonte,4356406,3115552,71.52,0.09
3502,2021-07-24,PIE,34788,18301,16487,7874,26325,589,ITC,ITC1,1,Piemonte,Piemonte,4356406,3150340,72.32,0.8
3503,2021-08-07,PIE,29626,15859,13767,12624,16616,386,ITC,ITC1,1,Piemonte,Piemonte,4356406,3179966,73.0,0.68
3504,2021-04-29,PIE,48448,21963,26485,34632,12639,1177,ITC,ITC1,1,Piemonte,Piemonte,4356406,3228414,74.11,1.11
3505,2021-05-16,PIE,28193,12794,15399,14740,13082,371,ITC,ITC1,1,Piemonte,Piemonte,4356406,3256607,74.75,0.65
3506,2021-02-05,PIE,9604,3137,6467,652,8950,2,ITC,ITC1,1,Piemonte,Piemonte,4356406,3266211,74.97,0.22
3507,2021-01-03,PIE,3060,965,2095,3058,0,2,ITC,ITC1,1,Piemonte,Piemonte,4356406,3269271,75.05,0.07
3508,2021-07-07,PIE,37949,18861,19088,9656,27714,579,ITC,ITC1,1,Piemonte,Piemonte,4356406,3307220,75.92,0.87
3509,2021-03-29,PIE,15246,6470,8776,8378,6610,258,ITC,ITC1,1,Piemonte,Piemonte,4356406,3322466,76.27,0.35
3510,2021-07-21,PIE,37921,20127,17794,6509,30892,520,ITC,ITC1,1,Piemonte,Piemonte,4356406,3360387,77.14,0.87
3511,2021-04-27,PIE,22623,10224,12399,16824,5156,643,ITC,ITC1,1,Piemonte,Piemonte,4356406,3383010,77.66,0.52
3512,2021-01-17,PIE,3515,1168,2347,2864,649,2,ITC,ITC1,1,Piemonte,Piemonte,4356406,3386525,77.74,0.08
3513,2021-03-15,PIE,10685,4194,6491,4929,5601,155,ITC,ITC1,1,Piemonte,Piemonte,4356406,3397210,77.98,0.25
3514,2021-05-11,PIE,32121,15490,16631,18256,13238,627,ITC,ITC1,1,Piemonte,Piemonte,4356406,3429331,78.72,0.74
3515,2021-01-31,PIE,4118,1755,2363,112,4006,0,ITC,ITC1,1,Piemonte,Piemonte,4356406,3433449,78.81,0.09
3516,2021-07-18,PIE,32869,17244,15625,3232,29310,327,ITC,ITC1,1,Piemonte,Piemonte,4356406,3466318,79.57,0.75
3517,2021-05-25,PIE,31157,14458,16699,15611,15157,389,ITC,ITC1,1,Piemonte,Piemonte,4356406,3497475,80.28,0.72
3518,2021-06-11,PIE,43558,23060,20498,39929,2831,798,ITC,ITC1,1,Piemonte,Piemonte,4356406,3541033,81.28,1.0
3519,2021-02-17,PIE,4796,2159,2637,3747,990,59,ITC,ITC1,1,Piemonte,Piemonte,4356406,3545829,81.39,0.11
3520,2021-06-08,PIE,37653,19498,18155,34107,2847,699,ITC,ITC1,1,Piemonte,Piemonte,4356406,3583482,82.26,0.86
3521,2021-08-04,PIE,29150,15396,13754,8895,19810,445,ITC,ITC1,1,Piemonte,Piemonte,4356406,3612632,82.93,0.67
3522,2021-04-26,PIE,19805,8754,11051,14906,4398,501,ITC,ITC1,1,Piemonte,Piemonte,4356406,3632437,83.38,0.45
3523,2021-04-15,PIE,29550,13539,16011,23385,5495,670,ITC,ITC1,1,Piemonte,Piemonte,4356406,3661987,84.06,0.68
3524,2021-01-05,PIE,5375,1602,3773,5370,0,5,ITC,ITC1,1,Piemonte,Piemonte,4356406,3667362,84.18,0.12
3525,2021-06-22,PIE,40616,20088,20528,17771,22305,540,ITC,ITC1,1,Piemonte,Piemonte,4356406,3707978,85.12,0.93
3526,2021-01-07,PIE,5374,1731,3643,5372,0,2,ITC,ITC1,1,Piemonte,Piemonte,4356406,3713352,85.24,0.12
3527,2021-03-05,PIE,15558,6229,9329,11461,3823,274,ITC,ITC1,1,Piemonte,Piemonte,4356406,3728910,85.6,0.36
3528,2021-06-18,PIE,40607,20305,20302,25738,14203,666,ITC,ITC1,1,Piemonte,Piemonte,4356406,3769517,86.53,0.93
3529,2021-03-10,PIE,13814,5339,8475,11264,2291,259,ITC,ITC1,1,Piemonte,Piemonte,4356406,3783331,86.85,0.32
3530,2021-03-27,PIE,18389,7825,10564,9127,8826,436,ITC,ITC1,1,Piemonte,Piemonte,4356406,3801720,87.27,0.42
3531,2021-06-27,PIE,37515,18599,18916,15187,21745,583,ITC,ITC1,1,Piemonte,Piemonte,4356406,3839235,88.13,0.86
3532,2021-03-19,PIE,11029,4518,6511,4215,6606,208,ITC,ITC1,1,Piemonte,Piemonte,4356406,3850264,88.38,0.25
3533,2021-04-05,PIE,14747,6237,8510,11938,2557,252,ITC,ITC1,1,Piemonte,Piemonte,4356406,3865011,88.72,0.34
3534,2021-06-29,PIE,40526,20245,20281,19166,20673,687,ITC,ITC1,1,Piemonte,Piemonte,4356406,3905537,89.65,0.93
3535,2021-04-12,PIE,22936,10360,12576,19427,2992,517,ITC,ITC1,1,Piemonte,Piemonte,4356406,3928473,90.18,0.53
3536,2021-01-02,PIE,3540,1132,2408,3539,0,1,ITC,ITC1,1,Piemonte,Piemonte,4356406,3932013,90.26,0.08
3537,2021-05-01,PIE,28552,13000,15552,16318,11795,439,ITC,ITC1,1,Piemonte,Piemonte,4356406,3960565,90.91,0.66
3538,2021-01-21,PIE,6872,2312,4560,3368,3498,6,ITC,ITC1,1,Piemonte,Piemonte,4356406,3967437,91.07,0.16
3539,2021-05-15,PIE,33780,15749,18031,19394,13730,656,ITC,ITC1,1,Piemonte,Piemonte,4356406,4001217,91.85,0.78
3540,2021-06-01,PIE,29309,14702,14607,24451,4431,427,ITC,ITC1,1,Piemonte,Piemonte,4356406,4030526,92.52,0.67
3541,2021-02-07,PIE,3084,972,2112,440,2643,1,ITC,ITC1,1,Piemonte,Piemonte,4356406,4033610,92.59,0.07
3542,2021-07-11,PIE,33154,16903,16251,4512,28328,314,ITC,ITC1,1,Piemonte,Piemonte,4356406,4066764,93.35,0.76
3543,2021-05-22,PIE,33521,15134,18387,16897,16222,402,ITC,ITC1,1,Piemonte,Piemonte,4356406,4100285,94.12,0.77
3544,2021-04-19,PIE,22552,10764,11788,17647,4350,555,ITC,ITC1,1,Piemonte,Piemonte,4356406,4122837,94.64,0.52
3545,2021-01-09,PIE,6181,2185,3996,6179,0,2,ITC,ITC1,1,Piemonte,Piemonte,4356406,4129018,94.78,0.14
3546,2021-01-26,PIE,6335,1882,4453,731,5603,1,ITC,ITC1,1,Piemonte,Piemonte,4356406,4135353,94.93,0.15
3547,2021-07-30,PIE,35625,18600,17025,9484,25711,430,ITC,ITC1,1,Piemonte,Piemonte,4356406,4170978,95.74,0.82
3548,2021-05-08,PIE,34275,16264,18011,18129,15638,508,ITC,ITC1,1,Piemonte,Piemonte,4356406,4205253,96.53,0.79
3549,2021-01-28,PIE,5593,1809,3784,380,5213,0,ITC,ITC1,1,Piemonte,Piemonte,4356406,4210846,96.66,0.13
3550,2021-02-14,PIE,1478,499,979,870,601,7,ITC,ITC1,1,Piemonte,Piemonte,4356406,4212324,96.69,0.03
3551,2021-08-11,PIE,20936,11196,9740,11788,8651,497,ITC,ITC1,1,Piemonte,Piemonte,4356406,4233260,97.17,0.48
3552,2021-05-03,PIE,26685,12206,14479,12036,14215,434,ITC,ITC1,1,Piemonte,Piemonte,4356406,4259945,97.79,0.61
3553,2021-02-26,PIE,12288,4930,7358,11345,737,206,ITC,ITC1,1,Piemonte,Piemonte,4356406,4272233,98.07,0.28
3554,2021-04-24,PIE,27498,12432,15066,21285,5659,554,ITC,ITC1,1,Piemonte,Piemonte,4356406,4299731,98.7,0.63
3555,2021-01-14,PIE,9759,3148,6611,9753,0,6,ITC,ITC1,1,Piemonte,Piemonte,4356406,4309490,98.92,0.22
3556,2021-01-19,PIE,6459,2108,4351,6441,9,9,ITC,ITC1,1,Piemonte,Piemonte,4356406,4315949,99.07,0.15
3557,2021-07-28,PIE,34676,18015,16661,9107,24972,597,ITC,ITC1,1,Piemonte,Piemonte,4356406,4350625,99.87,0.8
3558,2021-06-15,PIE,38925,20049,18876,26489,11768,668,ITC,ITC1,1,Piemonte,Piemonte,4356406,4389550,100.76,0.89
3559,2021-03-07,PIE,11980,4664,7316,10857,877,246,ITC,ITC1,1,Piemonte,Piemonte,4356406,4401530,101.04,0.27
3560,2020-12-31,PIE,3883,1323,2560,3883,0,0,ITC,ITC1,1,Piemonte,Piemonte,4356406,4405413,101.12,0.09
3561,2021-02-21,PIE,5092,2084,3008,4939,103,50,ITC,ITC1,1,Piemonte,Piemonte,4356406,4410505,101.24,0.12
3562,2021-06-20,PIE,34072,17087,16985,18743,14772,557,ITC,ITC1,1,Piemonte,Piemonte,4356406,4444577,102.02,0.78
3563,2021-03-12,PIE,14105,5330,8775,10890,2935,280,ITC,ITC1,1,Piemonte,Piemonte,4356406,4458682,102.35,0.32
3564,2021-07-04,PIE,33745,17011,16734,11218,21918,609,ITC,ITC1,1,Piemonte,Piemonte,4356406,4492427,103.12,0.77
3565,2021-03-26,PIE,17887,7105,10782,8476,8884,527,ITC,ITC1,1,Piemonte,Piemonte,4356406,4510314,103.53,0.41
3566,2021-07-23,PIE,38029,20055,17974,7976,29430,623,ITC,ITC1,1,Piemonte,Piemonte,4356406,4548343,104.41,0.87
3567,2021-04-14,PIE,27687,12552,15135,22456,4529,702,ITC,ITC1,1,Piemonte,Piemonte,4356406,4576030,105.04,0.64
3568,2021-08-06,PIE,30267,16020,14247,13260,16439,568,ITC,ITC1,1,Piemonte,Piemonte,4356406,4606297,105.74,0.69
3569,2021-06-03,PIE,34642,17898,16744,29695,4414,533,ITC,ITC1,1,Piemonte,Piemonte,4356406,4640939,106.53,0.8
3570,2021-02-27,PIE,12677,4847,7830,12111,336,230,ITC,ITC1,1,Piemonte,Piemonte,4356406,4653616,106.82,0.29
3571,2021-04-25,PIE,20232,9307,10925,17280,2501,451,ITC,ITC1,1,Piemonte,Piemonte,4356406,4673848,107.29,0.46
3572,2021-01-15,PIE,9106,3007,6099,9100,0,6,ITC,ITC1,1,Piemonte,Piemonte,4356406,4682954,107.5,0.21
3573,2021-06-21,PIE,38440,19220,19220,17119,20765,556,ITC,ITC1,1,Piemonte,Piemonte,4356406,4721394,108.38,0.88
3574,2021-03-13,PIE,13024,4715,8309,11327,1429,268,ITC,ITC1,1,Piemonte,Piemonte,4356406,4734418,108.68,0.3
3575,2021-04-18,PIE,22934,10799,12135,19619,2753,562,ITC,ITC1,1,Piemonte,Piemonte,4356406,4757352,109.2,0.53
3576,2021-01-08,PIE,5527,1760,3767,5525,0,2,ITC,ITC1,1,Piemonte,Piemonte,4356406,4762879,109.33,0.13
3577,2021-06-14,PIE,37975,19566,18409,30200,7091,684,ITC,ITC1,1,Piemonte,Piemonte,4356406,4800854,110.2,0.87
3578,2021-03-06,PIE,14004,5222,8782,11039,2790,175,ITC,ITC1,1,Piemonte,Piemonte,4356406,4814858,110.52,0.32
3579,2021-08-10,PIE,21745,11527,10218,12399,8793,553,ITC,ITC1,1,Piemonte,Piemonte,4356406,4836603,111.02,0.5
3580,2021-01-22,PIE,3867,1251,2616,2524,1342,1,ITC,ITC1,1,Piemonte,Piemonte,4356406,4840470,111.11,0.09
3581,2021-07-02,PIE,43741,22008,21733,17341,25561,839,ITC,ITC1,1,Piemonte,Piemonte,4356406,4884211,112.12,1.0
3582,2021-05-13,PIE,35697,17536,18161,19866,15129,702,ITC,ITC1,1,Piemonte,Piemonte,4356406,4919908,112.94,0.82
3583,2021-02-02,PIE,10258,3513,6745,808,9449,1,ITC,ITC1,1,Piemonte,Piemonte,4356406,4930166,113.17,0.24
3584,2021-07-09,PIE,40398,20614,19784,5742,34130,526,ITC,ITC1,1,Piemonte,Piemonte,4356406,4970564,114.1,0.93
3585,2021-03-31,PIE,19127,8122,11005,10096,8691,340,ITC,ITC1,1,Piemonte,Piemonte,4356406,4989691,114.54,0.44
3586,2021-05-27,PIE,37412,17398,20014,18812,18166,434,ITC,ITC1,1,Piemonte,Piemonte,4356406,5027103,115.4,0.86
3587,2021-02-16,PIE,3969,1758,2211,3162,758,49,ITC,ITC1,1,Piemonte,Piemonte,4356406,5031072,115.49,0.09
3588,2021-03-24,PIE,15563,6397,9166,6101,9130,332,ITC,ITC1,1,Piemonte,Piemonte,4356406,5046635,115.84,0.36
3589,2021-05-20,PIE,38641,17955,20686,13328,24957,356,ITC,ITC1,1,Piemonte,Piemonte,4356406,5085276,116.73,0.89
3590,2021-02-09,PIE,7392,2317,5075,714,6676,2,ITC,ITC1,1,Piemonte,Piemonte,4356406,5092668,116.9,0.17
3591,2021-07-16,PIE,41942,21917,20025,3583,37946,413,ITC,ITC1,1,Piemonte,Piemonte,4356406,5134610,117.86,0.96
3592,2021-04-07,PIE,23595,9988,13607,17613,5460,522,ITC,ITC1,1,Piemonte,Piemonte,4356406,5158205,118.41,0.54
3593,2021-06-19,SAR,15343,7515,7828,9119,6125,99,ITG,ITG2,20,Sardegna,Sardegna,1639591,15343,0.94,0.94
3594,2021-07-06,SAR,15942,7727,8215,4671,11173,98,ITG,ITG2,20,Sardegna,Sardegna,1639591,31285,1.91,0.97
3595,2021-03-28,SAR,4536,1795,2741,4391,78,67,ITG,ITG2,20,Sardegna,Sardegna,1639591,35821,2.18,0.28
3596,2021-01-04,SAR,587,215,372,587,0,0,ITG,ITG2,20,Sardegna,Sardegna,1639591,36408,2.22,0.04
3597,2021-03-09,SAR,5536,2742,2794,4746,727,63,ITG,ITG2,20,Sardegna,Sardegna,1639591,41944,2.56,0.34
3598,2021-05-05,SAR,10188,4653,5535,7950,2035,203,ITG,ITG2,20,Sardegna,Sardegna,1639591,52132,3.18,0.62
3599,2021-05-19,SAR,17044,8676,8368,12628,4255,161,ITG,ITG2,20,Sardegna,Sardegna,1639591,69176,4.22,1.04
3600,2021-06-05,SAR,17883,8438,9445,11285,6464,134,ITG,ITG2,20,Sardegna,Sardegna,1639591,87059,5.31,1.09
3601,2021-02-25,SAR,2899,1256,1643,2264,604,31,ITG,ITG2,20,Sardegna,Sardegna,1639591,89958,5.49,0.18
3602,2021-03-14,SAR,605,377,228,596,0,9,ITG,ITG2,20,Sardegna,Sardegna,1639591,90563,5.52,0.04
3603,2021-02-11,SAR,1311,488,823,1200,111,0,ITG,ITG2,20,Sardegna,Sardegna,1639591,91874,5.6,0.08
3604,2021-05-24,SAR,14470,7256,7214,8355,5983,132,ITG,ITG2,20,Sardegna,Sardegna,1639591,106344,6.49,0.88
3605,2021-02-13,SAR,1447,562,885,1441,2,4,ITG,ITG2,20,Sardegna,Sardegna,1639591,107791,6.57,0.09
3606,2021-04-09,SAR,12317,5477,6840,7829,4363,125,ITG,ITG2,20,Sardegna,Sardegna,1639591,120108,7.33,0.75
3607,2021-07-20,SAR,16148,7930,8218,3653,12404,91,ITG,ITG2,20,Sardegna,Sardegna,1639591,136256,8.31,0.98
3608,2021-04-11,SAR,5399,2445,2954,4251,1121,27,ITG,ITG2,20,Sardegna,Sardegna,1639591,141655,8.64,0.33
3609,2021-06-07,SAR,12564,6145,6419,9437,3005,122,ITG,ITG2,20,Sardegna,Sardegna,1639591,154219,9.41,0.77
3610,2021-02-04,SAR,2272,815,1457,910,1359,3,ITG,ITG2,20,Sardegna,Sardegna,1639591,156491,9.54,0.14
3611,2021-04-02,SAR,8989,3549,5440,5591,3245,153,ITG,ITG2,20,Sardegna,Sardegna,1639591,165480,10.09,0.55
3612,2021-01-16,SAR,1493,527,966,1493,0,0,ITG,ITG2,20,Sardegna,Sardegna,1639591,166973,10.18,0.09
3613,2021-08-01,SAR,3054,1500,1554,1031,1987,36,ITG,ITG2,20,Sardegna,Sardegna,1639591,170027,10.37,0.19
3614,2021-04-23,SAR,12875,5752,7123,7246,5486,143,ITG,ITG2,20,Sardegna,Sardegna,1639591,182902,11.16,0.79
3615,2021-05-10,SAR,9865,4399,5466,7153,2541,171,ITG,ITG2,20,Sardegna,Sardegna,1639591,192767,11.76,0.6
3616,2021-01-30,SAR,3869,1393,2476,363,3506,0,ITG,ITG2,20,Sardegna,Sardegna,1639591,196636,11.99,0.24
3617,2021-07-01,SAR,19834,9764,10070,7257,12484,93,ITG,ITG2,20,Sardegna,Sardegna,1639591,216470,13.2,1.21
3618,2021-03-23,SAR,6425,2888,3537,5180,1082,163,ITG,ITG2,20,Sardegna,Sardegna,1639591,222895,13.59,0.39
3619,2021-07-15,SAR,18777,9236,9541,4647,14031,99,ITG,ITG2,20,Sardegna,Sardegna,1639591,241672,14.74,1.15
3620,2021-08-03,SAR,14563,7502,7061,7516,6852,195,ITG,ITG2,20,Sardegna,Sardegna,1639591,256235,15.63,0.89
3621,2021-03-02,SAR,3039,1631,1408,1815,1154,70,ITG,ITG2,20,Sardegna,Sardegna,1639591,259274,15.81,0.19
3622,2021-04-28,SAR,9026,4284,4742,5167,3710,149,ITG,ITG2,20,Sardegna,Sardegna,1639591,268300,16.36,0.55
3623,2021-01-18,SAR,903,324,579,779,124,0,ITG,ITG2,20,Sardegna,Sardegna,1639591,269203,16.42,0.06
3624,2021-06-24,SAR,19198,9213,9985,8114,10982,102,ITG,ITG2,20,Sardegna,Sardegna,1639591,288401,17.59,1.17
3625,2021-03-16,SAR,4398,1954,2444,3434,922,42,ITG,ITG2,20,Sardegna,Sardegna,1639591,292799,17.86,0.27
3626,2021-04-21,SAR,12077,5555,6522,6440,5537,100,ITG,ITG2,20,Sardegna,Sardegna,1639591,304876,18.59,0.74
3627,2021-07-08,SAR,18444,8968,9476,3833,14527,84,ITG,ITG2,20,Sardegna,Sardegna,1639591,323320,19.72,1.12
3628,2021-07-25,SAR,4344,2143,2201,865,3464,15,ITG,ITG2,20,Sardegna,Sardegna,1639591,327664,19.98,0.26
3629,2021-04-16,SAR,14447,6490,7957,8941,5341,165,ITG,ITG2,20,Sardegna,Sardegna,1639591,342111,20.87,0.88
3630,2021-01-23,SAR,60,22,38,0,60,0,ITG,ITG2,20,Sardegna,Sardegna,1639591,342171,20.87,0.0
3631,2021-04-30,SAR,11145,5306,5839,6756,4209,180,ITG,ITG2,20,Sardegna,Sardegna,1639591,353316,21.55,0.68
3632,2021-05-17,SAR,12818,6261,6557,9125,3546,147,ITG,ITG2,20,Sardegna,Sardegna,1639591,366134,22.33,0.78
3633,2021-02-06,SAR,1973,700,1273,564,1406,3,ITG,ITG2,20,Sardegna,Sardegna,1639591,368107,22.45,0.12
3634,2021-02-23,SAR,1565,1043,522,1270,280,15,ITG,ITG2,20,Sardegna,Sardegna,1639591,369672,22.55,0.1
3635,2021-07-24,SAR,12386,6386,6000,1996,10363,27,ITG,ITG2,20,Sardegna,Sardegna,1639591,382058,23.3,0.76
3636,2021-08-10,SAR,14222,7499,6723,6252,7808,162,ITG,ITG2,20,Sardegna,Sardegna,1639591,396280,24.17,0.87
3637,2021-05-29,SAR,17994,8649,9345,13235,4592,167,ITG,ITG2,20,Sardegna,Sardegna,1639591,414274,25.27,1.1
3638,2021-02-18,SAR,1876,731,1145,1774,64,38,ITG,ITG2,20,Sardegna,Sardegna,1639591,416150,25.38,0.11
3639,2021-05-31,SAR,11368,5409,5959,8159,3110,99,ITG,ITG2,20,Sardegna,Sardegna,1639591,427518,26.07,0.69
3640,2021-07-27,SAR,16531,8384,8147,4216,12204,111,ITG,ITG2,20,Sardegna,Sardegna,1639591,444049,27.08,1.01
3641,2021-04-18,SAR,5132,2226,2906,2230,2874,28,ITG,ITG2,20,Sardegna,Sardegna,1639591,449181,27.4,0.31
3642,2021-01-08,SAR,3257,1184,2073,3255,0,2,ITG,ITG2,20,Sardegna,Sardegna,1639591,452438,27.59,0.2
3643,2021-07-13,SAR,17805,8522,9283,3251,14477,77,ITG,ITG2,20,Sardegna,Sardegna,1639591,470243,28.68,1.09
3644,2021-04-04,SAR,2,1,1,0,2,0,ITG,ITG2,20,Sardegna,Sardegna,1639591,470245,28.68,0.0
3645,2021-08-08,SAR,1884,979,905,1020,841,23,ITG,ITG2,20,Sardegna,Sardegna,1639591,472129,28.8,0.11
3646,2021-06-26,SAR,19147,9010,10137,5453,13619,75,ITG,ITG2,20,Sardegna,Sardegna,1639591,491276,29.96,1.17
3647,2021-06-12,SAR,14758,7195,7563,9938,4702,118,ITG,ITG2,20,Sardegna,Sardegna,1639591,506034,30.86,0.9
3648,2021-03-04,SAR,4372,2300,2072,3058,1256,58,ITG,ITG2,20,Sardegna,Sardegna,1639591,510406,31.13,0.27
3649,2021-03-21,SAR,4038,1813,2225,2572,1440,26,ITG,ITG2,20,Sardegna,Sardegna,1639591,514444,31.38,0.25
3650,2021-05-12,SAR,11142,5265,5877,7796,3139,207,ITG,ITG2,20,Sardegna,Sardegna,1639591,525586,32.06,0.68
3651,2020-12-28,SAR,66,26,40,66,0,0,ITG,ITG2,20,Sardegna,Sardegna,1639591,525652,32.06,0.0
3652,2021-06-14,SAR,13841,6687,7154,9885,3814,142,ITG,ITG2,20,Sardegna,Sardegna,1639591,539493,32.9,0.84
3653,2021-03-06,SAR,2635,1078,1557,781,1781,73,ITG,ITG2,20,Sardegna,Sardegna,1639591,542128,33.06,0.16
3654,2021-06-28,SAR,14993,7042,7951,3051,11876,66,ITG,ITG2,20,Sardegna,Sardegna,1639591,557121,33.98,0.91
3655,2021-04-06,SAR,7463,3124,4339,4972,2429,62,ITG,ITG2,20,Sardegna,Sardegna,1639591,564584,34.43,0.46
3656,2021-01-11,SAR,1183,505,678,1182,0,1,ITG,ITG2,20,Sardegna,Sardegna,1639591,565767,34.51,0.07
3657,2021-06-17,SAR,18464,8531,9933,9919,8424,121,ITG,ITG2,20,Sardegna,Sardegna,1639591,584231,35.63,1.13
3658,2021-01-25,SAR,591,214,377,22,569,0,ITG,ITG2,20,Sardegna,Sardegna,1639591,584822,35.67,0.04
3659,2021-05-16,SAR,8222,3832,4390,5985,2160,77,ITG,ITG2,20,Sardegna,Sardegna,1639591,593044,36.17,0.5
3660,2021-07-12,SAR,15335,7414,7921,2403,12877,55,ITG,ITG2,20,Sardegna,Sardegna,1639591,608379,37.11,0.94
3661,2021-02-22,SAR,1638,948,690,1384,228,26,ITG,ITG2,20,Sardegna,Sardegna,1639591,610017,37.21,0.1
3662,2021-03-11,SAR,6424,3092,3332,5148,1200,76,ITG,ITG2,20,Sardegna,Sardegna,1639591,616441,37.6,0.39
3663,2021-06-04,SAR,14493,6937,7556,9777,4558,158,ITG,ITG2,20,Sardegna,Sardegna,1639591,630934,38.48,0.88
3664,2021-06-21,SAR,14021,6733,7288,5123,8825,73,ITG,ITG2,20,Sardegna,Sardegna,1639591,644955,39.34,0.86
3665,2021-03-13,SAR,2756,1075,1681,2436,281,39,ITG,ITG2,20,Sardegna,Sardegna,1639591,647711,39.5,0.17
3666,2021-03-30,SAR,8768,3586,5182,6349,2274,145,ITG,ITG2,20,Sardegna,Sardegna,1639591,656479,40.04,0.53
3667,2021-05-02,SAR,5968,2698,3270,5215,652,101,ITG,ITG2,20,Sardegna,Sardegna,1639591,662447,40.4,0.36
3668,2021-02-08,SAR,1469,533,936,852,616,1,ITG,ITG2,20,Sardegna,Sardegna,1639591,663916,40.49,0.09
3669,2021-06-02,SAR,9787,4693,5094,8061,1640,86,ITG,ITG2,20,Sardegna,Sardegna,1639591,673703,41.09,0.6
3670,2021-07-29,SAR,17902,9049,8853,6529,11206,167,ITG,ITG2,20,Sardegna,Sardegna,1639591,691605,42.18,1.09
3671,2021-04-20,SAR,11005,4997,6008,7693,3219,93,ITG,ITG2,20,Sardegna,Sardegna,1639591,702610,42.85,0.67
3672,2021-06-16,SAR,17635,8276,9359,12167,5307,161,ITG,ITG2,20,Sardegna,Sardegna,1639591,720245,43.93,1.08
3673,2021-01-01,SAR,32,17,15,32,0,0,ITG,ITG2,20,Sardegna,Sardegna,1639591,720277,43.93,0.0
3674,2021-02-27,SAR,1918,644,1274,1318,559,41,ITG,ITG2,20,Sardegna,Sardegna,1639591,722195,44.05,0.12
3675,2020-12-27,SAR,65,34,31,65,0,0,ITG,ITG2,20,Sardegna,Sardegna,1639591,722260,44.05,0.0
3676,2021-04-25,SAR,4500,2271,2229,3674,780,46,ITG,ITG2,20,Sardegna,Sardegna,1639591,726760,44.33,0.27
3677,2021-01-15,SAR,1561,572,989,1559,0,2,ITG,ITG2,20,Sardegna,Sardegna,1639591,728321,44.42,0.1
3678,2021-02-01,SAR,1523,605,918,224,1299,0,ITG,ITG2,20,Sardegna,Sardegna,1639591,729844,44.51,0.09
3679,2021-05-09,SAR,6125,2872,3253,5112,925,88,ITG,ITG2,20,Sardegna,Sardegna,1639591,735969,44.89,0.37
3680,2021-05-26,SAR,15534,8189,7345,9702,5648,184,ITG,ITG2,20,Sardegna,Sardegna,1639591,751503,45.83,0.95
3681,2021-02-15,SAR,955,347,608,918,31,6,ITG,ITG2,20,Sardegna,Sardegna,1639591,752458,45.89,0.06
3682,2021-01-06,SAR,1614,547,1067,1614,0,0,ITG,ITG2,20,Sardegna,Sardegna,1639591,754072,45.99,0.1
3683,2021-06-23,SAR,20547,9667,10880,6193,14261,93,ITG,ITG2,20,Sardegna,Sardegna,1639591,774619,47.24,1.25
3684,2021-07-05,SAR,15583,7571,8012,3326,12208,49,ITG,ITG2,20,Sardegna,Sardegna,1639591,790202,48.2,0.95
3685,2021-01-20,SAR,210,77,133,208,2,0,ITG,ITG2,20,Sardegna,Sardegna,1639591,790412,48.21,0.01
3686,2021-03-29,SAR,4740,1846,2894,4072,589,79,ITG,ITG2,20,Sardegna,Sardegna,1639591,795152,48.5,0.29
3687,2021-04-15,SAR,11851,5540,6311,6779,4956,116,ITG,ITG2,20,Sardegna,Sardegna,1639591,807003,49.22,0.72
3688,2021-01-05,SAR,1322,443,879,1322,0,0,ITG,ITG2,20,Sardegna,Sardegna,1639591,808325,49.3,0.08
3689,2021-01-22,SAR,83,47,36,55,28,0,ITG,ITG2,20,Sardegna,Sardegna,1639591,808408,49.31,0.01
3690,2021-07-22,SAR,18328,9260,9068,4504,13715,109,ITG,ITG2,20,Sardegna,Sardegna,1639591,826736,50.42,1.12
3691,2021-04-13,SAR,7623,3600,4023,5736,1826,61,ITG,ITG2,20,Sardegna,Sardegna,1639591,834359,50.89,0.46
3692,2021-06-09,SAR,15464,7368,8096,11574,3740,150,ITG,ITG2,20,Sardegna,Sardegna,1639591,849823,51.83,0.94
3693,2021-08-05,SAR,15654,8231,7423,8696,6799,159,ITG,ITG2,20,Sardegna,Sardegna,1639591,865477,52.79,0.95
3694,2021-02-20,SAR,2040,854,1186,1683,334,23,ITG,ITG2,20,Sardegna,Sardegna,1639591,867517,52.91,0.12
3695,2021-08-07,SAR,8211,4307,3904,5437,2706,68,ITG,ITG2,20,Sardegna,Sardegna,1639591,875728,53.41,0.5
3696,2021-04-29,SAR,11123,5107,6016,6613,4356,154,ITG,ITG2,20,Sardegna,Sardegna,1639591,886851,54.09,0.68
3697,2021-06-25,SAR,16509,7810,8699,3896,12556,57,ITG,ITG2,20,Sardegna,Sardegna,1639591,903360,55.1,1.01
3698,2021-01-13,SAR,575,179,396,575,0,0,ITG,ITG2,20,Sardegna,Sardegna,1639591,903935,55.13,0.04
3699,2021-07-17,SAR,12871,6301,6570,3179,9625,67,ITG,ITG2,20,Sardegna,Sardegna,1639591,916806,55.92,0.79
3700,2021-07-31,SAR,10319,5456,4863,5278,4961,80,ITG,ITG2,20,Sardegna,Sardegna,1639591,927125,56.55,0.63
3701,2021-08-09,SAR,13414,6974,6440,6475,6793,146,ITG,ITG2,20,Sardegna,Sardegna,1639591,940539,57.36,0.82
3702,2021-05-18,SAR,14768,7380,7388,9441,5209,118,ITG,ITG2,20,Sardegna,Sardegna,1639591,955307,58.26,0.9
3703,2021-02-24,SAR,2417,1295,1122,2183,194,40,ITG,ITG2,20,Sardegna,Sardegna,1639591,957724,58.41,0.15
3704,2021-03-20,SAR,5196,2075,3121,2890,2279,27,ITG,ITG2,20,Sardegna,Sardegna,1639591,962920,58.73,0.32
3705,2021-06-13,SAR,9501,4677,4824,6161,3260,80,ITG,ITG2,20,Sardegna,Sardegna,1639591,972421,59.31,0.58
3706,2021-02-05,SAR,1901,750,1151,430,1469,2,ITG,ITG2,20,Sardegna,Sardegna,1639591,974322,59.42,0.12
3707,2021-04-03,SAR,4678,1811,2867,2641,1971,66,ITG,ITG2,20,Sardegna,Sardegna,1639591,979000,59.71,0.29
3708,2021-05-30,SAR,9728,4837,4891,7300,2358,70,ITG,ITG2,20,Sardegna,Sardegna,1639591,988728,60.3,0.59
3709,2021-02-19,SAR,1501,472,1029,1401,56,44,ITG,ITG2,20,Sardegna,Sardegna,1639591,990229,60.39,0.09
3710,2021-03-27,SAR,5732,2191,3541,5222,422,88,ITG,ITG2,20,Sardegna,Sardegna,1639591,995961,60.74,0.35
3711,2021-07-26,SAR,14598,7287,7311,4122,10399,77,ITG,ITG2,20,Sardegna,Sardegna,1639591,1010559,61.63,0.89
3712,2021-04-17,SAR,10088,4502,5586,5402,4606,80,ITG,ITG2,20,Sardegna,Sardegna,1639591,1020647,62.25,0.62
3713,2021-01-03,SAR,90,36,54,90,0,0,ITG,ITG2,20,Sardegna,Sardegna,1639591,1020737,62.26,0.01
3714,2021-01-10,SAR,2177,748,1429,2177,0,0,ITG,ITG2,20,Sardegna,Sardegna,1639591,1022914,62.39,0.13
3715,2021-07-02,SAR,18935,8892,10043,4407,14431,97,ITG,ITG2,20,Sardegna,Sardegna,1639591,1041849,63.54,1.15
3716,2021-03-08,SAR,4689,2436,2253,3422,1222,45,ITG,ITG2,20,Sardegna,Sardegna,1639591,1046538,63.83,0.29
3717,2021-05-04,SAR,9550,4390,5160,7543,1855,152,ITG,ITG2,20,Sardegna,Sardegna,1639591,1056088,64.41,0.58
3718,2021-01-24,SAR,91,35,56,5,86,0,ITG,ITG2,20,Sardegna,Sardegna,1639591,1056179,64.42,0.01
3719,2021-06-18,SAR,16487,7507,8980,8604,7768,115,ITG,ITG2,20,Sardegna,Sardegna,1639591,1072666,65.42,1.01
3720,2021-03-10,SAR,6056,2957,3099,5135,853,68,ITG,ITG2,20,Sardegna,Sardegna,1639591,1078722,65.79,0.37
3721,2021-05-06,SAR,12969,6020,6949,9569,3156,244,ITG,ITG2,20,Sardegna,Sardegna,1639591,1091691,66.58,0.79
3722,2021-06-06,SAR,10035,5001,5034,6315,3651,69,ITG,ITG2,20,Sardegna,Sardegna,1639591,1101726,67.2,0.61
3723,2021-07-23,SAR,15754,7783,7971,3400,12276,78,ITG,ITG2,20,Sardegna,Sardegna,1639591,1117480,68.16,0.96
3724,2021-05-28,SAR,17957,8699,9258,13493,4276,188,ITG,ITG2,20,Sardegna,Sardegna,1639591,1135437,69.25,1.1
3725,2021-02-17,SAR,1406,577,829,1274,74,58,ITG,ITG2,20,Sardegna,Sardegna,1639591,1136843,69.34,0.09
3726,2021-05-25,SAR,15143,7705,7438,8489,6479,175,ITG,ITG2,20,Sardegna,Sardegna,1639591,1151986,70.26,0.92
3727,2021-06-11,SAR,14780,7024,7756,9089,5538,153,ITG,ITG2,20,Sardegna,Sardegna,1639591,1166766,71.16,0.9
3728,2021-03-03,SAR,4115,2279,1836,2739,1298,78,ITG,ITG2,20,Sardegna,Sardegna,1639591,1170881,71.41,0.25
3729,2021-01-29,SAR,2959,1072,1887,45,2912,2,ITG,ITG2,20,Sardegna,Sardegna,1639591,1173840,71.59,0.18
3730,2021-08-02,SAR,13120,6603,6517,6212,6730,178,ITG,ITG2,20,Sardegna,Sardegna,1639591,1186960,72.39,0.8
3731,2021-05-23,SAR,9970,4811,5159,7626,2246,98,ITG,ITG2,20,Sardegna,Sardegna,1639591,1196930,73.0,0.61
3732,2021-02-12,SAR,2237,933,1304,2172,59,6,ITG,ITG2,20,Sardegna,Sardegna,1639591,1199167,73.14,0.14
3733,2021-07-19,SAR,15235,7633,7602,2796,12389,50,ITG,ITG2,20,Sardegna,Sardegna,1639591,1214402,74.07,0.93
3734,2021-04-10,SAR,10498,4751,5747,8453,1942,103,ITG,ITG2,20,Sardegna,Sardegna,1639591,1224900,74.71,0.64
3735,2021-01-07,SAR,3104,1072,2032,3100,0,4,ITG,ITG2,20,Sardegna,Sardegna,1639591,1228004,74.9,0.19
3736,2021-07-07,SAR,15918,7736,8182,4094,11771,53,ITG,ITG2,20,Sardegna,Sardegna,1639591,1243922,75.87,0.97
3737,2021-06-22,SAR,19340,8990,10350,7167,12072,101,ITG,ITG2,20,Sardegna,Sardegna,1639591,1263262,77.05,1.18
3738,2021-07-09,SAR,15877,7599,8278,3434,12363,80,ITG,ITG2,20,Sardegna,Sardegna,1639591,1279139,78.02,0.97
3739,2021-03-31,SAR,10258,4150,6108,7702,2432,124,ITG,ITG2,20,Sardegna,Sardegna,1639591,1289397,78.64,0.63
3740,2021-04-27,SAR,7622,3556,4066,5477,2042,103,ITG,ITG2,20,Sardegna,Sardegna,1639591,1297019,79.11,0.46
3741,2021-01-17,SAR,860,277,583,859,1,0,ITG,ITG2,20,Sardegna,Sardegna,1639591,1297879,79.16,0.05
3742,2021-03-15,SAR,2798,1317,1481,2384,374,40,ITG,ITG2,20,Sardegna,Sardegna,1639591,1300677,79.33,0.17
3743,2021-07-04,SAR,8207,3989,4218,2068,6124,15,ITG,ITG2,20,Sardegna,Sardegna,1639591,1308884,79.83,0.5
3744,2021-03-26,SAR,8468,3517,4951,6810,1528,130,ITG,ITG2,20,Sardegna,Sardegna,1639591,1317352,80.35,0.52
3745,2021-05-22,SAR,24936,11987,12949,19490,5143,303,ITG,ITG2,20,Sardegna,Sardegna,1639591,1342288,81.87,1.52
3746,2021-01-19,SAR,747,269,478,691,55,1,ITG,ITG2,20,Sardegna,Sardegna,1639591,1343035,81.91,0.05
3747,2021-03-17,SAR,6551,2847,3704,4905,1609,37,ITG,ITG2,20,Sardegna,Sardegna,1639591,1349586,82.31,0.4
3748,2021-03-01,SAR,2271,1157,1114,1583,659,29,ITG,ITG2,20,Sardegna,Sardegna,1639591,1351857,82.45,0.14
3749,2021-05-13,SAR,12382,5867,6515,8729,3447,206,ITG,ITG2,20,Sardegna,Sardegna,1639591,1364239,83.21,0.76
3750,2021-02-02,SAR,1501,670,831,257,1244,0,ITG,ITG2,20,Sardegna,Sardegna,1639591,1365740,83.3,0.09
3751,2021-06-30,SAR,17780,8519,9261,4814,12885,81,ITG,ITG2,20,Sardegna,Sardegna,1639591,1383520,84.38,1.08
3752,2021-03-22,SAR,3690,1493,2197,3099,514,77,ITG,ITG2,20,Sardegna,Sardegna,1639591,1387210,84.61,0.23
3753,2021-04-08,SAR,13444,5936,7508,8212,5119,113,ITG,ITG2,20,Sardegna,Sardegna,1639591,1400654,85.43,0.82
3754,2021-07-14,SAR,16910,8191,8719,3775,13024,111,ITG,ITG2,20,Sardegna,Sardegna,1639591,1417564,86.46,1.03
3755,2020-12-29,SAR,57,32,25,57,0,0,ITG,ITG2,20,Sardegna,Sardegna,1639591,1417621,86.46,0.0
3756,2021-04-22,SAR,10510,4664,5846,5500,4922,88,ITG,ITG2,20,Sardegna,Sardegna,1639591,1428131,87.1,0.64
3757,2021-01-12,SAR,866,408,458,866,0,0,ITG,ITG2,20,Sardegna,Sardegna,1639591,1428997,87.16,0.05
3758,2021-04-14,SAR,8267,3910,4357,6967,1239,61,ITG,ITG2,20,Sardegna,Sardegna,1639591,1437264,87.66,0.5
3759,2021-05-01,SAR,9921,4766,5155,5368,4457,96,ITG,ITG2,20,Sardegna,Sardegna,1639591,1447185,88.27,0.61
3760,2021-01-21,SAR,127,61,66,94,33,0,ITG,ITG2,20,Sardegna,Sardegna,1639591,1447312,88.27,0.01
3761,2021-02-07,SAR,1120,396,724,227,892,1,ITG,ITG2,20,Sardegna,Sardegna,1639591,1448432,88.34,0.07
3762,2021-08-11,SAR,9424,5031,4393,4566,4714,144,ITG,ITG2,20,Sardegna,Sardegna,1639591,1457856,88.92,0.57
3763,2021-05-03,SAR,8201,3830,4371,6492,1600,109,ITG,ITG2,20,Sardegna,Sardegna,1639591,1466057,89.42,0.5
3764,2021-05-20,SAR,16372,7884,8488,11268,4899,205,ITG,ITG2,20,Sardegna,Sardegna,1639591,1482429,90.41,1.0
3765,2021-02-09,SAR,2287,835,1452,1284,998,5,ITG,ITG2,20,Sardegna,Sardegna,1639591,1484716,90.55,0.14
3766,2021-02-26,SAR,2801,1105,1696,2444,306,51,ITG,ITG2,20,Sardegna,Sardegna,1639591,1487517,90.72,0.17
3767,2021-01-28,SAR,2975,1045,1930,68,2907,0,ITG,ITG2,20,Sardegna,Sardegna,1639591,1490492,90.91,0.18
3768,2021-05-27,SAR,17828,9264,8564,12083,5536,209,ITG,ITG2,20,Sardegna,Sardegna,1639591,1508320,91.99,1.09
3769,2021-02-16,SAR,699,289,410,663,27,9,ITG,ITG2,20,Sardegna,Sardegna,1639591,1509019,92.04,0.04
3770,2021-03-05,SAR,5208,2605,2603,2815,2356,37,ITG,ITG2,20,Sardegna,Sardegna,1639591,1514227,92.35,0.32
3771,2021-06-10,SAR,17811,8478,9333,11643,6042,126,ITG,ITG2,20,Sardegna,Sardegna,1639591,1532038,93.44,1.09
3772,2021-08-06,SAR,13824,7174,6650,7991,5661,172,ITG,ITG2,20,Sardegna,Sardegna,1639591,1545862,94.28,0.84
3773,2020-12-31,SAR,32,16,16,32,0,0,ITG,ITG2,20,Sardegna,Sardegna,1639591,1545894,94.29,0.0
3774,2021-07-30,SAR,15200,7854,7346,6621,8413,166,ITG,ITG2,20,Sardegna,Sardegna,1639591,1561094,95.21,0.93
3775,2021-06-03,SAR,16398,7645,8753,10567,5690,141,ITG,ITG2,20,Sardegna,Sardegna,1639591,1577492,96.21,1.0
3776,2021-06-20,SAR,6293,2806,3487,3637,2624,32,ITG,ITG2,20,Sardegna,Sardegna,1639591,1583785,96.6,0.38
3777,2021-03-12,SAR,5972,2617,3355,4518,1307,147,ITG,ITG2,20,Sardegna,Sardegna,1639591,1589757,96.96,0.36
3778,2021-06-27,SAR,9020,4310,4710,2957,6035,28,ITG,ITG2,20,Sardegna,Sardegna,1639591,1598777,97.51,0.55
3779,2021-03-24,SAR,7403,3111,4292,5907,1357,139,ITG,ITG2,20,Sardegna,Sardegna,1639591,1606180,97.96,0.45
3780,2021-05-11,SAR,8961,4186,4775,6401,2430,130,ITG,ITG2,20,Sardegna,Sardegna,1639591,1615141,98.51,0.55
3781,2021-01-31,SAR,2120,751,1369,45,2075,0,ITG,ITG2,20,Sardegna,Sardegna,1639591,1617261,98.64,0.13
3782,2021-02-14,SAR,538,263,275,536,2,0,ITG,ITG2,20,Sardegna,Sardegna,1639591,1617799,98.67,0.03
3783,2021-07-18,SAR,5692,2873,2819,981,4701,10,ITG,ITG2,20,Sardegna,Sardegna,1639591,1623491,99.02,0.35
3784,2021-05-15,SAR,13810,6429,7381,10200,3434,176,ITG,ITG2,20,Sardegna,Sardegna,1639591,1637301,99.86,0.84
3785,2021-07-11,SAR,6379,3119,3260,1424,4920,35,ITG,ITG2,20,Sardegna,Sardegna,1639591,1643680,100.25,0.39
3786,2021-01-26,SAR,1338,454,884,27,1311,0,ITG,ITG2,20,Sardegna,Sardegna,1639591,1645018,100.33,0.08
3787,2021-05-08,SAR,13094,5976,7118,10662,2286,146,ITG,ITG2,20,Sardegna,Sardegna,1639591,1658112,101.13,0.8
3788,2021-03-19,SAR,7263,3045,4218,4991,2218,54,ITG,ITG2,20,Sardegna,Sardegna,1639591,1665375,101.57,0.44
3789,2021-07-16,SAR,16935,8475,8460,4551,12250,134,ITG,ITG2,20,Sardegna,Sardegna,1639591,1682310,102.61,1.03
3790,2021-04-07,SAR,13554,6054,7500,7826,5656,72,ITG,ITG2,20,Sardegna,Sardegna,1639591,1695864,103.43,0.83
3791,2021-04-24,SAR,10367,4851,5516,7888,2348,131,ITG,ITG2,20,Sardegna,Sardegna,1639591,1706231,104.06,0.63
3792,2021-01-14,SAR,1105,425,680,1105,0,0,ITG,ITG2,20,Sardegna,Sardegna,1639591,1707336,104.13,0.07
3793,2021-04-05,SAR,2039,783,1256,2003,1,35,ITG,ITG2,20,Sardegna,Sardegna,1639591,1709375,104.26,0.12
3794,2021-06-29,SAR,17892,8605,9287,3755,14088,49,ITG,ITG2,20,Sardegna,Sardegna,1639591,1727267,105.35,1.09
3795,2021-05-07,SAR,14485,6640,7845,9715,4527,243,ITG,ITG2,20,Sardegna,Sardegna,1639591,1741752,106.23,0.88
3796,2021-01-27,SAR,1414,498,916,78,1336,0,ITG,ITG2,20,Sardegna,Sardegna,1639591,1743166,106.32,0.09
3797,2021-07-03,SAR,15842,7562,8280,3236,12575,31,ITG,ITG2,20,Sardegna,Sardegna,1639591,1759008,107.28,0.97
3798,2021-03-25,SAR,9119,3976,5143,7687,1304,128,ITG,ITG2,20,Sardegna,Sardegna,1639591,1768127,107.84,0.56
3799,2021-05-21,SAR,22642,11204,11438,16262,6100,280,ITG,ITG2,20,Sardegna,Sardegna,1639591,1790769,109.22,1.38
3800,2021-03-18,SAR,7256,3074,4182,5575,1607,74,ITG,ITG2,20,Sardegna,Sardegna,1639591,1798025,109.66,0.44
3801,2021-05-14,SAR,14577,6871,7706,10763,3644,170,ITG,ITG2,20,Sardegna,Sardegna,1639591,1812602,110.55,0.89
3802,2021-02-03,SAR,1119,419,700,424,694,1,ITG,ITG2,20,Sardegna,Sardegna,1639591,1813721,110.62,0.07
3803,2021-07-10,SAR,14243,6889,7354,2708,11502,33,ITG,ITG2,20,Sardegna,Sardegna,1639591,1827964,111.49,0.87
3804,2021-04-01,SAR,10166,4074,6092,7008,3015,143,ITG,ITG2,20,Sardegna,Sardegna,1639591,1838130,112.11,0.62
3805,2021-07-21,SAR,19397,9502,9895,3911,15402,84,ITG,ITG2,20,Sardegna,Sardegna,1639591,1857527,113.29,1.18
3806,2021-02-10,SAR,1961,766,1195,1435,520,6,ITG,ITG2,20,Sardegna,Sardegna,1639591,1859488,113.41,0.12
3807,2021-04-12,SAR,6998,3182,3816,5216,1713,69,ITG,ITG2,20,Sardegna,Sardegna,1639591,1866486,113.84,0.43
3808,2021-01-02,SAR,60,21,39,60,0,0,ITG,ITG2,20,Sardegna,Sardegna,1639591,1866546,113.84,0.0
3809,2021-06-08,SAR,14838,7073,7765,11172,3511,155,ITG,ITG2,20,Sardegna,Sardegna,1639591,1881384,114.75,0.9
3810,2021-02-28,SAR,367,169,198,139,226,2,ITG,ITG2,20,Sardegna,Sardegna,1639591,1881751,114.77,0.02
3811,2021-08-04,SAR,16215,8529,7686,9599,6354,262,ITG,ITG2,20,Sardegna,Sardegna,1639591,1897966,115.76,0.99
3812,2021-04-26,SAR,6858,3275,3583,5865,903,90,ITG,ITG2,20,Sardegna,Sardegna,1639591,1904824,116.18,0.42
3813,2021-06-01,SAR,14324,6657,7667,9639,4590,95,ITG,ITG2,20,Sardegna,Sardegna,1639591,1919148,117.05,0.87
3814,2021-02-21,SAR,1588,709,879,1557,30,1,ITG,ITG2,20,Sardegna,Sardegna,1639591,1920736,117.15,0.1
3815,2021-07-28,SAR,16794,8620,8174,6319,10327,148,ITG,ITG2,20,Sardegna,Sardegna,1639591,1937530,118.17,1.02
3816,2021-04-19,SAR,10188,4624,5564,8624,1429,135,ITG,ITG2,20,Sardegna,Sardegna,1639591,1947718,118.79,0.62
3817,2021-01-09,SAR,4013,1414,2599,4013,0,0,ITG,ITG2,20,Sardegna,Sardegna,1639591,1951731,119.04,0.24
3818,2021-06-15,SAR,14696,6810,7886,9819,4742,135,ITG,ITG2,20,Sardegna,Sardegna,1639591,1966427,119.93,0.9
3819,2021-03-07,SAR,1658,751,907,1113,541,4,ITG,ITG2,20,Sardegna,Sardegna,1639591,1968085,120.04,0.1
3820,2021-03-22,PAB,1162,528,634,1110,21,31,ITH,ITH1,4,Provincia Autonoma Bolzano / Bozen,P.A. Bolzano,533050,1162,0.22,0.22
3821,2021-01-26,PAB,810,291,519,1,809,0,ITH,ITH1,4,Provincia Autonoma Bolzano / Bozen,P.A. Bolzano,533050,1972,0.37,0.15
3822,2021-07-02,PAB,3202,1658,1544,856,2172,174,ITH,ITH1,4,Provincia Autonoma Bolzano / Bozen,P.A. Bolzano,533050,5174,0.97,0.6
3823,2021-03-24,PAB,2065,1000,1065,1997,13,55,ITH,ITH1,4,Provincia Autonoma Bolzano / Bozen,P.A. Bolzano,533050,7239,1.36,0.39
3824,2021-03-10,PAB,1270,531,739,1074,144,52,ITH,ITH1,4,Provincia Autonoma Bolzano / Bozen,P.A. Bolzano,533050,8509,1.6,0.24
3825,2021-05-06,PAB,5187,2749,2438,2349,2569,269,ITH,ITH1,4,Provincia Autonoma Bolzano / Bozen,P.A. Bolzano,533050,13696,2.57,0.97
3826,2021-07-16,PAB,4504,2443,2061,1050,3313,141,ITH,ITH1,4,Provincia Autonoma Bolzano / Bozen,P.A. Bolzano,533050,18200,3.41,0.84
3827,2021-04-24,PAB,5110,2452,2658,4289,485,336,ITH,ITH1,4,Provincia Autonoma Bolzano / Bozen,P.A. Bolzano,533050,23310,4.37,0.96
3828,2021-08-02,PAB,2125,1275,850,1162,874,89,ITH,ITH1,4,Provincia Autonoma Bolzano / Bozen,P.A. Bolzano,533050,25435,4.77,0.4
3829,2021-07-14,PAB,867,450,417,468,359,40,ITH,ITH1,4,Provincia Autonoma Bolzano / Bozen,P.A. Bolzano,533050,26302,4.93,0.16
3830,2021-04-05,PAB,301,144,157,22,278,1,ITH,ITH1,4,Provincia Autonoma Bolzano / Bozen,P.A. Bolzano,533050,26603,4.99,0.06
3831,2021-06-27,PAB,4426,2314,2112,573,3808,45,ITH,ITH1,4,Provincia Autonoma Bolzano / Bozen,P.A. Bolzano,533050,31029,5.82,0.83
3832,2021-01-12,PAB,1709,459,1250,1709,0,0,ITH,ITH1,4,Provincia Autonoma Bolzano / Bozen,P.A. Bolzano,533050,32738,6.14,0.32
3833,2021-02-12,PAB,730,217,513,464,248,18,ITH,ITH1,4,Provincia Autonoma Bolzano / Bozen,P.A. Bolzano,533050,33468,6.28,0.14
3834,2021-04-10,PAB,5398,2667,2731,4634,589,175,ITH,ITH1,4,Provincia Autonoma Bolzano / Bozen,P.A. Bolzano,533050,38866,7.29,1.01
3835,2020-12-31,PAB,929,528,401,929,0,0,ITH,ITH1,4,Provincia Autonoma Bolzano / Bozen,P.A. Bolzano,533050,39795,7.47,0.17
3836,2021-04-19,PAB,1873,859,1014,1600,182,91,ITH,ITH1,4,Provincia Autonoma Bolzano / Bozen,P.A. Bolzano,533050,41668,7.82,0.35
3837,2021-06-15,PAB,2041,1181,860,478,1532,31,ITH,ITH1,4,Provincia Autonoma Bolzano / Bozen,P.A. Bolzano,533050,43709,8.2,0.38
3838,2021-07-28,PAB,1426,779,647,860,490,76,ITH,ITH1,4,Provincia Autonoma Bolzano / Bozen,P.A. Bolzano,533050,45135,8.47,0.27
3839,2021-06-06,PAB,4543,2183,2360,809,3685,49,ITH,ITH1,4,Provincia Autonoma Bolzano / Bozen,P.A. Bolzano,533050,49678,9.32,0.85
3840,2021-02-26,PAB,1528,551,977,1470,30,28,ITH,ITH1,4,Provincia Autonoma Bolzano / Bozen,P.A. Bolzano,533050,51206,9.61,0.29
3841,2021-06-01,PAB,3641,2369,1272,2030,1474,137,ITH,ITH1,4,Provincia Autonoma Bolzano / Bozen,P.A. Bolzano,533050,54847,10.29,0.68
3842,2021-02-19,PAB,2252,512,1740,2192,11,49,ITH,ITH1,4,Provincia Autonoma Bolzano / Bozen,P.A. Bolzano,533050,57099,10.71,0.42
3843,2021-01-24,PAB,12,10,2,0,12,0,ITH,ITH1,4,Provincia Autonoma Bolzano / Bozen,P.A. Bolzano,533050,57111,10.71,0.0
3844,2021-06-20,PAB,5236,2848,2388,594,4594,48,ITH,ITH1,4,Provincia Autonoma Bolzano / Bozen,P.A. Bolzano,533050,62347,11.7,0.98
3845,2021-02-07,PAB,2364,1059,1305,14,2350,0,ITH,ITH1,4,Provincia Autonoma Bolzano / Bozen,P.A. Bolzano,533050,64711,12.14,0.44
3846,2021-05-18,PAB,3345,1755,1590,2053,1188,104,ITH,ITH1,4,Provincia Autonoma Bolzano / Bozen,P.A. Bolzano,533050,68056,12.77,0.63
3847,2021-05-20,PAB,4935,2479,2456,3286,1471,178,ITH,ITH1,4,Provincia Autonoma Bolzano / Bozen,P.A. Bolzano,533050,72991,13.69,0.93
3848,2021-07-09,PAB,5219,2610,2609,910,4163,146,ITH,ITH1,4,Provincia Autonoma Bolzano / Bozen,P.A. Bolzano,533050,78210,14.67,0.98
3849,2021-03-31,PAB,1835,695,1140,727,1014,94,ITH,ITH1,4,Provincia Autonoma Bolzano / Bozen,P.A. Bolzano,533050,80045,15.02,0.34
3850,2021-03-17,PAB,582,213,369,546,2,34,ITH,ITH1,4,Provincia Autonoma Bolzano / Bozen,P.A. Bolzano,533050,80627,15.13,0.11
3851,2021-05-13,PAB,2995,1355,1640,1010,1930,55,ITH,ITH1,4,Provincia Autonoma Bolzano / Bozen,P.A. Bolzano,533050,83622,15.69,0.56
3852,2021-04-29,PAB,2631,1351,1280,1731,694,206,ITH,ITH1,4,Provincia Autonoma Bolzano / Bozen,P.A. Bolzano,533050,86253,16.18,0.49
3853,2021-01-19,PAB,853,371,482,723,130,0,ITH,ITH1,4,Provincia Autonoma Bolzano / Bozen,P.A. Bolzano,533050,87106,16.34,0.16
3854,2021-06-25,PAB,4177,2307,1870,1023,3015,139,ITH,ITH1,4,Provincia Autonoma Bolzano / Bozen,P.A. Bolzano,533050,91283,17.12,0.78
3855,2021-03-05,PAB,1843,627,1216,1381,443,19,ITH,ITH1,4,Provincia Autonoma Bolzano / Bozen,P.A. Bolzano,533050,93126,17.47,0.35
3856,2021-05-27,PAB,6176,3253,2923,3828,2012,336,ITH,ITH1,4,Provincia Autonoma Bolzano / Bozen,P.A. Bolzano,533050,99302,18.63,1.16
3857,2021-06-13,PAB,3682,2049,1633,451,3191,40,ITH,ITH1,4,Provincia Autonoma Bolzano / Bozen,P.A. Bolzano,533050,102984,19.32,0.69
3858,2021-05-25,PAB,3868,2006,1862,2864,886,118,ITH,ITH1,4,Provincia Autonoma Bolzano / Bozen,P.A. Bolzano,533050,106852,20.05,0.73
3859,2021-02-14,PAB,297,130,167,295,0,2,ITH,ITH1,4,Provincia Autonoma Bolzano / Bozen,P.A. Bolzano,533050,107149,20.1,0.06
3860,2021-05-08,PAB,4427,2382,2045,3558,663,206,ITH,ITH1,4,Provincia Autonoma Bolzano / Bozen,P.A. Bolzano,533050,111576,20.93,0.83
3861,2021-03-03,PAB,1181,395,786,1144,13,24,ITH,ITH1,4,Provincia Autonoma Bolzano / Bozen,P.A. Bolzano,533050,112757,21.15,0.22
3862,2021-06-29,PAB,1878,1014,864,241,1617,20,ITH,ITH1,4,Provincia Autonoma Bolzano / Bozen,P.A. Bolzano,533050,114635,21.51,0.35
3863,2021-03-21,PAB,769,286,483,14,754,1,ITH,ITH1,4,Provincia Autonoma Bolzano / Bozen,P.A. Bolzano,533050,115404,21.65,0.14
3864,2021-04-17,PAB,5239,2602,2637,4945,44,250,ITH,ITH1,4,Provincia Autonoma Bolzano / Bozen,P.A. Bolzano,533050,120643,22.63,0.98
3865,2021-01-07,PAB,920,328,592,920,0,0,ITH,ITH1,4,Provincia Autonoma Bolzano / Bozen,P.A. Bolzano,533050,121563,22.81,0.17
3866,2021-07-21,PAB,3216,1880,1336,521,2642,53,ITH,ITH1,4,Provincia Autonoma Bolzano / Bozen,P.A. Bolzano,533050,124779,23.41,0.6
3867,2021-04-12,PAB,2105,946,1159,2022,7,76,ITH,ITH1,4,Provincia Autonoma Bolzano / Bozen,P.A. Bolzano,533050,126884,23.8,0.39
3868,2021-03-07,PAB,115,14,101,9,106,0,ITH,ITH1,4,Provincia Autonoma Bolzano / Bozen,P.A. Bolzano,533050,126999,23.82,0.02
3869,2021-08-04,PAB,3374,1791,1583,2311,955,108,ITH,ITH1,4,Provincia Autonoma Bolzano / Bozen,P.A. Bolzano,533050,130373,24.46,0.63
3870,2021-06-08,PAB,4211,2151,2060,863,3320,28,ITH,ITH1,4,Provincia Autonoma Bolzano / Bozen,P.A. Bolzano,533050,134584,25.25,0.79
3871,2021-07-04,PAB,4417,2131,2286,160,4229,28,ITH,ITH1,4,Provincia Autonoma Bolzano / Bozen,P.A. Bolzano,533050,139001,26.08,0.83
3872,2021-05-15,PAB,7012,3693,3319,6297,294,421,ITH,ITH1,4,Provincia Autonoma Bolzano / Bozen,P.A. Bolzano,533050,146013,27.39,1.32
3873,2021-08-09,PAB,1531,854,677,1117,414,0,ITH,ITH1,4,Provincia Autonoma Bolzano / Bozen,P.A. Bolzano,533050,147544,27.68,0.29
3874,2021-05-01,PAB,2105,1067,1038,1811,160,134,ITH,ITH1,4,Provincia Autonoma Bolzano / Bozen,P.A. Bolzano,533050,149649,28.07,0.39
3875,2021-03-12,PAB,1666,734,932,1221,413,32,ITH,ITH1,4,Provincia Autonoma Bolzano / Bozen,P.A. Bolzano,533050,151315,28.39,0.31
3876,2021-03-29,PAB,1172,500,672,390,760,22,ITH,ITH1,4,Provincia Autonoma Bolzano / Bozen,P.A. Bolzano,533050,152487,28.61,0.22
3877,2021-07-23,PAB,4347,2369,1978,1687,2391,269,ITH,ITH1,4,Provincia Autonoma Bolzano / Bozen,P.A. Bolzano,533050,156834,29.42,0.82
3878,2021-01-05,PAB,830,286,544,829,0,1,ITH,ITH1,4,Provincia Autonoma Bolzano / Bozen,P.A. Bolzano,533050,157664,29.58,0.16
3879,2021-01-23,PAB,197,117,80,0,197,0,ITH,ITH1,4,Provincia Autonoma Bolzano / Bozen,P.A. Bolzano,533050,157861,29.61,0.04
3880,2021-05-03,PAB,1832,848,984,397,1414,21,ITH,ITH1,4,Provincia Autonoma Bolzano / Bozen,P.A. Bolzano,533050,159693,29.96,0.34
3881,2021-02-23,PAB,769,324,445,760,6,3,ITH,ITH1,4,Provincia Autonoma Bolzano / Bozen,P.A. Bolzano,533050,160462,30.1,0.14
3882,2021-05-17,PAB,3141,1518,1623,2268,694,179,ITH,ITH1,4,Provincia Autonoma Bolzano / Bozen,P.A. Bolzano,533050,163603,30.69,0.59
3883,2021-02-09,PAB,317,126,191,1,316,0,ITH,ITH1,4,Provincia Autonoma Bolzano / Bozen,P.A. Bolzano,533050,163920,30.75,0.06
3884,2021-07-13,PAB,3378,1731,1647,1310,1928,140,ITH,ITH1,4,Provincia Autonoma Bolzano / Bozen,P.A. Bolzano,533050,167298,31.39,0.63
3885,2021-02-02,PAB,1752,509,1243,8,1744,0,ITH,ITH1,4,Provincia Autonoma Bolzano / Bozen,P.A. Bolzano,533050,169050,31.71,0.33
3886,2021-07-20,PAB,3130,1728,1402,1396,1523,211,ITH,ITH1,4,Provincia Autonoma Bolzano / Bozen,P.A. Bolzano,533050,172180,32.3,0.59
3887,2021-05-10,PAB,3019,1300,1719,1331,1606,82,ITH,ITH1,4,Provincia Autonoma Bolzano / Bozen,P.A. Bolzano,533050,175199,32.87,0.57
3888,2021-08-01,PAB,1293,749,544,691,548,54,ITH,ITH1,4,Provincia Autonoma Bolzano / Bozen,P.A. Bolzano,533050,176492,33.11,0.24
3889,2021-06-12,PAB,5068,2752,2316,1650,3288,130,ITH,ITH1,4,Provincia Autonoma Bolzano / Bozen,P.A. Bolzano,533050,181560,34.06,0.95
3890,2021-01-14,PAB,1952,578,1374,1952,0,0,ITH,ITH1,4,Provincia Autonoma Bolzano / Bozen,P.A. Bolzano,533050,183512,34.43,0.37
3891,2021-04-07,PAB,1798,823,975,1162,540,96,ITH,ITH1,4,Provincia Autonoma Bolzano / Bozen,P.A. Bolzano,533050,185310,34.76,0.34
3892,2021-03-02,PAB,696,200,496,674,2,20,ITH,ITH1,4,Provincia Autonoma Bolzano / Bozen,P.A. Bolzano,533050,186006,34.89,0.13
3893,2021-03-19,PAB,1920,777,1143,749,1120,51,ITH,ITH1,4,Provincia Autonoma Bolzano / Bozen,P.A. Bolzano,533050,187926,35.25,0.36
3894,2021-07-30,PAB,5277,2831,2446,3379,1538,360,ITH,ITH1,4,Provincia Autonoma Bolzano / Bozen,P.A. Bolzano,533050,193203,36.24,0.99
3895,2021-04-21,PAB,3013,1468,1545,2033,848,132,ITH,ITH1,4,Provincia Autonoma Bolzano / Bozen,P.A. Bolzano,533050,196216,36.81,0.57
3896,2021-06-24,PAB,3935,2036,1899,1567,2196,172,ITH,ITH1,4,Provincia Autonoma Bolzano / Bozen,P.A. Bolzano,533050,200151,37.55,0.74
3897,2021-01-09,PAB,612,326,286,612,0,0,ITH,ITH1,4,Provincia Autonoma Bolzano / Bozen,P.A. Bolzano,533050,200763,37.66,0.11
3898,2021-08-06,PAB,3354,1760,1594,1069,2284,1,ITH,ITH1,4,Provincia Autonoma Bolzano / Bozen,P.A. Bolzano,533050,204117,38.29,0.63
3899,2021-04-28,PAB,2464,1302,1162,2241,5,218,ITH,ITH1,4,Provincia Autonoma Bolzano / Bozen,P.A. Bolzano,533050,206581,38.75,0.46
3900,2021-01-16,PAB,2840,1265,1575,2840,0,0,ITH,ITH1,4,Provincia Autonoma Bolzano / Bozen,P.A. Bolzano,533050,209421,39.29,0.53
3901,2021-06-10,PAB,4474,2319,2155,1288,3094,92,ITH,ITH1,4,Provincia Autonoma Bolzano / Bozen,P.A. Bolzano,533050,213895,40.13,0.84
3902,2021-06-03,PAB,4848,2642,2206,3649,972,227,ITH,ITH1,4,Provincia Autonoma Bolzano / Bozen,P.A. Bolzano,533050,218743,41.04,0.91
3903,2021-07-06,PAB,1720,924,796,683,982,55,ITH,ITH1,4,Provincia Autonoma Bolzano / Bozen,P.A. Bolzano,533050,220463,41.36,0.32
3904,2021-06-22,PAB,2468,1421,1047,317,2125,26,ITH,ITH1,4,Provincia Autonoma Bolzano / Bozen,P.A. Bolzano,533050,222931,41.82,0.46
3905,2021-03-14,PAB,758,336,422,14,733,11,ITH,ITH1,4,Provincia Autonoma Bolzano / Bozen,P.A. Bolzano,533050,223689,41.96,0.14
3906,2021-04-14,PAB,3593,1645,1948,3216,91,286,ITH,ITH1,4,Provincia Autonoma Bolzano / Bozen,P.A. Bolzano,533050,227282,42.64,0.67
3907,2021-01-04,PAB,510,201,309,510,0,0,ITH,ITH1,4,Provincia Autonoma Bolzano / Bozen,P.A. Bolzano,533050,227792,42.73,0.1
3908,2021-02-16,PAB,530,205,325,529,0,1,ITH,ITH1,4,Provincia Autonoma Bolzano / Bozen,P.A. Bolzano,533050,228322,42.83,0.1
3909,2021-01-28,PAB,871,308,563,9,862,0,ITH,ITH1,4,Provincia Autonoma Bolzano / Bozen,P.A. Bolzano,533050,229193,43.0,0.16
3910,2021-04-25,PAB,3073,1497,1576,2274,672,127,ITH,ITH1,4,Provincia Autonoma Bolzano / Bozen,P.A. Bolzano,533050,232266,43.57,0.58
3911,2021-05-31,PAB,3031,1494,1537,2040,867,124,ITH,ITH1,4,Provincia Autonoma Bolzano / Bozen,P.A. Bolzano,533050,235297,44.14,0.57
3912,2021-07-01,PAB,4634,2301,2333,1310,3165,159,ITH,ITH1,4,Provincia Autonoma Bolzano / Bozen,P.A. Bolzano,533050,239931,45.01,0.87
3913,2021-03-04,PAB,1718,1008,710,1432,229,57,ITH,ITH1,4,Provincia Autonoma Bolzano / Bozen,P.A. Bolzano,533050,241649,45.33,0.32
3914,2021-04-26,PAB,1543,771,772,1446,5,92,ITH,ITH1,4,Provincia Autonoma Bolzano / Bozen,P.A. Bolzano,533050,243192,45.62,0.29
3915,2021-07-10,PAB,5804,2997,2807,927,4741,136,ITH,ITH1,4,Provincia Autonoma Bolzano / Bozen,P.A. Bolzano,533050,248996,46.71,1.09
3916,2021-06-17,PAB,1768,980,788,616,1079,73,ITH,ITH1,4,Provincia Autonoma Bolzano / Bozen,P.A. Bolzano,533050,250764,47.04,0.33
3917,2021-01-02,PAB,91,48,43,91,0,0,ITH,ITH1,4,Provincia Autonoma Bolzano / Bozen,P.A. Bolzano,533050,250855,47.06,0.02
3918,2021-06-26,PAB,4543,2329,2214,1362,3074,107,ITH,ITH1,4,Provincia Autonoma Bolzano / Bozen,P.A. Bolzano,533050,255398,47.91,0.85
3919,2021-03-18,PAB,1302,531,771,216,1076,10,ITH,ITH1,4,Provincia Autonoma Bolzano / Bozen,P.A. Bolzano,533050,256700,48.16,0.24
3920,2021-08-08,PAB,1548,840,708,719,829,0,ITH,ITH1,4,Provincia Autonoma Bolzano / Bozen,P.A. Bolzano,533050,258248,48.45,0.29
3921,2021-01-21,PAB,969,452,517,140,829,0,ITH,ITH1,4,Provincia Autonoma Bolzano / Bozen,P.A. Bolzano,533050,259217,48.63,0.18
3922,2021-07-25,PAB,1891,1127,764,665,1146,80,ITH,ITH1,4,Provincia Autonoma Bolzano / Bozen,P.A. Bolzano,533050,261108,48.98,0.35
3923,2021-08-03,PAB,2695,1444,1251,1751,817,127,ITH,ITH1,4,Provincia Autonoma Bolzano / Bozen,P.A. Bolzano,533050,263803,49.49,0.51
3924,2021-01-13,PAB,1719,566,1153,1719,0,0,ITH,ITH1,4,Provincia Autonoma Bolzano / Bozen,P.A. Bolzano,533050,265522,49.81,0.32
3925,2021-01-30,PAB,498,245,253,4,494,0,ITH,ITH1,4,Provincia Autonoma Bolzano / Bozen,P.A. Bolzano,533050,266020,49.91,0.09
3926,2021-04-23,PAB,4546,2152,2394,3043,1291,212,ITH,ITH1,4,Provincia Autonoma Bolzano / Bozen,P.A. Bolzano,533050,270566,50.76,0.85
3927,2021-02-06,PAB,2632,1175,1457,19,2613,0,ITH,ITH1,4,Provincia Autonoma Bolzano / Bozen,P.A. Bolzano,533050,273198,51.25,0.49
3928,2021-06-21,PAB,3167,1614,1553,260,2867,40,ITH,ITH1,4,Provincia Autonoma Bolzano / Bozen,P.A. Bolzano,533050,276365,51.85,0.59
3929,2021-01-01,PAB,6,5,1,6,0,0,ITH,ITH1,4,Provincia Autonoma Bolzano / Bozen,P.A. Bolzano,533050,276371,51.85,0.0
3930,2021-06-07,PAB,2958,1541,1417,2500,319,139,ITH,ITH1,4,Provincia Autonoma Bolzano / Bozen,P.A. Bolzano,533050,279329,52.4,0.55
3931,2021-02-27,PAB,2458,759,1699,2411,10,37,ITH,ITH1,4,Provincia Autonoma Bolzano / Bozen,P.A. Bolzano,533050,281787,52.86,0.46
3932,2021-02-13,PAB,318,79,239,310,6,2,ITH,ITH1,4,Provincia Autonoma Bolzano / Bozen,P.A. Bolzano,533050,282105,52.92,0.06
3933,2021-04-11,PAB,2724,1294,1430,2446,177,101,ITH,ITH1,4,Provincia Autonoma Bolzano / Bozen,P.A. Bolzano,533050,284829,53.43,0.51
3934,2021-05-26,PAB,4999,2523,2476,2835,1974,190,ITH,ITH1,4,Provincia Autonoma Bolzano / Bozen,P.A. Bolzano,533050,289828,54.37,0.94
3935,2021-06-14,PAB,2977,1613,1364,573,2358,46,ITH,ITH1,4,Provincia Autonoma Bolzano / Bozen,P.A. Bolzano,533050,292805,54.93,0.56
3936,2021-05-14,PAB,5136,2321,2815,2889,2039,208,ITH,ITH1,4,Provincia Autonoma Bolzano / Bozen,P.A. Bolzano,533050,297941,55.89,0.96
3937,2021-03-16,PAB,1290,532,758,116,1166,8,ITH,ITH1,4,Provincia Autonoma Bolzano / Bozen,P.A. Bolzano,533050,299231,56.14,0.24
3938,2021-05-12,PAB,3793,2059,1734,3393,154,246,ITH,ITH1,4,Provincia Autonoma Bolzano / Bozen,P.A. Bolzano,533050,303024,56.85,0.71
3939,2021-02-01,PAB,1460,445,1015,11,1448,1,ITH,ITH1,4,Provincia Autonoma Bolzano / Bozen,P.A. Bolzano,533050,304484,57.12,0.27
3940,2021-01-18,PAB,1772,687,1085,1766,5,1,ITH,ITH1,4,Provincia Autonoma Bolzano / Bozen,P.A. Bolzano,533050,306256,57.45,0.33
3941,2021-05-07,PAB,4195,2063,2132,3377,528,290,ITH,ITH1,4,Provincia Autonoma Bolzano / Bozen,P.A. Bolzano,533050,310451,58.24,0.79
3942,2021-07-03,PAB,5635,2791,2844,974,4563,98,ITH,ITH1,4,Provincia Autonoma Bolzano / Bozen,P.A. Bolzano,533050,316086,59.3,1.06
3943,2021-01-11,PAB,1590,521,1069,1590,0,0,ITH,ITH1,4,Provincia Autonoma Bolzano / Bozen,P.A. Bolzano,533050,317676,59.6,0.3
3944,2021-07-15,PAB,4387,2314,2073,1500,2699,188,ITH,ITH1,4,Provincia Autonoma Bolzano / Bozen,P.A. Bolzano,533050,322063,60.42,0.82
3945,2021-04-06,PAB,2251,1118,1133,1940,104,207,ITH,ITH1,4,Provincia Autonoma Bolzano / Bozen,P.A. Bolzano,533050,324314,60.84,0.42
3946,2021-07-17,PAB,3142,1797,1345,698,2348,96,ITH,ITH1,4,Provincia Autonoma Bolzano / Bozen,P.A. Bolzano,533050,327456,61.43,0.59
3947,2021-04-08,PAB,2775,1353,1422,2477,204,94,ITH,ITH1,4,Provincia Autonoma Bolzano / Bozen,P.A. Bolzano,533050,330231,61.95,0.52
3948,2021-06-05,PAB,6080,3030,3050,4696,1096,288,ITH,ITH1,4,Provincia Autonoma Bolzano / Bozen,P.A. Bolzano,533050,336311,63.09,1.14
3949,2021-04-30,PAB,3343,1595,1748,1430,1776,137,ITH,ITH1,4,Provincia Autonoma Bolzano / Bozen,P.A. Bolzano,533050,339654,63.72,0.63
3950,2021-01-20,PAB,619,254,365,410,209,0,ITH,ITH1,4,Provincia Autonoma Bolzano / Bozen,P.A. Bolzano,533050,340273,63.84,0.12
3951,2021-07-22,PAB,3721,1933,1788,1719,1787,215,ITH,ITH1,4,Provincia Autonoma Bolzano / Bozen,P.A. Bolzano,533050,343994,64.53,0.7
3952,2021-01-06,PAB,59,18,41,59,0,0,ITH,ITH1,4,Provincia Autonoma Bolzano / Bozen,P.A. Bolzano,533050,344053,64.54,0.01
3953,2021-03-28,PAB,569,212,357,11,558,0,ITH,ITH1,4,Provincia Autonoma Bolzano / Bozen,P.A. Bolzano,533050,344622,64.65,0.11
3954,2021-08-10,PAB,1284,688,596,1228,56,0,ITH,ITH1,4,Provincia Autonoma Bolzano / Bozen,P.A. Bolzano,533050,345906,64.89,0.24
3955,2021-05-24,PAB,1455,767,688,1039,334,82,ITH,ITH1,4,Provincia Autonoma Bolzano / Bozen,P.A. Bolzano,533050,347361,65.16,0.27
3956,2021-02-20,PAB,1802,540,1262,1753,18,31,ITH,ITH1,4,Provincia Autonoma Bolzano / Bozen,P.A. Bolzano,533050,349163,65.5,0.34
3957,2021-07-27,PAB,3144,1881,1263,882,2176,86,ITH,ITH1,4,Provincia Autonoma Bolzano / Bozen,P.A. Bolzano,533050,352307,66.09,0.59
3958,2021-04-18,PAB,3110,1607,1503,2004,1010,96,ITH,ITH1,4,Provincia Autonoma Bolzano / Bozen,P.A. Bolzano,533050,355417,66.68,0.58
3959,2021-01-15,PAB,3284,1230,2054,3283,0,1,ITH,ITH1,4,Provincia Autonoma Bolzano / Bozen,P.A. Bolzano,533050,358701,67.29,0.62
3960,2021-02-15,PAB,72,42,30,23,46,3,ITH,ITH1,4,Provincia Autonoma Bolzano / Bozen,P.A. Bolzano,533050,358773,67.31,0.01
3961,2021-05-11,PAB,2845,1336,1509,1242,1522,81,ITH,ITH1,4,Provincia Autonoma Bolzano / Bozen,P.A. Bolzano,533050,361618,67.84,0.53
3962,2021-07-31,PAB,3163,1718,1445,2107,922,134,ITH,ITH1,4,Provincia Autonoma Bolzano / Bozen,P.A. Bolzano,533050,364781,68.43,0.59
3963,2021-01-29,PAB,1512,517,995,24,1488,0,ITH,ITH1,4,Provincia Autonoma Bolzano / Bozen,P.A. Bolzano,533050,366293,68.72,0.28
3964,2021-04-22,PAB,2926,1503,1423,1854,942,130,ITH,ITH1,4,Provincia Autonoma Bolzano / Bozen,P.A. Bolzano,533050,369219,69.27,0.55
3965,2021-03-09,PAB,1194,543,651,1164,2,28,ITH,ITH1,4,Provincia Autonoma Bolzano / Bozen,P.A. Bolzano,533050,370413,69.49,0.22
3966,2021-05-23,PAB,4338,2303,2035,4117,8,213,ITH,ITH1,4,Provincia Autonoma Bolzano / Bozen,P.A. Bolzano,533050,374751,70.3,0.81
3967,2021-07-19,PAB,2772,1389,1383,617,2046,109,ITH,ITH1,4,Provincia Autonoma Bolzano / Bozen,P.A. Bolzano,533050,377523,70.82,0.52
3968,2021-02-03,PAB,1506,479,1027,5,1501,0,ITH,ITH1,4,Provincia Autonoma Bolzano / Bozen,P.A. Bolzano,533050,379029,71.11,0.28
3969,2021-02-10,PAB,1636,605,1031,25,1610,1,ITH,ITH1,4,Provincia Autonoma Bolzano / Bozen,P.A. Bolzano,533050,380665,71.41,0.31
3970,2021-05-05,PAB,4156,1946,2210,1811,2116,229,ITH,ITH1,4,Provincia Autonoma Bolzano / Bozen,P.A. Bolzano,533050,384821,72.19,0.78
3971,2021-01-25,PAB,491,185,306,3,488,0,ITH,ITH1,4,Provincia Autonoma Bolzano / Bozen,P.A. Bolzano,533050,385312,72.28,0.09
3972,2021-03-23,PAB,1555,760,795,1516,1,38,ITH,ITH1,4,Provincia Autonoma Bolzano / Bozen,P.A. Bolzano,533050,386867,72.58,0.29
3973,2021-04-01,PAB,2787,1407,1380,2498,144,145,ITH,ITH1,4,Provincia Autonoma Bolzano / Bozen,P.A. Bolzano,533050,389654,73.1,0.52
3974,2021-07-05,PAB,2936,1406,1530,823,1984,129,ITH,ITH1,4,Provincia Autonoma Bolzano / Bozen,P.A. Bolzano,533050,392590,73.65,0.55
3975,2021-03-30,PAB,1302,532,770,206,1081,15,ITH,ITH1,4,Provincia Autonoma Bolzano / Bozen,P.A. Bolzano,533050,393892,73.89,0.24
3976,2021-04-16,PAB,2952,1420,1532,2275,512,165,ITH,ITH1,4,Provincia Autonoma Bolzano / Bozen,P.A. Bolzano,533050,396844,74.45,0.55
3977,2021-07-08,PAB,5506,2781,2725,545,4883,78,ITH,ITH1,4,Provincia Autonoma Bolzano / Bozen,P.A. Bolzano,533050,402350,75.48,1.03
3978,2021-06-19,PAB,5662,3015,2647,555,5035,72,ITH,ITH1,4,Provincia Autonoma Bolzano / Bozen,P.A. Bolzano,533050,408012,76.54,1.06
3979,2021-03-11,PAB,1691,830,861,1098,539,54,ITH,ITH1,4,Provincia Autonoma Bolzano / Bozen,P.A. Bolzano,533050,409703,76.86,0.32
3980,2021-02-25,PAB,1498,549,949,1487,1,10,ITH,ITH1,4,Provincia Autonoma Bolzano / Bozen,P.A. Bolzano,533050,411201,77.14,0.28
3981,2021-06-02,PAB,1465,823,642,976,458,31,ITH,ITH1,4,Provincia Autonoma Bolzano / Bozen,P.A. Bolzano,533050,412666,77.42,0.27
3982,2020-12-27,PAB,144,65,79,144,0,0,ITH,ITH1,4,Provincia Autonoma Bolzano / Bozen,P.A. Bolzano,533050,412810,77.44,0.03
3983,2021-06-30,PAB,3062,1564,1498,399,2606,57,ITH,ITH1,4,Provincia Autonoma Bolzano / Bozen,P.A. Bolzano,533050,415872,78.02,0.57
3984,2021-06-11,PAB,5803,2985,2818,2105,3480,218,ITH,ITH1,4,Provincia Autonoma Bolzano / Bozen,P.A. Bolzano,533050,421675,79.11,1.09
3985,2021-03-20,PAB,1759,850,909,1108,625,26,ITH,ITH1,4,Provincia Autonoma Bolzano / Bozen,P.A. Bolzano,533050,423434,79.44,0.33
3986,2021-06-04,PAB,6603,3315,3288,4835,1533,235,ITH,ITH1,4,Provincia Autonoma Bolzano / Bozen,P.A. Bolzano,533050,430037,80.67,1.24
3987,2021-02-24,PAB,1368,407,961,1317,12,39,ITH,ITH1,4,Provincia Autonoma Bolzano / Bozen,P.A. Bolzano,533050,431405,80.93,0.26
3988,2021-03-27,PAB,3053,1554,1499,1479,1508,66,ITH,ITH1,4,Provincia Autonoma Bolzano / Bozen,P.A. Bolzano,533050,434458,81.5,0.57
3989,2021-03-13,PAB,2886,1460,1426,2726,101,59,ITH,ITH1,4,Provincia Autonoma Bolzano / Bozen,P.A. Bolzano,533050,437344,82.05,0.54
3990,2021-06-18,PAB,4160,2164,1996,1128,2901,131,ITH,ITH1,4,Provincia Autonoma Bolzano / Bozen,P.A. Bolzano,533050,441504,82.83,0.78
3991,2021-01-08,PAB,1525,479,1046,1525,0,0,ITH,ITH1,4,Provincia Autonoma Bolzano / Bozen,P.A. Bolzano,533050,443029,83.11,0.29
3992,2021-08-07,PAB,1893,1093,800,1364,529,0,ITH,ITH1,4,Provincia Autonoma Bolzano / Bozen,P.A. Bolzano,533050,444922,83.47,0.36
3993,2021-05-09,PAB,4242,2411,1831,2925,1152,165,ITH,ITH1,4,Provincia Autonoma Bolzano / Bozen,P.A. Bolzano,533050,449164,84.26,0.8
3994,2021-03-06,PAB,3973,2081,1892,3674,211,88,ITH,ITH1,4,Provincia Autonoma Bolzano / Bozen,P.A. Bolzano,533050,453137,85.01,0.75
3995,2021-05-28,PAB,7186,3782,3404,5076,1891,219,ITH,ITH1,4,Provincia Autonoma Bolzano / Bozen,P.A. Bolzano,533050,460323,86.36,1.35
3996,2021-02-17,PAB,156,51,105,139,17,0,ITH,ITH1,4,Provincia Autonoma Bolzano / Bozen,P.A. Bolzano,533050,460479,86.39,0.03
3997,2021-06-28,PAB,4608,2305,2303,216,4368,24,ITH,ITH1,4,Provincia Autonoma Bolzano / Bozen,P.A. Bolzano,533050,465087,87.25,0.86
3998,2021-05-21,PAB,6960,3826,3134,4804,1847,309,ITH,ITH1,4,Provincia Autonoma Bolzano / Bozen,P.A. Bolzano,533050,472047,88.56,1.31
3999,2021-05-16,PAB,2027,933,1094,1280,693,54,ITH,ITH1,4,Provincia Autonoma Bolzano / Bozen,P.A. Bolzano,533050,474074,88.94,0.38
4000,2021-02-08,PAB,2,1,1,1,1,0,ITH,ITH1,4,Provincia Autonoma Bolzano / Bozen,P.A. Bolzano,533050,474076,88.94,0.0
4001,2021-05-19,PAB,3854,1979,1875,1925,1787,142,ITH,ITH1,4,Provincia Autonoma Bolzano / Bozen,P.A. Bolzano,533050,477930,89.66,0.72
4002,2021-01-03,PAB,41,16,25,41,0,0,ITH,ITH1,4,Provincia Autonoma Bolzano / Bozen,P.A. Bolzano,533050,477971,89.67,0.01
4003,2021-04-13,PAB,2394,1132,1262,2298,7,89,ITH,ITH1,4,Provincia Autonoma Bolzano / Bozen,P.A. Bolzano,533050,480365,90.12,0.45
4004,2021-05-30,PAB,4782,2524,2258,727,4021,34,ITH,ITH1,4,Provincia Autonoma Bolzano / Bozen,P.A. Bolzano,533050,485147,91.01,0.9
4005,2021-07-12,PAB,3530,1754,1776,251,3241,38,ITH,ITH1,4,Provincia Autonoma Bolzano / Bozen,P.A. Bolzano,533050,488677,91.68,0.66
4006,2021-04-03,PAB,833,366,467,13,811,9,ITH,ITH1,4,Provincia Autonoma Bolzano / Bozen,P.A. Bolzano,533050,489510,91.83,0.16
4007,2021-03-25,PAB,2170,1080,1090,1662,443,65,ITH,ITH1,4,Provincia Autonoma Bolzano / Bozen,P.A. Bolzano,533050,491680,92.24,0.41
4008,2021-01-27,PAB,85,29,56,2,83,0,ITH,ITH1,4,Provincia Autonoma Bolzano / Bozen,P.A. Bolzano,533050,491765,92.25,0.02
4009,2021-02-05,PAB,3201,1186,2015,8,3193,0,ITH,ITH1,4,Provincia Autonoma Bolzano / Bozen,P.A. Bolzano,533050,494966,92.86,0.6
4010,2021-04-15,PAB,4401,2307,2094,3902,263,236,ITH,ITH1,4,Provincia Autonoma Bolzano / Bozen,P.A. Bolzano,533050,499367,93.68,0.83
4011,2021-07-24,PAB,4802,2834,1968,1355,3324,123,ITH,ITH1,4,Provincia Autonoma Bolzano / Bozen,P.A. Bolzano,533050,504169,94.58,0.9
4012,2021-05-02,PAB,2457,1288,1169,1424,921,112,ITH,ITH1,4,Provincia Autonoma Bolzano / Bozen,P.A. Bolzano,533050,506626,95.04,0.46
4013,2021-01-22,PAB,248,143,105,124,124,0,ITH,ITH1,4,Provincia Autonoma Bolzano / Bozen,P.A. Bolzano,533050,506874,95.09,0.05
4014,2021-07-26,PAB,1626,938,688,1123,411,92,ITH,ITH1,4,Provincia Autonoma Bolzano / Bozen,P.A. Bolzano,533050,508500,95.39,0.31
4015,2021-02-22,PAB,526,143,383,496,12,18,ITH,ITH1,4,Provincia Autonoma Bolzano / Bozen,P.A. Bolzano,533050,509026,95.49,0.1
4016,2021-07-07,PAB,1984,1030,954,583,1336,65,ITH,ITH1,4,Provincia Autonoma Bolzano / Bozen,P.A. Bolzano,533050,511010,95.87,0.37
4017,2021-02-04,PAB,1964,596,1368,8,1956,0,ITH,ITH1,4,Provincia Autonoma Bolzano / Bozen,P.A. Bolzano,533050,512974,96.23,0.37
4018,2021-07-11,PAB,6067,3091,2976,1082,4873,112,ITH,ITH1,4,Provincia Autonoma Bolzano / Bozen,P.A. Bolzano,533050,519041,97.37,1.14
4019,2021-04-02,PAB,2088,839,1249,590,1357,141,ITH,ITH1,4,Provincia Autonoma Bolzano / Bozen,P.A. Bolzano,533050,521129,97.76,0.39
4020,2021-05-29,PAB,7321,3894,3427,4002,3139,180,ITH,ITH1,4,Provincia Autonoma Bolzano / Bozen,P.A. Bolzano,533050,528450,99.14,1.37
4021,2021-03-26,PAB,1661,735,926,504,1136,21,ITH,ITH1,4,Provincia Autonoma Bolzano / Bozen,P.A. Bolzano,533050,530111,99.45,0.31
4022,2021-04-09,PAB,2937,1301,1636,1936,730,271,ITH,ITH1,4,Provincia Autonoma Bolzano / Bozen,P.A. Bolzano,533050,533048,100.0,0.55
4023,2021-05-22,PAB,6838,3568,3270,4445,2166,227,ITH,ITH1,4,Provincia Autonoma Bolzano / Bozen,P.A. Bolzano,533050,539886,101.28,1.28
4024,2021-02-11,PAB,1094,432,662,238,855,1,ITH,ITH1,4,Provincia Autonoma Bolzano / Bozen,P.A. Bolzano,533050,540980,101.49,0.21
4025,2021-07-18,PAB,1862,1032,830,635,1148,79,ITH,ITH1,4,Provincia Autonoma Bolzano / Bozen,P.A. Bolzano,533050,542842,101.84,0.35
4026,2021-02-18,PAB,1839,457,1382,1810,7,22,ITH,ITH1,4,Provincia Autonoma Bolzano / Bozen,P.A. Bolzano,533050,544681,102.18,0.34
4027,2021-07-29,PAB,1334,714,620,705,570,59,ITH,ITH1,4,Provincia Autonoma Bolzano / Bozen,P.A. Bolzano,533050,546015,102.43,0.25
4028,2020-12-30,PAB,389,183,206,389,0,0,ITH,ITH1,4,Provincia Autonoma Bolzano / Bozen,P.A. Bolzano,533050,546404,102.51,0.07
4029,2021-06-09,PAB,3824,1902,1922,1237,2477,110,ITH,ITH1,4,Provincia Autonoma Bolzano / Bozen,P.A. Bolzano,533050,550228,103.22,0.72
4030,2021-03-01,PAB,925,223,702,889,1,35,ITH,ITH1,4,Provincia Autonoma Bolzano / Bozen,P.A. Bolzano,533050,551153,103.4,0.17
4031,2021-08-05,PAB,3307,1802,1505,1729,1490,88,ITH,ITH1,4,Provincia Autonoma Bolzano / Bozen,P.A. Bolzano,533050,554460,104.02,0.62
4032,2021-03-15,PAB,1194,452,742,696,482,16,ITH,ITH1,4,Provincia Autonoma Bolzano / Bozen,P.A. Bolzano,533050,555654,104.24,0.22
4033,2021-04-27,PAB,2227,1013,1214,1052,1077,98,ITH,ITH1,4,Provincia Autonoma Bolzano / Bozen,P.A. Bolzano,533050,557881,104.66,0.42
4034,2021-01-17,PAB,2329,1044,1285,2318,11,0,ITH,ITH1,4,Provincia Autonoma Bolzano / Bozen,P.A. Bolzano,533050,560210,105.1,0.44
4035,2021-06-23,PAB,1151,594,557,333,767,51,ITH,ITH1,4,Provincia Autonoma Bolzano / Bozen,P.A. Bolzano,533050,561361,105.31,0.22
4036,2021-04-20,PAB,1563,785,778,1486,3,74,ITH,ITH1,4,Provincia Autonoma Bolzano / Bozen,P.A. Bolzano,533050,562924,105.6,0.29
4037,2021-01-10,PAB,2,2,0,2,0,0,ITH,ITH1,4,Provincia Autonoma Bolzano / Bozen,P.A. Bolzano,533050,562926,105.6,0.0
4038,2021-06-16,PAB,3819,2025,1794,11,3804,4,ITH,ITH1,4,Provincia Autonoma Bolzano / Bozen,P.A. Bolzano,533050,566745,106.32,0.72
4039,2021-03-08,PAB,1210,534,676,1161,27,22,ITH,ITH1,4,Provincia Autonoma Bolzano / Bozen,P.A. Bolzano,533050,567955,106.55,0.23
4040,2021-05-04,PAB,3451,1844,1607,2256,1037,158,ITH,ITH1,4,Provincia Autonoma Bolzano / Bozen,P.A. Bolzano,533050,571406,107.2,0.65
4041,2021-04-15,VDA,813,378,435,641,139,33,ITC,ITC2,2,Valle d'Aosta / Vallée d'Aoste,Valle d'Aosta,125666,813,0.65,0.65
4042,2021-07-07,VDA,792,439,353,413,362,17,ITC,ITC2,2,Valle d'Aosta / Vallée d'Aoste,Valle d'Aosta,125666,1605,1.28,0.63
4043,2021-07-24,VDA,1018,535,483,332,683,3,ITC,ITC2,2,Valle d'Aosta / Vallée d'Aoste,Valle d'Aosta,125666,2623,2.09,0.81
4044,2021-05-02,VDA,765,345,420,581,160,24,ITC,ITC2,2,Valle d'Aosta / Vallée d'Aoste,Valle d'Aosta,125666,3388,2.7,0.61
4045,2021-01-22,VDA,58,22,36,22,36,0,ITC,ITC2,2,Valle d'Aosta / Vallée d'Aoste,Valle d'Aosta,125666,3446,2.74,0.05
4046,2021-01-08,VDA,301,131,170,301,0,0,ITC,ITC2,2,Valle d'Aosta / Vallée d'Aoste,Valle d'Aosta,125666,3747,2.98,0.24
4047,2021-03-06,VDA,22,4,18,18,0,4,ITC,ITC2,2,Valle d'Aosta / Vallée d'Aoste,Valle d'Aosta,125666,3769,3.0,0.02
4048,2021-02-05,VDA,296,103,193,102,194,0,ITC,ITC2,2,Valle d'Aosta / Vallée d'Aoste,Valle d'Aosta,125666,4065,3.23,0.24
4049,2021-02-22,VDA,317,94,223,210,104,3,ITC,ITC2,2,Valle d'Aosta / Vallée d'Aoste,Valle d'Aosta,125666,4382,3.49,0.25
4050,2021-05-16,VDA,690,342,348,340,342,8,ITC,ITC2,2,Valle d'Aosta / Vallée d'Aoste,Valle d'Aosta,125666,5072,4.04,0.55
4051,2021-08-07,VDA,739,433,306,306,421,12,ITC,ITC2,2,Valle d'Aosta / Vallée d'Aoste,Valle d'Aosta,125666,5811,4.62,0.59
4052,2021-05-30,VDA,865,429,436,682,171,12,ITC,ITC2,2,Valle d'Aosta / Vallée d'Aoste,Valle d'Aosta,125666,6676,5.31,0.69
4053,2021-07-26,VDA,1005,512,493,316,687,2,ITC,ITC2,2,Valle d'Aosta / Vallée d'Aoste,Valle d'Aosta,125666,7681,6.11,0.8
4054,2021-05-28,VDA,977,415,562,545,413,19,ITC,ITC2,2,Valle d'Aosta / Vallée d'Aoste,Valle d'Aosta,125666,8658,6.89,0.78
4055,2021-02-17,VDA,327,144,183,223,100,4,ITC,ITC2,2,Valle d'Aosta / Vallée d'Aoste,Valle d'Aosta,125666,8985,7.15,0.26
4056,2021-02-03,VDA,353,115,238,15,338,0,ITC,ITC2,2,Valle d'Aosta / Vallée d'Aoste,Valle d'Aosta,125666,9338,7.43,0.28
4057,2021-04-01,VDA,778,394,384,747,12,19,ITC,ITC2,2,Valle d'Aosta / Vallée d'Aoste,Valle d'Aosta,125666,10116,8.05,0.62
4058,2021-03-08,VDA,488,233,255,240,245,3,ITC,ITC2,2,Valle d'Aosta / Vallée d'Aoste,Valle d'Aosta,125666,10604,8.44,0.39
4059,2021-05-04,VDA,1136,511,625,434,674,28,ITC,ITC2,2,Valle d'Aosta / Vallée d'Aoste,Valle d'Aosta,125666,11740,9.34,0.9
4060,2021-06-16,VDA,1062,565,497,664,394,4,ITC,ITC2,2,Valle d'Aosta / Vallée d'Aoste,Valle d'Aosta,125666,12802,10.19,0.85
4061,2021-03-15,VDA,387,141,246,175,203,9,ITC,ITC2,2,Valle d'Aosta / Vallée d'Aoste,Valle d'Aosta,125666,13189,10.5,0.31
4062,2021-05-11,VDA,649,326,323,471,150,28,ITC,ITC2,2,Valle d'Aosta / Vallée d'Aoste,Valle d'Aosta,125666,13838,11.01,0.52
4063,2021-04-27,VDA,979,424,555,651,292,36,ITC,ITC2,2,Valle d'Aosta / Vallée d'Aoste,Valle d'Aosta,125666,14817,11.79,0.78
4064,2021-01-17,VDA,131,56,75,131,0,0,ITC,ITC2,2,Valle d'Aosta / Vallée d'Aoste,Valle d'Aosta,125666,14948,11.9,0.1
4065,2021-06-23,VDA,1044,551,493,423,617,4,ITC,ITC2,2,Valle d'Aosta / Vallée d'Aoste,Valle d'Aosta,125666,15992,12.73,0.83
4066,2021-01-27,VDA,153,73,80,79,74,0,ITC,ITC2,2,Valle d'Aosta / Vallée d'Aoste,Valle d'Aosta,125666,16145,12.85,0.12
4067,2021-04-20,VDA,935,430,505,709,194,32,ITC,ITC2,2,Valle d'Aosta / Vallée d'Aoste,Valle d'Aosta,125666,17080,13.59,0.74
4068,2021-01-10,VDA,220,71,149,208,0,12,ITC,ITC2,2,Valle d'Aosta / Vallée d'Aoste,Valle d'Aosta,125666,17300,13.77,0.18
4069,2020-12-27,VDA,20,9,11,20,0,0,ITC,ITC2,2,Valle d'Aosta / Vallée d'Aoste,Valle d'Aosta,125666,17320,13.78,0.02
4070,2021-07-12,VDA,979,483,496,239,732,8,ITC,ITC2,2,Valle d'Aosta / Vallée d'Aoste,Valle d'Aosta,125666,18299,14.56,0.78
4071,2021-04-03,VDA,676,341,335,649,15,12,ITC,ITC2,2,Valle d'Aosta / Vallée d'Aoste,Valle d'Aosta,125666,18975,15.1,0.54
4072,2021-03-20,VDA,209,87,122,168,36,5,ITC,ITC2,2,Valle d'Aosta / Vallée d'Aoste,Valle d'Aosta,125666,19184,15.27,0.17
4073,2021-06-28,VDA,989,497,492,328,658,3,ITC,ITC2,2,Valle d'Aosta / Vallée d'Aoste,Valle d'Aosta,125666,20173,16.05,0.79
4074,2021-06-11,VDA,1048,484,564,755,283,10,ITC,ITC2,2,Valle d'Aosta / Vallée d'Aoste,Valle d'Aosta,125666,21221,16.89,0.83
4075,2021-03-13,VDA,147,88,59,141,0,6,ITC,ITC2,2,Valle d'Aosta / Vallée d'Aoste,Valle d'Aosta,125666,21368,17.0,0.12
4076,2021-01-15,VDA,220,83,137,220,0,0,ITC,ITC2,2,Valle d'Aosta / Vallée d'Aoste,Valle d'Aosta,125666,21588,17.18,0.18
4077,2021-04-13,VDA,373,171,202,311,44,18,ITC,ITC2,2,Valle d'Aosta / Vallée d'Aoste,Valle d'Aosta,125666,21961,17.48,0.3
4078,2021-07-05,VDA,834,355,479,312,508,14,ITC,ITC2,2,Valle d'Aosta / Vallée d'Aoste,Valle d'Aosta,125666,22795,18.14,0.66
4079,2021-03-27,VDA,336,165,171,291,31,14,ITC,ITC2,2,Valle d'Aosta / Vallée d'Aoste,Valle d'Aosta,125666,23131,18.41,0.27
4080,2021-06-18,VDA,1000,443,557,590,400,10,ITC,ITC2,2,Valle d'Aosta / Vallée d'Aoste,Valle d'Aosta,125666,24131,19.2,0.8
4081,2021-06-04,VDA,910,385,525,469,435,6,ITC,ITC2,2,Valle d'Aosta / Vallée d'Aoste,Valle d'Aosta,125666,25041,19.93,0.72
4082,2021-07-23,VDA,972,485,487,365,606,1,ITC,ITC2,2,Valle d'Aosta / Vallée d'Aoste,Valle d'Aosta,125666,26013,20.7,0.77
4083,2021-02-10,VDA,248,77,171,141,107,0,ITC,ITC2,2,Valle d'Aosta / Vallée d'Aoste,Valle d'Aosta,125666,26261,20.9,0.2
4084,2021-03-25,VDA,389,154,235,364,10,15,ITC,ITC2,2,Valle d'Aosta / Vallée d'Aoste,Valle d'Aosta,125666,26650,21.21,0.31
4085,2021-05-21,VDA,933,443,490,517,401,15,ITC,ITC2,2,Valle d'Aosta / Vallée d'Aoste,Valle d'Aosta,125666,27583,21.95,0.74
4086,2021-04-17,VDA,638,407,231,593,2,43,ITC,ITC2,2,Valle d'Aosta / Vallée d'Aoste,Valle d'Aosta,125666,28221,22.46,0.51
4087,2021-01-07,VDA,280,113,167,280,0,0,ITC,ITC2,2,Valle d'Aosta / Vallée d'Aoste,Valle d'Aosta,125666,28501,22.68,0.22
4088,2021-07-19,VDA,878,460,418,256,619,3,ITC,ITC2,2,Valle d'Aosta / Vallée d'Aoste,Valle d'Aosta,125666,29379,23.38,0.7
4089,2021-02-24,VDA,184,83,101,163,20,1,ITC,ITC2,2,Valle d'Aosta / Vallée d'Aoste,Valle d'Aosta,125666,29563,23.53,0.15
4090,2021-04-08,VDA,585,282,303,419,144,22,ITC,ITC2,2,Valle d'Aosta / Vallée d'Aoste,Valle d'Aosta,125666,30148,23.99,0.47
4091,2021-06-13,VDA,856,403,453,371,482,3,ITC,ITC2,2,Valle d'Aosta / Vallée d'Aoste,Valle d'Aosta,125666,31004,24.67,0.68
4092,2021-06-30,VDA,1120,543,577,417,694,9,ITC,ITC2,2,Valle d'Aosta / Vallée d'Aoste,Valle d'Aosta,125666,32124,25.56,0.89
4093,2021-06-09,VDA,1050,558,492,1007,35,8,ITC,ITC2,2,Valle d'Aosta / Vallée d'Aoste,Valle d'Aosta,125666,33174,26.4,0.84
4094,2021-03-01,VDA,181,66,115,139,34,8,ITC,ITC2,2,Valle d'Aosta / Vallée d'Aoste,Valle d'Aosta,125666,33355,26.54,0.14
4095,2021-02-15,VDA,264,136,128,225,35,4,ITC,ITC2,2,Valle d'Aosta / Vallée d'Aoste,Valle d'Aosta,125666,33619,26.75,0.21
4096,2021-05-23,VDA,999,465,534,653,340,6,ITC,ITC2,2,Valle d'Aosta / Vallée d'Aoste,Valle d'Aosta,125666,34618,27.55,0.79
4097,2021-01-29,VDA,321,139,182,2,319,0,ITC,ITC2,2,Valle d'Aosta / Vallée d'Aoste,Valle d'Aosta,125666,34939,27.8,0.26
4098,2021-04-22,VDA,1068,450,618,652,383,33,ITC,ITC2,2,Valle d'Aosta / Vallée d'Aoste,Valle d'Aosta,125666,36007,28.65,0.85
4099,2021-05-09,VDA,574,287,287,425,130,19,ITC,ITC2,2,Valle d'Aosta / Vallée d'Aoste,Valle d'Aosta,125666,36581,29.11,0.46
4100,2021-07-31,VDA,889,464,425,320,558,11,ITC,ITC2,2,Valle d'Aosta / Vallée d'Aoste,Valle d'Aosta,125666,37470,29.82,0.71
4101,2021-03-31,VDA,555,302,253,511,26,18,ITC,ITC2,2,Valle d'Aosta / Vallée d'Aoste,Valle d'Aosta,125666,38025,30.26,0.44
4102,2021-05-27,VDA,1093,498,595,575,506,12,ITC,ITC2,2,Valle d'Aosta / Vallée d'Aoste,Valle d'Aosta,125666,39118,31.13,0.87
4103,2021-05-13,VDA,1145,560,585,522,602,21,ITC,ITC2,2,Valle d'Aosta / Vallée d'Aoste,Valle d'Aosta,125666,40263,32.04,0.91
4104,2021-02-02,VDA,276,71,205,2,274,0,ITC,ITC2,2,Valle d'Aosta / Vallée d'Aoste,Valle d'Aosta,125666,40539,32.26,0.22
4105,2021-07-09,VDA,945,446,499,280,656,9,ITC,ITC2,2,Valle d'Aosta / Vallée d'Aoste,Valle d'Aosta,125666,41484,33.01,0.75
4106,2021-06-25,VDA,978,445,533,325,651,2,ITC,ITC2,2,Valle d'Aosta / Vallée d'Aoste,Valle d'Aosta,125666,42462,33.79,0.78
4107,2021-05-20,VDA,1044,475,569,591,440,13,ITC,ITC2,2,Valle d'Aosta / Vallée d'Aoste,Valle d'Aosta,125666,43506,34.62,0.83
4108,2021-07-02,VDA,869,384,485,302,562,5,ITC,ITC2,2,Valle d'Aosta / Vallée d'Aoste,Valle d'Aosta,125666,44375,35.31,0.69
4109,2021-03-24,VDA,515,230,285,255,257,3,ITC,ITC2,2,Valle d'Aosta / Vallée d'Aoste,Valle d'Aosta,125666,44890,35.72,0.41
4110,2021-03-29,VDA,494,233,261,449,40,5,ITC,ITC2,2,Valle d'Aosta / Vallée d'Aoste,Valle d'Aosta,125666,45384,36.11,0.39
4111,2021-06-20,VDA,1132,545,587,478,644,10,ITC,ITC2,2,Valle d'Aosta / Vallée d'Aoste,Valle d'Aosta,125666,46516,37.02,0.9
4112,2021-03-12,VDA,531,175,356,291,226,14,ITC,ITC2,2,Valle d'Aosta / Vallée d'Aoste,Valle d'Aosta,125666,47047,37.44,0.42
4113,2021-03-10,VDA,438,183,255,220,213,5,ITC,ITC2,2,Valle d'Aosta / Vallée d'Aoste,Valle d'Aosta,125666,47485,37.79,0.35
4114,2021-01-19,VDA,256,77,179,256,0,0,ITC,ITC2,2,Valle d'Aosta / Vallée d'Aoste,Valle d'Aosta,125666,47741,37.99,0.2
4115,2021-04-12,VDA,487,187,300,305,164,18,ITC,ITC2,2,Valle d'Aosta / Vallée d'Aoste,Valle d'Aosta,125666,48228,38.38,0.39
4116,2021-04-29,VDA,1293,636,657,740,532,21,ITC,ITC2,2,Valle d'Aosta / Vallée d'Aoste,Valle d'Aosta,125666,49521,39.41,1.03
4117,2021-07-21,VDA,1164,635,529,311,849,4,ITC,ITC2,2,Valle d'Aosta / Vallée d'Aoste,Valle d'Aosta,125666,50685,40.33,0.93
4118,2021-07-04,VDA,1192,530,662,349,829,14,ITC,ITC2,2,Valle d'Aosta / Vallée d'Aoste,Valle d'Aosta,125666,51877,41.28,0.95
4119,2021-02-19,VDA,292,102,190,266,24,2,ITC,ITC2,2,Valle d'Aosta / Vallée d'Aoste,Valle d'Aosta,125666,52169,41.51,0.23
4120,2021-08-04,VDA,1043,570,473,371,655,17,ITC,ITC2,2,Valle d'Aosta / Vallée d'Aoste,Valle d'Aosta,125666,53212,42.34,0.83
4121,2021-01-05,VDA,151,55,96,151,0,0,ITC,ITC2,2,Valle d'Aosta / Vallée d'Aoste,Valle d'Aosta,125666,53363,42.46,0.12
4122,2021-01-14,VDA,237,69,168,237,0,0,ITC,ITC2,2,Valle d'Aosta / Vallée d'Aoste,Valle d'Aosta,125666,53600,42.65,0.19
4123,2021-08-02,VDA,759,407,352,305,446,8,ITC,ITC2,2,Valle d'Aosta / Vallée d'Aoste,Valle d'Aosta,125666,54359,43.26,0.6
4124,2021-04-24,VDA,723,401,322,534,167,22,ITC,ITC2,2,Valle d'Aosta / Vallée d'Aoste,Valle d'Aosta,125666,55082,43.83,0.58
4125,2021-06-08,VDA,770,408,362,733,33,4,ITC,ITC2,2,Valle d'Aosta / Vallée d'Aoste,Valle d'Aosta,125666,55852,44.44,0.61
4126,2021-02-26,VDA,208,58,150,108,86,14,ITC,ITC2,2,Valle d'Aosta / Vallée d'Aoste,Valle d'Aosta,125666,56060,44.61,0.17
4127,2021-04-10,VDA,405,191,214,388,5,12,ITC,ITC2,2,Valle d'Aosta / Vallée d'Aoste,Valle d'Aosta,125666,56465,44.93,0.32
4128,2020-12-31,VDA,18,4,14,18,0,0,ITC,ITC2,2,Valle d'Aosta / Vallée d'Aoste,Valle d'Aosta,125666,56483,44.95,0.01
4129,2021-06-06,VDA,1160,582,578,782,373,5,ITC,ITC2,2,Valle d'Aosta / Vallée d'Aoste,Valle d'Aosta,125666,57643,45.87,0.92
4130,2021-03-17,VDA,433,185,248,259,160,14,ITC,ITC2,2,Valle d'Aosta / Vallée d'Aoste,Valle d'Aosta,125666,58076,46.21,0.34
4131,2021-03-03,VDA,256,118,138,182,69,5,ITC,ITC2,2,Valle d'Aosta / Vallée d'Aoste,Valle d'Aosta,125666,58332,46.42,0.2
4132,2021-07-16,VDA,1076,553,523,346,730,0,ITC,ITC2,2,Valle d'Aosta / Vallée d'Aoste,Valle d'Aosta,125666,59408,47.27,0.86
4133,2021-01-26,VDA,149,52,97,2,147,0,ITC,ITC2,2,Valle d'Aosta / Vallée d'Aoste,Valle d'Aosta,125666,59557,47.39,0.12
4134,2021-02-12,VDA,263,96,167,216,46,1,ITC,ITC2,2,Valle d'Aosta / Vallée d'Aoste,Valle d'Aosta,125666,59820,47.6,0.21
4135,2021-02-21,VDA,18,3,15,0,18,0,ITC,ITC2,2,Valle d'Aosta / Vallée d'Aoste,Valle d'Aosta,125666,59838,47.62,0.01
4136,2021-06-01,VDA,873,470,403,511,354,8,ITC,ITC2,2,Valle d'Aosta / Vallée d'Aoste,Valle d'Aosta,125666,60711,48.31,0.69
4137,2021-05-06,VDA,1082,515,567,665,384,33,ITC,ITC2,2,Valle d'Aosta / Vallée d'Aoste,Valle d'Aosta,125666,61793,49.17,0.86
4138,2021-02-16,VDA,326,53,273,309,6,11,ITC,ITC2,2,Valle d'Aosta / Vallée d'Aoste,Valle d'Aosta,125666,62119,49.43,0.26
4139,2021-05-18,VDA,972,484,488,349,619,4,ITC,ITC2,2,Valle d'Aosta / Vallée d'Aoste,Valle d'Aosta,125666,63091,50.21,0.77
4140,2021-02-07,VDA,292,120,172,190,102,0,ITC,ITC2,2,Valle d'Aosta / Vallée d'Aoste,Valle d'Aosta,125666,63383,50.44,0.23
4141,2021-08-09,VDA,674,335,339,257,398,19,ITC,ITC2,2,Valle d'Aosta / Vallée d'Aoste,Valle d'Aosta,125666,64057,50.97,0.54
4142,2021-05-01,VDA,941,564,377,440,484,17,ITC,ITC2,2,Valle d'Aosta / Vallée d'Aoste,Valle d'Aosta,125666,64998,51.72,0.75
4143,2021-04-14,VDA,942,430,512,690,224,28,ITC,ITC2,2,Valle d'Aosta / Vallée d'Aoste,Valle d'Aosta,125666,65940,52.47,0.75
4144,2021-07-06,VDA,884,480,404,157,722,5,ITC,ITC2,2,Valle d'Aosta / Vallée d'Aoste,Valle d'Aosta,125666,66824,53.18,0.7
4145,2021-06-15,VDA,924,508,416,654,257,13,ITC,ITC2,2,Valle d'Aosta / Vallée d'Aoste,Valle d'Aosta,125666,67748,53.91,0.74
4146,2021-08-11,VDA,562,289,273,138,415,9,ITC,ITC2,2,Valle d'Aosta / Vallée d'Aoste,Valle d'Aosta,125666,68310,54.36,0.45
4147,2021-03-05,VDA,277,125,152,53,223,1,ITC,ITC2,2,Valle d'Aosta / Vallée d'Aoste,Valle d'Aosta,125666,68587,54.58,0.22
4148,2021-02-28,VDA,260,86,174,73,183,4,ITC,ITC2,2,Valle d'Aosta / Vallée d'Aoste,Valle d'Aosta,125666,68847,54.79,0.21
4149,2021-07-28,VDA,1423,765,658,370,1048,5,ITC,ITC2,2,Valle d'Aosta / Vallée d'Aoste,Valle d'Aosta,125666,70270,55.92,1.13
4150,2021-04-19,VDA,753,326,427,521,209,23,ITC,ITC2,2,Valle d'Aosta / Vallée d'Aoste,Valle d'Aosta,125666,71023,56.52,0.6
4151,2021-01-16,VDA,237,80,157,237,0,0,ITC,ITC2,2,Valle d'Aosta / Vallée d'Aoste,Valle d'Aosta,125666,71260,56.71,0.19
4152,2021-06-22,VDA,1191,666,525,530,649,12,ITC,ITC2,2,Valle d'Aosta / Vallée d'Aoste,Valle d'Aosta,125666,72451,57.65,0.95
4153,2021-03-14,VDA,392,200,192,373,0,19,ITC,ITC2,2,Valle d'Aosta / Vallée d'Aoste,Valle d'Aosta,125666,72843,57.97,0.31
4154,2021-05-25,VDA,1117,532,585,530,575,12,ITC,ITC2,2,Valle d'Aosta / Vallée d'Aoste,Valle d'Aosta,125666,73960,58.85,0.89
4155,2021-02-14,VDA,48,16,32,1,47,0,ITC,ITC2,2,Valle d'Aosta / Vallée d'Aoste,Valle d'Aosta,125666,74008,58.89,0.04
4156,2021-05-08,VDA,908,543,365,498,382,28,ITC,ITC2,2,Valle d'Aosta / Vallée d'Aoste,Valle d'Aosta,125666,74916,59.62,0.72
4157,2021-02-23,VDA,217,124,93,216,0,1,ITC,ITC2,2,Valle d'Aosta / Vallée d'Aoste,Valle d'Aosta,125666,75133,59.79,0.17
4158,2021-06-03,VDA,1309,669,640,884,413,12,ITC,ITC2,2,Valle d'Aosta / Vallée d'Aoste,Valle d'Aosta,125666,76442,60.83,1.04
4159,2021-05-17,VDA,809,417,392,366,434,9,ITC,ITC2,2,Valle d'Aosta / Vallée d'Aoste,Valle d'Aosta,125666,77251,61.47,0.64
4160,2021-08-08,VDA,579,297,282,176,394,9,ITC,ITC2,2,Valle d'Aosta / Vallée d'Aoste,Valle d'Aosta,125666,77830,61.93,0.46
4161,2021-01-12,VDA,303,73,230,303,0,0,ITC,ITC2,2,Valle d'Aosta / Vallée d'Aoste,Valle d'Aosta,125666,78133,62.18,0.24
4162,2021-05-24,VDA,1137,516,621,675,446,16,ITC,ITC2,2,Valle d'Aosta / Vallée d'Aoste,Valle d'Aosta,125666,79270,63.08,0.9
4163,2021-05-10,VDA,783,382,401,531,235,17,ITC,ITC2,2,Valle d'Aosta / Vallée d'Aoste,Valle d'Aosta,125666,80053,63.7,0.62
4164,2021-04-07,VDA,910,474,436,654,229,27,ITC,ITC2,2,Valle d'Aosta / Vallée d'Aoste,Valle d'Aosta,125666,80963,64.43,0.72
4165,2021-02-09,VDA,252,84,168,68,183,1,ITC,ITC2,2,Valle d'Aosta / Vallée d'Aoste,Valle d'Aosta,125666,81215,64.63,0.2
4166,2021-01-02,VDA,6,5,1,6,0,0,ITC,ITC2,2,Valle d'Aosta / Vallée d'Aoste,Valle d'Aosta,125666,81221,64.63,0.0
4167,2021-03-26,VDA,498,204,294,471,7,20,ITC,ITC2,2,Valle d'Aosta / Vallée d'Aoste,Valle d'Aosta,125666,81719,65.03,0.4
4168,2021-06-17,VDA,990,529,461,637,341,12,ITC,ITC2,2,Valle d'Aosta / Vallée d'Aoste,Valle d'Aosta,125666,82709,65.82,0.79
4169,2021-01-21,VDA,33,12,21,33,0,0,ITC,ITC2,2,Valle d'Aosta / Vallée d'Aoste,Valle d'Aosta,125666,82742,65.84,0.03
4170,2021-04-26,VDA,716,328,388,513,170,33,ITC,ITC2,2,Valle d'Aosta / Vallée d'Aoste,Valle d'Aosta,125666,83458,66.41,0.57
4171,2021-07-01,VDA,962,473,489,328,621,13,ITC,ITC2,2,Valle d'Aosta / Vallée d'Aoste,Valle d'Aosta,125666,84420,67.18,0.77
4172,2021-01-09,VDA,444,199,245,444,0,0,ITC,ITC2,2,Valle d'Aosta / Vallée d'Aoste,Valle d'Aosta,125666,84864,67.53,0.35
4173,2021-05-05,VDA,1038,566,472,434,582,22,ITC,ITC2,2,Valle d'Aosta / Vallée d'Aoste,Valle d'Aosta,125666,85902,68.36,0.83
4174,2021-05-03,VDA,841,400,441,459,352,30,ITC,ITC2,2,Valle d'Aosta / Vallée d'Aoste,Valle d'Aosta,125666,86743,69.03,0.67
4175,2021-03-07,VDA,64,30,34,11,53,0,ITC,ITC2,2,Valle d'Aosta / Vallée d'Aoste,Valle d'Aosta,125666,86807,69.08,0.05
4176,2021-05-15,VDA,1067,614,453,368,686,13,ITC,ITC2,2,Valle d'Aosta / Vallée d'Aoste,Valle d'Aosta,125666,87874,69.93,0.85
4177,2021-02-04,VDA,294,86,208,8,286,0,ITC,ITC2,2,Valle d'Aosta / Vallée d'Aoste,Valle d'Aosta,125666,88168,70.16,0.23
4178,2021-04-28,VDA,1219,633,586,683,503,33,ITC,ITC2,2,Valle d'Aosta / Vallée d'Aoste,Valle d'Aosta,125666,89387,71.13,0.97
4179,2021-08-06,VDA,819,399,420,408,397,14,ITC,ITC2,2,Valle d'Aosta / Vallée d'Aoste,Valle d'Aosta,125666,90206,71.78,0.65
4180,2021-08-10,VDA,850,436,414,580,261,9,ITC,ITC2,2,Valle d'Aosta / Vallée d'Aoste,Valle d'Aosta,125666,91056,72.46,0.68
4181,2021-04-05,VDA,465,223,242,440,6,19,ITC,ITC2,2,Valle d'Aosta / Vallée d'Aoste,Valle d'Aosta,125666,91521,72.83,0.37
4182,2021-06-27,VDA,1253,608,645,312,931,10,ITC,ITC2,2,Valle d'Aosta / Vallée d'Aoste,Valle d'Aosta,125666,92774,73.83,1.0
4183,2021-07-14,VDA,1021,534,487,293,728,0,ITC,ITC2,2,Valle d'Aosta / Vallée d'Aoste,Valle d'Aosta,125666,93795,74.64,0.81
4184,2021-08-01,VDA,842,445,397,287,547,8,ITC,ITC2,2,Valle d'Aosta / Vallée d'Aoste,Valle d'Aosta,125666,94637,75.31,0.67
4185,2021-07-30,VDA,965,501,464,422,525,18,ITC,ITC2,2,Valle d'Aosta / Vallée d'Aoste,Valle d'Aosta,125666,95602,76.08,0.77
4186,2021-04-21,VDA,868,410,458,588,248,32,ITC,ITC2,2,Valle d'Aosta / Vallée d'Aoste,Valle d'Aosta,125666,96470,76.77,0.69
4187,2021-07-13,VDA,1061,567,494,307,748,6,ITC,ITC2,2,Valle d'Aosta / Vallée d'Aoste,Valle d'Aosta,125666,97531,77.61,0.84
4188,2021-03-21,VDA,359,168,191,350,0,9,ITC,ITC2,2,Valle d'Aosta / Vallée d'Aoste,Valle d'Aosta,125666,97890,77.9,0.29
4189,2021-06-29,VDA,782,390,392,236,543,3,ITC,ITC2,2,Valle d'Aosta / Vallée d'Aoste,Valle d'Aosta,125666,98672,78.52,0.62
4190,2021-06-10,VDA,1057,610,447,1008,42,7,ITC,ITC2,2,Valle d'Aosta / Vallée d'Aoste,Valle d'Aosta,125666,99729,79.36,0.84
4191,2021-03-02,VDA,340,166,174,292,3,45,ITC,ITC2,2,Valle d'Aosta / Vallée d'Aoste,Valle d'Aosta,125666,100069,79.63,0.27
4192,2021-07-20,VDA,1118,584,534,394,722,2,ITC,ITC2,2,Valle d'Aosta / Vallée d'Aoste,Valle d'Aosta,125666,101187,80.52,0.89
4193,2021-04-18,VDA,523,255,268,495,2,26,ITC,ITC2,2,Valle d'Aosta / Vallée d'Aoste,Valle d'Aosta,125666,101710,80.94,0.42
4194,2021-01-04,VDA,144,61,83,144,0,0,ITC,ITC2,2,Valle d'Aosta / Vallée d'Aoste,Valle d'Aosta,125666,101854,81.05,0.11
4195,2021-03-28,VDA,524,213,311,496,0,28,ITC,ITC2,2,Valle d'Aosta / Vallée d'Aoste,Valle d'Aosta,125666,102378,81.47,0.42
4196,2021-03-11,VDA,392,164,228,152,239,1,ITC,ITC2,2,Valle d'Aosta / Vallée d'Aoste,Valle d'Aosta,125666,102770,81.78,0.31
4197,2021-06-02,VDA,1215,688,527,811,401,3,ITC,ITC2,2,Valle d'Aosta / Vallée d'Aoste,Valle d'Aosta,125666,103985,82.75,0.97
4198,2021-06-19,VDA,1295,671,624,661,621,13,ITC,ITC2,2,Valle d'Aosta / Vallée d'Aoste,Valle d'Aosta,125666,105280,83.78,1.03
4199,2021-03-09,VDA,206,96,110,166,32,8,ITC,ITC2,2,Valle d'Aosta / Vallée d'Aoste,Valle d'Aosta,125666,105486,83.94,0.16
4200,2021-06-24,VDA,1225,631,594,381,836,8,ITC,ITC2,2,Valle d'Aosta / Vallée d'Aoste,Valle d'Aosta,125666,106711,84.92,0.97
4201,2021-07-03,VDA,936,485,451,390,537,9,ITC,ITC2,2,Valle d'Aosta / Vallée d'Aoste,Valle d'Aosta,125666,107647,85.66,0.74
4202,2021-02-08,VDA,223,83,140,25,198,0,ITC,ITC2,2,Valle d'Aosta / Vallée d'Aoste,Valle d'Aosta,125666,107870,85.84,0.18
4203,2021-03-23,VDA,380,150,230,228,135,17,ITC,ITC2,2,Valle d'Aosta / Vallée d'Aoste,Valle d'Aosta,125666,108250,86.14,0.3
4204,2021-05-19,VDA,993,498,495,411,575,7,ITC,ITC2,2,Valle d'Aosta / Vallée d'Aoste,Valle d'Aosta,125666,109243,86.93,0.79
4205,2021-01-30,VDA,439,202,237,12,425,2,ITC,ITC2,2,Valle d'Aosta / Vallée d'Aoste,Valle d'Aosta,125666,109682,87.28,0.35
4206,2021-01-25,VDA,150,67,83,1,149,0,ITC,ITC2,2,Valle d'Aosta / Vallée d'Aoste,Valle d'Aosta,125666,109832,87.4,0.12
4207,2021-01-28,VDA,294,124,170,55,239,0,ITC,ITC2,2,Valle d'Aosta / Vallée d'Aoste,Valle d'Aosta,125666,110126,87.63,0.23
4208,2021-06-12,VDA,1234,600,634,1062,167,5,ITC,ITC2,2,Valle d'Aosta / Vallée d'Aoste,Valle d'Aosta,125666,111360,88.62,0.98
4209,2021-02-06,VDA,289,104,185,91,197,1,ITC,ITC2,2,Valle d'Aosta / Vallée d'Aoste,Valle d'Aosta,125666,111649,88.85,0.23
4210,2021-04-30,VDA,833,357,476,468,347,18,ITC,ITC2,2,Valle d'Aosta / Vallée d'Aoste,Valle d'Aosta,125666,112482,89.51,0.66
4211,2021-01-20,VDA,64,15,49,64,0,0,ITC,ITC2,2,Valle d'Aosta / Vallée d'Aoste,Valle d'Aosta,125666,112546,89.56,0.05
4212,2021-07-22,VDA,974,516,458,276,698,0,ITC,ITC2,2,Valle d'Aosta / Vallée d'Aoste,Valle d'Aosta,125666,113520,90.33,0.78
4213,2021-01-18,VDA,213,74,139,213,0,0,ITC,ITC2,2,Valle d'Aosta / Vallée d'Aoste,Valle d'Aosta,125666,113733,90.5,0.17
4214,2021-01-11,VDA,326,112,214,326,0,0,ITC,ITC2,2,Valle d'Aosta / Vallée d'Aoste,Valle d'Aosta,125666,114059,90.76,0.26
4215,2021-06-14,VDA,1014,522,492,572,428,14,ITC,ITC2,2,Valle d'Aosta / Vallée d'Aoste,Valle d'Aosta,125666,115073,91.57,0.81
4216,2021-05-31,VDA,881,396,485,490,380,11,ITC,ITC2,2,Valle d'Aosta / Vallée d'Aoste,Valle d'Aosta,125666,115954,92.27,0.7
4217,2021-07-27,VDA,1119,595,524,567,552,0,ITC,ITC2,2,Valle d'Aosta / Vallée d'Aoste,Valle d'Aosta,125666,117073,93.16,0.89
4218,2021-04-25,VDA,850,409,441,674,139,37,ITC,ITC2,2,Valle d'Aosta / Vallée d'Aoste,Valle d'Aosta,125666,117923,93.84,0.68
4219,2021-06-21,VDA,1123,600,523,608,505,10,ITC,ITC2,2,Valle d'Aosta / Vallée d'Aoste,Valle d'Aosta,125666,119046,94.73,0.89
4220,2021-06-07,VDA,711,347,364,639,61,11,ITC,ITC2,2,Valle d'Aosta / Vallée d'Aoste,Valle d'Aosta,125666,119757,95.3,0.57
4221,2021-02-27,VDA,232,86,146,120,107,5,ITC,ITC2,2,Valle d'Aosta / Vallée d'Aoste,Valle d'Aosta,125666,119989,95.48,0.18
4222,2021-08-03,VDA,936,485,451,568,361,7,ITC,ITC2,2,Valle d'Aosta / Vallée d'Aoste,Valle d'Aosta,125666,120925,96.23,0.74
4223,2021-02-20,VDA,256,214,42,243,10,3,ITC,ITC2,2,Valle d'Aosta / Vallée d'Aoste,Valle d'Aosta,125666,121181,96.43,0.2
4224,2021-04-11,VDA,479,208,271,462,0,17,ITC,ITC2,2,Valle d'Aosta / Vallée d'Aoste,Valle d'Aosta,125666,121660,96.81,0.38
4225,2021-03-16,VDA,184,37,147,109,66,9,ITC,ITC2,2,Valle d'Aosta / Vallée d'Aoste,Valle d'Aosta,125666,121844,96.96,0.15
4226,2021-03-19,VDA,322,85,237,277,35,10,ITC,ITC2,2,Valle d'Aosta / Vallée d'Aoste,Valle d'Aosta,125666,122166,97.21,0.26
4227,2021-05-07,VDA,566,247,319,518,30,18,ITC,ITC2,2,Valle d'Aosta / Vallée d'Aoste,Valle d'Aosta,125666,122732,97.67,0.45
4228,2021-04-23,VDA,923,443,480,513,383,27,ITC,ITC2,2,Valle d'Aosta / Vallée d'Aoste,Valle d'Aosta,125666,123655,98.4,0.73
4229,2021-01-13,VDA,338,110,228,338,0,0,ITC,ITC2,2,Valle d'Aosta / Vallée d'Aoste,Valle d'Aosta,125666,123993,98.67,0.27
4230,2021-07-29,VDA,995,507,488,321,667,7,ITC,ITC2,2,Valle d'Aosta / Vallée d'Aoste,Valle d'Aosta,125666,124988,99.46,0.79
4231,2021-07-15,VDA,1092,592,500,297,794,1,ITC,ITC2,2,Valle d'Aosta / Vallée d'Aoste,Valle d'Aosta,125666,126080,100.33,0.87
4232,2021-04-06,VDA,743,382,361,598,112,33,ITC,ITC2,2,Valle d'Aosta / Vallée d'Aoste,Valle d'Aosta,125666,126823,100.92,0.59
4233,2021-07-10,VDA,1294,669,625,320,963,11,ITC,ITC2,2,Valle d'Aosta / Vallée d'Aoste,Valle d'Aosta,125666,128117,101.95,1.03
4234,2021-05-14,VDA,963,444,519,253,669,41,ITC,ITC2,2,Valle d'Aosta / Vallée d'Aoste,Valle d'Aosta,125666,129080,102.72,0.77
4235,2021-02-01,VDA,407,127,280,85,319,3,ITC,ITC2,2,Valle d'Aosta / Vallée d'Aoste,Valle d'Aosta,125666,129487,103.04,0.32
4236,2021-07-08,VDA,1275,709,566,341,924,10,ITC,ITC2,2,Valle d'Aosta / Vallée d'Aoste,Valle d'Aosta,125666,130762,104.06,1.01
4237,2021-03-30,VDA,402,223,179,364,20,18,ITC,ITC2,2,Valle d'Aosta / Vallée d'Aoste,Valle d'Aosta,125666,131164,104.38,0.32
4238,2021-05-12,VDA,1144,550,594,449,671,24,ITC,ITC2,2,Valle d'Aosta / Vallée d'Aoste,Valle d'Aosta,125666,132308,105.29,0.91
4239,2021-07-17,VDA,986,520,466,254,731,1,ITC,ITC2,2,Valle d'Aosta / Vallée d'Aoste,Valle d'Aosta,125666,133294,106.07,0.78
4240,2021-04-04,VDA,572,253,319,550,0,22,ITC,ITC2,2,Valle d'Aosta / Vallée d'Aoste,Valle d'Aosta,125666,133866,106.53,0.46
4241,2021-02-13,VDA,217,197,20,214,1,2,ITC,ITC2,2,Valle d'Aosta / Vallée d'Aoste,Valle d'Aosta,125666,134083,106.7,0.17
4242,2021-03-18,VDA,136,43,93,96,37,3,ITC,ITC2,2,Valle d'Aosta / Vallée d'Aoste,Valle d'Aosta,125666,134219,106.81,0.11
4243,2021-06-26,VDA,1065,512,553,352,707,6,ITC,ITC2,2,Valle d'Aosta / Vallée d'Aoste,Valle d'Aosta,125666,135284,107.65,0.85
4244,2021-03-04,VDA,291,139,152,39,250,2,ITC,ITC2,2,Valle d'Aosta / Vallée d'Aoste,Valle d'Aosta,125666,135575,107.89,0.23
4245,2021-05-26,VDA,1212,587,625,567,634,11,ITC,ITC2,2,Valle d'Aosta / Vallée d'Aoste,Valle d'Aosta,125666,136787,108.85,0.96
4246,2021-01-31,VDA,291,91,200,58,233,0,ITC,ITC2,2,Valle d'Aosta / Vallée d'Aoste,Valle d'Aosta,125666,137078,109.08,0.23
4247,2021-03-22,VDA,560,205,355,323,228,9,ITC,ITC2,2,Valle d'Aosta / Vallée d'Aoste,Valle d'Aosta,125666,137638,109.53,0.45
4248,2021-06-05,VDA,926,476,450,730,188,8,ITC,ITC2,2,Valle d'Aosta / Vallée d'Aoste,Valle d'Aosta,125666,138564,110.26,0.74
4249,2021-02-11,VDA,231,107,124,221,9,1,ITC,ITC2,2,Valle d'Aosta / Vallée d'Aoste,Valle d'Aosta,125666,138795,110.45,0.18
4250,2021-07-18,VDA,927,455,472,252,675,0,ITC,ITC2,2,Valle d'Aosta / Vallée d'Aoste,Valle d'Aosta,125666,139722,111.19,0.74
4251,2021-04-09,VDA,238,111,127,201,33,4,ITC,ITC2,2,Valle d'Aosta / Vallée d'Aoste,Valle d'Aosta,125666,139960,111.37,0.19
4252,2021-05-22,VDA,956,505,451,545,401,10,ITC,ITC2,2,Valle d'Aosta / Vallée d'Aoste,Valle d'Aosta,125666,140916,112.14,0.76
4253,2021-07-25,VDA,1017,493,524,264,753,0,ITC,ITC2,2,Valle d'Aosta / Vallée d'Aoste,Valle d'Aosta,125666,141933,112.94,0.81
4254,2021-04-16,VDA,599,261,338,565,2,32,ITC,ITC2,2,Valle d'Aosta / Vallée d'Aoste,Valle d'Aosta,125666,142532,113.42,0.48
4255,2021-04-02,VDA,875,345,530,596,226,53,ITC,ITC2,2,Valle d'Aosta / Vallée d'Aoste,Valle d'Aosta,125666,143407,114.12,0.7
4256,2021-05-29,VDA,798,434,364,553,237,8,ITC,ITC2,2,Valle d'Aosta / Vallée d'Aoste,Valle d'Aosta,125666,144205,114.75,0.64
4257,2021-07-11,VDA,908,472,436,254,643,11,ITC,ITC2,2,Valle d'Aosta / Vallée d'Aoste,Valle d'Aosta,125666,145113,115.48,0.72
4258,2021-02-25,VDA,201,101,100,190,7,4,ITC,ITC2,2,Valle d'Aosta / Vallée d'Aoste,Valle d'Aosta,125666,145314,115.64,0.16
4259,2021-08-05,VDA,786,406,380,283,482,21,ITC,ITC2,2,Valle d'Aosta / Vallée d'Aoste,Valle d'Aosta,125666,146100,116.26,0.63
4260,2021-01-06,VDA,66,34,32,66,0,0,ITC,ITC2,2,Valle d'Aosta / Vallée d'Aoste,Valle d'Aosta,125666,146166,116.31,0.05
4261,2021-02-18,VDA,349,153,196,255,88,6,ITC,ITC2,2,Valle d'Aosta / Vallée d'Aoste,Valle d'Aosta,125666,146515,116.59,0.28
4262,2021-06-05,LOM,102445,52961,49484,91104,9829,1512,ITC,ITC4,3,Lombardia,Lombardia,10060574,102445,1.02,1.02
4263,2021-03-14,LOM,14878,5349,9529,11218,3286,374,ITC,ITC4,3,Lombardia,Lombardia,10060574,117323,1.17,0.15
4264,2021-02-23,LOM,11833,4806,7027,11294,332,207,ITC,ITC4,3,Lombardia,Lombardia,10060574,129156,1.28,0.12
4265,2021-08-06,LOM,85552,46619,38933,17768,66931,853,ITC,ITC4,3,Lombardia,Lombardia,10060574,214708,2.13,0.85
4266,2021-04-28,LOM,95776,43680,52096,66934,26927,1915,ITC,ITC4,3,Lombardia,Lombardia,10060574,310484,3.09,0.95
4267,2021-06-24,LOM,109755,56737,53018,78386,28992,2377,ITC,ITC4,3,Lombardia,Lombardia,10060574,420239,4.18,1.09
4268,2021-03-16,LOM,25529,10127,15402,16305,9102,122,ITC,ITC4,3,Lombardia,Lombardia,10060574,445768,4.43,0.25
4269,2021-05-12,LOM,87568,41775,45793,57438,27604,2526,ITC,ITC4,3,Lombardia,Lombardia,10060574,533336,5.3,0.87
4270,2021-03-28,LOM,20628,7877,12751,13963,6280,385,ITC,ITC4,3,Lombardia,Lombardia,10060574,553964,5.51,0.21
4271,2021-04-14,LOM,47224,21043,26181,33557,12980,687,ITC,ITC4,3,Lombardia,Lombardia,10060574,601188,5.98,0.47
4272,2021-01-04,LOM,6129,2118,4011,6122,0,7,ITC,ITC4,3,Lombardia,Lombardia,10060574,607317,6.04,0.06
4273,2021-06-19,LOM,104393,52025,52368,56237,46732,1424,ITC,ITC4,3,Lombardia,Lombardia,10060574,711710,7.07,1.04
4274,2021-07-06,LOM,102069,50810,51259,23084,77569,1416,ITC,ITC4,3,Lombardia,Lombardia,10060574,813779,8.09,1.01
4275,2021-07-20,LOM,95019,49096,45923,6904,87360,755,ITC,ITC4,3,Lombardia,Lombardia,10060574,908798,9.03,0.94
4276,2021-02-04,LOM,27959,8145,19814,2045,25909,5,ITC,ITC4,3,Lombardia,Lombardia,10060574,936757,9.31,0.28
4277,2021-07-18,LOM,97102,50591,46511,8544,87865,693,ITC,ITC4,3,Lombardia,Lombardia,10060574,1033859,10.28,0.97
4278,2021-04-09,LOM,52440,22387,30053,35587,16014,839,ITC,ITC4,3,Lombardia,Lombardia,10060574,1086299,10.8,0.52
4279,2021-07-13,LOM,108611,56775,51836,15444,91930,1237,ITC,ITC4,3,Lombardia,Lombardia,10060574,1194910,11.88,1.08
4280,2021-04-04,LOM,7612,3230,4382,3682,3896,34,ITC,ITC4,3,Lombardia,Lombardia,10060574,1202522,11.95,0.08
4281,2021-05-24,LOM,89612,43525,46087,48597,40078,937,ITC,ITC4,3,Lombardia,Lombardia,10060574,1292134,12.84,0.89
4282,2021-02-11,LOM,17104,5020,12084,9635,7391,78,ITC,ITC4,3,Lombardia,Lombardia,10060574,1309238,13.01,0.17
4283,2021-05-31,LOM,95725,47422,48303,78378,16243,1104,ITC,ITC4,3,Lombardia,Lombardia,10060574,1404963,13.97,0.95
4284,2021-07-27,LOM,104918,56840,48078,7473,96739,706,ITC,ITC4,3,Lombardia,Lombardia,10060574,1509881,15.01,1.04
4285,2021-01-16,LOM,15637,5783,9854,15626,0,11,ITC,ITC4,3,Lombardia,Lombardia,10060574,1525518,15.16,0.16
4286,2021-08-01,LOM,53132,28427,24705,27333,24261,1538,ITC,ITC4,3,Lombardia,Lombardia,10060574,1578650,15.69,0.53
4287,2021-04-23,LOM,73613,33361,40252,55586,16636,1391,ITC,ITC4,3,Lombardia,Lombardia,10060574,1652263,16.42,0.73
4288,2021-05-10,LOM,85315,40906,44409,62028,21596,1691,ITC,ITC4,3,Lombardia,Lombardia,10060574,1737578,17.27,0.85
4289,2021-01-30,LOM,12340,4579,7761,146,12185,9,ITC,ITC4,3,Lombardia,Lombardia,10060574,1749918,17.39,0.12
4290,2021-02-16,LOM,9522,3079,6443,8974,448,100,ITC,ITC4,3,Lombardia,Lombardia,10060574,1759440,17.49,0.09
4291,2021-06-10,LOM,102708,52263,50445,86429,14479,1800,ITC,ITC4,3,Lombardia,Lombardia,10060574,1862148,18.51,1.02
4292,2021-03-02,LOM,22839,9710,13129,19532,3045,262,ITC,ITC4,3,Lombardia,Lombardia,10060574,1884987,18.74,0.23
4293,2020-12-28,LOM,108,47,61,108,0,0,ITC,ITC4,3,Lombardia,Lombardia,10060574,1885095,18.74,0.0
4294,2021-06-17,LOM,108619,52743,55876,50780,56662,1177,ITC,ITC4,3,Lombardia,Lombardia,10060574,1993714,19.82,1.08
4295,2021-03-09,LOM,33256,12876,20380,25251,7416,589,ITC,ITC4,3,Lombardia,Lombardia,10060574,2026970,20.15,0.33
4296,2021-05-05,LOM,88104,42001,46103,70480,15352,2272,ITC,ITC4,3,Lombardia,Lombardia,10060574,2115074,21.02,0.88
4297,2021-07-01,LOM,105134,52896,52238,53364,49373,2397,ITC,ITC4,3,Lombardia,Lombardia,10060574,2220208,22.07,1.05
4298,2021-08-08,LOM,58834,31955,26879,16678,41362,794,ITC,ITC4,3,Lombardia,Lombardia,10060574,2279042,22.65,0.58
4299,2021-05-17,LOM,94687,45372,49315,29549,64435,703,ITC,ITC4,3,Lombardia,Lombardia,10060574,2373729,23.59,0.94
4300,2021-07-08,LOM,114640,58431,56209,13210,100402,1028,ITC,ITC4,3,Lombardia,Lombardia,10060574,2488369,24.73,1.14
4301,2021-07-25,LOM,86634,45734,40900,9423,76430,781,ITC,ITC4,3,Lombardia,Lombardia,10060574,2575003,25.59,0.86
4302,2021-04-16,LOM,53713,23936,29777,38443,14383,887,ITC,ITC4,3,Lombardia,Lombardia,10060574,2628716,26.13,0.53
4303,2021-05-03,LOM,83740,39781,43959,69477,12138,2125,ITC,ITC4,3,Lombardia,Lombardia,10060574,2712456,26.96,0.83
4304,2021-01-23,LOM,1127,361,766,925,199,3,ITC,ITC4,3,Lombardia,Lombardia,10060574,2713583,26.97,0.01
4305,2021-04-02,LOM,41406,16948,24458,26212,14640,554,ITC,ITC4,3,Lombardia,Lombardia,10060574,2754989,27.38,0.41
4306,2021-03-26,LOM,41351,15716,25635,27508,13168,675,ITC,ITC4,3,Lombardia,Lombardia,10060574,2796340,27.8,0.41
4307,2021-05-22,LOM,70660,33861,36799,31727,38218,715,ITC,ITC4,3,Lombardia,Lombardia,10060574,2867000,28.5,0.7
4308,2021-05-29,LOM,88374,42433,45941,41397,46134,843,ITC,ITC4,3,Lombardia,Lombardia,10060574,2955374,29.38,0.88
4309,2021-02-18,LOM,14059,4929,9130,12823,1038,198,ITC,ITC4,3,Lombardia,Lombardia,10060574,2969433,29.52,0.14
4310,2021-01-09,LOM,12498,4610,7888,12490,0,8,ITC,ITC4,3,Lombardia,Lombardia,10060574,2981931,29.64,0.12
4311,2021-03-07,LOM,12093,5364,6729,9339,2562,192,ITC,ITC4,3,Lombardia,Lombardia,10060574,2994024,29.76,0.12
4312,2021-01-27,LOM,8059,2681,5378,807,7250,2,ITC,ITC4,3,Lombardia,Lombardia,10060574,3002083,29.84,0.08
4313,2021-07-03,LOM,102499,51712,50787,44537,55854,2108,ITC,ITC4,3,Lombardia,Lombardia,10060574,3104582,30.86,1.02
4314,2021-03-25,LOM,43019,16089,26930,29248,12866,905,ITC,ITC4,3,Lombardia,Lombardia,10060574,3147601,31.29,0.43
4315,2021-05-21,LOM,93920,45274,48646,28390,64769,761,ITC,ITC4,3,Lombardia,Lombardia,10060574,3241521,32.22,0.93
4316,2021-06-12,LOM,89315,48060,41255,84313,3161,1841,ITC,ITC4,3,Lombardia,Lombardia,10060574,3330836,33.11,0.89
4317,2021-06-29,LOM,107297,53208,54089,57425,47866,2006,ITC,ITC4,3,Lombardia,Lombardia,10060574,3438133,34.17,1.07
4318,2021-03-21,LOM,23521,8499,15022,17732,5197,592,ITC,ITC4,3,Lombardia,Lombardia,10060574,3461654,34.41,0.23
4319,2021-04-21,LOM,71866,32576,39290,55842,14685,1339,ITC,ITC4,3,Lombardia,Lombardia,10060574,3533520,35.12,0.71
4320,2021-01-11,LOM,16307,5390,10917,16297,0,10,ITC,ITC4,3,Lombardia,Lombardia,10060574,3549827,35.28,0.16
4321,2021-01-28,LOM,12258,3717,8541,795,11456,7,ITC,ITC4,3,Lombardia,Lombardia,10060574,3562085,35.41,0.12
4322,2021-08-03,LOM,85789,46507,39282,13452,71608,729,ITC,ITC4,3,Lombardia,Lombardia,10060574,3647874,36.26,0.85
4323,2021-04-25,LOM,51596,23658,27938,45545,4829,1222,ITC,ITC4,3,Lombardia,Lombardia,10060574,3699470,36.77,0.51
4324,2021-01-18,LOM,9251,2986,6265,8261,975,15,ITC,ITC4,3,Lombardia,Lombardia,10060574,3708721,36.86,0.09
4325,2021-03-23,LOM,42611,15482,27129,28870,12884,857,ITC,ITC4,3,Lombardia,Lombardia,10060574,3751332,37.29,0.42
4326,2021-05-19,LOM,83298,39782,43516,33117,49371,810,ITC,ITC4,3,Lombardia,Lombardia,10060574,3834630,38.12,0.83
4327,2021-02-08,LOM,10112,2929,7183,2124,7979,9,ITC,ITC4,3,Lombardia,Lombardia,10060574,3844742,38.22,0.1
4328,2021-02-25,LOM,15350,6368,8982,13534,1616,200,ITC,ITC4,3,Lombardia,Lombardia,10060574,3860092,38.37,0.15
4329,2021-02-06,LOM,15295,5550,9745,1012,14278,5,ITC,ITC4,3,Lombardia,Lombardia,10060574,3875387,38.52,0.15
4330,2021-07-24,LOM,95872,50654,45218,9738,85275,859,ITC,ITC4,3,Lombardia,Lombardia,10060574,3971259,39.47,0.95
4331,2021-08-10,LOM,59374,32123,27251,17874,40483,1017,ITC,ITC4,3,Lombardia,Lombardia,10060574,4030633,40.06,0.59
4332,2021-06-21,LOM,113365,58076,55289,78364,32832,2169,ITC,ITC4,3,Lombardia,Lombardia,10060574,4143998,41.19,1.13
4333,2021-06-02,LOM,84666,43589,41077,76988,6359,1319,ITC,ITC4,3,Lombardia,Lombardia,10060574,4228664,42.03,0.84
4334,2021-03-11,LOM,36257,13497,22760,25635,9938,684,ITC,ITC4,3,Lombardia,Lombardia,10060574,4264921,42.39,0.36
4335,2021-04-11,LOM,32222,13944,18278,24316,7395,511,ITC,ITC4,3,Lombardia,Lombardia,10060574,4297143,42.71,0.32
4336,2021-01-01,LOM,24,7,17,24,0,0,ITC,ITC4,3,Lombardia,Lombardia,10060574,4297167,42.71,0.0
4337,2021-06-07,LOM,99005,50441,48564,84035,13350,1620,ITC,ITC4,3,Lombardia,Lombardia,10060574,4396172,43.7,0.98
4338,2021-02-27,LOM,13954,5876,8078,13153,645,156,ITC,ITC4,3,Lombardia,Lombardia,10060574,4410126,43.84,0.14
4339,2020-12-30,LOM,115,42,73,115,0,0,ITC,ITC4,3,Lombardia,Lombardia,10060574,4410241,43.84,0.0
4340,2021-06-16,LOM,99354,50469,48885,49864,48340,1150,ITC,ITC4,3,Lombardia,Lombardia,10060574,4509595,44.82,0.99
4341,2021-07-29,LOM,74393,40414,33979,33760,38679,1954,ITC,ITC4,3,Lombardia,Lombardia,10060574,4583988,45.56,0.74
4342,2021-02-20,LOM,9359,3870,5489,8847,317,195,ITC,ITC4,3,Lombardia,Lombardia,10060574,4593347,45.66,0.09
4343,2021-04-18,LOM,36413,16233,20180,30527,5243,643,ITC,ITC4,3,Lombardia,Lombardia,10060574,4629760,46.02,0.36
4344,2021-01-08,LOM,12747,3936,8811,12736,0,11,ITC,ITC4,3,Lombardia,Lombardia,10060574,4642507,46.15,0.13
4345,2021-06-28,LOM,108081,55059,53022,74291,31184,2606,ITC,ITC4,3,Lombardia,Lombardia,10060574,4750588,47.22,1.07
4346,2021-07-15,LOM,109293,56213,53080,13371,94725,1197,ITC,ITC4,3,Lombardia,Lombardia,10060574,4859881,48.31,1.09
4347,2021-04-06,LOM,43092,17593,25499,24450,17951,691,ITC,ITC4,3,Lombardia,Lombardia,10060574,4902973,48.73,0.43
4348,2021-06-14,LOM,94877,48204,46673,49132,44627,1118,ITC,ITC4,3,Lombardia,Lombardia,10060574,4997850,49.68,0.94
4349,2021-05-02,LOM,83521,38343,45178,59263,22473,1785,ITC,ITC4,3,Lombardia,Lombardia,10060574,5081371,50.51,0.83
4350,2021-07-22,LOM,99368,52030,47338,12495,85417,1456,ITC,ITC4,3,Lombardia,Lombardia,10060574,5180739,51.5,0.99
4351,2021-04-13,LOM,47684,21285,26399,32937,14101,646,ITC,ITC4,3,Lombardia,Lombardia,10060574,5228423,51.97,0.47
4352,2021-04-30,LOM,117504,54884,62620,87259,27664,2581,ITC,ITC4,3,Lombardia,Lombardia,10060574,5345927,53.14,1.17
4353,2021-01-20,LOM,5699,1387,4312,5579,115,5,ITC,ITC4,3,Lombardia,Lombardia,10060574,5351626,53.19,0.06
4354,2021-01-22,LOM,3197,884,2313,3123,69,5,ITC,ITC4,3,Lombardia,Lombardia,10060574,5354823,53.23,0.03
4355,2021-01-25,LOM,7108,2395,4713,513,6592,3,ITC,ITC4,3,Lombardia,Lombardia,10060574,5361931,53.3,0.07
4356,2021-02-01,LOM,16104,5332,10772,306,15796,2,ITC,ITC4,3,Lombardia,Lombardia,10060574,5378035,53.46,0.16
4357,2021-07-05,LOM,101884,49772,52112,31469,68526,1889,ITC,ITC4,3,Lombardia,Lombardia,10060574,5479919,54.47,1.01
4358,2021-03-30,LOM,39711,15618,24093,24254,14847,610,ITC,ITC4,3,Lombardia,Lombardia,10060574,5519630,54.86,0.39
4359,2021-01-06,LOM,7163,2530,4633,7157,0,6,ITC,ITC4,3,Lombardia,Lombardia,10060574,5526793,54.94,0.07
4360,2021-05-18,LOM,88244,42173,46071,31888,55586,770,ITC,ITC4,3,Lombardia,Lombardia,10060574,5615037,55.81,0.88
4361,2021-06-04,LOM,104650,54321,50329,93201,9660,1789,ITC,ITC4,3,Lombardia,Lombardia,10060574,5719687,56.85,1.04
4362,2021-02-24,LOM,14724,5959,8765,13575,956,193,ITC,ITC4,3,Lombardia,Lombardia,10060574,5734411,57.0,0.15
4363,2021-08-05,LOM,90208,49216,40992,15695,73699,814,ITC,ITC4,3,Lombardia,Lombardia,10060574,5824619,57.9,0.9
4364,2021-01-15,LOM,25283,7451,17832,25231,0,52,ITC,ITC4,3,Lombardia,Lombardia,10060574,5849902,58.15,0.25
4365,2021-03-06,LOM,21359,9107,12252,16542,4519,298,ITC,ITC4,3,Lombardia,Lombardia,10060574,5871261,58.36,0.21
4366,2021-06-09,LOM,103700,52243,51457,87438,14541,1721,ITC,ITC4,3,Lombardia,Lombardia,10060574,5974961,59.39,1.03
4367,2021-03-08,LOM,29795,11204,18591,22168,7108,519,ITC,ITC4,3,Lombardia,Lombardia,10060574,6004756,59.69,0.3
4368,2021-05-04,LOM,86868,41092,45776,70301,14416,2151,ITC,ITC4,3,Lombardia,Lombardia,10060574,6091624,60.55,0.86
4369,2021-01-24,LOM,1201,458,743,538,663,0,ITC,ITC4,3,Lombardia,Lombardia,10060574,6092825,60.56,0.01
4370,2021-02-13,LOM,6423,2443,3980,4885,1478,60,ITC,ITC4,3,Lombardia,Lombardia,10060574,6099248,60.63,0.06
4371,2021-07-17,LOM,108499,57291,51208,10220,97354,925,ITC,ITC4,3,Lombardia,Lombardia,10060574,6207747,61.7,1.08
4372,2021-01-13,LOM,26466,8093,18373,26441,0,25,ITC,ITC4,3,Lombardia,Lombardia,10060574,6234213,61.97,0.26
4373,2021-07-07,LOM,112001,56153,55848,17999,92839,1163,ITC,ITC4,3,Lombardia,Lombardia,10060574,6346214,63.08,1.11
4374,2021-04-15,LOM,49471,21868,27603,34890,13830,751,ITC,ITC4,3,Lombardia,Lombardia,10060574,6395685,63.57,0.49
4375,2021-01-05,LOM,7870,2579,5291,7864,0,6,ITC,ITC4,3,Lombardia,Lombardia,10060574,6403555,63.65,0.08
4376,2021-05-26,LOM,93771,44679,49092,42746,50135,890,ITC,ITC4,3,Lombardia,Lombardia,10060574,6497326,64.58,0.93
4377,2021-02-15,LOM,9033,3163,5870,8379,474,180,ITC,ITC4,3,Lombardia,Lombardia,10060574,6506359,64.67,0.09
4378,2021-03-20,LOM,32610,12171,20439,22250,9859,501,ITC,ITC4,3,Lombardia,Lombardia,10060574,6538969,65.0,0.32
4379,2021-07-12,LOM,111834,57491,54343,14795,95898,1141,ITC,ITC4,3,Lombardia,Lombardia,10060574,6650803,66.11,1.11
4380,2021-04-03,LOM,36289,14878,21411,25786,10121,382,ITC,ITC4,3,Lombardia,Lombardia,10060574,6687092,66.47,0.36
4381,2021-05-30,LOM,74417,35611,38806,33794,40005,618,ITC,ITC4,3,Lombardia,Lombardia,10060574,6761509,67.21,0.74
4382,2021-07-26,LOM,109572,58902,50670,7694,101118,760,ITC,ITC4,3,Lombardia,Lombardia,10060574,6871081,68.3,1.09
4383,2021-05-16,LOM,68721,32513,36208,35587,32220,914,ITC,ITC4,3,Lombardia,Lombardia,10060574,6939802,68.98,0.68
4384,2021-02-05,LOM,25766,7480,18286,2426,23327,13,ITC,ITC4,3,Lombardia,Lombardia,10060574,6965568,69.24,0.26
4385,2021-02-22,LOM,11930,4815,7115,11423,309,198,ITC,ITC4,3,Lombardia,Lombardia,10060574,6977498,69.35,0.12
4386,2021-03-13,LOM,27221,9792,17429,20557,6113,551,ITC,ITC4,3,Lombardia,Lombardia,10060574,7004719,69.63,0.27
4387,2021-06-18,LOM,107703,52899,54804,51934,54530,1239,ITC,ITC4,3,Lombardia,Lombardia,10060574,7112422,70.7,1.07
4388,2021-08-07,LOM,79697,43261,36436,16059,62834,804,ITC,ITC4,3,Lombardia,Lombardia,10060574,7192119,71.49,0.79
4389,2021-04-29,LOM,115627,53622,62005,83146,29901,2580,ITC,ITC4,3,Lombardia,Lombardia,10060574,7307746,72.64,1.15
4390,2021-06-25,LOM,108323,56252,52071,78362,27656,2305,ITC,ITC4,3,Lombardia,Lombardia,10060574,7416069,73.71,1.08
4391,2021-04-20,LOM,67694,30840,36854,55905,10356,1433,ITC,ITC4,3,Lombardia,Lombardia,10060574,7483763,74.39,0.67
4392,2021-01-10,LOM,10550,3981,6569,10542,0,8,ITC,ITC4,3,Lombardia,Lombardia,10060574,7494313,74.49,0.1
4393,2021-01-17,LOM,8356,3349,5007,8149,201,6,ITC,ITC4,3,Lombardia,Lombardia,10060574,7502669,74.57,0.08
4394,2021-06-23,LOM,111047,57446,53601,76751,32163,2133,ITC,ITC4,3,Lombardia,Lombardia,10060574,7613716,75.68,1.1
4395,2021-03-15,LOM,31601,11349,20252,22430,8555,616,ITC,ITC4,3,Lombardia,Lombardia,10060574,7645317,75.99,0.31
4396,2021-03-27,LOM,32503,12403,20100,23117,8754,632,ITC,ITC4,3,Lombardia,Lombardia,10060574,7677820,76.32,0.32
4397,2021-01-03,LOM,855,316,539,854,0,1,ITC,ITC4,3,Lombardia,Lombardia,10060574,7678675,76.32,0.01
4398,2021-06-22,LOM,111249,58102,53147,79177,29948,2124,ITC,ITC4,3,Lombardia,Lombardia,10060574,7789924,77.43,1.11
4399,2021-03-04,LOM,29363,12131,17232,20062,9082,219,ITC,ITC4,3,Lombardia,Lombardia,10060574,7819287,77.72,0.29
4400,2021-06-30,LOM,106997,53004,53993,56597,48279,2121,ITC,ITC4,3,Lombardia,Lombardia,10060574,7926284,78.79,1.06
4401,2021-03-22,LOM,40349,14308,26041,28949,10566,834,ITC,ITC4,3,Lombardia,Lombardia,10060574,7966633,79.19,0.4
4402,2021-04-08,LOM,52448,21788,30660,35292,16483,673,ITC,ITC4,3,Lombardia,Lombardia,10060574,8019081,79.71,0.52
4403,2020-12-29,LOM,106,45,61,106,0,0,ITC,ITC4,3,Lombardia,Lombardia,10060574,8019187,79.71,0.0
4404,2021-07-14,LOM,109389,56836,52553,14339,93638,1412,ITC,ITC4,3,Lombardia,Lombardia,10060574,8128576,80.8,1.09
4405,2021-07-31,LOM,71109,38775,32334,36371,32718,2020,ITC,ITC4,3,Lombardia,Lombardia,10060574,8199685,81.5,0.71
4406,2021-04-22,LOM,74032,33427,40605,56230,16420,1382,ITC,ITC4,3,Lombardia,Lombardia,10060574,8273717,82.24,0.74
4407,2020-12-27,LOM,718,414,304,718,0,0,ITC,ITC4,3,Lombardia,Lombardia,10060574,8274435,82.25,0.01
4408,2021-08-02,LOM,83470,45218,38252,18254,64311,905,ITC,ITC4,3,Lombardia,Lombardia,10060574,8357905,83.08,0.83
4409,2021-05-09,LOM,69722,32891,36831,54468,13278,1976,ITC,ITC4,3,Lombardia,Lombardia,10060574,8427627,83.77,0.69
4410,2021-01-29,LOM,13535,4143,9392,686,12846,3,ITC,ITC4,3,Lombardia,Lombardia,10060574,8441162,83.9,0.13
4411,2021-05-23,LOM,60814,28963,31851,26295,34005,514,ITC,ITC4,3,Lombardia,Lombardia,10060574,8501976,84.51,0.6
4412,2021-02-12,LOM,14014,4381,9633,8875,4979,160,ITC,ITC4,3,Lombardia,Lombardia,10060574,8515990,84.65,0.14
4413,2021-07-19,LOM,96912,50313,46599,10803,85027,1082,ITC,ITC4,3,Lombardia,Lombardia,10060574,8612902,85.61,0.96
4414,2021-04-10,LOM,52785,21863,30922,40073,11961,751,ITC,ITC4,3,Lombardia,Lombardia,10060574,8665687,86.14,0.52
4415,2021-06-06,LOM,90133,46349,43784,79533,9222,1378,ITC,ITC4,3,Lombardia,Lombardia,10060574,8755820,87.03,0.9
4416,2021-01-07,LOM,11801,3653,8148,11760,0,41,ITC,ITC4,3,Lombardia,Lombardia,10060574,8767621,87.15,0.12
4417,2021-07-23,LOM,95503,50061,45442,11415,82827,1261,ITC,ITC4,3,Lombardia,Lombardia,10060574,8863124,88.1,0.95
4418,2021-08-09,LOM,68900,36984,31916,18598,49251,1051,ITC,ITC4,3,Lombardia,Lombardia,10060574,8932024,88.78,0.68
4419,2021-05-01,LOM,96043,43703,52340,65054,29273,1716,ITC,ITC4,3,Lombardia,Lombardia,10060574,9028067,89.74,0.95
4420,2021-01-21,LOM,5506,1609,3897,4795,694,17,ITC,ITC4,3,Lombardia,Lombardia,10060574,9033573,89.79,0.05
4421,2021-02-07,LOM,7317,2828,4489,335,6979,3,ITC,ITC4,3,Lombardia,Lombardia,10060574,9040890,89.86,0.07
4422,2021-01-19,LOM,8060,2331,5729,7577,469,14,ITC,ITC4,3,Lombardia,Lombardia,10060574,9048950,89.94,0.08
4423,2021-03-01,LOM,18799,8235,10564,16885,1708,206,ITC,ITC4,3,Lombardia,Lombardia,10060574,9067749,90.13,0.19
4424,2021-05-15,LOM,80961,38804,42157,45490,33423,2048,ITC,ITC4,3,Lombardia,Lombardia,10060574,9148710,90.94,0.8
4425,2021-07-11,LOM,90319,45693,44626,11766,77495,1058,ITC,ITC4,3,Lombardia,Lombardia,10060574,9239029,91.83,0.9
4426,2021-05-13,LOM,87223,41795,45428,55734,28893,2596,ITC,ITC4,3,Lombardia,Lombardia,10060574,9326252,92.7,0.87
4427,2021-04-27,LOM,86092,40004,46088,67678,16598,1816,ITC,ITC4,3,Lombardia,Lombardia,10060574,9412344,93.56,0.86
4428,2021-03-17,LOM,26288,10507,15781,15108,11020,160,ITC,ITC4,3,Lombardia,Lombardia,10060574,9438632,93.82,0.26
4429,2021-03-03,LOM,27010,11524,15486,19486,7306,218,ITC,ITC4,3,Lombardia,Lombardia,10060574,9465642,94.09,0.27
4430,2021-05-11,LOM,86932,41454,45478,58273,26243,2416,ITC,ITC4,3,Lombardia,Lombardia,10060574,9552574,94.95,0.86
4431,2021-05-28,LOM,93672,44873,48799,42033,50727,912,ITC,ITC4,3,Lombardia,Lombardia,10060574,9646246,95.88,0.93
4432,2021-02-17,LOM,12017,3769,8248,10432,1392,193,ITC,ITC4,3,Lombardia,Lombardia,10060574,9658263,96.0,0.12
4433,2021-06-11,LOM,101517,51709,49808,84941,14682,1894,ITC,ITC4,3,Lombardia,Lombardia,10060574,9759780,97.01,1.01
4434,2021-07-09,LOM,115729,58994,56735,11731,103114,884,ITC,ITC4,3,Lombardia,Lombardia,10060574,9875509,98.16,1.15
4435,2021-06-03,LOM,97186,49740,47446,84612,10910,1664,ITC,ITC4,3,Lombardia,Lombardia,10060574,9972695,99.13,0.97
4436,2021-06-20,LOM,89031,44369,44662,52834,34956,1241,ITC,ITC4,3,Lombardia,Lombardia,10060574,10061726,100.01,0.88
4437,2021-03-12,LOM,35307,12977,22330,24459,10232,616,ITC,ITC4,3,Lombardia,Lombardia,10060574,10097033,100.36,0.35
4438,2021-03-29,LOM,40061,15548,24513,24534,14848,679,ITC,ITC4,3,Lombardia,Lombardia,10060574,10137094,100.76,0.4
4439,2021-06-13,LOM,76001,40564,35437,72286,2129,1586,ITC,ITC4,3,Lombardia,Lombardia,10060574,10213095,101.52,0.76
4440,2021-03-05,LOM,28980,11957,17023,20248,8430,302,ITC,ITC4,3,Lombardia,Lombardia,10060574,10242075,101.8,0.29
4441,2021-06-27,LOM,90950,46821,44129,69783,18869,2298,ITC,ITC4,3,Lombardia,Lombardia,10060574,10333025,102.71,0.9
4442,2021-03-19,LOM,32485,12939,19546,18917,13246,322,ITC,ITC4,3,Lombardia,Lombardia,10060574,10365510,103.03,0.32
4443,2021-05-27,LOM,94947,45482,49465,40620,53534,793,ITC,ITC4,3,Lombardia,Lombardia,10060574,10460457,103.97,0.94
4444,2021-02-19,LOM,14226,5402,8824,13326,725,175,ITC,ITC4,3,Lombardia,Lombardia,10060574,10474683,104.12,0.14
4445,2021-04-17,LOM,48541,21315,27226,36968,10857,716,ITC,ITC4,3,Lombardia,Lombardia,10060574,10523224,104.6,0.48
4446,2021-02-26,LOM,18440,7569,10871,16329,1905,206,ITC,ITC4,3,Lombardia,Lombardia,10060574,10541664,104.78,0.18
4447,2021-07-30,LOM,73217,39736,33481,35023,36072,2122,ITC,ITC4,3,Lombardia,Lombardia,10060574,10614881,105.51,0.73
4448,2020-12-31,LOM,714,302,412,714,0,0,ITC,ITC4,3,Lombardia,Lombardia,10060574,10615595,105.52,0.01
4449,2021-08-11,LOM,39011,21348,17663,12299,25930,782,ITC,ITC4,3,Lombardia,Lombardia,10060574,10654606,105.9,0.39
4450,2021-05-20,LOM,95604,46240,49364,31692,63074,838,ITC,ITC4,3,Lombardia,Lombardia,10060574,10750210,106.85,0.95
4451,2021-02-02,LOM,19964,6629,13335,497,19464,3,ITC,ITC4,3,Lombardia,Lombardia,10060574,10770174,107.05,0.2
4452,2021-03-31,LOM,42244,17136,25108,26199,15363,682,ITC,ITC4,3,Lombardia,Lombardia,10060574,10812418,107.47,0.42
4453,2021-03-10,LOM,33341,12750,20591,24860,7889,592,ITC,ITC4,3,Lombardia,Lombardia,10060574,10845759,107.8,0.33
4454,2021-05-06,LOM,89930,42220,47710,70991,16566,2373,ITC,ITC4,3,Lombardia,Lombardia,10060574,10935689,108.7,0.89
4455,2021-01-26,LOM,8374,2713,5661,348,8025,1,ITC,ITC4,3,Lombardia,Lombardia,10060574,10944063,108.78,0.08
4456,2021-04-05,LOM,27391,11698,15693,19029,8108,254,ITC,ITC4,3,Lombardia,Lombardia,10060574,10971454,109.05,0.27
4457,2021-07-04,LOM,86754,43392,43362,40192,44607,1955,ITC,ITC4,3,Lombardia,Lombardia,10060574,11058208,109.92,0.86
4458,2021-07-02,LOM,103984,52129,51855,48888,52895,2201,ITC,ITC4,3,Lombardia,Lombardia,10060574,11162192,110.95,1.03
4459,2021-03-24,LOM,43305,15634,27671,30472,11943,890,ITC,ITC4,3,Lombardia,Lombardia,10060574,11205497,111.38,0.43
4460,2021-02-09,LOM,12228,3336,8892,4025,8189,14,ITC,ITC4,3,Lombardia,Lombardia,10060574,11217725,111.5,0.12
4461,2021-04-24,LOM,75831,33607,42224,53440,21150,1241,ITC,ITC4,3,Lombardia,Lombardia,10060574,11293556,112.26,0.75
4462,2021-01-14,LOM,26958,7813,19145,26905,0,53,ITC,ITC4,3,Lombardia,Lombardia,10060574,11320514,112.52,0.27
4463,2021-05-08,LOM,87783,40773,47010,63478,22078,2227,ITC,ITC4,3,Lombardia,Lombardia,10060574,11408297,113.4,0.87
4464,2021-07-16,LOM,108884,56698,52186,11126,96593,1165,ITC,ITC4,3,Lombardia,Lombardia,10060574,11517181,114.48,1.08
4465,2021-04-07,LOM,50616,20934,29682,34080,15828,708,ITC,ITC4,3,Lombardia,Lombardia,10060574,11567797,114.98,0.5
4466,2021-01-31,LOM,9804,3800,6004,29,9775,0,ITC,ITC4,3,Lombardia,Lombardia,10060574,11577601,115.08,0.1
4467,2021-05-25,LOM,91210,43640,47570,43857,46529,824,ITC,ITC4,3,Lombardia,Lombardia,10060574,11668811,115.99,0.91
4468,2021-02-14,LOM,3584,1547,2037,2934,636,14,ITC,ITC4,3,Lombardia,Lombardia,10060574,11672395,116.02,0.04
4469,2021-01-12,LOM,20322,6737,13585,20292,0,30,ITC,ITC4,3,Lombardia,Lombardia,10060574,11692717,116.22,0.2
4470,2021-05-07,LOM,92398,43730,48668,68388,22426,1584,ITC,ITC4,3,Lombardia,Lombardia,10060574,11785115,117.14,0.92
4471,2021-03-18,LOM,27427,10969,16458,15935,11265,227,ITC,ITC4,3,Lombardia,Lombardia,10060574,11812542,117.41,0.27
4472,2021-05-14,LOM,86028,41430,44598,53290,30355,2383,ITC,ITC4,3,Lombardia,Lombardia,10060574,11898570,118.27,0.86
4473,2021-07-10,LOM,107264,54300,52964,13914,92171,1179,ITC,ITC4,3,Lombardia,Lombardia,10060574,12005834,119.34,1.07
4474,2021-06-26,LOM,105921,55455,50466,77781,25738,2402,ITC,ITC4,3,Lombardia,Lombardia,10060574,12111755,120.39,1.05
4475,2021-02-10,LOM,14438,4518,9920,7565,6844,29,ITC,ITC4,3,Lombardia,Lombardia,10060574,12126193,120.53,0.14
4476,2021-02-03,LOM,25696,7938,17758,1078,24613,5,ITC,ITC4,3,Lombardia,Lombardia,10060574,12151889,120.79,0.26
4477,2021-04-01,LOM,43168,17310,25858,26081,16374,713,ITC,ITC4,3,Lombardia,Lombardia,10060574,12195057,121.22,0.43
4478,2021-06-01,LOM,94028,46128,47900,75801,17120,1107,ITC,ITC4,3,Lombardia,Lombardia,10060574,12289085,122.15,0.93
4479,2021-01-02,LOM,202,74,128,202,0,0,ITC,ITC4,3,Lombardia,Lombardia,10060574,12289287,122.15,0.0
4480,2021-06-08,LOM,102926,52311,50615,87174,14077,1675,ITC,ITC4,3,Lombardia,Lombardia,10060574,12392213,123.18,1.02
4481,2021-02-28,LOM,7886,3256,4630,7604,210,72,ITC,ITC4,3,Lombardia,Lombardia,10060574,12400099,123.25,0.08
4482,2021-08-04,LOM,90085,48777,41308,14423,74998,664,ITC,ITC4,3,Lombardia,Lombardia,10060574,12490184,124.15,0.9
4483,2021-04-26,LOM,88021,40949,47072,67080,19169,1772,ITC,ITC4,3,Lombardia,Lombardia,10060574,12578205,125.02,0.87
4484,2021-07-21,LOM,93975,48483,45492,8592,84502,881,ITC,ITC4,3,Lombardia,Lombardia,10060574,12672180,125.96,0.93
4485,2021-04-12,LOM,47323,20613,26710,32303,14384,636,ITC,ITC4,3,Lombardia,Lombardia,10060574,12719503,126.43,0.47
4486,2021-02-21,LOM,5053,1864,3189,4942,17,94,ITC,ITC4,3,Lombardia,Lombardia,10060574,12724556,126.48,0.05
4487,2021-07-28,LOM,77418,41713,35705,19101,56562,1755,ITC,ITC4,3,Lombardia,Lombardia,10060574,12801974,127.25,0.77
4488,2021-04-19,LOM,60395,27481,32914,49707,9411,1277,ITC,ITC4,3,Lombardia,Lombardia,10060574,12862369,127.85,0.6
4489,2021-06-15,LOM,96063,48889,47174,49023,45984,1056,ITC,ITC4,3,Lombardia,Lombardia,10060574,12958432,128.8,0.95
4490,2021-07-30,TOS,37859,20373,17486,10781,26729,349,ITI,ITI1,9,Toscana,Toscana,3729641,37859,1.02,1.02
4491,2021-07-13,TOS,29329,14730,14599,7712,21446,171,ITI,ITI1,9,Toscana,Toscana,3729641,67188,1.8,0.79
4492,2021-04-02,TOS,32021,13577,18444,23689,8077,255,ITI,ITI1,9,Toscana,Toscana,3729641,99209,2.66,0.86
4493,2021-07-11,TOS,26124,12689,13435,9130,16826,168,ITI,ITI1,9,Toscana,Toscana,3729641,125333,3.36,0.7
4494,2021-06-22,TOS,31048,15621,15427,22459,8213,376,ITI,ITI1,9,Toscana,Toscana,3729641,156381,4.19,0.83
4495,2021-05-17,TOS,29771,14878,14893,20557,8936,278,ITI,ITI1,9,Toscana,Toscana,3729641,186152,4.99,0.8
4496,2021-03-21,TOS,3296,1629,1667,1819,1434,43,ITI,ITI1,9,Toscana,Toscana,3729641,189448,5.08,0.09
4497,2021-01-23,TOS,3969,1360,2609,630,3333,6,ITI,ITI1,9,Toscana,Toscana,3729641,193417,5.19,0.11
4498,2021-06-29,TOS,37041,18035,19006,7990,28904,147,ITI,ITI1,9,Toscana,Toscana,3729641,230458,6.18,0.99
4499,2021-05-03,TOS,11944,5517,6427,10363,1334,247,ITI,ITI1,9,Toscana,Toscana,3729641,242402,6.5,0.32
4500,2021-05-22,TOS,26029,12665,13364,21487,4293,249,ITI,ITI1,9,Toscana,Toscana,3729641,268431,7.2,0.7
4501,2021-05-05,TOS,30153,13457,16696,14861,14556,736,ITI,ITI1,9,Toscana,Toscana,3729641,298584,8.01,0.81
4502,2021-02-28,TOS,1649,667,982,852,727,70,ITI,ITI1,9,Toscana,Toscana,3729641,300233,8.05,0.04
4503,2021-02-11,TOS,5384,2022,3362,5061,242,81,ITI,ITI1,9,Toscana,Toscana,3729641,305617,8.19,0.14
4504,2021-02-09,TOS,4490,1470,3020,3765,611,114,ITI,ITI1,9,Toscana,Toscana,3729641,310107,8.31,0.12
4505,2021-08-01,TOS,29903,15307,14596,13795,15635,473,ITI,ITI1,9,Toscana,Toscana,3729641,340010,9.12,0.8
4506,2021-06-05,TOS,28444,13600,14844,20558,7616,270,ITI,ITI1,9,Toscana,Toscana,3729641,368454,9.88,0.76
4507,2021-08-08,TOS,25002,12904,12098,14593,9910,499,ITI,ITI1,9,Toscana,Toscana,3729641,393456,10.55,0.67
4508,2021-01-11,TOS,5095,1691,3404,4996,0,99,ITI,ITI1,9,Toscana,Toscana,3729641,398551,10.69,0.14
4509,2021-04-21,TOS,29636,12683,16953,16852,12145,639,ITI,ITI1,9,Toscana,Toscana,3729641,428187,11.48,0.79
4510,2021-02-23,TOS,7723,3325,4398,7209,162,352,ITI,ITI1,9,Toscana,Toscana,3729641,435910,11.69,0.21
4511,2021-06-03,TOS,32059,15455,16604,27149,4587,323,ITI,ITI1,9,Toscana,Toscana,3729641,467969,12.55,0.86
4512,2021-04-07,TOS,35843,15474,20369,28147,7276,420,ITI,ITI1,9,Toscana,Toscana,3729641,503812,13.51,0.96
4513,2021-06-12,TOS,29401,15158,14243,24658,4392,351,ITI,ITI1,9,Toscana,Toscana,3729641,533213,14.3,0.79
4514,2021-01-28,TOS,6286,1883,4403,346,5933,7,ITI,ITI1,9,Toscana,Toscana,3729641,539499,14.47,0.17
4515,2021-03-19,TOS,10170,4474,5696,7127,2896,147,ITI,ITI1,9,Toscana,Toscana,3729641,549669,14.74,0.27
4516,2021-07-01,TOS,32048,15510,16538,10719,21060,269,ITI,ITI1,9,Toscana,Toscana,3729641,581717,15.6,0.86
4517,2021-03-26,TOS,20744,9430,11314,14708,5829,207,ITI,ITI1,9,Toscana,Toscana,3729641,602461,16.15,0.56
4518,2021-03-09,TOS,11142,4575,6567,5502,5562,78,ITI,ITI1,9,Toscana,Toscana,3729641,613603,16.45,0.3
4519,2021-04-09,TOS,24609,10581,14028,20708,3453,448,ITI,ITI1,9,Toscana,Toscana,3729641,638212,17.11,0.66
4520,2021-07-18,TOS,30365,15266,15099,8335,21821,209,ITI,ITI1,9,Toscana,Toscana,3729641,668577,17.93,0.81
4521,2021-06-17,TOS,32588,16694,15894,26695,5553,340,ITI,ITI1,9,Toscana,Toscana,3729641,701165,18.8,0.87
4522,2021-01-16,TOS,3271,1046,2225,3213,0,58,ITI,ITI1,9,Toscana,Toscana,3729641,704436,18.89,0.09
4523,2021-04-26,TOS,10147,4934,5213,7454,2557,136,ITI,ITI1,9,Toscana,Toscana,3729641,714583,19.16,0.27
4524,2021-01-02,TOS,3499,1096,2403,3455,0,44,ITI,ITI1,9,Toscana,Toscana,3729641,718082,19.25,0.09
4525,2021-03-28,TOS,6211,2807,3404,5875,253,83,ITI,ITI1,9,Toscana,Toscana,3729641,724293,19.42,0.17
4526,2021-01-30,TOS,4624,1623,3001,175,4431,18,ITI,ITI1,9,Toscana,Toscana,3729641,728917,19.54,0.12
4527,2021-07-06,TOS,25782,13033,12749,11041,14521,220,ITI,ITI1,9,Toscana,Toscana,3729641,754699,20.24,0.69
4528,2021-05-10,TOS,26230,12412,13818,15244,10641,345,ITI,ITI1,9,Toscana,Toscana,3729641,780929,20.94,0.7
4529,2021-03-14,TOS,7176,2570,4606,3148,3935,93,ITI,ITI1,9,Toscana,Toscana,3729641,788105,21.13,0.19
4530,2021-06-24,TOS,29447,14622,14825,19307,9747,393,ITI,ITI1,9,Toscana,Toscana,3729641,817552,21.92,0.79
4531,2021-01-09,TOS,4486,1596,2890,4420,0,66,ITI,ITI1,9,Toscana,Toscana,3729641,822038,22.04,0.12
4532,2021-03-18,TOS,9972,3980,5992,5844,3991,137,ITI,ITI1,9,Toscana,Toscana,3729641,832010,22.31,0.27
4533,2021-06-10,TOS,26439,13562,12877,25533,558,348,ITI,ITI1,9,Toscana,Toscana,3729641,858449,23.02,0.71
4534,2021-05-24,TOS,33749,16720,17029,23886,9583,280,ITI,ITI1,9,Toscana,Toscana,3729641,892198,23.92,0.9
4535,2021-01-25,TOS,5132,1895,3237,240,4888,4,ITI,ITI1,9,Toscana,Toscana,3729641,897330,24.06,0.14
4536,2021-02-16,TOS,9281,3340,5941,8329,721,231,ITI,ITI1,9,Toscana,Toscana,3729641,906611,24.31,0.25
4537,2021-05-02,TOS,11178,4935,6243,8978,1966,234,ITI,ITI1,9,Toscana,Toscana,3729641,917789,24.61,0.3
4538,2021-08-10,TOS,25628,13304,12324,16140,8855,633,ITI,ITI1,9,Toscana,Toscana,3729641,943417,25.3,0.69
4539,2021-04-16,TOS,28966,12888,16078,21419,6914,633,ITI,ITI1,9,Toscana,Toscana,3729641,972383,26.07,0.78
4540,2021-07-25,TOS,33897,16766,17131,7055,26665,177,ITI,ITI1,9,Toscana,Toscana,3729641,1006280,26.98,0.91
4541,2021-03-02,TOS,10600,3799,6801,7041,3446,113,ITI,ITI1,9,Toscana,Toscana,3729641,1016880,27.26,0.28
4542,2021-01-04,TOS,5067,1896,3171,5002,0,65,ITI,ITI1,9,Toscana,Toscana,3729641,1021947,27.4,0.14
4543,2021-04-14,TOS,20192,8349,11843,14500,5145,547,ITI,ITI1,9,Toscana,Toscana,3729641,1042139,27.94,0.54
4544,2021-06-14,TOS,31816,16339,15477,27420,4108,288,ITI,ITI1,9,Toscana,Toscana,3729641,1073955,28.8,0.85
4545,2021-01-21,TOS,1589,686,903,858,722,9,ITI,ITI1,9,Toscana,Toscana,3729641,1075544,28.84,0.04
4546,2021-06-02,TOS,27600,13624,13976,21858,5509,233,ITI,ITI1,9,Toscana,Toscana,3729641,1103144,29.58,0.74
4547,2021-04-06,TOS,22233,9829,12404,18069,3745,419,ITI,ITI1,9,Toscana,Toscana,3729641,1125377,30.17,0.6
4548,2021-02-08,TOS,4099,1362,2737,3529,459,111,ITI,ITI1,9,Toscana,Toscana,3729641,1129476,30.28,0.11
4549,2021-07-15,TOS,31238,15286,15952,8080,22915,243,ITI,ITI1,9,Toscana,Toscana,3729641,1160714,31.12,0.84
4550,2021-05-19,TOS,27969,13584,14385,18643,9060,266,ITI,ITI1,9,Toscana,Toscana,3729641,1188683,31.87,0.75
4551,2021-02-04,TOS,4254,1594,2660,933,3294,27,ITI,ITI1,9,Toscana,Toscana,3729641,1192937,31.99,0.11
4552,2021-05-15,TOS,29363,13858,15505,22868,5900,595,ITI,ITI1,9,Toscana,Toscana,3729641,1222300,32.77,0.79
4553,2021-04-28,TOS,19144,8191,10953,3455,15334,355,ITI,ITI1,9,Toscana,Toscana,3729641,1241444,33.29,0.51
4554,2021-02-18,TOS,8824,3285,5539,7744,896,184,ITI,ITI1,9,Toscana,Toscana,3729641,1250268,33.52,0.24
4555,2021-05-29,TOS,31575,15263,16312,23178,8170,227,ITI,ITI1,9,Toscana,Toscana,3729641,1281843,34.37,0.85
4556,2021-08-06,TOS,32885,17633,15252,15330,17081,474,ITI,ITI1,9,Toscana,Toscana,3729641,1314728,35.25,0.88
4557,2021-03-23,TOS,9443,4410,5033,6964,2282,197,ITI,ITI1,9,Toscana,Toscana,3729641,1324171,35.5,0.25
4558,2021-03-07,TOS,5649,2358,3291,1993,3545,111,ITI,ITI1,9,Toscana,Toscana,3729641,1329820,35.66,0.15
4559,2021-07-20,TOS,37318,19096,18222,7974,29155,189,ITI,ITI1,9,Toscana,Toscana,3729641,1367138,36.66,1.0
4560,2021-02-06,TOS,4529,1551,2978,1261,3236,32,ITI,ITI1,9,Toscana,Toscana,3729641,1371667,36.78,0.12
4561,2021-06-26,TOS,34565,16765,17800,9995,24340,230,ITI,ITI1,9,Toscana,Toscana,3729641,1406232,37.7,0.93
4562,2021-06-09,TOS,34834,17575,17259,33951,462,421,ITI,ITI1,9,Toscana,Toscana,3729641,1441066,38.64,0.93
4563,2021-04-04,TOS,13927,6612,7315,13507,255,165,ITI,ITI1,9,Toscana,Toscana,3729641,1454993,39.01,0.37
4564,2021-03-16,TOS,4903,1885,3018,2568,2254,81,ITI,ITI1,9,Toscana,Toscana,3729641,1459896,39.14,0.13
4565,2021-02-27,TOS,1984,756,1228,1007,902,75,ITI,ITI1,9,Toscana,Toscana,3729641,1461880,39.2,0.05
4566,2021-04-18,TOS,8364,4092,4272,7056,1032,276,ITI,ITI1,9,Toscana,Toscana,3729641,1470244,39.42,0.22
4567,2021-07-27,TOS,38666,20109,18557,11274,27060,332,ITI,ITI1,9,Toscana,Toscana,3729641,1508910,40.46,1.04
4568,2021-07-10,TOS,29302,14180,15122,7956,21161,185,ITI,ITI1,9,Toscana,Toscana,3729641,1538212,41.24,0.79
4569,2021-02-25,TOS,10632,4305,6327,9464,998,170,ITI,ITI1,9,Toscana,Toscana,3729641,1548844,41.53,0.29
4570,2021-06-28,TOS,37696,18138,19558,8440,29089,167,ITI,ITI1,9,Toscana,Toscana,3729641,1586540,42.54,1.01
4571,2021-01-20,TOS,1333,639,694,1022,248,63,ITI,ITI1,9,Toscana,Toscana,3729641,1587873,42.57,0.04
4572,2021-04-30,TOS,40234,17805,22429,19662,19927,645,ITI,ITI1,9,Toscana,Toscana,3729641,1628107,43.65,1.08
4573,2021-04-25,TOS,11063,5250,5813,8759,2143,161,ITI,ITI1,9,Toscana,Toscana,3729641,1639170,43.95,0.3
4574,2021-08-03,TOS,36310,18900,17410,12150,23783,377,ITI,ITI1,9,Toscana,Toscana,3729641,1675480,44.92,0.97
4575,2021-03-04,TOS,17859,6958,10901,14618,3085,156,ITI,ITI1,9,Toscana,Toscana,3729641,1693339,45.4,0.48
4576,2021-06-21,TOS,31196,15489,15707,18141,12793,262,ITI,ITI1,9,Toscana,Toscana,3729641,1724535,46.24,0.84
4577,2021-01-06,TOS,4519,1460,3059,4467,0,52,ITI,ITI1,9,Toscana,Toscana,3729641,1729054,46.36,0.12
4578,2021-02-20,TOS,4664,1797,2867,3993,537,134,ITI,ITI1,9,Toscana,Toscana,3729641,1733718,46.48,0.13
4579,2021-05-31,TOS,30345,14644,15701,19262,10842,241,ITI,ITI1,9,Toscana,Toscana,3729641,1764063,47.3,0.81
4580,2021-05-14,TOS,33388,15452,17936,20019,12728,641,ITI,ITI1,9,Toscana,Toscana,3729641,1797451,48.19,0.9
4581,2021-06-07,TOS,34955,17149,17806,30967,3647,341,ITI,ITI1,9,Toscana,Toscana,3729641,1832406,49.13,0.94
4582,2021-05-21,TOS,28943,13492,15451,17223,11463,257,ITI,ITI1,9,Toscana,Toscana,3729641,1861349,49.91,0.78
4583,2021-03-01,TOS,4474,1734,2740,766,3642,66,ITI,ITI1,9,Toscana,Toscana,3729641,1865823,50.03,0.12
4584,2021-07-17,TOS,27739,14332,13407,8957,18542,240,ITI,ITI1,9,Toscana,Toscana,3729641,1893562,50.77,0.74
4585,2021-06-11,TOS,29745,15490,14255,24720,4660,365,ITI,ITI1,9,Toscana,Toscana,3729641,1923307,51.57,0.8
4586,2021-04-15,TOS,24463,10226,14237,15331,8602,530,ITI,ITI1,9,Toscana,Toscana,3729641,1947770,52.22,0.66
4587,2021-02-17,TOS,8178,3171,5007,7301,753,124,ITI,ITI1,9,Toscana,Toscana,3729641,1955948,52.44,0.22
4588,2021-07-24,TOS,38427,19362,19065,6855,31347,225,ITI,ITI1,9,Toscana,Toscana,3729641,1994375,53.47,1.03
4589,2021-05-07,TOS,32162,14714,17448,11358,20192,612,ITI,ITI1,9,Toscana,Toscana,3729641,2026537,54.34,0.86
4590,2021-07-29,TOS,39360,20503,18857,12600,26417,343,ITI,ITI1,9,Toscana,Toscana,3729641,2065897,55.39,1.06
4591,2021-02-13,TOS,7787,2362,5425,7412,227,148,ITI,ITI1,9,Toscana,Toscana,3729641,2073684,55.6,0.21
4592,2021-01-08,TOS,5948,1644,4304,5855,0,93,ITI,ITI1,9,Toscana,Toscana,3729641,2079632,55.76,0.16
4593,2021-07-12,TOS,28265,13992,14273,9662,18304,299,ITI,ITI1,9,Toscana,Toscana,3729641,2107897,56.52,0.76
4594,2021-03-11,TOS,15958,6380,9578,12405,3372,181,ITI,ITI1,9,Toscana,Toscana,3729641,2123855,56.95,0.43
4595,2021-06-19,TOS,26511,13925,12586,21388,4788,335,ITI,ITI1,9,Toscana,Toscana,3729641,2150366,57.66,0.71
4596,2021-02-05,TOS,5750,2245,3505,1888,3828,34,ITI,ITI1,9,Toscana,Toscana,3729641,2156116,57.81,0.15
4597,2021-05-16,TOS,26687,12893,13794,23921,2470,296,ITI,ITI1,9,Toscana,Toscana,3729641,2182803,58.53,0.72
4598,2021-01-13,TOS,4062,1398,2664,3998,0,64,ITI,ITI1,9,Toscana,Toscana,3729641,2186865,58.63,0.11
4599,2021-04-23,TOS,25669,11429,14240,8806,16331,532,ITI,ITI1,9,Toscana,Toscana,3729641,2212534,59.32,0.69
4600,2021-03-20,TOS,6589,2978,3611,5361,1138,90,ITI,ITI1,9,Toscana,Toscana,3729641,2219123,59.5,0.18
4601,2020-12-30,TOS,329,106,223,328,0,1,ITI,ITI1,9,Toscana,Toscana,3729641,2219452,59.51,0.01
4602,2021-08-05,TOS,34595,17949,16646,12063,22162,370,ITI,ITI1,9,Toscana,Toscana,3729641,2254047,60.44,0.93
4603,2021-05-12,TOS,34216,15582,18634,13580,20050,586,ITI,ITI1,9,Toscana,Toscana,3729641,2288263,61.35,0.92
4604,2021-01-18,TOS,1120,637,483,972,98,50,ITI,ITI1,9,Toscana,Toscana,3729641,2289383,61.38,0.03
4605,2021-05-23,TOS,28431,13668,14763,25602,2560,269,ITI,ITI1,9,Toscana,Toscana,3729641,2317814,62.15,0.76
4606,2021-07-26,TOS,38247,19836,18411,10079,27863,305,ITI,ITI1,9,Toscana,Toscana,3729641,2356061,63.17,1.03
4607,2021-01-01,TOS,2370,788,1582,2325,0,45,ITI,ITI1,9,Toscana,Toscana,3729641,2358431,63.23,0.06
4608,2021-04-11,TOS,3645,1680,1965,3335,155,155,ITI,ITI1,9,Toscana,Toscana,3729641,2362076,63.33,0.1
4609,2021-07-03,TOS,29399,14815,14584,11853,17162,384,ITI,ITI1,9,Toscana,Toscana,3729641,2391475,64.12,0.79
4610,2021-08-07,TOS,30386,16252,14134,14178,15725,483,ITI,ITI1,9,Toscana,Toscana,3729641,2421861,64.94,0.81
4611,2021-03-06,TOS,7113,2852,4261,2826,4202,85,ITI,ITI1,9,Toscana,Toscana,3729641,2428974,65.13,0.19
4612,2021-05-28,TOS,30135,13952,16183,17425,12482,228,ITI,ITI1,9,Toscana,Toscana,3729641,2459109,65.93,0.81
4613,2021-04-22,TOS,35757,15313,20444,17403,17525,829,ITI,ITI1,9,Toscana,Toscana,3729641,2494866,66.89,0.96
4614,2021-02-24,TOS,10372,4467,5905,10034,198,140,ITI,ITI1,9,Toscana,Toscana,3729641,2505238,67.17,0.28
4615,2021-07-31,TOS,35812,19199,16613,12371,22999,442,ITI,ITI1,9,Toscana,Toscana,3729641,2541050,68.13,0.96
4616,2021-06-04,TOS,28331,13445,14886,20262,7804,265,ITI,ITI1,9,Toscana,Toscana,3729641,2569381,68.89,0.76
4617,2021-04-08,TOS,29736,12580,17156,22932,6435,369,ITI,ITI1,9,Toscana,Toscana,3729641,2599117,69.69,0.8
4618,2021-04-01,TOS,27119,11254,15865,16171,10708,240,ITI,ITI1,9,Toscana,Toscana,3729641,2626236,70.42,0.73
4619,2021-03-15,TOS,8706,3653,5053,4086,4447,173,ITI,ITI1,9,Toscana,Toscana,3729641,2634942,70.65,0.23
4620,2021-06-23,TOS,31550,15294,16256,19813,11381,356,ITI,ITI1,9,Toscana,Toscana,3729641,2666492,71.49,0.85
4621,2021-01-10,TOS,3002,1105,1897,2947,0,55,ITI,ITI1,9,Toscana,Toscana,3729641,2669494,71.58,0.08
4622,2021-04-20,TOS,18160,8109,10051,12210,5586,364,ITI,ITI1,9,Toscana,Toscana,3729641,2687654,72.06,0.49
4623,2021-04-03,TOS,15016,6646,8370,13674,1126,216,ITI,ITI1,9,Toscana,Toscana,3729641,2702670,72.46,0.4
4624,2021-01-22,TOS,2866,1064,1802,524,2339,3,ITI,ITI1,9,Toscana,Toscana,3729641,2705536,72.54,0.08
4625,2021-07-07,TOS,25640,12605,13035,9339,16114,187,ITI,ITI1,9,Toscana,Toscana,3729641,2731176,73.23,0.69
4626,2021-03-27,TOS,8865,4155,4710,8511,216,138,ITI,ITI1,9,Toscana,Toscana,3729641,2740041,73.47,0.24
4627,2021-05-11,TOS,27966,12993,14973,12104,15484,378,ITI,ITI1,9,Toscana,Toscana,3729641,2768007,74.22,0.75
4628,2021-03-13,TOS,9291,3311,5980,5171,3966,154,ITI,ITI1,9,Toscana,Toscana,3729641,2777298,74.47,0.25
4629,2021-07-14,TOS,28900,14270,14630,8603,20047,250,ITI,ITI1,9,Toscana,Toscana,3729641,2806198,75.24,0.77
4630,2021-01-29,TOS,6150,1702,4448,290,5848,12,ITI,ITI1,9,Toscana,Toscana,3729641,2812348,75.41,0.16
4631,2021-05-09,TOS,22541,9775,12766,9412,12868,261,ITI,ITI1,9,Toscana,Toscana,3729641,2834889,76.01,0.6
4632,2021-02-10,TOS,4268,1285,2983,3587,525,156,ITI,ITI1,9,Toscana,Toscana,3729641,2839157,76.12,0.11
4633,2021-05-04,TOS,18324,8217,10107,12415,5464,445,ITI,ITI1,9,Toscana,Toscana,3729641,2857481,76.62,0.49
4634,2021-02-12,TOS,7619,2694,4925,7293,213,113,ITI,ITI1,9,Toscana,Toscana,3729641,2865100,76.82,0.2
4635,2021-02-01,TOS,5514,1959,3555,510,4994,10,ITI,ITI1,9,Toscana,Toscana,3729641,2870614,76.97,0.15
4636,2021-02-03,TOS,4224,1452,2772,236,3984,4,ITI,ITI1,9,Toscana,Toscana,3729641,2874838,77.08,0.11
4637,2021-01-15,TOS,3879,1348,2531,3819,0,60,ITI,ITI1,9,Toscana,Toscana,3729641,2878717,77.18,0.1
4638,2021-06-18,TOS,30805,16258,14547,25000,5402,403,ITI,ITI1,9,Toscana,Toscana,3729641,2909522,78.01,0.83
4639,2021-03-25,TOS,23960,10399,13561,15304,8399,257,ITI,ITI1,9,Toscana,Toscana,3729641,2933482,78.65,0.64
4640,2021-03-03,TOS,18233,6541,11692,14496,3609,128,ITI,ITI1,9,Toscana,Toscana,3729641,2951715,79.14,0.49
4641,2021-01-05,TOS,5249,1755,3494,5193,0,56,ITI,ITI1,9,Toscana,Toscana,3729641,2956964,79.28,0.14
4642,2021-01-19,TOS,1106,533,573,1064,0,42,ITI,ITI1,9,Toscana,Toscana,3729641,2958070,79.31,0.03
4643,2021-01-27,TOS,4837,1575,3262,200,4632,5,ITI,ITI1,9,Toscana,Toscana,3729641,2962907,79.44,0.13
4644,2021-03-17,TOS,11426,4590,6836,6798,4534,94,ITI,ITI1,9,Toscana,Toscana,3729641,2974333,79.75,0.31
4645,2021-06-25,TOS,33634,16814,16820,12114,21242,278,ITI,ITI1,9,Toscana,Toscana,3729641,3007967,80.65,0.9
4646,2021-06-08,TOS,32598,16722,15876,31735,490,373,ITI,ITI1,9,Toscana,Toscana,3729641,3040565,81.52,0.87
4647,2021-02-26,TOS,10090,3840,6250,8661,1211,218,ITI,ITI1,9,Toscana,Toscana,3729641,3050655,81.79,0.27
4648,2021-06-06,TOS,28313,13657,14656,22585,5366,362,ITI,ITI1,9,Toscana,Toscana,3729641,3078968,82.55,0.76
4649,2021-06-30,TOS,38268,18513,19755,8461,29590,217,ITI,ITI1,9,Toscana,Toscana,3729641,3117236,83.58,1.03
4650,2021-02-14,TOS,9000,2569,6431,8737,110,153,ITI,ITI1,9,Toscana,Toscana,3729641,3126236,83.82,0.24
4651,2021-05-25,TOS,34192,16507,17685,19283,14636,273,ITI,ITI1,9,Toscana,Toscana,3729641,3160428,84.74,0.92
4652,2021-03-29,TOS,9698,4849,4849,9213,351,134,ITI,ITI1,9,Toscana,Toscana,3729641,3170126,85.0,0.26
4653,2021-07-16,TOS,27664,14037,13627,7695,19716,253,ITI,ITI1,9,Toscana,Toscana,3729641,3197790,85.74,0.74
4654,2021-05-20,TOS,29772,13919,15853,18640,10849,283,ITI,ITI1,9,Toscana,Toscana,3729641,3227562,86.54,0.8
4655,2021-01-31,TOS,3052,1131,1921,100,2949,3,ITI,ITI1,9,Toscana,Toscana,3729641,3230614,86.62,0.08
4656,2021-04-27,TOS,10371,4927,5444,3665,6502,204,ITI,ITI1,9,Toscana,Toscana,3729641,3240985,86.9,0.28
4657,2021-07-19,TOS,38014,18945,19069,8816,28909,289,ITI,ITI1,9,Toscana,Toscana,3729641,3278999,87.92,1.02
4658,2021-01-17,TOS,2536,871,1665,1987,514,35,ITI,ITI1,9,Toscana,Toscana,3729641,3281535,87.99,0.07
4659,2021-07-05,TOS,30515,15083,15432,10338,19946,231,ITI,ITI1,9,Toscana,Toscana,3729641,3312050,88.8,0.82
4660,2021-03-08,TOS,6712,2949,3763,1841,4825,46,ITI,ITI1,9,Toscana,Toscana,3729641,3318762,88.98,0.18
4661,2021-07-28,TOS,38526,20136,18390,12093,26096,337,ITI,ITI1,9,Toscana,Toscana,3729641,3357288,90.02,1.03
4662,2021-01-26,TOS,5398,1794,3604,210,5184,4,ITI,ITI1,9,Toscana,Toscana,3729641,3362686,90.16,0.14
4663,2021-05-06,TOS,31416,13667,17749,13464,17258,694,ITI,ITI1,9,Toscana,Toscana,3729641,3394102,91.0,0.84
4664,2021-04-19,TOS,9101,4513,4588,7752,1032,317,ITI,ITI1,9,Toscana,Toscana,3729641,3403203,91.25,0.24
4665,2021-04-17,TOS,20557,9218,11339,17928,2140,489,ITI,ITI1,9,Toscana,Toscana,3729641,3423760,91.8,0.55
4666,2021-04-12,TOS,2624,1192,1432,1800,655,169,ITI,ITI1,9,Toscana,Toscana,3729641,3426384,91.87,0.07
4667,2021-07-21,TOS,38479,19640,18839,7339,30906,234,ITI,ITI1,9,Toscana,Toscana,3729641,3464863,92.9,1.03
4668,2021-05-13,TOS,35181,15542,19639,13202,21339,640,ITI,ITI1,9,Toscana,Toscana,3729641,3500044,93.84,0.94
4669,2021-08-04,TOS,34733,17974,16759,11305,23014,414,ITI,ITI1,9,Toscana,Toscana,3729641,3534777,94.78,0.93
4670,2021-04-29,TOS,39367,17735,21632,18566,20140,661,ITI,ITI1,9,Toscana,Toscana,3729641,3574144,95.83,1.06
4671,2021-03-24,TOS,20030,8309,11721,10404,9483,143,ITI,ITI1,9,Toscana,Toscana,3729641,3594174,96.37,0.54
4672,2021-08-11,TOS,18981,9841,9140,11649,6848,484,ITI,ITI1,9,Toscana,Toscana,3729641,3613155,96.88,0.51
4673,2021-01-12,TOS,3581,1398,2183,3508,0,73,ITI,ITI1,9,Toscana,Toscana,3729641,3616736,96.97,0.1
4674,2021-01-24,TOS,3350,1073,2277,197,3150,3,ITI,ITI1,9,Toscana,Toscana,3729641,3620086,97.06,0.09
4675,2021-01-07,TOS,6018,1751,4267,5932,0,86,ITI,ITI1,9,Toscana,Toscana,3729641,3626104,97.22,0.16
4676,2021-05-27,TOS,28370,13206,15164,13274,14874,222,ITI,ITI1,9,Toscana,Toscana,3729641,3654474,97.98,0.76
4677,2021-03-31,TOS,32764,13277,19487,20189,12235,340,ITI,ITI1,9,Toscana,Toscana,3729641,3687238,98.86,0.88
4678,2021-07-09,TOS,29119,14103,15016,7691,21235,193,ITI,ITI1,9,Toscana,Toscana,3729641,3716357,99.64,0.78
4679,2021-03-22,TOS,5258,2768,2490,4675,447,136,ITI,ITI1,9,Toscana,Toscana,3729641,3721615,99.78,0.14
4680,2021-06-16,TOS,31779,16267,15512,26278,5181,320,ITI,ITI1,9,Toscana,Toscana,3729641,3753394,100.64,0.85
4681,2021-05-30,TOS,28697,13954,14743,21506,6949,242,ITI,ITI1,9,Toscana,Toscana,3729641,3782091,101.41,0.77
4682,2021-07-04,TOS,31518,15302,16216,9361,21869,288,ITI,ITI1,9,Toscana,Toscana,3729641,3813609,102.25,0.85
4683,2021-04-05,TOS,15288,6826,8462,14370,738,180,ITI,ITI1,9,Toscana,Toscana,3729641,3828897,102.66,0.41
4684,2021-02-07,TOS,2808,954,1854,864,1924,20,ITI,ITI1,9,Toscana,Toscana,3729641,3831705,102.74,0.08
4685,2021-07-23,TOS,38424,19286,19138,4391,33880,153,ITI,ITI1,9,Toscana,Toscana,3729641,3870129,103.77,1.03
4686,2021-05-18,TOS,28841,14276,14565,19760,8828,253,ITI,ITI1,9,Toscana,Toscana,3729641,3898970,104.54,0.77
4687,2021-02-21,TOS,5105,2089,3016,4731,170,204,ITI,ITI1,9,Toscana,Toscana,3729641,3904075,104.68,0.14
4688,2021-06-01,TOS,26951,13396,13555,22868,3834,249,ITI,ITI1,9,Toscana,Toscana,3729641,3931026,105.4,0.72
4689,2021-07-02,TOS,28296,14196,14100,10812,17196,288,ITI,ITI1,9,Toscana,Toscana,3729641,3959322,106.16,0.76
4690,2021-06-15,TOS,31215,16069,15146,26303,4573,339,ITI,ITI1,9,Toscana,Toscana,3729641,3990537,107.0,0.84
4691,2021-03-10,TOS,18367,7405,10962,14262,3998,107,ITI,ITI1,9,Toscana,Toscana,3729641,4008904,107.49,0.49
4692,2021-02-02,TOS,3744,1476,2268,189,3548,7,ITI,ITI1,9,Toscana,Toscana,3729641,4012648,107.59,0.1
4693,2020-12-31,TOS,802,201,601,798,0,4,ITI,ITI1,9,Toscana,Toscana,3729641,4013450,107.61,0.02
4694,2021-04-10,TOS,11751,5366,6385,10770,743,238,ITI,ITI1,9,Toscana,Toscana,3729641,4025201,107.92,0.32
4695,2021-02-19,TOS,8293,2952,5341,7600,513,180,ITI,ITI1,9,Toscana,Toscana,3729641,4033494,108.15,0.22
4696,2021-04-13,TOS,8494,3508,4986,5736,2475,283,ITI,ITI1,9,Toscana,Toscana,3729641,4041988,108.37,0.23
4697,2021-07-22,TOS,39369,19785,19584,4492,34712,165,ITI,ITI1,9,Toscana,Toscana,3729641,4081357,109.43,1.06
4698,2021-05-26,TOS,35606,17106,18500,20138,15212,256,ITI,ITI1,9,Toscana,Toscana,3729641,4116963,110.38,0.95
4699,2021-03-30,TOS,17035,7646,9389,13264,3573,198,ITI,ITI1,9,Toscana,Toscana,3729641,4133998,110.84,0.46
4700,2021-07-08,TOS,21075,10357,10718,9255,11580,240,ITI,ITI1,9,Toscana,Toscana,3729641,4155073,111.41,0.57
4701,2020-12-27,TOS,620,267,353,615,0,5,ITI,ITI1,9,Toscana,Toscana,3729641,4155693,111.42,0.02
4702,2021-08-02,TOS,35279,18077,17202,13349,21540,390,ITI,ITI1,9,Toscana,Toscana,3729641,4190972,112.37,0.95
4703,2021-01-03,TOS,3336,1052,2284,3290,0,46,ITI,ITI1,9,Toscana,Toscana,3729641,4194308,112.46,0.09
4704,2021-02-15,TOS,8770,3376,5394,7771,826,173,ITI,ITI1,9,Toscana,Toscana,3729641,4203078,112.69,0.24
4705,2021-02-22,TOS,9820,4254,5566,9166,277,377,ITI,ITI1,9,Toscana,Toscana,3729641,4212898,112.96,0.26
4706,2021-05-08,TOS,29180,13126,16054,13279,15500,401,ITI,ITI1,9,Toscana,Toscana,3729641,4242078,113.74,0.78
4707,2021-03-12,TOS,16989,6622,10367,13267,3531,191,ITI,ITI1,9,Toscana,Toscana,3729641,4259067,114.2,0.46
4708,2021-01-14,TOS,3255,1179,2076,3219,0,36,ITI,ITI1,9,Toscana,Toscana,3729641,4262322,114.28,0.09
4709,2021-06-20,TOS,25179,12485,12694,15419,9519,241,ITI,ITI1,9,Toscana,Toscana,3729641,4287501,114.96,0.68
4710,2021-04-24,TOS,13445,6172,7273,5619,7457,369,ITI,ITI1,9,Toscana,Toscana,3729641,4300946,115.32,0.36
4711,2021-06-27,TOS,33301,16077,17224,5915,27254,132,ITI,ITI1,9,Toscana,Toscana,3729641,4334247,116.21,0.89
4712,2021-05-01,TOS,23335,10070,13265,13728,9222,385,ITI,ITI1,9,Toscana,Toscana,3729641,4357582,116.84,0.63
4713,2021-03-05,TOS,16880,6691,10189,11943,4756,181,ITI,ITI1,9,Toscana,Toscana,3729641,4374462,117.29,0.45
4714,2021-08-09,TOS,28921,14688,14233,18492,9721,708,ITI,ITI1,9,Toscana,Toscana,3729641,4403383,118.06,0.78
4715,2021-06-13,TOS,24617,12353,12264,22607,1659,351,ITI,ITI1,9,Toscana,Toscana,3729641,4428000,118.72,0.66
